KODE KELURAHAN,WILAYAH KOTA,KECAMATAN,KELURAHAN,SASARAN,BELUM VAKSIN,DOSIS 1,DOSIS 2,TOTAL VAKSIN,TANGGAL
3172051003,JAKARTA UTARA,PADEMANGAN,ANCOL,20393,14442,5951,3258,9209,2021-06-20
3173041007,JAKARTA BARAT,TAMBORA,ANGKE,25785,19348,6437,3175,9612,2021-06-20
3175041005,JAKARTA TIMUR,KRAMAT JATI,BALE KAMBANG,25158,20675,4483,2577,7060,2021-06-20
3175031003,JAKARTA TIMUR,JATINEGARA,BALI MESTER,8683,6409,2274,1496,3770,2021-06-20
3175101006,JAKARTA TIMUR,CIPAYUNG,BAMBU APUS,22768,17106,5662,3935,9597,2021-06-20
3174031002,JAKARTA SELATAN,MAMPANG PRAPATAN,BANGKA,18930,14008,4922,2661,7583,2021-06-20
3175051002,JAKARTA TIMUR,PASAR REBO,BARU,20267,12944,7323,4624,11947,2021-06-20
3175041004,JAKARTA TIMUR,KRAMAT JATI,BATU AMPAR,41389,33015,8374,5128,13502,2021-06-20
3171071002,JAKARTA PUSAT,TANAH ABANG,BENDUNGAN HILIR,19008,13065,5943,3517,9460,2021-06-20
3175031002,JAKARTA TIMUR,JATINEGARA,BIDARA CINA,32331,25339,6992,3979,10971,2021-06-20
3174101002,JAKARTA SELATAN,PESANGGRAHAN,BINTARO,45843,34449,11394,6984,18378,2021-06-20
3174011005,JAKARTA SELATAN,TEBET,BUKIT DURI,29934,22998,6936,3897,10833,2021-06-20
3171041006,JAKARTA PUSAT,SENEN,BUNGUR,15932,11358,4574,2691,7265,2021-06-20
3175061007,JAKARTA TIMUR,CAKUNG,CAKUNG BARAT,49369,38436,10933,3943,14876,2021-06-20
3175061004,JAKARTA TIMUR,CAKUNG,CAKUNG TIMUR,50344,37636,12708,6269,18977,2021-06-20
3175041007,JAKARTA TIMUR,KRAMAT JATI,CAWANG,28708,22046,6662,4212,10874,2021-06-20
3175101008,JAKARTA TIMUR,CIPAYUNG,CEGER,16381,11957,4424,2525,6949,2021-06-20
3171031006,JAKARTA PUSAT,KEMAYORAN,CEMPAKA BARU,27330,20486,6844,3947,10791,2021-06-20
3171051002,JAKARTA PUSAT,CEMPAKA PUTIH,CEMPAKA PUTIH BARAT,30479,22751,7728,4908,12636,2021-06-20
3171051001,JAKARTA PUSAT,CEMPAKA PUTIH,CEMPAKA PUTIH TIMUR,21553,14950,6603,4378,10981,2021-06-20
3173011001,JAKARTA BARAT,CENGKARENG,CENGKARENG BARAT,57678,39701,17977,8135,26112,2021-06-20
3173011006,JAKARTA BARAT,CENGKARENG,CENGKARENG TIMUR,70122,52748,17374,8414,25788,2021-06-20
3175091002,JAKARTA TIMUR,CIRACAS,CIBUBUR,56927,42284,14643,9298,23941,2021-06-20
3171011002,JAKARTA PUSAT,GAMBIR,CIDENG,14203,9224,4979,3134,8113,2021-06-20
3174091003,JAKARTA SELATAN,JAGAKARSA,CIGANJUR,33127,24578,8549,5102,13651,2021-06-20
3175051003,JAKARTA TIMUR,PASAR REBO,CIJANTUNG,36027,26320,9707,6069,15776,2021-06-20
3171061003,JAKARTA PUSAT,MENTENG,CIKINI,7402,5320,2082,1355,3437,2021-06-20
3174081006,JAKARTA SELATAN,PANCORAN,CIKOKO,9280,6553,2727,1708,4435,2021-06-20
3174061001,JAKARTA SELATAN,CILANDAK,CILANDAK BARAT,45348,31705,13643,7766,21409,2021-06-20
3174041003,JAKARTA SELATAN,PASAR MINGGU,CILANDAK TIMUR,21207,14354,6853,4726,11579,2021-06-20
3175101002,JAKARTA TIMUR,CIPAYUNG,CILANGKAP,23675,17393,6282,3752,10034,2021-06-20
3175041006,JAKARTA TIMUR,KRAMAT JATI,CILILITAN,35164,26762,8402,5136,13538,2021-06-20
3172041001,JAKARTA UTARA,CILINCING,CILINCING,37003,29490,7513,3854,11367,2021-06-20
3175101001,JAKARTA TIMUR,CIPAYUNG,CIPAYUNG,22697,15991,6706,4149,10855,2021-06-20
3174091006,JAKARTA SELATAN,JAGAKARSA,CIPEDAK,32800,24423,8377,4723,13100,2021-06-20
3174061005,JAKARTA SELATAN,CILANDAK,CIPETE SELATAN,23463,17052,6411,3745,10156,2021-06-20
3174071010,JAKARTA SELATAN,KEBAYORAN BARU,CIPETE UTARA,29771,20382,9389,4033,13422,2021-06-20
3175021003,JAKARTA TIMUR,PULO GADUNG,CIPINANG,34608,25047,9561,5891,15452,2021-06-20
3175031007,JAKARTA TIMUR,JATINEGARA,CIPINANG BESAR SELATAN,30655,24232,6423,3816,10239,2021-06-20
3175031008,JAKARTA TIMUR,JATINEGARA,CIPINANG BESAR UTARA,38827,31887,6940,4124,11064,2021-06-20
3175031005,JAKARTA TIMUR,JATINEGARA,CIPINANG CEMPEDAK,29154,21645,7509,4632,12141,2021-06-20
3175081005,JAKARTA TIMUR,MAKASAR,CIPINANG MELAYU,37098,26895,10203,6292,16495,2021-06-20
3175031006,JAKARTA TIMUR,JATINEGARA,CIPINANG MUARA,46861,36116,10745,7170,17915,2021-06-20
3174051003,JAKARTA SELATAN,KEBAYORAN LAMA,CIPULIR,34708,26846,7862,4696,12558,2021-06-20
3175091001,JAKARTA TIMUR,CIRACAS,CIRACAS,55965,40942,15023,8251,23274,2021-06-20
3175041003,JAKARTA TIMUR,KRAMAT JATI,DUKUH,21239,16167,5072,3417,8489,2021-06-20
3175071001,JAKARTA TIMUR,DUREN SAWIT,DUREN SAWIT,53078,39324,13754,9047,22801,2021-06-20
3174081004,JAKARTA SELATAN,PANCORAN,DUREN TIGA,24673,18457,6216,3762,9978,2021-06-20
3173051005,JAKARTA BARAT,KEBON JERUK,DURI KEPA,52942,36175,16767,9804,26571,2021-06-20
3173011002,JAKARTA BARAT,CENGKARENG,DURI KOSAMBI,66093,49083,17010,8072,25082,2021-06-20
3171011006,JAKARTA PUSAT,GAMBIR,DURI PULO,17787,13397,4390,2351,6741,2021-06-20
3173041011,JAKARTA BARAT,TAMBORA,DURI SELATAN,12528,8629,3899,2337,6236,2021-06-20
3173041003,JAKARTA BARAT,TAMBORA,DURI UTARA,17380,12763,4617,2614,7231,2021-06-20
3171081003,JAKARTA PUSAT,JOHAR BARU,GALUR,15811,10897,4914,1943,6857,2021-06-20
3171011001,JAKARTA PUSAT,GAMBIR,GAMBIR,2232,1369,863,571,1434,2021-06-20
3174061004,JAKARTA SELATAN,CILANDAK,GANDARIA SELATAN,19394,13783,5611,2802,8413,2021-06-20
3174071009,JAKARTA SELATAN,KEBAYORAN BARU,GANDARIA UTARA,35026,25125,9901,5287,15188,2021-06-20
3175051001,JAKARTA TIMUR,PASAR REBO,GEDONG,31013,22871,8142,5191,13333,2021-06-20
3171071001,JAKARTA PUSAT,TANAH ABANG,GELORA,2753,1930,823,558,1381,2021-06-20
3173031007,JAKARTA BARAT,TAMAN SARI,GLODOK,7192,4224,2968,1955,4923,2021-06-20
3171061004,JAKARTA PUSAT,MENTENG,GONDANGDIA,3760,2107,1653,1266,2919,2021-06-20
3173021001,JAKARTA BARAT,GROGOL PETAMBURAN,GROGOL,15067,10778,4289,2564,6853,2021-06-20
3174051005,JAKARTA SELATAN,KEBAYORAN LAMA,GROGOL SELATAN,38688,28923,9765,5387,15152,2021-06-20
3174051004,JAKARTA SELATAN,KEBAYORAN LAMA,GROGOL UTARA,37234,28335,8899,5739,14638,2021-06-20
3174021007,JAKARTA SELATAN,SETIA BUDI,GUNTUR,3590,2188,1402,968,2370,2021-06-20
3174071002,JAKARTA SELATAN,KEBAYORAN BARU,GUNUNG,8309,5468,2841,2002,4843,2021-06-20
3171031005,JAKARTA PUSAT,KEMAYORAN,GUNUNG SAHARI SELATAN,17256,12556,4700,2764,7464,2021-06-20
3171021004,JAKARTA PUSAT,SAWAH BESAR,GUNUNG SAHARI UTARA,13937,8189,5748,3325,9073,2021-06-20
3175081004,JAKARTA TIMUR,MAKASAR,HALIM PERDANA KUSUMAH,24426,13203,11223,8258,19481,2021-06-20
3171031003,JAKARTA PUSAT,KEMAYORAN,HARAPAN MULIA,19987,15056,4931,2653,7584,2021-06-20
3174091001,JAKARTA SELATAN,JAGAKARSA,JAGAKARSA,53714,39039,14675,8346,23021,2021-06-20
3175021007,JAKARTA TIMUR,PULO GADUNG,JATI,28870,20378,8492,5488,13980,2021-06-20
3174041002,JAKARTA SELATAN,PASAR MINGGU,JATI PADANG,32857,23743,9114,5774,14888,2021-06-20
3173071004,JAKARTA BARAT,PALMERAH,JATI PULO,24508,15875,8633,3594,12227,2021-06-20
3175061001,JAKARTA TIMUR,CAKUNG,JATINEGARA,72652,59078,13574,6474,20048,2021-06-20
3175021004,JAKARTA TIMUR,PULO GADUNG,JATINEGARA KAUM,21313,16298,5015,2861,7876,2021-06-20
3173021004,JAKARTA BARAT,GROGOL PETAMBURAN,JELAMBAR,26984,18516,8468,5383,13851,2021-06-20
3173021006,JAKARTA BARAT,GROGOL PETAMBURAN,JELAMBAR BARU,33734,24057,9677,5977,15654,2021-06-20
3173041006,JAKARTA BARAT,TAMBORA,JEMBATAN BESI,25735,21128,4607,2388,6995,2021-06-20
3173041008,JAKARTA BARAT,TAMBORA,JEMBATAN LIMA,18241,14408,3833,2231,6064,2021-06-20
3173081005,JAKARTA BARAT,KEMBANGAN,JOGLO,35285,25638,9647,5851,15498,2021-06-20
3171081001,JAKARTA PUSAT,JOHAR BARU,JOHAR BARU,28311,17769,10542,5265,15807,2021-06-20
3173041002,JAKARTA BARAT,TAMBORA,KALI ANYAR,20624,16352,4272,2211,6483,2021-06-20
3172041004,JAKARTA UTARA,CILINCING,KALIBARU,57771,47971,9800,4256,14056,2021-06-20
3174081002,JAKARTA SELATAN,PANCORAN,KALIBATA,36451,27983,8468,4854,13322,2021-06-20
3173061001,JAKARTA BARAT,KALI DERES,KALIDERES,60209,45400,14809,7455,22264,2021-06-20
3175051004,JAKARTA TIMUR,PASAR REBO,KALISARI,37255,26637,10618,6645,17263,2021-06-20
3173061004,JAKARTA BARAT,KALI DERES,KAMAL,46035,37390,8645,3621,12266,2021-06-20
3172011002,JAKARTA UTARA,PENJARINGAN,KAMAL MUARA,11039,7180,3859,2482,6341,2021-06-20
3171071007,JAKARTA PUSAT,TANAH ABANG,KAMPUNG BALI,10113,7784,2329,1489,3818,2021-06-20
3175031001,JAKARTA TIMUR,JATINEGARA,KAMPUNG MELAYU,22293,18012,4281,2203,6484,2021-06-20
3171081002,JAKARTA PUSAT,JOHAR BARU,KAMPUNG RAWA,15550,9109,6441,2520,8961,2021-06-20
3175041002,JAKARTA TIMUR,KRAMAT JATI,KAMPUNG TENGAH,38048,29529,8519,5142,13661,2021-06-20
3173011005,JAKARTA BARAT,CENGKARENG,KAPUK,104630,81964,22666,9358,32024,2021-06-20
3172011003,JAKARTA UTARA,PENJARINGAN,KAPUK MUARA,31275,21274,10001,6562,16563,2021-06-20
3171021002,JAKARTA PUSAT,SAWAH BESAR,KARANG ANYAR,23056,16730,6326,3366,9692,2021-06-20
3174021004,JAKARTA SELATAN,SETIA BUDI,KARET,8542,5791,2751,1414,4165,2021-06-20
3174021003,JAKARTA SELATAN,SETIA BUDI,KARET KUNINGAN,14166,9605,4561,2285,6846,2021-06-20
3174021002,JAKARTA SELATAN,SETIA BUDI,KARET SEMANGGI,2469,1485,984,587,1571,2021-06-20
3171071003,JAKARTA PUSAT,TANAH ABANG,KARET TENGSIN,16695,12700,3995,2169,6164,2021-06-20
3171021003,JAKARTA PUSAT,SAWAH BESAR,KARTINI,19916,13871,6045,3407,9452,2021-06-20
3175011003,JAKARTA TIMUR,MATRAMAN,KAYU MANIS,22174,16903,5271,2949,8220,2021-06-20
3175021006,JAKARTA TIMUR,PULO GADUNG,KAYU PUTIH,35916,25108,10808,6911,17719,2021-06-20
3173031006,JAKARTA BARAT,TAMAN SARI,KEAGUNGAN,15262,11304,3958,1969,5927,2021-06-20
3174041007,JAKARTA SELATAN,PASAR MINGGU,KEBAGUSAN,38396,29235,9161,5080,14241,2021-06-20
3174051006,JAKARTA SELATAN,KEBAYORAN LAMA,KEBAYORAN LAMA SELATAN,35920,24981,10939,5693,16632,2021-06-20
3174051001,JAKARTA SELATAN,KEBAYORAN LAMA,KEBAYORAN LAMA UTARA,37004,27816,9188,5160,14348,2021-06-20
3174011004,JAKARTA SELATAN,TEBET,KEBON BARU,30533,21928,8605,5039,13644,2021-06-20
3172021005,JAKARTA UTARA,TANJUNG PRIOK,KEBON BAWANG,44427,32820,11607,6812,18419,2021-06-20
3173051001,JAKARTA BARAT,KEBON JERUK,KEBON JERUK,46870,35992,10878,6689,17567,2021-06-20
3171071006,JAKARTA PUSAT,TANAH ABANG,KEBON KACANG,19075,14987,4088,2588,6676,2021-06-20
3171011005,JAKARTA PUSAT,GAMBIR,KEBON KELAPA,9383,6857,2526,1643,4169,2021-06-20
3171031002,JAKARTA PUSAT,KEMAYORAN,KEBON KOSONG,26178,19592,6586,3415,10001,2021-06-20
3175011005,JAKARTA TIMUR,MATRAMAN,KEBON MANGGIS,14644,10415,4229,2716,6945,2021-06-20
3171071005,JAKARTA PUSAT,TANAH ABANG,KEBON MELATI,27297,22243,5054,2824,7878,2021-06-20
3175081003,JAKARTA TIMUR,MAKASAR,KEBON PALA,40723,30588,10135,6045,16180,2021-06-20
3171061005,JAKARTA PUSAT,MENTENG,KEBON SIRIH,10880,8443,2437,1525,3962,2021-06-20
3173011004,JAKARTA BARAT,CENGKARENG,KEDAUNG KALI ANGKE,28123,18513,9610,3176,12786,2021-06-20
3173051007,JAKARTA BARAT,KEBON JERUK,KEDOYA SELATAN,28300,20282,8018,4529,12547,2021-06-20
3173051006,JAKARTA BARAT,KEBON JERUK,KEDOYA UTARA,38771,25425,13346,6860,20206,2021-06-20
3173051004,JAKARTA BARAT,KEBON JERUK,KELAPA DUA,20509,15115,5394,3068,8462,2021-06-20
3175091003,JAKARTA TIMUR,CIRACAS,KELAPA DUA WETAN,40776,29217,11559,7044,18603,2021-06-20
3172061003,JAKARTA UTARA,KELAPA GADING,KELAPA GADING BARAT,31544,18792,12752,8580,21332,2021-06-20
3172061001,JAKARTA UTARA,KELAPA GADING,KELAPA GADING TIMUR,30470,17103,13367,8962,22329,2021-06-20
3173071005,JAKARTA BARAT,PALMERAH,KEMANGGISAN,28159,19806,8353,5091,13444,2021-06-20
3171031001,JAKARTA PUSAT,KEMAYORAN,KEMAYORAN,18556,13191,5365,2766,8131,2021-06-20
3173081006,JAKARTA BARAT,KEMBANGAN,KEMBANGAN SELATAN,24028,16291,7737,4926,12663,2021-06-20
3173081001,JAKARTA BARAT,KEMBANGAN,KEMBANGAN UTARA,45663,31774,13889,6468,20357,2021-06-20
3171041002,JAKARTA PUSAT,SENEN,KENARI,8328,5190,3138,1710,4848,2021-06-20
3173041005,JAKARTA BARAT,TAMBORA,KERENDANG,17494,13438,4056,2198,6254,2021-06-20
3175071003,JAKARTA TIMUR,DUREN SAWIT,KLENDER,60420,47013,13407,7208,20615,2021-06-20
3172031001,JAKARTA UTARA,KOJA,KOJA,24600,19316,5284,2688,7972,2021-06-20
3173071006,JAKARTA BARAT,PALMERAH,KOTA BAMBU SELATAN,18287,13630,4657,2206,6863,2021-06-20
3173071003,JAKARTA BARAT,PALMERAH,KOTA BAMBU UTARA,21312,16144,5168,2742,7910,2021-06-20
3171041004,JAKARTA PUSAT,SENEN,KRAMAT,25258,19782,5476,2931,8407,2021-06-20
3175041001,JAKARTA TIMUR,KRAMAT JATI,KRAMAT JATI,29922,21644,8278,4833,13111,2021-06-20
3174071003,JAKARTA SELATAN,KEBAYORAN BARU,KRAMAT PELA,12737,8217,4520,2340,6860,2021-06-20
3173031002,JAKARTA BARAT,TAMAN SARI,KRUKUT,17023,12290,4733,2244,6977,2021-06-20
3174031005,JAKARTA SELATAN,MAMPANG PRAPATAN,KUNINGAN BARAT,11229,7863,3366,1526,4892,2021-06-20
3174021008,JAKARTA SELATAN,SETIA BUDI,KUNINGAN TIMUR,5331,3623,1708,1031,2739,2021-06-20
3171041005,JAKARTA PUSAT,SENEN,KWITANG,13487,9539,3948,2047,5995,2021-06-20
3172031003,JAKARTA UTARA,KOJA,LAGOA,51431,40672,10759,5553,16312,2021-06-20
3174061002,JAKARTA SELATAN,CILANDAK,LEBAK BULUS,32738,23851,8887,5748,14635,2021-06-20
3174091004,JAKARTA SELATAN,JAGAKARSA,LENTENG AGUNG,46600,36382,10218,6039,16257,2021-06-20
3175101007,JAKARTA TIMUR,CIPAYUNG,LUBANG BUAYA,55114,42586,12528,8216,20744,2021-06-20
3175081001,JAKARTA TIMUR,MAKASAR,MAKASAR,30013,21992,8021,4862,12883,2021-06-20
3175071006,JAKARTA TIMUR,DUREN SAWIT,MALAKA JAYA,26798,19110,7688,5367,13055,2021-06-20
3175071005,JAKARTA TIMUR,DUREN SAWIT,MALAKA SARI,23691,15920,7771,5312,13083,2021-06-20
3174031001,JAKARTA SELATAN,MAMPANG PRAPATAN,MAMPANG PRAPATAN,15885,12349,3536,2022,5558,2021-06-20
3173031005,JAKARTA BARAT,TAMAN SARI,MANGGA BESAR,6690,4199,2491,1431,3922,2021-06-20
3171021005,JAKARTA PUSAT,SAWAH BESAR,MANGGA DUA SELATAN,24940,18035,6905,3795,10700,2021-06-20
3174011007,JAKARTA SELATAN,TEBET,MANGGARAI,24972,18399,6573,3504,10077,2021-06-20
3174011006,JAKARTA SELATAN,TEBET,MANGGARAI SELATAN,20274,14373,5901,3161,9062,2021-06-20
3173031003,JAKARTA BARAT,TAMAN SARI,MAPHAR,14671,9999,4672,2533,7205,2021-06-20
3172041003,JAKARTA UTARA,CILINCING,MARUNDA,24385,17656,6729,2540,9269,2021-06-20
3174071001,JAKARTA SELATAN,KEBAYORAN BARU,MELAWAI,2386,1307,1079,810,1889,2021-06-20
3171061001,JAKARTA PUSAT,MENTENG,MENTENG,22450,17168,5282,3445,8727,2021-06-20
3174021005,JAKARTA SELATAN,SETIA BUDI,MENTENG ATAS,24369,16860,7509,3948,11457,2021-06-20
3174011003,JAKARTA SELATAN,TEBET,MENTENG DALAM,31623,23381,8242,5066,13308,2021-06-20
3173081003,JAKARTA BARAT,KEMBANGAN,MERUYA SELATAN,27261,19480,7781,4268,12049,2021-06-20
3173081002,JAKARTA BARAT,KEMBANGAN,MERUYA UTARA,38525,27603,10922,6803,17725,2021-06-20
3175101004,JAKARTA TIMUR,CIPAYUNG,MUNJUL,20582,15108,5474,3522,8996,2021-06-20
3172051002,JAKARTA UTARA,PADEMANGAN,PADEMANGAN BARAT,64756,49693,15063,7696,22759,2021-06-20
3172051001,JAKARTA UTARA,PADEMANGAN,PADEMANGAN TIMUR,32689,20299,12390,6804,19194,2021-06-20
3175011004,JAKARTA TIMUR,MATRAMAN,PAL MERIAM,17550,12858,4692,2669,7361,2021-06-20
3173071001,JAKARTA BARAT,PALMERAH,PALMERAH,54706,40450,14256,7860,22116,2021-06-20
3174081001,JAKARTA SELATAN,PANCORAN,PANCORAN,16983,12797,4186,2575,6761,2021-06-20
3172021003,JAKARTA UTARA,TANJUNG PRIOK,PAPANGGO,33902,25283,8619,4592,13211,2021-06-20
3171021001,JAKARTA PUSAT,SAWAH BESAR,PASAR BARU,11656,6842,4814,2865,7679,2021-06-20
3174021006,JAKARTA SELATAN,SETIA BUDI,PASAR MANGGIS,23415,16979,6436,3495,9931,2021-06-20
3174041001,JAKARTA SELATAN,PASAR MINGGU,PASAR MINGGU,21700,14961,6739,4469,11208,2021-06-20
3171041003,JAKARTA PUSAT,SENEN,PASEBAN,20652,14724,5928,3253,9181,2021-06-20
3173061005,JAKARTA BARAT,KALI DERES,PEGADUNGAN,65248,49057,16191,8948,25139,2021-06-20
3171061002,JAKARTA PUSAT,MENTENG,PEGANGSAAN,18427,13052,5375,2883,8258,2021-06-20
3172061002,JAKARTA UTARA,KELAPA GADING,PEGANGSAAN DUA,44451,26501,17950,10285,28235,2021-06-20
3172011004,JAKARTA UTARA,PENJARINGAN,PEJAGALAN,66008,48346,17662,10736,28398,2021-06-20
3174041006,JAKARTA SELATAN,PASAR MINGGU,PEJATEN BARAT,30591,21416,9175,5444,14619,2021-06-20
3174041005,JAKARTA SELATAN,PASAR MINGGU,PEJATEN TIMUR,50150,38972,11178,5919,17097,2021-06-20
3175051005,JAKARTA TIMUR,PASAR REBO,PEKAYON,37440,27237,10203,5931,16134,2021-06-20
3173041009,JAKARTA BARAT,TAMBORA,PEKOJAN,20921,15109,5812,3369,9181,2021-06-20
3174031003,JAKARTA SELATAN,MAMPANG PRAPATAN,PELA MAMPANG,37784,27959,9825,5509,15334,2021-06-20
3174081005,JAKARTA SELATAN,PANCORAN,PENGADEGAN,18685,12851,5834,3247,9081,2021-06-20
3175061003,JAKARTA TIMUR,CAKUNG,PENGGILINGAN,84511,66910,17601,9126,26727,2021-06-20
3172011001,JAKARTA UTARA,PENJARINGAN,PENJARINGAN,75505,57456,18049,7718,25767,2021-06-20
3174101001,JAKARTA SELATAN,PESANGGRAHAN,PESANGGRAHAN,23733,15539,8194,4812,13006,2021-06-20
3171071004,JAKARTA PUSAT,TANAH ABANG,PETAMBURAN,28974,23678,5296,2873,8169,2021-06-20
3174071008,JAKARTA SELATAN,KEBAYORAN BARU,PETOGOGAN,10203,7152,3051,1813,4864,2021-06-20
3171011004,JAKARTA PUSAT,GAMBIR,PETOJO SELATAN,13506,9304,4202,2923,7125,2021-06-20
3171011003,JAKARTA PUSAT,GAMBIR,PETOJO UTARA,16084,11596,4488,2668,7156,2021-06-20
3174101004,JAKARTA SELATAN,PESANGGRAHAN,PETUKANGAN SELATAN,32229,22822,9407,4839,14246,2021-06-20
3174101003,JAKARTA SELATAN,PESANGGRAHAN,PETUKANGAN UTARA,46427,34731,11696,6606,18302,2021-06-20
3175081002,JAKARTA TIMUR,MAKASAR,PINANG RANTI,23465,17276,6189,3373,9562,2021-06-20
3173031008,JAKARTA BARAT,TAMAN SARI,PINANGSIA,9405,6293,3112,1609,4721,2021-06-20
3175011001,JAKARTA TIMUR,MATRAMAN,PISANGAN BARU,27793,21453,6340,3745,10085,2021-06-20
3175021002,JAKARTA TIMUR,PULO GADUNG,PISANGAN TIMUR,35717,25756,9961,5488,15449,2021-06-20
3172011005,JAKARTA UTARA,PENJARINGAN,PLUIT,42979,26426,16553,12159,28712,2021-06-20
3175071002,JAKARTA TIMUR,DUREN SAWIT,PONDOK BAMBU,53658,38833,14825,8656,23481,2021-06-20
3175071004,JAKARTA TIMUR,DUREN SAWIT,PONDOK KELAPA,62704,46460,16244,10745,26989,2021-06-20
3175071007,JAKARTA TIMUR,DUREN SAWIT,PONDOK KOPI,30741,23373,7368,4241,11609,2021-06-20
3174061003,JAKARTA SELATAN,CILANDAK,PONDOK LABU,39778,28952,10826,6724,17550,2021-06-20
3174051002,JAKARTA SELATAN,KEBAYORAN LAMA,PONDOK PINANG,49276,35731,13545,9168,22713,2021-06-20
3175101003,JAKARTA TIMUR,CIPAYUNG,PONDOK RANGGON,21791,16392,5399,3704,9103,2021-06-20
3101011003,KAB.ADM.KEP.SERIBU,KEP. SERIBU UTARA,PULAU HARAPAN,1785,978,807,625,1432,2021-06-20
3101011002,KAB.ADM.KEP.SERIBU,KEP. SERIBU UTARA,PULAU KELAPA,4729,2817,1912,1035,2947,2021-06-20
3101011001,KAB.ADM.KEP.SERIBU,KEP. SERIBU UTARA,PULAU PANGGANG,4667,2597,2070,1086,3156,2021-06-20
3101021003,KAB.ADM.KEP.SERIBU,KEP. SERIBU SELATAN,PULAU PARI,2370,1189,1181,600,1781,2021-06-20
3101021002,KAB.ADM.KEP.SERIBU,KEP. SERIBU SELATAN,PULAU TIDUNG,3922,2228,1694,1063,2757,2021-06-20
3101021001,KAB.ADM.KEP.SERIBU,KEP. SERIBU SELATAN,PULAU UNTUNG JAWA,1665,866,799,553,1352,2021-06-20
3174071007,JAKARTA SELATAN,KEBAYORAN BARU,PULO,5184,3293,1891,1321,3212,2021-06-20
3175021001,JAKARTA TIMUR,PULO GADUNG,PULO GADUNG,30292,22720,7572,4544,12116,2021-06-20
3175061005,JAKARTA TIMUR,CAKUNG,PULO GEBANG,83832,64835,18997,10389,29386,2021-06-20
3174041004,JAKARTA SELATAN,PASAR MINGGU,RAGUNAN,34536,24053,10483,5687,16170,2021-06-20
3175091005,JAKARTA TIMUR,CIRACAS,RAMBUTAN,31759,25043,6716,4180,10896,2021-06-20
3172031006,JAKARTA UTARA,KOJA,RAWA BADAK SELATAN,36403,29224,7179,3851,11030,2021-06-20
3172031004,JAKARTA UTARA,KOJA,RAWA BADAK UTARA,29198,21549,7649,3762,11411,2021-06-20
3174071005,JAKARTA SELATAN,KEBAYORAN BARU,RAWA BARAT,5029,3184,1845,1304,3149,2021-06-20
3173011003,JAKARTA BARAT,CENGKARENG,RAWA BUAYA,51752,37076,14676,5902,20578,2021-06-20
3175031004,JAKARTA TIMUR,JATINEGARA,RAWA BUNGA,18617,14403,4214,2441,6655,2021-06-20
3174081003,JAKARTA SELATAN,PANCORAN,RAWA JATI,18210,12607,5603,3349,8952,2021-06-20
3175061002,JAKARTA TIMUR,CAKUNG,RAWA TERATE,21332,14222,7110,2025,9135,2021-06-20
3175021005,JAKARTA TIMUR,PULO GADUNG,RAWAMANGUN,32470,23106,9364,5752,15116,2021-06-20
3171051003,JAKARTA PUSAT,CEMPAKA PUTIH,RAWASARI,19312,13743,5569,3420,8989,2021-06-20
3173041010,JAKARTA BARAT,TAMBORA,ROA MALAKA,3149,1875,1274,867,2141,2021-06-20
3172041006,JAKARTA UTARA,CILINCING,ROROTAN,35258,26298,8960,4477,13437,2021-06-20
3174071004,JAKARTA SELATAN,KEBAYORAN BARU,SELONG,2576,1448,1128,866,1994,2021-06-20
3173061002,JAKARTA BARAT,KALI DERES,SEMANAN,60715,48401,12314,4905,17219,2021-06-20
3172041007,JAKARTA UTARA,CILINCING,SEMPER BARAT,59323,42988,16335,8932,25267,2021-06-20
3172041005,JAKARTA UTARA,CILINCING,SEMPER TIMUR,31249,23551,7698,4234,11932,2021-06-20
3174071006,JAKARTA SELATAN,KEBAYORAN BARU,SENAYAN,2482,1715,767,561,1328,2021-06-20
3171041001,JAKARTA PUSAT,SENEN,SENEN,5951,3892,2059,1141,3200,2021-06-20
3171031004,JAKARTA PUSAT,KEMAYORAN,SERDANG,26045,18927,7118,3869,10987,2021-06-20
3174021001,JAKARTA SELATAN,SETIA BUDI,SETIA BUDI,2532,1600,932,631,1563,2021-06-20
3175101005,JAKARTA TIMUR,CIPAYUNG,SETU,17609,13538,4071,2630,6701,2021-06-20
3173071002,JAKARTA BARAT,PALMERAH,SLIPI,14526,9985,4541,2680,7221,2021-06-20
3173081004,JAKARTA BARAT,KEMBANGAN,SRENGSENG,39370,29798,9572,6075,15647,2021-06-20
3174091002,JAKARTA SELATAN,JAGAKARSA,SRENGSENG SAWAH,50305,33277,17028,8782,25810,2021-06-20
3173051003,JAKARTA BARAT,KEBON JERUK,SUKABUMI SELATAN,30581,24051,6530,3425,9955,2021-06-20
3173051002,JAKARTA BARAT,KEBON JERUK,SUKABUMI UTARA,33050,26248,6802,3940,10742,2021-06-20
3172041002,JAKARTA UTARA,CILINCING,SUKAPURA,46955,35295,11660,5343,17003,2021-06-20
3171031007,JAKARTA PUSAT,KEMAYORAN,SUMUR BATU,19863,14439,5424,3322,8746,2021-06-20
3172021004,JAKARTA UTARA,TANJUNG PRIOK,SUNGAI BAMBU,25366,18894,6472,3456,9928,2021-06-20
3172021006,JAKARTA UTARA,TANJUNG PRIOK,SUNTER AGUNG,62904,40352,22552,13301,35853,2021-06-20
3172021002,JAKARTA UTARA,TANJUNG PRIOK,SUNTER JAYA,55168,38225,16943,10257,27200,2021-06-20
3175091004,JAKARTA TIMUR,CIRACAS,SUSUKAN,28884,21336,7548,4510,12058,2021-06-20
3173031001,JAKARTA BARAT,TAMAN SARI,TAMAN SARI,12915,9093,3822,2370,6192,2021-06-20
3173041001,JAKARTA BARAT,TAMBORA,TAMBORA,9087,6690,2397,1504,3901,2021-06-20
3173041004,JAKARTA BARAT,TAMBORA,TANAH SEREAL,23141,15955,7186,3815,11001,2021-06-20
3171081004,JAKARTA PUSAT,JOHAR BARU,TANAH TINGGI,32931,23589,9342,4188,13530,2021-06-20
3173031004,JAKARTA BARAT,TAMAN SARI,TANGKI,11593,8028,3565,1898,5463,2021-06-20
3174091005,JAKARTA SELATAN,JAGAKARSA,TANJUNG BARAT,34530,25970,8560,5545,14105,2021-06-20
3173021005,JAKARTA BARAT,GROGOL PETAMBURAN,TANJUNG DUREN SELATAN,22469,14217,8252,4371,12623,2021-06-20
3173021002,JAKARTA BARAT,GROGOL PETAMBURAN,TANJUNG DUREN UTARA,15224,9645,5579,3461,9040,2021-06-20
3172021001,JAKARTA UTARA,TANJUNG PRIOK,TANJUNG PRIOK,29913,20342,9571,3794,13365,2021-06-20
3174011002,JAKARTA SELATAN,TEBET,TEBET BARAT,18916,12669,6247,4090,10337,2021-06-20
3174011001,JAKARTA SELATAN,TEBET,TEBET TIMUR,16031,10184,5847,3647,9494,2021-06-20
3173061003,JAKARTA BARAT,KALI DERES,TEGAL ALUR,71923,57238,14685,6727,21412,2021-06-20
3174031004,JAKARTA SELATAN,MAMPANG PRAPATAN,TEGAL PARANG,28143,22663,5480,3252,8732,2021-06-20
3173021003,JAKARTA BARAT,GROGOL PETAMBURAN,TOMANG,25531,16833,8698,4895,13593,2021-06-20
3172031005,JAKARTA UTARA,KOJA,TUGU SELATAN,33663,26386,7277,3738,11015,2021-06-20
3172031002,JAKARTA UTARA,KOJA,TUGU UTARA,58638,46824,11814,6628,18442,2021-06-20
3175061006,JAKARTA TIMUR,CAKUNG,UJUNG MENTENG,25702,18439,7263,3890,11153,2021-06-20
3174101005,JAKARTA SELATAN,PESANGGRAHAN,ULUJAMI,35077,26722,8355,4849,13204,2021-06-20
3175011006,JAKARTA TIMUR,MATRAMAN,UTAN KAYU SELATAN,29303,20916,8387,4944,13331,2021-06-20
3175011002,JAKARTA TIMUR,MATRAMAN,UTAN KAYU UTARA,24728,17881,6847,3726,10573,2021-06-20
3171031008,JAKARTA PUSAT,KEMAYORAN,UTAN PANJANG,25622,20143,5479,2756,8235,2021-06-20
3172021007,JAKARTA UTARA,TANJUNG PRIOK,WARAKAS,38194,28958,9236,5120,14356,2021-06-20
3173021007,JAKARTA BARAT,GROGOL PETAMBURAN,WIJAYA KUSUMA,34170,24574,9596,4781,14377,2021-06-20
3172051003,JAKARTA UTARA,PADEMANGAN,ANCOL,20393,14406,5987,3260,9247,2021-06-21
3173041007,JAKARTA BARAT,TAMBORA,ANGKE,25785,18930,6855,3175,10030,2021-06-21
3175041005,JAKARTA TIMUR,KRAMAT JATI,BALE KAMBANG,25158,20621,4537,2580,7117,2021-06-21
3175031003,JAKARTA TIMUR,JATINEGARA,BALI MESTER,8683,6351,2332,1496,3828,2021-06-21
3175101006,JAKARTA TIMUR,CIPAYUNG,BAMBU APUS,22768,17044,5724,3935,9659,2021-06-21
3174031002,JAKARTA SELATAN,MAMPANG PRAPATAN,BANGKA,18930,13969,4961,2663,7624,2021-06-21
3175051002,JAKARTA TIMUR,PASAR REBO,BARU,20267,12905,7362,4626,11988,2021-06-21
3175041004,JAKARTA TIMUR,KRAMAT JATI,BATU AMPAR,41389,32899,8490,5133,13623,2021-06-21
3171071002,JAKARTA PUSAT,TANAH ABANG,BENDUNGAN HILIR,19008,13019,5989,3517,9506,2021-06-21
3175031002,JAKARTA TIMUR,JATINEGARA,BIDARA CINA,32331,25263,7068,3980,11048,2021-06-21
3174101002,JAKARTA SELATAN,PESANGGRAHAN,BINTARO,45843,34341,11502,6988,18490,2021-06-21
3174011005,JAKARTA SELATAN,TEBET,BUKIT DURI,29934,22924,7010,3898,10908,2021-06-21
3171041006,JAKARTA PUSAT,SENEN,BUNGUR,15932,11317,4615,2695,7310,2021-06-21
3175061007,JAKARTA TIMUR,CAKUNG,CAKUNG BARAT,49369,38291,11078,3948,15026,2021-06-21
3175061004,JAKARTA TIMUR,CAKUNG,CAKUNG TIMUR,50344,37520,12824,6274,19098,2021-06-21
3175041007,JAKARTA TIMUR,KRAMAT JATI,CAWANG,28708,21950,6758,4213,10971,2021-06-21
3175101008,JAKARTA TIMUR,CIPAYUNG,CEGER,16381,11927,4454,2526,6980,2021-06-21
3171031006,JAKARTA PUSAT,KEMAYORAN,CEMPAKA BARU,27330,20441,6889,3948,10837,2021-06-21
3171051002,JAKARTA PUSAT,CEMPAKA PUTIH,CEMPAKA PUTIH BARAT,30479,22663,7816,4909,12725,2021-06-21
3171051001,JAKARTA PUSAT,CEMPAKA PUTIH,CEMPAKA PUTIH TIMUR,21553,14850,6703,4378,11081,2021-06-21
3173011001,JAKARTA BARAT,CENGKARENG,CENGKARENG BARAT,57678,38904,18774,8136,26910,2021-06-21
3173011006,JAKARTA BARAT,CENGKARENG,CENGKARENG TIMUR,70122,52264,17858,8415,26273,2021-06-21
3175091002,JAKARTA TIMUR,CIRACAS,CIBUBUR,56927,42066,14861,9305,24166,2021-06-21
3171011002,JAKARTA PUSAT,GAMBIR,CIDENG,14203,9173,5030,3134,8164,2021-06-21
3174091003,JAKARTA SELATAN,JAGAKARSA,CIGANJUR,33127,24508,8619,5104,13723,2021-06-21
3175051003,JAKARTA TIMUR,PASAR REBO,CIJANTUNG,36027,26239,9788,6071,15859,2021-06-21
3171061003,JAKARTA PUSAT,MENTENG,CIKINI,7402,5305,2097,1355,3452,2021-06-21
3174081006,JAKARTA SELATAN,PANCORAN,CIKOKO,9280,6528,2752,1708,4460,2021-06-21
3174061001,JAKARTA SELATAN,CILANDAK,CILANDAK BARAT,45348,31565,13783,7768,21551,2021-06-21
3174041003,JAKARTA SELATAN,PASAR MINGGU,CILANDAK TIMUR,21207,14288,6919,4729,11648,2021-06-21
3175101002,JAKARTA TIMUR,CIPAYUNG,CILANGKAP,23675,17357,6318,3757,10075,2021-06-21
3175041006,JAKARTA TIMUR,KRAMAT JATI,CILILITAN,35164,26525,8639,5136,13775,2021-06-21
3172041001,JAKARTA UTARA,CILINCING,CILINCING,37003,29449,7554,3857,11411,2021-06-21
3175101001,JAKARTA TIMUR,CIPAYUNG,CIPAYUNG,22697,15925,6772,4151,10923,2021-06-21
3174091006,JAKARTA SELATAN,JAGAKARSA,CIPEDAK,32800,24356,8444,4723,13167,2021-06-21
3174061005,JAKARTA SELATAN,CILANDAK,CIPETE SELATAN,23463,16998,6465,3745,10210,2021-06-21
3174071010,JAKARTA SELATAN,KEBAYORAN BARU,CIPETE UTARA,29771,20330,9441,4034,13475,2021-06-21
3175021003,JAKARTA TIMUR,PULO GADUNG,CIPINANG,34608,24927,9681,5892,15573,2021-06-21
3175031007,JAKARTA TIMUR,JATINEGARA,CIPINANG BESAR SELATAN,30655,24139,6516,3819,10335,2021-06-21
3175031008,JAKARTA TIMUR,JATINEGARA,CIPINANG BESAR UTARA,38827,31788,7039,4125,11164,2021-06-21
3175031005,JAKARTA TIMUR,JATINEGARA,CIPINANG CEMPEDAK,29154,21577,7577,4632,12209,2021-06-21
3175081005,JAKARTA TIMUR,MAKASAR,CIPINANG MELAYU,37098,26794,10304,6294,16598,2021-06-21
3175031006,JAKARTA TIMUR,JATINEGARA,CIPINANG MUARA,46861,35962,10899,7174,18073,2021-06-21
3174051003,JAKARTA SELATAN,KEBAYORAN LAMA,CIPULIR,34708,26777,7931,4697,12628,2021-06-21
3175091001,JAKARTA TIMUR,CIRACAS,CIRACAS,55965,40628,15337,8255,23592,2021-06-21
3175041003,JAKARTA TIMUR,KRAMAT JATI,DUKUH,21239,16138,5101,3417,8518,2021-06-21
3175071001,JAKARTA TIMUR,DUREN SAWIT,DUREN SAWIT,53078,39206,13872,9053,22925,2021-06-21
3174081004,JAKARTA SELATAN,PANCORAN,DUREN TIGA,24673,18406,6267,3762,10029,2021-06-21
3173051005,JAKARTA BARAT,KEBON JERUK,DURI KEPA,52942,35954,16988,9806,26794,2021-06-21
3173011002,JAKARTA BARAT,CENGKARENG,DURI KOSAMBI,66093,48364,17729,8072,25801,2021-06-21
3171011006,JAKARTA PUSAT,GAMBIR,DURI PULO,17787,13349,4438,2353,6791,2021-06-21
3173041011,JAKARTA BARAT,TAMBORA,DURI SELATAN,12528,8581,3947,2337,6284,2021-06-21
3173041003,JAKARTA BARAT,TAMBORA,DURI UTARA,17380,12690,4690,2614,7304,2021-06-21
3171081003,JAKARTA PUSAT,JOHAR BARU,GALUR,15811,10816,4995,1943,6938,2021-06-21
3171011001,JAKARTA PUSAT,GAMBIR,GAMBIR,2232,1363,869,571,1440,2021-06-21
3174061004,JAKARTA SELATAN,CILANDAK,GANDARIA SELATAN,19394,13729,5665,2802,8467,2021-06-21
3174071009,JAKARTA SELATAN,KEBAYORAN BARU,GANDARIA UTARA,35026,25042,9984,5289,15273,2021-06-21
3175051001,JAKARTA TIMUR,PASAR REBO,GEDONG,31013,22795,8218,5193,13411,2021-06-21
3171071001,JAKARTA PUSAT,TANAH ABANG,GELORA,2753,1918,835,558,1393,2021-06-21
3173031007,JAKARTA BARAT,TAMAN SARI,GLODOK,7192,4189,3003,1956,4959,2021-06-21
3171061004,JAKARTA PUSAT,MENTENG,GONDANGDIA,3760,2096,1664,1266,2930,2021-06-21
3173021001,JAKARTA BARAT,GROGOL PETAMBURAN,GROGOL,15067,10727,4340,2565,6905,2021-06-21
3174051005,JAKARTA SELATAN,KEBAYORAN LAMA,GROGOL SELATAN,38688,28829,9859,5389,15248,2021-06-21
3174051004,JAKARTA SELATAN,KEBAYORAN LAMA,GROGOL UTARA,37234,28240,8994,5739,14733,2021-06-21
3174021007,JAKARTA SELATAN,SETIA BUDI,GUNTUR,3590,2180,1410,968,2378,2021-06-21
3174071002,JAKARTA SELATAN,KEBAYORAN BARU,GUNUNG,8309,5454,2855,2002,4857,2021-06-21
3171031005,JAKARTA PUSAT,KEMAYORAN,GUNUNG SAHARI SELATAN,17256,12491,4765,2765,7530,2021-06-21
3171021004,JAKARTA PUSAT,SAWAH BESAR,GUNUNG SAHARI UTARA,13937,8154,5783,3325,9108,2021-06-21
3175081004,JAKARTA TIMUR,MAKASAR,HALIM PERDANA KUSUMAH,24426,13152,11274,8259,19533,2021-06-21
3171031003,JAKARTA PUSAT,KEMAYORAN,HARAPAN MULIA,19987,15000,4987,2653,7640,2021-06-21
3174091001,JAKARTA SELATAN,JAGAKARSA,JAGAKARSA,53714,38911,14803,8354,23157,2021-06-21
3175021007,JAKARTA TIMUR,PULO GADUNG,JATI,28870,20316,8554,5491,14045,2021-06-21
3174041002,JAKARTA SELATAN,PASAR MINGGU,JATI PADANG,32857,23682,9175,5779,14954,2021-06-21
3173071004,JAKARTA BARAT,PALMERAH,JATI PULO,24508,15824,8684,3595,12279,2021-06-21
3175061001,JAKARTA TIMUR,CAKUNG,JATINEGARA,72652,58889,13763,6482,20245,2021-06-21
3175021004,JAKARTA TIMUR,PULO GADUNG,JATINEGARA KAUM,21313,16253,5060,2864,7924,2021-06-21
3173021004,JAKARTA BARAT,GROGOL PETAMBURAN,JELAMBAR,26984,18383,8601,5383,13984,2021-06-21
3173021006,JAKARTA BARAT,GROGOL PETAMBURAN,JELAMBAR BARU,33734,23943,9791,5978,15769,2021-06-21
3173041006,JAKARTA BARAT,TAMBORA,JEMBATAN BESI,25735,21059,4676,2392,7068,2021-06-21
3173041008,JAKARTA BARAT,TAMBORA,JEMBATAN LIMA,18241,14337,3904,2232,6136,2021-06-21
3173081005,JAKARTA BARAT,KEMBANGAN,JOGLO,35285,25500,9785,5852,15637,2021-06-21
3171081001,JAKARTA PUSAT,JOHAR BARU,JOHAR BARU,28311,17693,10618,5268,15886,2021-06-21
3173041002,JAKARTA BARAT,TAMBORA,KALI ANYAR,20624,16319,4305,2212,6517,2021-06-21
3172041004,JAKARTA UTARA,CILINCING,KALIBARU,57771,47823,9948,4259,14207,2021-06-21
3174081002,JAKARTA SELATAN,PANCORAN,KALIBATA,36451,27895,8556,4856,13412,2021-06-21
3173061001,JAKARTA BARAT,KALI DERES,KALIDERES,60209,45088,15121,7456,22577,2021-06-21
3175051004,JAKARTA TIMUR,PASAR REBO,KALISARI,37255,26578,10677,6650,17327,2021-06-21
3173061004,JAKARTA BARAT,KALI DERES,KAMAL,46035,37300,8735,3621,12356,2021-06-21
3172011002,JAKARTA UTARA,PENJARINGAN,KAMAL MUARA,11039,7151,3888,2482,6370,2021-06-21
3171071007,JAKARTA PUSAT,TANAH ABANG,KAMPUNG BALI,10113,7758,2355,1489,3844,2021-06-21
3175031001,JAKARTA TIMUR,JATINEGARA,KAMPUNG MELAYU,22293,17909,4384,2205,6589,2021-06-21
3171081002,JAKARTA PUSAT,JOHAR BARU,KAMPUNG RAWA,15550,9052,6498,2520,9018,2021-06-21
3175041002,JAKARTA TIMUR,KRAMAT JATI,KAMPUNG TENGAH,38048,29469,8579,5142,13721,2021-06-21
3173011005,JAKARTA BARAT,CENGKARENG,KAPUK,104630,81240,23390,9360,32750,2021-06-21
3172011003,JAKARTA UTARA,PENJARINGAN,KAPUK MUARA,31275,21200,10075,6562,16637,2021-06-21
3171021002,JAKARTA PUSAT,SAWAH BESAR,KARANG ANYAR,23056,16682,6374,3367,9741,2021-06-21
3174021004,JAKARTA SELATAN,SETIA BUDI,KARET,8542,5761,2781,1414,4195,2021-06-21
3174021003,JAKARTA SELATAN,SETIA BUDI,KARET KUNINGAN,14166,9581,4585,2285,6870,2021-06-21
3174021002,JAKARTA SELATAN,SETIA BUDI,KARET SEMANGGI,2469,1478,991,589,1580,2021-06-21
3171071003,JAKARTA PUSAT,TANAH ABANG,KARET TENGSIN,16695,12635,4060,2169,6229,2021-06-21
3171021003,JAKARTA PUSAT,SAWAH BESAR,KARTINI,19916,13830,6086,3408,9494,2021-06-21
3175011003,JAKARTA TIMUR,MATRAMAN,KAYU MANIS,22174,16820,5354,2950,8304,2021-06-21
3175021006,JAKARTA TIMUR,PULO GADUNG,KAYU PUTIH,35916,25027,10889,6915,17804,2021-06-21
3173031006,JAKARTA BARAT,TAMAN SARI,KEAGUNGAN,15262,11251,4011,1969,5980,2021-06-21
3174041007,JAKARTA SELATAN,PASAR MINGGU,KEBAGUSAN,38396,29155,9241,5083,14324,2021-06-21
3174051006,JAKARTA SELATAN,KEBAYORAN LAMA,KEBAYORAN LAMA SELATAN,35920,24892,11028,5695,16723,2021-06-21
3174051001,JAKARTA SELATAN,KEBAYORAN LAMA,KEBAYORAN LAMA UTARA,37004,27712,9292,5160,14452,2021-06-21
3174011004,JAKARTA SELATAN,TEBET,KEBON BARU,30533,21833,8700,5040,13740,2021-06-21
3172021005,JAKARTA UTARA,TANJUNG PRIOK,KEBON BAWANG,44427,32593,11834,6817,18651,2021-06-21
3173051001,JAKARTA BARAT,KEBON JERUK,KEBON JERUK,46870,35855,11015,6690,17705,2021-06-21
3171071006,JAKARTA PUSAT,TANAH ABANG,KEBON KACANG,19075,14930,4145,2588,6733,2021-06-21
3171011005,JAKARTA PUSAT,GAMBIR,KEBON KELAPA,9383,6829,2554,1644,4198,2021-06-21
3171031002,JAKARTA PUSAT,KEMAYORAN,KEBON KOSONG,26178,19416,6762,3415,10177,2021-06-21
3175011005,JAKARTA TIMUR,MATRAMAN,KEBON MANGGIS,14644,10339,4305,2718,7023,2021-06-21
3171071005,JAKARTA PUSAT,TANAH ABANG,KEBON MELATI,27297,22190,5107,2824,7931,2021-06-21
3175081003,JAKARTA TIMUR,MAKASAR,KEBON PALA,40723,30453,10270,6046,16316,2021-06-21
3171061005,JAKARTA PUSAT,MENTENG,KEBON SIRIH,10880,8408,2472,1526,3998,2021-06-21
3173011004,JAKARTA BARAT,CENGKARENG,KEDAUNG KALI ANGKE,28123,18175,9948,3177,13125,2021-06-21
3173051007,JAKARTA BARAT,KEBON JERUK,KEDOYA SELATAN,28300,20174,8126,4530,12656,2021-06-21
3173051006,JAKARTA BARAT,KEBON JERUK,KEDOYA UTARA,38771,25210,13561,6861,20422,2021-06-21
3173051004,JAKARTA BARAT,KEBON JERUK,KELAPA DUA,20509,14923,5586,3070,8656,2021-06-21
3175091003,JAKARTA TIMUR,CIRACAS,KELAPA DUA WETAN,40776,29053,11723,7049,18772,2021-06-21
3172061003,JAKARTA UTARA,KELAPA GADING,KELAPA GADING BARAT,31544,18723,12821,8584,21405,2021-06-21
3172061001,JAKARTA UTARA,KELAPA GADING,KELAPA GADING TIMUR,30470,16981,13489,8964,22453,2021-06-21
3173071005,JAKARTA BARAT,PALMERAH,KEMANGGISAN,28159,19720,8439,5092,13531,2021-06-21
3171031001,JAKARTA PUSAT,KEMAYORAN,KEMAYORAN,18556,13138,5418,2766,8184,2021-06-21
3173081006,JAKARTA BARAT,KEMBANGAN,KEMBANGAN SELATAN,24028,16208,7820,4927,12747,2021-06-21
3173081001,JAKARTA BARAT,KEMBANGAN,KEMBANGAN UTARA,45663,31611,14052,6470,20522,2021-06-21
3171041002,JAKARTA PUSAT,SENEN,KENARI,8328,5168,3160,1712,4872,2021-06-21
3173041005,JAKARTA BARAT,TAMBORA,KERENDANG,17494,13379,4115,2198,6313,2021-06-21
3175071003,JAKARTA TIMUR,DUREN SAWIT,KLENDER,60420,46798,13622,7216,20838,2021-06-21
3172031001,JAKARTA UTARA,KOJA,KOJA,24600,19137,5463,2696,8159,2021-06-21
3173071006,JAKARTA BARAT,PALMERAH,KOTA BAMBU SELATAN,18287,13602,4685,2206,6891,2021-06-21
3173071003,JAKARTA BARAT,PALMERAH,KOTA BAMBU UTARA,21312,16111,5201,2743,7944,2021-06-21
3171041004,JAKARTA PUSAT,SENEN,KRAMAT,25258,19714,5544,2932,8476,2021-06-21
3175041001,JAKARTA TIMUR,KRAMAT JATI,KRAMAT JATI,29922,21551,8371,4834,13205,2021-06-21
3174071003,JAKARTA SELATAN,KEBAYORAN BARU,KRAMAT PELA,12737,8191,4546,2340,6886,2021-06-21
3173031002,JAKARTA BARAT,TAMAN SARI,KRUKUT,17023,12249,4774,2245,7019,2021-06-21
3174031005,JAKARTA SELATAN,MAMPANG PRAPATAN,KUNINGAN BARAT,11229,7845,3384,1528,4912,2021-06-21
3174021008,JAKARTA SELATAN,SETIA BUDI,KUNINGAN TIMUR,5331,3609,1722,1031,2753,2021-06-21
3171041005,JAKARTA PUSAT,SENEN,KWITANG,13487,9466,4021,2047,6068,2021-06-21
3172031003,JAKARTA UTARA,KOJA,LAGOA,51431,40457,10974,5557,16531,2021-06-21
3174061002,JAKARTA SELATAN,CILANDAK,LEBAK BULUS,32738,23762,8976,5749,14725,2021-06-21
3174091004,JAKARTA SELATAN,JAGAKARSA,LENTENG AGUNG,46600,36276,10324,6040,16364,2021-06-21
3175101007,JAKARTA TIMUR,CIPAYUNG,LUBANG BUAYA,55114,42342,12772,8225,20997,2021-06-21
3175081001,JAKARTA TIMUR,MAKASAR,MAKASAR,30013,21912,8101,4865,12966,2021-06-21
3175071006,JAKARTA TIMUR,DUREN SAWIT,MALAKA JAYA,26798,19053,7745,5372,13117,2021-06-21
3175071005,JAKARTA TIMUR,DUREN SAWIT,MALAKA SARI,23691,15869,7822,5313,13135,2021-06-21
3174031001,JAKARTA SELATAN,MAMPANG PRAPATAN,MAMPANG PRAPATAN,15885,12302,3583,2022,5605,2021-06-21
3173031005,JAKARTA BARAT,TAMAN SARI,MANGGA BESAR,6690,4164,2526,1431,3957,2021-06-21
3171021005,JAKARTA PUSAT,SAWAH BESAR,MANGGA DUA SELATAN,24940,17940,7000,3795,10795,2021-06-21
3174011007,JAKARTA SELATAN,TEBET,MANGGARAI,24972,18352,6620,3505,10125,2021-06-21
3174011006,JAKARTA SELATAN,TEBET,MANGGARAI SELATAN,20274,14333,5941,3162,9103,2021-06-21
3173031003,JAKARTA BARAT,TAMAN SARI,MAPHAR,14671,9960,4711,2533,7244,2021-06-21
3172041003,JAKARTA UTARA,CILINCING,MARUNDA,24385,17123,7262,2542,9804,2021-06-21
3174071001,JAKARTA SELATAN,KEBAYORAN BARU,MELAWAI,2386,1303,1083,810,1893,2021-06-21
3171061001,JAKARTA PUSAT,MENTENG,MENTENG,22450,17108,5342,3451,8793,2021-06-21
3174021005,JAKARTA SELATAN,SETIA BUDI,MENTENG ATAS,24369,16807,7562,3950,11512,2021-06-21
3174011003,JAKARTA SELATAN,TEBET,MENTENG DALAM,31623,23267,8356,5067,13423,2021-06-21
3173081003,JAKARTA BARAT,KEMBANGAN,MERUYA SELATAN,27261,19371,7890,4268,12158,2021-06-21
3173081002,JAKARTA BARAT,KEMBANGAN,MERUYA UTARA,38525,27428,11097,6804,17901,2021-06-21
3175101004,JAKARTA TIMUR,CIPAYUNG,MUNJUL,20582,15063,5519,3522,9041,2021-06-21
3172051002,JAKARTA UTARA,PADEMANGAN,PADEMANGAN BARAT,64756,49545,15211,7697,22908,2021-06-21
3172051001,JAKARTA UTARA,PADEMANGAN,PADEMANGAN TIMUR,32689,20219,12470,6804,19274,2021-06-21
3175011004,JAKARTA TIMUR,MATRAMAN,PAL MERIAM,17550,12790,4760,2671,7431,2021-06-21
3173071001,JAKARTA BARAT,PALMERAH,PALMERAH,54706,40314,14392,7862,22254,2021-06-21
3174081001,JAKARTA SELATAN,PANCORAN,PANCORAN,16983,12760,4223,2576,6799,2021-06-21
3172021003,JAKARTA UTARA,TANJUNG PRIOK,PAPANGGO,33902,25172,8730,4595,13325,2021-06-21
3171021001,JAKARTA PUSAT,SAWAH BESAR,PASAR BARU,11656,6810,4846,2865,7711,2021-06-21
3174021006,JAKARTA SELATAN,SETIA BUDI,PASAR MANGGIS,23415,16940,6475,3495,9970,2021-06-21
3174041001,JAKARTA SELATAN,PASAR MINGGU,PASAR MINGGU,21700,14916,6784,4473,11257,2021-06-21
3171041003,JAKARTA PUSAT,SENEN,PASEBAN,20652,14612,6040,3254,9294,2021-06-21
3173061005,JAKARTA BARAT,KALI DERES,PEGADUNGAN,65248,48785,16463,8949,25412,2021-06-21
3171061002,JAKARTA PUSAT,MENTENG,PEGANGSAAN,18427,13026,5401,2885,8286,2021-06-21
3172061002,JAKARTA UTARA,KELAPA GADING,PEGANGSAAN DUA,44451,26341,18110,10288,28398,2021-06-21
3172011004,JAKARTA UTARA,PENJARINGAN,PEJAGALAN,66008,47961,18047,10738,28785,2021-06-21
3174041006,JAKARTA SELATAN,PASAR MINGGU,PEJATEN BARAT,30591,21332,9259,5448,14707,2021-06-21
3174041005,JAKARTA SELATAN,PASAR MINGGU,PEJATEN TIMUR,50150,38870,11280,5920,17200,2021-06-21
3175051005,JAKARTA TIMUR,PASAR REBO,PEKAYON,37440,27041,10399,5941,16340,2021-06-21
3173041009,JAKARTA BARAT,TAMBORA,PEKOJAN,20921,15035,5886,3369,9255,2021-06-21
3174031003,JAKARTA SELATAN,MAMPANG PRAPATAN,PELA MAMPANG,37784,27880,9904,5510,15414,2021-06-21
3174081005,JAKARTA SELATAN,PANCORAN,PENGADEGAN,18685,12806,5879,3247,9126,2021-06-21
3175061003,JAKARTA TIMUR,CAKUNG,PENGGILINGAN,84511,66673,17838,9137,26975,2021-06-21
3172011001,JAKARTA UTARA,PENJARINGAN,PENJARINGAN,75505,57226,18279,7719,25998,2021-06-21
3174101001,JAKARTA SELATAN,PESANGGRAHAN,PESANGGRAHAN,23733,15398,8335,4814,13149,2021-06-21
3171071004,JAKARTA PUSAT,TANAH ABANG,PETAMBURAN,28974,23617,5357,2876,8233,2021-06-21
3174071008,JAKARTA SELATAN,KEBAYORAN BARU,PETOGOGAN,10203,7123,3080,1813,4893,2021-06-21
3171011004,JAKARTA PUSAT,GAMBIR,PETOJO SELATAN,13506,9233,4273,2925,7198,2021-06-21
3171011003,JAKARTA PUSAT,GAMBIR,PETOJO UTARA,16084,11553,4531,2669,7200,2021-06-21
3174101004,JAKARTA SELATAN,PESANGGRAHAN,PETUKANGAN SELATAN,32229,22759,9470,4841,14311,2021-06-21
3174101003,JAKARTA SELATAN,PESANGGRAHAN,PETUKANGAN UTARA,46427,34394,12033,6606,18639,2021-06-21
3175081002,JAKARTA TIMUR,MAKASAR,PINANG RANTI,23465,17189,6276,3374,9650,2021-06-21
3173031008,JAKARTA BARAT,TAMAN SARI,PINANGSIA,9405,6244,3161,1609,4770,2021-06-21
3175011001,JAKARTA TIMUR,MATRAMAN,PISANGAN BARU,27793,21377,6416,3746,10162,2021-06-21
3175021002,JAKARTA TIMUR,PULO GADUNG,PISANGAN TIMUR,35717,25692,10025,5488,15513,2021-06-21
3172011005,JAKARTA UTARA,PENJARINGAN,PLUIT,42979,26278,16701,12162,28863,2021-06-21
3175071002,JAKARTA TIMUR,DUREN SAWIT,PONDOK BAMBU,53658,38573,15085,8663,23748,2021-06-21
3175071004,JAKARTA TIMUR,DUREN SAWIT,PONDOK KELAPA,62704,46280,16424,10750,27174,2021-06-21
3175071007,JAKARTA TIMUR,DUREN SAWIT,PONDOK KOPI,30741,23309,7432,4247,11679,2021-06-21
3174061003,JAKARTA SELATAN,CILANDAK,PONDOK LABU,39778,28840,10938,6724,17662,2021-06-21
3174051002,JAKARTA SELATAN,KEBAYORAN LAMA,PONDOK PINANG,49276,35613,13663,9177,22840,2021-06-21
3175101003,JAKARTA TIMUR,CIPAYUNG,PONDOK RANGGON,21791,16356,5435,3705,9140,2021-06-21
3101011003,KAB.ADM.KEP.SERIBU,KEP. SERIBU UTARA,PULAU HARAPAN,1785,933,852,625,1477,2021-06-21
3101011002,KAB.ADM.KEP.SERIBU,KEP. SERIBU UTARA,PULAU KELAPA,4729,2755,1974,1037,3011,2021-06-21
3101011001,KAB.ADM.KEP.SERIBU,KEP. SERIBU UTARA,PULAU PANGGANG,4667,2360,2307,1087,3394,2021-06-21
3101021003,KAB.ADM.KEP.SERIBU,KEP. SERIBU SELATAN,PULAU PARI,2370,1127,1243,600,1843,2021-06-21
3101021002,KAB.ADM.KEP.SERIBU,KEP. SERIBU SELATAN,PULAU TIDUNG,3922,2126,1796,1072,2868,2021-06-21
3101021001,KAB.ADM.KEP.SERIBU,KEP. SERIBU SELATAN,PULAU UNTUNG JAWA,1665,855,810,553,1363,2021-06-21
3174071007,JAKARTA SELATAN,KEBAYORAN BARU,PULO,5184,3270,1914,1321,3235,2021-06-21
3175021001,JAKARTA TIMUR,PULO GADUNG,PULO GADUNG,30292,22633,7659,4546,12205,2021-06-21
3175061005,JAKARTA TIMUR,CAKUNG,PULO GEBANG,83832,64651,19181,10395,29576,2021-06-21
3174041004,JAKARTA SELATAN,PASAR MINGGU,RAGUNAN,34536,23983,10553,5688,16241,2021-06-21
3175091005,JAKARTA TIMUR,CIRACAS,RAMBUTAN,31759,24933,6826,4182,11008,2021-06-21
3172031006,JAKARTA UTARA,KOJA,RAWA BADAK SELATAN,36403,29097,7306,3859,11165,2021-06-21
3172031004,JAKARTA UTARA,KOJA,RAWA BADAK UTARA,29198,21419,7779,3763,11542,2021-06-21
3174071005,JAKARTA SELATAN,KEBAYORAN BARU,RAWA BARAT,5029,3175,1854,1305,3159,2021-06-21
3173011003,JAKARTA BARAT,CENGKARENG,RAWA BUAYA,51752,36378,15374,5902,21276,2021-06-21
3175031004,JAKARTA TIMUR,JATINEGARA,RAWA BUNGA,18617,14358,4259,2441,6700,2021-06-21
3174081003,JAKARTA SELATAN,PANCORAN,RAWA JATI,18210,12527,5683,3349,9032,2021-06-21
3175061002,JAKARTA TIMUR,CAKUNG,RAWA TERATE,21332,14160,7172,2027,9199,2021-06-21
3175021005,JAKARTA TIMUR,PULO GADUNG,RAWAMANGUN,32470,23044,9426,5754,15180,2021-06-21
3171051003,JAKARTA PUSAT,CEMPAKA PUTIH,RAWASARI,19312,13698,5614,3423,9037,2021-06-21
3173041010,JAKARTA BARAT,TAMBORA,ROA MALAKA,3149,1866,1283,867,2150,2021-06-21
3172041006,JAKARTA UTARA,CILINCING,ROROTAN,35258,26137,9121,4484,13605,2021-06-21
3174071004,JAKARTA SELATAN,KEBAYORAN BARU,SELONG,2576,1443,1133,866,1999,2021-06-21
3173061002,JAKARTA BARAT,KALI DERES,SEMANAN,60715,48165,12550,4906,17456,2021-06-21
3172041007,JAKARTA UTARA,CILINCING,SEMPER BARAT,59323,42880,16443,8935,25378,2021-06-21
3172041005,JAKARTA UTARA,CILINCING,SEMPER TIMUR,31249,23488,7761,4239,12000,2021-06-21
3174071006,JAKARTA SELATAN,KEBAYORAN BARU,SENAYAN,2482,1709,773,561,1334,2021-06-21
3171041001,JAKARTA PUSAT,SENEN,SENEN,5951,3880,2071,1142,3213,2021-06-21
3171031004,JAKARTA PUSAT,KEMAYORAN,SERDANG,26045,18888,7157,3870,11027,2021-06-21
3174021001,JAKARTA SELATAN,SETIA BUDI,SETIA BUDI,2532,1591,941,631,1572,2021-06-21
3175101005,JAKARTA TIMUR,CIPAYUNG,SETU,17609,13515,4094,2633,6727,2021-06-21
3173071002,JAKARTA BARAT,PALMERAH,SLIPI,14526,9953,4573,2680,7253,2021-06-21
3173081004,JAKARTA BARAT,KEMBANGAN,SRENGSENG,39370,29681,9689,6075,15764,2021-06-21
3174091002,JAKARTA SELATAN,JAGAKARSA,SRENGSENG SAWAH,50305,33228,17077,8784,25861,2021-06-21
3173051003,JAKARTA BARAT,KEBON JERUK,SUKABUMI SELATAN,30581,23990,6591,3425,10016,2021-06-21
3173051002,JAKARTA BARAT,KEBON JERUK,SUKABUMI UTARA,33050,26191,6859,3941,10800,2021-06-21
3172041002,JAKARTA UTARA,CILINCING,SUKAPURA,46955,35167,11788,5345,17133,2021-06-21
3171031007,JAKARTA PUSAT,KEMAYORAN,SUMUR BATU,19863,14395,5468,3323,8791,2021-06-21
3172021004,JAKARTA UTARA,TANJUNG PRIOK,SUNGAI BAMBU,25366,18713,6653,3457,10110,2021-06-21
3172021006,JAKARTA UTARA,TANJUNG PRIOK,SUNTER AGUNG,62904,40161,22743,13306,36049,2021-06-21
3172021002,JAKARTA UTARA,TANJUNG PRIOK,SUNTER JAYA,55168,38056,17112,10266,27378,2021-06-21
3175091004,JAKARTA TIMUR,CIRACAS,SUSUKAN,28884,21050,7834,4512,12346,2021-06-21
3173031001,JAKARTA BARAT,TAMAN SARI,TAMAN SARI,12915,9040,3875,2370,6245,2021-06-21
3173041001,JAKARTA BARAT,TAMBORA,TAMBORA,9087,6656,2431,1506,3937,2021-06-21
3173041004,JAKARTA BARAT,TAMBORA,TANAH SEREAL,23141,15880,7261,3816,11077,2021-06-21
3171081004,JAKARTA PUSAT,JOHAR BARU,TANAH TINGGI,32931,23438,9493,4189,13682,2021-06-21
3173031004,JAKARTA BARAT,TAMAN SARI,TANGKI,11593,7987,3606,1898,5504,2021-06-21
3174091005,JAKARTA SELATAN,JAGAKARSA,TANJUNG BARAT,34530,25891,8639,5549,14188,2021-06-21
3173021005,JAKARTA BARAT,GROGOL PETAMBURAN,TANJUNG DUREN SELATAN,22469,14088,8381,4374,12755,2021-06-21
3173021002,JAKARTA BARAT,GROGOL PETAMBURAN,TANJUNG DUREN UTARA,15224,9560,5664,3462,9126,2021-06-21
3172021001,JAKARTA UTARA,TANJUNG PRIOK,TANJUNG PRIOK,29913,20276,9637,3797,13434,2021-06-21
3174011002,JAKARTA SELATAN,TEBET,TEBET BARAT,18916,12593,6323,4092,10415,2021-06-21
3174011001,JAKARTA SELATAN,TEBET,TEBET TIMUR,16031,10104,5927,3649,9576,2021-06-21
3173061003,JAKARTA BARAT,KALI DERES,TEGAL ALUR,71923,56986,14937,6727,21664,2021-06-21
3174031004,JAKARTA SELATAN,MAMPANG PRAPATAN,TEGAL PARANG,28143,22607,5536,3253,8789,2021-06-21
3173021003,JAKARTA BARAT,GROGOL PETAMBURAN,TOMANG,25531,16743,8788,4895,13683,2021-06-21
3172031005,JAKARTA UTARA,KOJA,TUGU SELATAN,33663,26285,7378,3742,11120,2021-06-21
3172031002,JAKARTA UTARA,KOJA,TUGU UTARA,58638,46680,11958,6631,18589,2021-06-21
3175061006,JAKARTA TIMUR,CAKUNG,UJUNG MENTENG,25702,18390,7312,3896,11208,2021-06-21
3174101005,JAKARTA SELATAN,PESANGGRAHAN,ULUJAMI,35077,26608,8469,4853,13322,2021-06-21
3175011006,JAKARTA TIMUR,MATRAMAN,UTAN KAYU SELATAN,29303,20830,8473,4947,13420,2021-06-21
3175011002,JAKARTA TIMUR,MATRAMAN,UTAN KAYU UTARA,24728,17814,6914,3727,10641,2021-06-21
3171031008,JAKARTA PUSAT,KEMAYORAN,UTAN PANJANG,25622,20087,5535,2758,8293,2021-06-21
3172021007,JAKARTA UTARA,TANJUNG PRIOK,WARAKAS,38194,28825,9369,5122,14491,2021-06-21
3173021007,JAKARTA BARAT,GROGOL PETAMBURAN,WIJAYA KUSUMA,34170,24474,9696,4782,14478,2021-06-21
3172051003,JAKARTA UTARA,PADEMANGAN,ANCOL,20393,14269,6117,3261,9378,2021-06-22
3173041007,JAKARTA BARAT,TAMBORA,ANGKE,25785,18623,7153,3181,10334,2021-06-22
3175041005,JAKARTA TIMUR,KRAMAT JATI,BALE KAMBANG,25158,20445,4705,2588,7293,2021-06-22
3175031003,JAKARTA TIMUR,JATINEGARA,BALI MESTER,8683,6296,2384,1500,3884,2021-06-22
3175101006,JAKARTA TIMUR,CIPAYUNG,BAMBU APUS,22768,16869,5895,3936,9831,2021-06-22
3174031002,JAKARTA SELATAN,MAMPANG PRAPATAN,BANGKA,18930,13828,5096,2665,7761,2021-06-22
3175051002,JAKARTA TIMUR,PASAR REBO,BARU,20267,12700,7551,4635,12186,2021-06-22
3175041004,JAKARTA TIMUR,KRAMAT JATI,BATU AMPAR,41389,32654,8726,5146,13872,2021-06-22
3171071002,JAKARTA PUSAT,TANAH ABANG,BENDUNGAN HILIR,19008,12816,6185,3529,9714,2021-06-22
3175031002,JAKARTA TIMUR,JATINEGARA,BIDARA CINA,32331,25066,7261,3986,11247,2021-06-22
3174101002,JAKARTA SELATAN,PESANGGRAHAN,BINTARO,45843,34017,11816,7004,18820,2021-06-22
3174011005,JAKARTA SELATAN,TEBET,BUKIT DURI,29934,22608,7324,3903,11227,2021-06-22
3171041006,JAKARTA PUSAT,SENEN,BUNGUR,15932,11136,4782,2705,7487,2021-06-22
3175061007,JAKARTA TIMUR,CAKUNG,CAKUNG BARAT,49369,37154,12213,3955,16168,2021-06-22
3175061004,JAKARTA TIMUR,CAKUNG,CAKUNG TIMUR,50344,37077,13257,6284,19541,2021-06-22
3175041007,JAKARTA TIMUR,KRAMAT JATI,CAWANG,28708,21718,6985,4218,11203,2021-06-22
3175101008,JAKARTA TIMUR,CIPAYUNG,CEGER,16381,11785,4595,2534,7129,2021-06-22
3171031006,JAKARTA PUSAT,KEMAYORAN,CEMPAKA BARU,27330,20164,7156,3958,11114,2021-06-22
3171051002,JAKARTA PUSAT,CEMPAKA PUTIH,CEMPAKA PUTIH BARAT,30479,22457,8013,4916,12929,2021-06-22
3171051001,JAKARTA PUSAT,CEMPAKA PUTIH,CEMPAKA PUTIH TIMUR,21553,14679,6871,4384,11255,2021-06-22
3173011001,JAKARTA BARAT,CENGKARENG,CENGKARENG BARAT,57678,38625,19043,8152,27195,2021-06-22
3173011006,JAKARTA BARAT,CENGKARENG,CENGKARENG TIMUR,70122,51738,18375,8426,26801,2021-06-22
3175091002,JAKARTA TIMUR,CIRACAS,CIBUBUR,56927,41590,15326,9324,24650,2021-06-22
3171011002,JAKARTA PUSAT,GAMBIR,CIDENG,14203,9066,5129,3144,8273,2021-06-22
3174091003,JAKARTA SELATAN,JAGAKARSA,CIGANJUR,33127,24272,8844,5112,13956,2021-06-22
3175051003,JAKARTA TIMUR,PASAR REBO,CIJANTUNG,36027,25957,10060,6084,16144,2021-06-22
3171061003,JAKARTA PUSAT,MENTENG,CIKINI,7402,5263,2138,1357,3495,2021-06-22
3174081006,JAKARTA SELATAN,PANCORAN,CIKOKO,9280,6452,2828,1710,4538,2021-06-22
3174061001,JAKARTA SELATAN,CILANDAK,CILANDAK BARAT,45348,31030,14303,7776,22079,2021-06-22
3174041003,JAKARTA SELATAN,PASAR MINGGU,CILANDAK TIMUR,21207,14193,7005,4734,11739,2021-06-22
3175101002,JAKARTA TIMUR,CIPAYUNG,CILANGKAP,23675,17228,6440,3761,10201,2021-06-22
3175041006,JAKARTA TIMUR,KRAMAT JATI,CILILITAN,35164,26318,8837,5159,13996,2021-06-22
3172041001,JAKARTA UTARA,CILINCING,CILINCING,37003,29145,7851,3862,11713,2021-06-22
3175101001,JAKARTA TIMUR,CIPAYUNG,CIPAYUNG,22697,15779,6910,4159,11069,2021-06-22
3174091006,JAKARTA SELATAN,JAGAKARSA,CIPEDAK,32800,23982,8811,4728,13539,2021-06-22
3174061005,JAKARTA SELATAN,CILANDAK,CIPETE SELATAN,23463,16870,6590,3749,10339,2021-06-22
3174071010,JAKARTA SELATAN,KEBAYORAN BARU,CIPETE UTARA,29771,20106,9661,4038,13699,2021-06-22
3175021003,JAKARTA TIMUR,PULO GADUNG,CIPINANG,34608,24732,9868,5904,15772,2021-06-22
3175031007,JAKARTA TIMUR,JATINEGARA,CIPINANG BESAR SELATAN,30655,23934,6713,3826,10539,2021-06-22
3175031008,JAKARTA TIMUR,JATINEGARA,CIPINANG BESAR UTARA,38827,31604,7217,4135,11352,2021-06-22
3175031005,JAKARTA TIMUR,JATINEGARA,CIPINANG CEMPEDAK,29154,21425,7721,4639,12360,2021-06-22
3175081005,JAKARTA TIMUR,MAKASAR,CIPINANG MELAYU,37098,26516,10575,6305,16880,2021-06-22
3175031006,JAKARTA TIMUR,JATINEGARA,CIPINANG MUARA,46861,35650,11205,7191,18396,2021-06-22
3174051003,JAKARTA SELATAN,KEBAYORAN LAMA,CIPULIR,34708,26420,8283,4702,12985,2021-06-22
3175091001,JAKARTA TIMUR,CIRACAS,CIRACAS,55965,40244,15714,8271,23985,2021-06-22
3175041003,JAKARTA TIMUR,KRAMAT JATI,DUKUH,21239,15841,5394,3428,8822,2021-06-22
3175071001,JAKARTA TIMUR,DUREN SAWIT,DUREN SAWIT,53078,38744,14320,9091,23411,2021-06-22
3174081004,JAKARTA SELATAN,PANCORAN,DUREN TIGA,24673,18216,6452,3766,10218,2021-06-22
3173051005,JAKARTA BARAT,KEBON JERUK,DURI KEPA,52942,35470,17455,9826,27281,2021-06-22
3173011002,JAKARTA BARAT,CENGKARENG,DURI KOSAMBI,66093,47950,18134,8084,26218,2021-06-22
3171011006,JAKARTA PUSAT,GAMBIR,DURI PULO,17787,13243,4541,2357,6898,2021-06-22
3173041011,JAKARTA BARAT,TAMBORA,DURI SELATAN,12528,8520,4001,2343,6344,2021-06-22
3173041003,JAKARTA BARAT,TAMBORA,DURI UTARA,17380,12528,4849,2616,7465,2021-06-22
3171081003,JAKARTA PUSAT,JOHAR BARU,GALUR,15811,10657,5154,1946,7100,2021-06-22
3171011001,JAKARTA PUSAT,GAMBIR,GAMBIR,2232,1348,883,572,1455,2021-06-22
3174061004,JAKARTA SELATAN,CILANDAK,GANDARIA SELATAN,19394,13534,5852,2804,8656,2021-06-22
3174071009,JAKARTA SELATAN,KEBAYORAN BARU,GANDARIA UTARA,35026,24683,10339,5292,15631,2021-06-22
3175051001,JAKARTA TIMUR,PASAR REBO,GEDONG,31013,22570,8430,5201,13631,2021-06-22
3171071001,JAKARTA PUSAT,TANAH ABANG,GELORA,2753,1905,841,558,1399,2021-06-22
3173031007,JAKARTA BARAT,TAMAN SARI,GLODOK,7192,4117,3073,1959,5032,2021-06-22
3171061004,JAKARTA PUSAT,MENTENG,GONDANGDIA,3760,2043,1712,1267,2979,2021-06-22
3173021001,JAKARTA BARAT,GROGOL PETAMBURAN,GROGOL,15067,10600,4461,2574,7035,2021-06-22
3174051005,JAKARTA SELATAN,KEBAYORAN LAMA,GROGOL SELATAN,38688,28633,10048,5401,15449,2021-06-22
3174051004,JAKARTA SELATAN,KEBAYORAN LAMA,GROGOL UTARA,37234,27986,9231,5751,14982,2021-06-22
3174021007,JAKARTA SELATAN,SETIA BUDI,GUNTUR,3590,2156,1431,968,2399,2021-06-22
3174071002,JAKARTA SELATAN,KEBAYORAN BARU,GUNUNG,8309,5395,2913,2010,4923,2021-06-22
3171031005,JAKARTA PUSAT,KEMAYORAN,GUNUNG SAHARI SELATAN,17256,12292,4958,2770,7728,2021-06-22
3171021004,JAKARTA PUSAT,SAWAH BESAR,GUNUNG SAHARI UTARA,13937,8039,5892,3332,9224,2021-06-22
3175081004,JAKARTA TIMUR,MAKASAR,HALIM PERDANA KUSUMAH,24426,12789,11619,8299,19918,2021-06-22
3171031003,JAKARTA PUSAT,KEMAYORAN,HARAPAN MULIA,19987,14826,5157,2657,7814,2021-06-22
3174091001,JAKARTA SELATAN,JAGAKARSA,JAGAKARSA,53714,38293,15407,8377,23784,2021-06-22
3175021007,JAKARTA TIMUR,PULO GADUNG,JATI,28870,20082,8773,5513,14286,2021-06-22
3174041002,JAKARTA SELATAN,PASAR MINGGU,JATI PADANG,32857,23352,9496,5786,15282,2021-06-22
3173071004,JAKARTA BARAT,PALMERAH,JATI PULO,24508,15703,8802,3601,12403,2021-06-22
3175061001,JAKARTA TIMUR,CAKUNG,JATINEGARA,72652,58475,14177,6503,20680,2021-06-22
3175021004,JAKARTA TIMUR,PULO GADUNG,JATINEGARA KAUM,21313,16087,5223,2871,8094,2021-06-22
3173021004,JAKARTA BARAT,GROGOL PETAMBURAN,JELAMBAR,26984,18105,8869,5398,14267,2021-06-22
3173021006,JAKARTA BARAT,GROGOL PETAMBURAN,JELAMBAR BARU,33734,23668,10057,5992,16049,2021-06-22
3173041006,JAKARTA BARAT,TAMBORA,JEMBATAN BESI,25735,20880,4854,2397,7251,2021-06-22
3173041008,JAKARTA BARAT,TAMBORA,JEMBATAN LIMA,18241,14202,4033,2237,6270,2021-06-22
3173081005,JAKARTA BARAT,KEMBANGAN,JOGLO,35285,25241,10039,5864,15903,2021-06-22
3171081001,JAKARTA PUSAT,JOHAR BARU,JOHAR BARU,28311,17404,10901,5275,16176,2021-06-22
3173041002,JAKARTA BARAT,TAMBORA,KALI ANYAR,20624,16172,4450,2215,6665,2021-06-22
3172041004,JAKARTA UTARA,CILINCING,KALIBARU,57771,47606,10162,4261,14423,2021-06-22
3174081002,JAKARTA SELATAN,PANCORAN,KALIBATA,36451,27612,8838,4860,13698,2021-06-22
3173061001,JAKARTA BARAT,KALI DERES,KALIDERES,60209,44538,15654,7479,23133,2021-06-22
3175051004,JAKARTA TIMUR,PASAR REBO,KALISARI,37255,26263,10980,6660,17640,2021-06-22
3173061004,JAKARTA BARAT,KALI DERES,KAMAL,46035,36953,9080,3623,12703,2021-06-22
3172011002,JAKARTA UTARA,PENJARINGAN,KAMAL MUARA,11039,6961,4068,2483,6551,2021-06-22
3171071007,JAKARTA PUSAT,TANAH ABANG,KAMPUNG BALI,10113,7683,2430,1494,3924,2021-06-22
3175031001,JAKARTA TIMUR,JATINEGARA,KAMPUNG MELAYU,22293,17808,4482,2208,6690,2021-06-22
3171081002,JAKARTA PUSAT,JOHAR BARU,KAMPUNG RAWA,15550,8854,6693,2521,9214,2021-06-22
3175041002,JAKARTA TIMUR,KRAMAT JATI,KAMPUNG TENGAH,38048,29255,8784,5165,13949,2021-06-22
3173011005,JAKARTA BARAT,CENGKARENG,KAPUK,104630,80301,24321,9386,33707,2021-06-22
3172011003,JAKARTA UTARA,PENJARINGAN,KAPUK MUARA,31275,20984,10272,6575,16847,2021-06-22
3171021002,JAKARTA PUSAT,SAWAH BESAR,KARANG ANYAR,23056,16489,6556,3373,9929,2021-06-22
3174021004,JAKARTA SELATAN,SETIA BUDI,KARET,8542,5701,2839,1416,4255,2021-06-22
3174021003,JAKARTA SELATAN,SETIA BUDI,KARET KUNINGAN,14166,9483,4679,2288,6967,2021-06-22
3174021002,JAKARTA SELATAN,SETIA BUDI,KARET SEMANGGI,2469,1440,1026,590,1616,2021-06-22
3171071003,JAKARTA PUSAT,TANAH ABANG,KARET TENGSIN,16695,12453,4240,2171,6411,2021-06-22
3171021003,JAKARTA PUSAT,SAWAH BESAR,KARTINI,19916,13676,6236,3417,9653,2021-06-22
3175011003,JAKARTA TIMUR,MATRAMAN,KAYU MANIS,22174,16620,5552,2957,8509,2021-06-22
3175021006,JAKARTA TIMUR,PULO GADUNG,KAYU PUTIH,35916,24728,11173,6924,18097,2021-06-22
3173031006,JAKARTA BARAT,TAMAN SARI,KEAGUNGAN,15262,11148,4112,1973,6085,2021-06-22
3174041007,JAKARTA SELATAN,PASAR MINGGU,KEBAGUSAN,38396,28792,9595,5095,14690,2021-06-22
3174051006,JAKARTA SELATAN,KEBAYORAN LAMA,KEBAYORAN LAMA SELATAN,35920,24526,11385,5709,17094,2021-06-22
3174051001,JAKARTA SELATAN,KEBAYORAN LAMA,KEBAYORAN LAMA UTARA,37004,27400,9595,5171,14766,2021-06-22
3174011004,JAKARTA SELATAN,TEBET,KEBON BARU,30533,21545,8982,5046,14028,2021-06-22
3172021005,JAKARTA UTARA,TANJUNG PRIOK,KEBON BAWANG,44427,32138,12272,6825,19097,2021-06-22
3173051001,JAKARTA BARAT,KEBON JERUK,KEBON JERUK,46870,35519,11340,6695,18035,2021-06-22
3171071006,JAKARTA PUSAT,TANAH ABANG,KEBON KACANG,19075,14842,4231,2591,6822,2021-06-22
3171011005,JAKARTA PUSAT,GAMBIR,KEBON KELAPA,9383,6769,2613,1644,4257,2021-06-22
3171031002,JAKARTA PUSAT,KEMAYORAN,KEBON KOSONG,26178,19096,7078,3423,10501,2021-06-22
3175011005,JAKARTA TIMUR,MATRAMAN,KEBON MANGGIS,14644,10238,4400,2722,7122,2021-06-22
3171071005,JAKARTA PUSAT,TANAH ABANG,KEBON MELATI,27297,22066,5230,2827,8057,2021-06-22
3175081003,JAKARTA TIMUR,MAKASAR,KEBON PALA,40723,30159,10559,6058,16617,2021-06-22
3171061005,JAKARTA PUSAT,MENTENG,KEBON SIRIH,10880,8342,2538,1527,4065,2021-06-22
3173011004,JAKARTA BARAT,CENGKARENG,KEDAUNG KALI ANGKE,28123,18039,10079,3182,13261,2021-06-22
3173051007,JAKARTA BARAT,KEBON JERUK,KEDOYA SELATAN,28300,19916,8370,4535,12905,2021-06-22
3173051006,JAKARTA BARAT,KEBON JERUK,KEDOYA UTARA,38771,24866,13894,6870,20764,2021-06-22
3173051004,JAKARTA BARAT,KEBON JERUK,KELAPA DUA,20509,14706,5799,3074,8873,2021-06-22
3175091003,JAKARTA TIMUR,CIRACAS,KELAPA DUA WETAN,40776,28555,12210,7078,19288,2021-06-22
3172061003,JAKARTA UTARA,KELAPA GADING,KELAPA GADING BARAT,31544,18341,13179,8606,21785,2021-06-22
3172061001,JAKARTA UTARA,KELAPA GADING,KELAPA GADING TIMUR,30470,16666,13792,8987,22779,2021-06-22
3173071005,JAKARTA BARAT,PALMERAH,KEMANGGISAN,28159,19391,8761,5096,13857,2021-06-22
3171031001,JAKARTA PUSAT,KEMAYORAN,KEMAYORAN,18556,12975,5578,2774,8352,2021-06-22
3173081006,JAKARTA BARAT,KEMBANGAN,KEMBANGAN SELATAN,24028,16105,7907,4932,12839,2021-06-22
3173081001,JAKARTA BARAT,KEMBANGAN,KEMBANGAN UTARA,45663,31259,14394,6484,20878,2021-06-22
3171041002,JAKARTA PUSAT,SENEN,KENARI,8328,5143,3184,1713,4897,2021-06-22
3173041005,JAKARTA BARAT,TAMBORA,KERENDANG,17494,13255,4236,2202,6438,2021-06-22
3175071003,JAKARTA TIMUR,DUREN SAWIT,KLENDER,60420,46445,13970,7245,21215,2021-06-22
3172031001,JAKARTA UTARA,KOJA,KOJA,24600,18910,5689,2696,8385,2021-06-22
3173071006,JAKARTA BARAT,PALMERAH,KOTA BAMBU SELATAN,18287,13415,4870,2211,7081,2021-06-22
3173071003,JAKARTA BARAT,PALMERAH,KOTA BAMBU UTARA,21312,15910,5401,2750,8151,2021-06-22
3171041004,JAKARTA PUSAT,SENEN,KRAMAT,25258,19485,5771,2937,8708,2021-06-22
3175041001,JAKARTA TIMUR,KRAMAT JATI,KRAMAT JATI,29922,21353,8561,4873,13434,2021-06-22
3174071003,JAKARTA SELATAN,KEBAYORAN BARU,KRAMAT PELA,12737,8096,4638,2346,6984,2021-06-22
3173031002,JAKARTA BARAT,TAMAN SARI,KRUKUT,17023,12046,4971,2247,7218,2021-06-22
3174031005,JAKARTA SELATAN,MAMPANG PRAPATAN,KUNINGAN BARAT,11229,7732,3494,1528,5022,2021-06-22
3174021008,JAKARTA SELATAN,SETIA BUDI,KUNINGAN TIMUR,5331,3571,1758,1037,2795,2021-06-22
3171041005,JAKARTA PUSAT,SENEN,KWITANG,13487,9329,4156,2054,6210,2021-06-22
3172031003,JAKARTA UTARA,KOJA,LAGOA,51431,40107,11318,5570,16888,2021-06-22
3174061002,JAKARTA SELATAN,CILANDAK,LEBAK BULUS,32738,23506,9224,5753,14977,2021-06-22
3174091004,JAKARTA SELATAN,JAGAKARSA,LENTENG AGUNG,46600,35974,10623,6053,16676,2021-06-22
3175101007,JAKARTA TIMUR,CIPAYUNG,LUBANG BUAYA,55114,41840,13266,8232,21498,2021-06-22
3175081001,JAKARTA TIMUR,MAKASAR,MAKASAR,30013,21514,8492,4876,13368,2021-06-22
3175071006,JAKARTA TIMUR,DUREN SAWIT,MALAKA JAYA,26798,18787,8005,5380,13385,2021-06-22
3175071005,JAKARTA TIMUR,DUREN SAWIT,MALAKA SARI,23691,15688,7996,5330,13326,2021-06-22
3174031001,JAKARTA SELATAN,MAMPANG PRAPATAN,MAMPANG PRAPATAN,15885,12183,3698,2024,5722,2021-06-22
3173031005,JAKARTA BARAT,TAMAN SARI,MANGGA BESAR,6690,4097,2591,1432,4023,2021-06-22
3171021005,JAKARTA PUSAT,SAWAH BESAR,MANGGA DUA SELATAN,24940,17755,7181,3805,10986,2021-06-22
3174011007,JAKARTA SELATAN,TEBET,MANGGARAI,24972,18118,6849,3509,10358,2021-06-22
3174011006,JAKARTA SELATAN,TEBET,MANGGARAI SELATAN,20274,14079,6193,3164,9357,2021-06-22
3173031003,JAKARTA BARAT,TAMAN SARI,MAPHAR,14671,9811,4860,2541,7401,2021-06-22
3172041003,JAKARTA UTARA,CILINCING,MARUNDA,24385,16822,7561,2542,10103,2021-06-22
3174071001,JAKARTA SELATAN,KEBAYORAN BARU,MELAWAI,2386,1292,1093,810,1903,2021-06-22
3171061001,JAKARTA PUSAT,MENTENG,MENTENG,22450,17000,5445,3458,8903,2021-06-22
3174021005,JAKARTA SELATAN,SETIA BUDI,MENTENG ATAS,24369,16593,7771,3953,11724,2021-06-22
3174011003,JAKARTA SELATAN,TEBET,MENTENG DALAM,31623,23031,8583,5073,13656,2021-06-22
3173081003,JAKARTA BARAT,KEMBANGAN,MERUYA SELATAN,27261,19231,8022,4272,12294,2021-06-22
3173081002,JAKARTA BARAT,KEMBANGAN,MERUYA UTARA,38525,27188,11333,6822,18155,2021-06-22
3175101004,JAKARTA TIMUR,CIPAYUNG,MUNJUL,20582,14955,5626,3528,9154,2021-06-22
3172051002,JAKARTA UTARA,PADEMANGAN,PADEMANGAN BARAT,64756,48818,15932,7707,23639,2021-06-22
3172051001,JAKARTA UTARA,PADEMANGAN,PADEMANGAN TIMUR,32689,19871,12802,6815,19617,2021-06-22
3175011004,JAKARTA TIMUR,MATRAMAN,PAL MERIAM,17550,12611,4936,2675,7611,2021-06-22
3173071001,JAKARTA BARAT,PALMERAH,PALMERAH,54706,39728,14970,7877,22847,2021-06-22
3174081001,JAKARTA SELATAN,PANCORAN,PANCORAN,16983,12549,4433,2579,7012,2021-06-22
3172021003,JAKARTA UTARA,TANJUNG PRIOK,PAPANGGO,33902,24763,9122,4613,13735,2021-06-22
3171021001,JAKARTA PUSAT,SAWAH BESAR,PASAR BARU,11656,6712,4939,2875,7814,2021-06-22
3174021006,JAKARTA SELATAN,SETIA BUDI,PASAR MANGGIS,23415,16715,6694,3500,10194,2021-06-22
3174041001,JAKARTA SELATAN,PASAR MINGGU,PASAR MINGGU,21700,14802,6892,4481,11373,2021-06-22
3171041003,JAKARTA PUSAT,SENEN,PASEBAN,20652,14481,6166,3260,9426,2021-06-22
3173061005,JAKARTA BARAT,KALI DERES,PEGADUNGAN,65248,48192,17036,8983,26019,2021-06-22
3171061002,JAKARTA PUSAT,MENTENG,PEGANGSAAN,18427,12922,5503,2892,8395,2021-06-22
3172061002,JAKARTA UTARA,KELAPA GADING,PEGANGSAAN DUA,44451,25960,18474,10321,28795,2021-06-22
3172011004,JAKARTA UTARA,PENJARINGAN,PEJAGALAN,66008,47379,18610,10756,29366,2021-06-22
3174041006,JAKARTA SELATAN,PASAR MINGGU,PEJATEN BARAT,30591,21048,9533,5465,14998,2021-06-22
3174041005,JAKARTA SELATAN,PASAR MINGGU,PEJATEN TIMUR,50150,38371,11773,5926,17699,2021-06-22
3175051005,JAKARTA TIMUR,PASAR REBO,PEKAYON,37440,26647,10788,5948,16736,2021-06-22
3173041009,JAKARTA BARAT,TAMBORA,PEKOJAN,20921,14857,6059,3379,9438,2021-06-22
3174031003,JAKARTA SELATAN,MAMPANG PRAPATAN,PELA MAMPANG,37784,27547,10226,5526,15752,2021-06-22
3174081005,JAKARTA SELATAN,PANCORAN,PENGADEGAN,18685,12592,6088,3257,9345,2021-06-22
3175061003,JAKARTA TIMUR,CAKUNG,PENGGILINGAN,84511,66356,18154,9158,27312,2021-06-22
3172011001,JAKARTA UTARA,PENJARINGAN,PENJARINGAN,75505,56834,18660,7729,26389,2021-06-22
3174101001,JAKARTA SELATAN,PESANGGRAHAN,PESANGGRAHAN,23733,15205,8525,4827,13352,2021-06-22
3171071004,JAKARTA PUSAT,TANAH ABANG,PETAMBURAN,28974,23465,5506,2878,8384,2021-06-22
3174071008,JAKARTA SELATAN,KEBAYORAN BARU,PETOGOGAN,10203,7003,3199,1815,5014,2021-06-22
3171011004,JAKARTA PUSAT,GAMBIR,PETOJO SELATAN,13506,9139,4358,2942,7300,2021-06-22
3171011003,JAKARTA PUSAT,GAMBIR,PETOJO UTARA,16084,11425,4657,2674,7331,2021-06-22
3174101004,JAKARTA SELATAN,PESANGGRAHAN,PETUKANGAN SELATAN,32229,22351,9876,4849,14725,2021-06-22
3174101003,JAKARTA SELATAN,PESANGGRAHAN,PETUKANGAN UTARA,46427,33982,12442,6621,19063,2021-06-22
3175081002,JAKARTA TIMUR,MAKASAR,PINANG RANTI,23465,16947,6515,3382,9897,2021-06-22
3173031008,JAKARTA BARAT,TAMAN SARI,PINANGSIA,9405,6141,3263,1610,4873,2021-06-22
3175011001,JAKARTA TIMUR,MATRAMAN,PISANGAN BARU,27793,21184,6602,3755,10357,2021-06-22
3175021002,JAKARTA TIMUR,PULO GADUNG,PISANGAN TIMUR,35717,25436,10274,5499,15773,2021-06-22
3172011005,JAKARTA UTARA,PENJARINGAN,PLUIT,42979,25998,16951,12179,29130,2021-06-22
3175071002,JAKARTA TIMUR,DUREN SAWIT,PONDOK BAMBU,53658,38092,15554,8692,24246,2021-06-22
3175071004,JAKARTA TIMUR,DUREN SAWIT,PONDOK KELAPA,62704,45875,16814,10768,27582,2021-06-22
3175071007,JAKARTA TIMUR,DUREN SAWIT,PONDOK KOPI,30741,23094,7643,4256,11899,2021-06-22
3174061003,JAKARTA SELATAN,CILANDAK,PONDOK LABU,39778,28490,11277,6733,18010,2021-06-22
3174051002,JAKARTA SELATAN,KEBAYORAN LAMA,PONDOK PINANG,49276,35308,13947,9199,23146,2021-06-22
3175101003,JAKARTA TIMUR,CIPAYUNG,PONDOK RANGGON,21791,16220,5565,3707,9272,2021-06-22
3101011003,KAB.ADM.KEP.SERIBU,KEP. SERIBU UTARA,PULAU HARAPAN,1785,831,954,634,1588,2021-06-22
3101011002,KAB.ADM.KEP.SERIBU,KEP. SERIBU UTARA,PULAU KELAPA,4729,2546,2183,1043,3226,2021-06-22
3101011001,KAB.ADM.KEP.SERIBU,KEP. SERIBU UTARA,PULAU PANGGANG,4667,2197,2470,1088,3558,2021-06-22
3101021003,KAB.ADM.KEP.SERIBU,KEP. SERIBU SELATAN,PULAU PARI,2370,1042,1328,600,1928,2021-06-22
3101021002,KAB.ADM.KEP.SERIBU,KEP. SERIBU SELATAN,PULAU TIDUNG,3922,1970,1951,1072,3023,2021-06-22
3101021001,KAB.ADM.KEP.SERIBU,KEP. SERIBU SELATAN,PULAU UNTUNG JAWA,1665,765,900,553,1453,2021-06-22
3174071007,JAKARTA SELATAN,KEBAYORAN BARU,PULO,5184,3233,1949,1326,3275,2021-06-22
3175021001,JAKARTA TIMUR,PULO GADUNG,PULO GADUNG,30292,22484,7801,4558,12359,2021-06-22
3175061005,JAKARTA TIMUR,CAKUNG,PULO GEBANG,83832,63600,20223,10419,30642,2021-06-22
3174041004,JAKARTA SELATAN,PASAR MINGGU,RAGUNAN,34536,23700,10823,5701,16524,2021-06-22
3175091005,JAKARTA TIMUR,CIRACAS,RAMBUTAN,31759,24755,7000,4198,11198,2021-06-22
3172031006,JAKARTA UTARA,KOJA,RAWA BADAK SELATAN,36403,28810,7590,3862,11452,2021-06-22
3172031004,JAKARTA UTARA,KOJA,RAWA BADAK UTARA,29198,21164,8032,3766,11798,2021-06-22
3174071005,JAKARTA SELATAN,KEBAYORAN BARU,RAWA BARAT,5029,3151,1878,1306,3184,2021-06-22
3173011003,JAKARTA BARAT,CENGKARENG,RAWA BUAYA,51752,36036,15708,5910,21618,2021-06-22
3175031004,JAKARTA TIMUR,JATINEGARA,RAWA BUNGA,18617,14221,4395,2444,6839,2021-06-22
3174081003,JAKARTA SELATAN,PANCORAN,RAWA JATI,18210,12379,5826,3352,9178,2021-06-22
3175061002,JAKARTA TIMUR,CAKUNG,RAWA TERATE,21332,14073,7257,2029,9286,2021-06-22
3175021005,JAKARTA TIMUR,PULO GADUNG,RAWAMANGUN,32470,22784,9679,5770,15449,2021-06-22
3171051003,JAKARTA PUSAT,CEMPAKA PUTIH,RAWASARI,19312,13580,5726,3427,9153,2021-06-22
3173041010,JAKARTA BARAT,TAMBORA,ROA MALAKA,3149,1826,1320,868,2188,2021-06-22
3172041006,JAKARTA UTARA,CILINCING,ROROTAN,35258,25692,9563,4491,14054,2021-06-22
3174071004,JAKARTA SELATAN,KEBAYORAN BARU,SELONG,2576,1428,1145,867,2012,2021-06-22
3173061002,JAKARTA BARAT,KALI DERES,SEMANAN,60715,47724,12986,4915,17901,2021-06-22
3172041007,JAKARTA UTARA,CILINCING,SEMPER BARAT,59323,42246,17064,8945,26009,2021-06-22
3172041005,JAKARTA UTARA,CILINCING,SEMPER TIMUR,31249,23223,8023,4247,12270,2021-06-22
3174071006,JAKARTA SELATAN,KEBAYORAN BARU,SENAYAN,2482,1692,787,561,1348,2021-06-22
3171041001,JAKARTA PUSAT,SENEN,SENEN,5951,3859,2092,1151,3243,2021-06-22
3171031004,JAKARTA PUSAT,KEMAYORAN,SERDANG,26045,18641,7401,3876,11277,2021-06-22
3174021001,JAKARTA SELATAN,SETIA BUDI,SETIA BUDI,2532,1574,957,633,1590,2021-06-22
3175101005,JAKARTA TIMUR,CIPAYUNG,SETU,17609,13412,4195,2637,6832,2021-06-22
3173071002,JAKARTA BARAT,PALMERAH,SLIPI,14526,9815,4708,2687,7395,2021-06-22
3173081004,JAKARTA BARAT,KEMBANGAN,SRENGSENG,39370,29371,9986,6086,16072,2021-06-22
3174091002,JAKARTA SELATAN,JAGAKARSA,SRENGSENG SAWAH,50305,32770,17522,8795,26317,2021-06-22
3173051003,JAKARTA BARAT,KEBON JERUK,SUKABUMI SELATAN,30581,23658,6922,3428,10350,2021-06-22
3173051002,JAKARTA BARAT,KEBON JERUK,SUKABUMI UTARA,33050,25908,7139,3953,11092,2021-06-22
3172041002,JAKARTA UTARA,CILINCING,SUKAPURA,46955,34805,12143,5358,17501,2021-06-22
3171031007,JAKARTA PUSAT,KEMAYORAN,SUMUR BATU,19863,14149,5710,3327,9037,2021-06-22
3172021004,JAKARTA UTARA,TANJUNG PRIOK,SUNGAI BAMBU,25366,18342,7020,3460,10480,2021-06-22
3172021006,JAKARTA UTARA,TANJUNG PRIOK,SUNTER AGUNG,62904,39700,23179,13338,36517,2021-06-22
3172021002,JAKARTA UTARA,TANJUNG PRIOK,SUNTER JAYA,55168,37513,17636,10290,27926,2021-06-22
3175091004,JAKARTA TIMUR,CIRACAS,SUSUKAN,28884,20852,8030,4515,12545,2021-06-22
3173031001,JAKARTA BARAT,TAMAN SARI,TAMAN SARI,12915,8929,3984,2373,6357,2021-06-22
3173041001,JAKARTA BARAT,TAMBORA,TAMBORA,9087,6609,2478,1506,3984,2021-06-22
3173041004,JAKARTA BARAT,TAMBORA,TANAH SEREAL,23141,15584,7555,3831,11386,2021-06-22
3171081004,JAKARTA PUSAT,JOHAR BARU,TANAH TINGGI,32931,23044,9885,4196,14081,2021-06-22
3173031004,JAKARTA BARAT,TAMAN SARI,TANGKI,11593,7902,3688,1907,5595,2021-06-22
3174091005,JAKARTA SELATAN,JAGAKARSA,TANJUNG BARAT,34530,25632,8892,5560,14452,2021-06-22
3173021005,JAKARTA BARAT,GROGOL PETAMBURAN,TANJUNG DUREN SELATAN,22469,13961,8495,4387,12882,2021-06-22
3173021002,JAKARTA BARAT,GROGOL PETAMBURAN,TANJUNG DUREN UTARA,15224,9393,5825,3472,9297,2021-06-22
3172021001,JAKARTA UTARA,TANJUNG PRIOK,TANJUNG PRIOK,29913,19938,9966,3799,13765,2021-06-22
3174011002,JAKARTA SELATAN,TEBET,TEBET BARAT,18916,12405,6503,4103,10606,2021-06-22
3174011001,JAKARTA SELATAN,TEBET,TEBET TIMUR,16031,9937,6088,3660,9748,2021-06-22
3173061003,JAKARTA BARAT,KALI DERES,TEGAL ALUR,71923,56322,15594,6736,22330,2021-06-22
3174031004,JAKARTA SELATAN,MAMPANG PRAPATAN,TEGAL PARANG,28143,22423,5718,3256,8974,2021-06-22
3173021003,JAKARTA BARAT,GROGOL PETAMBURAN,TOMANG,25531,16558,8962,4906,13868,2021-06-22
3172031005,JAKARTA UTARA,KOJA,TUGU SELATAN,33663,25993,7666,3748,11414,2021-06-22
3172031002,JAKARTA UTARA,KOJA,TUGU UTARA,58638,46277,12358,6641,18999,2021-06-22
3175061006,JAKARTA TIMUR,CAKUNG,UJUNG MENTENG,25702,18136,7556,3902,11458,2021-06-22
3174101005,JAKARTA SELATAN,PESANGGRAHAN,ULUJAMI,35077,26282,8793,4860,13653,2021-06-22
3175011006,JAKARTA TIMUR,MATRAMAN,UTAN KAYU SELATAN,29303,20521,8771,4957,13728,2021-06-22
3175011002,JAKARTA TIMUR,MATRAMAN,UTAN KAYU UTARA,24728,17579,7148,3734,10882,2021-06-22
3171031008,JAKARTA PUSAT,KEMAYORAN,UTAN PANJANG,25622,19833,5788,2760,8548,2021-06-22
3172021007,JAKARTA UTARA,TANJUNG PRIOK,WARAKAS,38194,28220,9961,5130,15091,2021-06-22
3173021007,JAKARTA BARAT,GROGOL PETAMBURAN,WIJAYA KUSUMA,34170,24229,9932,4791,14723,2021-06-22
3172051003,JAKARTA UTARA,PADEMANGAN,ANCOL,20393,14204,6182,3262,9444,2021-06-23
3173041007,JAKARTA BARAT,TAMBORA,ANGKE,25785,18501,7275,3188,10463,2021-06-23
3175041005,JAKARTA TIMUR,KRAMAT JATI,BALE KAMBANG,25158,20353,4797,2593,7390,2021-06-23
3175031003,JAKARTA TIMUR,JATINEGARA,BALI MESTER,8683,6264,2416,1501,3917,2021-06-23
3175101006,JAKARTA TIMUR,CIPAYUNG,BAMBU APUS,22768,16801,5963,3938,9901,2021-06-23
3174031002,JAKARTA SELATAN,MAMPANG PRAPATAN,BANGKA,18930,13656,5268,2669,7937,2021-06-23
3175051002,JAKARTA TIMUR,PASAR REBO,BARU,20267,12648,7603,4640,12243,2021-06-23
3175041004,JAKARTA TIMUR,KRAMAT JATI,BATU AMPAR,41389,32537,8843,5155,13998,2021-06-23
3171071002,JAKARTA PUSAT,TANAH ABANG,BENDUNGAN HILIR,19008,12682,6319,3530,9849,2021-06-23
3175031002,JAKARTA TIMUR,JATINEGARA,BIDARA CINA,32331,24952,7375,3988,11363,2021-06-23
3174101002,JAKARTA SELATAN,PESANGGRAHAN,BINTARO,45843,33725,12108,7010,19118,2021-06-23
3174011005,JAKARTA SELATAN,TEBET,BUKIT DURI,29934,22341,7591,3907,11498,2021-06-23
3171041006,JAKARTA PUSAT,SENEN,BUNGUR,15932,10960,4958,2708,7666,2021-06-23
3175061007,JAKARTA TIMUR,CAKUNG,CAKUNG BARAT,49369,36869,12498,3963,16461,2021-06-23
3175061004,JAKARTA TIMUR,CAKUNG,CAKUNG TIMUR,50344,37005,13329,6314,19643,2021-06-23
3175041007,JAKARTA TIMUR,KRAMAT JATI,CAWANG,28708,21626,7077,4224,11301,2021-06-23
3175101008,JAKARTA TIMUR,CIPAYUNG,CEGER,16381,11733,4647,2539,7186,2021-06-23
3171031006,JAKARTA PUSAT,KEMAYORAN,CEMPAKA BARU,27330,19945,7375,3963,11338,2021-06-23
3171051002,JAKARTA PUSAT,CEMPAKA PUTIH,CEMPAKA PUTIH BARAT,30479,22315,8155,4919,13074,2021-06-23
3171051001,JAKARTA PUSAT,CEMPAKA PUTIH,CEMPAKA PUTIH TIMUR,21553,14556,6994,4387,11381,2021-06-23
3173011001,JAKARTA BARAT,CENGKARENG,CENGKARENG BARAT,57678,38368,19300,8164,27464,2021-06-23
3173011006,JAKARTA BARAT,CENGKARENG,CENGKARENG TIMUR,70122,51492,18621,8446,27067,2021-06-23
3175091002,JAKARTA TIMUR,CIRACAS,CIBUBUR,56927,41385,15531,9343,24874,2021-06-23
3171011002,JAKARTA PUSAT,GAMBIR,CIDENG,14203,9027,5168,3149,8317,2021-06-23
3174091003,JAKARTA SELATAN,JAGAKARSA,CIGANJUR,33127,24125,8991,5114,14105,2021-06-23
3175051003,JAKARTA TIMUR,PASAR REBO,CIJANTUNG,36027,25841,10176,6099,16275,2021-06-23
3171061003,JAKARTA PUSAT,MENTENG,CIKINI,7402,5245,2156,1361,3517,2021-06-23
3174081006,JAKARTA SELATAN,PANCORAN,CIKOKO,9280,6370,2910,1717,4627,2021-06-23
3174061001,JAKARTA SELATAN,CILANDAK,CILANDAK BARAT,45348,30515,14818,7785,22603,2021-06-23
3174041003,JAKARTA SELATAN,PASAR MINGGU,CILANDAK TIMUR,21207,14101,7097,4742,11839,2021-06-23
3175101002,JAKARTA TIMUR,CIPAYUNG,CILANGKAP,23675,17159,6509,3765,10274,2021-06-23
3175041006,JAKARTA TIMUR,KRAMAT JATI,CILILITAN,35164,26230,8925,5167,14092,2021-06-23
3172041001,JAKARTA UTARA,CILINCING,CILINCING,37003,29064,7932,3867,11799,2021-06-23
3175101001,JAKARTA TIMUR,CIPAYUNG,CIPAYUNG,22697,15714,6975,4167,11142,2021-06-23
3174091006,JAKARTA SELATAN,JAGAKARSA,CIPEDAK,32800,23693,9100,4737,13837,2021-06-23
3174061005,JAKARTA SELATAN,CILANDAK,CIPETE SELATAN,23463,16627,6833,3753,10586,2021-06-23
3174071010,JAKARTA SELATAN,KEBAYORAN BARU,CIPETE UTARA,29771,19894,9873,4046,13919,2021-06-23
3175021003,JAKARTA TIMUR,PULO GADUNG,CIPINANG,34608,24557,10043,5912,15955,2021-06-23
3175031007,JAKARTA TIMUR,JATINEGARA,CIPINANG BESAR SELATAN,30655,23841,6806,3832,10638,2021-06-23
3175031008,JAKARTA TIMUR,JATINEGARA,CIPINANG BESAR UTARA,38827,31513,7308,4137,11445,2021-06-23
3175031005,JAKARTA TIMUR,JATINEGARA,CIPINANG CEMPEDAK,29154,21330,7816,4642,12458,2021-06-23
3175081005,JAKARTA TIMUR,MAKASAR,CIPINANG MELAYU,37098,26385,10706,6319,17025,2021-06-23
3175031006,JAKARTA TIMUR,JATINEGARA,CIPINANG MUARA,46861,35466,11389,7205,18594,2021-06-23
3174051003,JAKARTA SELATAN,KEBAYORAN LAMA,CIPULIR,34708,26088,8615,4736,13351,2021-06-23
3175091001,JAKARTA TIMUR,CIRACAS,CIRACAS,55965,40107,15851,8293,24144,2021-06-23
3175041003,JAKARTA TIMUR,KRAMAT JATI,DUKUH,21239,15783,5452,3461,8913,2021-06-23
3175071001,JAKARTA TIMUR,DUREN SAWIT,DUREN SAWIT,53078,38599,14465,9106,23571,2021-06-23
3174081004,JAKARTA SELATAN,PANCORAN,DUREN TIGA,24673,18001,6667,3771,10438,2021-06-23
3173051005,JAKARTA BARAT,KEBON JERUK,DURI KEPA,52942,35230,17695,9840,27535,2021-06-23
3173011002,JAKARTA BARAT,CENGKARENG,DURI KOSAMBI,66093,47781,18303,8102,26405,2021-06-23
3171011006,JAKARTA PUSAT,GAMBIR,DURI PULO,17787,13174,4610,2361,6971,2021-06-23
3173041011,JAKARTA BARAT,TAMBORA,DURI SELATAN,12528,8470,4051,2348,6399,2021-06-23
3173041003,JAKARTA BARAT,TAMBORA,DURI UTARA,17380,12492,4885,2620,7505,2021-06-23
3171081003,JAKARTA PUSAT,JOHAR BARU,GALUR,15811,10505,5306,1948,7254,2021-06-23
3171011001,JAKARTA PUSAT,GAMBIR,GAMBIR,2232,1342,889,572,1461,2021-06-23
3174061004,JAKARTA SELATAN,CILANDAK,GANDARIA SELATAN,19394,13435,5951,2806,8757,2021-06-23
3174071009,JAKARTA SELATAN,KEBAYORAN BARU,GANDARIA UTARA,35026,24517,10505,5294,15799,2021-06-23
3175051001,JAKARTA TIMUR,PASAR REBO,GEDONG,31013,22488,8512,5215,13727,2021-06-23
3171071001,JAKARTA PUSAT,TANAH ABANG,GELORA,2753,1894,852,560,1412,2021-06-23
3173031007,JAKARTA BARAT,TAMAN SARI,GLODOK,7192,4083,3107,1964,5071,2021-06-23
3171061004,JAKARTA PUSAT,MENTENG,GONDANGDIA,3760,2031,1724,1268,2992,2021-06-23
3173021001,JAKARTA BARAT,GROGOL PETAMBURAN,GROGOL,15067,10546,4515,2578,7093,2021-06-23
3174051005,JAKARTA SELATAN,KEBAYORAN LAMA,GROGOL SELATAN,38688,28382,10299,5408,15707,2021-06-23
3174051004,JAKARTA SELATAN,KEBAYORAN LAMA,GROGOL UTARA,37234,27684,9533,5756,15289,2021-06-23
3174021007,JAKARTA SELATAN,SETIA BUDI,GUNTUR,3590,2135,1452,969,2421,2021-06-23
3174071002,JAKARTA SELATAN,KEBAYORAN BARU,GUNUNG,8309,5349,2959,2011,4970,2021-06-23
3171031005,JAKARTA PUSAT,KEMAYORAN,GUNUNG SAHARI SELATAN,17256,12175,5075,2778,7853,2021-06-23
3171021004,JAKARTA PUSAT,SAWAH BESAR,GUNUNG SAHARI UTARA,13937,7993,5938,3337,9275,2021-06-23
3175081004,JAKARTA TIMUR,MAKASAR,HALIM PERDANA KUSUMAH,24426,12709,11699,8325,20024,2021-06-23
3171031003,JAKARTA PUSAT,KEMAYORAN,HARAPAN MULIA,19987,14701,5282,2657,7939,2021-06-23
3174091001,JAKARTA SELATAN,JAGAKARSA,JAGAKARSA,53714,37770,15930,8391,24321,2021-06-23
3175021007,JAKARTA TIMUR,PULO GADUNG,JATI,28870,19948,8907,5514,14421,2021-06-23
3174041002,JAKARTA SELATAN,PASAR MINGGU,JATI PADANG,32857,23057,9791,5791,15582,2021-06-23
3173071004,JAKARTA BARAT,PALMERAH,JATI PULO,24508,15586,8919,3602,12521,2021-06-23
3175061001,JAKARTA TIMUR,CAKUNG,JATINEGARA,72652,58325,14327,6507,20834,2021-06-23
3175021004,JAKARTA TIMUR,PULO GADUNG,JATINEGARA KAUM,21313,16025,5285,2875,8160,2021-06-23
3173021004,JAKARTA BARAT,GROGOL PETAMBURAN,JELAMBAR,26984,17988,8986,5401,14387,2021-06-23
3173021006,JAKARTA BARAT,GROGOL PETAMBURAN,JELAMBAR BARU,33734,23521,10204,6002,16206,2021-06-23
3173041006,JAKARTA BARAT,TAMBORA,JEMBATAN BESI,25735,20802,4932,2402,7334,2021-06-23
3173041008,JAKARTA BARAT,TAMBORA,JEMBATAN LIMA,18241,14156,4079,2239,6318,2021-06-23
3173081005,JAKARTA BARAT,KEMBANGAN,JOGLO,35285,25126,10154,5873,16027,2021-06-23
3171081001,JAKARTA PUSAT,JOHAR BARU,JOHAR BARU,28311,17147,11158,5276,16434,2021-06-23
3173041002,JAKARTA BARAT,TAMBORA,KALI ANYAR,20624,16116,4506,2215,6721,2021-06-23
3172041004,JAKARTA UTARA,CILINCING,KALIBARU,57771,47503,10265,4264,14529,2021-06-23
3174081002,JAKARTA SELATAN,PANCORAN,KALIBATA,36451,27361,9089,4869,13958,2021-06-23
3173061001,JAKARTA BARAT,KALI DERES,KALIDERES,60209,44287,15905,7488,23393,2021-06-23
3175051004,JAKARTA TIMUR,PASAR REBO,KALISARI,37255,26126,11117,6670,17787,2021-06-23
3173061004,JAKARTA BARAT,KALI DERES,KAMAL,46035,36731,9302,3624,12926,2021-06-23
3172011002,JAKARTA UTARA,PENJARINGAN,KAMAL MUARA,11039,6893,4136,2484,6620,2021-06-23
3171071007,JAKARTA PUSAT,TANAH ABANG,KAMPUNG BALI,10113,7637,2476,1495,3971,2021-06-23
3175031001,JAKARTA TIMUR,JATINEGARA,KAMPUNG MELAYU,22293,17763,4527,2210,6737,2021-06-23
3171081002,JAKARTA PUSAT,JOHAR BARU,KAMPUNG RAWA,15550,8646,6901,2522,9423,2021-06-23
3175041002,JAKARTA TIMUR,KRAMAT JATI,KAMPUNG TENGAH,38048,29169,8870,5173,14043,2021-06-23
3173011005,JAKARTA BARAT,CENGKARENG,KAPUK,104630,79986,24636,9403,34039,2021-06-23
3172011003,JAKARTA UTARA,PENJARINGAN,KAPUK MUARA,31275,20880,10376,6580,16956,2021-06-23
3171021002,JAKARTA PUSAT,SAWAH BESAR,KARANG ANYAR,23056,16361,6684,3375,10059,2021-06-23
3174021004,JAKARTA SELATAN,SETIA BUDI,KARET,8542,5649,2891,1416,4307,2021-06-23
3174021003,JAKARTA SELATAN,SETIA BUDI,KARET KUNINGAN,14166,9369,4793,2289,7082,2021-06-23
3174021002,JAKARTA SELATAN,SETIA BUDI,KARET SEMANGGI,2469,1414,1052,590,1642,2021-06-23
3171071003,JAKARTA PUSAT,TANAH ABANG,KARET TENGSIN,16695,12316,4377,2172,6549,2021-06-23
3171021003,JAKARTA PUSAT,SAWAH BESAR,KARTINI,19916,13542,6370,3423,9793,2021-06-23
3175011003,JAKARTA TIMUR,MATRAMAN,KAYU MANIS,22174,16520,5652,2965,8617,2021-06-23
3175021006,JAKARTA TIMUR,PULO GADUNG,KAYU PUTIH,35916,24611,11290,6935,18225,2021-06-23
3173031006,JAKARTA BARAT,TAMAN SARI,KEAGUNGAN,15262,11099,4161,1975,6136,2021-06-23
3174041007,JAKARTA SELATAN,PASAR MINGGU,KEBAGUSAN,38396,28471,9916,5100,15016,2021-06-23
3174051006,JAKARTA SELATAN,KEBAYORAN LAMA,KEBAYORAN LAMA SELATAN,35920,24262,11649,5716,17365,2021-06-23
3174051001,JAKARTA SELATAN,KEBAYORAN LAMA,KEBAYORAN LAMA UTARA,37004,27040,9955,5175,15130,2021-06-23
3174011004,JAKARTA SELATAN,TEBET,KEBON BARU,30533,21264,9263,5054,14317,2021-06-23
3172021005,JAKARTA UTARA,TANJUNG PRIOK,KEBON BAWANG,44427,31971,12439,6830,19269,2021-06-23
3173051001,JAKARTA BARAT,KEBON JERUK,KEBON JERUK,46870,35386,11473,6708,18181,2021-06-23
3171071006,JAKARTA PUSAT,TANAH ABANG,KEBON KACANG,19075,14802,4271,2593,6864,2021-06-23
3171011005,JAKARTA PUSAT,GAMBIR,KEBON KELAPA,9383,6748,2634,1646,4280,2021-06-23
3171031002,JAKARTA PUSAT,KEMAYORAN,KEBON KOSONG,26178,18971,7203,3426,10629,2021-06-23
3175011005,JAKARTA TIMUR,MATRAMAN,KEBON MANGGIS,14644,10171,4467,2722,7189,2021-06-23
3171071005,JAKARTA PUSAT,TANAH ABANG,KEBON MELATI,27297,22001,5295,2830,8125,2021-06-23
3175081003,JAKARTA TIMUR,MAKASAR,KEBON PALA,40723,30048,10670,6065,16735,2021-06-23
3171061005,JAKARTA PUSAT,MENTENG,KEBON SIRIH,10880,8316,2564,1528,4092,2021-06-23
3173011004,JAKARTA BARAT,CENGKARENG,KEDAUNG KALI ANGKE,28123,17980,10138,3187,13325,2021-06-23
3173051007,JAKARTA BARAT,KEBON JERUK,KEDOYA SELATAN,28300,19802,8484,4540,13024,2021-06-23
3173051006,JAKARTA BARAT,KEBON JERUK,KEDOYA UTARA,38771,24763,13997,6880,20877,2021-06-23
3173051004,JAKARTA BARAT,KEBON JERUK,KELAPA DUA,20509,14619,5886,3081,8967,2021-06-23
3175091003,JAKARTA TIMUR,CIRACAS,KELAPA DUA WETAN,40776,28431,12333,7094,19427,2021-06-23
3172061003,JAKARTA UTARA,KELAPA GADING,KELAPA GADING BARAT,31544,18248,13272,8621,21893,2021-06-23
3172061001,JAKARTA UTARA,KELAPA GADING,KELAPA GADING TIMUR,30470,16549,13909,9007,22916,2021-06-23
3173071005,JAKARTA BARAT,PALMERAH,KEMANGGISAN,28159,19303,8849,5106,13955,2021-06-23
3171031001,JAKARTA PUSAT,KEMAYORAN,KEMAYORAN,18556,12871,5682,2779,8461,2021-06-23
3173081006,JAKARTA BARAT,KEMBANGAN,KEMBANGAN SELATAN,24028,16044,7967,4939,12906,2021-06-23
3173081001,JAKARTA BARAT,KEMBANGAN,KEMBANGAN UTARA,45663,31143,14510,6491,21001,2021-06-23
3171041002,JAKARTA PUSAT,SENEN,KENARI,8328,5116,3211,1713,4924,2021-06-23
3173041005,JAKARTA BARAT,TAMBORA,KERENDANG,17494,13216,4275,2204,6479,2021-06-23
3175071003,JAKARTA TIMUR,DUREN SAWIT,KLENDER,60420,46302,14113,7255,21368,2021-06-23
3172031001,JAKARTA UTARA,KOJA,KOJA,24600,18863,5736,2697,8433,2021-06-23
3173071006,JAKARTA BARAT,PALMERAH,KOTA BAMBU SELATAN,18287,13361,4924,2213,7137,2021-06-23
3173071003,JAKARTA BARAT,PALMERAH,KOTA BAMBU UTARA,21312,15840,5471,2752,8223,2021-06-23
3171041004,JAKARTA PUSAT,SENEN,KRAMAT,25258,19337,5919,2939,8858,2021-06-23
3175041001,JAKARTA TIMUR,KRAMAT JATI,KRAMAT JATI,29922,21303,8611,4885,13496,2021-06-23
3174071003,JAKARTA SELATAN,KEBAYORAN BARU,KRAMAT PELA,12737,8026,4708,2347,7055,2021-06-23
3173031002,JAKARTA BARAT,TAMAN SARI,KRUKUT,17023,11988,5029,2250,7279,2021-06-23
3174031005,JAKARTA SELATAN,MAMPANG PRAPATAN,KUNINGAN BARAT,11229,7652,3574,1530,5104,2021-06-23
3174021008,JAKARTA SELATAN,SETIA BUDI,KUNINGAN TIMUR,5331,3547,1782,1039,2821,2021-06-23
3171041005,JAKARTA PUSAT,SENEN,KWITANG,13487,9237,4248,2056,6304,2021-06-23
3172031003,JAKARTA UTARA,KOJA,LAGOA,51431,39966,11459,5577,17036,2021-06-23
3174061002,JAKARTA SELATAN,CILANDAK,LEBAK BULUS,32738,23197,9533,5761,15294,2021-06-23
3174091004,JAKARTA SELATAN,JAGAKARSA,LENTENG AGUNG,46600,35739,10858,6061,16919,2021-06-23
3175101007,JAKARTA TIMUR,CIPAYUNG,LUBANG BUAYA,55114,41602,13504,8239,21743,2021-06-23
3175081001,JAKARTA TIMUR,MAKASAR,MAKASAR,30013,21408,8598,4891,13489,2021-06-23
3175071006,JAKARTA TIMUR,DUREN SAWIT,MALAKA JAYA,26798,18716,8075,5386,13461,2021-06-23
3175071005,JAKARTA TIMUR,DUREN SAWIT,MALAKA SARI,23691,15592,8092,5335,13427,2021-06-23
3174031001,JAKARTA SELATAN,MAMPANG PRAPATAN,MAMPANG PRAPATAN,15885,12061,3819,2029,5848,2021-06-23
3173031005,JAKARTA BARAT,TAMAN SARI,MANGGA BESAR,6690,4072,2616,1433,4049,2021-06-23
3171021005,JAKARTA PUSAT,SAWAH BESAR,MANGGA DUA SELATAN,24940,17649,7287,3807,11094,2021-06-23
3174011007,JAKARTA SELATAN,TEBET,MANGGARAI,24972,17957,7010,3513,10523,2021-06-23
3174011006,JAKARTA SELATAN,TEBET,MANGGARAI SELATAN,20274,13919,6353,3167,9520,2021-06-23
3173031003,JAKARTA BARAT,TAMAN SARI,MAPHAR,14671,9769,4902,2544,7446,2021-06-23
3172041003,JAKARTA UTARA,CILINCING,MARUNDA,24385,16791,7592,2546,10138,2021-06-23
3174071001,JAKARTA SELATAN,KEBAYORAN BARU,MELAWAI,2386,1281,1104,810,1914,2021-06-23
3171061001,JAKARTA PUSAT,MENTENG,MENTENG,22450,16920,5525,3466,8991,2021-06-23
3174021005,JAKARTA SELATAN,SETIA BUDI,MENTENG ATAS,24369,16450,7914,3956,11870,2021-06-23
3174011003,JAKARTA SELATAN,TEBET,MENTENG DALAM,31623,22785,8828,5080,13908,2021-06-23
3173081003,JAKARTA BARAT,KEMBANGAN,MERUYA SELATAN,27261,19156,8097,4279,12376,2021-06-23
3173081002,JAKARTA BARAT,KEMBANGAN,MERUYA UTARA,38525,27038,11483,6833,18316,2021-06-23
3175101004,JAKARTA TIMUR,CIPAYUNG,MUNJUL,20582,14912,5669,3533,9202,2021-06-23
3172051002,JAKARTA UTARA,PADEMANGAN,PADEMANGAN BARAT,64756,48613,16137,7713,23850,2021-06-23
3172051001,JAKARTA UTARA,PADEMANGAN,PADEMANGAN TIMUR,32689,19797,12876,6822,19698,2021-06-23
3175011004,JAKARTA TIMUR,MATRAMAN,PAL MERIAM,17550,12497,5049,2684,7733,2021-06-23
3173071001,JAKARTA BARAT,PALMERAH,PALMERAH,54706,39504,15194,7890,23084,2021-06-23
3174081001,JAKARTA SELATAN,PANCORAN,PANCORAN,16983,12400,4582,2584,7166,2021-06-23
3172021003,JAKARTA UTARA,TANJUNG PRIOK,PAPANGGO,33902,24679,9206,4615,13821,2021-06-23
3171021001,JAKARTA PUSAT,SAWAH BESAR,PASAR BARU,11656,6665,4986,2881,7867,2021-06-23
3174021006,JAKARTA SELATAN,SETIA BUDI,PASAR MANGGIS,23415,16512,6897,3504,10401,2021-06-23
3174041001,JAKARTA SELATAN,PASAR MINGGU,PASAR MINGGU,21700,14711,6983,4487,11470,2021-06-23
3171041003,JAKARTA PUSAT,SENEN,PASEBAN,20652,14349,6298,3267,9565,2021-06-23
3173061005,JAKARTA BARAT,KALI DERES,PEGADUNGAN,65248,47736,17492,8991,26483,2021-06-23
3171061002,JAKARTA PUSAT,MENTENG,PEGANGSAAN,18427,12881,5544,2897,8441,2021-06-23
3172061002,JAKARTA UTARA,KELAPA GADING,PEGANGSAAN DUA,44451,25782,18652,10336,28988,2021-06-23
3172011004,JAKARTA UTARA,PENJARINGAN,PEJAGALAN,66008,47147,18842,10776,29618,2021-06-23
3174041006,JAKARTA SELATAN,PASAR MINGGU,PEJATEN BARAT,30591,20802,9779,5478,15257,2021-06-23
3174041005,JAKARTA SELATAN,PASAR MINGGU,PEJATEN TIMUR,50150,38012,12132,5937,18069,2021-06-23
3175051005,JAKARTA TIMUR,PASAR REBO,PEKAYON,37440,26524,10911,5957,16868,2021-06-23
3173041009,JAKARTA BARAT,TAMBORA,PEKOJAN,20921,14778,6138,3379,9517,2021-06-23
3174031003,JAKARTA SELATAN,MAMPANG PRAPATAN,PELA MAMPANG,37784,27205,10568,5534,16102,2021-06-23
3174081005,JAKARTA SELATAN,PANCORAN,PENGADEGAN,18685,12357,6323,3261,9584,2021-06-23
3175061003,JAKARTA TIMUR,CAKUNG,PENGGILINGAN,84511,66206,18304,9167,27471,2021-06-23
3172011001,JAKARTA UTARA,PENJARINGAN,PENJARINGAN,75505,56565,18929,7733,26662,2021-06-23
3174101001,JAKARTA SELATAN,PESANGGRAHAN,PESANGGRAHAN,23733,15093,8637,4832,13469,2021-06-23
3171071004,JAKARTA PUSAT,TANAH ABANG,PETAMBURAN,28974,23353,5617,2884,8501,2021-06-23
3174071008,JAKARTA SELATAN,KEBAYORAN BARU,PETOGOGAN,10203,6886,3316,1817,5133,2021-06-23
3171011004,JAKARTA PUSAT,GAMBIR,PETOJO SELATAN,13506,9039,4458,2954,7412,2021-06-23
3171011003,JAKARTA PUSAT,GAMBIR,PETOJO UTARA,16084,11376,4706,2677,7383,2021-06-23
3174101004,JAKARTA SELATAN,PESANGGRAHAN,PETUKANGAN SELATAN,32229,22173,10054,4854,14908,2021-06-23
3174101003,JAKARTA SELATAN,PESANGGRAHAN,PETUKANGAN UTARA,46427,33772,12652,6636,19288,2021-06-23
3175081002,JAKARTA TIMUR,MAKASAR,PINANG RANTI,23465,16851,6611,3384,9995,2021-06-23
3173031008,JAKARTA BARAT,TAMAN SARI,PINANGSIA,9405,6097,3307,1611,4918,2021-06-23
3175011001,JAKARTA TIMUR,MATRAMAN,PISANGAN BARU,27793,21049,6737,3758,10495,2021-06-23
3175021002,JAKARTA TIMUR,PULO GADUNG,PISANGAN TIMUR,35717,25328,10382,5505,15887,2021-06-23
3172011005,JAKARTA UTARA,PENJARINGAN,PLUIT,42979,25895,17054,12199,29253,2021-06-23
3175071002,JAKARTA TIMUR,DUREN SAWIT,PONDOK BAMBU,53658,37857,15789,8707,24496,2021-06-23
3175071004,JAKARTA TIMUR,DUREN SAWIT,PONDOK KELAPA,62704,45638,17051,10784,27835,2021-06-23
3175071007,JAKARTA TIMUR,DUREN SAWIT,PONDOK KOPI,30741,23013,7724,4263,11987,2021-06-23
3174061003,JAKARTA SELATAN,CILANDAK,PONDOK LABU,39778,28237,11530,6741,18271,2021-06-23
3174051002,JAKARTA SELATAN,KEBAYORAN LAMA,PONDOK PINANG,49276,34935,14320,9223,23543,2021-06-23
3175101003,JAKARTA TIMUR,CIPAYUNG,PONDOK RANGGON,21791,16165,5619,3716,9335,2021-06-23
3101011003,KAB.ADM.KEP.SERIBU,KEP. SERIBU UTARA,PULAU HARAPAN,1785,742,1043,651,1694,2021-06-23
3101011002,KAB.ADM.KEP.SERIBU,KEP. SERIBU UTARA,PULAU KELAPA,4729,2143,2586,1059,3645,2021-06-23
3101011001,KAB.ADM.KEP.SERIBU,KEP. SERIBU UTARA,PULAU PANGGANG,4667,2111,2556,1098,3654,2021-06-23
3101021003,KAB.ADM.KEP.SERIBU,KEP. SERIBU SELATAN,PULAU PARI,2370,926,1444,602,2046,2021-06-23
3101021002,KAB.ADM.KEP.SERIBU,KEP. SERIBU SELATAN,PULAU TIDUNG,3922,1762,2159,1104,3263,2021-06-23
3101021001,KAB.ADM.KEP.SERIBU,KEP. SERIBU SELATAN,PULAU UNTUNG JAWA,1665,764,901,553,1454,2021-06-23
3174071007,JAKARTA SELATAN,KEBAYORAN BARU,PULO,5184,3193,1989,1327,3316,2021-06-23
3175021001,JAKARTA TIMUR,PULO GADUNG,PULO GADUNG,30292,22378,7907,4568,12475,2021-06-23
3175061005,JAKARTA TIMUR,CAKUNG,PULO GEBANG,83832,63383,20440,10432,30872,2021-06-23
3174041004,JAKARTA SELATAN,PASAR MINGGU,RAGUNAN,34536,23386,11137,5708,16845,2021-06-23
3175091005,JAKARTA TIMUR,CIRACAS,RAMBUTAN,31759,24689,7066,4206,11272,2021-06-23
3172031006,JAKARTA UTARA,KOJA,RAWA BADAK SELATAN,36403,28623,7777,3866,11643,2021-06-23
3172031004,JAKARTA UTARA,KOJA,RAWA BADAK UTARA,29198,21119,8077,3774,11851,2021-06-23
3174071005,JAKARTA SELATAN,KEBAYORAN BARU,RAWA BARAT,5029,3124,1905,1307,3212,2021-06-23
3173011003,JAKARTA BARAT,CENGKARENG,RAWA BUAYA,51752,35860,15884,5920,21804,2021-06-23
3175031004,JAKARTA TIMUR,JATINEGARA,RAWA BUNGA,18617,14170,4446,2444,6890,2021-06-23
3174081003,JAKARTA SELATAN,PANCORAN,RAWA JATI,18210,12262,5943,3355,9298,2021-06-23
3175061002,JAKARTA TIMUR,CAKUNG,RAWA TERATE,21332,14038,7292,2031,9323,2021-06-23
3175021005,JAKARTA TIMUR,PULO GADUNG,RAWAMANGUN,32470,22619,9844,5777,15621,2021-06-23
3171051003,JAKARTA PUSAT,CEMPAKA PUTIH,RAWASARI,19312,13472,5834,3429,9263,2021-06-23
3173041010,JAKARTA BARAT,TAMBORA,ROA MALAKA,3149,1813,1333,868,2201,2021-06-23
3172041006,JAKARTA UTARA,CILINCING,ROROTAN,35258,25614,9641,4499,14140,2021-06-23
3174071004,JAKARTA SELATAN,KEBAYORAN BARU,SELONG,2576,1412,1161,872,2033,2021-06-23
3173061002,JAKARTA BARAT,KALI DERES,SEMANAN,60715,47377,13333,4925,18258,2021-06-23
3172041007,JAKARTA UTARA,CILINCING,SEMPER BARAT,59323,42131,17179,8955,26134,2021-06-23
3172041005,JAKARTA UTARA,CILINCING,SEMPER TIMUR,31249,23167,8079,4250,12329,2021-06-23
3174071006,JAKARTA SELATAN,KEBAYORAN BARU,SENAYAN,2482,1683,796,562,1358,2021-06-23
3171041001,JAKARTA PUSAT,SENEN,SENEN,5951,3840,2111,1159,3270,2021-06-23
3171031004,JAKARTA PUSAT,KEMAYORAN,SERDANG,26045,18465,7577,3880,11457,2021-06-23
3174021001,JAKARTA SELATAN,SETIA BUDI,SETIA BUDI,2532,1561,969,634,1603,2021-06-23
3175101005,JAKARTA TIMUR,CIPAYUNG,SETU,17609,13368,4239,2639,6878,2021-06-23
3173071002,JAKARTA BARAT,PALMERAH,SLIPI,14526,9774,4749,2690,7439,2021-06-23
3173081004,JAKARTA BARAT,KEMBANGAN,SRENGSENG,39370,29232,10125,6091,16216,2021-06-23
3174091002,JAKARTA SELATAN,JAGAKARSA,SRENGSENG SAWAH,50305,32377,17914,8810,26724,2021-06-23
3173051003,JAKARTA BARAT,KEBON JERUK,SUKABUMI SELATAN,30581,23512,7068,3430,10498,2021-06-23
3173051002,JAKARTA BARAT,KEBON JERUK,SUKABUMI UTARA,33050,25797,7250,3957,11207,2021-06-23
3172041002,JAKARTA UTARA,CILINCING,SUKAPURA,46955,34718,12230,5367,17597,2021-06-23
3171031007,JAKARTA PUSAT,KEMAYORAN,SUMUR BATU,19863,13980,5879,3330,9209,2021-06-23
3172021004,JAKARTA UTARA,TANJUNG PRIOK,SUNGAI BAMBU,25366,18262,7100,3464,10564,2021-06-23
3172021006,JAKARTA UTARA,TANJUNG PRIOK,SUNTER AGUNG,62904,39540,23339,13349,36688,2021-06-23
3172021002,JAKARTA UTARA,TANJUNG PRIOK,SUNTER JAYA,55168,37291,17858,10303,28161,2021-06-23
3175091004,JAKARTA TIMUR,CIRACAS,SUSUKAN,28884,20778,8104,4522,12626,2021-06-23
3173031001,JAKARTA BARAT,TAMAN SARI,TAMAN SARI,12915,8865,4048,2375,6423,2021-06-23
3173041001,JAKARTA BARAT,TAMBORA,TAMBORA,9087,6588,2499,1506,4005,2021-06-23
3173041004,JAKARTA BARAT,TAMBORA,TANAH SEREAL,23141,15524,7615,3839,11454,2021-06-23
3171081004,JAKARTA PUSAT,JOHAR BARU,TANAH TINGGI,32931,22790,10139,4199,14338,2021-06-23
3173031004,JAKARTA BARAT,TAMAN SARI,TANGKI,11593,7862,3728,1911,5639,2021-06-23
3174091005,JAKARTA SELATAN,JAGAKARSA,TANJUNG BARAT,34530,25481,9043,5570,14613,2021-06-23
3173021005,JAKARTA BARAT,GROGOL PETAMBURAN,TANJUNG DUREN SELATAN,22469,13859,8597,4399,12996,2021-06-23
3173021002,JAKARTA BARAT,GROGOL PETAMBURAN,TANJUNG DUREN UTARA,15224,9342,5876,3475,9351,2021-06-23
3172021001,JAKARTA UTARA,TANJUNG PRIOK,TANJUNG PRIOK,29913,19848,10056,3800,13856,2021-06-23
3174011002,JAKARTA SELATAN,TEBET,TEBET BARAT,18916,12228,6680,4107,10787,2021-06-23
3174011001,JAKARTA SELATAN,TEBET,TEBET TIMUR,16031,9774,6251,3665,9916,2021-06-23
3173061003,JAKARTA BARAT,KALI DERES,TEGAL ALUR,71923,55679,16237,6742,22979,2021-06-23
3174031004,JAKARTA SELATAN,MAMPANG PRAPATAN,TEGAL PARANG,28143,22245,5896,3258,9154,2021-06-23
3173021003,JAKARTA BARAT,GROGOL PETAMBURAN,TOMANG,25531,16501,9019,4911,13930,2021-06-23
3172031005,JAKARTA UTARA,KOJA,TUGU SELATAN,33663,25875,7783,3754,11537,2021-06-23
3172031002,JAKARTA UTARA,KOJA,TUGU UTARA,58638,45930,12705,6645,19350,2021-06-23
3175061006,JAKARTA TIMUR,CAKUNG,UJUNG MENTENG,25702,18042,7650,3907,11557,2021-06-23
3174101005,JAKARTA SELATAN,PESANGGRAHAN,ULUJAMI,35077,26140,8934,4867,13801,2021-06-23
3175011006,JAKARTA TIMUR,MATRAMAN,UTAN KAYU SELATAN,29303,20265,9027,4964,13991,2021-06-23
3175011002,JAKARTA TIMUR,MATRAMAN,UTAN KAYU UTARA,24728,17500,7227,3745,10972,2021-06-23
3171031008,JAKARTA PUSAT,KEMAYORAN,UTAN PANJANG,25622,19657,5964,2761,8725,2021-06-23
3172021007,JAKARTA UTARA,TANJUNG PRIOK,WARAKAS,38194,28116,10065,5136,15201,2021-06-23
3173021007,JAKARTA BARAT,GROGOL PETAMBURAN,WIJAYA KUSUMA,34170,24126,10035,4802,14837,2021-06-23
3172051003,JAKARTA UTARA,PADEMANGAN,ANCOL,20393,13977,6409,3264,9673,2021-06-24
3173041007,JAKARTA BARAT,TAMBORA,ANGKE,25785,17899,7877,3193,11070,2021-06-24
3175041005,JAKARTA TIMUR,KRAMAT JATI,BALE KAMBANG,25158,20033,5117,2599,7716,2021-06-24
3175031003,JAKARTA TIMUR,JATINEGARA,BALI MESTER,8683,6171,2509,1504,4013,2021-06-24
3175101006,JAKARTA TIMUR,CIPAYUNG,BAMBU APUS,22768,16567,6197,3942,10139,2021-06-24
3174031002,JAKARTA SELATAN,MAMPANG PRAPATAN,BANGKA,18930,13496,5428,2671,8099,2021-06-24
3175051002,JAKARTA TIMUR,PASAR REBO,BARU,20267,12346,7905,4647,12552,2021-06-24
3175041004,JAKARTA TIMUR,KRAMAT JATI,BATU AMPAR,41389,32201,9179,5163,14342,2021-06-24
3171071002,JAKARTA PUSAT,TANAH ABANG,BENDUNGAN HILIR,19008,12458,6543,3533,10076,2021-06-24
3175031002,JAKARTA TIMUR,JATINEGARA,BIDARA CINA,32331,24681,7646,3997,11643,2021-06-24
3174101002,JAKARTA SELATAN,PESANGGRAHAN,BINTARO,45843,33301,12532,7013,19545,2021-06-24
3174011005,JAKARTA SELATAN,TEBET,BUKIT DURI,29934,21974,7958,3911,11869,2021-06-24
3171041006,JAKARTA PUSAT,SENEN,BUNGUR,15932,10785,5133,2714,7847,2021-06-24
3175061007,JAKARTA TIMUR,CAKUNG,CAKUNG BARAT,49369,36112,13255,3971,17226,2021-06-24
3175061004,JAKARTA TIMUR,CAKUNG,CAKUNG TIMUR,50344,36177,14157,6319,20476,2021-06-24
3175041007,JAKARTA TIMUR,KRAMAT JATI,CAWANG,28708,21308,7395,4234,11629,2021-06-24
3175101008,JAKARTA TIMUR,CIPAYUNG,CEGER,16381,11546,4834,2541,7375,2021-06-24
3171031006,JAKARTA PUSAT,KEMAYORAN,CEMPAKA BARU,27330,19596,7724,3967,11691,2021-06-24
3171051002,JAKARTA PUSAT,CEMPAKA PUTIH,CEMPAKA PUTIH BARAT,30479,22091,8379,4925,13304,2021-06-24
3171051001,JAKARTA PUSAT,CEMPAKA PUTIH,CEMPAKA PUTIH TIMUR,21553,14334,7216,4391,11607,2021-06-24
3173011001,JAKARTA BARAT,CENGKARENG,CENGKARENG BARAT,57678,37452,20215,8174,28389,2021-06-24
3173011006,JAKARTA BARAT,CENGKARENG,CENGKARENG TIMUR,70122,50442,19670,8460,28130,2021-06-24
3175091002,JAKARTA TIMUR,CIRACAS,CIBUBUR,56927,40402,16514,9356,25870,2021-06-24
3171011002,JAKARTA PUSAT,GAMBIR,CIDENG,14203,8853,5342,3151,8493,2021-06-24
3174091003,JAKARTA SELATAN,JAGAKARSA,CIGANJUR,33127,23611,9505,5117,14622,2021-06-24
3175051003,JAKARTA TIMUR,PASAR REBO,CIJANTUNG,36027,25406,10611,6106,16717,2021-06-24
3171061003,JAKARTA PUSAT,MENTENG,CIKINI,7402,5154,2247,1362,3609,2021-06-24
3174081006,JAKARTA SELATAN,PANCORAN,CIKOKO,9280,6186,3094,1724,4818,2021-06-24
3174061001,JAKARTA SELATAN,CILANDAK,CILANDAK BARAT,45348,29903,15430,7800,23230,2021-06-24
3174041003,JAKARTA SELATAN,PASAR MINGGU,CILANDAK TIMUR,21207,13920,7278,4746,12024,2021-06-24
3175101002,JAKARTA TIMUR,CIPAYUNG,CILANGKAP,23675,16929,6739,3778,10517,2021-06-24
3175041006,JAKARTA TIMUR,KRAMAT JATI,CILILITAN,35164,25961,9194,5175,14369,2021-06-24
3172041001,JAKARTA UTARA,CILINCING,CILINCING,37003,28371,8625,3871,12496,2021-06-24
3175101001,JAKARTA TIMUR,CIPAYUNG,CIPAYUNG,22697,15458,7231,4171,11402,2021-06-24
3174091006,JAKARTA SELATAN,JAGAKARSA,CIPEDAK,32800,23251,9542,4742,14284,2021-06-24
3174061005,JAKARTA SELATAN,CILANDAK,CIPETE SELATAN,23463,16308,7152,3758,10910,2021-06-24
3174071010,JAKARTA SELATAN,KEBAYORAN BARU,CIPETE UTARA,29771,19613,10154,4049,14203,2021-06-24
3175021003,JAKARTA TIMUR,PULO GADUNG,CIPINANG,34608,24155,10445,5935,16380,2021-06-24
3175031007,JAKARTA TIMUR,JATINEGARA,CIPINANG BESAR SELATAN,30655,23576,7071,3841,10912,2021-06-24
3175031008,JAKARTA TIMUR,JATINEGARA,CIPINANG BESAR UTARA,38827,31133,7688,4138,11826,2021-06-24
3175031005,JAKARTA TIMUR,JATINEGARA,CIPINANG CEMPEDAK,29154,21086,8057,4653,12710,2021-06-24
3175081005,JAKARTA TIMUR,MAKASAR,CIPINANG MELAYU,37098,25790,11301,6328,17629,2021-06-24
3175031006,JAKARTA TIMUR,JATINEGARA,CIPINANG MUARA,46861,35026,11829,7215,19044,2021-06-24
3174051003,JAKARTA SELATAN,KEBAYORAN LAMA,CIPULIR,34708,25725,8978,4748,13726,2021-06-24
3175091001,JAKARTA TIMUR,CIRACAS,CIRACAS,55965,39317,16641,8309,24950,2021-06-24
3175041003,JAKARTA TIMUR,KRAMAT JATI,DUKUH,21239,15369,5866,3468,9334,2021-06-24
3175071001,JAKARTA TIMUR,DUREN SAWIT,DUREN SAWIT,53078,37703,15361,9117,24478,2021-06-24
3174081004,JAKARTA SELATAN,PANCORAN,DUREN TIGA,24673,17641,7027,3776,10803,2021-06-24
3173051005,JAKARTA BARAT,KEBON JERUK,DURI KEPA,52942,34466,18459,9847,28306,2021-06-24
3173011002,JAKARTA BARAT,CENGKARENG,DURI KOSAMBI,66093,46578,19506,8114,27620,2021-06-24
3171011006,JAKARTA PUSAT,GAMBIR,DURI PULO,17787,12982,4802,2363,7165,2021-06-24
3173041011,JAKARTA BARAT,TAMBORA,DURI SELATAN,12528,8272,4249,2350,6599,2021-06-24
3173041003,JAKARTA BARAT,TAMBORA,DURI UTARA,17380,12255,5122,2621,7743,2021-06-24
3171081003,JAKARTA PUSAT,JOHAR BARU,GALUR,15811,10279,5532,1949,7481,2021-06-24
3171011001,JAKARTA PUSAT,GAMBIR,GAMBIR,2232,1326,905,573,1478,2021-06-24
3174061004,JAKARTA SELATAN,CILANDAK,GANDARIA SELATAN,19394,13220,6166,2809,8975,2021-06-24
3174071009,JAKARTA SELATAN,KEBAYORAN BARU,GANDARIA UTARA,35026,24213,10809,5297,16106,2021-06-24
3175051001,JAKARTA TIMUR,PASAR REBO,GEDONG,31013,22014,8986,5226,14212,2021-06-24
3171071001,JAKARTA PUSAT,TANAH ABANG,GELORA,2753,1875,871,560,1431,2021-06-24
3173031007,JAKARTA BARAT,TAMAN SARI,GLODOK,7192,3956,3234,1966,5200,2021-06-24
3171061004,JAKARTA PUSAT,MENTENG,GONDANGDIA,3760,1995,1760,1270,3030,2021-06-24
3173021001,JAKARTA BARAT,GROGOL PETAMBURAN,GROGOL,15067,10349,4712,2578,7290,2021-06-24
3174051005,JAKARTA SELATAN,KEBAYORAN LAMA,GROGOL SELATAN,38688,27953,10728,5409,16137,2021-06-24
3174051004,JAKARTA SELATAN,KEBAYORAN LAMA,GROGOL UTARA,37234,27325,9892,5764,15656,2021-06-24
3174021007,JAKARTA SELATAN,SETIA BUDI,GUNTUR,3590,2088,1499,970,2469,2021-06-24
3174071002,JAKARTA SELATAN,KEBAYORAN BARU,GUNUNG,8309,5266,3042,2013,5055,2021-06-24
3171031005,JAKARTA PUSAT,KEMAYORAN,GUNUNG SAHARI SELATAN,17256,11911,5339,2784,8123,2021-06-24
3171021004,JAKARTA PUSAT,SAWAH BESAR,GUNUNG SAHARI UTARA,13937,7846,6085,3342,9427,2021-06-24
3175081004,JAKARTA TIMUR,MAKASAR,HALIM PERDANA KUSUMAH,24426,12198,12208,8870,21078,2021-06-24
3171031003,JAKARTA PUSAT,KEMAYORAN,HARAPAN MULIA,19987,14520,5463,2660,8123,2021-06-24
3174091001,JAKARTA SELATAN,JAGAKARSA,JAGAKARSA,53714,36863,16836,8402,25238,2021-06-24
3175021007,JAKARTA TIMUR,PULO GADUNG,JATI,28870,19684,9169,5518,14687,2021-06-24
3174041002,JAKARTA SELATAN,PASAR MINGGU,JATI PADANG,32857,22640,10208,5800,16008,2021-06-24
3173071004,JAKARTA BARAT,PALMERAH,JATI PULO,24508,15154,9351,3610,12961,2021-06-24
3175061001,JAKARTA TIMUR,CAKUNG,JATINEGARA,72652,57704,14948,6513,21461,2021-06-24
3175021004,JAKARTA TIMUR,PULO GADUNG,JATINEGARA KAUM,21313,15691,5619,2877,8496,2021-06-24
3173021004,JAKARTA BARAT,GROGOL PETAMBURAN,JELAMBAR,26984,17673,9301,5409,14710,2021-06-24
3173021006,JAKARTA BARAT,GROGOL PETAMBURAN,JELAMBAR BARU,33734,23006,10719,6006,16725,2021-06-24
3173041006,JAKARTA BARAT,TAMBORA,JEMBATAN BESI,25735,20489,5245,2404,7649,2021-06-24
3173041008,JAKARTA BARAT,TAMBORA,JEMBATAN LIMA,18241,13960,4275,2240,6515,2021-06-24
3173081005,JAKARTA BARAT,KEMBANGAN,JOGLO,35285,24658,10622,5881,16503,2021-06-24
3171081001,JAKARTA PUSAT,JOHAR BARU,JOHAR BARU,28311,16834,11471,5281,16752,2021-06-24
3173041002,JAKARTA BARAT,TAMBORA,KALI ANYAR,20624,15885,4737,2218,6955,2021-06-24
3172041004,JAKARTA UTARA,CILINCING,KALIBARU,57771,46955,10813,4269,15082,2021-06-24
3174081002,JAKARTA SELATAN,PANCORAN,KALIBATA,36451,26987,9463,4872,14335,2021-06-24
3173061001,JAKARTA BARAT,KALI DERES,KALIDERES,60209,43471,16719,7500,24219,2021-06-24
3175051004,JAKARTA TIMUR,PASAR REBO,KALISARI,37255,25570,11673,6677,18350,2021-06-24
3173061004,JAKARTA BARAT,KALI DERES,KAMAL,46035,36361,9672,3627,13299,2021-06-24
3172011002,JAKARTA UTARA,PENJARINGAN,KAMAL MUARA,11039,6495,4534,2488,7022,2021-06-24
3171071007,JAKARTA PUSAT,TANAH ABANG,KAMPUNG BALI,10113,7537,2576,1497,4073,2021-06-24
3175031001,JAKARTA TIMUR,JATINEGARA,KAMPUNG MELAYU,22293,17588,4702,2214,6916,2021-06-24
3171081002,JAKARTA PUSAT,JOHAR BARU,KAMPUNG RAWA,15550,8430,7117,2525,9642,2021-06-24
3175041002,JAKARTA TIMUR,KRAMAT JATI,KAMPUNG TENGAH,38048,28839,9200,5178,14378,2021-06-24
3173011005,JAKARTA BARAT,CENGKARENG,KAPUK,104630,78596,26026,9419,35445,2021-06-24
3172011003,JAKARTA UTARA,PENJARINGAN,KAPUK MUARA,31275,20468,10788,6595,17383,2021-06-24
3171021002,JAKARTA PUSAT,SAWAH BESAR,KARANG ANYAR,23056,16134,6911,3375,10286,2021-06-24
3174021004,JAKARTA SELATAN,SETIA BUDI,KARET,8542,5572,2968,1417,4385,2021-06-24
3174021003,JAKARTA SELATAN,SETIA BUDI,KARET KUNINGAN,14166,9172,4990,2292,7282,2021-06-24
3174021002,JAKARTA SELATAN,SETIA BUDI,KARET SEMANGGI,2469,1395,1071,591,1662,2021-06-24
3171071003,JAKARTA PUSAT,TANAH ABANG,KARET TENGSIN,16695,12091,4602,2174,6776,2021-06-24
3171021003,JAKARTA PUSAT,SAWAH BESAR,KARTINI,19916,13326,6586,3424,10010,2021-06-24
3175011003,JAKARTA TIMUR,MATRAMAN,KAYU MANIS,22174,16300,5872,2968,8840,2021-06-24
3175021006,JAKARTA TIMUR,PULO GADUNG,KAYU PUTIH,35916,24003,11898,6940,18838,2021-06-24
3173031006,JAKARTA BARAT,TAMAN SARI,KEAGUNGAN,15262,10918,4342,1979,6321,2021-06-24
3174041007,JAKARTA SELATAN,PASAR MINGGU,KEBAGUSAN,38396,28037,10350,5109,15459,2021-06-24
3174051006,JAKARTA SELATAN,KEBAYORAN LAMA,KEBAYORAN LAMA SELATAN,35920,23859,12052,5722,17774,2021-06-24
3174051001,JAKARTA SELATAN,KEBAYORAN LAMA,KEBAYORAN LAMA UTARA,37004,26684,10311,5181,15492,2021-06-24
3174011004,JAKARTA SELATAN,TEBET,KEBON BARU,30533,20883,9644,5058,14702,2021-06-24
3172021005,JAKARTA UTARA,TANJUNG PRIOK,KEBON BAWANG,44427,31075,13335,6845,20180,2021-06-24
3173051001,JAKARTA BARAT,KEBON JERUK,KEBON JERUK,46870,34775,12083,6719,18802,2021-06-24
3171071006,JAKARTA PUSAT,TANAH ABANG,KEBON KACANG,19075,14646,4427,2593,7020,2021-06-24
3171011005,JAKARTA PUSAT,GAMBIR,KEBON KELAPA,9383,6645,2737,1648,4385,2021-06-24
3171031002,JAKARTA PUSAT,KEMAYORAN,KEBON KOSONG,26178,18642,7532,3429,10961,2021-06-24
3175011005,JAKARTA TIMUR,MATRAMAN,KEBON MANGGIS,14644,9879,4759,2723,7482,2021-06-24
3171071005,JAKARTA PUSAT,TANAH ABANG,KEBON MELATI,27297,21805,5491,2830,8321,2021-06-24
3175081003,JAKARTA TIMUR,MAKASAR,KEBON PALA,40723,29589,11129,6082,17211,2021-06-24
3171061005,JAKARTA PUSAT,MENTENG,KEBON SIRIH,10880,8212,2668,1529,4197,2021-06-24
3173011004,JAKARTA BARAT,CENGKARENG,KEDAUNG KALI ANGKE,28123,17666,10452,3190,13642,2021-06-24
3173051007,JAKARTA BARAT,KEBON JERUK,KEDOYA SELATAN,28300,19365,8920,4548,13468,2021-06-24
3173051006,JAKARTA BARAT,KEBON JERUK,KEDOYA UTARA,38771,24299,14461,6894,21355,2021-06-24
3173051004,JAKARTA BARAT,KEBON JERUK,KELAPA DUA,20509,14300,6205,3085,9290,2021-06-24
3175091003,JAKARTA TIMUR,CIRACAS,KELAPA DUA WETAN,40776,27884,12880,7108,19988,2021-06-24
3172061003,JAKARTA UTARA,KELAPA GADING,KELAPA GADING BARAT,31544,17861,13659,8639,22298,2021-06-24
3172061001,JAKARTA UTARA,KELAPA GADING,KELAPA GADING TIMUR,30470,16124,14334,9019,23353,2021-06-24
3173071005,JAKARTA BARAT,PALMERAH,KEMANGGISAN,28159,18908,9244,5109,14353,2021-06-24
3171031001,JAKARTA PUSAT,KEMAYORAN,KEMAYORAN,18556,12675,5878,2781,8659,2021-06-24
3173081006,JAKARTA BARAT,KEMBANGAN,KEMBANGAN SELATAN,24028,15839,8172,4943,13115,2021-06-24
3173081001,JAKARTA BARAT,KEMBANGAN,KEMBANGAN UTARA,45663,30511,15142,6494,21636,2021-06-24
3171041002,JAKARTA PUSAT,SENEN,KENARI,8328,5053,3274,1718,4992,2021-06-24
3173041005,JAKARTA BARAT,TAMBORA,KERENDANG,17494,13009,4482,2204,6686,2021-06-24
3175071003,JAKARTA TIMUR,DUREN SAWIT,KLENDER,60420,45744,14671,7265,21936,2021-06-24
3172031001,JAKARTA UTARA,KOJA,KOJA,24600,18490,6109,2702,8811,2021-06-24
3173071006,JAKARTA BARAT,PALMERAH,KOTA BAMBU SELATAN,18287,13105,5180,2222,7402,2021-06-24
3173071003,JAKARTA BARAT,PALMERAH,KOTA BAMBU UTARA,21312,15490,5821,2753,8574,2021-06-24
3171041004,JAKARTA PUSAT,SENEN,KRAMAT,25258,19103,6153,2939,9092,2021-06-24
3175041001,JAKARTA TIMUR,KRAMAT JATI,KRAMAT JATI,29922,21014,8900,4901,13801,2021-06-24
3174071003,JAKARTA SELATAN,KEBAYORAN BARU,KRAMAT PELA,12737,7906,4828,2348,7176,2021-06-24
3173031002,JAKARTA BARAT,TAMAN SARI,KRUKUT,17023,11730,5286,2254,7540,2021-06-24
3174031005,JAKARTA SELATAN,MAMPANG PRAPATAN,KUNINGAN BARAT,11229,7552,3674,1531,5205,2021-06-24
3174021008,JAKARTA SELATAN,SETIA BUDI,KUNINGAN TIMUR,5331,3503,1826,1041,2867,2021-06-24
3171041005,JAKARTA PUSAT,SENEN,KWITANG,13487,9127,4358,2057,6415,2021-06-24
3172031003,JAKARTA UTARA,KOJA,LAGOA,51431,39259,12166,5581,17747,2021-06-24
3174061002,JAKARTA SELATAN,CILANDAK,LEBAK BULUS,32738,22697,10033,5763,15796,2021-06-24
3174091004,JAKARTA SELATAN,JAGAKARSA,LENTENG AGUNG,46600,35253,11344,6067,17411,2021-06-24
3175101007,JAKARTA TIMUR,CIPAYUNG,LUBANG BUAYA,55114,40674,14432,8258,22690,2021-06-24
3175081001,JAKARTA TIMUR,MAKASAR,MAKASAR,30013,20746,9260,4896,14156,2021-06-24
3175071006,JAKARTA TIMUR,DUREN SAWIT,MALAKA JAYA,26798,18185,8606,5394,14000,2021-06-24
3175071005,JAKARTA TIMUR,DUREN SAWIT,MALAKA SARI,23691,15249,8435,5341,13776,2021-06-24
3174031001,JAKARTA SELATAN,MAMPANG PRAPATAN,MAMPANG PRAPATAN,15885,11887,3993,2029,6022,2021-06-24
3173031005,JAKARTA BARAT,TAMAN SARI,MANGGA BESAR,6690,3990,2698,1434,4132,2021-06-24
3171021005,JAKARTA PUSAT,SAWAH BESAR,MANGGA DUA SELATAN,24940,17434,7502,3815,11317,2021-06-24
3174011007,JAKARTA SELATAN,TEBET,MANGGARAI,24972,17728,7239,3517,10756,2021-06-24
3174011006,JAKARTA SELATAN,TEBET,MANGGARAI SELATAN,20274,13642,6630,3169,9799,2021-06-24
3173031003,JAKARTA BARAT,TAMAN SARI,MAPHAR,14671,9649,5022,2544,7566,2021-06-24
3172041003,JAKARTA UTARA,CILINCING,MARUNDA,24385,16320,8063,2547,10610,2021-06-24
3174071001,JAKARTA SELATAN,KEBAYORAN BARU,MELAWAI,2386,1252,1133,810,1943,2021-06-24
3171061001,JAKARTA PUSAT,MENTENG,MENTENG,22450,16718,5727,3469,9196,2021-06-24
3174021005,JAKARTA SELATAN,SETIA BUDI,MENTENG ATAS,24369,16152,8212,3958,12170,2021-06-24
3174011003,JAKARTA SELATAN,TEBET,MENTENG DALAM,31623,22442,9171,5094,14265,2021-06-24
3173081003,JAKARTA BARAT,KEMBANGAN,MERUYA SELATAN,27261,18873,8380,4282,12662,2021-06-24
3173081002,JAKARTA BARAT,KEMBANGAN,MERUYA UTARA,38525,26664,11857,6840,18697,2021-06-24
3175101004,JAKARTA TIMUR,CIPAYUNG,MUNJUL,20582,14675,5904,3541,9445,2021-06-24
3172051002,JAKARTA UTARA,PADEMANGAN,PADEMANGAN BARAT,64756,47513,17237,7727,24964,2021-06-24
3172051001,JAKARTA UTARA,PADEMANGAN,PADEMANGAN TIMUR,32689,19309,13364,6833,20197,2021-06-24
3175011004,JAKARTA TIMUR,MATRAMAN,PAL MERIAM,17550,12305,5241,2688,7929,2021-06-24
3173071001,JAKARTA BARAT,PALMERAH,PALMERAH,54706,38642,16056,7910,23966,2021-06-24
3174081001,JAKARTA SELATAN,PANCORAN,PANCORAN,16983,12166,4816,2609,7425,2021-06-24
3172021003,JAKARTA UTARA,TANJUNG PRIOK,PAPANGGO,33902,24086,9799,4619,14418,2021-06-24
3171021001,JAKARTA PUSAT,SAWAH BESAR,PASAR BARU,11656,6554,5097,2883,7980,2021-06-24
3174021006,JAKARTA SELATAN,SETIA BUDI,PASAR MANGGIS,23415,16252,7157,3508,10665,2021-06-24
3174041001,JAKARTA SELATAN,PASAR MINGGU,PASAR MINGGU,21700,14488,7206,4496,11702,2021-06-24
3171041003,JAKARTA PUSAT,SENEN,PASEBAN,20652,14205,6442,3269,9711,2021-06-24
3173061005,JAKARTA BARAT,KALI DERES,PEGADUNGAN,65248,46890,18338,9002,27340,2021-06-24
3171061002,JAKARTA PUSAT,MENTENG,PEGANGSAAN,18427,12744,5681,2901,8582,2021-06-24
3172061002,JAKARTA UTARA,KELAPA GADING,PEGANGSAAN DUA,44451,25202,19232,10347,29579,2021-06-24
3172011004,JAKARTA UTARA,PENJARINGAN,PEJAGALAN,66008,46080,19909,10790,30699,2021-06-24
3174041006,JAKARTA SELATAN,PASAR MINGGU,PEJATEN BARAT,30591,20496,10084,5484,15568,2021-06-24
3174041005,JAKARTA SELATAN,PASAR MINGGU,PEJATEN TIMUR,50150,37389,12755,5948,18703,2021-06-24
3175051005,JAKARTA TIMUR,PASAR REBO,PEKAYON,37440,26002,11433,5970,17403,2021-06-24
3173041009,JAKARTA BARAT,TAMBORA,PEKOJAN,20921,14494,6422,3385,9807,2021-06-24
3174031003,JAKARTA SELATAN,MAMPANG PRAPATAN,PELA MAMPANG,37784,26792,10981,5538,16519,2021-06-24
3174081005,JAKARTA SELATAN,PANCORAN,PENGADEGAN,18685,11783,6897,3268,10165,2021-06-24
3175061003,JAKARTA TIMUR,CAKUNG,PENGGILINGAN,84511,65549,18960,9182,28142,2021-06-24
3172011001,JAKARTA UTARA,PENJARINGAN,PENJARINGAN,75505,55573,19921,7741,27662,2021-06-24
3174101001,JAKARTA SELATAN,PESANGGRAHAN,PESANGGRAHAN,23733,14773,8957,4834,13791,2021-06-24
3171071004,JAKARTA PUSAT,TANAH ABANG,PETAMBURAN,28974,23152,5818,2886,8704,2021-06-24
3174071008,JAKARTA SELATAN,KEBAYORAN BARU,PETOGOGAN,10203,6747,3455,1817,5272,2021-06-24
3171011004,JAKARTA PUSAT,GAMBIR,PETOJO SELATAN,13506,8906,4591,2958,7549,2021-06-24
3171011003,JAKARTA PUSAT,GAMBIR,PETOJO UTARA,16084,11188,4894,2679,7573,2021-06-24
3174101004,JAKARTA SELATAN,PESANGGRAHAN,PETUKANGAN SELATAN,32229,21691,10536,4854,15390,2021-06-24
3174101003,JAKARTA SELATAN,PESANGGRAHAN,PETUKANGAN UTARA,46427,33057,13367,6644,20011,2021-06-24
3175081002,JAKARTA TIMUR,MAKASAR,PINANG RANTI,23465,16516,6946,3399,10345,2021-06-24
3173031008,JAKARTA BARAT,TAMAN SARI,PINANGSIA,9405,5960,3444,1614,5058,2021-06-24
3175011001,JAKARTA TIMUR,MATRAMAN,PISANGAN BARU,27793,20832,6954,3764,10718,2021-06-24
3175021002,JAKARTA TIMUR,PULO GADUNG,PISANGAN TIMUR,35717,24854,10856,5509,16365,2021-06-24
3172011005,JAKARTA UTARA,PENJARINGAN,PLUIT,42979,25383,17566,12208,29774,2021-06-24
3175071002,JAKARTA TIMUR,DUREN SAWIT,PONDOK BAMBU,53658,36981,16664,8722,25386,2021-06-24
3175071004,JAKARTA TIMUR,DUREN SAWIT,PONDOK KELAPA,62704,44735,17954,10798,28752,2021-06-24
3175071007,JAKARTA TIMUR,DUREN SAWIT,PONDOK KOPI,30741,22671,8066,4268,12334,2021-06-24
3174061003,JAKARTA SELATAN,CILANDAK,PONDOK LABU,39778,27557,12210,6744,18954,2021-06-24
3174051002,JAKARTA SELATAN,KEBAYORAN LAMA,PONDOK PINANG,49276,34538,14717,9239,23956,2021-06-24
3175101003,JAKARTA TIMUR,CIPAYUNG,PONDOK RANGGON,21791,15971,5812,3730,9542,2021-06-24
3101011003,KAB.ADM.KEP.SERIBU,KEP. SERIBU UTARA,PULAU HARAPAN,1785,684,1101,655,1756,2021-06-24
3101011002,KAB.ADM.KEP.SERIBU,KEP. SERIBU UTARA,PULAU KELAPA,4729,1794,2935,1072,4007,2021-06-24
3101011001,KAB.ADM.KEP.SERIBU,KEP. SERIBU UTARA,PULAU PANGGANG,4667,1626,3041,1104,4145,2021-06-24
3101021003,KAB.ADM.KEP.SERIBU,KEP. SERIBU SELATAN,PULAU PARI,2370,740,1630,603,2233,2021-06-24
3101021002,KAB.ADM.KEP.SERIBU,KEP. SERIBU SELATAN,PULAU TIDUNG,3922,1391,2530,1121,3651,2021-06-24
3101021001,KAB.ADM.KEP.SERIBU,KEP. SERIBU SELATAN,PULAU UNTUNG JAWA,1665,513,1152,557,1709,2021-06-24
3174071007,JAKARTA SELATAN,KEBAYORAN BARU,PULO,5184,3151,2031,1328,3359,2021-06-24
3175021001,JAKARTA TIMUR,PULO GADUNG,PULO GADUNG,30292,21875,8410,4572,12982,2021-06-24
3175061005,JAKARTA TIMUR,CAKUNG,PULO GEBANG,83832,62438,21385,10446,31831,2021-06-24
3174041004,JAKARTA SELATAN,PASAR MINGGU,RAGUNAN,34536,22968,11555,5717,17272,2021-06-24
3175091005,JAKARTA TIMUR,CIRACAS,RAMBUTAN,31759,24417,7338,4212,11550,2021-06-24
3172031006,JAKARTA UTARA,KOJA,RAWA BADAK SELATAN,36403,28247,8153,3874,12027,2021-06-24
3172031004,JAKARTA UTARA,KOJA,RAWA BADAK UTARA,29198,20819,8377,3775,12152,2021-06-24
3174071005,JAKARTA SELATAN,KEBAYORAN BARU,RAWA BARAT,5029,3072,1956,1309,3265,2021-06-24
3173011003,JAKARTA BARAT,CENGKARENG,RAWA BUAYA,51752,35411,16333,5927,22260,2021-06-24
3175031004,JAKARTA TIMUR,JATINEGARA,RAWA BUNGA,18617,13983,4633,2447,7080,2021-06-24
3174081003,JAKARTA SELATAN,PANCORAN,RAWA JATI,18210,12046,6159,3361,9520,2021-06-24
3175061002,JAKARTA TIMUR,CAKUNG,RAWA TERATE,21332,13895,7435,2032,9467,2021-06-24
3175021005,JAKARTA TIMUR,PULO GADUNG,RAWAMANGUN,32470,22270,10193,5780,15973,2021-06-24
3171051003,JAKARTA PUSAT,CEMPAKA PUTIH,RAWASARI,19312,13243,6061,3433,9494,2021-06-24
3173041010,JAKARTA BARAT,TAMBORA,ROA MALAKA,3149,1772,1374,868,2242,2021-06-24
3172041006,JAKARTA UTARA,CILINCING,ROROTAN,35258,24316,10939,4502,15441,2021-06-24
3174071004,JAKARTA SELATAN,KEBAYORAN BARU,SELONG,2576,1386,1187,872,2059,2021-06-24
3173061002,JAKARTA BARAT,KALI DERES,SEMANAN,60715,46815,13895,4926,18821,2021-06-24
3172041007,JAKARTA UTARA,CILINCING,SEMPER BARAT,59323,40768,18542,8965,27507,2021-06-24
3172041005,JAKARTA UTARA,CILINCING,SEMPER TIMUR,31249,22363,8883,4253,13136,2021-06-24
3174071006,JAKARTA SELATAN,KEBAYORAN BARU,SENAYAN,2482,1666,813,563,1376,2021-06-24
3171041001,JAKARTA PUSAT,SENEN,SENEN,5951,3806,2145,1161,3306,2021-06-24
3171031004,JAKARTA PUSAT,KEMAYORAN,SERDANG,26045,18121,7921,3883,11804,2021-06-24
3174021001,JAKARTA SELATAN,SETIA BUDI,SETIA BUDI,2532,1546,984,634,1618,2021-06-24
3175101005,JAKARTA TIMUR,CIPAYUNG,SETU,17609,13159,4448,2643,7091,2021-06-24
3173071002,JAKARTA BARAT,PALMERAH,SLIPI,14526,9606,4917,2690,7607,2021-06-24
3173081004,JAKARTA BARAT,KEMBANGAN,SRENGSENG,39370,28749,10608,6097,16705,2021-06-24
3174091002,JAKARTA SELATAN,JAGAKARSA,SRENGSENG SAWAH,50305,31708,18582,8824,27406,2021-06-24
3173051003,JAKARTA BARAT,KEBON JERUK,SUKABUMI SELATAN,30581,23049,7531,3436,10967,2021-06-24
3173051002,JAKARTA BARAT,KEBON JERUK,SUKABUMI UTARA,33050,25431,7616,3963,11579,2021-06-24
3172041002,JAKARTA UTARA,CILINCING,SUKAPURA,46955,34094,12854,5376,18230,2021-06-24
3171031007,JAKARTA PUSAT,KEMAYORAN,SUMUR BATU,19863,13650,6209,3335,9544,2021-06-24
3172021004,JAKARTA UTARA,TANJUNG PRIOK,SUNGAI BAMBU,25366,17647,7714,3471,11185,2021-06-24
3172021006,JAKARTA UTARA,TANJUNG PRIOK,SUNTER AGUNG,62904,38714,24165,13357,37522,2021-06-24
3172021002,JAKARTA UTARA,TANJUNG PRIOK,SUNTER JAYA,55168,36463,18685,10309,28994,2021-06-24
3175091004,JAKARTA TIMUR,CIRACAS,SUSUKAN,28884,20492,8390,4528,12918,2021-06-24
3173031001,JAKARTA BARAT,TAMAN SARI,TAMAN SARI,12915,8717,4196,2375,6571,2021-06-24
3173041001,JAKARTA BARAT,TAMBORA,TAMBORA,9087,6452,2635,1507,4142,2021-06-24
3173041004,JAKARTA BARAT,TAMBORA,TANAH SEREAL,23141,15031,8108,3842,11950,2021-06-24
3171081004,JAKARTA PUSAT,JOHAR BARU,TANAH TINGGI,32931,22282,10647,4207,14854,2021-06-24
3173031004,JAKARTA BARAT,TAMAN SARI,TANGKI,11593,7714,3876,1911,5787,2021-06-24
3174091005,JAKARTA SELATAN,JAGAKARSA,TANJUNG BARAT,34530,25066,9458,5576,15034,2021-06-24
3173021005,JAKARTA BARAT,GROGOL PETAMBURAN,TANJUNG DUREN SELATAN,22469,13545,8911,4407,13318,2021-06-24
3173021002,JAKARTA BARAT,GROGOL PETAMBURAN,TANJUNG DUREN UTARA,15224,9020,6198,3487,9685,2021-06-24
3172021001,JAKARTA UTARA,TANJUNG PRIOK,TANJUNG PRIOK,29913,19338,10566,3801,14367,2021-06-24
3174011002,JAKARTA SELATAN,TEBET,TEBET BARAT,18916,12084,6824,4111,10935,2021-06-24
3174011001,JAKARTA SELATAN,TEBET,TEBET TIMUR,16031,9571,6454,3674,10128,2021-06-24
3173061003,JAKARTA BARAT,KALI DERES,TEGAL ALUR,71923,54763,17153,6745,23898,2021-06-24
3174031004,JAKARTA SELATAN,MAMPANG PRAPATAN,TEGAL PARANG,28143,21980,6161,3264,9425,2021-06-24
3173021003,JAKARTA BARAT,GROGOL PETAMBURAN,TOMANG,25531,16195,9325,4917,14242,2021-06-24
3172031005,JAKARTA UTARA,KOJA,TUGU SELATAN,33663,25421,8237,3760,11997,2021-06-24
3172031002,JAKARTA UTARA,KOJA,TUGU UTARA,58638,45253,13382,6647,20029,2021-06-24
3175061006,JAKARTA TIMUR,CAKUNG,UJUNG MENTENG,25702,17717,7975,3909,11884,2021-06-24
3174101005,JAKARTA SELATAN,PESANGGRAHAN,ULUJAMI,35077,25828,9246,4873,14119,2021-06-24
3175011006,JAKARTA TIMUR,MATRAMAN,UTAN KAYU SELATAN,29303,19853,9439,4966,14405,2021-06-24
3175011002,JAKARTA TIMUR,MATRAMAN,UTAN KAYU UTARA,24728,17059,7668,3752,11420,2021-06-24
3171031008,JAKARTA PUSAT,KEMAYORAN,UTAN PANJANG,25622,19317,6304,2763,9067,2021-06-24
3172021007,JAKARTA UTARA,TANJUNG PRIOK,WARAKAS,38194,27306,10875,5141,16016,2021-06-24
3173021007,JAKARTA BARAT,GROGOL PETAMBURAN,WIJAYA KUSUMA,34170,23780,10381,4806,15187,2021-06-24
3172051003,JAKARTA UTARA,PADEMANGAN,ANCOL,20393,13855,6531,3267,9798,2021-06-25
3173041007,JAKARTA BARAT,TAMBORA,ANGKE,25785,17638,8138,3202,11340,2021-06-25
3175041005,JAKARTA TIMUR,KRAMAT JATI,BALE KAMBANG,25158,19843,5307,2605,7912,2021-06-25
3175031003,JAKARTA TIMUR,JATINEGARA,BALI MESTER,8683,6102,2578,1509,4087,2021-06-25
3175101006,JAKARTA TIMUR,CIPAYUNG,BAMBU APUS,22768,16352,6412,3951,10363,2021-06-25
3174031002,JAKARTA SELATAN,MAMPANG PRAPATAN,BANGKA,18930,13315,5609,2671,8280,2021-06-25
3175051002,JAKARTA TIMUR,PASAR REBO,BARU,20267,12147,8104,4652,12756,2021-06-25
3175041004,JAKARTA TIMUR,KRAMAT JATI,BATU AMPAR,41389,31742,9638,5174,14812,2021-06-25
3171071002,JAKARTA PUSAT,TANAH ABANG,BENDUNGAN HILIR,19008,12325,6676,3539,10215,2021-06-25
3175031002,JAKARTA TIMUR,JATINEGARA,BIDARA CINA,32331,24432,7895,4009,11904,2021-06-25
3174101002,JAKARTA SELATAN,PESANGGRAHAN,BINTARO,45843,32868,12965,7017,19982,2021-06-25
3174011005,JAKARTA SELATAN,TEBET,BUKIT DURI,29934,21753,8179,3920,12099,2021-06-25
3171041006,JAKARTA PUSAT,SENEN,BUNGUR,15932,10626,5291,2716,8007,2021-06-25
3175061007,JAKARTA TIMUR,CAKUNG,CAKUNG BARAT,49369,35287,14080,3975,18055,2021-06-25
3175061004,JAKARTA TIMUR,CAKUNG,CAKUNG TIMUR,50344,35673,14661,6321,20982,2021-06-25
3175041007,JAKARTA TIMUR,KRAMAT JATI,CAWANG,28708,21133,7570,4244,11814,2021-06-25
3175101008,JAKARTA TIMUR,CIPAYUNG,CEGER,16381,11409,4971,2551,7522,2021-06-25
3171031006,JAKARTA PUSAT,KEMAYORAN,CEMPAKA BARU,27330,19363,7957,3969,11926,2021-06-25
3171051002,JAKARTA PUSAT,CEMPAKA PUTIH,CEMPAKA PUTIH BARAT,30479,21872,8598,4928,13526,2021-06-25
3171051001,JAKARTA PUSAT,CEMPAKA PUTIH,CEMPAKA PUTIH TIMUR,21553,14138,7412,4395,11807,2021-06-25
3173011001,JAKARTA BARAT,CENGKARENG,CENGKARENG BARAT,57678,36902,20764,8187,28951,2021-06-25
3173011006,JAKARTA BARAT,CENGKARENG,CENGKARENG TIMUR,70122,49885,20227,8470,28697,2021-06-25
3175091002,JAKARTA TIMUR,CIRACAS,CIBUBUR,56927,39667,17249,9376,26625,2021-06-25
3171011002,JAKARTA PUSAT,GAMBIR,CIDENG,14203,8714,5481,3153,8634,2021-06-25
3174091003,JAKARTA SELATAN,JAGAKARSA,CIGANJUR,33127,23313,9803,5123,14926,2021-06-25
3175051003,JAKARTA TIMUR,PASAR REBO,CIJANTUNG,36027,25040,10977,6118,17095,2021-06-25
3171061003,JAKARTA PUSAT,MENTENG,CIKINI,7402,5113,2288,1362,3650,2021-06-25
3174081006,JAKARTA SELATAN,PANCORAN,CIKOKO,9280,6011,3269,1728,4997,2021-06-25
3174061001,JAKARTA SELATAN,CILANDAK,CILANDAK BARAT,45348,29317,16016,7808,23824,2021-06-25
3174041003,JAKARTA SELATAN,PASAR MINGGU,CILANDAK TIMUR,21207,13708,7489,4787,12276,2021-06-25
3175101002,JAKARTA TIMUR,CIPAYUNG,CILANGKAP,23675,16774,6894,3788,10682,2021-06-25
3175041006,JAKARTA TIMUR,KRAMAT JATI,CILILITAN,35164,25788,9367,5184,14551,2021-06-25
3172041001,JAKARTA UTARA,CILINCING,CILINCING,37003,27929,9067,3874,12941,2021-06-25
3175101001,JAKARTA TIMUR,CIPAYUNG,CIPAYUNG,22697,15213,7476,4189,11665,2021-06-25
3174091006,JAKARTA SELATAN,JAGAKARSA,CIPEDAK,32800,22841,9952,4748,14700,2021-06-25
3174061005,JAKARTA SELATAN,CILANDAK,CIPETE SELATAN,23463,16072,7388,3763,11151,2021-06-25
3174071010,JAKARTA SELATAN,KEBAYORAN BARU,CIPETE UTARA,29771,19324,10443,4049,14492,2021-06-25
3175021003,JAKARTA TIMUR,PULO GADUNG,CIPINANG,34608,23863,10737,5949,16686,2021-06-25
3175031007,JAKARTA TIMUR,JATINEGARA,CIPINANG BESAR SELATAN,30655,23396,7251,3853,11104,2021-06-25
3175031008,JAKARTA TIMUR,JATINEGARA,CIPINANG BESAR UTARA,38827,30955,7866,4150,12016,2021-06-25
3175031005,JAKARTA TIMUR,JATINEGARA,CIPINANG CEMPEDAK,29154,20855,8288,4659,12947,2021-06-25
3175081005,JAKARTA TIMUR,MAKASAR,CIPINANG MELAYU,37098,25543,11547,6339,17886,2021-06-25
3175031006,JAKARTA TIMUR,JATINEGARA,CIPINANG MUARA,46861,34694,12160,7221,19381,2021-06-25
3174051003,JAKARTA SELATAN,KEBAYORAN LAMA,CIPULIR,34708,25355,9348,4752,14100,2021-06-25
3175091001,JAKARTA TIMUR,CIRACAS,CIRACAS,55965,38762,17196,8329,25525,2021-06-25
3175041003,JAKARTA TIMUR,KRAMAT JATI,DUKUH,21239,15287,5948,3478,9426,2021-06-25
3175071001,JAKARTA TIMUR,DUREN SAWIT,DUREN SAWIT,53078,37244,15820,9134,24954,2021-06-25
3174081004,JAKARTA SELATAN,PANCORAN,DUREN TIGA,24673,17312,7356,3780,11136,2021-06-25
3173051005,JAKARTA BARAT,KEBON JERUK,DURI KEPA,52942,33937,18988,9861,28849,2021-06-25
3173011002,JAKARTA BARAT,CENGKARENG,DURI KOSAMBI,66093,45736,20348,8131,28479,2021-06-25
3171011006,JAKARTA PUSAT,GAMBIR,DURI PULO,17787,12833,4951,2365,7316,2021-06-25
3173041011,JAKARTA BARAT,TAMBORA,DURI SELATAN,12528,8143,4378,2351,6729,2021-06-25
3173041003,JAKARTA BARAT,TAMBORA,DURI UTARA,17380,12148,5229,2625,7854,2021-06-25
3171081003,JAKARTA PUSAT,JOHAR BARU,GALUR,15811,10088,5723,1951,7674,2021-06-25
3171011001,JAKARTA PUSAT,GAMBIR,GAMBIR,2232,1306,925,573,1498,2021-06-25
3174061004,JAKARTA SELATAN,CILANDAK,GANDARIA SELATAN,19394,13086,6300,2811,9111,2021-06-25
3174071009,JAKARTA SELATAN,KEBAYORAN BARU,GANDARIA UTARA,35026,23916,11106,5302,16408,2021-06-25
3175051001,JAKARTA TIMUR,PASAR REBO,GEDONG,31013,21715,9284,5230,14514,2021-06-25
3171071001,JAKARTA PUSAT,TANAH ABANG,GELORA,2753,1848,898,561,1459,2021-06-25
3173031007,JAKARTA BARAT,TAMAN SARI,GLODOK,7192,3888,3302,1968,5270,2021-06-25
3171061004,JAKARTA PUSAT,MENTENG,GONDANGDIA,3760,1968,1787,1272,3059,2021-06-25
3173021001,JAKARTA BARAT,GROGOL PETAMBURAN,GROGOL,15067,10196,4865,2580,7445,2021-06-25
3174051005,JAKARTA SELATAN,KEBAYORAN LAMA,GROGOL SELATAN,38688,27533,11148,5415,16563,2021-06-25
3174051004,JAKARTA SELATAN,KEBAYORAN LAMA,GROGOL UTARA,37234,26996,10221,5775,15996,2021-06-25
3174021007,JAKARTA SELATAN,SETIA BUDI,GUNTUR,3590,2041,1546,972,2518,2021-06-25
3174071002,JAKARTA SELATAN,KEBAYORAN BARU,GUNUNG,8309,5194,3114,2015,5129,2021-06-25
3171031005,JAKARTA PUSAT,KEMAYORAN,GUNUNG SAHARI SELATAN,17256,11698,5552,2792,8344,2021-06-25
3171021004,JAKARTA PUSAT,SAWAH BESAR,GUNUNG SAHARI UTARA,13937,7733,6198,3345,9543,2021-06-25
3175081004,JAKARTA TIMUR,MAKASAR,HALIM PERDANA KUSUMAH,24426,11942,12464,9136,21600,2021-06-25
3171031003,JAKARTA PUSAT,KEMAYORAN,HARAPAN MULIA,19987,14359,5624,2662,8286,2021-06-25
3174091001,JAKARTA SELATAN,JAGAKARSA,JAGAKARSA,53714,36206,17493,8413,25906,2021-06-25
3175021007,JAKARTA TIMUR,PULO GADUNG,JATI,28870,19452,9401,5524,14925,2021-06-25
3174041002,JAKARTA SELATAN,PASAR MINGGU,JATI PADANG,32857,22324,10524,5805,16329,2021-06-25
3173071004,JAKARTA BARAT,PALMERAH,JATI PULO,24508,14939,9566,3617,13183,2021-06-25
3175061001,JAKARTA TIMUR,CAKUNG,JATINEGARA,72652,57320,15332,6529,21861,2021-06-25
3175021004,JAKARTA TIMUR,PULO GADUNG,JATINEGARA KAUM,21313,15451,5859,2882,8741,2021-06-25
3173021004,JAKARTA BARAT,GROGOL PETAMBURAN,JELAMBAR,26984,17383,9591,5411,15002,2021-06-25
3173021006,JAKARTA BARAT,GROGOL PETAMBURAN,JELAMBAR BARU,33734,22655,11070,6013,17083,2021-06-25
3173041006,JAKARTA BARAT,TAMBORA,JEMBATAN BESI,25735,20335,5399,2408,7807,2021-06-25
3173041008,JAKARTA BARAT,TAMBORA,JEMBATAN LIMA,18241,13809,4426,2242,6668,2021-06-25
3173081005,JAKARTA BARAT,KEMBANGAN,JOGLO,35285,24359,10921,5890,16811,2021-06-25
3171081001,JAKARTA PUSAT,JOHAR BARU,JOHAR BARU,28311,16563,11742,5287,17029,2021-06-25
3173041002,JAKARTA BARAT,TAMBORA,KALI ANYAR,20624,15746,4876,2218,7094,2021-06-25
3172041004,JAKARTA UTARA,CILINCING,KALIBARU,57771,46573,11195,4275,15470,2021-06-25
3174081002,JAKARTA SELATAN,PANCORAN,KALIBATA,36451,26644,9806,4879,14685,2021-06-25
3173061001,JAKARTA BARAT,KALI DERES,KALIDERES,60209,42837,17353,7513,24866,2021-06-25
3175051004,JAKARTA TIMUR,PASAR REBO,KALISARI,37255,25262,11981,6688,18669,2021-06-25
3173061004,JAKARTA BARAT,KALI DERES,KAMAL,46035,36024,10009,3635,13644,2021-06-25
3172011002,JAKARTA UTARA,PENJARINGAN,KAMAL MUARA,11039,6441,4588,2490,7078,2021-06-25
3171071007,JAKARTA PUSAT,TANAH ABANG,KAMPUNG BALI,10113,7455,2658,1497,4155,2021-06-25
3175031001,JAKARTA TIMUR,JATINEGARA,KAMPUNG MELAYU,22293,17477,4813,2216,7029,2021-06-25
3171081002,JAKARTA PUSAT,JOHAR BARU,KAMPUNG RAWA,15550,8250,7297,2529,9826,2021-06-25
3175041002,JAKARTA TIMUR,KRAMAT JATI,KAMPUNG TENGAH,38048,28530,9509,5180,14689,2021-06-25
3173011005,JAKARTA BARAT,CENGKARENG,KAPUK,104630,78038,26584,9422,36006,2021-06-25
3172011003,JAKARTA UTARA,PENJARINGAN,KAPUK MUARA,31275,20159,11097,6601,17698,2021-06-25
3171021002,JAKARTA PUSAT,SAWAH BESAR,KARANG ANYAR,23056,15973,7072,3376,10448,2021-06-25
3174021004,JAKARTA SELATAN,SETIA BUDI,KARET,8542,5457,3083,1418,4501,2021-06-25
3174021003,JAKARTA SELATAN,SETIA BUDI,KARET KUNINGAN,14166,9027,5135,2299,7434,2021-06-25
3174021002,JAKARTA SELATAN,SETIA BUDI,KARET SEMANGGI,2469,1369,1097,593,1690,2021-06-25
3171071003,JAKARTA PUSAT,TANAH ABANG,KARET TENGSIN,16695,11922,4771,2177,6948,2021-06-25
3171021003,JAKARTA PUSAT,SAWAH BESAR,KARTINI,19916,13167,6745,3429,10174,2021-06-25
3175011003,JAKARTA TIMUR,MATRAMAN,KAYU MANIS,22174,16099,6073,2972,9045,2021-06-25
3175021006,JAKARTA TIMUR,PULO GADUNG,KAYU PUTIH,35916,23523,12378,6949,19327,2021-06-25
3173031006,JAKARTA BARAT,TAMAN SARI,KEAGUNGAN,15262,10797,4463,1980,6443,2021-06-25
3174041007,JAKARTA SELATAN,PASAR MINGGU,KEBAGUSAN,38396,27696,10691,5119,15810,2021-06-25
3174051006,JAKARTA SELATAN,KEBAYORAN LAMA,KEBAYORAN LAMA SELATAN,35920,23497,12414,5730,18144,2021-06-25
3174051001,JAKARTA SELATAN,KEBAYORAN LAMA,KEBAYORAN LAMA UTARA,37004,26309,10686,5190,15876,2021-06-25
3174011004,JAKARTA SELATAN,TEBET,KEBON BARU,30533,20748,9779,5067,14846,2021-06-25
3172021005,JAKARTA UTARA,TANJUNG PRIOK,KEBON BAWANG,44427,30641,13769,6849,20618,2021-06-25
3173051001,JAKARTA BARAT,KEBON JERUK,KEBON JERUK,46870,34296,12562,6728,19290,2021-06-25
3171071006,JAKARTA PUSAT,TANAH ABANG,KEBON KACANG,19075,14539,4534,2598,7132,2021-06-25
3171011005,JAKARTA PUSAT,GAMBIR,KEBON KELAPA,9383,6549,2833,1650,4483,2021-06-25
3171031002,JAKARTA PUSAT,KEMAYORAN,KEBON KOSONG,26178,18465,7709,3431,11140,2021-06-25
3175011005,JAKARTA TIMUR,MATRAMAN,KEBON MANGGIS,14644,9759,4879,2728,7607,2021-06-25
3171071005,JAKARTA PUSAT,TANAH ABANG,KEBON MELATI,27297,21685,5611,2834,8445,2021-06-25
3175081003,JAKARTA TIMUR,MAKASAR,KEBON PALA,40723,29157,11561,6098,17659,2021-06-25
3171061005,JAKARTA PUSAT,MENTENG,KEBON SIRIH,10880,8152,2728,1529,4257,2021-06-25
3173011004,JAKARTA BARAT,CENGKARENG,KEDAUNG KALI ANGKE,28123,17424,10694,3192,13886,2021-06-25
3173051007,JAKARTA BARAT,KEBON JERUK,KEDOYA SELATAN,28300,19041,9244,4549,13793,2021-06-25
3173051006,JAKARTA BARAT,KEBON JERUK,KEDOYA UTARA,38771,23989,14771,6901,21672,2021-06-25
3173051004,JAKARTA BARAT,KEBON JERUK,KELAPA DUA,20509,14089,6416,3087,9503,2021-06-25
3175091003,JAKARTA TIMUR,CIRACAS,KELAPA DUA WETAN,40776,27605,13159,7121,20280,2021-06-25
3172061003,JAKARTA UTARA,KELAPA GADING,KELAPA GADING BARAT,31544,17659,13861,8649,22510,2021-06-25
3172061001,JAKARTA UTARA,KELAPA GADING,KELAPA GADING TIMUR,30470,15862,14596,9034,23630,2021-06-25
3173071005,JAKARTA BARAT,PALMERAH,KEMANGGISAN,28159,18648,9504,5117,14621,2021-06-25
3171031001,JAKARTA PUSAT,KEMAYORAN,KEMAYORAN,18556,12498,6055,2784,8839,2021-06-25
3173081006,JAKARTA BARAT,KEMBANGAN,KEMBANGAN SELATAN,24028,15636,8375,4945,13320,2021-06-25
3173081001,JAKARTA BARAT,KEMBANGAN,KEMBANGAN UTARA,45663,30134,15519,6506,22025,2021-06-25
3171041002,JAKARTA PUSAT,SENEN,KENARI,8328,5010,3317,1720,5037,2021-06-25
3173041005,JAKARTA BARAT,TAMBORA,KERENDANG,17494,12865,4626,2205,6831,2021-06-25
3175071003,JAKARTA TIMUR,DUREN SAWIT,KLENDER,60420,45335,15080,7280,22360,2021-06-25
3172031001,JAKARTA UTARA,KOJA,KOJA,24600,18311,6288,2702,8990,2021-06-25
3173071006,JAKARTA BARAT,PALMERAH,KOTA BAMBU SELATAN,18287,12962,5323,2224,7547,2021-06-25
3173071003,JAKARTA BARAT,PALMERAH,KOTA BAMBU UTARA,21312,15310,6001,2755,8756,2021-06-25
3171041004,JAKARTA PUSAT,SENEN,KRAMAT,25258,18898,6358,2944,9302,2021-06-25
3175041001,JAKARTA TIMUR,KRAMAT JATI,KRAMAT JATI,29922,20785,9129,4925,14054,2021-06-25
3174071003,JAKARTA SELATAN,KEBAYORAN BARU,KRAMAT PELA,12737,7803,4931,2353,7284,2021-06-25
3173031002,JAKARTA BARAT,TAMAN SARI,KRUKUT,17023,11561,5455,2259,7714,2021-06-25
3174031005,JAKARTA SELATAN,MAMPANG PRAPATAN,KUNINGAN BARAT,11229,7462,3764,1533,5297,2021-06-25
3174021008,JAKARTA SELATAN,SETIA BUDI,KUNINGAN TIMUR,5331,3447,1882,1042,2924,2021-06-25
3171041005,JAKARTA PUSAT,SENEN,KWITANG,13487,9014,4471,2058,6529,2021-06-25
3172031003,JAKARTA UTARA,KOJA,LAGOA,51431,38852,12572,5587,18159,2021-06-25
3174061002,JAKARTA SELATAN,CILANDAK,LEBAK BULUS,32738,22315,10415,5769,16184,2021-06-25
3174091004,JAKARTA SELATAN,JAGAKARSA,LENTENG AGUNG,46600,34832,11765,6075,17840,2021-06-25
3175101007,JAKARTA TIMUR,CIPAYUNG,LUBANG BUAYA,55114,39840,15266,8289,23555,2021-06-25
3175081001,JAKARTA TIMUR,MAKASAR,MAKASAR,30013,20354,9652,4906,14558,2021-06-25
3175071006,JAKARTA TIMUR,DUREN SAWIT,MALAKA JAYA,26798,17884,8907,5404,14311,2021-06-25
3175071005,JAKARTA TIMUR,DUREN SAWIT,MALAKA SARI,23691,15051,8633,5346,13979,2021-06-25
3174031001,JAKARTA SELATAN,MAMPANG PRAPATAN,MAMPANG PRAPATAN,15885,11726,4154,2031,6185,2021-06-25
3173031005,JAKARTA BARAT,TAMAN SARI,MANGGA BESAR,6690,3941,2747,1436,4183,2021-06-25
3171021005,JAKARTA PUSAT,SAWAH BESAR,MANGGA DUA SELATAN,24940,17231,7705,3819,11524,2021-06-25
3174011007,JAKARTA SELATAN,TEBET,MANGGARAI,24972,17541,7426,3522,10948,2021-06-25
3174011006,JAKARTA SELATAN,TEBET,MANGGARAI SELATAN,20274,13249,7023,3173,10196,2021-06-25
3173031003,JAKARTA BARAT,TAMAN SARI,MAPHAR,14671,9539,5132,2546,7678,2021-06-25
3172041003,JAKARTA UTARA,CILINCING,MARUNDA,24385,16077,8305,2554,10859,2021-06-25
3174071001,JAKARTA SELATAN,KEBAYORAN BARU,MELAWAI,2386,1227,1158,811,1969,2021-06-25
3171061001,JAKARTA PUSAT,MENTENG,MENTENG,22450,16563,5882,3473,9355,2021-06-25
3174021005,JAKARTA SELATAN,SETIA BUDI,MENTENG ATAS,24369,15911,8453,3964,12417,2021-06-25
3174011003,JAKARTA SELATAN,TEBET,MENTENG DALAM,31623,22155,9458,5101,14559,2021-06-25
3173081003,JAKARTA BARAT,KEMBANGAN,MERUYA SELATAN,27261,18704,8549,4289,12838,2021-06-25
3173081002,JAKARTA BARAT,KEMBANGAN,MERUYA UTARA,38525,26384,12137,6856,18993,2021-06-25
3175101004,JAKARTA TIMUR,CIPAYUNG,MUNJUL,20582,14561,6018,3549,9567,2021-06-25
3172051002,JAKARTA UTARA,PADEMANGAN,PADEMANGAN BARAT,64756,46794,17956,7737,25693,2021-06-25
3172051001,JAKARTA UTARA,PADEMANGAN,PADEMANGAN TIMUR,32689,19037,13636,6842,20478,2021-06-25
3175011004,JAKARTA TIMUR,MATRAMAN,PAL MERIAM,17550,12125,5421,2688,8109,2021-06-25
3173071001,JAKARTA BARAT,PALMERAH,PALMERAH,54706,38147,16550,7927,24477,2021-06-25
3174081001,JAKARTA SELATAN,PANCORAN,PANCORAN,16983,11971,5011,2617,7628,2021-06-25
3172021003,JAKARTA UTARA,TANJUNG PRIOK,PAPANGGO,33902,23711,10174,4627,14801,2021-06-25
3171021001,JAKARTA PUSAT,SAWAH BESAR,PASAR BARU,11656,6469,5182,2886,8068,2021-06-25
3174021006,JAKARTA SELATAN,SETIA BUDI,PASAR MANGGIS,23415,16003,7406,3516,10922,2021-06-25
3174041001,JAKARTA SELATAN,PASAR MINGGU,PASAR MINGGU,21700,14355,7339,4501,11840,2021-06-25
3171041003,JAKARTA PUSAT,SENEN,PASEBAN,20652,14040,6607,3272,9879,2021-06-25
3173061005,JAKARTA BARAT,KALI DERES,PEGADUNGAN,65248,46110,19118,9014,28132,2021-06-25
3171061002,JAKARTA PUSAT,MENTENG,PEGANGSAAN,18427,12644,5781,2904,8685,2021-06-25
3172061002,JAKARTA UTARA,KELAPA GADING,PEGANGSAAN DUA,44451,24709,19724,10358,30082,2021-06-25
3172011004,JAKARTA UTARA,PENJARINGAN,PEJAGALAN,66008,45283,20706,10796,31502,2021-06-25
3174041006,JAKARTA SELATAN,PASAR MINGGU,PEJATEN BARAT,30591,20132,10448,5490,15938,2021-06-25
3174041005,JAKARTA SELATAN,PASAR MINGGU,PEJATEN TIMUR,50150,36759,13385,5958,19343,2021-06-25
3175051005,JAKARTA TIMUR,PASAR REBO,PEKAYON,37440,25649,11786,5982,17768,2021-06-25
3173041009,JAKARTA BARAT,TAMBORA,PEKOJAN,20921,14298,6618,3390,10008,2021-06-25
3174031003,JAKARTA SELATAN,MAMPANG PRAPATAN,PELA MAMPANG,37784,26462,11311,5546,16857,2021-06-25
3174081005,JAKARTA SELATAN,PANCORAN,PENGADEGAN,18685,11342,7338,3278,10616,2021-06-25
3175061003,JAKARTA TIMUR,CAKUNG,PENGGILINGAN,84511,65142,19367,9193,28560,2021-06-25
3172011001,JAKARTA UTARA,PENJARINGAN,PENJARINGAN,75505,55083,20411,7752,28163,2021-06-25
3174101001,JAKARTA SELATAN,PESANGGRAHAN,PESANGGRAHAN,23733,14493,9237,4839,14076,2021-06-25
3171071004,JAKARTA PUSAT,TANAH ABANG,PETAMBURAN,28974,22996,5974,2886,8860,2021-06-25
3174071008,JAKARTA SELATAN,KEBAYORAN BARU,PETOGOGAN,10203,6662,3540,1820,5360,2021-06-25
3171011004,JAKARTA PUSAT,GAMBIR,PETOJO SELATAN,13506,8772,4725,2969,7694,2021-06-25
3171011003,JAKARTA PUSAT,GAMBIR,PETOJO UTARA,16084,11061,5021,2682,7703,2021-06-25
3174101004,JAKARTA SELATAN,PESANGGRAHAN,PETUKANGAN SELATAN,32229,21401,10826,4863,15689,2021-06-25
3174101003,JAKARTA SELATAN,PESANGGRAHAN,PETUKANGAN UTARA,46427,32454,13970,6654,20624,2021-06-25
3175081002,JAKARTA TIMUR,MAKASAR,PINANG RANTI,23465,16212,7250,3409,10659,2021-06-25
3173031008,JAKARTA BARAT,TAMAN SARI,PINANGSIA,9405,5893,3511,1615,5126,2021-06-25
3175011001,JAKARTA TIMUR,MATRAMAN,PISANGAN BARU,27793,20650,7136,3770,10906,2021-06-25
3175021002,JAKARTA TIMUR,PULO GADUNG,PISANGAN TIMUR,35717,24568,11141,5523,16664,2021-06-25
3172011005,JAKARTA UTARA,PENJARINGAN,PLUIT,42979,25018,17931,12226,30157,2021-06-25
3175071002,JAKARTA TIMUR,DUREN SAWIT,PONDOK BAMBU,53658,36481,17164,8741,25905,2021-06-25
3175071004,JAKARTA TIMUR,DUREN SAWIT,PONDOK KELAPA,62704,44048,18641,10815,29456,2021-06-25
3175071007,JAKARTA TIMUR,DUREN SAWIT,PONDOK KOPI,30741,22415,8322,4273,12595,2021-06-25
3174061003,JAKARTA SELATAN,CILANDAK,PONDOK LABU,39778,26908,12859,6756,19615,2021-06-25
3174051002,JAKARTA SELATAN,KEBAYORAN LAMA,PONDOK PINANG,49276,34082,15173,9274,24447,2021-06-25
3175101003,JAKARTA TIMUR,CIPAYUNG,PONDOK RANGGON,21791,15814,5969,3744,9713,2021-06-25
3101011003,KAB.ADM.KEP.SERIBU,KEP. SERIBU UTARA,PULAU HARAPAN,1785,615,1170,658,1828,2021-06-25
3101011002,KAB.ADM.KEP.SERIBU,KEP. SERIBU UTARA,PULAU KELAPA,4729,1665,3064,1074,4138,2021-06-25
3101011001,KAB.ADM.KEP.SERIBU,KEP. SERIBU UTARA,PULAU PANGGANG,4667,1590,3077,1106,4183,2021-06-25
3101021003,KAB.ADM.KEP.SERIBU,KEP. SERIBU SELATAN,PULAU PARI,2370,578,1792,609,2401,2021-06-25
3101021002,KAB.ADM.KEP.SERIBU,KEP. SERIBU SELATAN,PULAU TIDUNG,3922,1351,2570,1123,3693,2021-06-25
3101021001,KAB.ADM.KEP.SERIBU,KEP. SERIBU SELATAN,PULAU UNTUNG JAWA,1665,502,1163,558,1721,2021-06-25
3174071007,JAKARTA SELATAN,KEBAYORAN BARU,PULO,5184,3089,2093,1329,3422,2021-06-25
3175021001,JAKARTA TIMUR,PULO GADUNG,PULO GADUNG,30292,21565,8720,4578,13298,2021-06-25
3175061005,JAKARTA TIMUR,CAKUNG,PULO GEBANG,83832,61721,22102,10457,32559,2021-06-25
3174041004,JAKARTA SELATAN,PASAR MINGGU,RAGUNAN,34536,22607,11916,5724,17640,2021-06-25
3175091005,JAKARTA TIMUR,CIRACAS,RAMBUTAN,31759,24235,7518,4219,11737,2021-06-25
3172031006,JAKARTA UTARA,KOJA,RAWA BADAK SELATAN,36403,27956,8444,3882,12326,2021-06-25
3172031004,JAKARTA UTARA,KOJA,RAWA BADAK UTARA,29198,20529,8667,3790,12457,2021-06-25
3174071005,JAKARTA SELATAN,KEBAYORAN BARU,RAWA BARAT,5029,3028,2000,1312,3312,2021-06-25
3173011003,JAKARTA BARAT,CENGKARENG,RAWA BUAYA,51752,35102,16642,5938,22580,2021-06-25
3175031004,JAKARTA TIMUR,JATINEGARA,RAWA BUNGA,18617,13880,4736,2447,7183,2021-06-25
3174081003,JAKARTA SELATAN,PANCORAN,RAWA JATI,18210,11875,6329,3367,9696,2021-06-25
3175061002,JAKARTA TIMUR,CAKUNG,RAWA TERATE,21332,13817,7513,2034,9547,2021-06-25
3175021005,JAKARTA TIMUR,PULO GADUNG,RAWAMANGUN,32470,22021,10442,5785,16227,2021-06-25
3171051003,JAKARTA PUSAT,CEMPAKA PUTIH,RAWASARI,19312,13068,6235,3436,9671,2021-06-25
3173041010,JAKARTA BARAT,TAMBORA,ROA MALAKA,3149,1747,1399,871,2270,2021-06-25
3172041006,JAKARTA UTARA,CILINCING,ROROTAN,35258,23928,11327,4509,15836,2021-06-25
3174071004,JAKARTA SELATAN,KEBAYORAN BARU,SELONG,2576,1364,1209,874,2083,2021-06-25
3173061002,JAKARTA BARAT,KALI DERES,SEMANAN,60715,46313,14397,4930,19327,2021-06-25
3172041007,JAKARTA UTARA,CILINCING,SEMPER BARAT,59323,40273,19036,8974,28010,2021-06-25
3172041005,JAKARTA UTARA,CILINCING,SEMPER TIMUR,31249,22040,9206,4256,13462,2021-06-25
3174071006,JAKARTA SELATAN,KEBAYORAN BARU,SENAYAN,2482,1651,828,563,1391,2021-06-25
3171041001,JAKARTA PUSAT,SENEN,SENEN,5951,3777,2174,1161,3335,2021-06-25
3171031004,JAKARTA PUSAT,KEMAYORAN,SERDANG,26045,17899,8143,3889,12032,2021-06-25
3174021001,JAKARTA SELATAN,SETIA BUDI,SETIA BUDI,2532,1531,999,634,1633,2021-06-25
3175101005,JAKARTA TIMUR,CIPAYUNG,SETU,17609,13036,4571,2651,7222,2021-06-25
3173071002,JAKARTA BARAT,PALMERAH,SLIPI,14526,9512,5011,2695,7706,2021-06-25
3173081004,JAKARTA BARAT,KEMBANGAN,SRENGSENG,39370,28372,10984,6105,17089,2021-06-25
3174091002,JAKARTA SELATAN,JAGAKARSA,SRENGSENG SAWAH,50305,31178,19112,8830,27942,2021-06-25
3173051003,JAKARTA BARAT,KEBON JERUK,SUKABUMI SELATAN,30581,22750,7830,3439,11269,2021-06-25
3173051002,JAKARTA BARAT,KEBON JERUK,SUKABUMI UTARA,33050,25212,7835,3966,11801,2021-06-25
3172041002,JAKARTA UTARA,CILINCING,SUKAPURA,46955,33677,13271,5383,18654,2021-06-25
3171031007,JAKARTA PUSAT,KEMAYORAN,SUMUR BATU,19863,13411,6448,3347,9795,2021-06-25
3172021004,JAKARTA UTARA,TANJUNG PRIOK,SUNGAI BAMBU,25366,17321,8040,3475,11515,2021-06-25
3172021006,JAKARTA UTARA,TANJUNG PRIOK,SUNTER AGUNG,62904,38210,24668,13370,38038,2021-06-25
3172021002,JAKARTA UTARA,TANJUNG PRIOK,SUNTER JAYA,55168,35917,19231,10315,29546,2021-06-25
3175091004,JAKARTA TIMUR,CIRACAS,SUSUKAN,28884,20276,8606,4532,13138,2021-06-25
3173031001,JAKARTA BARAT,TAMAN SARI,TAMAN SARI,12915,8636,4277,2377,6654,2021-06-25
3173041001,JAKARTA BARAT,TAMBORA,TAMBORA,9087,6344,2743,1509,4252,2021-06-25
3173041004,JAKARTA BARAT,TAMBORA,TANAH SEREAL,23141,14827,8312,3846,12158,2021-06-25
3171081004,JAKARTA PUSAT,JOHAR BARU,TANAH TINGGI,32931,21923,11006,4210,15216,2021-06-25
3173031004,JAKARTA BARAT,TAMAN SARI,TANGKI,11593,7606,3984,1912,5896,2021-06-25
3174091005,JAKARTA SELATAN,JAGAKARSA,TANJUNG BARAT,34530,24760,9764,5596,15360,2021-06-25
3173021005,JAKARTA BARAT,GROGOL PETAMBURAN,TANJUNG DUREN SELATAN,22469,13295,9161,4408,13569,2021-06-25
3173021002,JAKARTA BARAT,GROGOL PETAMBURAN,TANJUNG DUREN UTARA,15224,8822,6396,3491,9887,2021-06-25
3172021001,JAKARTA UTARA,TANJUNG PRIOK,TANJUNG PRIOK,29913,18994,10910,3802,14712,2021-06-25
3174011002,JAKARTA SELATAN,TEBET,TEBET BARAT,18916,11885,7023,4122,11145,2021-06-25
3174011001,JAKARTA SELATAN,TEBET,TEBET TIMUR,16031,9482,6543,3678,10221,2021-06-25
3173061003,JAKARTA BARAT,KALI DERES,TEGAL ALUR,71923,54087,17829,6790,24619,2021-06-25
3174031004,JAKARTA SELATAN,MAMPANG PRAPATAN,TEGAL PARANG,28143,21744,6397,3269,9666,2021-06-25
3173021003,JAKARTA BARAT,GROGOL PETAMBURAN,TOMANG,25531,16002,9518,4924,14442,2021-06-25
3172031005,JAKARTA UTARA,KOJA,TUGU SELATAN,33663,25185,8473,3761,12234,2021-06-25
3172031002,JAKARTA UTARA,KOJA,TUGU UTARA,58638,44859,13776,6656,20432,2021-06-25
3175061006,JAKARTA TIMUR,CAKUNG,UJUNG MENTENG,25702,17507,8185,3912,12097,2021-06-25
3174101005,JAKARTA SELATAN,PESANGGRAHAN,ULUJAMI,35077,25434,9638,4878,14516,2021-06-25
3175011006,JAKARTA TIMUR,MATRAMAN,UTAN KAYU SELATAN,29303,19561,9731,4977,14708,2021-06-25
3175011002,JAKARTA TIMUR,MATRAMAN,UTAN KAYU UTARA,24728,16784,7943,3762,11705,2021-06-25
3171031008,JAKARTA PUSAT,KEMAYORAN,UTAN PANJANG,25622,19020,6601,2769,9370,2021-06-25
3172021007,JAKARTA UTARA,TANJUNG PRIOK,WARAKAS,38194,26836,11345,5149,16494,2021-06-25
3173021007,JAKARTA BARAT,GROGOL PETAMBURAN,WIJAYA KUSUMA,34170,23536,10625,4817,15442,2021-06-25
3172051003,JAKARTA UTARA,PADEMANGAN,ANCOL,20393,13734,6652,3273,9925,2021-06-26
3173041007,JAKARTA BARAT,TAMBORA,ANGKE,25785,17387,8389,3208,11597,2021-06-26
3175041005,JAKARTA TIMUR,KRAMAT JATI,BALE KAMBANG,25158,19636,5514,2612,8126,2021-06-26
3175031003,JAKARTA TIMUR,JATINEGARA,BALI MESTER,8683,6027,2653,1510,4163,2021-06-26
3175101006,JAKARTA TIMUR,CIPAYUNG,BAMBU APUS,22768,16086,6678,3957,10635,2021-06-26
3174031002,JAKARTA SELATAN,MAMPANG PRAPATAN,BANGKA,18930,13150,5774,2673,8447,2021-06-26
3175051002,JAKARTA TIMUR,PASAR REBO,BARU,20267,11949,8301,4658,12959,2021-06-26
3175041004,JAKARTA TIMUR,KRAMAT JATI,BATU AMPAR,41389,31390,9990,5188,15178,2021-06-26
3171071002,JAKARTA PUSAT,TANAH ABANG,BENDUNGAN HILIR,19008,12170,6831,3547,10378,2021-06-26
3175031002,JAKARTA TIMUR,JATINEGARA,BIDARA CINA,32331,24225,8102,4017,12119,2021-06-26
3174101002,JAKARTA SELATAN,PESANGGRAHAN,BINTARO,45843,32520,13312,7032,20344,2021-06-26
3174011005,JAKARTA SELATAN,TEBET,BUKIT DURI,29934,21553,8379,3929,12308,2021-06-26
3171041006,JAKARTA PUSAT,SENEN,BUNGUR,15932,10506,5410,2723,8133,2021-06-26
3175061007,JAKARTA TIMUR,CAKUNG,CAKUNG BARAT,49369,34420,14947,3981,18928,2021-06-26
3175061004,JAKARTA TIMUR,CAKUNG,CAKUNG TIMUR,50344,35173,15161,6335,21496,2021-06-26
3175041007,JAKARTA TIMUR,KRAMAT JATI,CAWANG,28708,20866,7837,4253,12090,2021-06-26
3175101008,JAKARTA TIMUR,CIPAYUNG,CEGER,16381,11272,5108,2554,7662,2021-06-26
3171031006,JAKARTA PUSAT,KEMAYORAN,CEMPAKA BARU,27330,19145,8175,3977,12152,2021-06-26
3171051002,JAKARTA PUSAT,CEMPAKA PUTIH,CEMPAKA PUTIH BARAT,30479,21629,8841,4937,13778,2021-06-26
3171051001,JAKARTA PUSAT,CEMPAKA PUTIH,CEMPAKA PUTIH TIMUR,21553,13953,7597,4410,12007,2021-06-26
3173011001,JAKARTA BARAT,CENGKARENG,CENGKARENG BARAT,57678,36525,21141,8195,29336,2021-06-26
3173011006,JAKARTA BARAT,CENGKARENG,CENGKARENG TIMUR,70122,49274,20838,8479,29317,2021-06-26
3175091002,JAKARTA TIMUR,CIRACAS,CIBUBUR,56927,38999,17917,9392,27309,2021-06-26
3171011002,JAKARTA PUSAT,GAMBIR,CIDENG,14203,8627,5568,3160,8728,2021-06-26
3174091003,JAKARTA SELATAN,JAGAKARSA,CIGANJUR,33127,22927,10189,5131,15320,2021-06-26
3175051003,JAKARTA TIMUR,PASAR REBO,CIJANTUNG,36027,24628,11389,6138,17527,2021-06-26
3171061003,JAKARTA PUSAT,MENTENG,CIKINI,7402,5054,2347,1365,3712,2021-06-26
3174081006,JAKARTA SELATAN,PANCORAN,CIKOKO,9280,5913,3367,1730,5097,2021-06-26
3174061001,JAKARTA SELATAN,CILANDAK,CILANDAK BARAT,45348,28776,16557,7819,24376,2021-06-26
3174041003,JAKARTA SELATAN,PASAR MINGGU,CILANDAK TIMUR,21207,13523,7674,4813,12487,2021-06-26
3175101002,JAKARTA TIMUR,CIPAYUNG,CILANGKAP,23675,16576,7092,3796,10888,2021-06-26
3175041006,JAKARTA TIMUR,KRAMAT JATI,CILILITAN,35164,25547,9608,5190,14798,2021-06-26
3172041001,JAKARTA UTARA,CILINCING,CILINCING,37003,27541,9455,3884,13339,2021-06-26
3175101001,JAKARTA TIMUR,CIPAYUNG,CIPAYUNG,22697,14929,7760,4202,11962,2021-06-26
3174091006,JAKARTA SELATAN,JAGAKARSA,CIPEDAK,32800,22402,10391,4767,15158,2021-06-26
3174061005,JAKARTA SELATAN,CILANDAK,CIPETE SELATAN,23463,15803,7657,3775,11432,2021-06-26
3174071010,JAKARTA SELATAN,KEBAYORAN BARU,CIPETE UTARA,29771,19038,10729,4057,14786,2021-06-26
3175021003,JAKARTA TIMUR,PULO GADUNG,CIPINANG,34608,23647,10953,5969,16922,2021-06-26
3175031007,JAKARTA TIMUR,JATINEGARA,CIPINANG BESAR SELATAN,30655,23172,7475,3865,11340,2021-06-26
3175031008,JAKARTA TIMUR,JATINEGARA,CIPINANG BESAR UTARA,38827,30703,8118,4158,12276,2021-06-26
3175031005,JAKARTA TIMUR,JATINEGARA,CIPINANG CEMPEDAK,29154,20671,8472,4668,13140,2021-06-26
3175081005,JAKARTA TIMUR,MAKASAR,CIPINANG MELAYU,37098,25233,11857,6356,18213,2021-06-26
3175031006,JAKARTA TIMUR,JATINEGARA,CIPINANG MUARA,46861,34357,12497,7243,19740,2021-06-26
3174051003,JAKARTA SELATAN,KEBAYORAN LAMA,CIPULIR,34708,24867,9836,4762,14598,2021-06-26
3175091001,JAKARTA TIMUR,CIRACAS,CIRACAS,55965,38231,17727,8338,26065,2021-06-26
3175041003,JAKARTA TIMUR,KRAMAT JATI,DUKUH,21239,15062,6173,3482,9655,2021-06-26
3175071001,JAKARTA TIMUR,DUREN SAWIT,DUREN SAWIT,53078,36783,16281,9157,25438,2021-06-26
3174081004,JAKARTA SELATAN,PANCORAN,DUREN TIGA,24673,16966,7701,3796,11497,2021-06-26
3173051005,JAKARTA BARAT,KEBON JERUK,DURI KEPA,52942,33320,19605,9892,29497,2021-06-26
3173011002,JAKARTA BARAT,CENGKARENG,DURI KOSAMBI,66093,45207,20877,8144,29021,2021-06-26
3171011006,JAKARTA PUSAT,GAMBIR,DURI PULO,17787,12688,5096,2369,7465,2021-06-26
3173041011,JAKARTA BARAT,TAMBORA,DURI SELATAN,12528,8046,4475,2352,6827,2021-06-26
3173041003,JAKARTA BARAT,TAMBORA,DURI UTARA,17380,11947,5430,2626,8056,2021-06-26
3171081003,JAKARTA PUSAT,JOHAR BARU,GALUR,15811,9931,5880,1955,7835,2021-06-26
3171011001,JAKARTA PUSAT,GAMBIR,GAMBIR,2232,1292,939,576,1515,2021-06-26
3174061004,JAKARTA SELATAN,CILANDAK,GANDARIA SELATAN,19394,12797,6589,2816,9405,2021-06-26
3174071009,JAKARTA SELATAN,KEBAYORAN BARU,GANDARIA UTARA,35026,23592,11430,5313,16743,2021-06-26
3175051001,JAKARTA TIMUR,PASAR REBO,GEDONG,31013,21486,9513,5236,14749,2021-06-26
3171071001,JAKARTA PUSAT,TANAH ABANG,GELORA,2753,1819,927,561,1488,2021-06-26
3173031007,JAKARTA BARAT,TAMAN SARI,GLODOK,7192,3797,3393,1970,5363,2021-06-26
3171061004,JAKARTA PUSAT,MENTENG,GONDANGDIA,3760,1942,1813,1275,3088,2021-06-26
3173021001,JAKARTA BARAT,GROGOL PETAMBURAN,GROGOL,15067,10050,5011,2586,7597,2021-06-26
3174051005,JAKARTA SELATAN,KEBAYORAN LAMA,GROGOL SELATAN,38688,27278,11402,5425,16827,2021-06-26
3174051004,JAKARTA SELATAN,KEBAYORAN LAMA,GROGOL UTARA,37234,26728,10489,5790,16279,2021-06-26
3174021007,JAKARTA SELATAN,SETIA BUDI,GUNTUR,3590,1997,1590,975,2565,2021-06-26
3174071002,JAKARTA SELATAN,KEBAYORAN BARU,GUNUNG,8309,5117,3191,2017,5208,2021-06-26
3171031005,JAKARTA PUSAT,KEMAYORAN,GUNUNG SAHARI SELATAN,17256,11481,5769,2798,8567,2021-06-26
3171021004,JAKARTA PUSAT,SAWAH BESAR,GUNUNG SAHARI UTARA,13937,7598,6333,3350,9683,2021-06-26
3175081004,JAKARTA TIMUR,MAKASAR,HALIM PERDANA KUSUMAH,24426,11663,12743,9185,21928,2021-06-26
3171031003,JAKARTA PUSAT,KEMAYORAN,HARAPAN MULIA,19987,14130,5853,2665,8518,2021-06-26
3174091001,JAKARTA SELATAN,JAGAKARSA,JAGAKARSA,53714,35558,18140,8426,26566,2021-06-26
3175021007,JAKARTA TIMUR,PULO GADUNG,JATI,28870,19201,9652,5541,15193,2021-06-26
3174041002,JAKARTA SELATAN,PASAR MINGGU,JATI PADANG,32857,21981,10867,5819,16686,2021-06-26
3173071004,JAKARTA BARAT,PALMERAH,JATI PULO,24508,14730,9775,3619,13394,2021-06-26
3175061001,JAKARTA TIMUR,CAKUNG,JATINEGARA,72652,56832,15820,6557,22377,2021-06-26
3175021004,JAKARTA TIMUR,PULO GADUNG,JATINEGARA KAUM,21313,15246,6064,2891,8955,2021-06-26
3173021004,JAKARTA BARAT,GROGOL PETAMBURAN,JELAMBAR,26984,17096,9877,5422,15299,2021-06-26
3173021006,JAKARTA BARAT,GROGOL PETAMBURAN,JELAMBAR BARU,33734,22225,11500,6024,17524,2021-06-26
3173041006,JAKARTA BARAT,TAMBORA,JEMBATAN BESI,25735,20152,5582,2410,7992,2021-06-26
3173041008,JAKARTA BARAT,TAMBORA,JEMBATAN LIMA,18241,13657,4578,2245,6823,2021-06-26
3173081005,JAKARTA BARAT,KEMBANGAN,JOGLO,35285,23983,11297,5900,17197,2021-06-26
3171081001,JAKARTA PUSAT,JOHAR BARU,JOHAR BARU,28311,16282,12023,5302,17325,2021-06-26
3173041002,JAKARTA BARAT,TAMBORA,KALI ANYAR,20624,15607,5015,2219,7234,2021-06-26
3172041004,JAKARTA UTARA,CILINCING,KALIBARU,57771,46013,11755,4292,16047,2021-06-26
3174081002,JAKARTA SELATAN,PANCORAN,KALIBATA,36451,26315,10135,4889,15024,2021-06-26
3173061001,JAKARTA BARAT,KALI DERES,KALIDERES,60209,42256,17934,7525,25459,2021-06-26
3175051004,JAKARTA TIMUR,PASAR REBO,KALISARI,37255,24966,12277,6704,18981,2021-06-26
3173061004,JAKARTA BARAT,KALI DERES,KAMAL,46035,35685,10346,3641,13987,2021-06-26
3172011002,JAKARTA UTARA,PENJARINGAN,KAMAL MUARA,11039,6276,4753,2491,7244,2021-06-26
3171071007,JAKARTA PUSAT,TANAH ABANG,KAMPUNG BALI,10113,7387,2726,1499,4225,2021-06-26
3175031001,JAKARTA TIMUR,JATINEGARA,KAMPUNG MELAYU,22293,17280,5010,2220,7230,2021-06-26
3171081002,JAKARTA PUSAT,JOHAR BARU,KAMPUNG RAWA,15550,8034,7513,2532,10045,2021-06-26
3175041002,JAKARTA TIMUR,KRAMAT JATI,KAMPUNG TENGAH,38048,28303,9736,5197,14933,2021-06-26
3173011005,JAKARTA BARAT,CENGKARENG,KAPUK,104630,77041,27581,9431,37012,2021-06-26
3172011003,JAKARTA UTARA,PENJARINGAN,KAPUK MUARA,31275,19829,11427,6609,18036,2021-06-26
3171021002,JAKARTA PUSAT,SAWAH BESAR,KARANG ANYAR,23056,15718,7327,3384,10711,2021-06-26
3174021004,JAKARTA SELATAN,SETIA BUDI,KARET,8542,5371,3169,1420,4589,2021-06-26
3174021003,JAKARTA SELATAN,SETIA BUDI,KARET KUNINGAN,14166,8884,5278,2304,7582,2021-06-26
3174021002,JAKARTA SELATAN,SETIA BUDI,KARET SEMANGGI,2469,1346,1120,595,1715,2021-06-26
3171071003,JAKARTA PUSAT,TANAH ABANG,KARET TENGSIN,16695,11756,4937,2185,7122,2021-06-26
3171021003,JAKARTA PUSAT,SAWAH BESAR,KARTINI,19916,12950,6962,3434,10396,2021-06-26
3175011003,JAKARTA TIMUR,MATRAMAN,KAYU MANIS,22174,15885,6287,2975,9262,2021-06-26
3175021006,JAKARTA TIMUR,PULO GADUNG,KAYU PUTIH,35916,23013,12885,6961,19846,2021-06-26
3173031006,JAKARTA BARAT,TAMAN SARI,KEAGUNGAN,15262,10659,4601,1986,6587,2021-06-26
3174041007,JAKARTA SELATAN,PASAR MINGGU,KEBAGUSAN,38396,27290,11097,5129,16226,2021-06-26
3174051006,JAKARTA SELATAN,KEBAYORAN LAMA,KEBAYORAN LAMA SELATAN,35920,23297,12614,5745,18359,2021-06-26
3174051001,JAKARTA SELATAN,KEBAYORAN LAMA,KEBAYORAN LAMA UTARA,37004,26058,10936,5202,16138,2021-06-26
3174011004,JAKARTA SELATAN,TEBET,KEBON BARU,30533,20599,9928,5071,14999,2021-06-26
3172021005,JAKARTA UTARA,TANJUNG PRIOK,KEBON BAWANG,44427,30093,14317,6858,21175,2021-06-26
3173051001,JAKARTA BARAT,KEBON JERUK,KEBON JERUK,46870,33816,13042,6736,19778,2021-06-26
3171071006,JAKARTA PUSAT,TANAH ABANG,KEBON KACANG,19075,14432,4640,2604,7244,2021-06-26
3171011005,JAKARTA PUSAT,GAMBIR,KEBON KELAPA,9383,6453,2929,1650,4579,2021-06-26
3171031002,JAKARTA PUSAT,KEMAYORAN,KEBON KOSONG,26178,18217,7957,3433,11390,2021-06-26
3175011005,JAKARTA TIMUR,MATRAMAN,KEBON MANGGIS,14644,9607,5031,2728,7759,2021-06-26
3171071005,JAKARTA PUSAT,TANAH ABANG,KEBON MELATI,27297,21565,5731,2846,8577,2021-06-26
3175081003,JAKARTA TIMUR,MAKASAR,KEBON PALA,40723,28732,11986,6114,18100,2021-06-26
3171061005,JAKARTA PUSAT,MENTENG,KEBON SIRIH,10880,8064,2816,1531,4347,2021-06-26
3173011004,JAKARTA BARAT,CENGKARENG,KEDAUNG KALI ANGKE,28123,17139,10979,3194,14173,2021-06-26
3173051007,JAKARTA BARAT,KEBON JERUK,KEDOYA SELATAN,28300,18727,9556,4561,14117,2021-06-26
3173051006,JAKARTA BARAT,KEBON JERUK,KEDOYA UTARA,38771,23638,15122,6908,22030,2021-06-26
3173051004,JAKARTA BARAT,KEBON JERUK,KELAPA DUA,20509,13897,6608,3092,9700,2021-06-26
3175091003,JAKARTA TIMUR,CIRACAS,KELAPA DUA WETAN,40776,27245,13519,7140,20659,2021-06-26
3172061003,JAKARTA UTARA,KELAPA GADING,KELAPA GADING BARAT,31544,17397,14123,8669,22792,2021-06-26
3172061001,JAKARTA UTARA,KELAPA GADING,KELAPA GADING TIMUR,30470,15555,14903,9051,23954,2021-06-26
3173071005,JAKARTA BARAT,PALMERAH,KEMANGGISAN,28159,18401,9751,5127,14878,2021-06-26
3171031001,JAKARTA PUSAT,KEMAYORAN,KEMAYORAN,18556,12270,6283,2790,9073,2021-06-26
3173081006,JAKARTA BARAT,KEMBANGAN,KEMBANGAN SELATAN,24028,15430,8581,4953,13534,2021-06-26
3173081001,JAKARTA BARAT,KEMBANGAN,KEMBANGAN UTARA,45663,29841,15811,6520,22331,2021-06-26
3171041002,JAKARTA PUSAT,SENEN,KENARI,8328,4950,3377,1722,5099,2021-06-26
3173041005,JAKARTA BARAT,TAMBORA,KERENDANG,17494,12733,4758,2207,6965,2021-06-26
3175071003,JAKARTA TIMUR,DUREN SAWIT,KLENDER,60420,44911,15504,7305,22809,2021-06-26
3172031001,JAKARTA UTARA,KOJA,KOJA,24600,18074,6525,2719,9244,2021-06-26
3173071006,JAKARTA BARAT,PALMERAH,KOTA BAMBU SELATAN,18287,12780,5505,2226,7731,2021-06-26
3173071003,JAKARTA BARAT,PALMERAH,KOTA BAMBU UTARA,21312,15120,6191,2755,8946,2021-06-26
3171041004,JAKARTA PUSAT,SENEN,KRAMAT,25258,18635,6621,2952,9573,2021-06-26
3175041001,JAKARTA TIMUR,KRAMAT JATI,KRAMAT JATI,29922,20549,9365,4948,14313,2021-06-26
3174071003,JAKARTA SELATAN,KEBAYORAN BARU,KRAMAT PELA,12737,7669,5065,2356,7421,2021-06-26
3173031002,JAKARTA BARAT,TAMAN SARI,KRUKUT,17023,11335,5681,2265,7946,2021-06-26
3174031005,JAKARTA SELATAN,MAMPANG PRAPATAN,KUNINGAN BARAT,11229,7377,3849,1533,5382,2021-06-26
3174021008,JAKARTA SELATAN,SETIA BUDI,KUNINGAN TIMUR,5331,3393,1936,1043,2979,2021-06-26
3171041005,JAKARTA PUSAT,SENEN,KWITANG,13487,8881,4604,2063,6667,2021-06-26
3172031003,JAKARTA UTARA,KOJA,LAGOA,51431,38307,13117,5595,18712,2021-06-26
3174061002,JAKARTA SELATAN,CILANDAK,LEBAK BULUS,32738,22105,10624,5783,16407,2021-06-26
3174091004,JAKARTA SELATAN,JAGAKARSA,LENTENG AGUNG,46600,34508,12089,6083,18172,2021-06-26
3175101007,JAKARTA TIMUR,CIPAYUNG,LUBANG BUAYA,55114,38812,16294,8308,24602,2021-06-26
3175081001,JAKARTA TIMUR,MAKASAR,MAKASAR,30013,19971,10034,4917,14951,2021-06-26
3175071006,JAKARTA TIMUR,DUREN SAWIT,MALAKA JAYA,26798,17584,9207,5420,14627,2021-06-26
3175071005,JAKARTA TIMUR,DUREN SAWIT,MALAKA SARI,23691,14856,8828,5362,14190,2021-06-26
3174031001,JAKARTA SELATAN,MAMPANG PRAPATAN,MAMPANG PRAPATAN,15885,11567,4313,2033,6346,2021-06-26
3173031005,JAKARTA BARAT,TAMAN SARI,MANGGA BESAR,6690,3882,2806,1439,4245,2021-06-26
3171021005,JAKARTA PUSAT,SAWAH BESAR,MANGGA DUA SELATAN,24940,16988,7948,3826,11774,2021-06-26
3174011007,JAKARTA SELATAN,TEBET,MANGGARAI,24972,17379,7588,3528,11116,2021-06-26
3174011006,JAKARTA SELATAN,TEBET,MANGGARAI SELATAN,20274,12875,7397,3176,10573,2021-06-26
3173031003,JAKARTA BARAT,TAMAN SARI,MAPHAR,14671,9416,5255,2551,7806,2021-06-26
3172041003,JAKARTA UTARA,CILINCING,MARUNDA,24385,15863,8519,2554,11073,2021-06-26
3174071001,JAKARTA SELATAN,KEBAYORAN BARU,MELAWAI,2386,1206,1179,812,1991,2021-06-26
3171061001,JAKARTA PUSAT,MENTENG,MENTENG,22450,16441,6004,3479,9483,2021-06-26
3174021005,JAKARTA SELATAN,SETIA BUDI,MENTENG ATAS,24369,15646,8718,3975,12693,2021-06-26
3174011003,JAKARTA SELATAN,TEBET,MENTENG DALAM,31623,21860,9753,5116,14869,2021-06-26
3173081003,JAKARTA BARAT,KEMBANGAN,MERUYA SELATAN,27261,18503,8749,4295,13044,2021-06-26
3173081002,JAKARTA BARAT,KEMBANGAN,MERUYA UTARA,38525,26038,12483,6872,19355,2021-06-26
3175101004,JAKARTA TIMUR,CIPAYUNG,MUNJUL,20582,14330,6249,3560,9809,2021-06-26
3172051002,JAKARTA UTARA,PADEMANGAN,PADEMANGAN BARAT,64756,46361,18389,7747,26136,2021-06-26
3172051001,JAKARTA UTARA,PADEMANGAN,PADEMANGAN TIMUR,32689,18710,13963,6848,20811,2021-06-26
3175011004,JAKARTA TIMUR,MATRAMAN,PAL MERIAM,17550,11961,5585,2691,8276,2021-06-26
3173071001,JAKARTA BARAT,PALMERAH,PALMERAH,54706,37551,17146,7945,25091,2021-06-26
3174081001,JAKARTA SELATAN,PANCORAN,PANCORAN,16983,11778,5204,2624,7828,2021-06-26
3172021003,JAKARTA UTARA,TANJUNG PRIOK,PAPANGGO,33902,23312,10573,4632,15205,2021-06-26
3171021001,JAKARTA PUSAT,SAWAH BESAR,PASAR BARU,11656,6375,5275,2890,8165,2021-06-26
3174021006,JAKARTA SELATAN,SETIA BUDI,PASAR MANGGIS,23415,15684,7725,3521,11246,2021-06-26
3174041001,JAKARTA SELATAN,PASAR MINGGU,PASAR MINGGU,21700,14192,7502,4513,12015,2021-06-26
3171041003,JAKARTA PUSAT,SENEN,PASEBAN,20652,13852,6795,3277,10072,2021-06-26
3173061005,JAKARTA BARAT,KALI DERES,PEGADUNGAN,65248,45260,19968,9025,28993,2021-06-26
3171061002,JAKARTA PUSAT,MENTENG,PEGANGSAAN,18427,12500,5925,2910,8835,2021-06-26
3172061002,JAKARTA UTARA,KELAPA GADING,PEGANGSAAN DUA,44451,24168,20264,10370,30634,2021-06-26
3172011004,JAKARTA UTARA,PENJARINGAN,PEJAGALAN,66008,44481,21507,10804,32311,2021-06-26
3174041006,JAKARTA SELATAN,PASAR MINGGU,PEJATEN BARAT,30591,19815,10765,5508,16273,2021-06-26
3174041005,JAKARTA SELATAN,PASAR MINGGU,PEJATEN TIMUR,50150,36170,13974,5972,19946,2021-06-26
3175051005,JAKARTA TIMUR,PASAR REBO,PEKAYON,37440,25319,12116,5992,18108,2021-06-26
3173041009,JAKARTA BARAT,TAMBORA,PEKOJAN,20921,14081,6835,3393,10228,2021-06-26
3174031003,JAKARTA SELATAN,MAMPANG PRAPATAN,PELA MAMPANG,37784,26075,11698,5556,17254,2021-06-26
3174081005,JAKARTA SELATAN,PANCORAN,PENGADEGAN,18685,11050,7630,3290,10920,2021-06-26
3175061003,JAKARTA TIMUR,CAKUNG,PENGGILINGAN,84511,64597,19912,9210,29122,2021-06-26
3172011001,JAKARTA UTARA,PENJARINGAN,PENJARINGAN,75505,54474,21020,7764,28784,2021-06-26
3174101001,JAKARTA SELATAN,PESANGGRAHAN,PESANGGRAHAN,23733,14306,9424,4843,14267,2021-06-26
3171071004,JAKARTA PUSAT,TANAH ABANG,PETAMBURAN,28974,22859,6111,2890,9001,2021-06-26
3174071008,JAKARTA SELATAN,KEBAYORAN BARU,PETOGOGAN,10203,6568,3634,1826,5460,2021-06-26
3171011004,JAKARTA PUSAT,GAMBIR,PETOJO SELATAN,13506,8608,4889,2984,7873,2021-06-26
3171011003,JAKARTA PUSAT,GAMBIR,PETOJO UTARA,16084,10937,5145,2685,7830,2021-06-26
3174101004,JAKARTA SELATAN,PESANGGRAHAN,PETUKANGAN SELATAN,32229,21188,11039,4872,15911,2021-06-26
3174101003,JAKARTA SELATAN,PESANGGRAHAN,PETUKANGAN UTARA,46427,31911,14513,6672,21185,2021-06-26
3175081002,JAKARTA TIMUR,MAKASAR,PINANG RANTI,23465,15914,7548,3416,10964,2021-06-26
3173031008,JAKARTA BARAT,TAMAN SARI,PINANGSIA,9405,5792,3612,1616,5228,2021-06-26
3175011001,JAKARTA TIMUR,MATRAMAN,PISANGAN BARU,27793,20452,7334,3773,11107,2021-06-26
3175021002,JAKARTA TIMUR,PULO GADUNG,PISANGAN TIMUR,35717,24245,11464,5541,17005,2021-06-26
3172011005,JAKARTA UTARA,PENJARINGAN,PLUIT,42979,24485,18464,12239,30703,2021-06-26
3175071002,JAKARTA TIMUR,DUREN SAWIT,PONDOK BAMBU,53658,36159,17486,8755,26241,2021-06-26
3175071004,JAKARTA TIMUR,DUREN SAWIT,PONDOK KELAPA,62704,43608,19081,10836,29917,2021-06-26
3175071007,JAKARTA TIMUR,DUREN SAWIT,PONDOK KOPI,30741,22177,8560,4288,12848,2021-06-26
3174061003,JAKARTA SELATAN,CILANDAK,PONDOK LABU,39778,26478,13289,6776,20065,2021-06-26
3174051002,JAKARTA SELATAN,KEBAYORAN LAMA,PONDOK PINANG,49276,33606,15649,9289,24938,2021-06-26
3175101003,JAKARTA TIMUR,CIPAYUNG,PONDOK RANGGON,21791,15691,6092,3752,9844,2021-06-26
3101011003,KAB.ADM.KEP.SERIBU,KEP. SERIBU UTARA,PULAU HARAPAN,1785,565,1220,665,1885,2021-06-26
3101011002,KAB.ADM.KEP.SERIBU,KEP. SERIBU UTARA,PULAU KELAPA,4729,1583,3146,1076,4222,2021-06-26
3101011001,KAB.ADM.KEP.SERIBU,KEP. SERIBU UTARA,PULAU PANGGANG,4667,1425,3242,1121,4363,2021-06-26
3101021003,KAB.ADM.KEP.SERIBU,KEP. SERIBU SELATAN,PULAU PARI,2370,479,1891,609,2500,2021-06-26
3101021002,KAB.ADM.KEP.SERIBU,KEP. SERIBU SELATAN,PULAU TIDUNG,3922,1283,2638,1127,3765,2021-06-26
3101021001,KAB.ADM.KEP.SERIBU,KEP. SERIBU SELATAN,PULAU UNTUNG JAWA,1665,482,1183,558,1741,2021-06-26
3174071007,JAKARTA SELATAN,KEBAYORAN BARU,PULO,5184,3036,2146,1332,3478,2021-06-26
3175021001,JAKARTA TIMUR,PULO GADUNG,PULO GADUNG,30292,21358,8926,4586,13512,2021-06-26
3175061005,JAKARTA TIMUR,CAKUNG,PULO GEBANG,83832,61140,22683,10477,33160,2021-06-26
3174041004,JAKARTA SELATAN,PASAR MINGGU,RAGUNAN,34536,22292,12231,5732,17963,2021-06-26
3175091005,JAKARTA TIMUR,CIRACAS,RAMBUTAN,31759,24052,7701,4233,11934,2021-06-26
3172031006,JAKARTA UTARA,KOJA,RAWA BADAK SELATAN,36403,27716,8684,3890,12574,2021-06-26
3172031004,JAKARTA UTARA,KOJA,RAWA BADAK UTARA,29198,20164,9031,3798,12829,2021-06-26
3174071005,JAKARTA SELATAN,KEBAYORAN BARU,RAWA BARAT,5029,2976,2052,1313,3365,2021-06-26
3173011003,JAKARTA BARAT,CENGKARENG,RAWA BUAYA,51752,34785,16959,5951,22910,2021-06-26
3175031004,JAKARTA TIMUR,JATINEGARA,RAWA BUNGA,18617,13778,4838,2449,7287,2021-06-26
3174081003,JAKARTA SELATAN,PANCORAN,RAWA JATI,18210,11699,6505,3373,9878,2021-06-26
3175061002,JAKARTA TIMUR,CAKUNG,RAWA TERATE,21332,13675,7655,2039,9694,2021-06-26
3175021005,JAKARTA TIMUR,PULO GADUNG,RAWAMANGUN,32470,21727,10736,5795,16531,2021-06-26
3171051003,JAKARTA PUSAT,CEMPAKA PUTIH,RAWASARI,19312,12840,6463,3446,9909,2021-06-26
3173041010,JAKARTA BARAT,TAMBORA,ROA MALAKA,3149,1714,1432,873,2305,2021-06-26
3172041006,JAKARTA UTARA,CILINCING,ROROTAN,35258,23574,11680,4527,16207,2021-06-26
3174071004,JAKARTA SELATAN,KEBAYORAN BARU,SELONG,2576,1339,1234,874,2108,2021-06-26
3173061002,JAKARTA BARAT,KALI DERES,SEMANAN,60715,45827,14883,4938,19821,2021-06-26
3172041007,JAKARTA UTARA,CILINCING,SEMPER BARAT,59323,39360,19948,8991,28939,2021-06-26
3172041005,JAKARTA UTARA,CILINCING,SEMPER TIMUR,31249,21537,9709,4262,13971,2021-06-26
3174071006,JAKARTA SELATAN,KEBAYORAN BARU,SENAYAN,2482,1630,849,564,1413,2021-06-26
3171041001,JAKARTA PUSAT,SENEN,SENEN,5951,3740,2210,1169,3379,2021-06-26
3171031004,JAKARTA PUSAT,KEMAYORAN,SERDANG,26045,17528,8514,3901,12415,2021-06-26
3174021001,JAKARTA SELATAN,SETIA BUDI,SETIA BUDI,2532,1511,1018,636,1654,2021-06-26
3175101005,JAKARTA TIMUR,CIPAYUNG,SETU,17609,12903,4704,2653,7357,2021-06-26
3173071002,JAKARTA BARAT,PALMERAH,SLIPI,14526,9372,5151,2698,7849,2021-06-26
3173081004,JAKARTA BARAT,KEMBANGAN,SRENGSENG,39370,27950,11406,6114,17520,2021-06-26
3174091002,JAKARTA SELATAN,JAGAKARSA,SRENGSENG SAWAH,50305,30672,19618,8841,28459,2021-06-26
3173051003,JAKARTA BARAT,KEBON JERUK,SUKABUMI SELATAN,30581,22437,8143,3446,11589,2021-06-26
3173051002,JAKARTA BARAT,KEBON JERUK,SUKABUMI UTARA,33050,24955,8092,3974,12066,2021-06-26
3172041002,JAKARTA UTARA,CILINCING,SUKAPURA,46955,33314,13634,5390,19024,2021-06-26
3171031007,JAKARTA PUSAT,KEMAYORAN,SUMUR BATU,19863,13150,6709,3358,10067,2021-06-26
3172021004,JAKARTA UTARA,TANJUNG PRIOK,SUNGAI BAMBU,25366,16961,8400,3480,11880,2021-06-26
3172021006,JAKARTA UTARA,TANJUNG PRIOK,SUNTER AGUNG,62904,37448,25428,13386,38814,2021-06-26
3172021002,JAKARTA UTARA,TANJUNG PRIOK,SUNTER JAYA,55168,35425,19722,10334,30056,2021-06-26
3175091004,JAKARTA TIMUR,CIRACAS,SUSUKAN,28884,19960,8922,4546,13468,2021-06-26
3173031001,JAKARTA BARAT,TAMAN SARI,TAMAN SARI,12915,8503,4410,2379,6789,2021-06-26
3173041001,JAKARTA BARAT,TAMBORA,TAMBORA,9087,6190,2897,1509,4406,2021-06-26
3173041004,JAKARTA BARAT,TAMBORA,TANAH SEREAL,23141,14567,8572,3850,12422,2021-06-26
3171081004,JAKARTA PUSAT,JOHAR BARU,TANAH TINGGI,32931,21563,11366,4220,15586,2021-06-26
3173031004,JAKARTA BARAT,TAMAN SARI,TANGKI,11593,7481,4109,1913,6022,2021-06-26
3174091005,JAKARTA SELATAN,JAGAKARSA,TANJUNG BARAT,34530,24418,10106,5603,15709,2021-06-26
3173021005,JAKARTA BARAT,GROGOL PETAMBURAN,TANJUNG DUREN SELATAN,22469,12995,9461,4414,13875,2021-06-26
3173021002,JAKARTA BARAT,GROGOL PETAMBURAN,TANJUNG DUREN UTARA,15224,8599,6619,3502,10121,2021-06-26
3172021001,JAKARTA UTARA,TANJUNG PRIOK,TANJUNG PRIOK,29913,18642,11262,3806,15068,2021-06-26
3174011002,JAKARTA SELATAN,TEBET,TEBET BARAT,18916,11762,7146,4136,11282,2021-06-26
3174011001,JAKARTA SELATAN,TEBET,TEBET TIMUR,16031,9296,6729,3699,10428,2021-06-26
3173061003,JAKARTA BARAT,KALI DERES,TEGAL ALUR,71923,53167,18749,6803,25552,2021-06-26
3174031004,JAKARTA SELATAN,MAMPANG PRAPATAN,TEGAL PARANG,28143,21510,6631,3280,9911,2021-06-26
3173021003,JAKARTA BARAT,GROGOL PETAMBURAN,TOMANG,25531,15716,9804,4932,14736,2021-06-26
3172031005,JAKARTA UTARA,KOJA,TUGU SELATAN,33663,24791,8867,3774,12641,2021-06-26
3172031002,JAKARTA UTARA,KOJA,TUGU UTARA,58638,44342,14292,6662,20954,2021-06-26
3175061006,JAKARTA TIMUR,CAKUNG,UJUNG MENTENG,25702,17255,8437,3923,12360,2021-06-26
3174101005,JAKARTA SELATAN,PESANGGRAHAN,ULUJAMI,35077,25115,9956,4894,14850,2021-06-26
3175011006,JAKARTA TIMUR,MATRAMAN,UTAN KAYU SELATAN,29303,19239,10053,4994,15047,2021-06-26
3175011002,JAKARTA TIMUR,MATRAMAN,UTAN KAYU UTARA,24728,16519,8208,3775,11983,2021-06-26
3171031008,JAKARTA PUSAT,KEMAYORAN,UTAN PANJANG,25622,18809,6812,2771,9583,2021-06-26
3172021007,JAKARTA UTARA,TANJUNG PRIOK,WARAKAS,38194,26341,11840,5155,16995,2021-06-26
3173021007,JAKARTA BARAT,GROGOL PETAMBURAN,WIJAYA KUSUMA,34170,23259,10902,4827,15729,2021-06-26
3172051003,JAKARTA UTARA,PADEMANGAN,ANCOL,20393,13653,6733,3273,10006,2021-06-27
3173041007,JAKARTA BARAT,TAMBORA,ANGKE,25785,17289,8487,3213,11700,2021-06-27
3175041005,JAKARTA TIMUR,KRAMAT JATI,BALE KAMBANG,25158,19569,5581,2613,8194,2021-06-27
3175031003,JAKARTA TIMUR,JATINEGARA,BALI MESTER,8683,5987,2693,1511,4204,2021-06-27
3175101006,JAKARTA TIMUR,CIPAYUNG,BAMBU APUS,22768,16012,6752,3959,10711,2021-06-27
3174031002,JAKARTA SELATAN,MAMPANG PRAPATAN,BANGKA,18930,13024,5900,2677,8577,2021-06-27
3175051002,JAKARTA TIMUR,PASAR REBO,BARU,20267,11910,8340,4660,13000,2021-06-27
3175041004,JAKARTA TIMUR,KRAMAT JATI,BATU AMPAR,41389,31269,10111,5197,15308,2021-06-27
3171071002,JAKARTA PUSAT,TANAH ABANG,BENDUNGAN HILIR,19008,12090,6911,3552,10463,2021-06-27
3175031002,JAKARTA TIMUR,JATINEGARA,BIDARA CINA,32331,24163,8164,4018,12182,2021-06-27
3174101002,JAKARTA SELATAN,PESANGGRAHAN,BINTARO,45843,32398,13434,7037,20471,2021-06-27
3174011005,JAKARTA SELATAN,TEBET,BUKIT DURI,29934,21421,8511,3933,12444,2021-06-27
3171041006,JAKARTA PUSAT,SENEN,BUNGUR,15932,10454,5462,2728,8190,2021-06-27
3175061007,JAKARTA TIMUR,CAKUNG,CAKUNG BARAT,49369,34265,15101,3988,19089,2021-06-27
3175061004,JAKARTA TIMUR,CAKUNG,CAKUNG TIMUR,50344,35069,15265,6345,21610,2021-06-27
3175041007,JAKARTA TIMUR,KRAMAT JATI,CAWANG,28708,20772,7931,4257,12188,2021-06-27
3175101008,JAKARTA TIMUR,CIPAYUNG,CEGER,16381,11225,5155,2556,7711,2021-06-27
3171031006,JAKARTA PUSAT,KEMAYORAN,CEMPAKA BARU,27330,19072,8248,3983,12231,2021-06-27
3171051002,JAKARTA PUSAT,CEMPAKA PUTIH,CEMPAKA PUTIH BARAT,30479,21546,8924,4947,13871,2021-06-27
3171051001,JAKARTA PUSAT,CEMPAKA PUTIH,CEMPAKA PUTIH TIMUR,21553,13829,7721,4418,12139,2021-06-27
3173011001,JAKARTA BARAT,CENGKARENG,CENGKARENG BARAT,57678,36207,21459,8202,29661,2021-06-27
3173011006,JAKARTA BARAT,CENGKARENG,CENGKARENG TIMUR,70122,48954,21158,8494,29652,2021-06-27
3175091002,JAKARTA TIMUR,CIRACAS,CIBUBUR,56927,38696,18220,9398,27618,2021-06-27
3171011002,JAKARTA PUSAT,GAMBIR,CIDENG,14203,8560,5635,3162,8797,2021-06-27
3174091003,JAKARTA SELATAN,JAGAKARSA,CIGANJUR,33127,22836,10280,5139,15419,2021-06-27
3175051003,JAKARTA TIMUR,PASAR REBO,CIJANTUNG,36027,24534,11483,6149,17632,2021-06-27
3171061003,JAKARTA PUSAT,MENTENG,CIKINI,7402,5040,2361,1366,3727,2021-06-27
3174081006,JAKARTA SELATAN,PANCORAN,CIKOKO,9280,5864,3416,1732,5148,2021-06-27
3174061001,JAKARTA SELATAN,CILANDAK,CILANDAK BARAT,45348,28568,16765,7826,24591,2021-06-27
3174041003,JAKARTA SELATAN,PASAR MINGGU,CILANDAK TIMUR,21207,13354,7843,4815,12658,2021-06-27
3175101002,JAKARTA TIMUR,CIPAYUNG,CILANGKAP,23675,16510,7158,3799,10957,2021-06-27
3175041006,JAKARTA TIMUR,KRAMAT JATI,CILILITAN,35164,25375,9780,5195,14975,2021-06-27
3172041001,JAKARTA UTARA,CILINCING,CILINCING,37003,27457,9539,3887,13426,2021-06-27
3175101001,JAKARTA TIMUR,CIPAYUNG,CIPAYUNG,22697,14832,7857,4203,12060,2021-06-27
3174091006,JAKARTA SELATAN,JAGAKARSA,CIPEDAK,32800,22325,10468,4767,15235,2021-06-27
3174061005,JAKARTA SELATAN,CILANDAK,CIPETE SELATAN,23463,15751,7709,3779,11488,2021-06-27
3174071010,JAKARTA SELATAN,KEBAYORAN BARU,CIPETE UTARA,29771,18883,10884,4057,14941,2021-06-27
3175021003,JAKARTA TIMUR,PULO GADUNG,CIPINANG,34608,23539,11060,5974,17034,2021-06-27
3175031007,JAKARTA TIMUR,JATINEGARA,CIPINANG BESAR SELATAN,30655,23124,7523,3871,11394,2021-06-27
3175031008,JAKARTA TIMUR,JATINEGARA,CIPINANG BESAR UTARA,38827,30630,8191,4163,12354,2021-06-27
3175031005,JAKARTA TIMUR,JATINEGARA,CIPINANG CEMPEDAK,29154,20591,8552,4670,13222,2021-06-27
3175081005,JAKARTA TIMUR,MAKASAR,CIPINANG MELAYU,37098,25087,12003,6359,18362,2021-06-27
3175031006,JAKARTA TIMUR,JATINEGARA,CIPINANG MUARA,46861,34216,12638,7251,19889,2021-06-27
3174051003,JAKARTA SELATAN,KEBAYORAN LAMA,CIPULIR,34708,24772,9931,4765,14696,2021-06-27
3175091001,JAKARTA TIMUR,CIRACAS,CIRACAS,55965,38028,17930,8343,26273,2021-06-27
3175041003,JAKARTA TIMUR,KRAMAT JATI,DUKUH,21239,15005,6230,3485,9715,2021-06-27
3175071001,JAKARTA TIMUR,DUREN SAWIT,DUREN SAWIT,53078,36649,16415,9164,25579,2021-06-27
3174081004,JAKARTA SELATAN,PANCORAN,DUREN TIGA,24673,16873,7794,3798,11592,2021-06-27
3173051005,JAKARTA BARAT,KEBON JERUK,DURI KEPA,52942,33058,19867,9902,29769,2021-06-27
3173011002,JAKARTA BARAT,CENGKARENG,DURI KOSAMBI,66093,45010,21074,8156,29230,2021-06-27
3171011006,JAKARTA PUSAT,GAMBIR,DURI PULO,17787,12625,5159,2370,7529,2021-06-27
3173041011,JAKARTA BARAT,TAMBORA,DURI SELATAN,12528,8013,4508,2354,6862,2021-06-27
3173041003,JAKARTA BARAT,TAMBORA,DURI UTARA,17380,11874,5503,2634,8137,2021-06-27
3171081003,JAKARTA PUSAT,JOHAR BARU,GALUR,15811,9872,5939,1956,7895,2021-06-27
3171011001,JAKARTA PUSAT,GAMBIR,GAMBIR,2232,1285,946,577,1523,2021-06-27
3174061004,JAKARTA SELATAN,CILANDAK,GANDARIA SELATAN,19394,12744,6642,2818,9460,2021-06-27
3174071009,JAKARTA SELATAN,KEBAYORAN BARU,GANDARIA UTARA,35026,23221,11800,5317,17117,2021-06-27
3175051001,JAKARTA TIMUR,PASAR REBO,GEDONG,31013,21424,9575,5241,14816,2021-06-27
3171071001,JAKARTA PUSAT,TANAH ABANG,GELORA,2753,1803,943,565,1508,2021-06-27
3173031007,JAKARTA BARAT,TAMAN SARI,GLODOK,7192,3762,3428,1972,5400,2021-06-27
3171061004,JAKARTA PUSAT,MENTENG,GONDANGDIA,3760,1933,1822,1279,3101,2021-06-27
3173021001,JAKARTA BARAT,GROGOL PETAMBURAN,GROGOL,15067,9996,5065,2590,7655,2021-06-27
3174051005,JAKARTA SELATAN,KEBAYORAN LAMA,GROGOL SELATAN,38688,27178,11502,5435,16937,2021-06-27
3174051004,JAKARTA SELATAN,KEBAYORAN LAMA,GROGOL UTARA,37234,26624,10593,5792,16385,2021-06-27
3174021007,JAKARTA SELATAN,SETIA BUDI,GUNTUR,3590,1983,1604,978,2582,2021-06-27
3174071002,JAKARTA SELATAN,KEBAYORAN BARU,GUNUNG,8309,5050,3258,2017,5275,2021-06-27
3171031005,JAKARTA PUSAT,KEMAYORAN,GUNUNG SAHARI SELATAN,17256,11428,5822,2801,8623,2021-06-27
3171021004,JAKARTA PUSAT,SAWAH BESAR,GUNUNG SAHARI UTARA,13937,7552,6379,3352,9731,2021-06-27
3175081004,JAKARTA TIMUR,MAKASAR,HALIM PERDANA KUSUMAH,24426,11622,12784,9189,21973,2021-06-27
3171031003,JAKARTA PUSAT,KEMAYORAN,HARAPAN MULIA,19987,14090,5893,2670,8563,2021-06-27
3174091001,JAKARTA SELATAN,JAGAKARSA,JAGAKARSA,53714,35318,18380,8433,26813,2021-06-27
3175021007,JAKARTA TIMUR,PULO GADUNG,JATI,28870,19114,9739,5545,15284,2021-06-27
3174041002,JAKARTA SELATAN,PASAR MINGGU,JATI PADANG,32857,21866,10982,5820,16802,2021-06-27
3173071004,JAKARTA BARAT,PALMERAH,JATI PULO,24508,14692,9813,3620,13433,2021-06-27
3175061001,JAKARTA TIMUR,CAKUNG,JATINEGARA,72652,56666,15986,6571,22557,2021-06-27
3175021004,JAKARTA TIMUR,PULO GADUNG,JATINEGARA KAUM,21313,15193,6117,2893,9010,2021-06-27
3173021004,JAKARTA BARAT,GROGOL PETAMBURAN,JELAMBAR,26984,16943,10030,5429,15459,2021-06-27
3173021006,JAKARTA BARAT,GROGOL PETAMBURAN,JELAMBAR BARU,33734,22049,11676,6038,17714,2021-06-27
3173041006,JAKARTA BARAT,TAMBORA,JEMBATAN BESI,25735,20077,5657,2417,8074,2021-06-27
3173041008,JAKARTA BARAT,TAMBORA,JEMBATAN LIMA,18241,13570,4665,2246,6911,2021-06-27
3173081005,JAKARTA BARAT,KEMBANGAN,JOGLO,35285,23889,11391,5903,17294,2021-06-27
3171081001,JAKARTA PUSAT,JOHAR BARU,JOHAR BARU,28311,16196,12109,5305,17414,2021-06-27
3173041002,JAKARTA BARAT,TAMBORA,KALI ANYAR,20624,15565,5057,2220,7277,2021-06-27
3172041004,JAKARTA UTARA,CILINCING,KALIBARU,57771,45776,11992,4299,16291,2021-06-27
3174081002,JAKARTA SELATAN,PANCORAN,KALIBATA,36451,26195,10255,4893,15148,2021-06-27
3173061001,JAKARTA BARAT,KALI DERES,KALIDERES,60209,42076,18114,7529,25643,2021-06-27
3175051004,JAKARTA TIMUR,PASAR REBO,KALISARI,37255,24899,12344,6708,19052,2021-06-27
3173061004,JAKARTA BARAT,KALI DERES,KAMAL,46035,35606,10425,3643,14068,2021-06-27
3172011002,JAKARTA UTARA,PENJARINGAN,KAMAL MUARA,11039,6172,4857,2493,7350,2021-06-27
3171071007,JAKARTA PUSAT,TANAH ABANG,KAMPUNG BALI,10113,7374,2739,1500,4239,2021-06-27
3175031001,JAKARTA TIMUR,JATINEGARA,KAMPUNG MELAYU,22293,17243,5047,2222,7269,2021-06-27
3171081002,JAKARTA PUSAT,JOHAR BARU,KAMPUNG RAWA,15550,7974,7573,2534,10107,2021-06-27
3175041002,JAKARTA TIMUR,KRAMAT JATI,KAMPUNG TENGAH,38048,28203,9836,5201,15037,2021-06-27
3173011005,JAKARTA BARAT,CENGKARENG,KAPUK,104630,76442,28180,9435,37615,2021-06-27
3172011003,JAKARTA UTARA,PENJARINGAN,KAPUK MUARA,31275,19672,11584,6610,18194,2021-06-27
3171021002,JAKARTA PUSAT,SAWAH BESAR,KARANG ANYAR,23056,15637,7408,3386,10794,2021-06-27
3174021004,JAKARTA SELATAN,SETIA BUDI,KARET,8542,5349,3191,1422,4613,2021-06-27
3174021003,JAKARTA SELATAN,SETIA BUDI,KARET KUNINGAN,14166,8847,5315,2305,7620,2021-06-27
3174021002,JAKARTA SELATAN,SETIA BUDI,KARET SEMANGGI,2469,1337,1129,596,1725,2021-06-27
3171071003,JAKARTA PUSAT,TANAH ABANG,KARET TENGSIN,16695,11695,4998,2185,7183,2021-06-27
3171021003,JAKARTA PUSAT,SAWAH BESAR,KARTINI,19916,12880,7032,3435,10467,2021-06-27
3175011003,JAKARTA TIMUR,MATRAMAN,KAYU MANIS,22174,15836,6336,2979,9315,2021-06-27
3175021006,JAKARTA TIMUR,PULO GADUNG,KAYU PUTIH,35916,22923,12975,6966,19941,2021-06-27
3173031006,JAKARTA BARAT,TAMAN SARI,KEAGUNGAN,15262,10616,4644,1987,6631,2021-06-27
3174041007,JAKARTA SELATAN,PASAR MINGGU,KEBAGUSAN,38396,26972,11415,5134,16549,2021-06-27
3174051006,JAKARTA SELATAN,KEBAYORAN LAMA,KEBAYORAN LAMA SELATAN,35920,23197,12714,5752,18466,2021-06-27
3174051001,JAKARTA SELATAN,KEBAYORAN LAMA,KEBAYORAN LAMA UTARA,37004,25942,11052,5204,16256,2021-06-27
3174011004,JAKARTA SELATAN,TEBET,KEBON BARU,30533,20531,9996,5074,15070,2021-06-27
3172021005,JAKARTA UTARA,TANJUNG PRIOK,KEBON BAWANG,44427,29909,14501,6862,21363,2021-06-27
3173051001,JAKARTA BARAT,KEBON JERUK,KEBON JERUK,46870,33687,13171,6741,19912,2021-06-27
3171071006,JAKARTA PUSAT,TANAH ABANG,KEBON KACANG,19075,14387,4685,2606,7291,2021-06-27
3171011005,JAKARTA PUSAT,GAMBIR,KEBON KELAPA,9383,6423,2959,1650,4609,2021-06-27
3171031002,JAKARTA PUSAT,KEMAYORAN,KEBON KOSONG,26178,18167,8007,3436,11443,2021-06-27
3175011005,JAKARTA TIMUR,MATRAMAN,KEBON MANGGIS,14644,9557,5081,2733,7814,2021-06-27
3171071005,JAKARTA PUSAT,TANAH ABANG,KEBON MELATI,27297,21503,5793,2846,8639,2021-06-27
3175081003,JAKARTA TIMUR,MAKASAR,KEBON PALA,40723,28615,12103,6122,18225,2021-06-27
3171061005,JAKARTA PUSAT,MENTENG,KEBON SIRIH,10880,8039,2841,1532,4373,2021-06-27
3173011004,JAKARTA BARAT,CENGKARENG,KEDAUNG KALI ANGKE,28123,16995,11123,3196,14319,2021-06-27
3173051007,JAKARTA BARAT,KEBON JERUK,KEDOYA SELATAN,28300,18633,9649,4565,14214,2021-06-27
3173051006,JAKARTA BARAT,KEBON JERUK,KEDOYA UTARA,38771,23488,15272,6917,22189,2021-06-27
3173051004,JAKARTA BARAT,KEBON JERUK,KELAPA DUA,20509,13862,6643,3099,9742,2021-06-27
3175091003,JAKARTA TIMUR,CIRACAS,KELAPA DUA WETAN,40776,27115,13649,7148,20797,2021-06-27
3172061003,JAKARTA UTARA,KELAPA GADING,KELAPA GADING BARAT,31544,17303,14217,8701,22918,2021-06-27
3172061001,JAKARTA UTARA,KELAPA GADING,KELAPA GADING TIMUR,30470,15466,14992,9063,24055,2021-06-27
3173071005,JAKARTA BARAT,PALMERAH,KEMANGGISAN,28159,18324,9827,5131,14958,2021-06-27
3171031001,JAKARTA PUSAT,KEMAYORAN,KEMAYORAN,18556,12236,6317,2792,9109,2021-06-27
3173081006,JAKARTA BARAT,KEMBANGAN,KEMBANGAN SELATAN,24028,15347,8663,4959,13622,2021-06-27
3173081001,JAKARTA BARAT,KEMBANGAN,KEMBANGAN UTARA,45663,29724,15927,6528,22455,2021-06-27
3171041002,JAKARTA PUSAT,SENEN,KENARI,8328,4927,3400,1723,5123,2021-06-27
3173041005,JAKARTA BARAT,TAMBORA,KERENDANG,17494,12662,4829,2207,7036,2021-06-27
3175071003,JAKARTA TIMUR,DUREN SAWIT,KLENDER,60420,44777,15638,7317,22955,2021-06-27
3172031001,JAKARTA UTARA,KOJA,KOJA,24600,17908,6691,2722,9413,2021-06-27
3173071006,JAKARTA BARAT,PALMERAH,KOTA BAMBU SELATAN,18287,12744,5541,2227,7768,2021-06-27
3173071003,JAKARTA BARAT,PALMERAH,KOTA BAMBU UTARA,21312,15074,6237,2756,8993,2021-06-27
3171041004,JAKARTA PUSAT,SENEN,KRAMAT,25258,18572,6684,2955,9639,2021-06-27
3175041001,JAKARTA TIMUR,KRAMAT JATI,KRAMAT JATI,29922,20443,9471,4952,14423,2021-06-27
3174071003,JAKARTA SELATAN,KEBAYORAN BARU,KRAMAT PELA,12737,7621,5113,2357,7470,2021-06-27
3173031002,JAKARTA BARAT,TAMAN SARI,KRUKUT,17023,11282,5734,2265,7999,2021-06-27
3174031005,JAKARTA SELATAN,MAMPANG PRAPATAN,KUNINGAN BARAT,11229,7305,3921,1536,5457,2021-06-27
3174021008,JAKARTA SELATAN,SETIA BUDI,KUNINGAN TIMUR,5331,3377,1952,1045,2997,2021-06-27
3171041005,JAKARTA PUSAT,SENEN,KWITANG,13487,8850,4635,2066,6701,2021-06-27
3172031003,JAKARTA UTARA,KOJA,LAGOA,51431,37998,13426,5604,19030,2021-06-27
3174061002,JAKARTA SELATAN,CILANDAK,LEBAK BULUS,32738,22010,10719,5785,16504,2021-06-27
3174091004,JAKARTA SELATAN,JAGAKARSA,LENTENG AGUNG,46600,34282,12315,6087,18402,2021-06-27
3175101007,JAKARTA TIMUR,CIPAYUNG,LUBANG BUAYA,55114,38666,16440,8319,24759,2021-06-27
3175081001,JAKARTA TIMUR,MAKASAR,MAKASAR,30013,19881,10124,4921,15045,2021-06-27
3175071006,JAKARTA TIMUR,DUREN SAWIT,MALAKA JAYA,26798,17513,9278,5425,14703,2021-06-27
3175071005,JAKARTA TIMUR,DUREN SAWIT,MALAKA SARI,23691,14809,8875,5365,14240,2021-06-27
3174031001,JAKARTA SELATAN,MAMPANG PRAPATAN,MAMPANG PRAPATAN,15885,11434,4446,2038,6484,2021-06-27
3173031005,JAKARTA BARAT,TAMAN SARI,MANGGA BESAR,6690,3858,2830,1439,4269,2021-06-27
3171021005,JAKARTA PUSAT,SAWAH BESAR,MANGGA DUA SELATAN,24940,16916,8020,3828,11848,2021-06-27
3174011007,JAKARTA SELATAN,TEBET,MANGGARAI,24972,17332,7635,3530,11165,2021-06-27
3174011006,JAKARTA SELATAN,TEBET,MANGGARAI SELATAN,20274,12805,7467,3178,10645,2021-06-27
3173031003,JAKARTA BARAT,TAMAN SARI,MAPHAR,14671,9369,5302,2553,7855,2021-06-27
3172041003,JAKARTA UTARA,CILINCING,MARUNDA,24385,15706,8676,2557,11233,2021-06-27
3174071001,JAKARTA SELATAN,KEBAYORAN BARU,MELAWAI,2386,1196,1189,812,2001,2021-06-27
3171061001,JAKARTA PUSAT,MENTENG,MENTENG,22450,16380,6065,3482,9547,2021-06-27
3174021005,JAKARTA SELATAN,SETIA BUDI,MENTENG ATAS,24369,15571,8793,3980,12773,2021-06-27
3174011003,JAKARTA SELATAN,TEBET,MENTENG DALAM,31623,21751,9862,5119,14981,2021-06-27
3173081003,JAKARTA BARAT,KEMBANGAN,MERUYA SELATAN,27261,18442,8810,4297,13107,2021-06-27
3173081002,JAKARTA BARAT,KEMBANGAN,MERUYA UTARA,38525,25886,12635,6881,19516,2021-06-27
3175101004,JAKARTA TIMUR,CIPAYUNG,MUNJUL,20582,14248,6331,3562,9893,2021-06-27
3172051002,JAKARTA UTARA,PADEMANGAN,PADEMANGAN BARAT,64756,46060,18690,7760,26450,2021-06-27
3172051001,JAKARTA UTARA,PADEMANGAN,PADEMANGAN TIMUR,32689,18581,14092,6855,20947,2021-06-27
3175011004,JAKARTA TIMUR,MATRAMAN,PAL MERIAM,17550,11911,5635,2694,8329,2021-06-27
3173071001,JAKARTA BARAT,PALMERAH,PALMERAH,54706,37375,17322,7946,25268,2021-06-27
3174081001,JAKARTA SELATAN,PANCORAN,PANCORAN,16983,11715,5267,2624,7891,2021-06-27
3172021003,JAKARTA UTARA,TANJUNG PRIOK,PAPANGGO,33902,23201,10684,4638,15322,2021-06-27
3171021001,JAKARTA PUSAT,SAWAH BESAR,PASAR BARU,11656,6338,5312,2895,8207,2021-06-27
3174021006,JAKARTA SELATAN,SETIA BUDI,PASAR MANGGIS,23415,15627,7782,3523,11305,2021-06-27
3174041001,JAKARTA SELATAN,PASAR MINGGU,PASAR MINGGU,21700,14124,7570,4516,12086,2021-06-27
3171041003,JAKARTA PUSAT,SENEN,PASEBAN,20652,13783,6864,3278,10142,2021-06-27
3173061005,JAKARTA BARAT,KALI DERES,PEGADUNGAN,65248,44974,20254,9034,29288,2021-06-27
3171061002,JAKARTA PUSAT,MENTENG,PEGANGSAAN,18427,12463,5962,2912,8874,2021-06-27
3172061002,JAKARTA UTARA,KELAPA GADING,PEGANGSAAN DUA,44451,23998,20434,10387,30821,2021-06-27
3172011004,JAKARTA UTARA,PENJARINGAN,PEJAGALAN,66008,44113,21875,10828,32703,2021-06-27
3174041006,JAKARTA SELATAN,PASAR MINGGU,PEJATEN BARAT,30591,19743,10837,5512,16349,2021-06-27
3174041005,JAKARTA SELATAN,PASAR MINGGU,PEJATEN TIMUR,50150,36038,14106,5975,20081,2021-06-27
3175051005,JAKARTA TIMUR,PASAR REBO,PEKAYON,37440,25223,12212,5997,18209,2021-06-27
3173041009,JAKARTA BARAT,TAMBORA,PEKOJAN,20921,14003,6913,3395,10308,2021-06-27
3174031003,JAKARTA SELATAN,MAMPANG PRAPATAN,PELA MAMPANG,37784,25857,11916,5561,17477,2021-06-27
3174081005,JAKARTA SELATAN,PANCORAN,PENGADEGAN,18685,10999,7681,3294,10975,2021-06-27
3175061003,JAKARTA TIMUR,CAKUNG,PENGGILINGAN,84511,64409,20100,9226,29326,2021-06-27
3172011001,JAKARTA UTARA,PENJARINGAN,PENJARINGAN,75505,54293,21201,7773,28974,2021-06-27
3174101001,JAKARTA SELATAN,PESANGGRAHAN,PESANGGRAHAN,23733,14249,9481,4848,14329,2021-06-27
3171071004,JAKARTA PUSAT,TANAH ABANG,PETAMBURAN,28974,22804,6166,2894,9060,2021-06-27
3174071008,JAKARTA SELATAN,KEBAYORAN BARU,PETOGOGAN,10203,6536,3666,1826,5492,2021-06-27
3171011004,JAKARTA PUSAT,GAMBIR,PETOJO SELATAN,13506,8569,4928,2985,7913,2021-06-27
3171011003,JAKARTA PUSAT,GAMBIR,PETOJO UTARA,16084,10850,5232,2686,7918,2021-06-27
3174101004,JAKARTA SELATAN,PESANGGRAHAN,PETUKANGAN SELATAN,32229,21118,11109,4875,15984,2021-06-27
3174101003,JAKARTA SELATAN,PESANGGRAHAN,PETUKANGAN UTARA,46427,31658,14766,6677,21443,2021-06-27
3175081002,JAKARTA TIMUR,MAKASAR,PINANG RANTI,23465,15853,7609,3420,11029,2021-06-27
3173031008,JAKARTA BARAT,TAMAN SARI,PINANGSIA,9405,5763,3641,1616,5257,2021-06-27
3175011001,JAKARTA TIMUR,MATRAMAN,PISANGAN BARU,27793,20372,7414,3778,11192,2021-06-27
3175021002,JAKARTA TIMUR,PULO GADUNG,PISANGAN TIMUR,35717,24167,11542,5557,17099,2021-06-27
3172011005,JAKARTA UTARA,PENJARINGAN,PLUIT,42979,24246,18702,12245,30947,2021-06-27
3175071002,JAKARTA TIMUR,DUREN SAWIT,PONDOK BAMBU,53658,36024,17621,8761,26382,2021-06-27
3175071004,JAKARTA TIMUR,DUREN SAWIT,PONDOK KELAPA,62704,43007,19682,10847,30529,2021-06-27
3175071007,JAKARTA TIMUR,DUREN SAWIT,PONDOK KOPI,30741,22119,8618,4293,12911,2021-06-27
3174061003,JAKARTA SELATAN,CILANDAK,PONDOK LABU,39778,26342,13424,6786,20210,2021-06-27
3174051002,JAKARTA SELATAN,KEBAYORAN LAMA,PONDOK PINANG,49276,33377,15878,9295,25173,2021-06-27
3175101003,JAKARTA TIMUR,CIPAYUNG,PONDOK RANGGON,21791,15600,6183,3755,9938,2021-06-27
3101011003,KAB.ADM.KEP.SERIBU,KEP. SERIBU UTARA,PULAU HARAPAN,1785,555,1230,665,1895,2021-06-27
3101011002,KAB.ADM.KEP.SERIBU,KEP. SERIBU UTARA,PULAU KELAPA,4729,1555,3174,1076,4250,2021-06-27
3101011001,KAB.ADM.KEP.SERIBU,KEP. SERIBU UTARA,PULAU PANGGANG,4667,1414,3253,1130,4383,2021-06-27
3101021003,KAB.ADM.KEP.SERIBU,KEP. SERIBU SELATAN,PULAU PARI,2370,468,1902,609,2511,2021-06-27
3101021002,KAB.ADM.KEP.SERIBU,KEP. SERIBU SELATAN,PULAU TIDUNG,3922,1270,2651,1128,3779,2021-06-27
3101021001,KAB.ADM.KEP.SERIBU,KEP. SERIBU SELATAN,PULAU UNTUNG JAWA,1665,473,1192,558,1750,2021-06-27
3174071007,JAKARTA SELATAN,KEBAYORAN BARU,PULO,5184,2999,2183,1333,3516,2021-06-27
3175021001,JAKARTA TIMUR,PULO GADUNG,PULO GADUNG,30292,21267,9016,4595,13611,2021-06-27
3175061005,JAKARTA TIMUR,CAKUNG,PULO GEBANG,83832,60938,22885,10489,33374,2021-06-27
3174041004,JAKARTA SELATAN,PASAR MINGGU,RAGUNAN,34536,22187,12336,5738,18074,2021-06-27
3175091005,JAKARTA TIMUR,CIRACAS,RAMBUTAN,31759,23976,7777,4236,12013,2021-06-27
3172031006,JAKARTA UTARA,KOJA,RAWA BADAK SELATAN,36403,27492,8908,3900,12808,2021-06-27
3172031004,JAKARTA UTARA,KOJA,RAWA BADAK UTARA,29198,19888,9307,3805,13112,2021-06-27
3174071005,JAKARTA SELATAN,KEBAYORAN BARU,RAWA BARAT,5029,2951,2077,1314,3391,2021-06-27
3173011003,JAKARTA BARAT,CENGKARENG,RAWA BUAYA,51752,34501,17243,5956,23199,2021-06-27
3175031004,JAKARTA TIMUR,JATINEGARA,RAWA BUNGA,18617,13733,4883,2452,7335,2021-06-27
3174081003,JAKARTA SELATAN,PANCORAN,RAWA JATI,18210,11641,6563,3376,9939,2021-06-27
3175061002,JAKARTA TIMUR,CAKUNG,RAWA TERATE,21332,13619,7711,2044,9755,2021-06-27
3175021005,JAKARTA TIMUR,PULO GADUNG,RAWAMANGUN,32470,21644,10819,5801,16620,2021-06-27
3171051003,JAKARTA PUSAT,CEMPAKA PUTIH,RAWASARI,19312,12775,6528,3455,9983,2021-06-27
3173041010,JAKARTA BARAT,TAMBORA,ROA MALAKA,3149,1700,1446,873,2319,2021-06-27
3172041006,JAKARTA UTARA,CILINCING,ROROTAN,35258,23433,11821,4534,16355,2021-06-27
3174071004,JAKARTA SELATAN,KEBAYORAN BARU,SELONG,2576,1329,1244,875,2119,2021-06-27
3173061002,JAKARTA BARAT,KALI DERES,SEMANAN,60715,45751,14959,4940,19899,2021-06-27
3172041007,JAKARTA UTARA,CILINCING,SEMPER BARAT,59323,39205,20103,9001,29104,2021-06-27
3172041005,JAKARTA UTARA,CILINCING,SEMPER TIMUR,31249,21465,9781,4269,14050,2021-06-27
3174071006,JAKARTA SELATAN,KEBAYORAN BARU,SENAYAN,2482,1615,864,564,1428,2021-06-27
3171041001,JAKARTA PUSAT,SENEN,SENEN,5951,3725,2225,1170,3395,2021-06-27
3171031004,JAKARTA PUSAT,KEMAYORAN,SERDANG,26045,17483,8559,3908,12467,2021-06-27
3174021001,JAKARTA SELATAN,SETIA BUDI,SETIA BUDI,2532,1508,1021,636,1657,2021-06-27
3175101005,JAKARTA TIMUR,CIPAYUNG,SETU,17609,12863,4744,2656,7400,2021-06-27
3173071002,JAKARTA BARAT,PALMERAH,SLIPI,14526,9332,5191,2702,7893,2021-06-27
3173081004,JAKARTA BARAT,KEMBANGAN,SRENGSENG,39370,27850,11506,6117,17623,2021-06-27
3174091002,JAKARTA SELATAN,JAGAKARSA,SRENGSENG SAWAH,50305,30578,19712,8848,28560,2021-06-27
3173051003,JAKARTA BARAT,KEBON JERUK,SUKABUMI SELATAN,30581,22391,8189,3446,11635,2021-06-27
3173051002,JAKARTA BARAT,KEBON JERUK,SUKABUMI UTARA,33050,24884,8163,3978,12141,2021-06-27
3172041002,JAKARTA UTARA,CILINCING,SUKAPURA,46955,33209,13739,5401,19140,2021-06-27
3171031007,JAKARTA PUSAT,KEMAYORAN,SUMUR BATU,19863,13105,6754,3366,10120,2021-06-27
3172021004,JAKARTA UTARA,TANJUNG PRIOK,SUNGAI BAMBU,25366,16919,8442,3486,11928,2021-06-27
3172021006,JAKARTA UTARA,TANJUNG PRIOK,SUNTER AGUNG,62904,37176,25700,13407,39107,2021-06-27
3172021002,JAKARTA UTARA,TANJUNG PRIOK,SUNTER JAYA,55168,35269,19878,10359,30237,2021-06-27
3175091004,JAKARTA TIMUR,CIRACAS,SUSUKAN,28884,19831,9051,4551,13602,2021-06-27
3173031001,JAKARTA BARAT,TAMAN SARI,TAMAN SARI,12915,8452,4461,2380,6841,2021-06-27
3173041001,JAKARTA BARAT,TAMBORA,TAMBORA,9087,6158,2929,1510,4439,2021-06-27
3173041004,JAKARTA BARAT,TAMBORA,TANAH SEREAL,23141,14469,8670,3855,12525,2021-06-27
3171081004,JAKARTA PUSAT,JOHAR BARU,TANAH TINGGI,32931,21374,11555,4224,15779,2021-06-27
3173031004,JAKARTA BARAT,TAMAN SARI,TANGKI,11593,7439,4151,1915,6066,2021-06-27
3174091005,JAKARTA SELATAN,JAGAKARSA,TANJUNG BARAT,34530,24320,10204,5605,15809,2021-06-27
3173021005,JAKARTA BARAT,GROGOL PETAMBURAN,TANJUNG DUREN SELATAN,22469,12905,9551,4423,13974,2021-06-27
3173021002,JAKARTA BARAT,GROGOL PETAMBURAN,TANJUNG DUREN UTARA,15224,8512,6706,3507,10213,2021-06-27
3172021001,JAKARTA UTARA,TANJUNG PRIOK,TANJUNG PRIOK,29913,18578,11326,3808,15134,2021-06-27
3174011002,JAKARTA SELATAN,TEBET,TEBET BARAT,18916,11681,7227,4136,11363,2021-06-27
3174011001,JAKARTA SELATAN,TEBET,TEBET TIMUR,16031,9234,6791,3699,10490,2021-06-27
3173061003,JAKARTA BARAT,KALI DERES,TEGAL ALUR,71923,52963,18953,6810,25763,2021-06-27
3174031004,JAKARTA SELATAN,MAMPANG PRAPATAN,TEGAL PARANG,28143,21353,6788,3280,10068,2021-06-27
3173021003,JAKARTA BARAT,GROGOL PETAMBURAN,TOMANG,25531,15613,9907,4944,14851,2021-06-27
3172031005,JAKARTA UTARA,KOJA,TUGU SELATAN,33663,24694,8964,3780,12744,2021-06-27
3172031002,JAKARTA UTARA,KOJA,TUGU UTARA,58638,44064,14570,6671,21241,2021-06-27
3175061006,JAKARTA TIMUR,CAKUNG,UJUNG MENTENG,25702,17184,8508,3928,12436,2021-06-27
3174101005,JAKARTA SELATAN,PESANGGRAHAN,ULUJAMI,35077,24962,10109,4896,15005,2021-06-27
3175011006,JAKARTA TIMUR,MATRAMAN,UTAN KAYU SELATAN,29303,19167,10125,5001,15126,2021-06-27
3175011002,JAKARTA TIMUR,MATRAMAN,UTAN KAYU UTARA,24728,16467,8260,3778,12038,2021-06-27
3171031008,JAKARTA PUSAT,KEMAYORAN,UTAN PANJANG,25622,18777,6844,2774,9618,2021-06-27
3172021007,JAKARTA UTARA,TANJUNG PRIOK,WARAKAS,38194,26249,11932,5159,17091,2021-06-27
3173021007,JAKARTA BARAT,GROGOL PETAMBURAN,WIJAYA KUSUMA,34170,23146,11015,4834,15849,2021-06-27
3172051003,JAKARTA UTARA,PADEMANGAN,ANCOL,20393,13623,6763,3273,10036,2021-06-28
3173041007,JAKARTA BARAT,TAMBORA,ANGKE,25785,17237,8539,3213,11752,2021-06-28
3175041005,JAKARTA TIMUR,KRAMAT JATI,BALE KAMBANG,25158,19537,5613,2615,8228,2021-06-28
3175031003,JAKARTA TIMUR,JATINEGARA,BALI MESTER,8683,5958,2722,1512,4234,2021-06-28
3175101006,JAKARTA TIMUR,CIPAYUNG,BAMBU APUS,22768,15989,6775,3959,10734,2021-06-28
3174031002,JAKARTA SELATAN,MAMPANG PRAPATAN,BANGKA,18930,12985,5939,2678,8617,2021-06-28
3175051002,JAKARTA TIMUR,PASAR REBO,BARU,20267,11887,8363,4660,13023,2021-06-28
3175041004,JAKARTA TIMUR,KRAMAT JATI,BATU AMPAR,41389,31220,10160,5198,15358,2021-06-28
3171071002,JAKARTA PUSAT,TANAH ABANG,BENDUNGAN HILIR,19008,12070,6931,3552,10483,2021-06-28
3175031002,JAKARTA TIMUR,JATINEGARA,BIDARA CINA,32331,24128,8199,4021,12220,2021-06-28
3174101002,JAKARTA SELATAN,PESANGGRAHAN,BINTARO,45843,32347,13485,7038,20523,2021-06-28
3174011005,JAKARTA SELATAN,TEBET,BUKIT DURI,29934,21395,8537,3935,12472,2021-06-28
3171041006,JAKARTA PUSAT,SENEN,BUNGUR,15932,10441,5475,2728,8203,2021-06-28
3175061007,JAKARTA TIMUR,CAKUNG,CAKUNG BARAT,49369,34220,15146,3990,19136,2021-06-28
3175061004,JAKARTA TIMUR,CAKUNG,CAKUNG TIMUR,50344,35029,15305,6351,21656,2021-06-28
3175041007,JAKARTA TIMUR,KRAMAT JATI,CAWANG,28708,20723,7980,4260,12240,2021-06-28
3175101008,JAKARTA TIMUR,CIPAYUNG,CEGER,16381,11201,5179,2557,7736,2021-06-28
3171031006,JAKARTA PUSAT,KEMAYORAN,CEMPAKA BARU,27330,19050,8270,3988,12258,2021-06-28
3171051002,JAKARTA PUSAT,CEMPAKA PUTIH,CEMPAKA PUTIH BARAT,30479,21528,8942,4948,13890,2021-06-28
3171051001,JAKARTA PUSAT,CEMPAKA PUTIH,CEMPAKA PUTIH TIMUR,21553,13819,7731,4421,12152,2021-06-28
3173011001,JAKARTA BARAT,CENGKARENG,CENGKARENG BARAT,57678,35917,21749,8202,29951,2021-06-28
3173011006,JAKARTA BARAT,CENGKARENG,CENGKARENG TIMUR,70122,48671,21441,8496,29937,2021-06-28
3175091002,JAKARTA TIMUR,CIRACAS,CIBUBUR,56927,38593,18323,9403,27726,2021-06-28
3171011002,JAKARTA PUSAT,GAMBIR,CIDENG,14203,8542,5653,3162,8815,2021-06-28
3174091003,JAKARTA SELATAN,JAGAKARSA,CIGANJUR,33127,22785,10331,5141,15472,2021-06-28
3175051003,JAKARTA TIMUR,PASAR REBO,CIJANTUNG,36027,24229,11788,6152,17940,2021-06-28
3171061003,JAKARTA PUSAT,MENTENG,CIKINI,7402,5031,2370,1366,3736,2021-06-28
3174081006,JAKARTA SELATAN,PANCORAN,CIKOKO,9280,5852,3428,1732,5160,2021-06-28
3174061001,JAKARTA SELATAN,CILANDAK,CILANDAK BARAT,45348,28473,16860,7827,24687,2021-06-28
3174041003,JAKARTA SELATAN,PASAR MINGGU,CILANDAK TIMUR,21207,13268,7929,4818,12747,2021-06-28
3175101002,JAKARTA TIMUR,CIPAYUNG,CILANGKAP,23675,16408,7260,3800,11060,2021-06-28
3175041006,JAKARTA TIMUR,KRAMAT JATI,CILILITAN,35164,25216,9939,5200,15139,2021-06-28
3172041001,JAKARTA UTARA,CILINCING,CILINCING,37003,27426,9570,3895,13465,2021-06-28
3175101001,JAKARTA TIMUR,CIPAYUNG,CIPAYUNG,22697,14777,7912,4203,12115,2021-06-28
3174091006,JAKARTA SELATAN,JAGAKARSA,CIPEDAK,32800,22280,10513,4769,15282,2021-06-28
3174061005,JAKARTA SELATAN,CILANDAK,CIPETE SELATAN,23463,15713,7747,3779,11526,2021-06-28
3174071010,JAKARTA SELATAN,KEBAYORAN BARU,CIPETE UTARA,29771,18848,10919,4057,14976,2021-06-28
3175021003,JAKARTA TIMUR,PULO GADUNG,CIPINANG,34608,23488,11111,5977,17088,2021-06-28
3175031007,JAKARTA TIMUR,JATINEGARA,CIPINANG BESAR SELATAN,30655,23093,7554,3876,11430,2021-06-28
3175031008,JAKARTA TIMUR,JATINEGARA,CIPINANG BESAR UTARA,38827,30599,8222,4172,12394,2021-06-28
3175031005,JAKARTA TIMUR,JATINEGARA,CIPINANG CEMPEDAK,29154,20560,8583,4670,13253,2021-06-28
3175081005,JAKARTA TIMUR,MAKASAR,CIPINANG MELAYU,37098,25049,12041,6362,18403,2021-06-28
3175031006,JAKARTA TIMUR,JATINEGARA,CIPINANG MUARA,46861,34166,12688,7257,19945,2021-06-28
3174051003,JAKARTA SELATAN,KEBAYORAN LAMA,CIPULIR,34708,24727,9976,4765,14741,2021-06-28
3175091001,JAKARTA TIMUR,CIRACAS,CIRACAS,55965,37664,18294,8346,26640,2021-06-28
3175041003,JAKARTA TIMUR,KRAMAT JATI,DUKUH,21239,14989,6246,3486,9732,2021-06-28
3175071001,JAKARTA TIMUR,DUREN SAWIT,DUREN SAWIT,53078,36601,16463,9167,25630,2021-06-28
3174081004,JAKARTA SELATAN,PANCORAN,DUREN TIGA,24673,16836,7831,3798,11629,2021-06-28
3173051005,JAKARTA BARAT,KEBON JERUK,DURI KEPA,52942,32939,19986,9902,29888,2021-06-28
3173011002,JAKARTA BARAT,CENGKARENG,DURI KOSAMBI,66093,44913,21171,8159,29330,2021-06-28
3171011006,JAKARTA PUSAT,GAMBIR,DURI PULO,17787,12595,5189,2370,7559,2021-06-28
3173041011,JAKARTA BARAT,TAMBORA,DURI SELATAN,12528,7990,4531,2354,6885,2021-06-28
3173041003,JAKARTA BARAT,TAMBORA,DURI UTARA,17380,11826,5551,2634,8185,2021-06-28
3171081003,JAKARTA PUSAT,JOHAR BARU,GALUR,15811,9866,5945,1959,7904,2021-06-28
3171011001,JAKARTA PUSAT,GAMBIR,GAMBIR,2232,1285,946,577,1523,2021-06-28
3174061004,JAKARTA SELATAN,CILANDAK,GANDARIA SELATAN,19394,12713,6673,2819,9492,2021-06-28
3174071009,JAKARTA SELATAN,KEBAYORAN BARU,GANDARIA UTARA,35026,23178,11843,5318,17161,2021-06-28
3175051001,JAKARTA TIMUR,PASAR REBO,GEDONG,31013,21375,9624,5244,14868,2021-06-28
3171071001,JAKARTA PUSAT,TANAH ABANG,GELORA,2753,1800,946,565,1511,2021-06-28
3173031007,JAKARTA BARAT,TAMAN SARI,GLODOK,7192,3748,3442,1972,5414,2021-06-28
3171061004,JAKARTA PUSAT,MENTENG,GONDANGDIA,3760,1930,1825,1279,3104,2021-06-28
3173021001,JAKARTA BARAT,GROGOL PETAMBURAN,GROGOL,15067,9969,5092,2590,7682,2021-06-28
3174051005,JAKARTA SELATAN,KEBAYORAN LAMA,GROGOL SELATAN,38688,27139,11540,5436,16976,2021-06-28
3174051004,JAKARTA SELATAN,KEBAYORAN LAMA,GROGOL UTARA,37234,26594,10623,5792,16415,2021-06-28
3174021007,JAKARTA SELATAN,SETIA BUDI,GUNTUR,3590,1975,1612,978,2590,2021-06-28
3174071002,JAKARTA SELATAN,KEBAYORAN BARU,GUNUNG,8309,5039,3269,2018,5287,2021-06-28
3171031005,JAKARTA PUSAT,KEMAYORAN,GUNUNG SAHARI SELATAN,17256,11400,5850,2801,8651,2021-06-28
3171021004,JAKARTA PUSAT,SAWAH BESAR,GUNUNG SAHARI UTARA,13937,7520,6411,3352,9763,2021-06-28
3175081004,JAKARTA TIMUR,MAKASAR,HALIM PERDANA KUSUMAH,24426,11591,12815,9190,22005,2021-06-28
3171031003,JAKARTA PUSAT,KEMAYORAN,HARAPAN MULIA,19987,14084,5899,2675,8574,2021-06-28
3174091001,JAKARTA SELATAN,JAGAKARSA,JAGAKARSA,53714,35179,18519,8436,26955,2021-06-28
3175021007,JAKARTA TIMUR,PULO GADUNG,JATI,28870,19086,9767,5546,15313,2021-06-28
3174041002,JAKARTA SELATAN,PASAR MINGGU,JATI PADANG,32857,21810,11038,5821,16859,2021-06-28
3173071004,JAKARTA BARAT,PALMERAH,JATI PULO,24508,14674,9831,3623,13454,2021-06-28
3175061001,JAKARTA TIMUR,CAKUNG,JATINEGARA,72652,56620,16032,6580,22612,2021-06-28
3175021004,JAKARTA TIMUR,PULO GADUNG,JATINEGARA KAUM,21313,15180,6130,2896,9026,2021-06-28
3173021004,JAKARTA BARAT,GROGOL PETAMBURAN,JELAMBAR,26984,16895,10078,5429,15507,2021-06-28
3173021006,JAKARTA BARAT,GROGOL PETAMBURAN,JELAMBAR BARU,33734,21960,11765,6038,17803,2021-06-28
3173041006,JAKARTA BARAT,TAMBORA,JEMBATAN BESI,25735,20051,5683,2417,8100,2021-06-28
3173041008,JAKARTA BARAT,TAMBORA,JEMBATAN LIMA,18241,13539,4696,2247,6943,2021-06-28
3173081005,JAKARTA BARAT,KEMBANGAN,JOGLO,35285,23845,11435,5903,17338,2021-06-28
3171081001,JAKARTA PUSAT,JOHAR BARU,JOHAR BARU,28311,16157,12148,5308,17456,2021-06-28
3173041002,JAKARTA BARAT,TAMBORA,KALI ANYAR,20624,15549,5073,2220,7293,2021-06-28
3172041004,JAKARTA UTARA,CILINCING,KALIBARU,57771,45752,12016,4300,16316,2021-06-28
3174081002,JAKARTA SELATAN,PANCORAN,KALIBATA,36451,26150,10300,4893,15193,2021-06-28
3173061001,JAKARTA BARAT,KALI DERES,KALIDERES,60209,41987,18203,7529,25732,2021-06-28
3175051004,JAKARTA TIMUR,PASAR REBO,KALISARI,37255,24829,12414,6711,19125,2021-06-28
3173061004,JAKARTA BARAT,KALI DERES,KAMAL,46035,35562,10469,3643,14112,2021-06-28
3172011002,JAKARTA UTARA,PENJARINGAN,KAMAL MUARA,11039,6145,4884,2494,7378,2021-06-28
3171071007,JAKARTA PUSAT,TANAH ABANG,KAMPUNG BALI,10113,7366,2747,1501,4248,2021-06-28
3175031001,JAKARTA TIMUR,JATINEGARA,KAMPUNG MELAYU,22293,17206,5084,2224,7308,2021-06-28
3171081002,JAKARTA PUSAT,JOHAR BARU,KAMPUNG RAWA,15550,7964,7583,2535,10118,2021-06-28
3175041002,JAKARTA TIMUR,KRAMAT JATI,KAMPUNG TENGAH,38048,28155,9884,5202,15086,2021-06-28
3173011005,JAKARTA BARAT,CENGKARENG,KAPUK,104630,76298,28324,9435,37759,2021-06-28
3172011003,JAKARTA UTARA,PENJARINGAN,KAPUK MUARA,31275,19585,11671,6610,18281,2021-06-28
3171021002,JAKARTA PUSAT,SAWAH BESAR,KARANG ANYAR,23056,15609,7436,3388,10824,2021-06-28
3174021004,JAKARTA SELATAN,SETIA BUDI,KARET,8542,5339,3201,1422,4623,2021-06-28
3174021003,JAKARTA SELATAN,SETIA BUDI,KARET KUNINGAN,14166,8826,5336,2307,7643,2021-06-28
3174021002,JAKARTA SELATAN,SETIA BUDI,KARET SEMANGGI,2469,1335,1131,596,1727,2021-06-28
3171071003,JAKARTA PUSAT,TANAH ABANG,KARET TENGSIN,16695,11668,5025,2185,7210,2021-06-28
3171021003,JAKARTA PUSAT,SAWAH BESAR,KARTINI,19916,12860,7052,3436,10488,2021-06-28
3175011003,JAKARTA TIMUR,MATRAMAN,KAYU MANIS,22174,15820,6352,2983,9335,2021-06-28
3175021006,JAKARTA TIMUR,PULO GADUNG,KAYU PUTIH,35916,22895,13003,6968,19971,2021-06-28
3173031006,JAKARTA BARAT,TAMAN SARI,KEAGUNGAN,15262,10595,4665,1987,6652,2021-06-28
3174041007,JAKARTA SELATAN,PASAR MINGGU,KEBAGUSAN,38396,26928,11459,5137,16596,2021-06-28
3174051006,JAKARTA SELATAN,KEBAYORAN LAMA,KEBAYORAN LAMA SELATAN,35920,23147,12764,5753,18517,2021-06-28
3174051001,JAKARTA SELATAN,KEBAYORAN LAMA,KEBAYORAN LAMA UTARA,37004,25892,11102,5204,16306,2021-06-28
3174011004,JAKARTA SELATAN,TEBET,KEBON BARU,30533,20511,10016,5075,15091,2021-06-28
3172021005,JAKARTA UTARA,TANJUNG PRIOK,KEBON BAWANG,44427,29880,14530,6866,21396,2021-06-28
3173051001,JAKARTA BARAT,KEBON JERUK,KEBON JERUK,46870,33624,13234,6742,19976,2021-06-28
3171071006,JAKARTA PUSAT,TANAH ABANG,KEBON KACANG,19075,14378,4694,2608,7302,2021-06-28
3171011005,JAKARTA PUSAT,GAMBIR,KEBON KELAPA,9383,6419,2963,1650,4613,2021-06-28
3171031002,JAKARTA PUSAT,KEMAYORAN,KEBON KOSONG,26178,18148,8026,3438,11464,2021-06-28
3175011005,JAKARTA TIMUR,MATRAMAN,KEBON MANGGIS,14644,9547,5091,2734,7825,2021-06-28
3171071005,JAKARTA PUSAT,TANAH ABANG,KEBON MELATI,27297,21479,5817,2847,8664,2021-06-28
3175081003,JAKARTA TIMUR,MAKASAR,KEBON PALA,40723,28533,12185,6129,18314,2021-06-28
3171061005,JAKARTA PUSAT,MENTENG,KEBON SIRIH,10880,8033,2847,1532,4379,2021-06-28
3173011004,JAKARTA BARAT,CENGKARENG,KEDAUNG KALI ANGKE,28123,16973,11145,3196,14341,2021-06-28
3173051007,JAKARTA BARAT,KEBON JERUK,KEDOYA SELATAN,28300,18598,9684,4565,14249,2021-06-28
3173051006,JAKARTA BARAT,KEBON JERUK,KEDOYA UTARA,38771,23426,15334,6921,22255,2021-06-28
3173051004,JAKARTA BARAT,KEBON JERUK,KELAPA DUA,20509,13844,6661,3100,9761,2021-06-28
3175091003,JAKARTA TIMUR,CIRACAS,KELAPA DUA WETAN,40776,26969,13795,7154,20949,2021-06-28
3172061003,JAKARTA UTARA,KELAPA GADING,KELAPA GADING BARAT,31544,17272,14248,8718,22966,2021-06-28
3172061001,JAKARTA UTARA,KELAPA GADING,KELAPA GADING TIMUR,30470,15447,15011,9063,24074,2021-06-28
3173071005,JAKARTA BARAT,PALMERAH,KEMANGGISAN,28159,18294,9857,5133,14990,2021-06-28
3171031001,JAKARTA PUSAT,KEMAYORAN,KEMAYORAN,18556,12219,6334,2792,9126,2021-06-28
3173081006,JAKARTA BARAT,KEMBANGAN,KEMBANGAN SELATAN,24028,15313,8697,4960,13657,2021-06-28
3173081001,JAKARTA BARAT,KEMBANGAN,KEMBANGAN UTARA,45663,29701,15950,6528,22478,2021-06-28
3171041002,JAKARTA PUSAT,SENEN,KENARI,8328,4923,3404,1725,5129,2021-06-28
3173041005,JAKARTA BARAT,TAMBORA,KERENDANG,17494,12628,4863,2207,7070,2021-06-28
3175071003,JAKARTA TIMUR,DUREN SAWIT,KLENDER,60420,44701,15714,7330,23044,2021-06-28
3172031001,JAKARTA UTARA,KOJA,KOJA,24600,17890,6709,2723,9432,2021-06-28
3173071006,JAKARTA BARAT,PALMERAH,KOTA BAMBU SELATAN,18287,12733,5552,2227,7779,2021-06-28
3173071003,JAKARTA BARAT,PALMERAH,KOTA BAMBU UTARA,21312,15064,6247,2757,9004,2021-06-28
3171041004,JAKARTA PUSAT,SENEN,KRAMAT,25258,18548,6708,2956,9664,2021-06-28
3175041001,JAKARTA TIMUR,KRAMAT JATI,KRAMAT JATI,29922,20416,9498,4954,14452,2021-06-28
3174071003,JAKARTA SELATAN,KEBAYORAN BARU,KRAMAT PELA,12737,7610,5124,2357,7481,2021-06-28
3173031002,JAKARTA BARAT,TAMAN SARI,KRUKUT,17023,11264,5752,2265,8017,2021-06-28
3174031005,JAKARTA SELATAN,MAMPANG PRAPATAN,KUNINGAN BARAT,11229,7297,3929,1536,5465,2021-06-28
3174021008,JAKARTA SELATAN,SETIA BUDI,KUNINGAN TIMUR,5331,3375,1954,1045,2999,2021-06-28
3171041005,JAKARTA PUSAT,SENEN,KWITANG,13487,8834,4651,2068,6719,2021-06-28
3172031003,JAKARTA UTARA,KOJA,LAGOA,51431,37958,13466,5613,19079,2021-06-28
3174061002,JAKARTA SELATAN,CILANDAK,LEBAK BULUS,32738,21957,10772,5786,16558,2021-06-28
3174091004,JAKARTA SELATAN,JAGAKARSA,LENTENG AGUNG,46600,34221,12376,6096,18472,2021-06-28
3175101007,JAKARTA TIMUR,CIPAYUNG,LUBANG BUAYA,55114,38602,16504,8322,24826,2021-06-28
3175081001,JAKARTA TIMUR,MAKASAR,MAKASAR,30013,19824,10181,4924,15105,2021-06-28
3175071006,JAKARTA TIMUR,DUREN SAWIT,MALAKA JAYA,26798,17477,9314,5430,14744,2021-06-28
3175071005,JAKARTA TIMUR,DUREN SAWIT,MALAKA SARI,23691,14784,8900,5367,14267,2021-06-28
3174031001,JAKARTA SELATAN,MAMPANG PRAPATAN,MAMPANG PRAPATAN,15885,11417,4463,2040,6503,2021-06-28
3173031005,JAKARTA BARAT,TAMAN SARI,MANGGA BESAR,6690,3848,2840,1439,4279,2021-06-28
3171021005,JAKARTA PUSAT,SAWAH BESAR,MANGGA DUA SELATAN,24940,16881,8055,3828,11883,2021-06-28
3174011007,JAKARTA SELATAN,TEBET,MANGGARAI,24972,17313,7654,3531,11185,2021-06-28
3174011006,JAKARTA SELATAN,TEBET,MANGGARAI SELATAN,20274,12797,7475,3178,10653,2021-06-28
3173031003,JAKARTA BARAT,TAMAN SARI,MAPHAR,14671,9351,5320,2553,7873,2021-06-28
3172041003,JAKARTA UTARA,CILINCING,MARUNDA,24385,15688,8694,2559,11253,2021-06-28
3174071001,JAKARTA SELATAN,KEBAYORAN BARU,MELAWAI,2386,1194,1191,812,2003,2021-06-28
3171061001,JAKARTA PUSAT,MENTENG,MENTENG,22450,16356,6089,3482,9571,2021-06-28
3174021005,JAKARTA SELATAN,SETIA BUDI,MENTENG ATAS,24369,15539,8825,3981,12806,2021-06-28
3174011003,JAKARTA SELATAN,TEBET,MENTENG DALAM,31623,21706,9907,5120,15027,2021-06-28
3173081003,JAKARTA BARAT,KEMBANGAN,MERUYA SELATAN,27261,18412,8840,4297,13137,2021-06-28
3173081002,JAKARTA BARAT,KEMBANGAN,MERUYA UTARA,38525,25849,12672,6882,19554,2021-06-28
3175101004,JAKARTA TIMUR,CIPAYUNG,MUNJUL,20582,14183,6396,3563,9959,2021-06-28
3172051002,JAKARTA UTARA,PADEMANGAN,PADEMANGAN BARAT,64756,45851,18899,7764,26663,2021-06-28
3172051001,JAKARTA UTARA,PADEMANGAN,PADEMANGAN TIMUR,32689,18508,14165,6856,21021,2021-06-28
3175011004,JAKARTA TIMUR,MATRAMAN,PAL MERIAM,17550,11895,5651,2695,8346,2021-06-28
3173071001,JAKARTA BARAT,PALMERAH,PALMERAH,54706,37319,17378,7948,25326,2021-06-28
3174081001,JAKARTA SELATAN,PANCORAN,PANCORAN,16983,11696,5286,2624,7910,2021-06-28
3172021003,JAKARTA UTARA,TANJUNG PRIOK,PAPANGGO,33902,23168,10717,4640,15357,2021-06-28
3171021001,JAKARTA PUSAT,SAWAH BESAR,PASAR BARU,11656,6329,5321,2895,8216,2021-06-28
3174021006,JAKARTA SELATAN,SETIA BUDI,PASAR MANGGIS,23415,15599,7810,3524,11334,2021-06-28
3174041001,JAKARTA SELATAN,PASAR MINGGU,PASAR MINGGU,21700,14093,7601,4517,12118,2021-06-28
3171041003,JAKARTA PUSAT,SENEN,PASEBAN,20652,13763,6884,3278,10162,2021-06-28
3173061005,JAKARTA BARAT,KALI DERES,PEGADUNGAN,65248,44775,20453,9034,29487,2021-06-28
3171061002,JAKARTA PUSAT,MENTENG,PEGANGSAAN,18427,12454,5971,2912,8883,2021-06-28
3172061002,JAKARTA UTARA,KELAPA GADING,PEGANGSAAN DUA,44451,23960,20472,10393,30865,2021-06-28
3172011004,JAKARTA UTARA,PENJARINGAN,PEJAGALAN,66008,43811,22177,10830,33007,2021-06-28
3174041006,JAKARTA SELATAN,PASAR MINGGU,PEJATEN BARAT,30591,19704,10876,5513,16389,2021-06-28
3174041005,JAKARTA SELATAN,PASAR MINGGU,PEJATEN TIMUR,50150,35991,14153,5977,20130,2021-06-28
3175051005,JAKARTA TIMUR,PASAR REBO,PEKAYON,37440,25103,12332,6001,18333,2021-06-28
3173041009,JAKARTA BARAT,TAMBORA,PEKOJAN,20921,13960,6956,3395,10351,2021-06-28
3174031003,JAKARTA SELATAN,MAMPANG PRAPATAN,PELA MAMPANG,37784,25804,11969,5563,17532,2021-06-28
3174081005,JAKARTA SELATAN,PANCORAN,PENGADEGAN,18685,10974,7706,3294,11000,2021-06-28
3175061003,JAKARTA TIMUR,CAKUNG,PENGGILINGAN,84511,64306,20203,9239,29442,2021-06-28
3172011001,JAKARTA UTARA,PENJARINGAN,PENJARINGAN,75505,54182,21312,7774,29086,2021-06-28
3174101001,JAKARTA SELATAN,PESANGGRAHAN,PESANGGRAHAN,23733,14215,9515,4849,14364,2021-06-28
3171071004,JAKARTA PUSAT,TANAH ABANG,PETAMBURAN,28974,22780,6190,2895,9085,2021-06-28
3174071008,JAKARTA SELATAN,KEBAYORAN BARU,PETOGOGAN,10203,6528,3674,1826,5500,2021-06-28
3171011004,JAKARTA PUSAT,GAMBIR,PETOJO SELATAN,13506,8559,4938,2986,7924,2021-06-28
3171011003,JAKARTA PUSAT,GAMBIR,PETOJO UTARA,16084,10830,5252,2686,7938,2021-06-28
3174101004,JAKARTA SELATAN,PESANGGRAHAN,PETUKANGAN SELATAN,32229,21080,11147,4875,16022,2021-06-28
3174101003,JAKARTA SELATAN,PESANGGRAHAN,PETUKANGAN UTARA,46427,31599,14825,6677,21502,2021-06-28
3175081002,JAKARTA TIMUR,MAKASAR,PINANG RANTI,23465,15803,7659,3421,11080,2021-06-28
3173031008,JAKARTA BARAT,TAMAN SARI,PINANGSIA,9405,5746,3658,1616,5274,2021-06-28
3175011001,JAKARTA TIMUR,MATRAMAN,PISANGAN BARU,27793,20354,7432,3783,11215,2021-06-28
3175021002,JAKARTA TIMUR,PULO GADUNG,PISANGAN TIMUR,35717,24134,11575,5562,17137,2021-06-28
3172011005,JAKARTA UTARA,PENJARINGAN,PLUIT,42979,24106,18842,12245,31087,2021-06-28
3175071002,JAKARTA TIMUR,DUREN SAWIT,PONDOK BAMBU,53658,35975,17670,8765,26435,2021-06-28
3175071004,JAKARTA TIMUR,DUREN SAWIT,PONDOK KELAPA,62704,42944,19745,10849,30594,2021-06-28
3175071007,JAKARTA TIMUR,DUREN SAWIT,PONDOK KOPI,30741,22104,8633,4295,12928,2021-06-28
3174061003,JAKARTA SELATAN,CILANDAK,PONDOK LABU,39778,26278,13488,6787,20275,2021-06-28
3174051002,JAKARTA SELATAN,KEBAYORAN LAMA,PONDOK PINANG,49276,33179,16076,9296,25372,2021-06-28
3175101003,JAKARTA TIMUR,CIPAYUNG,PONDOK RANGGON,21791,15504,6279,3756,10035,2021-06-28
3101011003,KAB.ADM.KEP.SERIBU,KEP. SERIBU UTARA,PULAU HARAPAN,1785,550,1235,665,1900,2021-06-28
3101011002,KAB.ADM.KEP.SERIBU,KEP. SERIBU UTARA,PULAU KELAPA,4729,1540,3189,1076,4265,2021-06-28
3101011001,KAB.ADM.KEP.SERIBU,KEP. SERIBU UTARA,PULAU PANGGANG,4667,1409,3258,1130,4388,2021-06-28
3101021003,KAB.ADM.KEP.SERIBU,KEP. SERIBU SELATAN,PULAU PARI,2370,467,1903,609,2512,2021-06-28
3101021002,KAB.ADM.KEP.SERIBU,KEP. SERIBU SELATAN,PULAU TIDUNG,3922,1260,2661,1129,3790,2021-06-28
3101021001,KAB.ADM.KEP.SERIBU,KEP. SERIBU SELATAN,PULAU UNTUNG JAWA,1665,466,1199,558,1757,2021-06-28
3174071007,JAKARTA SELATAN,KEBAYORAN BARU,PULO,5184,2996,2186,1333,3519,2021-06-28
3175021001,JAKARTA TIMUR,PULO GADUNG,PULO GADUNG,30292,21227,9056,4599,13655,2021-06-28
3175061005,JAKARTA TIMUR,CAKUNG,PULO GEBANG,83832,60828,22995,10504,33499,2021-06-28
3174041004,JAKARTA SELATAN,PASAR MINGGU,RAGUNAN,34536,22125,12398,5738,18136,2021-06-28
3175091005,JAKARTA TIMUR,CIRACAS,RAMBUTAN,31759,23882,7871,4239,12110,2021-06-28
3172031006,JAKARTA UTARA,KOJA,RAWA BADAK SELATAN,36403,27475,8925,3903,12828,2021-06-28
3172031004,JAKARTA UTARA,KOJA,RAWA BADAK UTARA,29198,19874,9321,3808,13129,2021-06-28
3174071005,JAKARTA SELATAN,KEBAYORAN BARU,RAWA BARAT,5029,2940,2088,1314,3402,2021-06-28
3173011003,JAKARTA BARAT,CENGKARENG,RAWA BUAYA,51752,34445,17299,5959,23258,2021-06-28
3175031004,JAKARTA TIMUR,JATINEGARA,RAWA BUNGA,18617,13706,4910,2453,7363,2021-06-28
3174081003,JAKARTA SELATAN,PANCORAN,RAWA JATI,18210,11617,6587,3376,9963,2021-06-28
3175061002,JAKARTA TIMUR,CAKUNG,RAWA TERATE,21332,13601,7729,2045,9774,2021-06-28
3175021005,JAKARTA TIMUR,PULO GADUNG,RAWAMANGUN,32470,21614,10849,5804,16653,2021-06-28
3171051003,JAKARTA PUSAT,CEMPAKA PUTIH,RAWASARI,19312,12761,6542,3457,9999,2021-06-28
3173041010,JAKARTA BARAT,TAMBORA,ROA MALAKA,3149,1692,1454,873,2327,2021-06-28
3172041006,JAKARTA UTARA,CILINCING,ROROTAN,35258,23412,11842,4537,16379,2021-06-28
3174071004,JAKARTA SELATAN,KEBAYORAN BARU,SELONG,2576,1326,1247,875,2122,2021-06-28
3173061002,JAKARTA BARAT,KALI DERES,SEMANAN,60715,45704,15006,4941,19947,2021-06-28
3172041007,JAKARTA UTARA,CILINCING,SEMPER BARAT,59323,39173,20135,9005,29140,2021-06-28
3172041005,JAKARTA UTARA,CILINCING,SEMPER TIMUR,31249,21449,9797,4269,14066,2021-06-28
3174071006,JAKARTA SELATAN,KEBAYORAN BARU,SENAYAN,2482,1615,864,564,1428,2021-06-28
3171041001,JAKARTA PUSAT,SENEN,SENEN,5951,3723,2227,1170,3397,2021-06-28
3171031004,JAKARTA PUSAT,KEMAYORAN,SERDANG,26045,17470,8572,3913,12485,2021-06-28
3174021001,JAKARTA SELATAN,SETIA BUDI,SETIA BUDI,2532,1506,1023,638,1661,2021-06-28
3175101005,JAKARTA TIMUR,CIPAYUNG,SETU,17609,12843,4764,2657,7421,2021-06-28
3173071002,JAKARTA BARAT,PALMERAH,SLIPI,14526,9316,5207,2702,7909,2021-06-28
3173081004,JAKARTA BARAT,KEMBANGAN,SRENGSENG,39370,27809,11547,6120,17667,2021-06-28
3174091002,JAKARTA SELATAN,JAGAKARSA,SRENGSENG SAWAH,50305,30532,19758,8848,28606,2021-06-28
3173051003,JAKARTA BARAT,KEBON JERUK,SUKABUMI SELATAN,30581,22367,8213,3446,11659,2021-06-28
3173051002,JAKARTA BARAT,KEBON JERUK,SUKABUMI UTARA,33050,24848,8199,3979,12178,2021-06-28
3172041002,JAKARTA UTARA,CILINCING,SUKAPURA,46955,33174,13774,5404,19178,2021-06-28
3171031007,JAKARTA PUSAT,KEMAYORAN,SUMUR BATU,19863,13092,6767,3369,10136,2021-06-28
3172021004,JAKARTA UTARA,TANJUNG PRIOK,SUNGAI BAMBU,25366,16907,8454,3489,11943,2021-06-28
3172021006,JAKARTA UTARA,TANJUNG PRIOK,SUNTER AGUNG,62904,37072,25804,13410,39214,2021-06-28
3172021002,JAKARTA UTARA,TANJUNG PRIOK,SUNTER JAYA,55168,35220,19927,10372,30299,2021-06-28
3175091004,JAKARTA TIMUR,CIRACAS,SUSUKAN,28884,19582,9300,4557,13857,2021-06-28
3173031001,JAKARTA BARAT,TAMAN SARI,TAMAN SARI,12915,8425,4488,2380,6868,2021-06-28
3173041001,JAKARTA BARAT,TAMBORA,TAMBORA,9087,6136,2951,1510,4461,2021-06-28
3173041004,JAKARTA BARAT,TAMBORA,TANAH SEREAL,23141,14403,8736,3855,12591,2021-06-28
3171081004,JAKARTA PUSAT,JOHAR BARU,TANAH TINGGI,32931,21368,11561,4226,15787,2021-06-28
3173031004,JAKARTA BARAT,TAMAN SARI,TANGKI,11593,7421,4169,1915,6084,2021-06-28
3174091005,JAKARTA SELATAN,JAGAKARSA,TANJUNG BARAT,34530,24267,10257,5605,15862,2021-06-28
3173021005,JAKARTA BARAT,GROGOL PETAMBURAN,TANJUNG DUREN SELATAN,22469,12857,9599,4427,14026,2021-06-28
3173021002,JAKARTA BARAT,GROGOL PETAMBURAN,TANJUNG DUREN UTARA,15224,8478,6740,3508,10248,2021-06-28
3172021001,JAKARTA UTARA,TANJUNG PRIOK,TANJUNG PRIOK,29913,18562,11342,3815,15157,2021-06-28
3174011002,JAKARTA SELATAN,TEBET,TEBET BARAT,18916,11664,7244,4137,11381,2021-06-28
3174011001,JAKARTA SELATAN,TEBET,TEBET TIMUR,16031,9206,6818,3701,10519,2021-06-28
3173061003,JAKARTA BARAT,KALI DERES,TEGAL ALUR,71923,52837,19079,6810,25889,2021-06-28
3174031004,JAKARTA SELATAN,MAMPANG PRAPATAN,TEGAL PARANG,28143,21322,6819,3280,10099,2021-06-28
3173021003,JAKARTA BARAT,GROGOL PETAMBURAN,TOMANG,25531,15576,9944,4947,14891,2021-06-28
3172031005,JAKARTA UTARA,KOJA,TUGU SELATAN,33663,24669,8989,3787,12776,2021-06-28
3172031002,JAKARTA UTARA,KOJA,TUGU UTARA,58638,44018,14616,6678,21294,2021-06-28
3175061006,JAKARTA TIMUR,CAKUNG,UJUNG MENTENG,25702,17157,8535,3930,12465,2021-06-28
3174101005,JAKARTA SELATAN,PESANGGRAHAN,ULUJAMI,35077,24929,10142,4896,15038,2021-06-28
3175011006,JAKARTA TIMUR,MATRAMAN,UTAN KAYU SELATAN,29303,19132,10160,5003,15163,2021-06-28
3175011002,JAKARTA TIMUR,MATRAMAN,UTAN KAYU UTARA,24728,16440,8287,3780,12067,2021-06-28
3171031008,JAKARTA PUSAT,KEMAYORAN,UTAN PANJANG,25622,18761,6860,2779,9639,2021-06-28
3172021007,JAKARTA UTARA,TANJUNG PRIOK,WARAKAS,38194,26222,11959,5163,17122,2021-06-28
3173021007,JAKARTA BARAT,GROGOL PETAMBURAN,WIJAYA KUSUMA,34170,23113,11048,4835,15883,2021-06-28
3172051003,JAKARTA UTARA,PADEMANGAN,ANCOL,20393,13515,6871,3276,10147,2021-06-29
3173041007,JAKARTA BARAT,TAMBORA,ANGKE,25785,16987,8789,3214,12003,2021-06-29
3175041005,JAKARTA TIMUR,KRAMAT JATI,BALE KAMBANG,25158,19322,5828,2631,8459,2021-06-29
3175031003,JAKARTA TIMUR,JATINEGARA,BALI MESTER,8683,5888,2792,1512,4304,2021-06-29
3175101006,JAKARTA TIMUR,CIPAYUNG,BAMBU APUS,22768,15791,6973,3973,10946,2021-06-29
3174031002,JAKARTA SELATAN,MAMPANG PRAPATAN,BANGKA,18930,12834,6090,2697,8787,2021-06-29
3175051002,JAKARTA TIMUR,PASAR REBO,BARU,20267,11688,8562,4663,13225,2021-06-29
3175041004,JAKARTA TIMUR,KRAMAT JATI,BATU AMPAR,41389,30941,10438,5224,15662,2021-06-29
3171071002,JAKARTA PUSAT,TANAH ABANG,BENDUNGAN HILIR,19008,11854,7147,3559,10706,2021-06-29
3175031002,JAKARTA TIMUR,JATINEGARA,BIDARA CINA,32331,23908,8419,4024,12443,2021-06-29
3174101002,JAKARTA SELATAN,PESANGGRAHAN,BINTARO,45843,31945,13887,7052,20939,2021-06-29
3174011005,JAKARTA SELATAN,TEBET,BUKIT DURI,29934,20962,8970,3942,12912,2021-06-29
3171041006,JAKARTA PUSAT,SENEN,BUNGUR,15932,10293,5623,2732,8355,2021-06-29
3175061007,JAKARTA TIMUR,CAKUNG,CAKUNG BARAT,49369,33797,15569,4004,19573,2021-06-29
3175061004,JAKARTA TIMUR,CAKUNG,CAKUNG TIMUR,50344,34356,15978,6368,22346,2021-06-29
3175041007,JAKARTA TIMUR,KRAMAT JATI,CAWANG,28708,20275,8428,4271,12699,2021-06-29
3175101008,JAKARTA TIMUR,CIPAYUNG,CEGER,16381,11028,5352,2560,7912,2021-06-29
3171031006,JAKARTA PUSAT,KEMAYORAN,CEMPAKA BARU,27330,18853,8467,3994,12461,2021-06-29
3171051002,JAKARTA PUSAT,CEMPAKA PUTIH,CEMPAKA PUTIH BARAT,30479,21285,9185,4957,14142,2021-06-29
3171051001,JAKARTA PUSAT,CEMPAKA PUTIH,CEMPAKA PUTIH TIMUR,21553,13644,7906,4429,12335,2021-06-29
3173011001,JAKARTA BARAT,CENGKARENG,CENGKARENG BARAT,57678,35368,22298,8209,30507,2021-06-29
3173011006,JAKARTA BARAT,CENGKARENG,CENGKARENG TIMUR,70122,47976,22135,8505,30640,2021-06-29
3175091002,JAKARTA TIMUR,CIRACAS,CIBUBUR,56927,38058,18858,9415,28273,2021-06-29
3171011002,JAKARTA PUSAT,GAMBIR,CIDENG,14203,8445,5750,3170,8920,2021-06-29
3174091003,JAKARTA SELATAN,JAGAKARSA,CIGANJUR,33127,22423,10691,5154,15845,2021-06-29
3175051003,JAKARTA TIMUR,PASAR REBO,CIJANTUNG,36027,23814,12203,6166,18369,2021-06-29
3171061003,JAKARTA PUSAT,MENTENG,CIKINI,7402,4977,2424,1369,3793,2021-06-29
3174081006,JAKARTA SELATAN,PANCORAN,CIKOKO,9280,5685,3595,1741,5336,2021-06-29
3174061001,JAKARTA SELATAN,CILANDAK,CILANDAK BARAT,45348,27885,17448,7853,25301,2021-06-29
3174041003,JAKARTA SELATAN,PASAR MINGGU,CILANDAK TIMUR,21207,13128,8068,4825,12893,2021-06-29
3175101002,JAKARTA TIMUR,CIPAYUNG,CILANGKAP,23675,16233,7435,3804,11239,2021-06-29
3175041006,JAKARTA TIMUR,KRAMAT JATI,CILILITAN,35164,24940,10215,5220,15435,2021-06-29
3172041001,JAKARTA UTARA,CILINCING,CILINCING,37003,27027,9969,3906,13875,2021-06-29
3175101001,JAKARTA TIMUR,CIPAYUNG,CIPAYUNG,22697,14531,8158,4214,12372,2021-06-29
3174091006,JAKARTA SELATAN,JAGAKARSA,CIPEDAK,32800,21878,10915,4781,15696,2021-06-29
3174061005,JAKARTA SELATAN,CILANDAK,CIPETE SELATAN,23463,15448,8012,3794,11806,2021-06-29
3174071010,JAKARTA SELATAN,KEBAYORAN BARU,CIPETE UTARA,29771,18633,11134,4074,15208,2021-06-29
3175021003,JAKARTA TIMUR,PULO GADUNG,CIPINANG,34608,23195,11404,5992,17396,2021-06-29
3175031007,JAKARTA TIMUR,JATINEGARA,CIPINANG BESAR SELATAN,30655,22860,7787,3883,11670,2021-06-29
3175031008,JAKARTA TIMUR,JATINEGARA,CIPINANG BESAR UTARA,38827,30346,8475,4178,12653,2021-06-29
3175031005,JAKARTA TIMUR,JATINEGARA,CIPINANG CEMPEDAK,29154,20363,8778,4682,13460,2021-06-29
3175081005,JAKARTA TIMUR,MAKASAR,CIPINANG MELAYU,37098,24606,12484,6378,18862,2021-06-29
3175031006,JAKARTA TIMUR,JATINEGARA,CIPINANG MUARA,46861,33836,13018,7267,20285,2021-06-29
3174051003,JAKARTA SELATAN,KEBAYORAN LAMA,CIPULIR,34708,24319,10384,4777,15161,2021-06-29
3175091001,JAKARTA TIMUR,CIRACAS,CIRACAS,55965,37092,18866,8363,27229,2021-06-29
3175041003,JAKARTA TIMUR,KRAMAT JATI,DUKUH,21239,14733,6502,3494,9996,2021-06-29
3175071001,JAKARTA TIMUR,DUREN SAWIT,DUREN SAWIT,53078,36058,17006,9185,26191,2021-06-29
3174081004,JAKARTA SELATAN,PANCORAN,DUREN TIGA,24673,16466,8201,3811,12012,2021-06-29
3173051005,JAKARTA BARAT,KEBON JERUK,DURI KEPA,52942,32360,20565,9911,30476,2021-06-29
3173011002,JAKARTA BARAT,CENGKARENG,DURI KOSAMBI,66093,44223,21860,8170,30030,2021-06-29
3171011006,JAKARTA PUSAT,GAMBIR,DURI PULO,17787,12473,5311,2373,7684,2021-06-29
3173041011,JAKARTA BARAT,TAMBORA,DURI SELATAN,12528,7897,4624,2356,6980,2021-06-29
3173041003,JAKARTA BARAT,TAMBORA,DURI UTARA,17380,11744,5633,2635,8268,2021-06-29
3171081003,JAKARTA PUSAT,JOHAR BARU,GALUR,15811,9682,6129,1961,8090,2021-06-29
3171011001,JAKARTA PUSAT,GAMBIR,GAMBIR,2232,1276,955,577,1532,2021-06-29
3174061004,JAKARTA SELATAN,CILANDAK,GANDARIA SELATAN,19394,12528,6858,2826,9684,2021-06-29
3174071009,JAKARTA SELATAN,KEBAYORAN BARU,GANDARIA UTARA,35026,22895,12126,5333,17459,2021-06-29
3175051001,JAKARTA TIMUR,PASAR REBO,GEDONG,31013,21074,9925,5260,15185,2021-06-29
3171071001,JAKARTA PUSAT,TANAH ABANG,GELORA,2753,1766,980,567,1547,2021-06-29
3173031007,JAKARTA BARAT,TAMAN SARI,GLODOK,7192,3685,3505,1972,5477,2021-06-29
3171061004,JAKARTA PUSAT,MENTENG,GONDANGDIA,3760,1913,1842,1281,3123,2021-06-29
3173021001,JAKARTA BARAT,GROGOL PETAMBURAN,GROGOL,15067,9811,5250,2597,7847,2021-06-29
3174051005,JAKARTA SELATAN,KEBAYORAN LAMA,GROGOL SELATAN,38688,26888,11791,5445,17236,2021-06-29
3174051004,JAKARTA SELATAN,KEBAYORAN LAMA,GROGOL UTARA,37234,26213,11004,5807,16811,2021-06-29
3174021007,JAKARTA SELATAN,SETIA BUDI,GUNTUR,3590,1947,1640,979,2619,2021-06-29
3174071002,JAKARTA SELATAN,KEBAYORAN BARU,GUNUNG,8309,4966,3342,2023,5365,2021-06-29
3171031005,JAKARTA PUSAT,KEMAYORAN,GUNUNG SAHARI SELATAN,17256,11268,5982,2803,8785,2021-06-29
3171021004,JAKARTA PUSAT,SAWAH BESAR,GUNUNG SAHARI UTARA,13937,7393,6538,3357,9895,2021-06-29
3175081004,JAKARTA TIMUR,MAKASAR,HALIM PERDANA KUSUMAH,24426,11327,13079,9223,22302,2021-06-29
3171031003,JAKARTA PUSAT,KEMAYORAN,HARAPAN MULIA,19987,13923,6060,2679,8739,2021-06-29
3174091001,JAKARTA SELATAN,JAGAKARSA,JAGAKARSA,53714,34543,19155,8463,27618,2021-06-29
3175021007,JAKARTA TIMUR,PULO GADUNG,JATI,28870,18879,9973,5561,15534,2021-06-29
3174041002,JAKARTA SELATAN,PASAR MINGGU,JATI PADANG,32857,21511,11337,5831,17168,2021-06-29
3173071004,JAKARTA BARAT,PALMERAH,JATI PULO,24508,14531,9974,3627,13601,2021-06-29
3175061001,JAKARTA TIMUR,CAKUNG,JATINEGARA,72652,55895,16757,6600,23357,2021-06-29
3175021004,JAKARTA TIMUR,PULO GADUNG,JATINEGARA KAUM,21313,14921,6389,2904,9293,2021-06-29
3173021004,JAKARTA BARAT,GROGOL PETAMBURAN,JELAMBAR,26984,16624,10349,5446,15795,2021-06-29
3173021006,JAKARTA BARAT,GROGOL PETAMBURAN,JELAMBAR BARU,33734,21576,12149,6042,18191,2021-06-29
3173041006,JAKARTA BARAT,TAMBORA,JEMBATAN BESI,25735,19887,5847,2421,8268,2021-06-29
3173041008,JAKARTA BARAT,TAMBORA,JEMBATAN LIMA,18241,13355,4879,2249,7128,2021-06-29
3173081005,JAKARTA BARAT,KEMBANGAN,JOGLO,35285,23635,11645,5911,17556,2021-06-29
3171081001,JAKARTA PUSAT,JOHAR BARU,JOHAR BARU,28311,15908,12397,5314,17711,2021-06-29
3173041002,JAKARTA BARAT,TAMBORA,KALI ANYAR,20624,15408,5214,2223,7437,2021-06-29
3172041004,JAKARTA UTARA,CILINCING,KALIBARU,57771,44912,12856,4313,17169,2021-06-29
3174081002,JAKARTA SELATAN,PANCORAN,KALIBATA,36451,25763,10687,4901,15588,2021-06-29
3173061001,JAKARTA BARAT,KALI DERES,KALIDERES,60209,41344,18846,7540,26386,2021-06-29
3175051004,JAKARTA TIMUR,PASAR REBO,KALISARI,37255,24518,12724,6721,19445,2021-06-29
3173061004,JAKARTA BARAT,KALI DERES,KAMAL,46035,35244,10787,3646,14433,2021-06-29
3172011002,JAKARTA UTARA,PENJARINGAN,KAMAL MUARA,11039,5930,5099,2496,7595,2021-06-29
3171071007,JAKARTA PUSAT,TANAH ABANG,KAMPUNG BALI,10113,7294,2819,1502,4321,2021-06-29
3175031001,JAKARTA TIMUR,JATINEGARA,KAMPUNG MELAYU,22293,17087,5203,2225,7428,2021-06-29
3171081002,JAKARTA PUSAT,JOHAR BARU,KAMPUNG RAWA,15550,7758,7789,2537,10326,2021-06-29
3175041002,JAKARTA TIMUR,KRAMAT JATI,KAMPUNG TENGAH,38048,27912,10127,5216,15343,2021-06-29
3173011005,JAKARTA BARAT,CENGKARENG,KAPUK,104630,75401,29219,9446,38665,2021-06-29
3172011003,JAKARTA UTARA,PENJARINGAN,KAPUK MUARA,31275,19292,11964,6617,18581,2021-06-29
3171021002,JAKARTA PUSAT,SAWAH BESAR,KARANG ANYAR,23056,15432,7613,3389,11002,2021-06-29
3174021004,JAKARTA SELATAN,SETIA BUDI,KARET,8542,5265,3275,1425,4700,2021-06-29
3174021003,JAKARTA SELATAN,SETIA BUDI,KARET KUNINGAN,14166,8681,5481,2313,7794,2021-06-29
3174021002,JAKARTA SELATAN,SETIA BUDI,KARET SEMANGGI,2469,1301,1165,596,1761,2021-06-29
3171071003,JAKARTA PUSAT,TANAH ABANG,KARET TENGSIN,16695,11499,5194,2188,7382,2021-06-29
3171021003,JAKARTA PUSAT,SAWAH BESAR,KARTINI,19916,12637,7275,3437,10712,2021-06-29
3175011003,JAKARTA TIMUR,MATRAMAN,KAYU MANIS,22174,15661,6511,2991,9502,2021-06-29
3175021006,JAKARTA TIMUR,PULO GADUNG,KAYU PUTIH,35916,22401,13497,6990,20487,2021-06-29
3173031006,JAKARTA BARAT,TAMAN SARI,KEAGUNGAN,15262,10516,4744,1989,6733,2021-06-29
3174041007,JAKARTA SELATAN,PASAR MINGGU,KEBAGUSAN,38396,26589,11798,5153,16951,2021-06-29
3174051006,JAKARTA SELATAN,KEBAYORAN LAMA,KEBAYORAN LAMA SELATAN,35920,22786,13125,5764,18889,2021-06-29
3174051001,JAKARTA SELATAN,KEBAYORAN LAMA,KEBAYORAN LAMA UTARA,37004,25466,11528,5216,16744,2021-06-29
3174011004,JAKARTA SELATAN,TEBET,KEBON BARU,30533,20170,10357,5086,15443,2021-06-29
3172021005,JAKARTA UTARA,TANJUNG PRIOK,KEBON BAWANG,44427,29353,15057,6880,21937,2021-06-29
3173051001,JAKARTA BARAT,KEBON JERUK,KEBON JERUK,46870,33212,13646,6751,20397,2021-06-29
3171071006,JAKARTA PUSAT,TANAH ABANG,KEBON KACANG,19075,14260,4812,2609,7421,2021-06-29
3171011005,JAKARTA PUSAT,GAMBIR,KEBON KELAPA,9383,6329,3053,1653,4706,2021-06-29
3171031002,JAKARTA PUSAT,KEMAYORAN,KEBON KOSONG,26178,17913,8261,3443,11704,2021-06-29
3175011005,JAKARTA TIMUR,MATRAMAN,KEBON MANGGIS,14644,9406,5232,2743,7975,2021-06-29
3171071005,JAKARTA PUSAT,TANAH ABANG,KEBON MELATI,27297,21349,5947,2849,8796,2021-06-29
3175081003,JAKARTA TIMUR,MAKASAR,KEBON PALA,40723,28126,12591,6146,18737,2021-06-29
3171061005,JAKARTA PUSAT,MENTENG,KEBON SIRIH,10880,7968,2912,1535,4447,2021-06-29
3173011004,JAKARTA BARAT,CENGKARENG,KEDAUNG KALI ANGKE,28123,16712,11406,3199,14605,2021-06-29
3173051007,JAKARTA BARAT,KEBON JERUK,KEDOYA SELATAN,28300,18293,9989,4572,14561,2021-06-29
3173051006,JAKARTA BARAT,KEBON JERUK,KEDOYA UTARA,38771,23125,15634,6927,22561,2021-06-29
3173051004,JAKARTA BARAT,KEBON JERUK,KELAPA DUA,20509,13613,6891,3108,9999,2021-06-29
3175091003,JAKARTA TIMUR,CIRACAS,KELAPA DUA WETAN,40776,26606,14157,7161,21318,2021-06-29
3172061003,JAKARTA UTARA,KELAPA GADING,KELAPA GADING BARAT,31544,16990,14529,8738,23267,2021-06-29
3172061001,JAKARTA UTARA,KELAPA GADING,KELAPA GADING TIMUR,30470,15047,15411,9077,24488,2021-06-29
3173071005,JAKARTA BARAT,PALMERAH,KEMANGGISAN,28159,18059,10090,5153,15243,2021-06-29
3171031001,JAKARTA PUSAT,KEMAYORAN,KEMAYORAN,18556,11974,6579,2798,9377,2021-06-29
3173081006,JAKARTA BARAT,KEMBANGAN,KEMBANGAN SELATAN,24028,15170,8840,4974,13814,2021-06-29
3173081001,JAKARTA BARAT,KEMBANGAN,KEMBANGAN UTARA,45663,29500,16151,6543,22694,2021-06-29
3171041002,JAKARTA PUSAT,SENEN,KENARI,8328,4848,3479,1728,5207,2021-06-29
3173041005,JAKARTA BARAT,TAMBORA,KERENDANG,17494,12505,4986,2208,7194,2021-06-29
3175071003,JAKARTA TIMUR,DUREN SAWIT,KLENDER,60420,44308,16107,7356,23463,2021-06-29
3172031001,JAKARTA UTARA,KOJA,KOJA,24600,17642,6957,2730,9687,2021-06-29
3173071006,JAKARTA BARAT,PALMERAH,KOTA BAMBU SELATAN,18287,12552,5733,2228,7961,2021-06-29
3173071003,JAKARTA BARAT,PALMERAH,KOTA BAMBU UTARA,21312,14920,6391,2763,9154,2021-06-29
3171041004,JAKARTA PUSAT,SENEN,KRAMAT,25258,18278,6978,2959,9937,2021-06-29
3175041001,JAKARTA TIMUR,KRAMAT JATI,KRAMAT JATI,29922,20169,9745,4967,14712,2021-06-29
3174071003,JAKARTA SELATAN,KEBAYORAN BARU,KRAMAT PELA,12737,7529,5205,2361,7566,2021-06-29
3173031002,JAKARTA BARAT,TAMAN SARI,KRUKUT,17023,11202,5814,2269,8083,2021-06-29
3174031005,JAKARTA SELATAN,MAMPANG PRAPATAN,KUNINGAN BARAT,11229,7209,4017,1538,5555,2021-06-29
3174021008,JAKARTA SELATAN,SETIA BUDI,KUNINGAN TIMUR,5331,3324,2005,1049,3054,2021-06-29
3171041005,JAKARTA PUSAT,SENEN,KWITANG,13487,8673,4812,2074,6886,2021-06-29
3172031003,JAKARTA UTARA,KOJA,LAGOA,51431,37502,13922,5621,19543,2021-06-29
3174061002,JAKARTA SELATAN,CILANDAK,LEBAK BULUS,32738,21531,11197,5808,17005,2021-06-29
3174091004,JAKARTA SELATAN,JAGAKARSA,LENTENG AGUNG,46600,33821,12776,6102,18878,2021-06-29
3175101007,JAKARTA TIMUR,CIPAYUNG,LUBANG BUAYA,55114,37713,17393,8346,25739,2021-06-29
3175081001,JAKARTA TIMUR,MAKASAR,MAKASAR,30013,19373,10632,4933,15565,2021-06-29
3175071006,JAKARTA TIMUR,DUREN SAWIT,MALAKA JAYA,26798,17151,9640,5442,15082,2021-06-29
3175071005,JAKARTA TIMUR,DUREN SAWIT,MALAKA SARI,23691,14576,9108,5376,14484,2021-06-29
3174031001,JAKARTA SELATAN,MAMPANG PRAPATAN,MAMPANG PRAPATAN,15885,11246,4634,2047,6681,2021-06-29
3173031005,JAKARTA BARAT,TAMAN SARI,MANGGA BESAR,6690,3766,2922,1441,4363,2021-06-29
3171021005,JAKARTA PUSAT,SAWAH BESAR,MANGGA DUA SELATAN,24940,16643,8293,3833,12126,2021-06-29
3174011007,JAKARTA SELATAN,TEBET,MANGGARAI,24972,17057,7909,3538,11447,2021-06-29
3174011006,JAKARTA SELATAN,TEBET,MANGGARAI SELATAN,20274,12615,7657,3187,10844,2021-06-29
3173031003,JAKARTA BARAT,TAMAN SARI,MAPHAR,14671,9239,5432,2554,7986,2021-06-29
3172041003,JAKARTA UTARA,CILINCING,MARUNDA,24385,15472,8910,2567,11477,2021-06-29
3174071001,JAKARTA SELATAN,KEBAYORAN BARU,MELAWAI,2386,1181,1203,818,2021,2021-06-29
3171061001,JAKARTA PUSAT,MENTENG,MENTENG,22450,16229,6216,3490,9706,2021-06-29
3174021005,JAKARTA SELATAN,SETIA BUDI,MENTENG ATAS,24369,15389,8975,3989,12964,2021-06-29
3174011003,JAKARTA SELATAN,TEBET,MENTENG DALAM,31623,21346,10266,5140,15406,2021-06-29
3173081003,JAKARTA BARAT,KEMBANGAN,MERUYA SELATAN,27261,18089,9160,4303,13463,2021-06-29
3173081002,JAKARTA BARAT,KEMBANGAN,MERUYA UTARA,38525,25567,12954,6891,19845,2021-06-29
3175101004,JAKARTA TIMUR,CIPAYUNG,MUNJUL,20582,14002,6577,3573,10150,2021-06-29
3172051002,JAKARTA UTARA,PADEMANGAN,PADEMANGAN BARAT,64756,45423,19327,7769,27096,2021-06-29
3172051001,JAKARTA UTARA,PADEMANGAN,PADEMANGAN TIMUR,32689,18249,14424,6859,21283,2021-06-29
3175011004,JAKARTA TIMUR,MATRAMAN,PAL MERIAM,17550,11747,5799,2700,8499,2021-06-29
3173071001,JAKARTA BARAT,PALMERAH,PALMERAH,54706,36761,17936,7963,25899,2021-06-29
3174081001,JAKARTA SELATAN,PANCORAN,PANCORAN,16983,11513,5469,2631,8100,2021-06-29
3172021003,JAKARTA UTARA,TANJUNG PRIOK,PAPANGGO,33902,22762,11123,4656,15779,2021-06-29
3171021001,JAKARTA PUSAT,SAWAH BESAR,PASAR BARU,11656,6252,5398,2899,8297,2021-06-29
3174021006,JAKARTA SELATAN,SETIA BUDI,PASAR MANGGIS,23415,15344,8065,3526,11591,2021-06-29
3174041001,JAKARTA SELATAN,PASAR MINGGU,PASAR MINGGU,21700,13896,7798,4532,12330,2021-06-29
3171041003,JAKARTA PUSAT,SENEN,PASEBAN,20652,13612,7034,3287,10321,2021-06-29
3173061005,JAKARTA BARAT,KALI DERES,PEGADUNGAN,65248,43807,21420,9042,30462,2021-06-29
3171061002,JAKARTA PUSAT,MENTENG,PEGANGSAAN,18427,12315,6110,2916,9026,2021-06-29
3172061002,JAKARTA UTARA,KELAPA GADING,PEGANGSAAN DUA,44451,23455,20975,10412,31387,2021-06-29
3172011004,JAKARTA UTARA,PENJARINGAN,PEJAGALAN,66008,43019,22969,10841,33810,2021-06-29
3174041006,JAKARTA SELATAN,PASAR MINGGU,PEJATEN BARAT,30591,19359,11221,5529,16750,2021-06-29
3174041005,JAKARTA SELATAN,PASAR MINGGU,PEJATEN TIMUR,50150,35268,14875,5994,20869,2021-06-29
3175051005,JAKARTA TIMUR,PASAR REBO,PEKAYON,37440,24750,12685,6013,18698,2021-06-29
3173041009,JAKARTA BARAT,TAMBORA,PEKOJAN,20921,13757,7159,3401,10560,2021-06-29
3174031003,JAKARTA SELATAN,MAMPANG PRAPATAN,PELA MAMPANG,37784,25615,12157,5574,17731,2021-06-29
3174081005,JAKARTA SELATAN,PANCORAN,PENGADEGAN,18685,10674,8006,3303,11309,2021-06-29
3175061003,JAKARTA TIMUR,CAKUNG,PENGGILINGAN,84511,63822,20687,9257,29944,2021-06-29
3172011001,JAKARTA UTARA,PENJARINGAN,PENJARINGAN,75505,53552,21942,7783,29725,2021-06-29
3174101001,JAKARTA SELATAN,PESANGGRAHAN,PESANGGRAHAN,23733,13847,9882,4855,14737,2021-06-29
3171071004,JAKARTA PUSAT,TANAH ABANG,PETAMBURAN,28974,22618,6352,2910,9262,2021-06-29
3174071008,JAKARTA SELATAN,KEBAYORAN BARU,PETOGOGAN,10203,6464,3738,1834,5572,2021-06-29
3171011004,JAKARTA PUSAT,GAMBIR,PETOJO SELATAN,13506,8445,5052,2987,8039,2021-06-29
3171011003,JAKARTA PUSAT,GAMBIR,PETOJO UTARA,16084,10719,5363,2686,8049,2021-06-29
3174101004,JAKARTA SELATAN,PESANGGRAHAN,PETUKANGAN SELATAN,32229,20859,11368,4888,16256,2021-06-29
3174101003,JAKARTA SELATAN,PESANGGRAHAN,PETUKANGAN UTARA,46427,31255,15169,6690,21859,2021-06-29
3175081002,JAKARTA TIMUR,MAKASAR,PINANG RANTI,23465,15458,8004,3422,11426,2021-06-29
3173031008,JAKARTA BARAT,TAMAN SARI,PINANGSIA,9405,5674,3730,1619,5349,2021-06-29
3175011001,JAKARTA TIMUR,MATRAMAN,PISANGAN BARU,27793,20120,7666,3789,11455,2021-06-29
3175021002,JAKARTA TIMUR,PULO GADUNG,PISANGAN TIMUR,35717,23799,11910,5568,17478,2021-06-29
3172011005,JAKARTA UTARA,PENJARINGAN,PLUIT,42979,23685,19263,12249,31512,2021-06-29
3175071002,JAKARTA TIMUR,DUREN SAWIT,PONDOK BAMBU,53658,35560,18085,8783,26868,2021-06-29
3175071004,JAKARTA TIMUR,DUREN SAWIT,PONDOK KELAPA,62704,42215,20474,10869,31343,2021-06-29
3175071007,JAKARTA TIMUR,DUREN SAWIT,PONDOK KOPI,30741,21860,8877,4301,13178,2021-06-29
3174061003,JAKARTA SELATAN,CILANDAK,PONDOK LABU,39778,25908,13857,6804,20661,2021-06-29
3174051002,JAKARTA SELATAN,KEBAYORAN LAMA,PONDOK PINANG,49276,32768,16487,9314,25801,2021-06-29
3175101003,JAKARTA TIMUR,CIPAYUNG,PONDOK RANGGON,21791,15321,6462,3763,10225,2021-06-29
3101011003,KAB.ADM.KEP.SERIBU,KEP. SERIBU UTARA,PULAU HARAPAN,1785,541,1244,666,1910,2021-06-29
3101011002,KAB.ADM.KEP.SERIBU,KEP. SERIBU UTARA,PULAU KELAPA,4729,1459,3270,1078,4348,2021-06-29
3101011001,KAB.ADM.KEP.SERIBU,KEP. SERIBU UTARA,PULAU PANGGANG,4667,1395,3272,1132,4404,2021-06-29
3101021003,KAB.ADM.KEP.SERIBU,KEP. SERIBU SELATAN,PULAU PARI,2370,465,1905,609,2514,2021-06-29
3101021002,KAB.ADM.KEP.SERIBU,KEP. SERIBU SELATAN,PULAU TIDUNG,3922,1231,2690,1132,3822,2021-06-29
3101021001,KAB.ADM.KEP.SERIBU,KEP. SERIBU SELATAN,PULAU UNTUNG JAWA,1665,455,1210,558,1768,2021-06-29
3174071007,JAKARTA SELATAN,KEBAYORAN BARU,PULO,5184,2943,2239,1335,3574,2021-06-29
3175021001,JAKARTA TIMUR,PULO GADUNG,PULO GADUNG,30292,21025,9258,4611,13869,2021-06-29
3175061005,JAKARTA TIMUR,CAKUNG,PULO GEBANG,83832,60212,23611,10532,34143,2021-06-29
3174041004,JAKARTA SELATAN,PASAR MINGGU,RAGUNAN,34536,21847,12676,5763,18439,2021-06-29
3175091005,JAKARTA TIMUR,CIRACAS,RAMBUTAN,31759,23715,8038,4249,12287,2021-06-29
3172031006,JAKARTA UTARA,KOJA,RAWA BADAK SELATAN,36403,27153,9247,3909,13156,2021-06-29
3172031004,JAKARTA UTARA,KOJA,RAWA BADAK UTARA,29198,19532,9663,3824,13487,2021-06-29
3174071005,JAKARTA SELATAN,KEBAYORAN BARU,RAWA BARAT,5029,2905,2123,1316,3439,2021-06-29
3173011003,JAKARTA BARAT,CENGKARENG,RAWA BUAYA,51752,34144,17599,5967,23566,2021-06-29
3175031004,JAKARTA TIMUR,JATINEGARA,RAWA BUNGA,18617,13558,5058,2455,7513,2021-06-29
3174081003,JAKARTA SELATAN,PANCORAN,RAWA JATI,18210,11447,6757,3383,10140,2021-06-29
3175061002,JAKARTA TIMUR,CAKUNG,RAWA TERATE,21332,13419,7911,2047,9958,2021-06-29
3175021005,JAKARTA TIMUR,PULO GADUNG,RAWAMANGUN,32470,21337,11126,5812,16938,2021-06-29
3171051003,JAKARTA PUSAT,CEMPAKA PUTIH,RAWASARI,19312,12594,6708,3462,10170,2021-06-29
3173041010,JAKARTA BARAT,TAMBORA,ROA MALAKA,3149,1655,1490,876,2366,2021-06-29
3172041006,JAKARTA UTARA,CILINCING,ROROTAN,35258,23139,12115,4564,16679,2021-06-29
3174071004,JAKARTA SELATAN,KEBAYORAN BARU,SELONG,2576,1306,1267,876,2143,2021-06-29
3173061002,JAKARTA BARAT,KALI DERES,SEMANAN,60715,45314,15396,4945,20341,2021-06-29
3172041007,JAKARTA UTARA,CILINCING,SEMPER BARAT,59323,38494,20814,9027,29841,2021-06-29
3172041005,JAKARTA UTARA,CILINCING,SEMPER TIMUR,31249,21061,10185,4275,14460,2021-06-29
3174071006,JAKARTA SELATAN,KEBAYORAN BARU,SENAYAN,2482,1591,888,567,1455,2021-06-29
3171041001,JAKARTA PUSAT,SENEN,SENEN,5951,3677,2273,1172,3445,2021-06-29
3171031004,JAKARTA PUSAT,KEMAYORAN,SERDANG,26045,17132,8910,3916,12826,2021-06-29
3174021001,JAKARTA SELATAN,SETIA BUDI,SETIA BUDI,2532,1487,1042,643,1685,2021-06-29
3175101005,JAKARTA TIMUR,CIPAYUNG,SETU,17609,12767,4840,2659,7499,2021-06-29
3173071002,JAKARTA BARAT,PALMERAH,SLIPI,14526,9179,5344,2703,8047,2021-06-29
3173081004,JAKARTA BARAT,KEMBANGAN,SRENGSENG,39370,27551,11804,6129,17933,2021-06-29
3174091002,JAKARTA SELATAN,JAGAKARSA,SRENGSENG SAWAH,50305,30016,20274,8860,29134,2021-06-29
3173051003,JAKARTA BARAT,KEBON JERUK,SUKABUMI SELATAN,30581,22052,8528,3451,11979,2021-06-29
3173051002,JAKARTA BARAT,KEBON JERUK,SUKABUMI UTARA,33050,24561,8486,3989,12475,2021-06-29
3172041002,JAKARTA UTARA,CILINCING,SUKAPURA,46955,32805,14143,5412,19555,2021-06-29
3171031007,JAKARTA PUSAT,KEMAYORAN,SUMUR BATU,19863,12855,7004,3380,10384,2021-06-29
3172021004,JAKARTA UTARA,TANJUNG PRIOK,SUNGAI BAMBU,25366,16592,8769,3503,12272,2021-06-29
3172021006,JAKARTA UTARA,TANJUNG PRIOK,SUNTER AGUNG,62904,36449,26426,13427,39853,2021-06-29
3172021002,JAKARTA UTARA,TANJUNG PRIOK,SUNTER JAYA,55168,34544,20603,10396,30999,2021-06-29
3175091004,JAKARTA TIMUR,CIRACAS,SUSUKAN,28884,19301,9581,4571,14152,2021-06-29
3173031001,JAKARTA BARAT,TAMAN SARI,TAMAN SARI,12915,8325,4588,2381,6969,2021-06-29
3173041001,JAKARTA BARAT,TAMBORA,TAMBORA,9087,5994,3093,1512,4605,2021-06-29
3173041004,JAKARTA BARAT,TAMBORA,TANAH SEREAL,23141,14263,8876,3858,12734,2021-06-29
3171081004,JAKARTA PUSAT,JOHAR BARU,TANAH TINGGI,32931,21066,11863,4234,16097,2021-06-29
3173031004,JAKARTA BARAT,TAMAN SARI,TANGKI,11593,7311,4279,1917,6196,2021-06-29
3174091005,JAKARTA SELATAN,JAGAKARSA,TANJUNG BARAT,34530,23939,10585,5620,16205,2021-06-29
3173021005,JAKARTA BARAT,GROGOL PETAMBURAN,TANJUNG DUREN SELATAN,22469,12642,9814,4431,14245,2021-06-29
3173021002,JAKARTA BARAT,GROGOL PETAMBURAN,TANJUNG DUREN UTARA,15224,8313,6905,3510,10415,2021-06-29
3172021001,JAKARTA UTARA,TANJUNG PRIOK,TANJUNG PRIOK,29913,18315,11589,3817,15406,2021-06-29
3174011002,JAKARTA SELATAN,TEBET,TEBET BARAT,18916,11455,7453,4152,11605,2021-06-29
3174011001,JAKARTA SELATAN,TEBET,TEBET TIMUR,16031,9093,6931,3709,10640,2021-06-29
3173061003,JAKARTA BARAT,KALI DERES,TEGAL ALUR,71923,52158,19758,6814,26572,2021-06-29
3174031004,JAKARTA SELATAN,MAMPANG PRAPATAN,TEGAL PARANG,28143,21126,7014,3285,10299,2021-06-29
3173021003,JAKARTA BARAT,GROGOL PETAMBURAN,TOMANG,25531,15361,10159,4954,15113,2021-06-29
3172031005,JAKARTA UTARA,KOJA,TUGU SELATAN,33663,24406,9252,3799,13051,2021-06-29
3172031002,JAKARTA UTARA,KOJA,TUGU UTARA,58638,43401,15233,6695,21928,2021-06-29
3175061006,JAKARTA TIMUR,CAKUNG,UJUNG MENTENG,25702,16914,8778,3942,12720,2021-06-29
3174101005,JAKARTA SELATAN,PESANGGRAHAN,ULUJAMI,35077,24777,10294,4904,15198,2021-06-29
3175011006,JAKARTA TIMUR,MATRAMAN,UTAN KAYU SELATAN,29303,18883,10409,5013,15422,2021-06-29
3175011002,JAKARTA TIMUR,MATRAMAN,UTAN KAYU UTARA,24728,16158,8569,3787,12356,2021-06-29
3171031008,JAKARTA PUSAT,KEMAYORAN,UTAN PANJANG,25622,18618,7003,2783,9786,2021-06-29
3172021007,JAKARTA UTARA,TANJUNG PRIOK,WARAKAS,38194,25539,12641,5177,17818,2021-06-29
3173021007,JAKARTA BARAT,GROGOL PETAMBURAN,WIJAYA KUSUMA,34170,22891,11266,4839,16105,2021-06-29
3172051003,JAKARTA UTARA,PADEMANGAN,ANCOL,20393,13394,6992,3277,10269,2021-06-30
3173041007,JAKARTA BARAT,TAMBORA,ANGKE,25785,16743,9033,3217,12250,2021-06-30
3175041005,JAKARTA TIMUR,KRAMAT JATI,BALE KAMBANG,25158,19068,6082,2636,8718,2021-06-30
3175031003,JAKARTA TIMUR,JATINEGARA,BALI MESTER,8683,5816,2864,1512,4376,2021-06-30
3175101006,JAKARTA TIMUR,CIPAYUNG,BAMBU APUS,22768,15575,7189,3977,11166,2021-06-30
3174031002,JAKARTA SELATAN,MAMPANG PRAPATAN,BANGKA,18930,12655,6269,2699,8968,2021-06-30
3175051002,JAKARTA TIMUR,PASAR REBO,BARU,20267,11481,8769,4668,13437,2021-06-30
3175041004,JAKARTA TIMUR,KRAMAT JATI,BATU AMPAR,41389,30601,10777,5234,16011,2021-06-30
3171071002,JAKARTA PUSAT,TANAH ABANG,BENDUNGAN HILIR,19008,11660,7341,3561,10902,2021-06-30
3175031002,JAKARTA TIMUR,JATINEGARA,BIDARA CINA,32331,23675,8652,4030,12682,2021-06-30
3174101002,JAKARTA SELATAN,PESANGGRAHAN,BINTARO,45843,31591,14241,7056,21297,2021-06-30
3174011005,JAKARTA SELATAN,TEBET,BUKIT DURI,29934,20617,9315,3942,13257,2021-06-30
3171041006,JAKARTA PUSAT,SENEN,BUNGUR,15932,10153,5763,2733,8496,2021-06-30
3175061007,JAKARTA TIMUR,CAKUNG,CAKUNG BARAT,49369,33413,15953,4007,19960,2021-06-30
3175061004,JAKARTA TIMUR,CAKUNG,CAKUNG TIMUR,50344,33701,16633,6375,23008,2021-06-30
3175041007,JAKARTA TIMUR,KRAMAT JATI,CAWANG,28708,20028,8674,4275,12949,2021-06-30
3175101008,JAKARTA TIMUR,CIPAYUNG,CEGER,16381,10899,5481,2565,8046,2021-06-30
3171031006,JAKARTA PUSAT,KEMAYORAN,CEMPAKA BARU,27330,18618,8702,3999,12701,2021-06-30
3171051002,JAKARTA PUSAT,CEMPAKA PUTIH,CEMPAKA PUTIH BARAT,30479,21057,9413,4959,14372,2021-06-30
3171051001,JAKARTA PUSAT,CEMPAKA PUTIH,CEMPAKA PUTIH TIMUR,21553,13475,8074,4434,12508,2021-06-30
3173011001,JAKARTA BARAT,CENGKARENG,CENGKARENG BARAT,57678,34860,22806,8215,31021,2021-06-30
3173011006,JAKARTA BARAT,CENGKARENG,CENGKARENG TIMUR,70122,47040,23070,8509,31579,2021-06-30
3175091002,JAKARTA TIMUR,CIRACAS,CIBUBUR,56927,37381,19535,9428,28963,2021-06-30
3171011002,JAKARTA PUSAT,GAMBIR,CIDENG,14203,8343,5852,3173,9025,2021-06-30
3174091003,JAKARTA SELATAN,JAGAKARSA,CIGANJUR,33127,22100,11013,5158,16171,2021-06-30
3175051003,JAKARTA TIMUR,PASAR REBO,CIJANTUNG,36027,23486,12531,6177,18708,2021-06-30
3171061003,JAKARTA PUSAT,MENTENG,CIKINI,7402,4850,2551,1369,3920,2021-06-30
3174081006,JAKARTA SELATAN,PANCORAN,CIKOKO,9280,5548,3732,1742,5474,2021-06-30
3174061001,JAKARTA SELATAN,CILANDAK,CILANDAK BARAT,45348,27384,17949,7856,25805,2021-06-30
3174041003,JAKARTA SELATAN,PASAR MINGGU,CILANDAK TIMUR,21207,12855,8341,4832,13173,2021-06-30
3175101002,JAKARTA TIMUR,CIPAYUNG,CILANGKAP,23675,16017,7651,3807,11458,2021-06-30
3175041006,JAKARTA TIMUR,KRAMAT JATI,CILILITAN,35164,24649,10506,5224,15730,2021-06-30
3172041001,JAKARTA UTARA,CILINCING,CILINCING,37003,26625,10371,3918,14289,2021-06-30
3175101001,JAKARTA TIMUR,CIPAYUNG,CIPAYUNG,22697,14327,8362,4222,12584,2021-06-30
3174091006,JAKARTA SELATAN,JAGAKARSA,CIPEDAK,32800,21509,11282,4788,16070,2021-06-30
3174061005,JAKARTA SELATAN,CILANDAK,CIPETE SELATAN,23463,15173,8287,3797,12084,2021-06-30
3174071010,JAKARTA SELATAN,KEBAYORAN BARU,CIPETE UTARA,29771,18347,11420,4074,15494,2021-06-30
3175021003,JAKARTA TIMUR,PULO GADUNG,CIPINANG,34608,22880,11719,5997,17716,2021-06-30
3175031007,JAKARTA TIMUR,JATINEGARA,CIPINANG BESAR SELATAN,30655,22649,7998,3890,11888,2021-06-30
3175031008,JAKARTA TIMUR,JATINEGARA,CIPINANG BESAR UTARA,38827,30084,8737,4183,12920,2021-06-30
3175031005,JAKARTA TIMUR,JATINEGARA,CIPINANG CEMPEDAK,29154,20157,8984,4683,13667,2021-06-30
3175081005,JAKARTA TIMUR,MAKASAR,CIPINANG MELAYU,37098,24149,12941,6381,19322,2021-06-30
3175031006,JAKARTA TIMUR,JATINEGARA,CIPINANG MUARA,46861,33505,13349,7271,20620,2021-06-30
3174051003,JAKARTA SELATAN,KEBAYORAN LAMA,CIPULIR,34708,23797,10906,4791,15697,2021-06-30
3175091001,JAKARTA TIMUR,CIRACAS,CIRACAS,55965,36564,19394,8372,27766,2021-06-30
3175041003,JAKARTA TIMUR,KRAMAT JATI,DUKUH,21239,14541,6694,3495,10189,2021-06-30
3175071001,JAKARTA TIMUR,DUREN SAWIT,DUREN SAWIT,53078,35475,17589,9199,26788,2021-06-30
3174081004,JAKARTA SELATAN,PANCORAN,DUREN TIGA,24673,16199,8468,3814,12282,2021-06-30
3173051005,JAKARTA BARAT,KEBON JERUK,DURI KEPA,52942,31821,21104,9917,31021,2021-06-30
3173011002,JAKARTA BARAT,CENGKARENG,DURI KOSAMBI,66093,43394,22689,8172,30861,2021-06-30
3171011006,JAKARTA PUSAT,GAMBIR,DURI PULO,17787,12326,5458,2373,7831,2021-06-30
3173041011,JAKARTA BARAT,TAMBORA,DURI SELATAN,12528,7835,4686,2357,7043,2021-06-30
3173041003,JAKARTA BARAT,TAMBORA,DURI UTARA,17380,11624,5753,2635,8388,2021-06-30
3171081003,JAKARTA PUSAT,JOHAR BARU,GALUR,15811,9494,6317,1962,8279,2021-06-30
3171011001,JAKARTA PUSAT,GAMBIR,GAMBIR,2232,1259,972,577,1549,2021-06-30
3174061004,JAKARTA SELATAN,CILANDAK,GANDARIA SELATAN,19394,12268,7118,2831,9949,2021-06-30
3174071009,JAKARTA SELATAN,KEBAYORAN BARU,GANDARIA UTARA,35026,22575,12446,5341,17787,2021-06-30
3175051001,JAKARTA TIMUR,PASAR REBO,GEDONG,31013,20769,10230,5268,15498,2021-06-30
3171071001,JAKARTA PUSAT,TANAH ABANG,GELORA,2753,1740,1006,567,1573,2021-06-30
3173031007,JAKARTA BARAT,TAMAN SARI,GLODOK,7192,3622,3568,1973,5541,2021-06-30
3171061004,JAKARTA PUSAT,MENTENG,GONDANGDIA,3760,1889,1866,1282,3148,2021-06-30
3173021001,JAKARTA BARAT,GROGOL PETAMBURAN,GROGOL,15067,9679,5382,2597,7979,2021-06-30
3174051005,JAKARTA SELATAN,KEBAYORAN LAMA,GROGOL SELATAN,38688,26614,12065,5448,17513,2021-06-30
3174051004,JAKARTA SELATAN,KEBAYORAN LAMA,GROGOL UTARA,37234,25783,11434,5814,17248,2021-06-30
3174021007,JAKARTA SELATAN,SETIA BUDI,GUNTUR,3590,1923,1664,980,2644,2021-06-30
3174071002,JAKARTA SELATAN,KEBAYORAN BARU,GUNUNG,8309,4894,3414,2023,5437,2021-06-30
3171031005,JAKARTA PUSAT,KEMAYORAN,GUNUNG SAHARI SELATAN,17256,11122,6128,2804,8932,2021-06-30
3171021004,JAKARTA PUSAT,SAWAH BESAR,GUNUNG SAHARI UTARA,13937,7260,6671,3360,10031,2021-06-30
3175081004,JAKARTA TIMUR,MAKASAR,HALIM PERDANA KUSUMAH,24426,11128,13278,9232,22510,2021-06-30
3171031003,JAKARTA PUSAT,KEMAYORAN,HARAPAN MULIA,19987,13778,6204,2683,8887,2021-06-30
3174091001,JAKARTA SELATAN,JAGAKARSA,JAGAKARSA,53714,33877,19821,8470,28291,2021-06-30
3175021007,JAKARTA TIMUR,PULO GADUNG,JATI,28870,18682,10169,5566,15735,2021-06-30
3174041002,JAKARTA SELATAN,PASAR MINGGU,JATI PADANG,32857,21200,11648,5837,17485,2021-06-30
3173071004,JAKARTA BARAT,PALMERAH,JATI PULO,24508,14339,10166,3631,13797,2021-06-30
3175061001,JAKARTA TIMUR,CAKUNG,JATINEGARA,72652,55373,17279,6606,23885,2021-06-30
3175021004,JAKARTA TIMUR,PULO GADUNG,JATINEGARA KAUM,21313,14724,6586,2906,9492,2021-06-30
3173021004,JAKARTA BARAT,GROGOL PETAMBURAN,JELAMBAR,26984,16303,10670,5449,16119,2021-06-30
3173021006,JAKARTA BARAT,GROGOL PETAMBURAN,JELAMBAR BARU,33734,21190,12535,6047,18582,2021-06-30
3173041006,JAKARTA BARAT,TAMBORA,JEMBATAN BESI,25735,19732,6002,2421,8423,2021-06-30
3173041008,JAKARTA BARAT,TAMBORA,JEMBATAN LIMA,18241,13160,5074,2254,7328,2021-06-30
3173081005,JAKARTA BARAT,KEMBANGAN,JOGLO,35285,23236,12044,5916,17960,2021-06-30
3171081001,JAKARTA PUSAT,JOHAR BARU,JOHAR BARU,28311,15644,12661,5315,17976,2021-06-30
3173041002,JAKARTA BARAT,TAMBORA,KALI ANYAR,20624,15291,5331,2228,7559,2021-06-30
3172041004,JAKARTA UTARA,CILINCING,KALIBARU,57771,44350,13418,4319,17737,2021-06-30
3174081002,JAKARTA SELATAN,PANCORAN,KALIBATA,36451,25419,11031,4907,15938,2021-06-30
3173061001,JAKARTA BARAT,KALI DERES,KALIDERES,60209,40636,19554,7544,27098,2021-06-30
3175051004,JAKARTA TIMUR,PASAR REBO,KALISARI,37255,24172,13070,6726,19796,2021-06-30
3173061004,JAKARTA BARAT,KALI DERES,KAMAL,46035,34921,11110,3646,14756,2021-06-30
3172011002,JAKARTA UTARA,PENJARINGAN,KAMAL MUARA,11039,5760,5269,2496,7765,2021-06-30
3171071007,JAKARTA PUSAT,TANAH ABANG,KAMPUNG BALI,10113,7202,2911,1502,4413,2021-06-30
3175031001,JAKARTA TIMUR,JATINEGARA,KAMPUNG MELAYU,22293,16947,5343,2226,7569,2021-06-30
3171081002,JAKARTA PUSAT,JOHAR BARU,KAMPUNG RAWA,15550,7570,7977,2539,10516,2021-06-30
3175041002,JAKARTA TIMUR,KRAMAT JATI,KAMPUNG TENGAH,38048,27533,10506,5224,15730,2021-06-30
3173011005,JAKARTA BARAT,CENGKARENG,KAPUK,104630,74217,30403,9456,39859,2021-06-30
3172011003,JAKARTA UTARA,PENJARINGAN,KAPUK MUARA,31275,18927,12329,6622,18951,2021-06-30
3171021002,JAKARTA PUSAT,SAWAH BESAR,KARANG ANYAR,23056,15233,7812,3392,11204,2021-06-30
3174021004,JAKARTA SELATAN,SETIA BUDI,KARET,8542,5160,3380,1427,4807,2021-06-30
3174021003,JAKARTA SELATAN,SETIA BUDI,KARET KUNINGAN,14166,8527,5635,2316,7951,2021-06-30
3174021002,JAKARTA SELATAN,SETIA BUDI,KARET SEMANGGI,2469,1272,1194,597,1791,2021-06-30
3171071003,JAKARTA PUSAT,TANAH ABANG,KARET TENGSIN,16695,11312,5381,2188,7569,2021-06-30
3171021003,JAKARTA PUSAT,SAWAH BESAR,KARTINI,19916,12459,7453,3441,10894,2021-06-30
3175011003,JAKARTA TIMUR,MATRAMAN,KAYU MANIS,22174,15445,6727,2992,9719,2021-06-30
3175021006,JAKARTA TIMUR,PULO GADUNG,KAYU PUTIH,35916,22003,13895,7001,20896,2021-06-30
3173031006,JAKARTA BARAT,TAMAN SARI,KEAGUNGAN,15262,10407,4852,1991,6843,2021-06-30
3174041007,JAKARTA SELATAN,PASAR MINGGU,KEBAGUSAN,38396,26205,12182,5160,17342,2021-06-30
3174051006,JAKARTA SELATAN,KEBAYORAN LAMA,KEBAYORAN LAMA SELATAN,35920,22296,13615,5769,19384,2021-06-30
3174051001,JAKARTA SELATAN,KEBAYORAN LAMA,KEBAYORAN LAMA UTARA,37004,25212,11782,5219,17001,2021-06-30
3174011004,JAKARTA SELATAN,TEBET,KEBON BARU,30533,19846,10681,5093,15774,2021-06-30
3172021005,JAKARTA UTARA,TANJUNG PRIOK,KEBON BAWANG,44427,28837,15572,6887,22459,2021-06-30
3173051001,JAKARTA BARAT,KEBON JERUK,KEBON JERUK,46870,32831,14026,6757,20783,2021-06-30
3171071006,JAKARTA PUSAT,TANAH ABANG,KEBON KACANG,19075,14130,4942,2610,7552,2021-06-30
3171011005,JAKARTA PUSAT,GAMBIR,KEBON KELAPA,9383,6250,3132,1653,4785,2021-06-30
3171031002,JAKARTA PUSAT,KEMAYORAN,KEBON KOSONG,26178,17596,8578,3445,12023,2021-06-30
3175011005,JAKARTA TIMUR,MATRAMAN,KEBON MANGGIS,14644,9250,5388,2749,8137,2021-06-30
3171071005,JAKARTA PUSAT,TANAH ABANG,KEBON MELATI,27297,21223,6073,2851,8924,2021-06-30
3175081003,JAKARTA TIMUR,MAKASAR,KEBON PALA,40723,27773,12944,6152,19096,2021-06-30
3171061005,JAKARTA PUSAT,MENTENG,KEBON SIRIH,10880,7907,2973,1535,4508,2021-06-30
3173011004,JAKARTA BARAT,CENGKARENG,KEDAUNG KALI ANGKE,28123,16482,11636,3205,14841,2021-06-30
3173051007,JAKARTA BARAT,KEBON JERUK,KEDOYA SELATAN,28300,17971,10309,4577,14886,2021-06-30
3173051006,JAKARTA BARAT,KEBON JERUK,KEDOYA UTARA,38771,22860,15899,6931,22830,2021-06-30
3173051004,JAKARTA BARAT,KEBON JERUK,KELAPA DUA,20509,13392,7112,3113,10225,2021-06-30
3175091003,JAKARTA TIMUR,CIRACAS,KELAPA DUA WETAN,40776,26321,14442,7173,21615,2021-06-30
3172061003,JAKARTA UTARA,KELAPA GADING,KELAPA GADING BARAT,31544,16739,14779,8754,23533,2021-06-30
3172061001,JAKARTA UTARA,KELAPA GADING,KELAPA GADING TIMUR,30470,14553,15905,9078,24983,2021-06-30
3173071005,JAKARTA BARAT,PALMERAH,KEMANGGISAN,28159,17873,10276,5160,15436,2021-06-30
3171031001,JAKARTA PUSAT,KEMAYORAN,KEMAYORAN,18556,11760,6793,2801,9594,2021-06-30
3173081006,JAKARTA BARAT,KEMBANGAN,KEMBANGAN SELATAN,24028,15016,8994,4976,13970,2021-06-30
3173081001,JAKARTA BARAT,KEMBANGAN,KEMBANGAN UTARA,45663,29261,16390,6548,22938,2021-06-30
3171041002,JAKARTA PUSAT,SENEN,KENARI,8328,4789,3538,1729,5267,2021-06-30
3173041005,JAKARTA BARAT,TAMBORA,KERENDANG,17494,12395,5096,2211,7307,2021-06-30
3175071003,JAKARTA TIMUR,DUREN SAWIT,KLENDER,60420,43946,16469,7365,23834,2021-06-30
3172031001,JAKARTA UTARA,KOJA,KOJA,24600,17353,7246,2732,9978,2021-06-30
3173071006,JAKARTA BARAT,PALMERAH,KOTA BAMBU SELATAN,18287,12390,5895,2230,8125,2021-06-30
3173071003,JAKARTA BARAT,PALMERAH,KOTA BAMBU UTARA,21312,14775,6536,2763,9299,2021-06-30
3171041004,JAKARTA PUSAT,SENEN,KRAMAT,25258,18035,7221,2962,10183,2021-06-30
3175041001,JAKARTA TIMUR,KRAMAT JATI,KRAMAT JATI,29922,19978,9936,4975,14911,2021-06-30
3174071003,JAKARTA SELATAN,KEBAYORAN BARU,KRAMAT PELA,12737,7418,5316,2365,7681,2021-06-30
3173031002,JAKARTA BARAT,TAMAN SARI,KRUKUT,17023,11090,5926,2270,8196,2021-06-30
3174031005,JAKARTA SELATAN,MAMPANG PRAPATAN,KUNINGAN BARAT,11229,7117,4109,1539,5648,2021-06-30
3174021008,JAKARTA SELATAN,SETIA BUDI,KUNINGAN TIMUR,5331,3274,2055,1049,3104,2021-06-30
3171041005,JAKARTA PUSAT,SENEN,KWITANG,13487,8533,4952,2077,7029,2021-06-30
3172031003,JAKARTA UTARA,KOJA,LAGOA,51431,37069,14355,5624,19979,2021-06-30
3174061002,JAKARTA SELATAN,CILANDAK,LEBAK BULUS,32738,21285,11443,5809,17252,2021-06-30
3174091004,JAKARTA SELATAN,JAGAKARSA,LENTENG AGUNG,46600,33407,13190,6108,19298,2021-06-30
3175101007,JAKARTA TIMUR,CIPAYUNG,LUBANG BUAYA,55114,36890,18216,8357,26573,2021-06-30
3175081001,JAKARTA TIMUR,MAKASAR,MAKASAR,30013,19016,10989,4937,15926,2021-06-30
3175071006,JAKARTA TIMUR,DUREN SAWIT,MALAKA JAYA,26798,16828,9963,5446,15409,2021-06-30
3175071005,JAKARTA TIMUR,DUREN SAWIT,MALAKA SARI,23691,14287,9397,5382,14779,2021-06-30
3174031001,JAKARTA SELATAN,MAMPANG PRAPATAN,MAMPANG PRAPATAN,15885,11031,4849,2047,6896,2021-06-30
3173031005,JAKARTA BARAT,TAMAN SARI,MANGGA BESAR,6690,3702,2986,1441,4427,2021-06-30
3171021005,JAKARTA PUSAT,SAWAH BESAR,MANGGA DUA SELATAN,24940,16405,8530,3838,12368,2021-06-30
3174011007,JAKARTA SELATAN,TEBET,MANGGARAI,24972,16795,8171,3544,11715,2021-06-30
3174011006,JAKARTA SELATAN,TEBET,MANGGARAI SELATAN,20274,12344,7927,3190,11117,2021-06-30
3173031003,JAKARTA BARAT,TAMAN SARI,MAPHAR,14671,9131,5540,2555,8095,2021-06-30
3172041003,JAKARTA UTARA,CILINCING,MARUNDA,24385,15243,9139,2570,11709,2021-06-30
3174071001,JAKARTA SELATAN,KEBAYORAN BARU,MELAWAI,2386,1167,1217,818,2035,2021-06-30
3171061001,JAKARTA PUSAT,MENTENG,MENTENG,22450,16113,6332,3492,9824,2021-06-30
3174021005,JAKARTA SELATAN,SETIA BUDI,MENTENG ATAS,24369,15122,9242,3991,13233,2021-06-30
3174011003,JAKARTA SELATAN,TEBET,MENTENG DALAM,31623,20888,10724,5146,15870,2021-06-30
3173081003,JAKARTA BARAT,KEMBANGAN,MERUYA SELATAN,27261,17780,9469,4305,13774,2021-06-30
3173081002,JAKARTA BARAT,KEMBANGAN,MERUYA UTARA,38525,25223,13298,6896,20194,2021-06-30
3175101004,JAKARTA TIMUR,CIPAYUNG,MUNJUL,20582,13848,6731,3579,10310,2021-06-30
3172051002,JAKARTA UTARA,PADEMANGAN,PADEMANGAN BARAT,64756,45016,19734,7772,27506,2021-06-30
3172051001,JAKARTA UTARA,PADEMANGAN,PADEMANGAN TIMUR,32689,17924,14748,6861,21609,2021-06-30
3175011004,JAKARTA TIMUR,MATRAMAN,PAL MERIAM,17550,11591,5955,2700,8655,2021-06-30
3173071001,JAKARTA BARAT,PALMERAH,PALMERAH,54706,36239,18458,7966,26424,2021-06-30
3174081001,JAKARTA SELATAN,PANCORAN,PANCORAN,16983,11324,5658,2633,8291,2021-06-30
3172021003,JAKARTA UTARA,TANJUNG PRIOK,PAPANGGO,33902,22315,11570,4668,16238,2021-06-30
3171021001,JAKARTA PUSAT,SAWAH BESAR,PASAR BARU,11656,6162,5488,2899,8387,2021-06-30
3174021006,JAKARTA SELATAN,SETIA BUDI,PASAR MANGGIS,23415,15094,8315,3528,11843,2021-06-30
3174041001,JAKARTA SELATAN,PASAR MINGGU,PASAR MINGGU,21700,13722,7972,4536,12508,2021-06-30
3171041003,JAKARTA PUSAT,SENEN,PASEBAN,20652,13486,7160,3287,10447,2021-06-30
3173061005,JAKARTA BARAT,KALI DERES,PEGADUNGAN,65248,42935,22292,9051,31343,2021-06-30
3171061002,JAKARTA PUSAT,MENTENG,PEGANGSAAN,18427,12197,6228,2919,9147,2021-06-30
3172061002,JAKARTA UTARA,KELAPA GADING,PEGANGSAAN DUA,44451,22978,21452,10417,31869,2021-06-30
3172011004,JAKARTA UTARA,PENJARINGAN,PEJAGALAN,66008,42137,23851,10850,34701,2021-06-30
3174041006,JAKARTA SELATAN,PASAR MINGGU,PEJATEN BARAT,30591,19021,11559,5532,17091,2021-06-30
3174041005,JAKARTA SELATAN,PASAR MINGGU,PEJATEN TIMUR,50150,34623,15520,5995,21515,2021-06-30
3175051005,JAKARTA TIMUR,PASAR REBO,PEKAYON,37440,24347,13088,6019,19107,2021-06-30
3173041009,JAKARTA BARAT,TAMBORA,PEKOJAN,20921,13540,7376,3402,10778,2021-06-30
3174031003,JAKARTA SELATAN,MAMPANG PRAPATAN,PELA MAMPANG,37784,25218,12554,5580,18134,2021-06-30
3174081005,JAKARTA SELATAN,PANCORAN,PENGADEGAN,18685,10445,8235,3305,11540,2021-06-30
3175061003,JAKARTA TIMUR,CAKUNG,PENGGILINGAN,84511,63271,21238,9272,30510,2021-06-30
3172011001,JAKARTA UTARA,PENJARINGAN,PENJARINGAN,75505,53109,22385,7793,30178,2021-06-30
3174101001,JAKARTA SELATAN,PESANGGRAHAN,PESANGGRAHAN,23733,13654,10075,4858,14933,2021-06-30
3171071004,JAKARTA PUSAT,TANAH ABANG,PETAMBURAN,28974,22426,6544,2910,9454,2021-06-30
3174071008,JAKARTA SELATAN,KEBAYORAN BARU,PETOGOGAN,10203,6226,3976,1834,5810,2021-06-30
3171011004,JAKARTA PUSAT,GAMBIR,PETOJO SELATAN,13506,8332,5165,2991,8156,2021-06-30
3171011003,JAKARTA PUSAT,GAMBIR,PETOJO UTARA,16084,10609,5473,2686,8159,2021-06-30
3174101004,JAKARTA SELATAN,PESANGGRAHAN,PETUKANGAN SELATAN,32229,20644,11583,4889,16472,2021-06-30
3174101003,JAKARTA SELATAN,PESANGGRAHAN,PETUKANGAN UTARA,46427,30952,15472,6693,22165,2021-06-30
3175081002,JAKARTA TIMUR,MAKASAR,PINANG RANTI,23465,15129,8333,3427,11760,2021-06-30
3173031008,JAKARTA BARAT,TAMAN SARI,PINANGSIA,9405,5592,3812,1620,5432,2021-06-30
3175011001,JAKARTA TIMUR,MATRAMAN,PISANGAN BARU,27793,19934,7852,3794,11646,2021-06-30
3175021002,JAKARTA TIMUR,PULO GADUNG,PISANGAN TIMUR,35717,23424,12285,5571,17856,2021-06-30
3172011005,JAKARTA UTARA,PENJARINGAN,PLUIT,42979,23217,19731,12252,31983,2021-06-30
3175071002,JAKARTA TIMUR,DUREN SAWIT,PONDOK BAMBU,53658,35160,18485,8793,27278,2021-06-30
3175071004,JAKARTA TIMUR,DUREN SAWIT,PONDOK KELAPA,62704,41528,21161,10879,32040,2021-06-30
3175071007,JAKARTA TIMUR,DUREN SAWIT,PONDOK KOPI,30741,21646,9091,4308,13399,2021-06-30
3174061003,JAKARTA SELATAN,CILANDAK,PONDOK LABU,39778,25435,14330,6812,21142,2021-06-30
3174051002,JAKARTA SELATAN,KEBAYORAN LAMA,PONDOK PINANG,49276,32298,16956,9317,26273,2021-06-30
3175101003,JAKARTA TIMUR,CIPAYUNG,PONDOK RANGGON,21791,15161,6622,3766,10388,2021-06-30
3101011003,KAB.ADM.KEP.SERIBU,KEP. SERIBU UTARA,PULAU HARAPAN,1785,538,1247,666,1913,2021-06-30
3101011002,KAB.ADM.KEP.SERIBU,KEP. SERIBU UTARA,PULAU KELAPA,4729,1395,3334,1078,4412,2021-06-30
3101011001,KAB.ADM.KEP.SERIBU,KEP. SERIBU UTARA,PULAU PANGGANG,4667,1346,3321,1138,4459,2021-06-30
3101021003,KAB.ADM.KEP.SERIBU,KEP. SERIBU SELATAN,PULAU PARI,2370,459,1911,612,2523,2021-06-30
3101021002,KAB.ADM.KEP.SERIBU,KEP. SERIBU SELATAN,PULAU TIDUNG,3922,1216,2705,1133,3838,2021-06-30
3101021001,KAB.ADM.KEP.SERIBU,KEP. SERIBU SELATAN,PULAU UNTUNG JAWA,1665,448,1217,558,1775,2021-06-30
3174071007,JAKARTA SELATAN,KEBAYORAN BARU,PULO,5184,2890,2292,1337,3629,2021-06-30
3175021001,JAKARTA TIMUR,PULO GADUNG,PULO GADUNG,30292,20736,9547,4618,14165,2021-06-30
3175061005,JAKARTA TIMUR,CAKUNG,PULO GEBANG,83832,59783,24040,10544,34584,2021-06-30
3174041004,JAKARTA SELATAN,PASAR MINGGU,RAGUNAN,34536,21441,13082,5769,18851,2021-06-30
3175091005,JAKARTA TIMUR,CIRACAS,RAMBUTAN,31759,23492,8261,4255,12516,2021-06-30
3172031006,JAKARTA UTARA,KOJA,RAWA BADAK SELATAN,36403,26846,9554,3920,13474,2021-06-30
3172031004,JAKARTA UTARA,KOJA,RAWA BADAK UTARA,29198,19151,10042,3830,13872,2021-06-30
3174071005,JAKARTA SELATAN,KEBAYORAN BARU,RAWA BARAT,5029,2856,2172,1317,3489,2021-06-30
3173011003,JAKARTA BARAT,CENGKARENG,RAWA BUAYA,51752,33822,17921,5971,23892,2021-06-30
3175031004,JAKARTA TIMUR,JATINEGARA,RAWA BUNGA,18617,13453,5163,2456,7619,2021-06-30
3174081003,JAKARTA SELATAN,PANCORAN,RAWA JATI,18210,11302,6902,3390,10292,2021-06-30
3175061002,JAKARTA TIMUR,CAKUNG,RAWA TERATE,21332,13290,8040,2049,10089,2021-06-30
3175021005,JAKARTA TIMUR,PULO GADUNG,RAWAMANGUN,32470,21081,11382,5818,17200,2021-06-30
3171051003,JAKARTA PUSAT,CEMPAKA PUTIH,RAWASARI,19312,12442,6860,3464,10324,2021-06-30
3173041010,JAKARTA BARAT,TAMBORA,ROA MALAKA,3149,1634,1511,877,2388,2021-06-30
3172041006,JAKARTA UTARA,CILINCING,ROROTAN,35258,22945,12309,4574,16883,2021-06-30
3174071004,JAKARTA SELATAN,KEBAYORAN BARU,SELONG,2576,1289,1284,877,2161,2021-06-30
3173061002,JAKARTA BARAT,KALI DERES,SEMANAN,60715,44831,15879,4952,20831,2021-06-30
3172041007,JAKARTA UTARA,CILINCING,SEMPER BARAT,59323,37770,21538,9041,30579,2021-06-30
3172041005,JAKARTA UTARA,CILINCING,SEMPER TIMUR,31249,20699,10547,4280,14827,2021-06-30
3174071006,JAKARTA SELATAN,KEBAYORAN BARU,SENAYAN,2482,1573,906,567,1473,2021-06-30
3171041001,JAKARTA PUSAT,SENEN,SENEN,5951,3629,2321,1174,3495,2021-06-30
3171031004,JAKARTA PUSAT,KEMAYORAN,SERDANG,26045,16856,9186,3921,13107,2021-06-30
3174021001,JAKARTA SELATAN,SETIA BUDI,SETIA BUDI,2532,1461,1068,643,1711,2021-06-30
3175101005,JAKARTA TIMUR,CIPAYUNG,SETU,17609,12614,4993,2662,7655,2021-06-30
3173071002,JAKARTA BARAT,PALMERAH,SLIPI,14526,9020,5503,2708,8211,2021-06-30
3173081004,JAKARTA BARAT,KEMBANGAN,SRENGSENG,39370,27246,12109,6133,18242,2021-06-30
3174091002,JAKARTA SELATAN,JAGAKARSA,SRENGSENG SAWAH,50305,29427,20863,8864,29727,2021-06-30
3173051003,JAKARTA BARAT,KEBON JERUK,SUKABUMI SELATAN,30581,21682,8898,3456,12354,2021-06-30
3173051002,JAKARTA BARAT,KEBON JERUK,SUKABUMI UTARA,33050,24254,8793,3989,12782,2021-06-30
3172041002,JAKARTA UTARA,CILINCING,SUKAPURA,46955,32455,14493,5420,19913,2021-06-30
3171031007,JAKARTA PUSAT,KEMAYORAN,SUMUR BATU,19863,12583,7276,3385,10661,2021-06-30
3172021004,JAKARTA UTARA,TANJUNG PRIOK,SUNGAI BAMBU,25366,16228,9133,3511,12644,2021-06-30
3172021006,JAKARTA UTARA,TANJUNG PRIOK,SUNTER AGUNG,62904,35733,27142,13437,40579,2021-06-30
3172021002,JAKARTA UTARA,TANJUNG PRIOK,SUNTER JAYA,55168,33910,21237,10404,31641,2021-06-30
3175091004,JAKARTA TIMUR,CIRACAS,SUSUKAN,28884,18996,9886,4581,14467,2021-06-30
3173031001,JAKARTA BARAT,TAMAN SARI,TAMAN SARI,12915,8192,4721,2381,7102,2021-06-30
3173041001,JAKARTA BARAT,TAMBORA,TAMBORA,9087,5867,3220,1512,4732,2021-06-30
3173041004,JAKARTA BARAT,TAMBORA,TANAH SEREAL,23141,14098,9041,3863,12904,2021-06-30
3171081004,JAKARTA PUSAT,JOHAR BARU,TANAH TINGGI,32931,20765,12164,4235,16399,2021-06-30
3173031004,JAKARTA BARAT,TAMAN SARI,TANGKI,11593,7199,4391,1921,6312,2021-06-30
3174091005,JAKARTA SELATAN,JAGAKARSA,TANJUNG BARAT,34530,23626,10898,5629,16527,2021-06-30
3173021005,JAKARTA BARAT,GROGOL PETAMBURAN,TANJUNG DUREN SELATAN,22469,12459,9997,4433,14430,2021-06-30
3173021002,JAKARTA BARAT,GROGOL PETAMBURAN,TANJUNG DUREN UTARA,15224,8114,7104,3514,10618,2021-06-30
3172021001,JAKARTA UTARA,TANJUNG PRIOK,TANJUNG PRIOK,29913,18100,11804,3821,15625,2021-06-30
3174011002,JAKARTA SELATAN,TEBET,TEBET BARAT,18916,11245,7663,4154,11817,2021-06-30
3174011001,JAKARTA SELATAN,TEBET,TEBET TIMUR,16031,8863,7161,3712,10873,2021-06-30
3173061003,JAKARTA BARAT,KALI DERES,TEGAL ALUR,71923,51361,20553,6825,27378,2021-06-30
3174031004,JAKARTA SELATAN,MAMPANG PRAPATAN,TEGAL PARANG,28143,20869,7270,3289,10559,2021-06-30
3173021003,JAKARTA BARAT,GROGOL PETAMBURAN,TOMANG,25531,15190,10330,4957,15287,2021-06-30
3172031005,JAKARTA UTARA,KOJA,TUGU SELATAN,33663,24142,9516,3805,13321,2021-06-30
3172031002,JAKARTA UTARA,KOJA,TUGU UTARA,58638,42815,15818,6704,22522,2021-06-30
3175061006,JAKARTA TIMUR,CAKUNG,UJUNG MENTENG,25702,16675,9017,3948,12965,2021-06-30
3174101005,JAKARTA SELATAN,PESANGGRAHAN,ULUJAMI,35077,24293,10778,4907,15685,2021-06-30
3175011006,JAKARTA TIMUR,MATRAMAN,UTAN KAYU SELATAN,29303,18646,10646,5017,15663,2021-06-30
3175011002,JAKARTA TIMUR,MATRAMAN,UTAN KAYU UTARA,24728,15868,8859,3790,12649,2021-06-30
3171031008,JAKARTA PUSAT,KEMAYORAN,UTAN PANJANG,25622,18451,7170,2787,9957,2021-06-30
3172021007,JAKARTA UTARA,TANJUNG PRIOK,WARAKAS,38194,25061,13119,5186,18305,2021-06-30
3173021007,JAKARTA BARAT,GROGOL PETAMBURAN,WIJAYA KUSUMA,34170,22658,11499,4841,16340,2021-06-30
3172051003,JAKARTA UTARA,PADEMANGAN,ANCOL,20393,13272,7114,3287,10401,2021-07-01
3173041007,JAKARTA BARAT,TAMBORA,ANGKE,25785,16477,9299,3221,12520,2021-07-01
3175041005,JAKARTA TIMUR,KRAMAT JATI,BALE KAMBANG,25158,18849,6301,2644,8945,2021-07-01
3175031003,JAKARTA TIMUR,JATINEGARA,BALI MESTER,8683,5743,2937,1517,4454,2021-07-01
3175101006,JAKARTA TIMUR,CIPAYUNG,BAMBU APUS,22768,15407,7357,3985,11342,2021-07-01
3174031002,JAKARTA SELATAN,MAMPANG PRAPATAN,BANGKA,18930,12503,6421,2704,9125,2021-07-01
3175051002,JAKARTA TIMUR,PASAR REBO,BARU,20267,11268,8982,4674,13656,2021-07-01
3175041004,JAKARTA TIMUR,KRAMAT JATI,BATU AMPAR,41389,30358,11020,5254,16274,2021-07-01
3171071002,JAKARTA PUSAT,TANAH ABANG,BENDUNGAN HILIR,19008,11502,7499,3566,11065,2021-07-01
3175031002,JAKARTA TIMUR,JATINEGARA,BIDARA CINA,32331,23395,8932,4034,12966,2021-07-01
3174101002,JAKARTA SELATAN,PESANGGRAHAN,BINTARO,45843,31042,14790,7070,21860,2021-07-01
3174011005,JAKARTA SELATAN,TEBET,BUKIT DURI,29934,20254,9678,3957,13635,2021-07-01
3171041006,JAKARTA PUSAT,SENEN,BUNGUR,15932,9968,5948,2739,8687,2021-07-01
3175061007,JAKARTA TIMUR,CAKUNG,CAKUNG BARAT,49369,32912,16454,4011,20465,2021-07-01
3175061004,JAKARTA TIMUR,CAKUNG,CAKUNG TIMUR,50344,33061,17273,6385,23658,2021-07-01
3175041007,JAKARTA TIMUR,KRAMAT JATI,CAWANG,28708,19737,8965,4286,13251,2021-07-01
3175101008,JAKARTA TIMUR,CIPAYUNG,CEGER,16381,10775,5605,2567,8172,2021-07-01
3171031006,JAKARTA PUSAT,KEMAYORAN,CEMPAKA BARU,27330,18417,8902,4008,12910,2021-07-01
3171051002,JAKARTA PUSAT,CEMPAKA PUTIH,CEMPAKA PUTIH BARAT,30479,20831,9639,4970,14609,2021-07-01
3171051001,JAKARTA PUSAT,CEMPAKA PUTIH,CEMPAKA PUTIH TIMUR,21553,13314,8234,4446,12680,2021-07-01
3173011001,JAKARTA BARAT,CENGKARENG,CENGKARENG BARAT,57678,34297,23367,8236,31603,2021-07-01
3173011006,JAKARTA BARAT,CENGKARENG,CENGKARENG TIMUR,70122,46208,23900,8517,32417,2021-07-01
3175091002,JAKARTA TIMUR,CIRACAS,CIBUBUR,56927,36733,20181,9445,29626,2021-07-01
3171011002,JAKARTA PUSAT,GAMBIR,CIDENG,14203,8247,5948,3182,9130,2021-07-01
3174091003,JAKARTA SELATAN,JAGAKARSA,CIGANJUR,33127,21739,11374,5163,16537,2021-07-01
3175051003,JAKARTA TIMUR,PASAR REBO,CIJANTUNG,36027,23138,12879,6190,19069,2021-07-01
3171061003,JAKARTA PUSAT,MENTENG,CIKINI,7402,4773,2628,1371,3999,2021-07-01
3174081006,JAKARTA SELATAN,PANCORAN,CIKOKO,9280,5392,3888,1745,5633,2021-07-01
3174061001,JAKARTA SELATAN,CILANDAK,CILANDAK BARAT,45348,26802,18530,7868,26398,2021-07-01
3174041003,JAKARTA SELATAN,PASAR MINGGU,CILANDAK TIMUR,21207,12625,8571,4839,13410,2021-07-01
3175101002,JAKARTA TIMUR,CIPAYUNG,CILANGKAP,23675,15808,7860,3812,11672,2021-07-01
3175041006,JAKARTA TIMUR,KRAMAT JATI,CILILITAN,35164,24458,10697,5242,15939,2021-07-01
3172041001,JAKARTA UTARA,CILINCING,CILINCING,37003,26181,10815,3926,14741,2021-07-01
3175101001,JAKARTA TIMUR,CIPAYUNG,CIPAYUNG,22697,14124,8565,4227,12792,2021-07-01
3174091006,JAKARTA SELATAN,JAGAKARSA,CIPEDAK,32800,21112,11679,4793,16472,2021-07-01
3174061005,JAKARTA SELATAN,CILANDAK,CIPETE SELATAN,23463,14949,8511,3806,12317,2021-07-01
3174071010,JAKARTA SELATAN,KEBAYORAN BARU,CIPETE UTARA,29771,18080,11687,4082,15769,2021-07-01
3175021003,JAKARTA TIMUR,PULO GADUNG,CIPINANG,34608,22570,12029,6008,18037,2021-07-01
3175031007,JAKARTA TIMUR,JATINEGARA,CIPINANG BESAR SELATAN,30655,22388,8258,3898,12156,2021-07-01
3175031008,JAKARTA TIMUR,JATINEGARA,CIPINANG BESAR UTARA,38827,29839,8982,4187,13169,2021-07-01
3175031005,JAKARTA TIMUR,JATINEGARA,CIPINANG CEMPEDAK,29154,19938,9202,4692,13894,2021-07-01
3175081005,JAKARTA TIMUR,MAKASAR,CIPINANG MELAYU,37098,23732,13358,6393,19751,2021-07-01
3175031006,JAKARTA TIMUR,JATINEGARA,CIPINANG MUARA,46861,33173,13681,7286,20967,2021-07-01
3174051003,JAKARTA SELATAN,KEBAYORAN LAMA,CIPULIR,34708,23388,11315,4800,16115,2021-07-01
3175091001,JAKARTA TIMUR,CIRACAS,CIRACAS,55965,36020,19937,8388,28325,2021-07-01
3175041003,JAKARTA TIMUR,KRAMAT JATI,DUKUH,21239,14371,6863,3503,10366,2021-07-01
3175071001,JAKARTA TIMUR,DUREN SAWIT,DUREN SAWIT,53078,34975,18089,9218,27307,2021-07-01
3174081004,JAKARTA SELATAN,PANCORAN,DUREN TIGA,24673,15943,8723,3820,12543,2021-07-01
3173051005,JAKARTA BARAT,KEBON JERUK,DURI KEPA,52942,31244,21679,9949,31628,2021-07-01
3173011002,JAKARTA BARAT,CENGKARENG,DURI KOSAMBI,66093,42766,23317,8205,31522,2021-07-01
3171011006,JAKARTA PUSAT,GAMBIR,DURI PULO,17787,12207,5577,2376,7953,2021-07-01
3173041011,JAKARTA BARAT,TAMBORA,DURI SELATAN,12528,7737,4784,2363,7147,2021-07-01
3173041003,JAKARTA BARAT,TAMBORA,DURI UTARA,17380,11489,5888,2637,8525,2021-07-01
3171081003,JAKARTA PUSAT,JOHAR BARU,GALUR,15811,9306,6505,1966,8471,2021-07-01
3171011001,JAKARTA PUSAT,GAMBIR,GAMBIR,2232,1251,980,578,1558,2021-07-01
3174061004,JAKARTA SELATAN,CILANDAK,GANDARIA SELATAN,19394,12094,7292,2832,10124,2021-07-01
3174071009,JAKARTA SELATAN,KEBAYORAN BARU,GANDARIA UTARA,35026,22325,12696,5353,18049,2021-07-01
3175051001,JAKARTA TIMUR,PASAR REBO,GEDONG,31013,20541,10458,5274,15732,2021-07-01
3171071001,JAKARTA PUSAT,TANAH ABANG,GELORA,2753,1707,1039,567,1606,2021-07-01
3173031007,JAKARTA BARAT,TAMAN SARI,GLODOK,7192,3561,3629,1977,5606,2021-07-01
3171061004,JAKARTA PUSAT,MENTENG,GONDANGDIA,3760,1866,1889,1285,3174,2021-07-01
3173021001,JAKARTA BARAT,GROGOL PETAMBURAN,GROGOL,15067,9527,5534,2603,8137,2021-07-01
3174051005,JAKARTA SELATAN,KEBAYORAN LAMA,GROGOL SELATAN,38688,26395,12284,5457,17741,2021-07-01
3174051004,JAKARTA SELATAN,KEBAYORAN LAMA,GROGOL UTARA,37234,25516,11700,5825,17525,2021-07-01
3174021007,JAKARTA SELATAN,SETIA BUDI,GUNTUR,3590,1909,1678,984,2662,2021-07-01
3174071002,JAKARTA SELATAN,KEBAYORAN BARU,GUNUNG,8309,4813,3495,2027,5522,2021-07-01
3171031005,JAKARTA PUSAT,KEMAYORAN,GUNUNG SAHARI SELATAN,17256,10947,6303,2814,9117,2021-07-01
3171021004,JAKARTA PUSAT,SAWAH BESAR,GUNUNG SAHARI UTARA,13937,7140,6790,3366,10156,2021-07-01
3175081004,JAKARTA TIMUR,MAKASAR,HALIM PERDANA KUSUMAH,24426,10932,13473,9286,22759,2021-07-01
3171031003,JAKARTA PUSAT,KEMAYORAN,HARAPAN MULIA,19987,13623,6358,2690,9048,2021-07-01
3174091001,JAKARTA SELATAN,JAGAKARSA,JAGAKARSA,53714,33301,20397,8486,28883,2021-07-01
3175021007,JAKARTA TIMUR,PULO GADUNG,JATI,28870,18450,10401,5574,15975,2021-07-01
3174041002,JAKARTA SELATAN,PASAR MINGGU,JATI PADANG,32857,20902,11946,5848,17794,2021-07-01
3173071004,JAKARTA BARAT,PALMERAH,JATI PULO,24508,14204,10301,3638,13939,2021-07-01
3175061001,JAKARTA TIMUR,CAKUNG,JATINEGARA,72652,54375,18277,6618,24895,2021-07-01
3175021004,JAKARTA TIMUR,PULO GADUNG,JATINEGARA KAUM,21313,14540,6770,2914,9684,2021-07-01
3173021004,JAKARTA BARAT,GROGOL PETAMBURAN,JELAMBAR,26984,15998,10975,5461,16436,2021-07-01
3173021006,JAKARTA BARAT,GROGOL PETAMBURAN,JELAMBAR BARU,33734,20850,12875,6059,18934,2021-07-01
3173041006,JAKARTA BARAT,TAMBORA,JEMBATAN BESI,25735,19531,6203,2423,8626,2021-07-01
3173041008,JAKARTA BARAT,TAMBORA,JEMBATAN LIMA,18241,12979,5255,2258,7513,2021-07-01
3173081005,JAKARTA BARAT,KEMBANGAN,JOGLO,35285,22899,12381,5937,18318,2021-07-01
3171081001,JAKARTA PUSAT,JOHAR BARU,JOHAR BARU,28311,15419,12886,5320,18206,2021-07-01
3173041002,JAKARTA BARAT,TAMBORA,KALI ANYAR,20624,15136,5486,2231,7717,2021-07-01
3172041004,JAKARTA UTARA,CILINCING,KALIBARU,57771,43708,14060,4326,18386,2021-07-01
3174081002,JAKARTA SELATAN,PANCORAN,KALIBATA,36451,25169,11281,4912,16193,2021-07-01
3173061001,JAKARTA BARAT,KALI DERES,KALIDERES,60209,40068,20122,7568,27690,2021-07-01
3175051004,JAKARTA TIMUR,PASAR REBO,KALISARI,37255,23825,13416,6741,20157,2021-07-01
3173061004,JAKARTA BARAT,KALI DERES,KAMAL,46035,34576,11455,3651,15106,2021-07-01
3172011002,JAKARTA UTARA,PENJARINGAN,KAMAL MUARA,11039,5598,5431,2499,7930,2021-07-01
3171071007,JAKARTA PUSAT,TANAH ABANG,KAMPUNG BALI,10113,7129,2984,1504,4488,2021-07-01
3175031001,JAKARTA TIMUR,JATINEGARA,KAMPUNG MELAYU,22293,16813,5477,2233,7710,2021-07-01
3171081002,JAKARTA PUSAT,JOHAR BARU,KAMPUNG RAWA,15550,7386,8161,2543,10704,2021-07-01
3175041002,JAKARTA TIMUR,KRAMAT JATI,KAMPUNG TENGAH,38048,27248,10790,5240,16030,2021-07-01
3173011005,JAKARTA BARAT,CENGKARENG,KAPUK,104630,72832,31788,9472,41260,2021-07-01
3172011003,JAKARTA UTARA,PENJARINGAN,KAPUK MUARA,31275,18505,12751,6632,19383,2021-07-01
3171021002,JAKARTA PUSAT,SAWAH BESAR,KARANG ANYAR,23056,15040,8005,3397,11402,2021-07-01
3174021004,JAKARTA SELATAN,SETIA BUDI,KARET,8542,5082,3458,1431,4889,2021-07-01
3174021003,JAKARTA SELATAN,SETIA BUDI,KARET KUNINGAN,14166,8403,5759,2318,8077,2021-07-01
3174021002,JAKARTA SELATAN,SETIA BUDI,KARET SEMANGGI,2469,1240,1226,597,1823,2021-07-01
3171071003,JAKARTA PUSAT,TANAH ABANG,KARET TENGSIN,16695,11165,5527,2196,7723,2021-07-01
3171021003,JAKARTA PUSAT,SAWAH BESAR,KARTINI,19916,12272,7640,3450,11090,2021-07-01
3175011003,JAKARTA TIMUR,MATRAMAN,KAYU MANIS,22174,15238,6934,3000,9934,2021-07-01
3175021006,JAKARTA TIMUR,PULO GADUNG,KAYU PUTIH,35916,21683,14215,7008,21223,2021-07-01
3173031006,JAKARTA BARAT,TAMAN SARI,KEAGUNGAN,15262,10275,4984,1993,6977,2021-07-01
3174041007,JAKARTA SELATAN,PASAR MINGGU,KEBAGUSAN,38396,25856,12531,5162,17693,2021-07-01
3174051006,JAKARTA SELATAN,KEBAYORAN LAMA,KEBAYORAN LAMA SELATAN,35920,21934,13977,5775,19752,2021-07-01
3174051001,JAKARTA SELATAN,KEBAYORAN LAMA,KEBAYORAN LAMA UTARA,37004,24969,12025,5233,17258,2021-07-01
3174011004,JAKARTA SELATAN,TEBET,KEBON BARU,30533,19502,11025,5114,16139,2021-07-01
3172021005,JAKARTA UTARA,TANJUNG PRIOK,KEBON BAWANG,44427,28497,15912,6900,22812,2021-07-01
3173051001,JAKARTA BARAT,KEBON JERUK,KEBON JERUK,46870,32410,14446,6769,21215,2021-07-01
3171071006,JAKARTA PUSAT,TANAH ABANG,KEBON KACANG,19075,14044,5028,2612,7640,2021-07-01
3171011005,JAKARTA PUSAT,GAMBIR,KEBON KELAPA,9383,6170,3212,1656,4868,2021-07-01
3171031002,JAKARTA PUSAT,KEMAYORAN,KEBON KOSONG,26178,17370,8804,3454,12258,2021-07-01
3175011005,JAKARTA TIMUR,MATRAMAN,KEBON MANGGIS,14644,9098,5540,2756,8296,2021-07-01
3171071005,JAKARTA PUSAT,TANAH ABANG,KEBON MELATI,27297,21096,6200,2854,9054,2021-07-01
3175081003,JAKARTA TIMUR,MAKASAR,KEBON PALA,40723,27462,13255,6163,19418,2021-07-01
3171061005,JAKARTA PUSAT,MENTENG,KEBON SIRIH,10880,7822,3058,1539,4597,2021-07-01
3173011004,JAKARTA BARAT,CENGKARENG,KEDAUNG KALI ANGKE,28123,16356,11762,3208,14970,2021-07-01
3173051007,JAKARTA BARAT,KEBON JERUK,KEDOYA SELATAN,28300,17656,10624,4586,15210,2021-07-01
3173051006,JAKARTA BARAT,KEBON JERUK,KEDOYA UTARA,38771,22539,16220,6940,23160,2021-07-01
3173051004,JAKARTA BARAT,KEBON JERUK,KELAPA DUA,20509,13160,7344,3119,10463,2021-07-01
3175091003,JAKARTA TIMUR,CIRACAS,KELAPA DUA WETAN,40776,25996,14767,7187,21954,2021-07-01
3172061003,JAKARTA UTARA,KELAPA GADING,KELAPA GADING BARAT,31544,16241,15276,8772,24048,2021-07-01
3172061001,JAKARTA UTARA,KELAPA GADING,KELAPA GADING TIMUR,30470,14229,16228,9102,25330,2021-07-01
3173071005,JAKARTA BARAT,PALMERAH,KEMANGGISAN,28159,17621,10528,5173,15701,2021-07-01
3171031001,JAKARTA PUSAT,KEMAYORAN,KEMAYORAN,18556,11523,7030,2804,9834,2021-07-01
3173081006,JAKARTA BARAT,KEMBANGAN,KEMBANGAN SELATAN,24028,14892,9118,4981,14099,2021-07-01
3173081001,JAKARTA BARAT,KEMBANGAN,KEMBANGAN UTARA,45663,29042,16609,6561,23170,2021-07-01
3171041002,JAKARTA PUSAT,SENEN,KENARI,8328,4745,3582,1729,5311,2021-07-01
3173041005,JAKARTA BARAT,TAMBORA,KERENDANG,17494,12237,5254,2215,7469,2021-07-01
3175071003,JAKARTA TIMUR,DUREN SAWIT,KLENDER,60420,43508,16906,7385,24291,2021-07-01
3172031001,JAKARTA UTARA,KOJA,KOJA,24600,17157,7442,2734,10176,2021-07-01
3173071006,JAKARTA BARAT,PALMERAH,KOTA BAMBU SELATAN,18287,12248,6037,2232,8269,2021-07-01
3173071003,JAKARTA BARAT,PALMERAH,KOTA BAMBU UTARA,21312,14710,6601,2769,9370,2021-07-01
3171041004,JAKARTA PUSAT,SENEN,KRAMAT,25258,17801,7455,2965,10420,2021-07-01
3175041001,JAKARTA TIMUR,KRAMAT JATI,KRAMAT JATI,29922,19776,10138,4983,15121,2021-07-01
3174071003,JAKARTA SELATAN,KEBAYORAN BARU,KRAMAT PELA,12737,7323,5411,2365,7776,2021-07-01
3173031002,JAKARTA BARAT,TAMAN SARI,KRUKUT,17023,10960,6056,2276,8332,2021-07-01
3174031005,JAKARTA SELATAN,MAMPANG PRAPATAN,KUNINGAN BARAT,11229,7025,4201,1541,5742,2021-07-01
3174021008,JAKARTA SELATAN,SETIA BUDI,KUNINGAN TIMUR,5331,3237,2092,1053,3145,2021-07-01
3171041005,JAKARTA PUSAT,SENEN,KWITANG,13487,8405,5080,2084,7164,2021-07-01
3172031003,JAKARTA UTARA,KOJA,LAGOA,51431,36652,14771,5637,20408,2021-07-01
3174061002,JAKARTA SELATAN,CILANDAK,LEBAK BULUS,32738,20929,11798,5826,17624,2021-07-01
3174091004,JAKARTA SELATAN,JAGAKARSA,LENTENG AGUNG,46600,33012,13585,6114,19699,2021-07-01
3175101007,JAKARTA TIMUR,CIPAYUNG,LUBANG BUAYA,55114,36244,18861,8379,27240,2021-07-01
3175081001,JAKARTA TIMUR,MAKASAR,MAKASAR,30013,18642,11363,4943,16306,2021-07-01
3175071006,JAKARTA TIMUR,DUREN SAWIT,MALAKA JAYA,26798,16551,10240,5462,15702,2021-07-01
3175071005,JAKARTA TIMUR,DUREN SAWIT,MALAKA SARI,23691,14066,9616,5394,15010,2021-07-01
3174031001,JAKARTA SELATAN,MAMPANG PRAPATAN,MAMPANG PRAPATAN,15885,10845,5035,2050,7085,2021-07-01
3173031005,JAKARTA BARAT,TAMAN SARI,MANGGA BESAR,6690,3646,3042,1443,4485,2021-07-01
3171021005,JAKARTA PUSAT,SAWAH BESAR,MANGGA DUA SELATAN,24940,16190,8745,3846,12591,2021-07-01
3174011007,JAKARTA SELATAN,TEBET,MANGGARAI,24972,16586,8380,3549,11929,2021-07-01
3174011006,JAKARTA SELATAN,TEBET,MANGGARAI SELATAN,20274,12176,8095,3196,11291,2021-07-01
3173031003,JAKARTA BARAT,TAMAN SARI,MAPHAR,14671,8957,5714,2556,8270,2021-07-01
3172041003,JAKARTA UTARA,CILINCING,MARUNDA,24385,14948,9434,2573,12007,2021-07-01
3174071001,JAKARTA SELATAN,KEBAYORAN BARU,MELAWAI,2386,1137,1247,823,2070,2021-07-01
3171061001,JAKARTA PUSAT,MENTENG,MENTENG,22450,15966,6479,3498,9977,2021-07-01
3174021005,JAKARTA SELATAN,SETIA BUDI,MENTENG ATAS,24369,14926,9438,4000,13438,2021-07-01
3174011003,JAKARTA SELATAN,TEBET,MENTENG DALAM,31623,20615,10997,5159,16156,2021-07-01
3173081003,JAKARTA BARAT,KEMBANGAN,MERUYA SELATAN,27261,17503,9745,4309,14054,2021-07-01
3173081002,JAKARTA BARAT,KEMBANGAN,MERUYA UTARA,38525,24938,13582,6909,20491,2021-07-01
3175101004,JAKARTA TIMUR,CIPAYUNG,MUNJUL,20582,13693,6886,3584,10470,2021-07-01
3172051002,JAKARTA UTARA,PADEMANGAN,PADEMANGAN BARAT,64756,44563,20186,7780,27966,2021-07-01
3172051001,JAKARTA UTARA,PADEMANGAN,PADEMANGAN TIMUR,32689,17617,15054,6878,21932,2021-07-01
3175011004,JAKARTA TIMUR,MATRAMAN,PAL MERIAM,17550,11392,6154,2711,8865,2021-07-01
3173071001,JAKARTA BARAT,PALMERAH,PALMERAH,54706,35781,18916,7977,26893,2021-07-01
3174081001,JAKARTA SELATAN,PANCORAN,PANCORAN,16983,11113,5869,2640,8509,2021-07-01
3172021003,JAKARTA UTARA,TANJUNG PRIOK,PAPANGGO,33902,21877,12008,4677,16685,2021-07-01
3171021001,JAKARTA PUSAT,SAWAH BESAR,PASAR BARU,11656,6067,5582,2904,8486,2021-07-01
3174021006,JAKARTA SELATAN,SETIA BUDI,PASAR MANGGIS,23415,14855,8554,3538,12092,2021-07-01
3174041001,JAKARTA SELATAN,PASAR MINGGU,PASAR MINGGU,21700,13616,8078,4542,12620,2021-07-01
3171041003,JAKARTA PUSAT,SENEN,PASEBAN,20652,13307,7339,3294,10633,2021-07-01
3173061005,JAKARTA BARAT,KALI DERES,PEGADUNGAN,65248,42078,23148,9071,32219,2021-07-01
3171061002,JAKARTA PUSAT,MENTENG,PEGANGSAAN,18427,12086,6339,2923,9262,2021-07-01
3172061002,JAKARTA UTARA,KELAPA GADING,PEGANGSAAN DUA,44451,22516,21914,10440,32354,2021-07-01
3172011004,JAKARTA UTARA,PENJARINGAN,PEJAGALAN,66008,41329,24658,10873,35531,2021-07-01
3174041006,JAKARTA SELATAN,PASAR MINGGU,PEJATEN BARAT,30591,18705,11875,5546,17421,2021-07-01
3174041005,JAKARTA SELATAN,PASAR MINGGU,PEJATEN TIMUR,50150,34075,16068,6005,22073,2021-07-01
3175051005,JAKARTA TIMUR,PASAR REBO,PEKAYON,37440,24027,13408,6024,19432,2021-07-01
3173041009,JAKARTA BARAT,TAMBORA,PEKOJAN,20921,13272,7642,3411,11053,2021-07-01
3174031003,JAKARTA SELATAN,MAMPANG PRAPATAN,PELA MAMPANG,37784,24862,12910,5596,18506,2021-07-01
3174081005,JAKARTA SELATAN,PANCORAN,PENGADEGAN,18685,10236,8444,3312,11756,2021-07-01
3175061003,JAKARTA TIMUR,CAKUNG,PENGGILINGAN,84511,62643,21866,9297,31163,2021-07-01
3172011001,JAKARTA UTARA,PENJARINGAN,PENJARINGAN,75505,52346,23148,7813,30961,2021-07-01
3174101001,JAKARTA SELATAN,PESANGGRAHAN,PESANGGRAHAN,23733,13520,10209,4864,15073,2021-07-01
3171071004,JAKARTA PUSAT,TANAH ABANG,PETAMBURAN,28974,22248,6722,2913,9635,2021-07-01
3174071008,JAKARTA SELATAN,KEBAYORAN BARU,PETOGOGAN,10203,6158,4044,1835,5879,2021-07-01
3171011004,JAKARTA PUSAT,GAMBIR,PETOJO SELATAN,13506,8254,5243,2993,8236,2021-07-01
3171011003,JAKARTA PUSAT,GAMBIR,PETOJO UTARA,16084,10498,5584,2687,8271,2021-07-01
3174101004,JAKARTA SELATAN,PESANGGRAHAN,PETUKANGAN SELATAN,32229,20431,11796,4895,16691,2021-07-01
3174101003,JAKARTA SELATAN,PESANGGRAHAN,PETUKANGAN UTARA,46427,30551,15873,6705,22578,2021-07-01
3175081002,JAKARTA TIMUR,MAKASAR,PINANG RANTI,23465,14732,8729,3433,12162,2021-07-01
3173031008,JAKARTA BARAT,TAMAN SARI,PINANGSIA,9405,5515,3889,1623,5512,2021-07-01
3175011001,JAKARTA TIMUR,MATRAMAN,PISANGAN BARU,27793,19721,8065,3799,11864,2021-07-01
3175021002,JAKARTA TIMUR,PULO GADUNG,PISANGAN TIMUR,35717,23066,12643,5578,18221,2021-07-01
3172011005,JAKARTA UTARA,PENJARINGAN,PLUIT,42979,22735,20213,12273,32486,2021-07-01
3175071002,JAKARTA TIMUR,DUREN SAWIT,PONDOK BAMBU,53658,34711,18932,8818,27750,2021-07-01
3175071004,JAKARTA TIMUR,DUREN SAWIT,PONDOK KELAPA,62704,40828,21860,10903,32763,2021-07-01
3175071007,JAKARTA TIMUR,DUREN SAWIT,PONDOK KOPI,30741,21467,9270,4321,13591,2021-07-01
3174061003,JAKARTA SELATAN,CILANDAK,PONDOK LABU,39778,24892,14873,6828,21701,2021-07-01
3174051002,JAKARTA SELATAN,KEBAYORAN LAMA,PONDOK PINANG,49276,31862,17392,9324,26716,2021-07-01
3175101003,JAKARTA TIMUR,CIPAYUNG,PONDOK RANGGON,21791,15007,6776,3772,10548,2021-07-01
3101011003,KAB.ADM.KEP.SERIBU,KEP. SERIBU UTARA,PULAU HARAPAN,1785,523,1262,667,1929,2021-07-01
3101011002,KAB.ADM.KEP.SERIBU,KEP. SERIBU UTARA,PULAU KELAPA,4729,1369,3360,1080,4440,2021-07-01
3101011001,KAB.ADM.KEP.SERIBU,KEP. SERIBU UTARA,PULAU PANGGANG,4667,1258,3409,1138,4547,2021-07-01
3101021003,KAB.ADM.KEP.SERIBU,KEP. SERIBU SELATAN,PULAU PARI,2370,452,1918,613,2531,2021-07-01
3101021002,KAB.ADM.KEP.SERIBU,KEP. SERIBU SELATAN,PULAU TIDUNG,3922,1202,2719,1133,3852,2021-07-01
3101021001,KAB.ADM.KEP.SERIBU,KEP. SERIBU SELATAN,PULAU UNTUNG JAWA,1665,443,1222,558,1780,2021-07-01
3174071007,JAKARTA SELATAN,KEBAYORAN BARU,PULO,5184,2841,2341,1339,3680,2021-07-01
3175021001,JAKARTA TIMUR,PULO GADUNG,PULO GADUNG,30292,20363,9918,4627,14545,2021-07-01
3175061005,JAKARTA TIMUR,CAKUNG,PULO GEBANG,83832,59361,24461,10562,35023,2021-07-01
3174041004,JAKARTA SELATAN,PASAR MINGGU,RAGUNAN,34536,20962,13561,5780,19341,2021-07-01
3175091005,JAKARTA TIMUR,CIRACAS,RAMBUTAN,31759,23251,8502,4265,12767,2021-07-01
3172031006,JAKARTA UTARA,KOJA,RAWA BADAK SELATAN,36403,26533,9867,3925,13792,2021-07-01
3172031004,JAKARTA UTARA,KOJA,RAWA BADAK UTARA,29198,18975,10218,3835,14053,2021-07-01
3174071005,JAKARTA SELATAN,KEBAYORAN BARU,RAWA BARAT,5029,2819,2209,1317,3526,2021-07-01
3173011003,JAKARTA BARAT,CENGKARENG,RAWA BUAYA,51752,33503,18240,5980,24220,2021-07-01
3175031004,JAKARTA TIMUR,JATINEGARA,RAWA BUNGA,18617,13352,5264,2459,7723,2021-07-01
3174081003,JAKARTA SELATAN,PANCORAN,RAWA JATI,18210,11134,7070,3402,10472,2021-07-01
3175061002,JAKARTA TIMUR,CAKUNG,RAWA TERATE,21332,13135,8195,2053,10248,2021-07-01
3175021005,JAKARTA TIMUR,PULO GADUNG,RAWAMANGUN,32470,20814,11649,5826,17475,2021-07-01
3171051003,JAKARTA PUSAT,CEMPAKA PUTIH,RAWASARI,19312,12274,7027,3468,10495,2021-07-01
3173041010,JAKARTA BARAT,TAMBORA,ROA MALAKA,3149,1605,1540,878,2418,2021-07-01
3172041006,JAKARTA UTARA,CILINCING,ROROTAN,35258,22318,12935,4581,17516,2021-07-01
3174071004,JAKARTA SELATAN,KEBAYORAN BARU,SELONG,2576,1277,1296,877,2173,2021-07-01
3173061002,JAKARTA BARAT,KALI DERES,SEMANAN,60715,44367,16343,4961,21304,2021-07-01
3172041007,JAKARTA UTARA,CILINCING,SEMPER BARAT,59323,37022,22286,9067,31353,2021-07-01
3172041005,JAKARTA UTARA,CILINCING,SEMPER TIMUR,31249,20144,11102,4284,15386,2021-07-01
3174071006,JAKARTA SELATAN,KEBAYORAN BARU,SENAYAN,2482,1558,921,568,1489,2021-07-01
3171041001,JAKARTA PUSAT,SENEN,SENEN,5951,3594,2356,1174,3530,2021-07-01
3171031004,JAKARTA PUSAT,KEMAYORAN,SERDANG,26045,16614,9428,3928,13356,2021-07-01
3174021001,JAKARTA SELATAN,SETIA BUDI,SETIA BUDI,2532,1449,1080,643,1723,2021-07-01
3175101005,JAKARTA TIMUR,CIPAYUNG,SETU,17609,12475,5132,2665,7797,2021-07-01
3173071002,JAKARTA BARAT,PALMERAH,SLIPI,14526,8882,5641,2715,8356,2021-07-01
3173081004,JAKARTA BARAT,KEMBANGAN,SRENGSENG,39370,27008,12347,6144,18491,2021-07-01
3174091002,JAKARTA SELATAN,JAGAKARSA,SRENGSENG SAWAH,50305,28889,21401,8870,30271,2021-07-01
3173051003,JAKARTA BARAT,KEBON JERUK,SUKABUMI SELATAN,30581,21333,9247,3460,12707,2021-07-01
3173051002,JAKARTA BARAT,KEBON JERUK,SUKABUMI UTARA,33050,23939,9108,3997,13105,2021-07-01
3172041002,JAKARTA UTARA,CILINCING,SUKAPURA,46955,32074,14874,5431,20305,2021-07-01
3171031007,JAKARTA PUSAT,KEMAYORAN,SUMUR BATU,19863,12353,7506,3388,10894,2021-07-01
3172021004,JAKARTA UTARA,TANJUNG PRIOK,SUNGAI BAMBU,25366,15910,9451,3519,12970,2021-07-01
3172021006,JAKARTA UTARA,TANJUNG PRIOK,SUNTER AGUNG,62904,35015,27860,13463,41323,2021-07-01
3172021002,JAKARTA UTARA,TANJUNG PRIOK,SUNTER JAYA,55168,33244,21901,10427,32328,2021-07-01
3175091004,JAKARTA TIMUR,CIRACAS,SUSUKAN,28884,18704,10178,4588,14766,2021-07-01
3173031001,JAKARTA BARAT,TAMAN SARI,TAMAN SARI,12915,8011,4902,2386,7288,2021-07-01
3173041001,JAKARTA BARAT,TAMBORA,TAMBORA,9087,5762,3325,1514,4839,2021-07-01
3173041004,JAKARTA BARAT,TAMBORA,TANAH SEREAL,23141,13787,9352,3869,13221,2021-07-01
3171081004,JAKARTA PUSAT,JOHAR BARU,TANAH TINGGI,32931,20433,12496,4242,16738,2021-07-01
3173031004,JAKARTA BARAT,TAMAN SARI,TANGKI,11593,7071,4518,1926,6444,2021-07-01
3174091005,JAKARTA SELATAN,JAGAKARSA,TANJUNG BARAT,34530,23317,11207,5646,16853,2021-07-01
3173021005,JAKARTA BARAT,GROGOL PETAMBURAN,TANJUNG DUREN SELATAN,22469,12299,10156,4445,14601,2021-07-01
3173021002,JAKARTA BARAT,GROGOL PETAMBURAN,TANJUNG DUREN UTARA,15224,7932,7286,3520,10806,2021-07-01
3172021001,JAKARTA UTARA,TANJUNG PRIOK,TANJUNG PRIOK,29913,17893,12011,3825,15836,2021-07-01
3174011002,JAKARTA SELATAN,TEBET,TEBET BARAT,18916,11019,7889,4171,12060,2021-07-01
3174011001,JAKARTA SELATAN,TEBET,TEBET TIMUR,16031,8718,7306,3716,11022,2021-07-01
3173061003,JAKARTA BARAT,KALI DERES,TEGAL ALUR,71923,50526,21388,6838,28226,2021-07-01
3174031004,JAKARTA SELATAN,MAMPANG PRAPATAN,TEGAL PARANG,28143,20661,7478,3296,10774,2021-07-01
3173021003,JAKARTA BARAT,GROGOL PETAMBURAN,TOMANG,25531,14971,10547,4968,15515,2021-07-01
3172031005,JAKARTA UTARA,KOJA,TUGU SELATAN,33663,23873,9785,3809,13594,2021-07-01
3172031002,JAKARTA UTARA,KOJA,TUGU UTARA,58638,42271,16362,6713,23075,2021-07-01
3175061006,JAKARTA TIMUR,CAKUNG,UJUNG MENTENG,25702,16520,9172,3953,13125,2021-07-01
3174101005,JAKARTA SELATAN,PESANGGRAHAN,ULUJAMI,35077,24138,10933,4917,15850,2021-07-01
3175011006,JAKARTA TIMUR,MATRAMAN,UTAN KAYU SELATAN,29303,18412,10880,5026,15906,2021-07-01
3175011002,JAKARTA TIMUR,MATRAMAN,UTAN KAYU UTARA,24728,15608,9119,3805,12924,2021-07-01
3171031008,JAKARTA PUSAT,KEMAYORAN,UTAN PANJANG,25622,18320,7301,2791,10092,2021-07-01
3172021007,JAKARTA UTARA,TANJUNG PRIOK,WARAKAS,38194,24610,13570,5196,18766,2021-07-01
3173021007,JAKARTA BARAT,GROGOL PETAMBURAN,WIJAYA KUSUMA,34170,22400,11757,4842,16599,2021-07-01
3172051003,JAKARTA UTARA,PADEMANGAN,ANCOL,20393,13163,7223,3290,10513,2021-07-02
3173041007,JAKARTA BARAT,TAMBORA,ANGKE,25785,16303,9473,3226,12699,2021-07-02
3175041005,JAKARTA TIMUR,KRAMAT JATI,BALE KAMBANG,25158,18716,6434,2650,9084,2021-07-02
3175031003,JAKARTA TIMUR,JATINEGARA,BALI MESTER,8683,5684,2996,1519,4515,2021-07-02
3175101006,JAKARTA TIMUR,CIPAYUNG,BAMBU APUS,22768,15219,7544,3994,11538,2021-07-02
3174031002,JAKARTA SELATAN,MAMPANG PRAPATAN,BANGKA,18930,12359,6565,2710,9275,2021-07-02
3175051002,JAKARTA TIMUR,PASAR REBO,BARU,20267,11196,9054,4682,13736,2021-07-02
3175041004,JAKARTA TIMUR,KRAMAT JATI,BATU AMPAR,41389,30138,11240,5269,16509,2021-07-02
3171071002,JAKARTA PUSAT,TANAH ABANG,BENDUNGAN HILIR,19008,11348,7653,3574,11227,2021-07-02
3175031002,JAKARTA TIMUR,JATINEGARA,BIDARA CINA,32331,23191,9136,4038,13174,2021-07-02
3174101002,JAKARTA SELATAN,PESANGGRAHAN,BINTARO,45843,30757,15075,7095,22170,2021-07-02
3174011005,JAKARTA SELATAN,TEBET,BUKIT DURI,29934,20068,9864,3966,13830,2021-07-02
3171041006,JAKARTA PUSAT,SENEN,BUNGUR,15932,9832,6084,2743,8827,2021-07-02
3175061007,JAKARTA TIMUR,CAKUNG,CAKUNG BARAT,49369,32640,16726,4019,20745,2021-07-02
3175061004,JAKARTA TIMUR,CAKUNG,CAKUNG TIMUR,50344,32905,17429,6396,23825,2021-07-02
3175041007,JAKARTA TIMUR,KRAMAT JATI,CAWANG,28708,19545,9157,4290,13447,2021-07-02
3175101008,JAKARTA TIMUR,CIPAYUNG,CEGER,16381,10631,5749,2574,8323,2021-07-02
3171031006,JAKARTA PUSAT,KEMAYORAN,CEMPAKA BARU,27330,18242,9077,4016,13093,2021-07-02
3171051002,JAKARTA PUSAT,CEMPAKA PUTIH,CEMPAKA PUTIH BARAT,30479,20636,9834,4974,14808,2021-07-02
3171051001,JAKARTA PUSAT,CEMPAKA PUTIH,CEMPAKA PUTIH TIMUR,21553,13162,8386,4451,12837,2021-07-02
3173011001,JAKARTA BARAT,CENGKARENG,CENGKARENG BARAT,57678,33992,23672,8246,31918,2021-07-02
3173011006,JAKARTA BARAT,CENGKARENG,CENGKARENG TIMUR,70122,45714,24394,8529,32923,2021-07-02
3175091002,JAKARTA TIMUR,CIRACAS,CIBUBUR,56927,36163,20750,9467,30217,2021-07-02
3171011002,JAKARTA PUSAT,GAMBIR,CIDENG,14203,8143,6052,3186,9238,2021-07-02
3174091003,JAKARTA SELATAN,JAGAKARSA,CIGANJUR,33127,21445,11668,5173,16841,2021-07-02
3175051003,JAKARTA TIMUR,PASAR REBO,CIJANTUNG,36027,22837,13180,6203,19383,2021-07-02
3171061003,JAKARTA PUSAT,MENTENG,CIKINI,7402,4733,2668,1371,4039,2021-07-02
3174081006,JAKARTA SELATAN,PANCORAN,CIKOKO,9280,5335,3945,1745,5690,2021-07-02
3174061001,JAKARTA SELATAN,CILANDAK,CILANDAK BARAT,45348,26475,18855,7886,26741,2021-07-02
3174041003,JAKARTA SELATAN,PASAR MINGGU,CILANDAK TIMUR,21207,12430,8766,4853,13619,2021-07-02
3175101002,JAKARTA TIMUR,CIPAYUNG,CILANGKAP,23675,15614,8054,3818,11872,2021-07-02
3175041006,JAKARTA TIMUR,KRAMAT JATI,CILILITAN,35164,24227,10928,5251,16179,2021-07-02
3172041001,JAKARTA UTARA,CILINCING,CILINCING,37003,26049,10947,3935,14882,2021-07-02
3175101001,JAKARTA TIMUR,CIPAYUNG,CIPAYUNG,22697,13919,8770,4236,13006,2021-07-02
3174091006,JAKARTA SELATAN,JAGAKARSA,CIPEDAK,32800,20771,12020,4805,16825,2021-07-02
3174061005,JAKARTA SELATAN,CILANDAK,CIPETE SELATAN,23463,14745,8715,3816,12531,2021-07-02
3174071010,JAKARTA SELATAN,KEBAYORAN BARU,CIPETE UTARA,29771,17895,11872,4102,15974,2021-07-02
3175021003,JAKARTA TIMUR,PULO GADUNG,CIPINANG,34608,22343,12254,6023,18277,2021-07-02
3175031007,JAKARTA TIMUR,JATINEGARA,CIPINANG BESAR SELATAN,30655,22174,8472,3907,12379,2021-07-02
3175031008,JAKARTA TIMUR,JATINEGARA,CIPINANG BESAR UTARA,38827,29627,9193,4200,13393,2021-07-02
3175031005,JAKARTA TIMUR,JATINEGARA,CIPINANG CEMPEDAK,29154,19770,9370,4700,14070,2021-07-02
3175081005,JAKARTA TIMUR,MAKASAR,CIPINANG MELAYU,37098,23477,13613,6412,20025,2021-07-02
3175031006,JAKARTA TIMUR,JATINEGARA,CIPINANG MUARA,46861,32906,13948,7298,21246,2021-07-02
3174051003,JAKARTA SELATAN,KEBAYORAN LAMA,CIPULIR,34708,23221,11482,4805,16287,2021-07-02
3175091001,JAKARTA TIMUR,CIRACAS,CIRACAS,55965,35646,20310,8403,28713,2021-07-02
3175041003,JAKARTA TIMUR,KRAMAT JATI,DUKUH,21239,14191,7043,3508,10551,2021-07-02
3175071001,JAKARTA TIMUR,DUREN SAWIT,DUREN SAWIT,53078,34685,18378,9233,27611,2021-07-02
3174081004,JAKARTA SELATAN,PANCORAN,DUREN TIGA,24673,15691,8975,3825,12800,2021-07-02
3173051005,JAKARTA BARAT,KEBON JERUK,DURI KEPA,52942,30870,22053,9962,32015,2021-07-02
3173011002,JAKARTA BARAT,CENGKARENG,DURI KOSAMBI,66093,42384,23698,8214,31912,2021-07-02
3171011006,JAKARTA PUSAT,GAMBIR,DURI PULO,17787,12124,5660,2379,8039,2021-07-02
3173041011,JAKARTA BARAT,TAMBORA,DURI SELATAN,12528,7686,4835,2363,7198,2021-07-02
3173041003,JAKARTA BARAT,TAMBORA,DURI UTARA,17380,11345,6032,2639,8671,2021-07-02
3171081003,JAKARTA PUSAT,JOHAR BARU,GALUR,15811,9173,6638,1970,8608,2021-07-02
3171011001,JAKARTA PUSAT,GAMBIR,GAMBIR,2232,1242,989,578,1567,2021-07-02
3174061004,JAKARTA SELATAN,CILANDAK,GANDARIA SELATAN,19394,11952,7434,2836,10270,2021-07-02
3174071009,JAKARTA SELATAN,KEBAYORAN BARU,GANDARIA UTARA,35026,22011,13010,5365,18375,2021-07-02
3175051001,JAKARTA TIMUR,PASAR REBO,GEDONG,31013,20332,10667,5290,15957,2021-07-02
3171071001,JAKARTA PUSAT,TANAH ABANG,GELORA,2753,1690,1056,567,1623,2021-07-02
3173031007,JAKARTA BARAT,TAMAN SARI,GLODOK,7192,3419,3771,1977,5748,2021-07-02
3171061004,JAKARTA PUSAT,MENTENG,GONDANGDIA,3760,1855,1900,1291,3191,2021-07-02
3173021001,JAKARTA BARAT,GROGOL PETAMBURAN,GROGOL,15067,9403,5658,2605,8263,2021-07-02
3174051005,JAKARTA SELATAN,KEBAYORAN LAMA,GROGOL SELATAN,38688,26249,12430,5464,17894,2021-07-02
3174051004,JAKARTA SELATAN,KEBAYORAN LAMA,GROGOL UTARA,37234,25248,11968,5840,17808,2021-07-02
3174021007,JAKARTA SELATAN,SETIA BUDI,GUNTUR,3590,1891,1696,987,2683,2021-07-02
3174071002,JAKARTA SELATAN,KEBAYORAN BARU,GUNUNG,8309,4750,3558,2033,5591,2021-07-02
3171031005,JAKARTA PUSAT,KEMAYORAN,GUNUNG SAHARI SELATAN,17256,10815,6434,2817,9251,2021-07-02
3171021004,JAKARTA PUSAT,SAWAH BESAR,GUNUNG SAHARI UTARA,13937,7041,6889,3370,10259,2021-07-02
3175081004,JAKARTA TIMUR,MAKASAR,HALIM PERDANA KUSUMAH,24426,10810,13595,9302,22897,2021-07-02
3171031003,JAKARTA PUSAT,KEMAYORAN,HARAPAN MULIA,19987,13509,6472,2695,9167,2021-07-02
3174091001,JAKARTA SELATAN,JAGAKARSA,JAGAKARSA,53714,32819,20879,8509,29388,2021-07-02
3175021007,JAKARTA TIMUR,PULO GADUNG,JATI,28870,18283,10568,5582,16150,2021-07-02
3174041002,JAKARTA SELATAN,PASAR MINGGU,JATI PADANG,32857,20642,12206,5853,18059,2021-07-02
3173071004,JAKARTA BARAT,PALMERAH,JATI PULO,24508,14000,10505,3644,14149,2021-07-02
3175061001,JAKARTA TIMUR,CAKUNG,JATINEGARA,72652,54128,18524,6681,25205,2021-07-02
3175021004,JAKARTA TIMUR,PULO GADUNG,JATINEGARA KAUM,21313,14378,6932,2925,9857,2021-07-02
3173021004,JAKARTA BARAT,GROGOL PETAMBURAN,JELAMBAR,26984,15820,11153,5465,16618,2021-07-02
3173021006,JAKARTA BARAT,GROGOL PETAMBURAN,JELAMBAR BARU,33734,20614,13108,6067,19175,2021-07-02
3173041006,JAKARTA BARAT,TAMBORA,JEMBATAN BESI,25735,19417,6317,2426,8743,2021-07-02
3173041008,JAKARTA BARAT,TAMBORA,JEMBATAN LIMA,18241,12860,5374,2261,7635,2021-07-02
3173081005,JAKARTA BARAT,KEMBANGAN,JOGLO,35285,22605,12675,5944,18619,2021-07-02
3171081001,JAKARTA PUSAT,JOHAR BARU,JOHAR BARU,28311,15171,13134,5329,18463,2021-07-02
3173041002,JAKARTA BARAT,TAMBORA,KALI ANYAR,20624,15062,5560,2233,7793,2021-07-02
3172041004,JAKARTA UTARA,CILINCING,KALIBARU,57771,43538,14230,4332,18562,2021-07-02
3174081002,JAKARTA SELATAN,PANCORAN,KALIBATA,36451,24918,11532,4920,16452,2021-07-02
3173061001,JAKARTA BARAT,KALI DERES,KALIDERES,60209,39789,20401,7577,27978,2021-07-02
3175051004,JAKARTA TIMUR,PASAR REBO,KALISARI,37255,23536,13705,6751,20456,2021-07-02
3173061004,JAKARTA BARAT,KALI DERES,KAMAL,46035,34376,11655,3655,15310,2021-07-02
3172011002,JAKARTA UTARA,PENJARINGAN,KAMAL MUARA,11039,5486,5543,2500,8043,2021-07-02
3171071007,JAKARTA PUSAT,TANAH ABANG,KAMPUNG BALI,10113,7044,3067,1509,4576,2021-07-02
3175031001,JAKARTA TIMUR,JATINEGARA,KAMPUNG MELAYU,22293,16705,5585,2236,7821,2021-07-02
3171081002,JAKARTA PUSAT,JOHAR BARU,KAMPUNG RAWA,15550,7245,8302,2543,10845,2021-07-02
3175041002,JAKARTA TIMUR,KRAMAT JATI,KAMPUNG TENGAH,38048,27012,11026,5249,16275,2021-07-02
3173011005,JAKARTA BARAT,CENGKARENG,KAPUK,104630,72258,32362,9479,41841,2021-07-02
3172011003,JAKARTA UTARA,PENJARINGAN,KAPUK MUARA,31275,18179,13077,6638,19715,2021-07-02
3171021002,JAKARTA PUSAT,SAWAH BESAR,KARANG ANYAR,23056,14851,8194,3402,11596,2021-07-02
3174021004,JAKARTA SELATAN,SETIA BUDI,KARET,8542,5029,3511,1434,4945,2021-07-02
3174021003,JAKARTA SELATAN,SETIA BUDI,KARET KUNINGAN,14166,8289,5873,2325,8198,2021-07-02
3174021002,JAKARTA SELATAN,SETIA BUDI,KARET SEMANGGI,2469,1227,1239,599,1838,2021-07-02
3171071003,JAKARTA PUSAT,TANAH ABANG,KARET TENGSIN,16695,11031,5661,2204,7865,2021-07-02
3171021003,JAKARTA PUSAT,SAWAH BESAR,KARTINI,19916,12122,7790,3452,11242,2021-07-02
3175011003,JAKARTA TIMUR,MATRAMAN,KAYU MANIS,22174,15058,7114,3005,10119,2021-07-02
3175021006,JAKARTA TIMUR,PULO GADUNG,KAYU PUTIH,35916,21433,14465,7022,21487,2021-07-02
3173031006,JAKARTA BARAT,TAMAN SARI,KEAGUNGAN,15262,9818,5441,1995,7436,2021-07-02
3174041007,JAKARTA SELATAN,PASAR MINGGU,KEBAGUSAN,38396,25570,12817,5177,17994,2021-07-02
3174051006,JAKARTA SELATAN,KEBAYORAN LAMA,KEBAYORAN LAMA SELATAN,35920,21592,14319,5788,20107,2021-07-02
3174051001,JAKARTA SELATAN,KEBAYORAN LAMA,KEBAYORAN LAMA UTARA,37004,24789,12205,5241,17446,2021-07-02
3174011004,JAKARTA SELATAN,TEBET,KEBON BARU,30533,19227,11300,5123,16423,2021-07-02
3172021005,JAKARTA UTARA,TANJUNG PRIOK,KEBON BAWANG,44427,28113,16296,6914,23210,2021-07-02
3173051001,JAKARTA BARAT,KEBON JERUK,KEBON JERUK,46870,32075,14781,6777,21558,2021-07-02
3171071006,JAKARTA PUSAT,TANAH ABANG,KEBON KACANG,19075,13930,5142,2621,7763,2021-07-02
3171011005,JAKARTA PUSAT,GAMBIR,KEBON KELAPA,9383,6086,3296,1656,4952,2021-07-02
3171031002,JAKARTA PUSAT,KEMAYORAN,KEBON KOSONG,26178,17216,8958,3459,12417,2021-07-02
3175011005,JAKARTA TIMUR,MATRAMAN,KEBON MANGGIS,14644,9004,5634,2759,8393,2021-07-02
3171071005,JAKARTA PUSAT,TANAH ABANG,KEBON MELATI,27297,20993,6303,2856,9159,2021-07-02
3175081003,JAKARTA TIMUR,MAKASAR,KEBON PALA,40723,27275,13442,6175,19617,2021-07-02
3171061005,JAKARTA PUSAT,MENTENG,KEBON SIRIH,10880,7750,3130,1540,4670,2021-07-02
3173011004,JAKARTA BARAT,CENGKARENG,KEDAUNG KALI ANGKE,28123,16193,11925,3212,15137,2021-07-02
3173051007,JAKARTA BARAT,KEBON JERUK,KEDOYA SELATAN,28300,17455,10825,4597,15422,2021-07-02
3173051006,JAKARTA BARAT,KEBON JERUK,KEDOYA UTARA,38771,22319,16440,6950,23390,2021-07-02
3173051004,JAKARTA BARAT,KEBON JERUK,KELAPA DUA,20509,13011,7493,3124,10617,2021-07-02
3175091003,JAKARTA TIMUR,CIRACAS,KELAPA DUA WETAN,40776,25695,15068,7197,22265,2021-07-02
3172061003,JAKARTA UTARA,KELAPA GADING,KELAPA GADING BARAT,31544,16065,15451,8790,24241,2021-07-02
3172061001,JAKARTA UTARA,KELAPA GADING,KELAPA GADING TIMUR,30470,13947,16509,9109,25618,2021-07-02
3173071005,JAKARTA BARAT,PALMERAH,KEMANGGISAN,28159,17468,10681,5183,15864,2021-07-02
3171031001,JAKARTA PUSAT,KEMAYORAN,KEMAYORAN,18556,11330,7223,2811,10034,2021-07-02
3173081006,JAKARTA BARAT,KEMBANGAN,KEMBANGAN SELATAN,24028,14762,9247,4991,14238,2021-07-02
3173081001,JAKARTA BARAT,KEMBANGAN,KEMBANGAN UTARA,45663,28860,16791,6568,23359,2021-07-02
3171041002,JAKARTA PUSAT,SENEN,KENARI,8328,4711,3616,1729,5345,2021-07-02
3173041005,JAKARTA BARAT,TAMBORA,KERENDANG,17494,12127,5364,2216,7580,2021-07-02
3175071003,JAKARTA TIMUR,DUREN SAWIT,KLENDER,60420,43054,17360,7406,24766,2021-07-02
3172031001,JAKARTA UTARA,KOJA,KOJA,24600,16898,7701,2737,10438,2021-07-02
3173071006,JAKARTA BARAT,PALMERAH,KOTA BAMBU SELATAN,18287,12084,6201,2234,8435,2021-07-02
3173071003,JAKARTA BARAT,PALMERAH,KOTA BAMBU UTARA,21312,14578,6733,2770,9503,2021-07-02
3171041004,JAKARTA PUSAT,SENEN,KRAMAT,25258,17572,7683,2972,10655,2021-07-02
3175041001,JAKARTA TIMUR,KRAMAT JATI,KRAMAT JATI,29922,19598,10316,4995,15311,2021-07-02
3174071003,JAKARTA SELATAN,KEBAYORAN BARU,KRAMAT PELA,12737,7236,5498,2368,7866,2021-07-02
3173031002,JAKARTA BARAT,TAMAN SARI,KRUKUT,17023,10824,6192,2280,8472,2021-07-02
3174031005,JAKARTA SELATAN,MAMPANG PRAPATAN,KUNINGAN BARAT,11229,6934,4292,1542,5834,2021-07-02
3174021008,JAKARTA SELATAN,SETIA BUDI,KUNINGAN TIMUR,5331,3221,2108,1054,3162,2021-07-02
3171041005,JAKARTA PUSAT,SENEN,KWITANG,13487,8335,5150,2089,7239,2021-07-02
3172031003,JAKARTA UTARA,KOJA,LAGOA,51431,36373,15050,5641,20691,2021-07-02
3174061002,JAKARTA SELATAN,CILANDAK,LEBAK BULUS,32738,20598,12129,5849,17978,2021-07-02
3174091004,JAKARTA SELATAN,JAGAKARSA,LENTENG AGUNG,46600,32629,13965,6127,20092,2021-07-02
3175101007,JAKARTA TIMUR,CIPAYUNG,LUBANG BUAYA,55114,35559,19545,8389,27934,2021-07-02
3175081001,JAKARTA TIMUR,MAKASAR,MAKASAR,30013,18425,11580,4953,16533,2021-07-02
3175071006,JAKARTA TIMUR,DUREN SAWIT,MALAKA JAYA,26798,16312,10479,5468,15947,2021-07-02
3175071005,JAKARTA TIMUR,DUREN SAWIT,MALAKA SARI,23691,13876,9806,5407,15213,2021-07-02
3174031001,JAKARTA SELATAN,MAMPANG PRAPATAN,MAMPANG PRAPATAN,15885,10707,5173,2052,7225,2021-07-02
3173031005,JAKARTA BARAT,TAMAN SARI,MANGGA BESAR,6690,3506,3182,1444,4626,2021-07-02
3171021005,JAKARTA PUSAT,SAWAH BESAR,MANGGA DUA SELATAN,24940,16032,8903,3848,12751,2021-07-02
3174011007,JAKARTA SELATAN,TEBET,MANGGARAI,24972,16441,8525,3552,12077,2021-07-02
3174011006,JAKARTA SELATAN,TEBET,MANGGARAI SELATAN,20274,11970,8301,3197,11498,2021-07-02
3173031003,JAKARTA BARAT,TAMAN SARI,MAPHAR,14671,8761,5910,2559,8469,2021-07-02
3172041003,JAKARTA UTARA,CILINCING,MARUNDA,24385,14909,9473,2574,12047,2021-07-02
3174071001,JAKARTA SELATAN,KEBAYORAN BARU,MELAWAI,2386,1126,1258,826,2084,2021-07-02
3171061001,JAKARTA PUSAT,MENTENG,MENTENG,22450,15829,6616,3503,10119,2021-07-02
3174021005,JAKARTA SELATAN,SETIA BUDI,MENTENG ATAS,24369,14787,9577,4010,13587,2021-07-02
3174011003,JAKARTA SELATAN,TEBET,MENTENG DALAM,31623,20398,11214,5171,16385,2021-07-02
3173081003,JAKARTA BARAT,KEMBANGAN,MERUYA SELATAN,27261,17293,9955,4320,14275,2021-07-02
3173081002,JAKARTA BARAT,KEMBANGAN,MERUYA UTARA,38525,24670,13850,6918,20768,2021-07-02
3175101004,JAKARTA TIMUR,CIPAYUNG,MUNJUL,20582,13570,7009,3588,10597,2021-07-02
3172051002,JAKARTA UTARA,PADEMANGAN,PADEMANGAN BARAT,64756,44189,20560,7785,28345,2021-07-02
3172051001,JAKARTA UTARA,PADEMANGAN,PADEMANGAN TIMUR,32689,17451,15220,6879,22099,2021-07-02
3175011004,JAKARTA TIMUR,MATRAMAN,PAL MERIAM,17550,11246,6300,2713,9013,2021-07-02
3173071001,JAKARTA BARAT,PALMERAH,PALMERAH,54706,35348,19348,7982,27330,2021-07-02
3174081001,JAKARTA SELATAN,PANCORAN,PANCORAN,16983,11008,5974,2645,8619,2021-07-02
3172021003,JAKARTA UTARA,TANJUNG PRIOK,PAPANGGO,33902,21456,12429,4683,17112,2021-07-02
3171021001,JAKARTA PUSAT,SAWAH BESAR,PASAR BARU,11656,5970,5679,2908,8587,2021-07-02
3174021006,JAKARTA SELATAN,SETIA BUDI,PASAR MANGGIS,23415,14631,8778,3541,12319,2021-07-02
3174041001,JAKARTA SELATAN,PASAR MINGGU,PASAR MINGGU,21700,13531,8163,4549,12712,2021-07-02
3171041003,JAKARTA PUSAT,SENEN,PASEBAN,20652,13180,7466,3300,10766,2021-07-02
3173061005,JAKARTA BARAT,KALI DERES,PEGADUNGAN,65248,41697,23529,9082,32611,2021-07-02
3171061002,JAKARTA PUSAT,MENTENG,PEGANGSAAN,18427,12003,6422,2929,9351,2021-07-02
3172061002,JAKARTA UTARA,KELAPA GADING,PEGANGSAAN DUA,44451,22156,22270,10461,32731,2021-07-02
3172011004,JAKARTA UTARA,PENJARINGAN,PEJAGALAN,66008,40771,25216,10883,36099,2021-07-02
3174041006,JAKARTA SELATAN,PASAR MINGGU,PEJATEN BARAT,30591,18436,12144,5563,17707,2021-07-02
3174041005,JAKARTA SELATAN,PASAR MINGGU,PEJATEN TIMUR,50150,33801,16342,6015,22357,2021-07-02
3175051005,JAKARTA TIMUR,PASAR REBO,PEKAYON,37440,23692,13743,6031,19774,2021-07-02
3173041009,JAKARTA BARAT,TAMBORA,PEKOJAN,20921,13073,7841,3413,11254,2021-07-02
3174031003,JAKARTA SELATAN,MAMPANG PRAPATAN,PELA MAMPANG,37784,24558,13214,5615,18829,2021-07-02
3174081005,JAKARTA SELATAN,PANCORAN,PENGADEGAN,18685,10102,8578,3316,11894,2021-07-02
3175061003,JAKARTA TIMUR,CAKUNG,PENGGILINGAN,84511,62361,22148,9324,31472,2021-07-02
3172011001,JAKARTA UTARA,PENJARINGAN,PENJARINGAN,75505,51687,23807,7818,31625,2021-07-02
3174101001,JAKARTA SELATAN,PESANGGRAHAN,PESANGGRAHAN,23733,13430,10299,4869,15168,2021-07-02
3171071004,JAKARTA PUSAT,TANAH ABANG,PETAMBURAN,28974,22109,6861,2920,9781,2021-07-02
3174071008,JAKARTA SELATAN,KEBAYORAN BARU,PETOGOGAN,10203,6094,4108,1841,5949,2021-07-02
3171011004,JAKARTA PUSAT,GAMBIR,PETOJO SELATAN,13506,8201,5296,2994,8290,2021-07-02
3171011003,JAKARTA PUSAT,GAMBIR,PETOJO UTARA,16084,10438,5644,2691,8335,2021-07-02
3174101004,JAKARTA SELATAN,PESANGGRAHAN,PETUKANGAN SELATAN,32229,20269,11958,4904,16862,2021-07-02
3174101003,JAKARTA SELATAN,PESANGGRAHAN,PETUKANGAN UTARA,46427,30094,16330,6714,23044,2021-07-02
3175081002,JAKARTA TIMUR,MAKASAR,PINANG RANTI,23465,14586,8875,3444,12319,2021-07-02
3173031008,JAKARTA BARAT,TAMAN SARI,PINANGSIA,9405,5457,3947,1625,5572,2021-07-02
3175011001,JAKARTA TIMUR,MATRAMAN,PISANGAN BARU,27793,19599,8187,3809,11996,2021-07-02
3175021002,JAKARTA TIMUR,PULO GADUNG,PISANGAN TIMUR,35717,22756,12953,5602,18555,2021-07-02
3172011005,JAKARTA UTARA,PENJARINGAN,PLUIT,42979,22445,20501,12291,32792,2021-07-02
3175071002,JAKARTA TIMUR,DUREN SAWIT,PONDOK BAMBU,53658,34287,19355,8842,28197,2021-07-02
3175071004,JAKARTA TIMUR,DUREN SAWIT,PONDOK KELAPA,62704,40184,22504,10930,33434,2021-07-02
3175071007,JAKARTA TIMUR,DUREN SAWIT,PONDOK KOPI,30741,21333,9404,4332,13736,2021-07-02
3174061003,JAKARTA SELATAN,CILANDAK,PONDOK LABU,39778,24496,15269,6839,22108,2021-07-02
3174051002,JAKARTA SELATAN,KEBAYORAN LAMA,PONDOK PINANG,49276,31667,17586,9387,26973,2021-07-02
3175101003,JAKARTA TIMUR,CIPAYUNG,PONDOK RANGGON,21791,14893,6890,3774,10664,2021-07-02
3101011003,KAB.ADM.KEP.SERIBU,KEP. SERIBU UTARA,PULAU HARAPAN,1785,511,1274,667,1941,2021-07-02
3101011002,KAB.ADM.KEP.SERIBU,KEP. SERIBU UTARA,PULAU KELAPA,4729,1348,3381,1080,4461,2021-07-02
3101011001,KAB.ADM.KEP.SERIBU,KEP. SERIBU UTARA,PULAU PANGGANG,4667,1238,3429,1140,4569,2021-07-02
3101021003,KAB.ADM.KEP.SERIBU,KEP. SERIBU SELATAN,PULAU PARI,2370,451,1919,613,2532,2021-07-02
3101021002,KAB.ADM.KEP.SERIBU,KEP. SERIBU SELATAN,PULAU TIDUNG,3922,1191,2730,1133,3863,2021-07-02
3101021001,KAB.ADM.KEP.SERIBU,KEP. SERIBU SELATAN,PULAU UNTUNG JAWA,1665,439,1226,558,1784,2021-07-02
3174071007,JAKARTA SELATAN,KEBAYORAN BARU,PULO,5184,2783,2399,1342,3741,2021-07-02
3175021001,JAKARTA TIMUR,PULO GADUNG,PULO GADUNG,30292,20197,10084,4640,14724,2021-07-02
3175061005,JAKARTA TIMUR,CAKUNG,PULO GEBANG,83832,58836,24986,10591,35577,2021-07-02
3174041004,JAKARTA SELATAN,PASAR MINGGU,RAGUNAN,34536,20666,13857,5797,19654,2021-07-02
3175091005,JAKARTA TIMUR,CIRACAS,RAMBUTAN,31759,23030,8723,4276,12999,2021-07-02
3172031006,JAKARTA UTARA,KOJA,RAWA BADAK SELATAN,36403,26171,10229,3929,14158,2021-07-02
3172031004,JAKARTA UTARA,KOJA,RAWA BADAK UTARA,29198,18843,10350,3846,14196,2021-07-02
3174071005,JAKARTA SELATAN,KEBAYORAN BARU,RAWA BARAT,5029,2789,2239,1319,3558,2021-07-02
3173011003,JAKARTA BARAT,CENGKARENG,RAWA BUAYA,51752,33260,18483,5985,24468,2021-07-02
3175031004,JAKARTA TIMUR,JATINEGARA,RAWA BUNGA,18617,13268,5348,2460,7808,2021-07-02
3174081003,JAKARTA SELATAN,PANCORAN,RAWA JATI,18210,11026,7178,3413,10591,2021-07-02
3175061002,JAKARTA TIMUR,CAKUNG,RAWA TERATE,21332,13087,8243,2068,10311,2021-07-02
3175021005,JAKARTA TIMUR,PULO GADUNG,RAWAMANGUN,32470,20606,11857,5831,17688,2021-07-02
3171051003,JAKARTA PUSAT,CEMPAKA PUTIH,RAWASARI,19312,12126,7175,3472,10647,2021-07-02
3173041010,JAKARTA BARAT,TAMBORA,ROA MALAKA,3149,1573,1572,878,2450,2021-07-02
3172041006,JAKARTA UTARA,CILINCING,ROROTAN,35258,22174,13079,4587,17666,2021-07-02
3174071004,JAKARTA SELATAN,KEBAYORAN BARU,SELONG,2576,1256,1317,878,2195,2021-07-02
3173061002,JAKARTA BARAT,KALI DERES,SEMANAN,60715,44035,16675,4973,21648,2021-07-02
3172041007,JAKARTA UTARA,CILINCING,SEMPER BARAT,59323,36818,22490,9072,31562,2021-07-02
3172041005,JAKARTA UTARA,CILINCING,SEMPER TIMUR,31249,20046,11200,4295,15495,2021-07-02
3174071006,JAKARTA SELATAN,KEBAYORAN BARU,SENAYAN,2482,1542,937,568,1505,2021-07-02
3171041001,JAKARTA PUSAT,SENEN,SENEN,5951,3577,2373,1176,3549,2021-07-02
3171031004,JAKARTA PUSAT,KEMAYORAN,SERDANG,26045,16433,9609,3935,13544,2021-07-02
3174021001,JAKARTA SELATAN,SETIA BUDI,SETIA BUDI,2532,1435,1094,643,1737,2021-07-02
3175101005,JAKARTA TIMUR,CIPAYUNG,SETU,17609,12336,5271,2667,7938,2021-07-02
3173071002,JAKARTA BARAT,PALMERAH,SLIPI,14526,8771,5752,2719,8471,2021-07-02
3173081004,JAKARTA BARAT,KEMBANGAN,SRENGSENG,39370,26794,12560,6155,18715,2021-07-02
3174091002,JAKARTA SELATAN,JAGAKARSA,SRENGSENG SAWAH,50305,28449,21841,8880,30721,2021-07-02
3173051003,JAKARTA BARAT,KEBON JERUK,SUKABUMI SELATAN,30581,21091,9489,3470,12959,2021-07-02
3173051002,JAKARTA BARAT,KEBON JERUK,SUKABUMI UTARA,33050,23669,9378,4004,13382,2021-07-02
3172041002,JAKARTA UTARA,CILINCING,SUKAPURA,46955,31850,15098,5433,20531,2021-07-02
3171031007,JAKARTA PUSAT,KEMAYORAN,SUMUR BATU,19863,12175,7684,3396,11080,2021-07-02
3172021004,JAKARTA UTARA,TANJUNG PRIOK,SUNGAI BAMBU,25366,15710,9651,3526,13177,2021-07-02
3172021006,JAKARTA UTARA,TANJUNG PRIOK,SUNTER AGUNG,62904,34503,28372,13466,41838,2021-07-02
3172021002,JAKARTA UTARA,TANJUNG PRIOK,SUNTER JAYA,55168,32795,22349,10443,32792,2021-07-02
3175091004,JAKARTA TIMUR,CIRACAS,SUSUKAN,28884,18437,10445,4593,15038,2021-07-02
3173031001,JAKARTA BARAT,TAMAN SARI,TAMAN SARI,12915,7861,5052,2387,7439,2021-07-02
3173041001,JAKARTA BARAT,TAMBORA,TAMBORA,9087,5721,3366,1515,4881,2021-07-02
3173041004,JAKARTA BARAT,TAMBORA,TANAH SEREAL,23141,13595,9544,3871,13415,2021-07-02
3171081004,JAKARTA PUSAT,JOHAR BARU,TANAH TINGGI,32931,20158,12771,4245,17016,2021-07-02
3173031004,JAKARTA BARAT,TAMAN SARI,TANGKI,11593,6981,4608,1926,6534,2021-07-02
3174091005,JAKARTA SELATAN,JAGAKARSA,TANJUNG BARAT,34530,23108,11416,5660,17076,2021-07-02
3173021005,JAKARTA BARAT,GROGOL PETAMBURAN,TANJUNG DUREN SELATAN,22469,12165,10290,4450,14740,2021-07-02
3173021002,JAKARTA BARAT,GROGOL PETAMBURAN,TANJUNG DUREN UTARA,15224,7852,7366,3524,10890,2021-07-02
3172021001,JAKARTA UTARA,TANJUNG PRIOK,TANJUNG PRIOK,29913,17718,12186,3828,16014,2021-07-02
3174011002,JAKARTA SELATAN,TEBET,TEBET BARAT,18916,10930,7978,4179,12157,2021-07-02
3174011001,JAKARTA SELATAN,TEBET,TEBET TIMUR,16031,8576,7448,3729,11177,2021-07-02
3173061003,JAKARTA BARAT,KALI DERES,TEGAL ALUR,71923,49869,22045,6844,28889,2021-07-02
3174031004,JAKARTA SELATAN,MAMPANG PRAPATAN,TEGAL PARANG,28143,20443,7696,3300,10996,2021-07-02
3173021003,JAKARTA BARAT,GROGOL PETAMBURAN,TOMANG,25531,14809,10708,4973,15681,2021-07-02
3172031005,JAKARTA UTARA,KOJA,TUGU SELATAN,33663,23674,9984,3816,13800,2021-07-02
3172031002,JAKARTA UTARA,KOJA,TUGU UTARA,58638,41813,16820,6725,23545,2021-07-02
3175061006,JAKARTA TIMUR,CAKUNG,UJUNG MENTENG,25702,16366,9326,3961,13287,2021-07-02
3174101005,JAKARTA SELATAN,PESANGGRAHAN,ULUJAMI,35077,23984,11086,4930,16016,2021-07-02
3175011006,JAKARTA TIMUR,MATRAMAN,UTAN KAYU SELATAN,29303,18181,11111,5038,16149,2021-07-02
3175011002,JAKARTA TIMUR,MATRAMAN,UTAN KAYU UTARA,24728,15444,9283,3812,13095,2021-07-02
3171031008,JAKARTA PUSAT,KEMAYORAN,UTAN PANJANG,25622,18202,7419,2794,10213,2021-07-02
3172021007,JAKARTA UTARA,TANJUNG PRIOK,WARAKAS,38194,24291,13889,5204,19093,2021-07-02
3173021007,JAKARTA BARAT,GROGOL PETAMBURAN,WIJAYA KUSUMA,34170,22217,11940,4845,16785,2021-07-02
3172051003,JAKARTA UTARA,PADEMANGAN,ANCOL,20393,13065,7321,3297,10618,2021-07-03
3173041007,JAKARTA BARAT,TAMBORA,ANGKE,25785,16090,9686,3231,12917,2021-07-03
3175041005,JAKARTA TIMUR,KRAMAT JATI,BALE KAMBANG,25158,18622,6528,2660,9188,2021-07-03
3175031003,JAKARTA TIMUR,JATINEGARA,BALI MESTER,8683,5653,3027,1519,4546,2021-07-03
3175101006,JAKARTA TIMUR,CIPAYUNG,BAMBU APUS,22768,15099,7663,4001,11664,2021-07-03
3174031002,JAKARTA SELATAN,MAMPANG PRAPATAN,BANGKA,18930,12267,6657,2716,9373,2021-07-03
3175051002,JAKARTA TIMUR,PASAR REBO,BARU,20267,11093,9157,4688,13845,2021-07-03
3175041004,JAKARTA TIMUR,KRAMAT JATI,BATU AMPAR,41389,29961,11417,5276,16693,2021-07-03
3171071002,JAKARTA PUSAT,TANAH ABANG,BENDUNGAN HILIR,19008,11274,7727,3581,11308,2021-07-03
3175031002,JAKARTA TIMUR,JATINEGARA,BIDARA CINA,32331,23043,9283,4042,13325,2021-07-03
3174101002,JAKARTA SELATAN,PESANGGRAHAN,BINTARO,45843,30533,15299,7101,22400,2021-07-03
3174011005,JAKARTA SELATAN,TEBET,BUKIT DURI,29934,19938,9994,3973,13967,2021-07-03
3171041006,JAKARTA PUSAT,SENEN,BUNGUR,15932,9747,6169,2746,8915,2021-07-03
3175061007,JAKARTA TIMUR,CAKUNG,CAKUNG BARAT,49369,32456,16910,4025,20935,2021-07-03
3175061004,JAKARTA TIMUR,CAKUNG,CAKUNG TIMUR,50344,32705,17629,6415,24044,2021-07-03
3175041007,JAKARTA TIMUR,KRAMAT JATI,CAWANG,28708,19371,9330,4292,13622,2021-07-03
3175101008,JAKARTA TIMUR,CIPAYUNG,CEGER,16381,10548,5832,2576,8408,2021-07-03
3171031006,JAKARTA PUSAT,KEMAYORAN,CEMPAKA BARU,27330,18090,9229,4020,13249,2021-07-03
3171051002,JAKARTA PUSAT,CEMPAKA PUTIH,CEMPAKA PUTIH BARAT,30479,20456,10014,4980,14994,2021-07-03
3171051001,JAKARTA PUSAT,CEMPAKA PUTIH,CEMPAKA PUTIH TIMUR,21553,13029,8519,4456,12975,2021-07-03
3173011001,JAKARTA BARAT,CENGKARENG,CENGKARENG BARAT,57678,33773,23890,8248,32138,2021-07-03
3173011006,JAKARTA BARAT,CENGKARENG,CENGKARENG TIMUR,70122,45064,25042,8535,33577,2021-07-03
3175091002,JAKARTA TIMUR,CIRACAS,CIBUBUR,56927,35696,21217,9470,30687,2021-07-03
3171011002,JAKARTA PUSAT,GAMBIR,CIDENG,14203,8039,6156,3186,9342,2021-07-03
3174091003,JAKARTA SELATAN,JAGAKARSA,CIGANJUR,33127,21274,11839,5177,17016,2021-07-03
3175051003,JAKARTA TIMUR,PASAR REBO,CIJANTUNG,36027,22643,13374,6206,19580,2021-07-03
3171061003,JAKARTA PUSAT,MENTENG,CIKINI,7402,4710,2691,1371,4062,2021-07-03
3174081006,JAKARTA SELATAN,PANCORAN,CIKOKO,9280,5297,3983,1749,5732,2021-07-03
3174061001,JAKARTA SELATAN,CILANDAK,CILANDAK BARAT,45348,26220,19108,7902,27010,2021-07-03
3174041003,JAKARTA SELATAN,PASAR MINGGU,CILANDAK TIMUR,21207,12339,8857,4858,13715,2021-07-03
3175101002,JAKARTA TIMUR,CIPAYUNG,CILANGKAP,23675,15484,8184,3822,12006,2021-07-03
3175041006,JAKARTA TIMUR,KRAMAT JATI,CILILITAN,35164,24121,11034,5252,16286,2021-07-03
3172041001,JAKARTA UTARA,CILINCING,CILINCING,37003,25913,11083,3936,15019,2021-07-03
3175101001,JAKARTA TIMUR,CIPAYUNG,CIPAYUNG,22697,13760,8927,4243,13170,2021-07-03
3174091006,JAKARTA SELATAN,JAGAKARSA,CIPEDAK,32800,20531,12260,4816,17076,2021-07-03
3174061005,JAKARTA SELATAN,CILANDAK,CIPETE SELATAN,23463,14614,8846,3819,12665,2021-07-03
3174071010,JAKARTA SELATAN,KEBAYORAN BARU,CIPETE UTARA,29771,17764,12003,4102,16105,2021-07-03
3175021003,JAKARTA TIMUR,PULO GADUNG,CIPINANG,34608,22128,12469,6033,18502,2021-07-03
3175031007,JAKARTA TIMUR,JATINEGARA,CIPINANG BESAR SELATAN,30655,22019,8627,3910,12537,2021-07-03
3175031008,JAKARTA TIMUR,JATINEGARA,CIPINANG BESAR UTARA,38827,29436,9384,4205,13589,2021-07-03
3175031005,JAKARTA TIMUR,JATINEGARA,CIPINANG CEMPEDAK,29154,19686,9454,4704,14158,2021-07-03
3175081005,JAKARTA TIMUR,MAKASAR,CIPINANG MELAYU,37098,23264,13826,6414,20240,2021-07-03
3175031006,JAKARTA TIMUR,JATINEGARA,CIPINANG MUARA,46861,32657,14197,7306,21503,2021-07-03
3174051003,JAKARTA SELATAN,KEBAYORAN LAMA,CIPULIR,34708,23088,11615,4806,16421,2021-07-03
3175091001,JAKARTA TIMUR,CIRACAS,CIRACAS,55965,35365,20590,8412,29002,2021-07-03
3175041003,JAKARTA TIMUR,KRAMAT JATI,DUKUH,21239,14127,7107,3513,10620,2021-07-03
3175071001,JAKARTA TIMUR,DUREN SAWIT,DUREN SAWIT,53078,34446,18617,9246,27863,2021-07-03
3174081004,JAKARTA SELATAN,PANCORAN,DUREN TIGA,24673,15512,9154,3829,12983,2021-07-03
3173051005,JAKARTA BARAT,KEBON JERUK,DURI KEPA,52942,30594,22329,9971,32300,2021-07-03
3173011002,JAKARTA BARAT,CENGKARENG,DURI KOSAMBI,66093,42082,24000,8216,32216,2021-07-03
3171011006,JAKARTA PUSAT,GAMBIR,DURI PULO,17787,12051,5733,2383,8116,2021-07-03
3173041011,JAKARTA BARAT,TAMBORA,DURI SELATAN,12528,7592,4929,2365,7294,2021-07-03
3173041003,JAKARTA BARAT,TAMBORA,DURI UTARA,17380,11254,6123,2640,8763,2021-07-03
3171081003,JAKARTA PUSAT,JOHAR BARU,GALUR,15811,9066,6745,1970,8715,2021-07-03
3171011001,JAKARTA PUSAT,GAMBIR,GAMBIR,2232,1236,995,578,1573,2021-07-03
3174061004,JAKARTA SELATAN,CILANDAK,GANDARIA SELATAN,19394,11824,7562,2841,10403,2021-07-03
3174071009,JAKARTA SELATAN,KEBAYORAN BARU,GANDARIA UTARA,35026,21796,13225,5371,18596,2021-07-03
3175051001,JAKARTA TIMUR,PASAR REBO,GEDONG,31013,20205,10794,5296,16090,2021-07-03
3171071001,JAKARTA PUSAT,TANAH ABANG,GELORA,2753,1675,1071,568,1639,2021-07-03
3173031007,JAKARTA BARAT,TAMAN SARI,GLODOK,7192,3351,3839,1977,5816,2021-07-03
3171061004,JAKARTA PUSAT,MENTENG,GONDANGDIA,3760,1846,1909,1292,3201,2021-07-03
3173021001,JAKARTA BARAT,GROGOL PETAMBURAN,GROGOL,15067,9320,5741,2606,8347,2021-07-03
3174051005,JAKARTA SELATAN,KEBAYORAN LAMA,GROGOL SELATAN,38688,26111,12567,5466,18033,2021-07-03
3174051004,JAKARTA SELATAN,KEBAYORAN LAMA,GROGOL UTARA,37234,25035,12181,5845,18026,2021-07-03
3174021007,JAKARTA SELATAN,SETIA BUDI,GUNTUR,3590,1876,1711,989,2700,2021-07-03
3174071002,JAKARTA SELATAN,KEBAYORAN BARU,GUNUNG,8309,4685,3623,2033,5656,2021-07-03
3171031005,JAKARTA PUSAT,KEMAYORAN,GUNUNG SAHARI SELATAN,17256,10708,6541,2822,9363,2021-07-03
3171021004,JAKARTA PUSAT,SAWAH BESAR,GUNUNG SAHARI UTARA,13937,6983,6947,3373,10320,2021-07-03
3175081004,JAKARTA TIMUR,MAKASAR,HALIM PERDANA KUSUMAH,24426,10699,13705,9308,23013,2021-07-03
3171031003,JAKARTA PUSAT,KEMAYORAN,HARAPAN MULIA,19987,13409,6572,2699,9271,2021-07-03
3174091001,JAKARTA SELATAN,JAGAKARSA,JAGAKARSA,53714,32408,21290,8519,29809,2021-07-03
3175021007,JAKARTA TIMUR,PULO GADUNG,JATI,28870,18155,10694,5600,16294,2021-07-03
3174041002,JAKARTA SELATAN,PASAR MINGGU,JATI PADANG,32857,20460,12388,5858,18246,2021-07-03
3173071004,JAKARTA BARAT,PALMERAH,JATI PULO,24508,13892,10613,3649,14262,2021-07-03
3175061001,JAKARTA TIMUR,CAKUNG,JATINEGARA,72652,53818,18833,6720,25553,2021-07-03
3175021004,JAKARTA TIMUR,PULO GADUNG,JATINEGARA KAUM,21313,14254,7056,2930,9986,2021-07-03
3173021004,JAKARTA BARAT,GROGOL PETAMBURAN,JELAMBAR,26984,15627,11346,5470,16816,2021-07-03
3173021006,JAKARTA BARAT,GROGOL PETAMBURAN,JELAMBAR BARU,33734,20373,13348,6071,19419,2021-07-03
3173041006,JAKARTA BARAT,TAMBORA,JEMBATAN BESI,25735,19332,6402,2426,8828,2021-07-03
3173041008,JAKARTA BARAT,TAMBORA,JEMBATAN LIMA,18241,12773,5461,2266,7727,2021-07-03
3173081005,JAKARTA BARAT,KEMBANGAN,JOGLO,35285,22397,12883,5946,18829,2021-07-03
3171081001,JAKARTA PUSAT,JOHAR BARU,JOHAR BARU,28311,15012,13293,5336,18629,2021-07-03
3173041002,JAKARTA BARAT,TAMBORA,KALI ANYAR,20624,15003,5619,2234,7853,2021-07-03
3172041004,JAKARTA UTARA,CILINCING,KALIBARU,57771,43274,14494,4337,18831,2021-07-03
3174081002,JAKARTA SELATAN,PANCORAN,KALIBATA,36451,24759,11691,4920,16611,2021-07-03
3173061001,JAKARTA BARAT,KALI DERES,KALIDERES,60209,39465,20724,7583,28307,2021-07-03
3175051004,JAKARTA TIMUR,PASAR REBO,KALISARI,37255,23368,13873,6764,20637,2021-07-03
3173061004,JAKARTA BARAT,KALI DERES,KAMAL,46035,34153,11878,3658,15536,2021-07-03
3172011002,JAKARTA UTARA,PENJARINGAN,KAMAL MUARA,11039,5431,5598,2500,8098,2021-07-03
3171071007,JAKARTA PUSAT,TANAH ABANG,KAMPUNG BALI,10113,7010,3101,1509,4610,2021-07-03
3175031001,JAKARTA TIMUR,JATINEGARA,KAMPUNG MELAYU,22293,16604,5686,2239,7925,2021-07-03
3171081002,JAKARTA PUSAT,JOHAR BARU,KAMPUNG RAWA,15550,7160,8387,2546,10933,2021-07-03
3175041002,JAKARTA TIMUR,KRAMAT JATI,KAMPUNG TENGAH,38048,26872,11166,5255,16421,2021-07-03
3173011005,JAKARTA BARAT,CENGKARENG,KAPUK,104630,71764,32856,9494,42350,2021-07-03
3172011003,JAKARTA UTARA,PENJARINGAN,KAPUK MUARA,31275,17884,13372,6643,20015,2021-07-03
3171021002,JAKARTA PUSAT,SAWAH BESAR,KARANG ANYAR,23056,14706,8339,3403,11742,2021-07-03
3174021004,JAKARTA SELATAN,SETIA BUDI,KARET,8542,4980,3560,1436,4996,2021-07-03
3174021003,JAKARTA SELATAN,SETIA BUDI,KARET KUNINGAN,14166,8220,5942,2326,8268,2021-07-03
3174021002,JAKARTA SELATAN,SETIA BUDI,KARET SEMANGGI,2469,1218,1248,602,1850,2021-07-03
3171071003,JAKARTA PUSAT,TANAH ABANG,KARET TENGSIN,16695,10946,5746,2205,7951,2021-07-03
3171021003,JAKARTA PUSAT,SAWAH BESAR,KARTINI,19916,11973,7939,3453,11392,2021-07-03
3175011003,JAKARTA TIMUR,MATRAMAN,KAYU MANIS,22174,14952,7220,3007,10227,2021-07-03
3175021006,JAKARTA TIMUR,PULO GADUNG,KAYU PUTIH,35916,21243,14655,7047,21702,2021-07-03
3173031006,JAKARTA BARAT,TAMAN SARI,KEAGUNGAN,15262,9609,5650,1995,7645,2021-07-03
3174041007,JAKARTA SELATAN,PASAR MINGGU,KEBAGUSAN,38396,25374,13013,5182,18195,2021-07-03
3174051006,JAKARTA SELATAN,KEBAYORAN LAMA,KEBAYORAN LAMA SELATAN,35920,21441,14469,5793,20262,2021-07-03
3174051001,JAKARTA SELATAN,KEBAYORAN LAMA,KEBAYORAN LAMA UTARA,37004,24661,12333,5244,17577,2021-07-03
3174011004,JAKARTA SELATAN,TEBET,KEBON BARU,30533,19135,11392,5126,16518,2021-07-03
3172021005,JAKARTA UTARA,TANJUNG PRIOK,KEBON BAWANG,44427,27823,16586,6921,23507,2021-07-03
3173051001,JAKARTA BARAT,KEBON JERUK,KEBON JERUK,46870,31829,15027,6781,21808,2021-07-03
3171071006,JAKARTA PUSAT,TANAH ABANG,KEBON KACANG,19075,13860,5212,2624,7836,2021-07-03
3171011005,JAKARTA PUSAT,GAMBIR,KEBON KELAPA,9383,6041,3341,1656,4997,2021-07-03
3171031002,JAKARTA PUSAT,KEMAYORAN,KEBON KOSONG,26178,17074,9100,3463,12563,2021-07-03
3175011005,JAKARTA TIMUR,MATRAMAN,KEBON MANGGIS,14644,8959,5679,2759,8438,2021-07-03
3171071005,JAKARTA PUSAT,TANAH ABANG,KEBON MELATI,27297,20933,6363,2857,9220,2021-07-03
3175081003,JAKARTA TIMUR,MAKASAR,KEBON PALA,40723,27078,13639,6177,19816,2021-07-03
3171061005,JAKARTA PUSAT,MENTENG,KEBON SIRIH,10880,7718,3162,1544,4706,2021-07-03
3173011004,JAKARTA BARAT,CENGKARENG,KEDAUNG KALI ANGKE,28123,16057,12061,3214,15275,2021-07-03
3173051007,JAKARTA BARAT,KEBON JERUK,KEDOYA SELATAN,28300,17313,10967,4604,15571,2021-07-03
3173051006,JAKARTA BARAT,KEBON JERUK,KEDOYA UTARA,38771,22114,16645,6957,23602,2021-07-03
3173051004,JAKARTA BARAT,KEBON JERUK,KELAPA DUA,20509,12882,7621,3133,10754,2021-07-03
3175091003,JAKARTA TIMUR,CIRACAS,KELAPA DUA WETAN,40776,25486,15277,7208,22485,2021-07-03
3172061003,JAKARTA UTARA,KELAPA GADING,KELAPA GADING BARAT,31544,15936,15580,8800,24380,2021-07-03
3172061001,JAKARTA UTARA,KELAPA GADING,KELAPA GADING TIMUR,30470,13765,16691,9112,25803,2021-07-03
3173071005,JAKARTA BARAT,PALMERAH,KEMANGGISAN,28159,17316,10833,5191,16024,2021-07-03
3171031001,JAKARTA PUSAT,KEMAYORAN,KEMAYORAN,18556,11217,7335,2815,10150,2021-07-03
3173081006,JAKARTA BARAT,KEMBANGAN,KEMBANGAN SELATAN,24028,14635,9374,4997,14371,2021-07-03
3173081001,JAKARTA BARAT,KEMBANGAN,KEMBANGAN UTARA,45663,28685,16966,6572,23538,2021-07-03
3171041002,JAKARTA PUSAT,SENEN,KENARI,8328,4688,3639,1731,5370,2021-07-03
3173041005,JAKARTA BARAT,TAMBORA,KERENDANG,17494,12050,5441,2218,7659,2021-07-03
3175071003,JAKARTA TIMUR,DUREN SAWIT,KLENDER,60420,42736,17678,7413,25091,2021-07-03
3172031001,JAKARTA UTARA,KOJA,KOJA,24600,16792,7807,2740,10547,2021-07-03
3173071006,JAKARTA BARAT,PALMERAH,KOTA BAMBU SELATAN,18287,12004,6280,2237,8517,2021-07-03
3173071003,JAKARTA BARAT,PALMERAH,KOTA BAMBU UTARA,21312,14438,6873,2770,9643,2021-07-03
3171041004,JAKARTA PUSAT,SENEN,KRAMAT,25258,17470,7785,2976,10761,2021-07-03
3175041001,JAKARTA TIMUR,KRAMAT JATI,KRAMAT JATI,29922,19467,10447,5002,15449,2021-07-03
3174071003,JAKARTA SELATAN,KEBAYORAN BARU,KRAMAT PELA,12737,7178,5556,2370,7926,2021-07-03
3173031002,JAKARTA BARAT,TAMAN SARI,KRUKUT,17023,10749,6267,2281,8548,2021-07-03
3174031005,JAKARTA SELATAN,MAMPANG PRAPATAN,KUNINGAN BARAT,11229,6843,4383,1543,5926,2021-07-03
3174021008,JAKARTA SELATAN,SETIA BUDI,KUNINGAN TIMUR,5331,3197,2132,1055,3187,2021-07-03
3171041005,JAKARTA PUSAT,SENEN,KWITANG,13487,8286,5199,2094,7293,2021-07-03
3172031003,JAKARTA UTARA,KOJA,LAGOA,51431,36014,15409,5642,21051,2021-07-03
3174061002,JAKARTA SELATAN,CILANDAK,LEBAK BULUS,32738,20468,12259,5856,18115,2021-07-03
3174091004,JAKARTA SELATAN,JAGAKARSA,LENTENG AGUNG,46600,32343,14251,6133,20384,2021-07-03
3175101007,JAKARTA TIMUR,CIPAYUNG,LUBANG BUAYA,55114,35219,19885,8395,28280,2021-07-03
3175081001,JAKARTA TIMUR,MAKASAR,MAKASAR,30013,18269,11736,4956,16692,2021-07-03
3175071006,JAKARTA TIMUR,DUREN SAWIT,MALAKA JAYA,26798,16147,10644,5479,16123,2021-07-03
3175071005,JAKARTA TIMUR,DUREN SAWIT,MALAKA SARI,23691,13759,9921,5410,15331,2021-07-03
3174031001,JAKARTA SELATAN,MAMPANG PRAPATAN,MAMPANG PRAPATAN,15885,10609,5271,2054,7325,2021-07-03
3173031005,JAKARTA BARAT,TAMAN SARI,MANGGA BESAR,6690,3417,3271,1444,4715,2021-07-03
3171021005,JAKARTA PUSAT,SAWAH BESAR,MANGGA DUA SELATAN,24940,15900,9035,3849,12884,2021-07-03
3174011007,JAKARTA SELATAN,TEBET,MANGGARAI,24972,16299,8667,3555,12222,2021-07-03
3174011006,JAKARTA SELATAN,TEBET,MANGGARAI SELATAN,20274,11848,8423,3204,11627,2021-07-03
3173031003,JAKARTA BARAT,TAMAN SARI,MAPHAR,14671,8702,5969,2560,8529,2021-07-03
3172041003,JAKARTA UTARA,CILINCING,MARUNDA,24385,14768,9614,2575,12189,2021-07-03
3174071001,JAKARTA SELATAN,KEBAYORAN BARU,MELAWAI,2386,1116,1268,826,2094,2021-07-03
3171061001,JAKARTA PUSAT,MENTENG,MENTENG,22450,15745,6700,3506,10206,2021-07-03
3174021005,JAKARTA SELATAN,SETIA BUDI,MENTENG ATAS,24369,14536,9828,4017,13845,2021-07-03
3174011003,JAKARTA SELATAN,TEBET,MENTENG DALAM,31623,20248,11364,5172,16536,2021-07-03
3173081003,JAKARTA BARAT,KEMBANGAN,MERUYA SELATAN,27261,17116,10132,4323,14455,2021-07-03
3173081002,JAKARTA BARAT,KEMBANGAN,MERUYA UTARA,38525,24476,14044,6920,20964,2021-07-03
3175101004,JAKARTA TIMUR,CIPAYUNG,MUNJUL,20582,13454,7125,3593,10718,2021-07-03
3172051002,JAKARTA UTARA,PADEMANGAN,PADEMANGAN BARAT,64756,43887,20862,7791,28653,2021-07-03
3172051001,JAKARTA UTARA,PADEMANGAN,PADEMANGAN TIMUR,32689,17252,15419,6883,22302,2021-07-03
3175011004,JAKARTA TIMUR,MATRAMAN,PAL MERIAM,17550,11164,6382,2716,9098,2021-07-03
3173071001,JAKARTA BARAT,PALMERAH,PALMERAH,54706,34955,19741,7990,27731,2021-07-03
3174081001,JAKARTA SELATAN,PANCORAN,PANCORAN,16983,10905,6077,2649,8726,2021-07-03
3172021003,JAKARTA UTARA,TANJUNG PRIOK,PAPANGGO,33902,21202,12683,4685,17368,2021-07-03
3171021001,JAKARTA PUSAT,SAWAH BESAR,PASAR BARU,11656,5909,5740,2909,8649,2021-07-03
3174021006,JAKARTA SELATAN,SETIA BUDI,PASAR MANGGIS,23415,14503,8906,3545,12451,2021-07-03
3174041001,JAKARTA SELATAN,PASAR MINGGU,PASAR MINGGU,21700,13479,8215,4554,12769,2021-07-03
3171041003,JAKARTA PUSAT,SENEN,PASEBAN,20652,13082,7564,3302,10866,2021-07-03
3173061005,JAKARTA BARAT,KALI DERES,PEGADUNGAN,65248,41348,23878,9092,32970,2021-07-03
3171061002,JAKARTA PUSAT,MENTENG,PEGANGSAAN,18427,11943,6482,2933,9415,2021-07-03
3172061002,JAKARTA UTARA,KELAPA GADING,PEGANGSAAN DUA,44451,21887,22538,10467,33005,2021-07-03
3172011004,JAKARTA UTARA,PENJARINGAN,PEJAGALAN,66008,40267,25720,10892,36612,2021-07-03
3174041006,JAKARTA SELATAN,PASAR MINGGU,PEJATEN BARAT,30591,18282,12298,5571,17869,2021-07-03
3174041005,JAKARTA SELATAN,PASAR MINGGU,PEJATEN TIMUR,50150,33620,16522,6023,22545,2021-07-03
3175051005,JAKARTA TIMUR,PASAR REBO,PEKAYON,37440,23455,13980,6036,20016,2021-07-03
3173041009,JAKARTA BARAT,TAMBORA,PEKOJAN,20921,12928,7986,3413,11399,2021-07-03
3174031003,JAKARTA SELATAN,MAMPANG PRAPATAN,PELA MAMPANG,37784,24324,13448,5619,19067,2021-07-03
3174081005,JAKARTA SELATAN,PANCORAN,PENGADEGAN,18685,10032,8648,3318,11966,2021-07-03
3175061003,JAKARTA TIMUR,CAKUNG,PENGGILINGAN,84511,62119,22390,9341,31731,2021-07-03
3172011001,JAKARTA UTARA,PENJARINGAN,PENJARINGAN,75505,51216,24278,7826,32104,2021-07-03
3174101001,JAKARTA SELATAN,PESANGGRAHAN,PESANGGRAHAN,23733,13361,10368,4870,15238,2021-07-03
3171071004,JAKARTA PUSAT,TANAH ABANG,PETAMBURAN,28974,22021,6949,2922,9871,2021-07-03
3174071008,JAKARTA SELATAN,KEBAYORAN BARU,PETOGOGAN,10203,6052,4150,1843,5993,2021-07-03
3171011004,JAKARTA PUSAT,GAMBIR,PETOJO SELATAN,13506,8129,5368,2995,8363,2021-07-03
3171011003,JAKARTA PUSAT,GAMBIR,PETOJO UTARA,16084,10391,5691,2695,8386,2021-07-03
3174101004,JAKARTA SELATAN,PESANGGRAHAN,PETUKANGAN SELATAN,32229,20071,12155,4907,17062,2021-07-03
3174101003,JAKARTA SELATAN,PESANGGRAHAN,PETUKANGAN UTARA,46427,29750,16674,6719,23393,2021-07-03
3175081002,JAKARTA TIMUR,MAKASAR,PINANG RANTI,23465,14446,9015,3446,12461,2021-07-03
3173031008,JAKARTA BARAT,TAMAN SARI,PINANGSIA,9405,5402,4002,1626,5628,2021-07-03
3175011001,JAKARTA TIMUR,MATRAMAN,PISANGAN BARU,27793,19506,8280,3811,12091,2021-07-03
3175021002,JAKARTA TIMUR,PULO GADUNG,PISANGAN TIMUR,35717,22560,13149,5629,18778,2021-07-03
3172011005,JAKARTA UTARA,PENJARINGAN,PLUIT,42979,22149,20796,12296,33092,2021-07-03
3175071002,JAKARTA TIMUR,DUREN SAWIT,PONDOK BAMBU,53658,33976,19666,8857,28523,2021-07-03
3175071004,JAKARTA TIMUR,DUREN SAWIT,PONDOK KELAPA,62704,39594,23093,10941,34034,2021-07-03
3175071007,JAKARTA TIMUR,DUREN SAWIT,PONDOK KOPI,30741,21159,9578,4344,13922,2021-07-03
3174061003,JAKARTA SELATAN,CILANDAK,PONDOK LABU,39778,24156,15609,6850,22459,2021-07-03
3174051002,JAKARTA SELATAN,KEBAYORAN LAMA,PONDOK PINANG,49276,31484,17769,9398,27167,2021-07-03
3175101003,JAKARTA TIMUR,CIPAYUNG,PONDOK RANGGON,21791,14773,7010,3777,10787,2021-07-03
3101011003,KAB.ADM.KEP.SERIBU,KEP. SERIBU UTARA,PULAU HARAPAN,1785,505,1280,669,1949,2021-07-03
3101011002,KAB.ADM.KEP.SERIBU,KEP. SERIBU UTARA,PULAU KELAPA,4729,1342,3387,1080,4467,2021-07-03
3101011001,KAB.ADM.KEP.SERIBU,KEP. SERIBU UTARA,PULAU PANGGANG,4667,1214,3453,1140,4593,2021-07-03
3101021003,KAB.ADM.KEP.SERIBU,KEP. SERIBU SELATAN,PULAU PARI,2370,451,1919,613,2532,2021-07-03
3101021002,KAB.ADM.KEP.SERIBU,KEP. SERIBU SELATAN,PULAU TIDUNG,3922,1183,2738,1133,3871,2021-07-03
3101021001,KAB.ADM.KEP.SERIBU,KEP. SERIBU SELATAN,PULAU UNTUNG JAWA,1665,433,1232,558,1790,2021-07-03
3174071007,JAKARTA SELATAN,KEBAYORAN BARU,PULO,5184,2761,2421,1343,3764,2021-07-03
3175021001,JAKARTA TIMUR,PULO GADUNG,PULO GADUNG,30292,20078,10203,4643,14846,2021-07-03
3175061005,JAKARTA TIMUR,CAKUNG,PULO GEBANG,83832,58513,25309,10611,35920,2021-07-03
3174041004,JAKARTA SELATAN,PASAR MINGGU,RAGUNAN,34536,20476,14047,5800,19847,2021-07-03
3175091005,JAKARTA TIMUR,CIRACAS,RAMBUTAN,31759,22895,8858,4281,13139,2021-07-03
3172031006,JAKARTA UTARA,KOJA,RAWA BADAK SELATAN,36403,25963,10437,3932,14369,2021-07-03
3172031004,JAKARTA UTARA,KOJA,RAWA BADAK UTARA,29198,18723,10470,3848,14318,2021-07-03
3174071005,JAKARTA SELATAN,KEBAYORAN BARU,RAWA BARAT,5029,2757,2271,1320,3591,2021-07-03
3173011003,JAKARTA BARAT,CENGKARENG,RAWA BUAYA,51752,32991,18752,5986,24738,2021-07-03
3175031004,JAKARTA TIMUR,JATINEGARA,RAWA BUNGA,18617,13214,5402,2464,7866,2021-07-03
3174081003,JAKARTA SELATAN,PANCORAN,RAWA JATI,18210,10944,7260,3415,10675,2021-07-03
3175061002,JAKARTA TIMUR,CAKUNG,RAWA TERATE,21332,13041,8289,2093,10382,2021-07-03
3175021005,JAKARTA TIMUR,PULO GADUNG,RAWAMANGUN,32470,20450,12013,5837,17850,2021-07-03
3171051003,JAKARTA PUSAT,CEMPAKA PUTIH,RAWASARI,19312,12021,7280,3477,10757,2021-07-03
3173041010,JAKARTA BARAT,TAMBORA,ROA MALAKA,3149,1547,1598,881,2479,2021-07-03
3172041006,JAKARTA UTARA,CILINCING,ROROTAN,35258,22015,13238,4589,17827,2021-07-03
3174071004,JAKARTA SELATAN,KEBAYORAN BARU,SELONG,2576,1243,1330,878,2208,2021-07-03
3173061002,JAKARTA BARAT,KALI DERES,SEMANAN,60715,43765,16945,4974,21919,2021-07-03
3172041007,JAKARTA UTARA,CILINCING,SEMPER BARAT,59323,36536,22772,9076,31848,2021-07-03
3172041005,JAKARTA UTARA,CILINCING,SEMPER TIMUR,31249,19869,11377,4296,15673,2021-07-03
3174071006,JAKARTA SELATAN,KEBAYORAN BARU,SENAYAN,2482,1529,950,568,1518,2021-07-03
3171041001,JAKARTA PUSAT,SENEN,SENEN,5951,3560,2390,1177,3567,2021-07-03
3171031004,JAKARTA PUSAT,KEMAYORAN,SERDANG,26045,16285,9757,3936,13693,2021-07-03
3174021001,JAKARTA SELATAN,SETIA BUDI,SETIA BUDI,2532,1418,1111,643,1754,2021-07-03
3175101005,JAKARTA TIMUR,CIPAYUNG,SETU,17609,12270,5337,2668,8005,2021-07-03
3173071002,JAKARTA BARAT,PALMERAH,SLIPI,14526,8672,5851,2720,8571,2021-07-03
3173081004,JAKARTA BARAT,KEMBANGAN,SRENGSENG,39370,26621,12733,6162,18895,2021-07-03
3174091002,JAKARTA SELATAN,JAGAKARSA,SRENGSENG SAWAH,50305,28180,22110,8886,30996,2021-07-03
3173051003,JAKARTA BARAT,KEBON JERUK,SUKABUMI SELATAN,30581,20940,9640,3471,13111,2021-07-03
3173051002,JAKARTA BARAT,KEBON JERUK,SUKABUMI UTARA,33050,23498,9549,4004,13553,2021-07-03
3172041002,JAKARTA UTARA,CILINCING,SUKAPURA,46955,31569,15377,5442,20819,2021-07-03
3171031007,JAKARTA PUSAT,KEMAYORAN,SUMUR BATU,19863,12072,7787,3396,11183,2021-07-03
3172021004,JAKARTA UTARA,TANJUNG PRIOK,SUNGAI BAMBU,25366,15560,9801,3530,13331,2021-07-03
3172021006,JAKARTA UTARA,TANJUNG PRIOK,SUNTER AGUNG,62904,34054,28821,13481,42302,2021-07-03
3172021002,JAKARTA UTARA,TANJUNG PRIOK,SUNTER JAYA,55168,32464,22679,10451,33130,2021-07-03
3175091004,JAKARTA TIMUR,CIRACAS,SUSUKAN,28884,18227,10655,4595,15250,2021-07-03
3173031001,JAKARTA BARAT,TAMAN SARI,TAMAN SARI,12915,7781,5132,2387,7519,2021-07-03
3173041001,JAKARTA BARAT,TAMBORA,TAMBORA,9087,5700,3387,1516,4903,2021-07-03
3173041004,JAKARTA BARAT,TAMBORA,TANAH SEREAL,23141,13423,9716,3874,13590,2021-07-03
3171081004,JAKARTA PUSAT,JOHAR BARU,TANAH TINGGI,32931,20010,12919,4247,17166,2021-07-03
3173031004,JAKARTA BARAT,TAMAN SARI,TANGKI,11593,6919,4670,1927,6597,2021-07-03
3174091005,JAKARTA SELATAN,JAGAKARSA,TANJUNG BARAT,34530,22907,11617,5672,17289,2021-07-03
3173021005,JAKARTA BARAT,GROGOL PETAMBURAN,TANJUNG DUREN SELATAN,22469,12041,10413,4458,14871,2021-07-03
3173021002,JAKARTA BARAT,GROGOL PETAMBURAN,TANJUNG DUREN UTARA,15224,7764,7454,3525,10979,2021-07-03
3172021001,JAKARTA UTARA,TANJUNG PRIOK,TANJUNG PRIOK,29913,17632,12272,3831,16103,2021-07-03
3174011002,JAKARTA SELATAN,TEBET,TEBET BARAT,18916,10820,8087,4187,12274,2021-07-03
3174011001,JAKARTA SELATAN,TEBET,TEBET TIMUR,16031,8451,7573,3739,11312,2021-07-03
3173061003,JAKARTA BARAT,KALI DERES,TEGAL ALUR,71923,49280,22634,6848,29482,2021-07-03
3174031004,JAKARTA SELATAN,MAMPANG PRAPATAN,TEGAL PARANG,28143,20315,7824,3303,11127,2021-07-03
3173021003,JAKARTA BARAT,GROGOL PETAMBURAN,TOMANG,25531,14679,10838,4975,15813,2021-07-03
3172031005,JAKARTA UTARA,KOJA,TUGU SELATAN,33663,23524,10134,3817,13951,2021-07-03
3172031002,JAKARTA UTARA,KOJA,TUGU UTARA,58638,41546,17087,6736,23823,2021-07-03
3175061006,JAKARTA TIMUR,CAKUNG,UJUNG MENTENG,25702,16270,9422,3968,13390,2021-07-03
3174101005,JAKARTA SELATAN,PESANGGRAHAN,ULUJAMI,35077,23889,11181,4933,16114,2021-07-03
3175011006,JAKARTA TIMUR,MATRAMAN,UTAN KAYU SELATAN,29303,18041,11251,5041,16292,2021-07-03
3175011002,JAKARTA TIMUR,MATRAMAN,UTAN KAYU UTARA,24728,15349,9378,3816,13194,2021-07-03
3171031008,JAKARTA PUSAT,KEMAYORAN,UTAN PANJANG,25622,18096,7525,2797,10322,2021-07-03
3172021007,JAKARTA UTARA,TANJUNG PRIOK,WARAKAS,38194,24056,14124,5206,19330,2021-07-03
3173021007,JAKARTA BARAT,GROGOL PETAMBURAN,WIJAYA KUSUMA,34170,22038,12117,4852,16969,2021-07-03
3172051003,JAKARTA UTARA,PADEMANGAN,ANCOL,23379,15880,7499,3299,10798,2021-07-04
3173041007,JAKARTA BARAT,TAMBORA,ANGKE,29230,19256,9974,3237,13211,2021-07-04
3175041005,JAKARTA TIMUR,KRAMAT JATI,BALE KAMBANG,28803,22148,6655,2663,9318,2021-07-04
3175031003,JAKARTA TIMUR,JATINEGARA,BALI MESTER,9675,6587,3088,1524,4612,2021-07-04
3175101006,JAKARTA TIMUR,CIPAYUNG,BAMBU APUS,25985,18212,7773,4002,11775,2021-07-04
3174031002,JAKARTA SELATAN,MAMPANG PRAPATAN,BANGKA,21356,14580,6776,2722,9498,2021-07-04
3175051002,JAKARTA TIMUR,PASAR REBO,BARU,23514,14269,9245,4693,13938,2021-07-04
3175041004,JAKARTA TIMUR,KRAMAT JATI,BATU AMPAR,47416,35796,11620,5285,16905,2021-07-04
3171071002,JAKARTA PUSAT,TANAH ABANG,BENDUNGAN HILIR,21374,13513,7861,3590,11451,2021-07-04
3175031002,JAKARTA TIMUR,JATINEGARA,BIDARA CINA,36461,26996,9465,4051,13516,2021-07-04
3174101002,JAKARTA SELATAN,PESANGGRAHAN,BINTARO,52402,36840,15562,7108,22670,2021-07-04
3174011005,JAKARTA SELATAN,TEBET,BUKIT DURI,33953,23810,10143,3976,14119,2021-07-04
3171041006,JAKARTA PUSAT,SENEN,BUNGUR,17929,11655,6274,2749,9023,2021-07-04
3175061007,JAKARTA TIMUR,CAKUNG,CAKUNG BARAT,57222,39859,17363,4032,21395,2021-07-04
3175061004,JAKARTA TIMUR,CAKUNG,CAKUNG TIMUR,57655,39682,17973,6436,24409,2021-07-04
3175041007,JAKARTA TIMUR,KRAMAT JATI,CAWANG,32481,22937,9544,4295,13839,2021-07-04
3175101008,JAKARTA TIMUR,CIPAYUNG,CEGER,18740,12824,5916,2577,8493,2021-07-04
3171031006,JAKARTA PUSAT,KEMAYORAN,CEMPAKA BARU,31257,21837,9420,4025,13445,2021-07-04
3171051002,JAKARTA PUSAT,CEMPAKA PUTIH,CEMPAKA PUTIH BARAT,34725,24550,10175,4986,15161,2021-07-04
3171051001,JAKARTA PUSAT,CEMPAKA PUTIH,CEMPAKA PUTIH TIMUR,24170,15438,8732,4466,13198,2021-07-04
3173011001,JAKARTA BARAT,CENGKARENG,CENGKARENG BARAT,65702,41434,24268,8255,32523,2021-07-04
3173011006,JAKARTA BARAT,CENGKARENG,CENGKARENG TIMUR,80100,54162,25938,8541,34479,2021-07-04
3175091002,JAKARTA TIMUR,CIRACAS,CIBUBUR,65231,43352,21879,9481,31360,2021-07-04
3171011002,JAKARTA PUSAT,GAMBIR,CIDENG,15696,9374,6322,3190,9512,2021-07-04
3174091003,JAKARTA SELATAN,JAGAKARSA,CIGANJUR,38048,25897,12151,5181,17332,2021-07-04
3175051003,JAKARTA TIMUR,PASAR REBO,CIJANTUNG,41013,27353,13660,6212,19872,2021-07-04
3171061003,JAKARTA PUSAT,MENTENG,CIKINI,8260,5539,2721,1372,4093,2021-07-04
3174081006,JAKARTA SELATAN,PANCORAN,CIKOKO,10503,6466,4037,1753,5790,2021-07-04
3174061001,JAKARTA SELATAN,CILANDAK,CILANDAK BARAT,51346,31847,19499,7916,27415,2021-07-04
3174041003,JAKARTA SELATAN,PASAR MINGGU,CILANDAK TIMUR,24239,15178,9061,4860,13921,2021-07-04
3175101002,JAKARTA TIMUR,CIPAYUNG,CILANGKAP,27179,18818,8361,3825,12186,2021-07-04
3175041006,JAKARTA TIMUR,KRAMAT JATI,CILILITAN,39984,28784,11200,5258,16458,2021-07-04
3172041001,JAKARTA UTARA,CILINCING,CILINCING,42677,31281,11396,3941,15337,2021-07-04
3175101001,JAKARTA TIMUR,CIPAYUNG,CIPAYUNG,25747,16637,9110,4251,13361,2021-07-04
3174091006,JAKARTA SELATAN,JAGAKARSA,CIPEDAK,37809,25250,12559,4819,17378,2021-07-04
3174061005,JAKARTA SELATAN,CILANDAK,CIPETE SELATAN,26500,17418,9082,3824,12906,2021-07-04
3174071010,JAKARTA SELATAN,KEBAYORAN BARU,CIPETE UTARA,33902,21720,12182,4106,16288,2021-07-04
3175021003,JAKARTA TIMUR,PULO GADUNG,CIPINANG,39069,26356,12713,6053,18766,2021-07-04
3175031007,JAKARTA TIMUR,JATINEGARA,CIPINANG BESAR SELATAN,34938,26179,8759,3916,12675,2021-07-04
3175031008,JAKARTA TIMUR,JATINEGARA,CIPINANG BESAR UTARA,44479,34932,9547,4206,13753,2021-07-04
3175031005,JAKARTA TIMUR,JATINEGARA,CIPINANG CEMPEDAK,32695,23089,9606,4713,14319,2021-07-04
3175081005,JAKARTA TIMUR,MAKASAR,CIPINANG MELAYU,42144,28002,14142,6420,20562,2021-07-04
3175031006,JAKARTA TIMUR,JATINEGARA,CIPINANG MUARA,53251,38739,14512,7324,21836,2021-07-04
3174051003,JAKARTA SELATAN,KEBAYORAN LAMA,CIPULIR,39635,27781,11854,4811,16665,2021-07-04
3175091001,JAKARTA TIMUR,CIRACAS,CIRACAS,63801,42861,20940,8414,29354,2021-07-04
3175041003,JAKARTA TIMUR,KRAMAT JATI,DUKUH,24404,17217,7187,3518,10705,2021-07-04
3175071001,JAKARTA TIMUR,DUREN SAWIT,DUREN SAWIT,60443,41465,18978,9263,28241,2021-07-04
3174081004,JAKARTA SELATAN,PANCORAN,DUREN TIGA,28099,18750,9349,3834,13183,2021-07-04
3173051005,JAKARTA BARAT,KEBON JERUK,DURI KEPA,59448,36650,22798,9982,32780,2021-07-04
3173011002,JAKARTA BARAT,CENGKARENG,DURI KOSAMBI,75895,51450,24445,8225,32670,2021-07-04
3171011006,JAKARTA PUSAT,GAMBIR,DURI PULO,19986,14153,5833,2389,8222,2021-07-04
3173041011,JAKARTA BARAT,TAMBORA,DURI SELATAN,14099,9057,5042,2367,7409,2021-07-04
3173041003,JAKARTA BARAT,TAMBORA,DURI UTARA,19768,13490,6278,2641,8919,2021-07-04
3171081003,JAKARTA PUSAT,JOHAR BARU,GALUR,18098,11234,6864,1972,8836,2021-07-04
3171011001,JAKARTA PUSAT,GAMBIR,GAMBIR,2434,1425,1009,580,1589,2021-07-04
3174061004,JAKARTA SELATAN,CILANDAK,GANDARIA SELATAN,21926,14178,7748,2845,10593,2021-07-04
3174071009,JAKARTA SELATAN,KEBAYORAN BARU,GANDARIA UTARA,39609,26127,13482,5374,18856,2021-07-04
3175051001,JAKARTA TIMUR,PASAR REBO,GEDONG,35444,24420,11024,5300,16324,2021-07-04
3171071001,JAKARTA PUSAT,TANAH ABANG,GELORA,3106,2010,1096,569,1665,2021-07-04
3173031007,JAKARTA BARAT,TAMAN SARI,GLODOK,7836,3916,3920,1977,5897,2021-07-04
3171061004,JAKARTA PUSAT,MENTENG,GONDANGDIA,4093,2153,1940,1294,3234,2021-07-04
3173021001,JAKARTA BARAT,GROGOL PETAMBURAN,GROGOL,16815,10983,5832,2607,8439,2021-07-04
3174051005,JAKARTA SELATAN,KEBAYORAN LAMA,GROGOL SELATAN,43915,31133,12782,5469,18251,2021-07-04
3174051004,JAKARTA SELATAN,KEBAYORAN LAMA,GROGOL UTARA,42216,29719,12497,5857,18354,2021-07-04
3174021007,JAKARTA SELATAN,SETIA BUDI,GUNTUR,3962,2235,1727,990,2717,2021-07-04
3174071002,JAKARTA SELATAN,KEBAYORAN BARU,GUNUNG,9344,5636,3708,2035,5743,2021-07-04
3171031005,JAKARTA PUSAT,KEMAYORAN,GUNUNG SAHARI SELATAN,19380,12670,6710,2823,9533,2021-07-04
3171021004,JAKARTA PUSAT,SAWAH BESAR,GUNUNG SAHARI UTARA,15647,8611,7036,3376,10412,2021-07-04
3175081004,JAKARTA TIMUR,MAKASAR,HALIM PERDANA KUSUMAH,28110,14273,13837,9312,23149,2021-07-04
3171031003,JAKARTA PUSAT,KEMAYORAN,HARAPAN MULIA,22700,15988,6712,2702,9414,2021-07-04
3174091001,JAKARTA SELATAN,JAGAKARSA,JAGAKARSA,61552,39694,21858,8533,30391,2021-07-04
3175021007,JAKARTA TIMUR,PULO GADUNG,JATI,32443,21564,10879,5611,16490,2021-07-04
3174041002,JAKARTA SELATAN,PASAR MINGGU,JATI PADANG,37250,24638,12612,5863,18475,2021-07-04
3173071004,JAKARTA BARAT,PALMERAH,JATI PULO,27994,17288,10706,3651,14357,2021-07-04
3175061001,JAKARTA TIMUR,CAKUNG,JATINEGARA,83563,64346,19217,6765,25982,2021-07-04
3175021004,JAKARTA TIMUR,PULO GADUNG,JATINEGARA KAUM,24364,17151,7213,2936,10149,2021-07-04
3173021004,JAKARTA BARAT,GROGOL PETAMBURAN,JELAMBAR,30180,18554,11626,5479,17105,2021-07-04
3173021006,JAKARTA BARAT,GROGOL PETAMBURAN,JELAMBAR BARU,37799,24126,13673,6076,19749,2021-07-04
3173041006,JAKARTA BARAT,TAMBORA,JEMBATAN BESI,29182,22630,6552,2430,8982,2021-07-04
3173041008,JAKARTA BARAT,TAMBORA,JEMBATAN LIMA,20627,14939,5688,2267,7955,2021-07-04
3173081005,JAKARTA BARAT,KEMBANGAN,JOGLO,40475,27340,13135,5949,19084,2021-07-04
3171081001,JAKARTA PUSAT,JOHAR BARU,JOHAR BARU,32845,19345,13500,5342,18842,2021-07-04
3173041002,JAKARTA BARAT,TAMBORA,KALI ANYAR,23582,17862,5720,2236,7956,2021-07-04
3172041004,JAKARTA UTARA,CILINCING,KALIBARU,67165,52077,15088,4351,19439,2021-07-04
3174081002,JAKARTA SELATAN,PANCORAN,KALIBATA,41464,29509,11955,4925,16880,2021-07-04
3173061001,JAKARTA BARAT,KALI DERES,KALIDERES,69014,47829,21185,7596,28781,2021-07-04
3175051004,JAKARTA TIMUR,PASAR REBO,KALISARI,42557,28469,14088,6768,20856,2021-07-04
3173061004,JAKARTA BARAT,KALI DERES,KAMAL,53180,41080,12100,3658,15758,2021-07-04
3172011002,JAKARTA UTARA,PENJARINGAN,KAMAL MUARA,12679,6986,5693,2502,8195,2021-07-04
3171071007,JAKARTA PUSAT,TANAH ABANG,KAMPUNG BALI,11551,8381,3170,1511,4681,2021-07-04
3175031001,JAKARTA TIMUR,JATINEGARA,KAMPUNG MELAYU,25476,19535,5941,2243,8184,2021-07-04
3171081002,JAKARTA PUSAT,JOHAR BARU,KAMPUNG RAWA,18247,9744,8503,2546,11049,2021-07-04
3175041002,JAKARTA TIMUR,KRAMAT JATI,KAMPUNG TENGAH,43668,32333,11335,5257,16592,2021-07-04
3173011005,JAKARTA BARAT,CENGKARENG,KAPUK,121994,88522,33472,9500,42972,2021-07-04
3172011003,JAKARTA UTARA,PENJARINGAN,KAPUK MUARA,35498,21699,13799,6650,20449,2021-07-04
3171021002,JAKARTA PUSAT,SAWAH BESAR,KARANG ANYAR,25865,17330,8535,3404,11939,2021-07-04
3174021004,JAKARTA SELATAN,SETIA BUDI,KARET,9581,5973,3608,1436,5044,2021-07-04
3174021003,JAKARTA SELATAN,SETIA BUDI,KARET KUNINGAN,15939,9876,6063,2330,8393,2021-07-04
3174021002,JAKARTA SELATAN,SETIA BUDI,KARET SEMANGGI,2746,1475,1271,602,1873,2021-07-04
3171071003,JAKARTA PUSAT,TANAH ABANG,KARET TENGSIN,19113,13244,5869,2208,8077,2021-07-04
3171021003,JAKARTA PUSAT,SAWAH BESAR,KARTINI,22303,14210,8093,3454,11547,2021-07-04
3175011003,JAKARTA TIMUR,MATRAMAN,KAYU MANIS,25138,17756,7382,3013,10395,2021-07-04
3175021006,JAKARTA TIMUR,PULO GADUNG,KAYU PUTIH,40378,25487,14891,7063,21954,2021-07-04
3173031006,JAKARTA BARAT,TAMAN SARI,KEAGUNGAN,17231,11388,5843,1997,7840,2021-07-04
3174041007,JAKARTA SELATAN,PASAR MINGGU,KEBAGUSAN,44010,30757,13253,5188,18441,2021-07-04
3174051006,JAKARTA SELATAN,KEBAYORAN LAMA,KEBAYORAN LAMA SELATAN,40895,26208,14687,5799,20486,2021-07-04
3174051001,JAKARTA SELATAN,KEBAYORAN LAMA,KEBAYORAN LAMA UTARA,42214,29658,12556,5252,17808,2021-07-04
3174011004,JAKARTA SELATAN,TEBET,KEBON BARU,34878,23350,11528,5132,16660,2021-07-04
3172021005,JAKARTA UTARA,TANJUNG PRIOK,KEBON BAWANG,50597,33639,16958,6925,23883,2021-07-04
3173051001,JAKARTA BARAT,KEBON JERUK,KEBON JERUK,53296,37932,15364,6786,22150,2021-07-04
3171071006,JAKARTA PUSAT,TANAH ABANG,KEBON KACANG,21376,16027,5349,2627,7976,2021-07-04
3171011005,JAKARTA PUSAT,GAMBIR,KEBON KELAPA,10380,6959,3421,1658,5079,2021-07-04
3171031002,JAKARTA PUSAT,KEMAYORAN,KEBON KOSONG,30003,20694,9309,3464,12773,2021-07-04
3175011005,JAKARTA TIMUR,MATRAMAN,KEBON MANGGIS,16393,10571,5822,2762,8584,2021-07-04
3171071005,JAKARTA PUSAT,TANAH ABANG,KEBON MELATI,31355,24860,6495,2861,9356,2021-07-04
3175081003,JAKARTA TIMUR,MAKASAR,KEBON PALA,46176,32320,13856,6182,20038,2021-07-04
3171061005,JAKARTA PUSAT,MENTENG,KEBON SIRIH,12256,9031,3225,1545,4770,2021-07-04
3173011004,JAKARTA BARAT,CENGKARENG,KEDAUNG KALI ANGKE,32185,19898,12287,3224,15511,2021-07-04
3173051007,JAKARTA BARAT,KEBON JERUK,KEDOYA SELATAN,31907,20653,11254,4609,15863,2021-07-04
3173051006,JAKARTA BARAT,KEBON JERUK,KEDOYA UTARA,43826,26814,17012,6973,23985,2021-07-04
3173051004,JAKARTA BARAT,KEBON JERUK,KELAPA DUA,23293,15539,7754,3136,10890,2021-07-04
3175091003,JAKARTA TIMUR,CIRACAS,KELAPA DUA WETAN,46441,30875,15566,7213,22779,2021-07-04
3172061003,JAKARTA UTARA,KELAPA GADING,KELAPA GADING BARAT,35403,19486,15917,8812,24729,2021-07-04
3172061001,JAKARTA UTARA,KELAPA GADING,KELAPA GADING TIMUR,33472,16431,17041,9124,26165,2021-07-04
3173071005,JAKARTA BARAT,PALMERAH,KEMANGGISAN,31952,20935,11017,5196,16213,2021-07-04
3171031001,JAKARTA PUSAT,KEMAYORAN,KEMAYORAN,20947,13450,7497,2819,10316,2021-07-04
3173081006,JAKARTA BARAT,KEMBANGAN,KEMBANGAN SELATAN,26920,17252,9668,5002,14670,2021-07-04
3173081001,JAKARTA BARAT,KEMBANGAN,KEMBANGAN UTARA,52368,34917,17451,6588,24039,2021-07-04
3171041002,JAKARTA PUSAT,SENEN,KENARI,9317,5575,3742,1740,5482,2021-07-04
3173041005,JAKARTA BARAT,TAMBORA,KERENDANG,19869,14255,5614,2219,7833,2021-07-04
3175071003,JAKARTA TIMUR,DUREN SAWIT,KLENDER,69321,51302,18019,7428,25447,2021-07-04
3172031001,JAKARTA UTARA,KOJA,KOJA,28036,19749,8287,2743,11030,2021-07-04
3173071006,JAKARTA BARAT,PALMERAH,KOTA BAMBU SELATAN,20926,14515,6411,2240,8651,2021-07-04
3173071003,JAKARTA BARAT,PALMERAH,KOTA BAMBU UTARA,24416,17429,6987,2770,9757,2021-07-04
3171041004,JAKARTA PUSAT,SENEN,KRAMAT,28661,20750,7911,2978,10889,2021-07-04
3175041001,JAKARTA TIMUR,KRAMAT JATI,KRAMAT JATI,33851,23262,10589,5005,15594,2021-07-04
3174071003,JAKARTA SELATAN,KEBAYORAN BARU,KRAMAT PELA,14340,8675,5665,2375,8040,2021-07-04
3173031002,JAKARTA BARAT,TAMAN SARI,KRUKUT,19130,12746,6384,2284,8668,2021-07-04
3174031005,JAKARTA SELATAN,MAMPANG PRAPATAN,KUNINGAN BARAT,12675,8221,4454,1545,5999,2021-07-04
3174021008,JAKARTA SELATAN,SETIA BUDI,KUNINGAN TIMUR,5982,3823,2159,1059,3218,2021-07-04
3171041005,JAKARTA PUSAT,SENEN,KWITANG,15295,10012,5283,2094,7377,2021-07-04
3172031003,JAKARTA UTARA,KOJA,LAGOA,58726,42855,15871,5647,21518,2021-07-04
3174061002,JAKARTA SELATAN,CILANDAK,LEBAK BULUS,37213,24751,12462,5870,18332,2021-07-04
3174091004,JAKARTA SELATAN,JAGAKARSA,LENTENG AGUNG,53453,38801,14652,6138,20790,2021-07-04
3175101007,JAKARTA TIMUR,CIPAYUNG,LUBANG BUAYA,62984,42534,20450,8403,28853,2021-07-04
3175081001,JAKARTA TIMUR,MAKASAR,MAKASAR,34062,22128,11934,4961,16895,2021-07-04
3175071006,JAKARTA TIMUR,DUREN SAWIT,MALAKA JAYA,30744,19868,10876,5489,16365,2021-07-04
3175071005,JAKARTA TIMUR,DUREN SAWIT,MALAKA SARI,27015,16931,10084,5422,15506,2021-07-04
3174031001,JAKARTA SELATAN,MAMPANG PRAPATAN,MAMPANG PRAPATAN,18046,12631,5415,2055,7470,2021-07-04
3173031005,JAKARTA BARAT,TAMAN SARI,MANGGA BESAR,7439,4103,3336,1448,4784,2021-07-04
3171021005,JAKARTA PUSAT,SAWAH BESAR,MANGGA DUA SELATAN,27767,18519,9248,3855,13103,2021-07-04
3174011007,JAKARTA SELATAN,TEBET,MANGGARAI,28388,19588,8800,3562,12362,2021-07-04
3174011006,JAKARTA SELATAN,TEBET,MANGGARAI SELATAN,22902,14370,8532,3210,11742,2021-07-04
3173031003,JAKARTA BARAT,TAMAN SARI,MAPHAR,16385,10299,6086,2564,8650,2021-07-04
3172041003,JAKARTA UTARA,CILINCING,MARUNDA,28614,18716,9898,2580,12478,2021-07-04
3174071001,JAKARTA SELATAN,KEBAYORAN BARU,MELAWAI,2634,1344,1290,827,2117,2021-07-04
3171061001,JAKARTA PUSAT,MENTENG,MENTENG,25280,18423,6857,3510,10367,2021-07-04
3174021005,JAKARTA SELATAN,SETIA BUDI,MENTENG ATAS,27671,17684,9987,4025,14012,2021-07-04
3174011003,JAKARTA SELATAN,TEBET,MENTENG DALAM,35936,24384,11552,5176,16728,2021-07-04
3173081003,JAKARTA BARAT,KEMBANGAN,MERUYA SELATAN,31227,20769,10458,4330,14788,2021-07-04
3173081002,JAKARTA BARAT,KEMBANGAN,MERUYA UTARA,43382,28856,14526,6935,21461,2021-07-04
3175101004,JAKARTA TIMUR,CIPAYUNG,MUNJUL,23570,16343,7227,3595,10822,2021-07-04
3172051002,JAKARTA UTARA,PADEMANGAN,PADEMANGAN BARAT,73841,52178,21663,7795,29458,2021-07-04
3172051001,JAKARTA UTARA,PADEMANGAN,PADEMANGAN TIMUR,36757,20929,15828,6889,22717,2021-07-04
3175011004,JAKARTA TIMUR,MATRAMAN,PAL MERIAM,19632,13116,6516,2719,9235,2021-07-04
3173071001,JAKARTA BARAT,PALMERAH,PALMERAH,62175,42062,20113,8000,28113,2021-07-04
3174081001,JAKARTA SELATAN,PANCORAN,PANCORAN,19301,13062,6239,2652,8891,2021-07-04
3172021003,JAKARTA UTARA,TANJUNG PRIOK,PAPANGGO,38871,25780,13091,4696,17787,2021-07-04
3171021001,JAKARTA PUSAT,SAWAH BESAR,PASAR BARU,12710,6873,5837,2913,8750,2021-07-04
3174021006,JAKARTA SELATAN,SETIA BUDI,PASAR MANGGIS,26572,17532,9040,3546,12586,2021-07-04
3174041001,JAKARTA SELATAN,PASAR MINGGU,PASAR MINGGU,24670,16311,8359,4556,12915,2021-07-04
3171041003,JAKARTA PUSAT,SENEN,PASEBAN,23321,15636,7685,3304,10989,2021-07-04
3173061005,JAKARTA BARAT,KALI DERES,PEGADUNGAN,74685,50294,24391,9105,33496,2021-07-04
3171061002,JAKARTA PUSAT,MENTENG,PEGANGSAAN,21120,14526,6594,2938,9532,2021-07-04
3172061002,JAKARTA UTARA,KELAPA GADING,PEGANGSAAN DUA,49632,26638,22994,10489,33483,2021-07-04
3172011004,JAKARTA UTARA,PENJARINGAN,PEJAGALAN,74043,47574,26469,10900,37369,2021-07-04
3174041006,JAKARTA SELATAN,PASAR MINGGU,PEJATEN BARAT,35061,22569,12492,5579,18071,2021-07-04
3174041005,JAKARTA SELATAN,PASAR MINGGU,PEJATEN TIMUR,57257,40451,16806,6029,22835,2021-07-04
3175051005,JAKARTA TIMUR,PASAR REBO,PEKAYON,42705,28477,14228,6045,20273,2021-07-04
3173041009,JAKARTA BARAT,TAMBORA,PEKOJAN,23428,15238,8190,3414,11604,2021-07-04
3174031003,JAKARTA SELATAN,MAMPANG PRAPATAN,PELA MAMPANG,42709,28885,13824,5629,19453,2021-07-04
3174081005,JAKARTA SELATAN,PANCORAN,PENGADEGAN,21111,12350,8761,3324,12085,2021-07-04
3175061003,JAKARTA TIMUR,CAKUNG,PENGGILINGAN,97138,74267,22871,9362,32233,2021-07-04
3172011001,JAKARTA UTARA,PENJARINGAN,PENJARINGAN,86712,61852,24860,7830,32690,2021-07-04
3174101001,JAKARTA SELATAN,PESANGGRAHAN,PESANGGRAHAN,27215,16705,10510,4873,15383,2021-07-04
3171071004,JAKARTA PUSAT,TANAH ABANG,PETAMBURAN,33060,25946,7114,2925,10039,2021-07-04
3174071008,JAKARTA SELATAN,KEBAYORAN BARU,PETOGOGAN,11418,7190,4228,1845,6073,2021-07-04
3171011004,JAKARTA PUSAT,GAMBIR,PETOJO SELATAN,14946,9472,5474,2999,8473,2021-07-04
3171011003,JAKARTA PUSAT,GAMBIR,PETOJO UTARA,17843,12042,5801,2695,8496,2021-07-04
3174101004,JAKARTA SELATAN,PESANGGRAHAN,PETUKANGAN SELATAN,36769,24049,12720,4912,17632,2021-07-04
3174101003,JAKARTA SELATAN,PESANGGRAHAN,PETUKANGAN UTARA,53184,36066,17118,6730,23848,2021-07-04
3175081002,JAKARTA TIMUR,MAKASAR,PINANG RANTI,26915,17759,9156,3449,12605,2021-07-04
3173031008,JAKARTA BARAT,TAMAN SARI,PINANGSIA,10583,6517,4066,1629,5695,2021-07-04
3175011001,JAKARTA TIMUR,MATRAMAN,PISANGAN BARU,31537,23100,8437,3814,12251,2021-07-04
3175021002,JAKARTA TIMUR,PULO GADUNG,PISANGAN TIMUR,40576,27141,13435,5655,19090,2021-07-04
3172011005,JAKARTA UTARA,PENJARINGAN,PLUIT,47433,26206,21227,12306,33533,2021-07-04
3175071002,JAKARTA TIMUR,DUREN SAWIT,PONDOK BAMBU,61047,41114,19933,8870,28803,2021-07-04
3175071004,JAKARTA TIMUR,DUREN SAWIT,PONDOK KELAPA,71347,47699,23648,10961,34609,2021-07-04
3175071007,JAKARTA TIMUR,DUREN SAWIT,PONDOK KOPI,35051,25369,9682,4351,14033,2021-07-04
3174061003,JAKARTA SELATAN,CILANDAK,PONDOK LABU,45944,29898,16046,6859,22905,2021-07-04
3174051002,JAKARTA SELATAN,KEBAYORAN LAMA,PONDOK PINANG,55724,37557,18167,9420,27587,2021-07-04
3175101003,JAKARTA TIMUR,CIPAYUNG,PONDOK RANGGON,25123,17946,7177,3781,10958,2021-07-04
3101011003,KAB.ADM.KEP.SERIBU,KEP. SERIBU UTARA,PULAU HARAPAN,2036,714,1322,670,1992,2021-07-04
3101011002,KAB.ADM.KEP.SERIBU,KEP. SERIBU UTARA,PULAU KELAPA,5460,2063,3397,1082,4479,2021-07-04
3101011001,KAB.ADM.KEP.SERIBU,KEP. SERIBU UTARA,PULAU PANGGANG,5395,1934,3461,1140,4601,2021-07-04
3101021003,KAB.ADM.KEP.SERIBU,KEP. SERIBU SELATAN,PULAU PARI,2736,791,1945,613,2558,2021-07-04
3101021002,KAB.ADM.KEP.SERIBU,KEP. SERIBU SELATAN,PULAU TIDUNG,4528,1564,2964,1133,4097,2021-07-04
3101021001,KAB.ADM.KEP.SERIBU,KEP. SERIBU SELATAN,PULAU UNTUNG JAWA,1918,613,1305,558,1863,2021-07-04
3174071007,JAKARTA SELATAN,KEBAYORAN BARU,PULO,5777,3206,2571,1346,3917,2021-07-04
3175021001,JAKARTA TIMUR,PULO GADUNG,PULO GADUNG,34175,23827,10348,4653,15001,2021-07-04
3175061005,JAKARTA TIMUR,CAKUNG,PULO GEBANG,95947,70097,25850,10643,36493,2021-07-04
3174041004,JAKARTA SELATAN,PASAR MINGGU,RAGUNAN,39233,24901,14332,5808,20140,2021-07-04
3175091005,JAKARTA TIMUR,CIRACAS,RAMBUTAN,36368,27319,9049,4286,13335,2021-07-04
3172031006,JAKARTA UTARA,KOJA,RAWA BADAK SELATAN,41895,31210,10685,3940,14625,2021-07-04
3172031004,JAKARTA UTARA,KOJA,RAWA BADAK UTARA,33538,22556,10982,3856,14838,2021-07-04
3174071005,JAKARTA SELATAN,KEBAYORAN BARU,RAWA BARAT,5574,3275,2299,1324,3623,2021-07-04
3173011003,JAKARTA BARAT,CENGKARENG,RAWA BUAYA,59533,40522,19011,5994,25005,2021-07-04
3175031004,JAKARTA TIMUR,JATINEGARA,RAWA BUNGA,21272,15772,5500,2467,7967,2021-07-04
3174081003,JAKARTA SELATAN,PANCORAN,RAWA JATI,20321,12950,7371,3420,10791,2021-07-04
3175061002,JAKARTA TIMUR,CAKUNG,RAWA TERATE,24433,16068,8365,2106,10471,2021-07-04
3175021005,JAKARTA TIMUR,PULO GADUNG,RAWAMANGUN,36788,24582,12206,5843,18049,2021-07-04
3171051003,JAKARTA PUSAT,CEMPAKA PUTIH,RAWASARI,21770,14380,7390,3483,10873,2021-07-04
3173041010,JAKARTA BARAT,TAMBORA,ROA MALAKA,3449,1805,1644,881,2525,2021-07-04
3172041006,JAKARTA UTARA,CILINCING,ROROTAN,40953,27472,13481,4597,18078,2021-07-04
3174071004,JAKARTA SELATAN,KEBAYORAN BARU,SELONG,2843,1501,1342,881,2223,2021-07-04
3173061002,JAKARTA BARAT,KALI DERES,SEMANAN,70293,52865,17428,4980,22408,2021-07-04
3172041007,JAKARTA UTARA,CILINCING,SEMPER BARAT,67899,43915,23984,9082,33066,2021-07-04
3172041005,JAKARTA UTARA,CILINCING,SEMPER TIMUR,36029,24265,11764,4310,16074,2021-07-04
3174071006,JAKARTA SELATAN,KEBAYORAN BARU,SENAYAN,2780,1817,963,571,1534,2021-07-04
3171041001,JAKARTA PUSAT,SENEN,SENEN,6757,4310,2447,1181,3628,2021-07-04
3171031004,JAKARTA PUSAT,KEMAYORAN,SERDANG,29730,19829,9901,3941,13842,2021-07-04
3174021001,JAKARTA SELATAN,SETIA BUDI,SETIA BUDI,2841,1714,1127,643,1770,2021-07-04
3175101005,JAKARTA TIMUR,CIPAYUNG,SETU,20306,14869,5437,2668,8105,2021-07-04
3173071002,JAKARTA BARAT,PALMERAH,SLIPI,16475,10490,5985,2723,8708,2021-07-04
3173081004,JAKARTA BARAT,KEMBANGAN,SRENGSENG,44969,31956,13013,6164,19177,2021-07-04
3174091002,JAKARTA SELATAN,JAGAKARSA,SRENGSENG SAWAH,57480,34968,22512,8892,31404,2021-07-04
3173051003,JAKARTA BARAT,KEBON JERUK,SUKABUMI SELATAN,35170,25331,9839,3473,13312,2021-07-04
3173051002,JAKARTA BARAT,KEBON JERUK,SUKABUMI UTARA,37628,27884,9744,4007,13751,2021-07-04
3172041002,JAKARTA UTARA,CILINCING,SUKAPURA,53786,37629,16157,5452,21609,2021-07-04
3171031007,JAKARTA PUSAT,KEMAYORAN,SUMUR BATU,22506,14533,7973,3399,11372,2021-07-04
3172021004,JAKARTA UTARA,TANJUNG PRIOK,SUNGAI BAMBU,29115,18628,10487,3535,14022,2021-07-04
3172021006,JAKARTA UTARA,TANJUNG PRIOK,SUNTER AGUNG,70860,41270,29590,13497,43087,2021-07-04
3172021002,JAKARTA UTARA,TANJUNG PRIOK,SUNTER JAYA,62516,39284,23232,10465,33697,2021-07-04
3175091004,JAKARTA TIMUR,CIRACAS,SUSUKAN,33525,22657,10868,4602,15470,2021-07-04
3173031001,JAKARTA BARAT,TAMAN SARI,TAMAN SARI,14281,9001,5280,2390,7670,2021-07-04
3173041001,JAKARTA BARAT,TAMBORA,TAMBORA,10177,6732,3445,1516,4961,2021-07-04
3173041004,JAKARTA BARAT,TAMBORA,TANAH SEREAL,25944,15975,9969,3881,13850,2021-07-04
3171081004,JAKARTA PUSAT,JOHAR BARU,TANAH TINGGI,37800,24697,13103,4253,17356,2021-07-04
3173031004,JAKARTA BARAT,TAMAN SARI,TANGKI,12991,8206,4785,1927,6712,2021-07-04
3174091005,JAKARTA SELATAN,JAGAKARSA,TANJUNG BARAT,39368,27537,11831,5677,17508,2021-07-04
3173021005,JAKARTA BARAT,GROGOL PETAMBURAN,TANJUNG DUREN SELATAN,24917,14275,10642,4468,15110,2021-07-04
3173021002,JAKARTA BARAT,GROGOL PETAMBURAN,TANJUNG DUREN UTARA,16940,9329,7611,3530,11141,2021-07-04
3172021001,JAKARTA UTARA,TANJUNG PRIOK,TANJUNG PRIOK,34316,21731,12585,3832,16417,2021-07-04
3174011002,JAKARTA SELATAN,TEBET,TEBET BARAT,21164,12909,8255,4198,12453,2021-07-04
3174011001,JAKARTA SELATAN,TEBET,TEBET TIMUR,18030,10346,7684,3745,11429,2021-07-04
3173061003,JAKARTA BARAT,KALI DERES,TEGAL ALUR,82647,59544,23103,6853,29956,2021-07-04
3174031004,JAKARTA SELATAN,MAMPANG PRAPATAN,TEGAL PARANG,32174,24097,8077,3309,11386,2021-07-04
3173021003,JAKARTA BARAT,GROGOL PETAMBURAN,TOMANG,28665,17590,11075,4981,16056,2021-07-04
3172031005,JAKARTA UTARA,KOJA,TUGU SELATAN,38749,28341,10408,3822,14230,2021-07-04
3172031002,JAKARTA UTARA,KOJA,TUGU UTARA,67211,49414,17797,6745,24542,2021-07-04
3175061006,JAKARTA TIMUR,CAKUNG,UJUNG MENTENG,29527,19943,9584,3982,13566,2021-07-04
3174101005,JAKARTA SELATAN,PESANGGRAHAN,ULUJAMI,40120,28779,11341,4937,16278,2021-07-04
3175011006,JAKARTA TIMUR,MATRAMAN,UTAN KAYU SELATAN,33233,21787,11446,5051,16497,2021-07-04
3175011002,JAKARTA TIMUR,MATRAMAN,UTAN KAYU UTARA,27995,18478,9517,3823,13340,2021-07-04
3171031008,JAKARTA PUSAT,KEMAYORAN,UTAN PANJANG,29260,21615,7645,2800,10445,2021-07-04
3172021007,JAKARTA UTARA,TANJUNG PRIOK,WARAKAS,43754,29223,14531,5212,19743,2021-07-04
3173021007,JAKARTA BARAT,GROGOL PETAMBURAN,WIJAYA KUSUMA,38584,26211,12373,4858,17231,2021-07-04
3172051003,JAKARTA UTARA,PADEMANGAN,ANCOL,23379,15856,7523,3299,10822,2021-07-05
3173041007,JAKARTA BARAT,TAMBORA,ANGKE,29230,19213,10017,3237,13254,2021-07-05
3175041005,JAKARTA TIMUR,KRAMAT JATI,BALE KAMBANG,28803,22108,6695,2663,9358,2021-07-05
3175031003,JAKARTA TIMUR,JATINEGARA,BALI MESTER,9675,6570,3105,1525,4630,2021-07-05
3175101006,JAKARTA TIMUR,CIPAYUNG,BAMBU APUS,25985,18185,7800,4002,11802,2021-07-05
3174031002,JAKARTA SELATAN,MAMPANG PRAPATAN,BANGKA,21356,14559,6797,2722,9519,2021-07-05
3175051002,JAKARTA TIMUR,PASAR REBO,BARU,23514,14248,9266,4693,13959,2021-07-05
3175041004,JAKARTA TIMUR,KRAMAT JATI,BATU AMPAR,47416,35724,11692,5287,16979,2021-07-05
3171071002,JAKARTA PUSAT,TANAH ABANG,BENDUNGAN HILIR,21374,13474,7900,3594,11494,2021-07-05
3175031002,JAKARTA TIMUR,JATINEGARA,BIDARA CINA,36461,26945,9516,4051,13567,2021-07-05
3174101002,JAKARTA SELATAN,PESANGGRAHAN,BINTARO,52402,36789,15613,7108,22721,2021-07-05
3174011005,JAKARTA SELATAN,TEBET,BUKIT DURI,33953,23781,10172,3976,14148,2021-07-05
3171041006,JAKARTA PUSAT,SENEN,BUNGUR,17929,11642,6287,2749,9036,2021-07-05
3175061007,JAKARTA TIMUR,CAKUNG,CAKUNG BARAT,57222,39815,17407,4032,21439,2021-07-05
3175061004,JAKARTA TIMUR,CAKUNG,CAKUNG TIMUR,57655,39632,18023,6437,24460,2021-07-05
3175041007,JAKARTA TIMUR,KRAMAT JATI,CAWANG,32481,22829,9652,4296,13948,2021-07-05
3175101008,JAKARTA TIMUR,CIPAYUNG,CEGER,18740,12806,5934,2577,8511,2021-07-05
3171031006,JAKARTA PUSAT,KEMAYORAN,CEMPAKA BARU,31257,21811,9446,4025,13471,2021-07-05
3171051002,JAKARTA PUSAT,CEMPAKA PUTIH,CEMPAKA PUTIH BARAT,34725,24508,10217,4986,15203,2021-07-05
3171051001,JAKARTA PUSAT,CEMPAKA PUTIH,CEMPAKA PUTIH TIMUR,24170,15413,8757,4468,13225,2021-07-05
3173011001,JAKARTA BARAT,CENGKARENG,CENGKARENG BARAT,65702,41381,24321,8255,32576,2021-07-05
3173011006,JAKARTA BARAT,CENGKARENG,CENGKARENG TIMUR,80100,54090,26010,8544,34554,2021-07-05
3175091002,JAKARTA TIMUR,CIRACAS,CIBUBUR,65231,43304,21927,9482,31409,2021-07-05
3171011002,JAKARTA PUSAT,GAMBIR,CIDENG,15696,9328,6368,3190,9558,2021-07-05
3174091003,JAKARTA SELATAN,JAGAKARSA,CIGANJUR,38048,25854,12194,5184,17378,2021-07-05
3175051003,JAKARTA TIMUR,PASAR REBO,CIJANTUNG,41013,27284,13729,6215,19944,2021-07-05
3171061003,JAKARTA PUSAT,MENTENG,CIKINI,8260,5534,2726,1372,4098,2021-07-05
3174081006,JAKARTA SELATAN,PANCORAN,CIKOKO,10503,6457,4046,1753,5799,2021-07-05
3174061001,JAKARTA SELATAN,CILANDAK,CILANDAK BARAT,51346,31769,19577,7917,27494,2021-07-05
3174041003,JAKARTA SELATAN,PASAR MINGGU,CILANDAK TIMUR,24239,15171,9068,4861,13929,2021-07-05
3175101002,JAKARTA TIMUR,CIPAYUNG,CILANGKAP,27179,18695,8484,3825,12309,2021-07-05
3175041006,JAKARTA TIMUR,KRAMAT JATI,CILILITAN,39984,28740,11244,5259,16503,2021-07-05
3172041001,JAKARTA UTARA,CILINCING,CILINCING,42677,31257,11420,3944,15364,2021-07-05
3175101001,JAKARTA TIMUR,CIPAYUNG,CIPAYUNG,25747,16596,9151,4252,13403,2021-07-05
3174091006,JAKARTA SELATAN,JAGAKARSA,CIPEDAK,37809,25228,12581,4819,17400,2021-07-05
3174061005,JAKARTA SELATAN,CILANDAK,CIPETE SELATAN,26500,17395,9105,3824,12929,2021-07-05
3174071010,JAKARTA SELATAN,KEBAYORAN BARU,CIPETE UTARA,33902,21704,12198,4106,16304,2021-07-05
3175021003,JAKARTA TIMUR,PULO GADUNG,CIPINANG,39069,26315,12754,6053,18807,2021-07-05
3175031007,JAKARTA TIMUR,JATINEGARA,CIPINANG BESAR SELATAN,34938,26127,8811,3917,12728,2021-07-05
3175031008,JAKARTA TIMUR,JATINEGARA,CIPINANG BESAR UTARA,44479,34903,9576,4206,13782,2021-07-05
3175031005,JAKARTA TIMUR,JATINEGARA,CIPINANG CEMPEDAK,32695,23053,9642,4714,14356,2021-07-05
3175081005,JAKARTA TIMUR,MAKASAR,CIPINANG MELAYU,42144,27956,14188,6420,20608,2021-07-05
3175031006,JAKARTA TIMUR,JATINEGARA,CIPINANG MUARA,53251,38672,14579,7324,21903,2021-07-05
3174051003,JAKARTA SELATAN,KEBAYORAN LAMA,CIPULIR,39635,27730,11905,4812,16717,2021-07-05
3175091001,JAKARTA TIMUR,CIRACAS,CIRACAS,63801,42792,21009,8420,29429,2021-07-05
3175041003,JAKARTA TIMUR,KRAMAT JATI,DUKUH,24404,17199,7205,3518,10723,2021-07-05
3175071001,JAKARTA TIMUR,DUREN SAWIT,DUREN SAWIT,60443,41377,19066,9263,28329,2021-07-05
3174081004,JAKARTA SELATAN,PANCORAN,DUREN TIGA,28099,18720,9379,3834,13213,2021-07-05
3173051005,JAKARTA BARAT,KEBON JERUK,DURI KEPA,59448,36542,22906,9984,32890,2021-07-05
3173011002,JAKARTA BARAT,CENGKARENG,DURI KOSAMBI,75895,51392,24503,8225,32728,2021-07-05
3171011006,JAKARTA PUSAT,GAMBIR,DURI PULO,19986,14123,5863,2391,8254,2021-07-05
3173041011,JAKARTA BARAT,TAMBORA,DURI SELATAN,14099,9047,5052,2367,7419,2021-07-05
3173041003,JAKARTA BARAT,TAMBORA,DURI UTARA,19768,13459,6309,2641,8950,2021-07-05
3171081003,JAKARTA PUSAT,JOHAR BARU,GALUR,18098,11222,6876,1973,8849,2021-07-05
3171011001,JAKARTA PUSAT,GAMBIR,GAMBIR,2434,1406,1028,580,1608,2021-07-05
3174061004,JAKARTA SELATAN,CILANDAK,GANDARIA SELATAN,21926,14149,7777,2845,10622,2021-07-05
3174071009,JAKARTA SELATAN,KEBAYORAN BARU,GANDARIA UTARA,39609,26082,13527,5375,18902,2021-07-05
3175051001,JAKARTA TIMUR,PASAR REBO,GEDONG,35444,24394,11050,5301,16351,2021-07-05
3171071001,JAKARTA PUSAT,TANAH ABANG,GELORA,3106,2005,1101,569,1670,2021-07-05
3173031007,JAKARTA BARAT,TAMAN SARI,GLODOK,7836,3899,3937,1977,5914,2021-07-05
3171061004,JAKARTA PUSAT,MENTENG,GONDANGDIA,4093,2144,1949,1294,3243,2021-07-05
3173021001,JAKARTA BARAT,GROGOL PETAMBURAN,GROGOL,16815,10954,5861,2607,8468,2021-07-05
3174051005,JAKARTA SELATAN,KEBAYORAN LAMA,GROGOL SELATAN,43915,31079,12836,5469,18305,2021-07-05
3174051004,JAKARTA SELATAN,KEBAYORAN LAMA,GROGOL UTARA,42216,29642,12574,5858,18432,2021-07-05
3174021007,JAKARTA SELATAN,SETIA BUDI,GUNTUR,3962,2232,1730,990,2720,2021-07-05
3174071002,JAKARTA SELATAN,KEBAYORAN BARU,GUNUNG,9344,5621,3723,2035,5758,2021-07-05
3171031005,JAKARTA PUSAT,KEMAYORAN,GUNUNG SAHARI SELATAN,19380,12634,6746,2823,9569,2021-07-05
3171021004,JAKARTA PUSAT,SAWAH BESAR,GUNUNG SAHARI UTARA,15647,8573,7074,3376,10450,2021-07-05
3175081004,JAKARTA TIMUR,MAKASAR,HALIM PERDANA KUSUMAH,28110,14255,13855,9313,23168,2021-07-05
3171031003,JAKARTA PUSAT,KEMAYORAN,HARAPAN MULIA,22700,15957,6743,2702,9445,2021-07-05
3174091001,JAKARTA SELATAN,JAGAKARSA,JAGAKARSA,61552,39598,21954,8533,30487,2021-07-05
3175021007,JAKARTA TIMUR,PULO GADUNG,JATI,32443,21532,10911,5612,16523,2021-07-05
3174041002,JAKARTA SELATAN,PASAR MINGGU,JATI PADANG,37250,24600,12650,5863,18513,2021-07-05
3173071004,JAKARTA BARAT,PALMERAH,JATI PULO,27994,17261,10733,3651,14384,2021-07-05
3175061001,JAKARTA TIMUR,CAKUNG,JATINEGARA,83563,64291,19272,6766,26038,2021-07-05
3175021004,JAKARTA TIMUR,PULO GADUNG,JATINEGARA KAUM,24364,17129,7235,2936,10171,2021-07-05
3173021004,JAKARTA BARAT,GROGOL PETAMBURAN,JELAMBAR,30180,18481,11699,5479,17178,2021-07-05
3173021006,JAKARTA BARAT,GROGOL PETAMBURAN,JELAMBAR BARU,37799,24042,13757,6078,19835,2021-07-05
3173041006,JAKARTA BARAT,TAMBORA,JEMBATAN BESI,29182,22610,6572,2430,9002,2021-07-05
3173041008,JAKARTA BARAT,TAMBORA,JEMBATAN LIMA,20627,14913,5714,2267,7981,2021-07-05
3173081005,JAKARTA BARAT,KEMBANGAN,JOGLO,40475,27265,13210,5950,19160,2021-07-05
3171081001,JAKARTA PUSAT,JOHAR BARU,JOHAR BARU,32845,19324,13521,5342,18863,2021-07-05
3173041002,JAKARTA BARAT,TAMBORA,KALI ANYAR,23582,17844,5738,2236,7974,2021-07-05
3172041004,JAKARTA UTARA,CILINCING,KALIBARU,67165,52048,15117,4351,19468,2021-07-05
3174081002,JAKARTA SELATAN,PANCORAN,KALIBATA,41464,29474,11990,4926,16916,2021-07-05
3173061001,JAKARTA BARAT,KALI DERES,KALIDERES,69014,47770,21244,7596,28840,2021-07-05
3175051004,JAKARTA TIMUR,PASAR REBO,KALISARI,42557,28409,14148,6769,20917,2021-07-05
3173061004,JAKARTA BARAT,KALI DERES,KAMAL,53180,41049,12131,3658,15789,2021-07-05
3172011002,JAKARTA UTARA,PENJARINGAN,KAMAL MUARA,12679,6977,5702,2502,8204,2021-07-05
3171071007,JAKARTA PUSAT,TANAH ABANG,KAMPUNG BALI,11551,8368,3183,1511,4694,2021-07-05
3175031001,JAKARTA TIMUR,JATINEGARA,KAMPUNG MELAYU,25476,19511,5965,2244,8209,2021-07-05
3171081002,JAKARTA PUSAT,JOHAR BARU,KAMPUNG RAWA,18247,9741,8506,2546,11052,2021-07-05
3175041002,JAKARTA TIMUR,KRAMAT JATI,KAMPUNG TENGAH,43668,32261,11407,5260,16667,2021-07-05
3173011005,JAKARTA BARAT,CENGKARENG,KAPUK,121994,88422,33572,9501,43073,2021-07-05
3172011003,JAKARTA UTARA,PENJARINGAN,KAPUK MUARA,35498,21662,13836,6650,20486,2021-07-05
3171021002,JAKARTA PUSAT,SAWAH BESAR,KARANG ANYAR,25865,17291,8574,3404,11978,2021-07-05
3174021004,JAKARTA SELATAN,SETIA BUDI,KARET,9581,5967,3614,1436,5050,2021-07-05
3174021003,JAKARTA SELATAN,SETIA BUDI,KARET KUNINGAN,15939,9855,6084,2330,8414,2021-07-05
3174021002,JAKARTA SELATAN,SETIA BUDI,KARET SEMANGGI,2746,1466,1280,602,1882,2021-07-05
3171071003,JAKARTA PUSAT,TANAH ABANG,KARET TENGSIN,19113,13211,5902,2208,8110,2021-07-05
3171021003,JAKARTA PUSAT,SAWAH BESAR,KARTINI,22303,14178,8125,3454,11579,2021-07-05
3175011003,JAKARTA TIMUR,MATRAMAN,KAYU MANIS,25138,17731,7407,3014,10421,2021-07-05
3175021006,JAKARTA TIMUR,PULO GADUNG,KAYU PUTIH,40378,25431,14947,7063,22010,2021-07-05
3173031006,JAKARTA BARAT,TAMAN SARI,KEAGUNGAN,17231,11368,5863,1998,7861,2021-07-05
3174041007,JAKARTA SELATAN,PASAR MINGGU,KEBAGUSAN,44010,30729,13281,5189,18470,2021-07-05
3174051006,JAKARTA SELATAN,KEBAYORAN LAMA,KEBAYORAN LAMA SELATAN,40895,26148,14747,5800,20547,2021-07-05
3174051001,JAKARTA SELATAN,KEBAYORAN LAMA,KEBAYORAN LAMA UTARA,42214,29606,12608,5252,17860,2021-07-05
3174011004,JAKARTA SELATAN,TEBET,KEBON BARU,34878,23317,11561,5132,16693,2021-07-05
3172021005,JAKARTA UTARA,TANJUNG PRIOK,KEBON BAWANG,50597,33590,17007,6928,23935,2021-07-05
3173051001,JAKARTA BARAT,KEBON JERUK,KEBON JERUK,53296,37856,15440,6790,22230,2021-07-05
3171071006,JAKARTA PUSAT,TANAH ABANG,KEBON KACANG,21376,16002,5374,2627,8001,2021-07-05
3171011005,JAKARTA PUSAT,GAMBIR,KEBON KELAPA,10380,6931,3449,1658,5107,2021-07-05
3171031002,JAKARTA PUSAT,KEMAYORAN,KEBON KOSONG,30003,20653,9350,3464,12814,2021-07-05
3175011005,JAKARTA TIMUR,MATRAMAN,KEBON MANGGIS,16393,10563,5830,2762,8592,2021-07-05
3171071005,JAKARTA PUSAT,TANAH ABANG,KEBON MELATI,31355,24833,6522,2861,9383,2021-07-05
3175081003,JAKARTA TIMUR,MAKASAR,KEBON PALA,46176,32263,13913,6184,20097,2021-07-05
3171061005,JAKARTA PUSAT,MENTENG,KEBON SIRIH,12256,9003,3253,1545,4798,2021-07-05
3173011004,JAKARTA BARAT,CENGKARENG,KEDAUNG KALI ANGKE,32185,19870,12315,3224,15539,2021-07-05
3173051007,JAKARTA BARAT,KEBON JERUK,KEDOYA SELATAN,31907,20607,11300,4609,15909,2021-07-05
3173051006,JAKARTA BARAT,KEBON JERUK,KEDOYA UTARA,43826,26755,17071,6973,24044,2021-07-05
3173051004,JAKARTA BARAT,KEBON JERUK,KELAPA DUA,23293,15513,7780,3137,10917,2021-07-05
3175091003,JAKARTA TIMUR,CIRACAS,KELAPA DUA WETAN,46441,30801,15640,7216,22856,2021-07-05
3172061003,JAKARTA UTARA,KELAPA GADING,KELAPA GADING BARAT,35403,19446,15957,8812,24769,2021-07-05
3172061001,JAKARTA UTARA,KELAPA GADING,KELAPA GADING TIMUR,33472,16384,17088,9125,26213,2021-07-05
3173071005,JAKARTA BARAT,PALMERAH,KEMANGGISAN,31952,20892,11060,5196,16256,2021-07-05
3171031001,JAKARTA PUSAT,KEMAYORAN,KEMAYORAN,20947,13418,7529,2819,10348,2021-07-05
3173081006,JAKARTA BARAT,KEMBANGAN,KEMBANGAN SELATAN,26920,17171,9749,5002,14751,2021-07-05
3173081001,JAKARTA BARAT,KEMBANGAN,KEMBANGAN UTARA,52368,34817,17551,6590,24141,2021-07-05
3171041002,JAKARTA PUSAT,SENEN,KENARI,9317,5566,3751,1740,5491,2021-07-05
3173041005,JAKARTA BARAT,TAMBORA,KERENDANG,19869,14232,5637,2220,7857,2021-07-05
3175071003,JAKARTA TIMUR,DUREN SAWIT,KLENDER,69321,51237,18084,7428,25512,2021-07-05
3172031001,JAKARTA UTARA,KOJA,KOJA,28036,19732,8304,2744,11048,2021-07-05
3173071006,JAKARTA BARAT,PALMERAH,KOTA BAMBU SELATAN,20926,14505,6421,2240,8661,2021-07-05
3173071003,JAKARTA BARAT,PALMERAH,KOTA BAMBU UTARA,24416,17408,7008,2770,9778,2021-07-05
3171041004,JAKARTA PUSAT,SENEN,KRAMAT,28661,20728,7933,2981,10914,2021-07-05
3175041001,JAKARTA TIMUR,KRAMAT JATI,KRAMAT JATI,33851,23199,10652,5005,15657,2021-07-05
3174071003,JAKARTA SELATAN,KEBAYORAN BARU,KRAMAT PELA,14340,8648,5692,2377,8069,2021-07-05
3173031002,JAKARTA BARAT,TAMAN SARI,KRUKUT,19130,12724,6406,2284,8690,2021-07-05
3174031005,JAKARTA SELATAN,MAMPANG PRAPATAN,KUNINGAN BARAT,12675,8217,4458,1546,6004,2021-07-05
3174021008,JAKARTA SELATAN,SETIA BUDI,KUNINGAN TIMUR,5982,3818,2164,1059,3223,2021-07-05
3171041005,JAKARTA PUSAT,SENEN,KWITANG,15295,9994,5301,2095,7396,2021-07-05
3172031003,JAKARTA UTARA,KOJA,LAGOA,58726,42822,15904,5652,21556,2021-07-05
3174061002,JAKARTA SELATAN,CILANDAK,LEBAK BULUS,37213,24710,12503,5872,18375,2021-07-05
3174091004,JAKARTA SELATAN,JAGAKARSA,LENTENG AGUNG,53453,38743,14710,6140,20850,2021-07-05
3175101007,JAKARTA TIMUR,CIPAYUNG,LUBANG BUAYA,62984,42491,20493,8404,28897,2021-07-05
3175081001,JAKARTA TIMUR,MAKASAR,MAKASAR,34062,22105,11957,4961,16918,2021-07-05
3175071006,JAKARTA TIMUR,DUREN SAWIT,MALAKA JAYA,30744,19846,10898,5490,16388,2021-07-05
3175071005,JAKARTA TIMUR,DUREN SAWIT,MALAKA SARI,27015,16897,10118,5422,15540,2021-07-05
3174031001,JAKARTA SELATAN,MAMPANG PRAPATAN,MAMPANG PRAPATAN,18046,12616,5430,2055,7485,2021-07-05
3173031005,JAKARTA BARAT,TAMAN SARI,MANGGA BESAR,7439,4093,3346,1448,4794,2021-07-05
3171021005,JAKARTA PUSAT,SAWAH BESAR,MANGGA DUA SELATAN,27767,18475,9292,3855,13147,2021-07-05
3174011007,JAKARTA SELATAN,TEBET,MANGGARAI,28388,19564,8824,3562,12386,2021-07-05
3174011006,JAKARTA SELATAN,TEBET,MANGGARAI SELATAN,22902,14346,8556,3212,11768,2021-07-05
3173031003,JAKARTA BARAT,TAMAN SARI,MAPHAR,16385,10273,6112,2565,8677,2021-07-05
3172041003,JAKARTA UTARA,CILINCING,MARUNDA,28614,18703,9911,2580,12491,2021-07-05
3174071001,JAKARTA SELATAN,KEBAYORAN BARU,MELAWAI,2634,1339,1295,827,2122,2021-07-05
3171061001,JAKARTA PUSAT,MENTENG,MENTENG,25280,18394,6886,3511,10397,2021-07-05
3174021005,JAKARTA SELATAN,SETIA BUDI,MENTENG ATAS,27671,17652,10019,4027,14046,2021-07-05
3174011003,JAKARTA SELATAN,TEBET,MENTENG DALAM,35936,24351,11585,5177,16762,2021-07-05
3173081003,JAKARTA BARAT,KEMBANGAN,MERUYA SELATAN,31227,20719,10508,4330,14838,2021-07-05
3173081002,JAKARTA BARAT,KEMBANGAN,MERUYA UTARA,43382,28736,14646,6937,21583,2021-07-05
3175101004,JAKARTA TIMUR,CIPAYUNG,MUNJUL,23570,16289,7281,3595,10876,2021-07-05
3172051002,JAKARTA UTARA,PADEMANGAN,PADEMANGAN BARAT,73841,51814,22027,7795,29822,2021-07-05
3172051001,JAKARTA UTARA,PADEMANGAN,PADEMANGAN TIMUR,36757,20825,15932,6891,22823,2021-07-05
3175011004,JAKARTA TIMUR,MATRAMAN,PAL MERIAM,19632,13107,6525,2719,9244,2021-07-05
3173071001,JAKARTA BARAT,PALMERAH,PALMERAH,62175,42006,20169,8000,28169,2021-07-05
3174081001,JAKARTA SELATAN,PANCORAN,PANCORAN,19301,13056,6245,2652,8897,2021-07-05
3172021003,JAKARTA UTARA,TANJUNG PRIOK,PAPANGGO,38871,25735,13136,4704,17840,2021-07-05
3171021001,JAKARTA PUSAT,SAWAH BESAR,PASAR BARU,12710,6856,5854,2913,8767,2021-07-05
3174021006,JAKARTA SELATAN,SETIA BUDI,PASAR MANGGIS,26572,17518,9054,3547,12601,2021-07-05
3174041001,JAKARTA SELATAN,PASAR MINGGU,PASAR MINGGU,24670,16290,8380,4556,12936,2021-07-05
3171041003,JAKARTA PUSAT,SENEN,PASEBAN,23321,15608,7713,3304,11017,2021-07-05
3173061005,JAKARTA BARAT,KALI DERES,PEGADUNGAN,74685,50210,24475,9107,33582,2021-07-05
3171061002,JAKARTA PUSAT,MENTENG,PEGANGSAAN,21120,14505,6615,2939,9554,2021-07-05
3172061002,JAKARTA UTARA,KELAPA GADING,PEGANGSAAN DUA,49632,26581,23051,10490,33541,2021-07-05
3172011004,JAKARTA UTARA,PENJARINGAN,PEJAGALAN,74043,47390,26653,10901,37554,2021-07-05
3174041006,JAKARTA SELATAN,PASAR MINGGU,PEJATEN BARAT,35061,22534,12527,5579,18106,2021-07-05
3174041005,JAKARTA SELATAN,PASAR MINGGU,PEJATEN TIMUR,57257,40416,16841,6029,22870,2021-07-05
3175051005,JAKARTA TIMUR,PASAR REBO,PEKAYON,42705,28408,14297,6046,20343,2021-07-05
3173041009,JAKARTA BARAT,TAMBORA,PEKOJAN,23428,15214,8214,3414,11628,2021-07-05
3174031003,JAKARTA SELATAN,MAMPANG PRAPATAN,PELA MAMPANG,42709,28835,13874,5629,19503,2021-07-05
3174081005,JAKARTA SELATAN,PANCORAN,PENGADEGAN,21111,12339,8772,3324,12096,2021-07-05
3175061003,JAKARTA TIMUR,CAKUNG,PENGGILINGAN,97138,74203,22935,9364,32299,2021-07-05
3172011001,JAKARTA UTARA,PENJARINGAN,PENJARINGAN,86712,61679,25033,7832,32865,2021-07-05
3174101001,JAKARTA SELATAN,PESANGGRAHAN,PESANGGRAHAN,27215,16672,10543,4875,15418,2021-07-05
3171071004,JAKARTA PUSAT,TANAH ABANG,PETAMBURAN,33060,25908,7152,2925,10077,2021-07-05
3174071008,JAKARTA SELATAN,KEBAYORAN BARU,PETOGOGAN,11418,7179,4239,1848,6087,2021-07-05
3171011004,JAKARTA PUSAT,GAMBIR,PETOJO SELATAN,14946,9460,5486,3001,8487,2021-07-05
3171011003,JAKARTA PUSAT,GAMBIR,PETOJO UTARA,17843,12015,5828,2695,8523,2021-07-05
3174101004,JAKARTA SELATAN,PESANGGRAHAN,PETUKANGAN SELATAN,36769,24015,12754,4913,17667,2021-07-05
3174101003,JAKARTA SELATAN,PESANGGRAHAN,PETUKANGAN UTARA,53184,36018,17166,6731,23897,2021-07-05
3175081002,JAKARTA TIMUR,MAKASAR,PINANG RANTI,26915,17740,9175,3451,12626,2021-07-05
3173031008,JAKARTA BARAT,TAMAN SARI,PINANGSIA,10583,6491,4092,1629,5721,2021-07-05
3175011001,JAKARTA TIMUR,MATRAMAN,PISANGAN BARU,31537,23065,8472,3816,12288,2021-07-05
3175021002,JAKARTA TIMUR,PULO GADUNG,PISANGAN TIMUR,40576,27110,13466,5656,19122,2021-07-05
3172011005,JAKARTA UTARA,PENJARINGAN,PLUIT,47433,26143,21290,12306,33596,2021-07-05
3175071002,JAKARTA TIMUR,DUREN SAWIT,PONDOK BAMBU,61047,41055,19992,8872,28864,2021-07-05
3175071004,JAKARTA TIMUR,DUREN SAWIT,PONDOK KELAPA,71347,47627,23720,10967,34687,2021-07-05
3175071007,JAKARTA TIMUR,DUREN SAWIT,PONDOK KOPI,35051,25336,9715,4351,14066,2021-07-05
3174061003,JAKARTA SELATAN,CILANDAK,PONDOK LABU,45944,29857,16087,6859,22946,2021-07-05
3174051002,JAKARTA SELATAN,KEBAYORAN LAMA,PONDOK PINANG,55724,37251,18473,9424,27897,2021-07-05
3175101003,JAKARTA TIMUR,CIPAYUNG,PONDOK RANGGON,25123,17807,7316,3782,11098,2021-07-05
3101011003,KAB.ADM.KEP.SERIBU,KEP. SERIBU UTARA,PULAU HARAPAN,2036,714,1322,670,1992,2021-07-05
3101011002,KAB.ADM.KEP.SERIBU,KEP. SERIBU UTARA,PULAU KELAPA,5460,2061,3399,1082,4481,2021-07-05
3101011001,KAB.ADM.KEP.SERIBU,KEP. SERIBU UTARA,PULAU PANGGANG,5395,1933,3462,1140,4602,2021-07-05
3101021003,KAB.ADM.KEP.SERIBU,KEP. SERIBU SELATAN,PULAU PARI,2736,791,1945,613,2558,2021-07-05
3101021002,KAB.ADM.KEP.SERIBU,KEP. SERIBU SELATAN,PULAU TIDUNG,4528,1564,2964,1133,4097,2021-07-05
3101021001,KAB.ADM.KEP.SERIBU,KEP. SERIBU SELATAN,PULAU UNTUNG JAWA,1918,613,1305,558,1863,2021-07-05
3174071007,JAKARTA SELATAN,KEBAYORAN BARU,PULO,5777,3204,2573,1346,3919,2021-07-05
3175021001,JAKARTA TIMUR,PULO GADUNG,PULO GADUNG,34175,23799,10376,4654,15030,2021-07-05
3175061005,JAKARTA TIMUR,CAKUNG,PULO GEBANG,95947,70005,25942,10645,36587,2021-07-05
3174041004,JAKARTA SELATAN,PASAR MINGGU,RAGUNAN,39233,24869,14364,5808,20172,2021-07-05
3175091005,JAKARTA TIMUR,CIRACAS,RAMBUTAN,36368,27282,9086,4287,13373,2021-07-05
3172031006,JAKARTA UTARA,KOJA,RAWA BADAK SELATAN,41895,31187,10708,3940,14648,2021-07-05
3172031004,JAKARTA UTARA,KOJA,RAWA BADAK UTARA,33538,22524,11014,3859,14873,2021-07-05
3174071005,JAKARTA SELATAN,KEBAYORAN BARU,RAWA BARAT,5574,3273,2301,1324,3625,2021-07-05
3173011003,JAKARTA BARAT,CENGKARENG,RAWA BUAYA,59533,40453,19080,5995,25075,2021-07-05
3175031004,JAKARTA TIMUR,JATINEGARA,RAWA BUNGA,21272,15758,5514,2468,7982,2021-07-05
3174081003,JAKARTA SELATAN,PANCORAN,RAWA JATI,20321,12930,7391,3420,10811,2021-07-05
3175061002,JAKARTA TIMUR,CAKUNG,RAWA TERATE,24433,16051,8382,2110,10492,2021-07-05
3175021005,JAKARTA TIMUR,PULO GADUNG,RAWAMANGUN,36788,24551,12237,5843,18080,2021-07-05
3171051003,JAKARTA PUSAT,CEMPAKA PUTIH,RAWASARI,21770,14360,7410,3486,10896,2021-07-05
3173041010,JAKARTA BARAT,TAMBORA,ROA MALAKA,3449,1802,1647,881,2528,2021-07-05
3172041006,JAKARTA UTARA,CILINCING,ROROTAN,40953,27450,13503,4598,18101,2021-07-05
3174071004,JAKARTA SELATAN,KEBAYORAN BARU,SELONG,2843,1493,1350,881,2231,2021-07-05
3173061002,JAKARTA BARAT,KALI DERES,SEMANAN,70293,52807,17486,4981,22467,2021-07-05
3172041007,JAKARTA UTARA,CILINCING,SEMPER BARAT,67899,43874,24025,9085,33110,2021-07-05
3172041005,JAKARTA UTARA,CILINCING,SEMPER TIMUR,36029,24243,11786,4311,16097,2021-07-05
3174071006,JAKARTA SELATAN,KEBAYORAN BARU,SENAYAN,2780,1812,968,571,1539,2021-07-05
3171041001,JAKARTA PUSAT,SENEN,SENEN,6757,4301,2456,1181,3637,2021-07-05
3171031004,JAKARTA PUSAT,KEMAYORAN,SERDANG,29730,19801,9929,3941,13870,2021-07-05
3174021001,JAKARTA SELATAN,SETIA BUDI,SETIA BUDI,2841,1705,1136,643,1779,2021-07-05
3175101005,JAKARTA TIMUR,CIPAYUNG,SETU,20306,14857,5449,2668,8117,2021-07-05
3173071002,JAKARTA BARAT,PALMERAH,SLIPI,16475,10477,5998,2723,8721,2021-07-05
3173081004,JAKARTA BARAT,KEMBANGAN,SRENGSENG,44969,31871,13098,6166,19264,2021-07-05
3174091002,JAKARTA SELATAN,JAGAKARSA,SRENGSENG SAWAH,57480,34921,22559,8892,31451,2021-07-05
3173051003,JAKARTA BARAT,KEBON JERUK,SUKABUMI SELATAN,35170,25305,9865,3473,13338,2021-07-05
3173051002,JAKARTA BARAT,KEBON JERUK,SUKABUMI UTARA,37628,27848,9780,4007,13787,2021-07-05
3172041002,JAKARTA UTARA,CILINCING,SUKAPURA,53786,37603,16183,5454,21637,2021-07-05
3171031007,JAKARTA PUSAT,KEMAYORAN,SUMUR BATU,22506,14512,7994,3399,11393,2021-07-05
3172021004,JAKARTA UTARA,TANJUNG PRIOK,SUNGAI BAMBU,29115,18602,10513,3541,14054,2021-07-05
3172021006,JAKARTA UTARA,TANJUNG PRIOK,SUNTER AGUNG,70860,41129,29731,13497,43228,2021-07-05
3172021002,JAKARTA UTARA,TANJUNG PRIOK,SUNTER JAYA,62516,39209,23307,10467,33774,2021-07-05
3175091004,JAKARTA TIMUR,CIRACAS,SUSUKAN,33525,22607,10918,4602,15520,2021-07-05
3173031001,JAKARTA BARAT,TAMAN SARI,TAMAN SARI,14281,8968,5313,2390,7703,2021-07-05
3173041001,JAKARTA BARAT,TAMBORA,TAMBORA,10177,6716,3461,1516,4977,2021-07-05
3173041004,JAKARTA BARAT,TAMBORA,TANAH SEREAL,25944,15931,10013,3881,13894,2021-07-05
3171081004,JAKARTA PUSAT,JOHAR BARU,TANAH TINGGI,37800,24674,13126,4253,17379,2021-07-05
3173031004,JAKARTA BARAT,TAMAN SARI,TANGKI,12991,8178,4813,1927,6740,2021-07-05
3174091005,JAKARTA SELATAN,JAGAKARSA,TANJUNG BARAT,39368,27481,11887,5680,17567,2021-07-05
3173021005,JAKARTA BARAT,GROGOL PETAMBURAN,TANJUNG DUREN SELATAN,24917,14219,10698,4469,15167,2021-07-05
3173021002,JAKARTA BARAT,GROGOL PETAMBURAN,TANJUNG DUREN UTARA,16940,9298,7642,3532,11174,2021-07-05
3172021001,JAKARTA UTARA,TANJUNG PRIOK,TANJUNG PRIOK,34316,21701,12615,3834,16449,2021-07-05
3174011002,JAKARTA SELATAN,TEBET,TEBET BARAT,21164,12883,8281,4198,12479,2021-07-05
3174011001,JAKARTA SELATAN,TEBET,TEBET TIMUR,18030,10327,7703,3745,11448,2021-07-05
3173061003,JAKARTA BARAT,KALI DERES,TEGAL ALUR,82647,59466,23181,6853,30034,2021-07-05
3174031004,JAKARTA SELATAN,MAMPANG PRAPATAN,TEGAL PARANG,32174,24056,8118,3311,11429,2021-07-05
3173021003,JAKARTA BARAT,GROGOL PETAMBURAN,TOMANG,28665,17533,11132,4982,16114,2021-07-05
3172031005,JAKARTA UTARA,KOJA,TUGU SELATAN,38749,28314,10435,3823,14258,2021-07-05
3172031002,JAKARTA UTARA,KOJA,TUGU UTARA,67211,49384,17827,6747,24574,2021-07-05
3175061006,JAKARTA TIMUR,CAKUNG,UJUNG MENTENG,29527,19907,9620,3983,13603,2021-07-05
3174101005,JAKARTA SELATAN,PESANGGRAHAN,ULUJAMI,40120,28756,11364,4937,16301,2021-07-05
3175011006,JAKARTA TIMUR,MATRAMAN,UTAN KAYU SELATAN,33233,21751,11482,5051,16533,2021-07-05
3175011002,JAKARTA TIMUR,MATRAMAN,UTAN KAYU UTARA,27995,18463,9532,3823,13355,2021-07-05
3171031008,JAKARTA PUSAT,KEMAYORAN,UTAN PANJANG,29260,21585,7675,2801,10476,2021-07-05
3172021007,JAKARTA UTARA,TANJUNG PRIOK,WARAKAS,43754,29169,14585,5217,19802,2021-07-05
3173021007,JAKARTA BARAT,GROGOL PETAMBURAN,WIJAYA KUSUMA,38584,26162,12422,4858,17280,2021-07-05
3172051003,JAKARTA UTARA,PADEMANGAN,ANCOL,23379,15752,7627,3303,10930,2021-07-06
3173041007,JAKARTA BARAT,TAMBORA,ANGKE,29230,19056,10174,3241,13415,2021-07-06
3175041005,JAKARTA TIMUR,KRAMAT JATI,BALE KAMBANG,28803,22030,6773,2667,9440,2021-07-06
3175031003,JAKARTA TIMUR,JATINEGARA,BALI MESTER,9675,6521,3154,1526,4680,2021-07-06
3175101006,JAKARTA TIMUR,CIPAYUNG,BAMBU APUS,25985,18035,7950,4003,11953,2021-07-06
3174031002,JAKARTA SELATAN,MAMPANG PRAPATAN,BANGKA,21356,14463,6893,2725,9618,2021-07-06
3175051002,JAKARTA TIMUR,PASAR REBO,BARU,23514,14114,9400,4695,14095,2021-07-06
3175041004,JAKARTA TIMUR,KRAMAT JATI,BATU AMPAR,47416,35517,11899,5295,17194,2021-07-06
3171071002,JAKARTA PUSAT,TANAH ABANG,BENDUNGAN HILIR,21374,13359,8015,3597,11612,2021-07-06
3175031002,JAKARTA TIMUR,JATINEGARA,BIDARA CINA,36461,26769,9692,4061,13753,2021-07-06
3174101002,JAKARTA SELATAN,PESANGGRAHAN,BINTARO,52402,36508,15894,7112,23006,2021-07-06
3174011005,JAKARTA SELATAN,TEBET,BUKIT DURI,33953,23706,10247,3978,14225,2021-07-06
3171041006,JAKARTA PUSAT,SENEN,BUNGUR,17929,11571,6358,2754,9112,2021-07-06
3175061007,JAKARTA TIMUR,CAKUNG,CAKUNG BARAT,57222,39542,17680,4042,21722,2021-07-06
3175061004,JAKARTA TIMUR,CAKUNG,CAKUNG TIMUR,57655,39247,18408,6443,24851,2021-07-06
3175041007,JAKARTA TIMUR,KRAMAT JATI,CAWANG,32481,22670,9811,4301,14112,2021-07-06
3175101008,JAKARTA TIMUR,CIPAYUNG,CEGER,18740,12716,6024,2583,8607,2021-07-06
3171031006,JAKARTA PUSAT,KEMAYORAN,CEMPAKA BARU,31257,21668,9589,4031,13620,2021-07-06
3171051002,JAKARTA PUSAT,CEMPAKA PUTIH,CEMPAKA PUTIH BARAT,34725,24251,10474,4989,15463,2021-07-06
3171051001,JAKARTA PUSAT,CEMPAKA PUTIH,CEMPAKA PUTIH TIMUR,24170,15277,8893,4474,13367,2021-07-06
3173011001,JAKARTA BARAT,CENGKARENG,CENGKARENG BARAT,65702,40989,24713,8267,32980,2021-07-06
3173011006,JAKARTA BARAT,CENGKARENG,CENGKARENG TIMUR,80100,53701,26399,8544,34943,2021-07-06
3175091002,JAKARTA TIMUR,CIRACAS,CIBUBUR,65231,43002,22229,9506,31735,2021-07-06
3171011002,JAKARTA PUSAT,GAMBIR,CIDENG,15696,9250,6446,3191,9637,2021-07-06
3174091003,JAKARTA SELATAN,JAGAKARSA,CIGANJUR,38048,25637,12411,5186,17597,2021-07-06
3175051003,JAKARTA TIMUR,PASAR REBO,CIJANTUNG,41013,27048,13965,6226,20191,2021-07-06
3171061003,JAKARTA PUSAT,MENTENG,CIKINI,8260,5513,2747,1375,4122,2021-07-06
3174081006,JAKARTA SELATAN,PANCORAN,CIKOKO,10503,6399,4104,1756,5860,2021-07-06
3174061001,JAKARTA SELATAN,CILANDAK,CILANDAK BARAT,51346,31423,19923,7928,27851,2021-07-06
3174041003,JAKARTA SELATAN,PASAR MINGGU,CILANDAK TIMUR,24239,15057,9182,4864,14046,2021-07-06
3175101002,JAKARTA TIMUR,CIPAYUNG,CILANGKAP,27179,18581,8598,3828,12426,2021-07-06
3175041006,JAKARTA TIMUR,KRAMAT JATI,CILILITAN,39984,28572,11412,5272,16684,2021-07-06
3172041001,JAKARTA UTARA,CILINCING,CILINCING,42677,31031,11646,3950,15596,2021-07-06
3175101001,JAKARTA TIMUR,CIPAYUNG,CIPAYUNG,25747,16421,9326,4257,13583,2021-07-06
3174091006,JAKARTA SELATAN,JAGAKARSA,CIPEDAK,37809,24910,12899,4824,17723,2021-07-06
3174061005,JAKARTA SELATAN,CILANDAK,CIPETE SELATAN,26500,17227,9273,3828,13101,2021-07-06
3174071010,JAKARTA SELATAN,KEBAYORAN BARU,CIPETE UTARA,33902,21520,12382,4112,16494,2021-07-06
3175021003,JAKARTA TIMUR,PULO GADUNG,CIPINANG,39069,26151,12918,6062,18980,2021-07-06
3175031007,JAKARTA TIMUR,JATINEGARA,CIPINANG BESAR SELATAN,34938,26049,8889,3920,12809,2021-07-06
3175031008,JAKARTA TIMUR,JATINEGARA,CIPINANG BESAR UTARA,44479,34681,9798,4209,14007,2021-07-06
3175031005,JAKARTA TIMUR,JATINEGARA,CIPINANG CEMPEDAK,32695,22879,9816,4718,14534,2021-07-06
3175081005,JAKARTA TIMUR,MAKASAR,CIPINANG MELAYU,42144,27834,14310,6426,20736,2021-07-06
3175031006,JAKARTA TIMUR,JATINEGARA,CIPINANG MUARA,53251,38491,14760,7328,22088,2021-07-06
3174051003,JAKARTA SELATAN,KEBAYORAN LAMA,CIPULIR,39635,27657,11978,4819,16797,2021-07-06
3175091001,JAKARTA TIMUR,CIRACAS,CIRACAS,63801,42426,21375,8432,29807,2021-07-06
3175041003,JAKARTA TIMUR,KRAMAT JATI,DUKUH,24404,17070,7334,3525,10859,2021-07-06
3175071001,JAKARTA TIMUR,DUREN SAWIT,DUREN SAWIT,60443,41103,19340,9277,28617,2021-07-06
3174081004,JAKARTA SELATAN,PANCORAN,DUREN TIGA,28099,18536,9563,3839,13402,2021-07-06
3173051005,JAKARTA BARAT,KEBON JERUK,DURI KEPA,59448,36251,23197,10000,33197,2021-07-06
3173011002,JAKARTA BARAT,CENGKARENG,DURI KOSAMBI,75895,51077,24818,8228,33046,2021-07-06
3171011006,JAKARTA PUSAT,GAMBIR,DURI PULO,19986,14062,5924,2393,8317,2021-07-06
3173041011,JAKARTA BARAT,TAMBORA,DURI SELATAN,14099,8998,5101,2368,7469,2021-07-06
3173041003,JAKARTA BARAT,TAMBORA,DURI UTARA,19768,13295,6473,2644,9117,2021-07-06
3171081003,JAKARTA PUSAT,JOHAR BARU,GALUR,18098,11091,7007,1973,8980,2021-07-06
3171011001,JAKARTA PUSAT,GAMBIR,GAMBIR,2434,1392,1042,580,1622,2021-07-06
3174061004,JAKARTA SELATAN,CILANDAK,GANDARIA SELATAN,21926,14096,7830,2846,10676,2021-07-06
3174071009,JAKARTA SELATAN,KEBAYORAN BARU,GANDARIA UTARA,39609,25851,13758,5377,19135,2021-07-06
3175051001,JAKARTA TIMUR,PASAR REBO,GEDONG,35444,24181,11263,5309,16572,2021-07-06
3171071001,JAKARTA PUSAT,TANAH ABANG,GELORA,3106,1994,1112,570,1682,2021-07-06
3173031007,JAKARTA BARAT,TAMAN SARI,GLODOK,7836,3873,3963,1978,5941,2021-07-06
3171061004,JAKARTA PUSAT,MENTENG,GONDANGDIA,4093,2137,1956,1297,3253,2021-07-06
3173021001,JAKARTA BARAT,GROGOL PETAMBURAN,GROGOL,16815,10840,5975,2609,8584,2021-07-06
3174051005,JAKARTA SELATAN,KEBAYORAN LAMA,GROGOL SELATAN,43915,30928,12987,5472,18459,2021-07-06
3174051004,JAKARTA SELATAN,KEBAYORAN LAMA,GROGOL UTARA,42216,29425,12791,5860,18651,2021-07-06
3174021007,JAKARTA SELATAN,SETIA BUDI,GUNTUR,3962,2212,1750,991,2741,2021-07-06
3174071002,JAKARTA SELATAN,KEBAYORAN BARU,GUNUNG,9344,5571,3773,2038,5811,2021-07-06
3171031005,JAKARTA PUSAT,KEMAYORAN,GUNUNG SAHARI SELATAN,19380,12560,6820,2825,9645,2021-07-06
3171021004,JAKARTA PUSAT,SAWAH BESAR,GUNUNG SAHARI UTARA,15647,8500,7147,3379,10526,2021-07-06
3175081004,JAKARTA TIMUR,MAKASAR,HALIM PERDANA KUSUMAH,28110,14050,14060,9317,23377,2021-07-06
3171031003,JAKARTA PUSAT,KEMAYORAN,HARAPAN MULIA,22700,15855,6845,2702,9547,2021-07-06
3174091001,JAKARTA SELATAN,JAGAKARSA,JAGAKARSA,61552,39198,22354,8543,30897,2021-07-06
3175021007,JAKARTA TIMUR,PULO GADUNG,JATI,32443,21354,11089,5620,16709,2021-07-06
3174041002,JAKARTA SELATAN,PASAR MINGGU,JATI PADANG,37250,24348,12902,5868,18770,2021-07-06
3173071004,JAKARTA BARAT,PALMERAH,JATI PULO,27994,17141,10853,3658,14511,2021-07-06
3175061001,JAKARTA TIMUR,CAKUNG,JATINEGARA,83563,63951,19612,6796,26408,2021-07-06
3175021004,JAKARTA TIMUR,PULO GADUNG,JATINEGARA KAUM,24364,17012,7352,2937,10289,2021-07-06
3173021004,JAKARTA BARAT,GROGOL PETAMBURAN,JELAMBAR,30180,18342,11838,5481,17319,2021-07-06
3173021006,JAKARTA BARAT,GROGOL PETAMBURAN,JELAMBAR BARU,37799,23868,13931,6083,20014,2021-07-06
3173041006,JAKARTA BARAT,TAMBORA,JEMBATAN BESI,29182,22536,6646,2430,9076,2021-07-06
3173041008,JAKARTA BARAT,TAMBORA,JEMBATAN LIMA,20627,14847,5780,2268,8048,2021-07-06
3173081005,JAKARTA BARAT,KEMBANGAN,JOGLO,40475,27104,13371,5958,19329,2021-07-06
3171081001,JAKARTA PUSAT,JOHAR BARU,JOHAR BARU,32845,19164,13681,5351,19032,2021-07-06
3173041002,JAKARTA BARAT,TAMBORA,KALI ANYAR,23582,17721,5861,2240,8101,2021-07-06
3172041004,JAKARTA UTARA,CILINCING,KALIBARU,67165,51716,15449,4352,19801,2021-07-06
3174081002,JAKARTA SELATAN,PANCORAN,KALIBATA,41464,29262,12202,4934,17136,2021-07-06
3173061001,JAKARTA BARAT,KALI DERES,KALIDERES,69014,47476,21538,7602,29140,2021-07-06
3175051004,JAKARTA TIMUR,PASAR REBO,KALISARI,42557,28167,14390,6785,21175,2021-07-06
3173061004,JAKARTA BARAT,KALI DERES,KAMAL,53180,40794,12386,3659,16045,2021-07-06
3172011002,JAKARTA UTARA,PENJARINGAN,KAMAL MUARA,12679,6866,5813,2509,8322,2021-07-06
3171071007,JAKARTA PUSAT,TANAH ABANG,KAMPUNG BALI,11551,8323,3228,1512,4740,2021-07-06
3175031001,JAKARTA TIMUR,JATINEGARA,KAMPUNG MELAYU,25476,19433,6043,2244,8287,2021-07-06
3171081002,JAKARTA PUSAT,JOHAR BARU,KAMPUNG RAWA,18247,9626,8621,2547,11168,2021-07-06
3175041002,JAKARTA TIMUR,KRAMAT JATI,KAMPUNG TENGAH,43668,32091,11577,5266,16843,2021-07-06
3173011005,JAKARTA BARAT,CENGKARENG,KAPUK,121994,87968,34026,9506,43532,2021-07-06
3172011003,JAKARTA UTARA,PENJARINGAN,KAPUK MUARA,35498,21425,14073,6658,20731,2021-07-06
3171021002,JAKARTA PUSAT,SAWAH BESAR,KARANG ANYAR,25865,17105,8760,3410,12170,2021-07-06
3174021004,JAKARTA SELATAN,SETIA BUDI,KARET,9581,5916,3665,1439,5104,2021-07-06
3174021003,JAKARTA SELATAN,SETIA BUDI,KARET KUNINGAN,15939,9754,6185,2334,8519,2021-07-06
3174021002,JAKARTA SELATAN,SETIA BUDI,KARET SEMANGGI,2746,1455,1291,602,1893,2021-07-06
3171071003,JAKARTA PUSAT,TANAH ABANG,KARET TENGSIN,19113,13081,6032,2215,8247,2021-07-06
3171021003,JAKARTA PUSAT,SAWAH BESAR,KARTINI,22303,14070,8233,3456,11689,2021-07-06
3175011003,JAKARTA TIMUR,MATRAMAN,KAYU MANIS,25138,17622,7516,3015,10531,2021-07-06
3175021006,JAKARTA TIMUR,PULO GADUNG,KAYU PUTIH,40378,25178,15200,7072,22272,2021-07-06
3173031006,JAKARTA BARAT,TAMAN SARI,KEAGUNGAN,17231,11274,5957,1999,7956,2021-07-06
3174041007,JAKARTA SELATAN,PASAR MINGGU,KEBAGUSAN,44010,30523,13487,5198,18685,2021-07-06
3174051006,JAKARTA SELATAN,KEBAYORAN LAMA,KEBAYORAN LAMA SELATAN,40895,26021,14874,5805,20679,2021-07-06
3174051001,JAKARTA SELATAN,KEBAYORAN LAMA,KEBAYORAN LAMA UTARA,42214,29421,12793,5253,18046,2021-07-06
3174011004,JAKARTA SELATAN,TEBET,KEBON BARU,34878,23110,11768,5136,16904,2021-07-06
3172021005,JAKARTA UTARA,TANJUNG PRIOK,KEBON BAWANG,50597,33241,17356,6934,24290,2021-07-06
3173051001,JAKARTA BARAT,KEBON JERUK,KEBON JERUK,53296,37575,15721,6795,22516,2021-07-06
3171071006,JAKARTA PUSAT,TANAH ABANG,KEBON KACANG,21376,15915,5461,2629,8090,2021-07-06
3171011005,JAKARTA PUSAT,GAMBIR,KEBON KELAPA,10380,6897,3483,1658,5141,2021-07-06
3171031002,JAKARTA PUSAT,KEMAYORAN,KEBON KOSONG,30003,20480,9523,3466,12989,2021-07-06
3175011005,JAKARTA TIMUR,MATRAMAN,KEBON MANGGIS,16393,10492,5901,2765,8666,2021-07-06
3171071005,JAKARTA PUSAT,TANAH ABANG,KEBON MELATI,31355,24745,6610,2862,9472,2021-07-06
3175081003,JAKARTA TIMUR,MAKASAR,KEBON PALA,46176,32050,14126,6191,20317,2021-07-06
3171061005,JAKARTA PUSAT,MENTENG,KEBON SIRIH,12256,8957,3299,1547,4846,2021-07-06
3173011004,JAKARTA BARAT,CENGKARENG,KEDAUNG KALI ANGKE,32185,19702,12483,3226,15709,2021-07-06
3173051007,JAKARTA BARAT,KEBON JERUK,KEDOYA SELATAN,31907,20534,11373,4611,15984,2021-07-06
3173051006,JAKARTA BARAT,KEBON JERUK,KEDOYA UTARA,43826,26583,17243,6980,24223,2021-07-06
3173051004,JAKARTA BARAT,KEBON JERUK,KELAPA DUA,23293,15456,7837,3140,10977,2021-07-06
3175091003,JAKARTA TIMUR,CIRACAS,KELAPA DUA WETAN,46441,30570,15871,7233,23104,2021-07-06
3172061003,JAKARTA UTARA,KELAPA GADING,KELAPA GADING BARAT,35403,19309,16094,8821,24915,2021-07-06
3172061001,JAKARTA UTARA,KELAPA GADING,KELAPA GADING TIMUR,33472,16248,17224,9137,26361,2021-07-06
3173071005,JAKARTA BARAT,PALMERAH,KEMANGGISAN,31952,20748,11204,5203,16407,2021-07-06
3171031001,JAKARTA PUSAT,KEMAYORAN,KEMAYORAN,20947,13304,7643,2819,10462,2021-07-06
3173081006,JAKARTA BARAT,KEMBANGAN,KEMBANGAN SELATAN,26920,17050,9870,5009,14879,2021-07-06
3173081001,JAKARTA BARAT,KEMBANGAN,KEMBANGAN UTARA,52368,34524,17844,6596,24440,2021-07-06
3171041002,JAKARTA PUSAT,SENEN,KENARI,9317,5500,3817,1742,5559,2021-07-06
3173041005,JAKARTA BARAT,TAMBORA,KERENDANG,19869,14151,5718,2221,7939,2021-07-06
3175071003,JAKARTA TIMUR,DUREN SAWIT,KLENDER,69321,50930,18391,7435,25826,2021-07-06
3172031001,JAKARTA UTARA,KOJA,KOJA,28036,19572,8464,2744,11208,2021-07-06
3173071006,JAKARTA BARAT,PALMERAH,KOTA BAMBU SELATAN,20926,14352,6574,2242,8816,2021-07-06
3173071003,JAKARTA BARAT,PALMERAH,KOTA BAMBU UTARA,24416,17243,7173,2771,9944,2021-07-06
3171041004,JAKARTA PUSAT,SENEN,KRAMAT,28661,20637,8024,2985,11009,2021-07-06
3175041001,JAKARTA TIMUR,KRAMAT JATI,KRAMAT JATI,33851,23031,10820,5019,15839,2021-07-06
3174071003,JAKARTA SELATAN,KEBAYORAN BARU,KRAMAT PELA,14340,8571,5769,2377,8146,2021-07-06
3173031002,JAKARTA BARAT,TAMAN SARI,KRUKUT,19130,12518,6612,2287,8899,2021-07-06
3174031005,JAKARTA SELATAN,MAMPANG PRAPATAN,KUNINGAN BARAT,12675,8092,4583,1546,6129,2021-07-06
3174021008,JAKARTA SELATAN,SETIA BUDI,KUNINGAN TIMUR,5982,3777,2205,1060,3265,2021-07-06
3171041005,JAKARTA PUSAT,SENEN,KWITANG,15295,9956,5339,2095,7434,2021-07-06
3172031003,JAKARTA UTARA,KOJA,LAGOA,58726,42540,16186,5654,21840,2021-07-06
3174061002,JAKARTA SELATAN,CILANDAK,LEBAK BULUS,37213,24509,12704,5883,18587,2021-07-06
3174091004,JAKARTA SELATAN,JAGAKARSA,LENTENG AGUNG,53453,38498,14955,6141,21096,2021-07-06
3175101007,JAKARTA TIMUR,CIPAYUNG,LUBANG BUAYA,62984,42064,20920,8411,29331,2021-07-06
3175081001,JAKARTA TIMUR,MAKASAR,MAKASAR,34062,21990,12072,4966,17038,2021-07-06
3175071006,JAKARTA TIMUR,DUREN SAWIT,MALAKA JAYA,30744,19688,11056,5495,16551,2021-07-06
3175071005,JAKARTA TIMUR,DUREN SAWIT,MALAKA SARI,27015,16785,10230,5425,15655,2021-07-06
3174031001,JAKARTA SELATAN,MAMPANG PRAPATAN,MAMPANG PRAPATAN,18046,12486,5560,2055,7615,2021-07-06
3173031005,JAKARTA BARAT,TAMAN SARI,MANGGA BESAR,7439,4042,3397,1448,4845,2021-07-06
3171021005,JAKARTA PUSAT,SAWAH BESAR,MANGGA DUA SELATAN,27767,18319,9448,3859,13307,2021-07-06
3174011007,JAKARTA SELATAN,TEBET,MANGGARAI,28388,19521,8867,3564,12431,2021-07-06
3174011006,JAKARTA SELATAN,TEBET,MANGGARAI SELATAN,22902,14293,8609,3214,11823,2021-07-06
3173031003,JAKARTA BARAT,TAMAN SARI,MAPHAR,16385,10235,6150,2567,8717,2021-07-06
3172041003,JAKARTA UTARA,CILINCING,MARUNDA,28614,18515,10099,2582,12681,2021-07-06
3174071001,JAKARTA SELATAN,KEBAYORAN BARU,MELAWAI,2634,1324,1310,829,2139,2021-07-06
3171061001,JAKARTA PUSAT,MENTENG,MENTENG,25280,18312,6968,3517,10485,2021-07-06
3174021005,JAKARTA SELATAN,SETIA BUDI,MENTENG ATAS,27671,17496,10175,4033,14208,2021-07-06
3174011003,JAKARTA SELATAN,TEBET,MENTENG DALAM,35936,24159,11777,5184,16961,2021-07-06
3173081003,JAKARTA BARAT,KEMBANGAN,MERUYA SELATAN,31227,20599,10628,4330,14958,2021-07-06
3173081002,JAKARTA BARAT,KEMBANGAN,MERUYA UTARA,43382,28563,14819,6949,21768,2021-07-06
3175101004,JAKARTA TIMUR,CIPAYUNG,MUNJUL,23570,16147,7423,3597,11020,2021-07-06
3172051002,JAKARTA UTARA,PADEMANGAN,PADEMANGAN BARAT,73841,51592,22249,7802,30051,2021-07-06
3172051001,JAKARTA UTARA,PADEMANGAN,PADEMANGAN TIMUR,36757,20649,16108,6893,23001,2021-07-06
3175011004,JAKARTA TIMUR,MATRAMAN,PAL MERIAM,19632,13035,6597,2719,9316,2021-07-06
3173071001,JAKARTA BARAT,PALMERAH,PALMERAH,62175,41732,20443,8014,28457,2021-07-06
3174081001,JAKARTA SELATAN,PANCORAN,PANCORAN,19301,12910,6391,2656,9047,2021-07-06
3172021003,JAKARTA UTARA,TANJUNG PRIOK,PAPANGGO,38871,25446,13425,4712,18137,2021-07-06
3171021001,JAKARTA PUSAT,SAWAH BESAR,PASAR BARU,12710,6811,5899,2914,8813,2021-07-06
3174021006,JAKARTA SELATAN,SETIA BUDI,PASAR MANGGIS,26572,17368,9204,3548,12752,2021-07-06
3174041001,JAKARTA SELATAN,PASAR MINGGU,PASAR MINGGU,24670,16138,8532,4559,13091,2021-07-06
3171041003,JAKARTA PUSAT,SENEN,PASEBAN,23321,15472,7849,3304,11153,2021-07-06
3173061005,JAKARTA BARAT,KALI DERES,PEGADUNGAN,74685,49929,24756,9111,33867,2021-07-06
3171061002,JAKARTA PUSAT,MENTENG,PEGANGSAAN,21120,14413,6707,2945,9652,2021-07-06
3172061002,JAKARTA UTARA,KELAPA GADING,PEGANGSAAN DUA,49632,26166,23466,10503,33969,2021-07-06
3172011004,JAKARTA UTARA,PENJARINGAN,PEJAGALAN,74043,47098,26945,10916,37861,2021-07-06
3174041006,JAKARTA SELATAN,PASAR MINGGU,PEJATEN BARAT,35061,22281,12780,5593,18373,2021-07-06
3174041005,JAKARTA SELATAN,PASAR MINGGU,PEJATEN TIMUR,57257,40143,17114,6039,23153,2021-07-06
3175051005,JAKARTA TIMUR,PASAR REBO,PEKAYON,42705,28164,14541,6073,20614,2021-07-06
3173041009,JAKARTA BARAT,TAMBORA,PEKOJAN,23428,15080,8348,3415,11763,2021-07-06
3174031003,JAKARTA SELATAN,MAMPANG PRAPATAN,PELA MAMPANG,42709,28588,14121,5638,19759,2021-07-06
3174081005,JAKARTA SELATAN,PANCORAN,PENGADEGAN,21111,12217,8894,3328,12222,2021-07-06
3175061003,JAKARTA TIMUR,CAKUNG,PENGGILINGAN,97138,73863,23275,9382,32657,2021-07-06
3172011001,JAKARTA UTARA,PENJARINGAN,PENJARINGAN,86712,61282,25430,7838,33268,2021-07-06
3174101001,JAKARTA SELATAN,PESANGGRAHAN,PESANGGRAHAN,27215,16497,10718,4877,15595,2021-07-06
3171071004,JAKARTA PUSAT,TANAH ABANG,PETAMBURAN,33060,25801,7259,2927,10186,2021-07-06
3174071008,JAKARTA SELATAN,KEBAYORAN BARU,PETOGOGAN,11418,7134,4284,1851,6135,2021-07-06
3171011004,JAKARTA PUSAT,GAMBIR,PETOJO SELATAN,14946,9373,5573,3002,8575,2021-07-06
3171011003,JAKARTA PUSAT,GAMBIR,PETOJO UTARA,17843,11947,5896,2698,8594,2021-07-06
3174101004,JAKARTA SELATAN,PESANGGRAHAN,PETUKANGAN SELATAN,36769,23908,12861,4914,17775,2021-07-06
3174101003,JAKARTA SELATAN,PESANGGRAHAN,PETUKANGAN UTARA,53184,35857,17327,6739,24066,2021-07-06
3175081002,JAKARTA TIMUR,MAKASAR,PINANG RANTI,26915,17604,9311,3454,12765,2021-07-06
3173031008,JAKARTA BARAT,TAMAN SARI,PINANGSIA,10583,6403,4180,1631,5811,2021-07-06
3175011001,JAKARTA TIMUR,MATRAMAN,PISANGAN BARU,31537,22973,8564,3822,12386,2021-07-06
3175021002,JAKARTA TIMUR,PULO GADUNG,PISANGAN TIMUR,40576,26961,13615,5661,19276,2021-07-06
3172011005,JAKARTA UTARA,PENJARINGAN,PLUIT,47433,25990,21443,12319,33762,2021-07-06
3175071002,JAKARTA TIMUR,DUREN SAWIT,PONDOK BAMBU,61047,40824,20223,8883,29106,2021-07-06
3175071004,JAKARTA TIMUR,DUREN SAWIT,PONDOK KELAPA,71347,47238,24109,10978,35087,2021-07-06
3175071007,JAKARTA TIMUR,DUREN SAWIT,PONDOK KOPI,35051,25213,9838,4356,14194,2021-07-06
3174061003,JAKARTA SELATAN,CILANDAK,PONDOK LABU,45944,29585,16359,6865,23224,2021-07-06
3174051002,JAKARTA SELATAN,KEBAYORAN LAMA,PONDOK PINANG,55724,37063,18661,9425,28086,2021-07-06
3175101003,JAKARTA TIMUR,CIPAYUNG,PONDOK RANGGON,25123,17723,7400,3786,11186,2021-07-06
3101011003,KAB.ADM.KEP.SERIBU,KEP. SERIBU UTARA,PULAU HARAPAN,2036,704,1332,670,2002,2021-07-06
3101011002,KAB.ADM.KEP.SERIBU,KEP. SERIBU UTARA,PULAU KELAPA,5460,2003,3457,1082,4539,2021-07-06
3101011001,KAB.ADM.KEP.SERIBU,KEP. SERIBU UTARA,PULAU PANGGANG,5395,1930,3465,1140,4605,2021-07-06
3101021003,KAB.ADM.KEP.SERIBU,KEP. SERIBU SELATAN,PULAU PARI,2736,700,2036,613,2649,2021-07-06
3101021002,KAB.ADM.KEP.SERIBU,KEP. SERIBU SELATAN,PULAU TIDUNG,4528,1499,3029,1133,4162,2021-07-06
3101021001,KAB.ADM.KEP.SERIBU,KEP. SERIBU SELATAN,PULAU UNTUNG JAWA,1918,592,1326,559,1885,2021-07-06
3174071007,JAKARTA SELATAN,KEBAYORAN BARU,PULO,5777,3185,2592,1349,3941,2021-07-06
3175021001,JAKARTA TIMUR,PULO GADUNG,PULO GADUNG,34175,23614,10561,4661,15222,2021-07-06
3175061005,JAKARTA TIMUR,CAKUNG,PULO GEBANG,95947,69533,26414,10675,37089,2021-07-06
3174041004,JAKARTA SELATAN,PASAR MINGGU,RAGUNAN,39233,24617,14616,5814,20430,2021-07-06
3175091005,JAKARTA TIMUR,CIRACAS,RAMBUTAN,36368,27094,9274,4292,13566,2021-07-06
3172031006,JAKARTA UTARA,KOJA,RAWA BADAK SELATAN,41895,30927,10968,3942,14910,2021-07-06
3172031004,JAKARTA UTARA,KOJA,RAWA BADAK UTARA,33538,22219,11319,3864,15183,2021-07-06
3174071005,JAKARTA SELATAN,KEBAYORAN BARU,RAWA BARAT,5574,3239,2335,1327,3662,2021-07-06
3173011003,JAKARTA BARAT,CENGKARENG,RAWA BUAYA,59533,40218,19315,5996,25311,2021-07-06
3175031004,JAKARTA TIMUR,JATINEGARA,RAWA BUNGA,21272,15597,5675,2470,8145,2021-07-06
3174081003,JAKARTA SELATAN,PANCORAN,RAWA JATI,20321,12848,7473,3420,10893,2021-07-06
3175061002,JAKARTA TIMUR,CAKUNG,RAWA TERATE,24433,15986,8447,2123,10570,2021-07-06
3175021005,JAKARTA TIMUR,PULO GADUNG,RAWAMANGUN,36788,24361,12427,5854,18281,2021-07-06
3171051003,JAKARTA PUSAT,CEMPAKA PUTIH,RAWASARI,21770,14237,7533,3490,11023,2021-07-06
3173041010,JAKARTA BARAT,TAMBORA,ROA MALAKA,3449,1775,1674,881,2555,2021-07-06
3172041006,JAKARTA UTARA,CILINCING,ROROTAN,40953,27109,13844,4603,18447,2021-07-06
3174071004,JAKARTA SELATAN,KEBAYORAN BARU,SELONG,2843,1476,1367,883,2250,2021-07-06
3173061002,JAKARTA BARAT,KALI DERES,SEMANAN,70293,52512,17781,4987,22768,2021-07-06
3172041007,JAKARTA UTARA,CILINCING,SEMPER BARAT,67899,43521,24378,9090,33468,2021-07-06
3172041005,JAKARTA UTARA,CILINCING,SEMPER TIMUR,36029,23990,12039,4315,16354,2021-07-06
3174071006,JAKARTA SELATAN,KEBAYORAN BARU,SENAYAN,2780,1795,985,573,1558,2021-07-06
3171041001,JAKARTA PUSAT,SENEN,SENEN,6757,4286,2471,1181,3652,2021-07-06
3171031004,JAKARTA PUSAT,KEMAYORAN,SERDANG,29730,19674,10056,3945,14001,2021-07-06
3174021001,JAKARTA SELATAN,SETIA BUDI,SETIA BUDI,2841,1687,1154,645,1799,2021-07-06
3175101005,JAKARTA TIMUR,CIPAYUNG,SETU,20306,14781,5525,2672,8197,2021-07-06
3173071002,JAKARTA BARAT,PALMERAH,SLIPI,16475,10417,6058,2727,8785,2021-07-06
3173081004,JAKARTA BARAT,KEMBANGAN,SRENGSENG,44969,31664,13305,6172,19477,2021-07-06
3174091002,JAKARTA SELATAN,JAGAKARSA,SRENGSENG SAWAH,57480,34544,22936,8896,31832,2021-07-06
3173051003,JAKARTA BARAT,KEBON JERUK,SUKABUMI SELATAN,35170,25024,10146,3475,13621,2021-07-06
3173051002,JAKARTA BARAT,KEBON JERUK,SUKABUMI UTARA,37628,27667,9961,4012,13973,2021-07-06
3172041002,JAKARTA UTARA,CILINCING,SUKAPURA,53786,37271,16515,5458,21973,2021-07-06
3171031007,JAKARTA PUSAT,KEMAYORAN,SUMUR BATU,22506,14453,8053,3404,11457,2021-07-06
3172021004,JAKARTA UTARA,TANJUNG PRIOK,SUNGAI BAMBU,29115,18350,10765,3552,14317,2021-07-06
3172021006,JAKARTA UTARA,TANJUNG PRIOK,SUNTER AGUNG,70860,40678,30182,13506,43688,2021-07-06
3172021002,JAKARTA UTARA,TANJUNG PRIOK,SUNTER JAYA,62516,38734,23782,10474,34256,2021-07-06
3175091004,JAKARTA TIMUR,CIRACAS,SUSUKAN,33525,22372,11153,4609,15762,2021-07-06
3173031001,JAKARTA BARAT,TAMAN SARI,TAMAN SARI,14281,8906,5375,2391,7766,2021-07-06
3173041001,JAKARTA BARAT,TAMBORA,TAMBORA,10177,6675,3502,1520,5022,2021-07-06
3173041004,JAKARTA BARAT,TAMBORA,TANAH SEREAL,25944,15804,10140,3883,14023,2021-07-06
3171081004,JAKARTA PUSAT,JOHAR BARU,TANAH TINGGI,37800,24481,13319,4254,17573,2021-07-06
3173031004,JAKARTA BARAT,TAMAN SARI,TANGKI,12991,8108,4883,1928,6811,2021-07-06
3174091005,JAKARTA SELATAN,JAGAKARSA,TANJUNG BARAT,39368,27282,12086,5686,17772,2021-07-06
3173021005,JAKARTA BARAT,GROGOL PETAMBURAN,TANJUNG DUREN SELATAN,24917,14156,10761,4476,15237,2021-07-06
3173021002,JAKARTA BARAT,GROGOL PETAMBURAN,TANJUNG DUREN UTARA,16940,9213,7727,3534,11261,2021-07-06
3172021001,JAKARTA UTARA,TANJUNG PRIOK,TANJUNG PRIOK,34316,21563,12753,3837,16590,2021-07-06
3174011002,JAKARTA SELATAN,TEBET,TEBET BARAT,21164,12799,8365,4200,12565,2021-07-06
3174011001,JAKARTA SELATAN,TEBET,TEBET TIMUR,18030,10164,7866,3746,11612,2021-07-06
3173061003,JAKARTA BARAT,KALI DERES,TEGAL ALUR,82647,59029,23618,6856,30474,2021-07-06
3174031004,JAKARTA SELATAN,MAMPANG PRAPATAN,TEGAL PARANG,32174,23894,8280,3312,11592,2021-07-06
3173021003,JAKARTA BARAT,GROGOL PETAMBURAN,TOMANG,28665,17409,11256,4984,16240,2021-07-06
3172031005,JAKARTA UTARA,KOJA,TUGU SELATAN,38749,28074,10675,3826,14501,2021-07-06
3172031002,JAKARTA UTARA,KOJA,TUGU UTARA,67211,48915,18296,6752,25048,2021-07-06
3175061006,JAKARTA TIMUR,CAKUNG,UJUNG MENTENG,29527,19783,9744,3984,13728,2021-07-06
3174101005,JAKARTA SELATAN,PESANGGRAHAN,ULUJAMI,40120,28665,11455,4938,16393,2021-07-06
3175011006,JAKARTA TIMUR,MATRAMAN,UTAN KAYU SELATAN,33233,21612,11621,5057,16678,2021-07-06
3175011002,JAKARTA TIMUR,MATRAMAN,UTAN KAYU UTARA,27995,18368,9627,3829,13456,2021-07-06
3171031008,JAKARTA PUSAT,KEMAYORAN,UTAN PANJANG,29260,21377,7883,2802,10685,2021-07-06
3172021007,JAKARTA UTARA,TANJUNG PRIOK,WARAKAS,43754,28875,14879,5221,20100,2021-07-06
3173021007,JAKARTA BARAT,GROGOL PETAMBURAN,WIJAYA KUSUMA,38584,25919,12665,4863,17528,2021-07-06
3172051003,JAKARTA UTARA,PADEMANGAN,ANCOL,23379,15545,7834,3307,11141,2021-07-07
3173041007,JAKARTA BARAT,TAMBORA,ANGKE,29230,18740,10490,3245,13735,2021-07-07
3175041005,JAKARTA TIMUR,KRAMAT JATI,BALE KAMBANG,28803,21827,6976,2675,9651,2021-07-07
3175031003,JAKARTA TIMUR,JATINEGARA,BALI MESTER,9675,6421,3254,1534,4788,2021-07-07
3175101006,JAKARTA TIMUR,CIPAYUNG,BAMBU APUS,25985,17813,8172,4007,12179,2021-07-07
3174031002,JAKARTA SELATAN,MAMPANG PRAPATAN,BANGKA,21356,14246,7110,2734,9844,2021-07-07
3175051002,JAKARTA TIMUR,PASAR REBO,BARU,23514,13879,9635,4707,14342,2021-07-07
3175041004,JAKARTA TIMUR,KRAMAT JATI,BATU AMPAR,47416,35121,12295,5312,17607,2021-07-07
3171071002,JAKARTA PUSAT,TANAH ABANG,BENDUNGAN HILIR,21374,13166,8208,3600,11808,2021-07-07
3175031002,JAKARTA TIMUR,JATINEGARA,BIDARA CINA,36461,26453,10008,4067,14075,2021-07-07
3174101002,JAKARTA SELATAN,PESANGGRAHAN,BINTARO,52402,35792,16610,7130,23740,2021-07-07
3174011005,JAKARTA SELATAN,TEBET,BUKIT DURI,33953,23348,10605,3982,14587,2021-07-07
3171041006,JAKARTA PUSAT,SENEN,BUNGUR,17929,11198,6731,2763,9494,2021-07-07
3175061007,JAKARTA TIMUR,CAKUNG,CAKUNG BARAT,57222,38728,18494,4052,22546,2021-07-07
3175061004,JAKARTA TIMUR,CAKUNG,CAKUNG TIMUR,57655,38503,19152,6457,25609,2021-07-07
3175041007,JAKARTA TIMUR,KRAMAT JATI,CAWANG,32481,22321,10160,4323,14483,2021-07-07
3175101008,JAKARTA TIMUR,CIPAYUNG,CEGER,18740,12604,6136,2587,8723,2021-07-07
3171031006,JAKARTA PUSAT,KEMAYORAN,CEMPAKA BARU,31257,21448,9809,4041,13850,2021-07-07
3171051002,JAKARTA PUSAT,CEMPAKA PUTIH,CEMPAKA PUTIH BARAT,34725,23833,10892,4997,15889,2021-07-07
3171051001,JAKARTA PUSAT,CEMPAKA PUTIH,CEMPAKA PUTIH TIMUR,24170,14964,9206,4482,13688,2021-07-07
3173011001,JAKARTA BARAT,CENGKARENG,CENGKARENG BARAT,65702,40491,25211,8280,33491,2021-07-07
3173011006,JAKARTA BARAT,CENGKARENG,CENGKARENG TIMUR,80100,52996,27104,8550,35654,2021-07-07
3175091002,JAKARTA TIMUR,CIRACAS,CIBUBUR,65231,42301,22930,9559,32489,2021-07-07
3171011002,JAKARTA PUSAT,GAMBIR,CIDENG,15696,9115,6581,3205,9786,2021-07-07
3174091003,JAKARTA SELATAN,JAGAKARSA,CIGANJUR,38048,25224,12824,5202,18026,2021-07-07
3175051003,JAKARTA TIMUR,PASAR REBO,CIJANTUNG,41013,26593,14420,6240,20660,2021-07-07
3171061003,JAKARTA PUSAT,MENTENG,CIKINI,8260,5460,2800,1377,4177,2021-07-07
3174081006,JAKARTA SELATAN,PANCORAN,CIKOKO,10503,6295,4208,1761,5969,2021-07-07
3174061001,JAKARTA SELATAN,CILANDAK,CILANDAK BARAT,51346,30711,20635,7939,28574,2021-07-07
3174041003,JAKARTA SELATAN,PASAR MINGGU,CILANDAK TIMUR,24239,14815,9424,4875,14299,2021-07-07
3175101002,JAKARTA TIMUR,CIPAYUNG,CILANGKAP,27179,18302,8877,3833,12710,2021-07-07
3175041006,JAKARTA TIMUR,KRAMAT JATI,CILILITAN,39984,28238,11746,5300,17046,2021-07-07
3172041001,JAKARTA UTARA,CILINCING,CILINCING,42677,30436,12241,3955,16196,2021-07-07
3175101001,JAKARTA TIMUR,CIPAYUNG,CIPAYUNG,25747,16122,9625,4268,13893,2021-07-07
3174091006,JAKARTA SELATAN,JAGAKARSA,CIPEDAK,37809,24328,13481,4833,18314,2021-07-07
3174061005,JAKARTA SELATAN,CILANDAK,CIPETE SELATAN,26500,16927,9573,3839,13412,2021-07-07
3174071010,JAKARTA SELATAN,KEBAYORAN BARU,CIPETE UTARA,33902,21238,12664,4124,16788,2021-07-07
3175021003,JAKARTA TIMUR,PULO GADUNG,CIPINANG,39069,25725,13344,6091,19435,2021-07-07
3175031007,JAKARTA TIMUR,JATINEGARA,CIPINANG BESAR SELATAN,34938,25848,9090,3926,13016,2021-07-07
3175031008,JAKARTA TIMUR,JATINEGARA,CIPINANG BESAR UTARA,44479,34411,10068,4214,14282,2021-07-07
3175031005,JAKARTA TIMUR,JATINEGARA,CIPINANG CEMPEDAK,32695,22592,10103,4728,14831,2021-07-07
3175081005,JAKARTA TIMUR,MAKASAR,CIPINANG MELAYU,42144,27368,14776,6442,21218,2021-07-07
3175031006,JAKARTA TIMUR,JATINEGARA,CIPINANG MUARA,53251,38136,15115,7340,22455,2021-07-07
3174051003,JAKARTA SELATAN,KEBAYORAN LAMA,CIPULIR,39635,27241,12394,4829,17223,2021-07-07
3175091001,JAKARTA TIMUR,CIRACAS,CIRACAS,63801,41824,21977,8466,30443,2021-07-07
3175041003,JAKARTA TIMUR,KRAMAT JATI,DUKUH,24404,16770,7634,3531,11165,2021-07-07
3175071001,JAKARTA TIMUR,DUREN SAWIT,DUREN SAWIT,60443,40555,19888,9299,29187,2021-07-07
3174081004,JAKARTA SELATAN,PANCORAN,DUREN TIGA,28099,18165,9934,3854,13788,2021-07-07
3173051005,JAKARTA BARAT,KEBON JERUK,DURI KEPA,59448,35730,23718,10021,33739,2021-07-07
3173011002,JAKARTA BARAT,CENGKARENG,DURI KOSAMBI,75895,50487,25408,8235,33643,2021-07-07
3171011006,JAKARTA PUSAT,GAMBIR,DURI PULO,19986,13901,6085,2402,8487,2021-07-07
3173041011,JAKARTA BARAT,TAMBORA,DURI SELATAN,14099,8800,5299,2373,7672,2021-07-07
3173041003,JAKARTA BARAT,TAMBORA,DURI UTARA,19768,13145,6623,2647,9270,2021-07-07
3171081003,JAKARTA PUSAT,JOHAR BARU,GALUR,18098,10903,7195,1976,9171,2021-07-07
3171011001,JAKARTA PUSAT,GAMBIR,GAMBIR,2434,1381,1053,580,1633,2021-07-07
3174061004,JAKARTA SELATAN,CILANDAK,GANDARIA SELATAN,21926,13947,7979,2855,10834,2021-07-07
3174071009,JAKARTA SELATAN,KEBAYORAN BARU,GANDARIA UTARA,39609,25426,14183,5383,19566,2021-07-07
3175051001,JAKARTA TIMUR,PASAR REBO,GEDONG,35444,23751,11693,5323,17016,2021-07-07
3171071001,JAKARTA PUSAT,TANAH ABANG,GELORA,3106,1975,1131,571,1702,2021-07-07
3173031007,JAKARTA BARAT,TAMAN SARI,GLODOK,7836,3799,4037,1981,6018,2021-07-07
3171061004,JAKARTA PUSAT,MENTENG,GONDANGDIA,4093,2116,1977,1297,3274,2021-07-07
3173021001,JAKARTA BARAT,GROGOL PETAMBURAN,GROGOL,16815,10685,6130,2613,8743,2021-07-07
3174051005,JAKARTA SELATAN,KEBAYORAN LAMA,GROGOL SELATAN,43915,30553,13362,5478,18840,2021-07-07
3174051004,JAKARTA SELATAN,KEBAYORAN LAMA,GROGOL UTARA,42216,29077,13139,5865,19004,2021-07-07
3174021007,JAKARTA SELATAN,SETIA BUDI,GUNTUR,3962,2182,1780,991,2771,2021-07-07
3174071002,JAKARTA SELATAN,KEBAYORAN BARU,GUNUNG,9344,5465,3879,2045,5924,2021-07-07
3171031005,JAKARTA PUSAT,KEMAYORAN,GUNUNG SAHARI SELATAN,19380,12370,7010,2827,9837,2021-07-07
3171021004,JAKARTA PUSAT,SAWAH BESAR,GUNUNG SAHARI UTARA,15647,8339,7308,3383,10691,2021-07-07
3175081004,JAKARTA TIMUR,MAKASAR,HALIM PERDANA KUSUMAH,28110,13778,14332,9327,23659,2021-07-07
3171031003,JAKARTA PUSAT,KEMAYORAN,HARAPAN MULIA,22700,15583,7117,2703,9820,2021-07-07
3174091001,JAKARTA SELATAN,JAGAKARSA,JAGAKARSA,61552,38434,23118,8559,31677,2021-07-07
3175021007,JAKARTA TIMUR,PULO GADUNG,JATI,32443,21041,11402,5634,17036,2021-07-07
3174041002,JAKARTA SELATAN,PASAR MINGGU,JATI PADANG,37250,23899,13351,5879,19230,2021-07-07
3173071004,JAKARTA BARAT,PALMERAH,JATI PULO,27994,16971,11023,3672,14695,2021-07-07
3175061001,JAKARTA TIMUR,CAKUNG,JATINEGARA,83563,63402,20161,6819,26980,2021-07-07
3175021004,JAKARTA TIMUR,PULO GADUNG,JATINEGARA KAUM,24364,16813,7551,2945,10496,2021-07-07
3173021004,JAKARTA BARAT,GROGOL PETAMBURAN,JELAMBAR,30180,18061,12119,5492,17611,2021-07-07
3173021006,JAKARTA BARAT,GROGOL PETAMBURAN,JELAMBAR BARU,37799,23390,14409,6094,20503,2021-07-07
3173041006,JAKARTA BARAT,TAMBORA,JEMBATAN BESI,29182,22303,6879,2430,9309,2021-07-07
3173041008,JAKARTA BARAT,TAMBORA,JEMBATAN LIMA,20627,14650,5977,2273,8250,2021-07-07
3173081005,JAKARTA BARAT,KEMBANGAN,JOGLO,40475,26789,13686,5969,19655,2021-07-07
3171081001,JAKARTA PUSAT,JOHAR BARU,JOHAR BARU,32845,18894,13951,5359,19310,2021-07-07
3173041002,JAKARTA BARAT,TAMBORA,KALI ANYAR,23582,17480,6102,2250,8352,2021-07-07
3172041004,JAKARTA UTARA,CILINCING,KALIBARU,67165,50684,16481,4362,20843,2021-07-07
3174081002,JAKARTA SELATAN,PANCORAN,KALIBATA,41464,28855,12609,4939,17548,2021-07-07
3173061001,JAKARTA BARAT,KALI DERES,KALIDERES,69014,46688,22326,7615,29941,2021-07-07
3175051004,JAKARTA TIMUR,PASAR REBO,KALISARI,42557,27668,14889,6804,21693,2021-07-07
3173061004,JAKARTA BARAT,KALI DERES,KAMAL,53180,40380,12800,3664,16464,2021-07-07
3172011002,JAKARTA UTARA,PENJARINGAN,KAMAL MUARA,12679,6734,5945,2520,8465,2021-07-07
3171071007,JAKARTA PUSAT,TANAH ABANG,KAMPUNG BALI,11551,8212,3339,1519,4858,2021-07-07
3175031001,JAKARTA TIMUR,JATINEGARA,KAMPUNG MELAYU,25476,19164,6312,2251,8563,2021-07-07
3171081002,JAKARTA PUSAT,JOHAR BARU,KAMPUNG RAWA,18247,9457,8790,2551,11341,2021-07-07
3175041002,JAKARTA TIMUR,KRAMAT JATI,KAMPUNG TENGAH,43668,31695,11973,5286,17259,2021-07-07
3173011005,JAKARTA BARAT,CENGKARENG,KAPUK,121994,86666,35328,9520,44848,2021-07-07
3172011003,JAKARTA UTARA,PENJARINGAN,KAPUK MUARA,35498,20997,14501,6681,21182,2021-07-07
3171021002,JAKARTA PUSAT,SAWAH BESAR,KARANG ANYAR,25865,16847,9018,3412,12430,2021-07-07
3174021004,JAKARTA SELATAN,SETIA BUDI,KARET,9581,5803,3778,1440,5218,2021-07-07
3174021003,JAKARTA SELATAN,SETIA BUDI,KARET KUNINGAN,15939,9604,6335,2336,8671,2021-07-07
3174021002,JAKARTA SELATAN,SETIA BUDI,KARET SEMANGGI,2746,1409,1337,602,1939,2021-07-07
3171071003,JAKARTA PUSAT,TANAH ABANG,KARET TENGSIN,19113,12917,6196,2218,8414,2021-07-07
3171021003,JAKARTA PUSAT,SAWAH BESAR,KARTINI,22303,13819,8484,3464,11948,2021-07-07
3175011003,JAKARTA TIMUR,MATRAMAN,KAYU MANIS,25138,17358,7780,3017,10797,2021-07-07
3175021006,JAKARTA TIMUR,PULO GADUNG,KAYU PUTIH,40378,24597,15781,7093,22874,2021-07-07
3173031006,JAKARTA BARAT,TAMAN SARI,KEAGUNGAN,17231,10987,6244,2005,8249,2021-07-07
3174041007,JAKARTA SELATAN,PASAR MINGGU,KEBAGUSAN,44010,30100,13910,5214,19124,2021-07-07
3174051006,JAKARTA SELATAN,KEBAYORAN LAMA,KEBAYORAN LAMA SELATAN,40895,25656,15239,5817,21056,2021-07-07
3174051001,JAKARTA SELATAN,KEBAYORAN LAMA,KEBAYORAN LAMA UTARA,42214,28919,13295,5271,18566,2021-07-07
3174011004,JAKARTA SELATAN,TEBET,KEBON BARU,34878,22732,12146,5144,17290,2021-07-07
3172021005,JAKARTA UTARA,TANJUNG PRIOK,KEBON BAWANG,50597,32414,18183,6953,25136,2021-07-07
3173051001,JAKARTA BARAT,KEBON JERUK,KEBON JERUK,53296,37126,16170,6803,22973,2021-07-07
3171071006,JAKARTA PUSAT,TANAH ABANG,KEBON KACANG,21376,15756,5620,2632,8252,2021-07-07
3171011005,JAKARTA PUSAT,GAMBIR,KEBON KELAPA,10380,6825,3555,1658,5213,2021-07-07
3171031002,JAKARTA PUSAT,KEMAYORAN,KEBON KOSONG,30003,20041,9962,3470,13432,2021-07-07
3175011005,JAKARTA TIMUR,MATRAMAN,KEBON MANGGIS,16393,10352,6041,2769,8810,2021-07-07
3171071005,JAKARTA PUSAT,TANAH ABANG,KEBON MELATI,31355,24548,6807,2864,9671,2021-07-07
3175081003,JAKARTA TIMUR,MAKASAR,KEBON PALA,46176,31660,14516,6198,20714,2021-07-07
3171061005,JAKARTA PUSAT,MENTENG,KEBON SIRIH,12256,8878,3378,1551,4929,2021-07-07
3173011004,JAKARTA BARAT,CENGKARENG,KEDAUNG KALI ANGKE,32185,19271,12914,3229,16143,2021-07-07
3173051007,JAKARTA BARAT,KEBON JERUK,KEDOYA SELATAN,31907,20338,11569,4618,16187,2021-07-07
3173051006,JAKARTA BARAT,KEBON JERUK,KEDOYA UTARA,43826,26151,17675,7008,24683,2021-07-07
3173051004,JAKARTA BARAT,KEBON JERUK,KELAPA DUA,23293,15291,8002,3146,11148,2021-07-07
3175091003,JAKARTA TIMUR,CIRACAS,KELAPA DUA WETAN,46441,30148,16293,7267,23560,2021-07-07
3172061003,JAKARTA UTARA,KELAPA GADING,KELAPA GADING BARAT,35403,18724,16679,8849,25528,2021-07-07
3172061001,JAKARTA UTARA,KELAPA GADING,KELAPA GADING TIMUR,33472,15850,17622,9149,26771,2021-07-07
3173071005,JAKARTA BARAT,PALMERAH,KEMANGGISAN,31952,20423,11529,5209,16738,2021-07-07
3171031001,JAKARTA PUSAT,KEMAYORAN,KEMAYORAN,20947,13068,7879,2825,10704,2021-07-07
3173081006,JAKARTA BARAT,KEMBANGAN,KEMBANGAN SELATAN,26920,16774,10146,5025,15171,2021-07-07
3173081001,JAKARTA BARAT,KEMBANGAN,KEMBANGAN UTARA,52368,33919,18449,6615,25064,2021-07-07
3171041002,JAKARTA PUSAT,SENEN,KENARI,9317,5405,3912,1745,5657,2021-07-07
3173041005,JAKARTA BARAT,TAMBORA,KERENDANG,19869,13911,5958,2224,8182,2021-07-07
3175071003,JAKARTA TIMUR,DUREN SAWIT,KLENDER,69321,50473,18848,7445,26293,2021-07-07
3172031001,JAKARTA UTARA,KOJA,KOJA,28036,19138,8898,2751,11649,2021-07-07
3173071006,JAKARTA BARAT,PALMERAH,KOTA BAMBU SELATAN,20926,14109,6817,2244,9061,2021-07-07
3173071003,JAKARTA BARAT,PALMERAH,KOTA BAMBU UTARA,24416,16968,7448,2776,10224,2021-07-07
3171041004,JAKARTA PUSAT,SENEN,KRAMAT,28661,20394,8267,2992,11259,2021-07-07
3175041001,JAKARTA TIMUR,KRAMAT JATI,KRAMAT JATI,33851,22775,11076,5033,16109,2021-07-07
3174071003,JAKARTA SELATAN,KEBAYORAN BARU,KRAMAT PELA,14340,8469,5871,2379,8250,2021-07-07
3173031002,JAKARTA BARAT,TAMAN SARI,KRUKUT,19130,12195,6935,2291,9226,2021-07-07
3174031005,JAKARTA SELATAN,MAMPANG PRAPATAN,KUNINGAN BARAT,12675,7869,4806,1550,6356,2021-07-07
3174021008,JAKARTA SELATAN,SETIA BUDI,KUNINGAN TIMUR,5982,3719,2263,1062,3325,2021-07-07
3171041005,JAKARTA PUSAT,SENEN,KWITANG,15295,9847,5448,2100,7548,2021-07-07
3172031003,JAKARTA UTARA,KOJA,LAGOA,58726,41796,16930,5659,22589,2021-07-07
3174061002,JAKARTA SELATAN,CILANDAK,LEBAK BULUS,37213,23995,13218,5911,19129,2021-07-07
3174091004,JAKARTA SELATAN,JAGAKARSA,LENTENG AGUNG,53453,37989,15464,6159,21623,2021-07-07
3175101007,JAKARTA TIMUR,CIPAYUNG,LUBANG BUAYA,62984,41312,21672,8426,30098,2021-07-07
3175081001,JAKARTA TIMUR,MAKASAR,MAKASAR,34062,21757,12305,4976,17281,2021-07-07
3175071006,JAKARTA TIMUR,DUREN SAWIT,MALAKA JAYA,30744,19413,11331,5500,16831,2021-07-07
3175071005,JAKARTA TIMUR,DUREN SAWIT,MALAKA SARI,27015,16547,10468,5429,15897,2021-07-07
3174031001,JAKARTA SELATAN,MAMPANG PRAPATAN,MAMPANG PRAPATAN,18046,12241,5805,2059,7864,2021-07-07
3173031005,JAKARTA BARAT,TAMAN SARI,MANGGA BESAR,7439,3945,3494,1448,4942,2021-07-07
3171021005,JAKARTA PUSAT,SAWAH BESAR,MANGGA DUA SELATAN,27767,18010,9757,3863,13620,2021-07-07
3174011007,JAKARTA SELATAN,TEBET,MANGGARAI,28388,19263,9125,3565,12690,2021-07-07
3174011006,JAKARTA SELATAN,TEBET,MANGGARAI SELATAN,22902,14052,8850,3218,12068,2021-07-07
3173031003,JAKARTA BARAT,TAMAN SARI,MAPHAR,16385,10088,6297,2570,8867,2021-07-07
3172041003,JAKARTA UTARA,CILINCING,MARUNDA,28614,17780,10834,2588,13422,2021-07-07
3174071001,JAKARTA SELATAN,KEBAYORAN BARU,MELAWAI,2634,1293,1341,830,2171,2021-07-07
3171061001,JAKARTA PUSAT,MENTENG,MENTENG,25280,18133,7147,3529,10676,2021-07-07
3174021005,JAKARTA SELATAN,SETIA BUDI,MENTENG ATAS,27671,17291,10380,4039,14419,2021-07-07
3174011003,JAKARTA SELATAN,TEBET,MENTENG DALAM,35936,23814,12122,5199,17321,2021-07-07
3173081003,JAKARTA BARAT,KEMBANGAN,MERUYA SELATAN,31227,20423,10804,4337,15141,2021-07-07
3173081002,JAKARTA BARAT,KEMBANGAN,MERUYA UTARA,43382,28220,15162,6966,22128,2021-07-07
3175101004,JAKARTA TIMUR,CIPAYUNG,MUNJUL,23570,15932,7638,3603,11241,2021-07-07
3172051002,JAKARTA UTARA,PADEMANGAN,PADEMANGAN BARAT,73841,50798,23043,7810,30853,2021-07-07
3172051001,JAKARTA UTARA,PADEMANGAN,PADEMANGAN TIMUR,36757,20226,16531,6897,23428,2021-07-07
3175011004,JAKARTA TIMUR,MATRAMAN,PAL MERIAM,19632,12874,6758,2722,9480,2021-07-07
3173071001,JAKARTA BARAT,PALMERAH,PALMERAH,62175,41147,21028,8022,29050,2021-07-07
3174081001,JAKARTA SELATAN,PANCORAN,PANCORAN,19301,12635,6666,2659,9325,2021-07-07
3172021003,JAKARTA UTARA,TANJUNG PRIOK,PAPANGGO,38871,24652,14219,4732,18951,2021-07-07
3171021001,JAKARTA PUSAT,SAWAH BESAR,PASAR BARU,12710,6718,5992,2918,8910,2021-07-07
3174021006,JAKARTA SELATAN,SETIA BUDI,PASAR MANGGIS,26572,17113,9459,3551,13010,2021-07-07
3174041001,JAKARTA SELATAN,PASAR MINGGU,PASAR MINGGU,24670,15885,8785,4581,13366,2021-07-07
3171041003,JAKARTA PUSAT,SENEN,PASEBAN,23321,15193,8128,3312,11440,2021-07-07
3173061005,JAKARTA BARAT,KALI DERES,PEGADUNGAN,74685,49166,25519,9128,34647,2021-07-07
3171061002,JAKARTA PUSAT,MENTENG,PEGANGSAAN,21120,14243,6877,2948,9825,2021-07-07
3172061002,JAKARTA UTARA,KELAPA GADING,PEGANGSAAN DUA,49632,25535,24097,10522,34619,2021-07-07
3172011004,JAKARTA UTARA,PENJARINGAN,PEJAGALAN,74043,46052,27991,10933,38924,2021-07-07
3174041006,JAKARTA SELATAN,PASAR MINGGU,PEJATEN BARAT,35061,21928,13133,5614,18747,2021-07-07
3174041005,JAKARTA SELATAN,PASAR MINGGU,PEJATEN TIMUR,57257,39596,17661,6063,23724,2021-07-07
3175051005,JAKARTA TIMUR,PASAR REBO,PEKAYON,42705,27725,14980,6108,21088,2021-07-07
3173041009,JAKARTA BARAT,TAMBORA,PEKOJAN,23428,14808,8620,3421,12041,2021-07-07
3174031003,JAKARTA SELATAN,MAMPANG PRAPATAN,PELA MAMPANG,42709,28007,14702,5645,20347,2021-07-07
3174081005,JAKARTA SELATAN,PANCORAN,PENGADEGAN,21111,12040,9071,3334,12405,2021-07-07
3175061003,JAKARTA TIMUR,CAKUNG,PENGGILINGAN,97138,73188,23950,9395,33345,2021-07-07
3172011001,JAKARTA UTARA,PENJARINGAN,PENJARINGAN,86712,60090,26622,7858,34480,2021-07-07
3174101001,JAKARTA SELATAN,PESANGGRAHAN,PESANGGRAHAN,27215,16057,11158,4889,16047,2021-07-07
3171071004,JAKARTA PUSAT,TANAH ABANG,PETAMBURAN,33060,25586,7474,2939,10413,2021-07-07
3174071008,JAKARTA SELATAN,KEBAYORAN BARU,PETOGOGAN,11418,7009,4409,1857,6266,2021-07-07
3171011004,JAKARTA PUSAT,GAMBIR,PETOJO SELATAN,14946,9241,5705,3005,8710,2021-07-07
3171011003,JAKARTA PUSAT,GAMBIR,PETOJO UTARA,17843,11809,6034,2701,8735,2021-07-07
3174101004,JAKARTA SELATAN,PESANGGRAHAN,PETUKANGAN SELATAN,36769,23643,13126,4924,18050,2021-07-07
3174101003,JAKARTA SELATAN,PESANGGRAHAN,PETUKANGAN UTARA,53184,35454,17730,6747,24477,2021-07-07
3175081002,JAKARTA TIMUR,MAKASAR,PINANG RANTI,26915,17390,9525,3463,12988,2021-07-07
3173031008,JAKARTA BARAT,TAMAN SARI,PINANGSIA,10583,6168,4415,1635,6050,2021-07-07
3175011001,JAKARTA TIMUR,MATRAMAN,PISANGAN BARU,31537,22700,8837,3826,12663,2021-07-07
3175021002,JAKARTA TIMUR,PULO GADUNG,PISANGAN TIMUR,40576,26663,13913,5680,19593,2021-07-07
3172011005,JAKARTA UTARA,PENJARINGAN,PLUIT,47433,25637,21796,12350,34146,2021-07-07
3175071002,JAKARTA TIMUR,DUREN SAWIT,PONDOK BAMBU,61047,40346,20701,8910,29611,2021-07-07
3175071004,JAKARTA TIMUR,DUREN SAWIT,PONDOK KELAPA,71347,46337,25010,10998,36008,2021-07-07
3175071007,JAKARTA TIMUR,DUREN SAWIT,PONDOK KOPI,35051,24923,10128,4362,14490,2021-07-07
3174061003,JAKARTA SELATAN,CILANDAK,PONDOK LABU,45944,28914,17030,6891,23921,2021-07-07
3174051002,JAKARTA SELATAN,KEBAYORAN LAMA,PONDOK PINANG,55724,36509,19215,9546,28761,2021-07-07
3175101003,JAKARTA TIMUR,CIPAYUNG,PONDOK RANGGON,25123,17396,7727,3792,11519,2021-07-07
3101011003,KAB.ADM.KEP.SERIBU,KEP. SERIBU UTARA,PULAU HARAPAN,2036,667,1369,670,2039,2021-07-07
3101011002,KAB.ADM.KEP.SERIBU,KEP. SERIBU UTARA,PULAU KELAPA,5460,1787,3673,1082,4755,2021-07-07
3101011001,KAB.ADM.KEP.SERIBU,KEP. SERIBU UTARA,PULAU PANGGANG,5395,1745,3650,1147,4797,2021-07-07
3101021003,KAB.ADM.KEP.SERIBU,KEP. SERIBU SELATAN,PULAU PARI,2736,618,2118,614,2732,2021-07-07
3101021002,KAB.ADM.KEP.SERIBU,KEP. SERIBU SELATAN,PULAU TIDUNG,4528,1411,3117,1133,4250,2021-07-07
3101021001,KAB.ADM.KEP.SERIBU,KEP. SERIBU SELATAN,PULAU UNTUNG JAWA,1918,562,1356,559,1915,2021-07-07
3174071007,JAKARTA SELATAN,KEBAYORAN BARU,PULO,5777,3105,2672,1353,4025,2021-07-07
3175021001,JAKARTA TIMUR,PULO GADUNG,PULO GADUNG,34175,23261,10914,4671,15585,2021-07-07
3175061005,JAKARTA TIMUR,CAKUNG,PULO GEBANG,95947,68538,27409,10700,38109,2021-07-07
3174041004,JAKARTA SELATAN,PASAR MINGGU,RAGUNAN,39233,24155,15078,5827,20905,2021-07-07
3175091005,JAKARTA TIMUR,CIRACAS,RAMBUTAN,36368,26791,9577,4303,13880,2021-07-07
3172031006,JAKARTA UTARA,KOJA,RAWA BADAK SELATAN,41895,30465,11430,3949,15379,2021-07-07
3172031004,JAKARTA UTARA,KOJA,RAWA BADAK UTARA,33538,21774,11764,3867,15631,2021-07-07
3174071005,JAKARTA SELATAN,KEBAYORAN BARU,RAWA BARAT,5574,3179,2395,1330,3725,2021-07-07
3173011003,JAKARTA BARAT,CENGKARENG,RAWA BUAYA,59533,39836,19697,6002,25699,2021-07-07
3175031004,JAKARTA TIMUR,JATINEGARA,RAWA BUNGA,21272,15385,5887,2471,8358,2021-07-07
3174081003,JAKARTA SELATAN,PANCORAN,RAWA JATI,20321,12618,7703,3427,11130,2021-07-07
3175061002,JAKARTA TIMUR,CAKUNG,RAWA TERATE,24433,15807,8626,2131,10757,2021-07-07
3175021005,JAKARTA TIMUR,PULO GADUNG,RAWAMANGUN,36788,24035,12753,5869,18622,2021-07-07
3171051003,JAKARTA PUSAT,CEMPAKA PUTIH,RAWASARI,21770,13911,7859,3494,11353,2021-07-07
3173041010,JAKARTA BARAT,TAMBORA,ROA MALAKA,3449,1745,1704,883,2587,2021-07-07
3172041006,JAKARTA UTARA,CILINCING,ROROTAN,40953,26341,14612,4608,19220,2021-07-07
3174071004,JAKARTA SELATAN,KEBAYORAN BARU,SELONG,2843,1446,1397,884,2281,2021-07-07
3173061002,JAKARTA BARAT,KALI DERES,SEMANAN,70293,51992,18301,5001,23302,2021-07-07
3172041007,JAKARTA UTARA,CILINCING,SEMPER BARAT,67899,42368,25531,9103,34634,2021-07-07
3172041005,JAKARTA UTARA,CILINCING,SEMPER TIMUR,36029,23456,12573,4320,16893,2021-07-07
3174071006,JAKARTA SELATAN,KEBAYORAN BARU,SENAYAN,2780,1779,1001,574,1575,2021-07-07
3171041001,JAKARTA PUSAT,SENEN,SENEN,6757,4249,2508,1182,3690,2021-07-07
3171031004,JAKARTA PUSAT,KEMAYORAN,SERDANG,29730,19401,10329,3952,14281,2021-07-07
3174021001,JAKARTA SELATAN,SETIA BUDI,SETIA BUDI,2841,1657,1184,646,1830,2021-07-07
3175101005,JAKARTA TIMUR,CIPAYUNG,SETU,20306,14609,5697,2679,8376,2021-07-07
3173071002,JAKARTA BARAT,PALMERAH,SLIPI,16475,10191,6284,2734,9018,2021-07-07
3173081004,JAKARTA BARAT,KEMBANGAN,SRENGSENG,44969,31223,13746,6178,19924,2021-07-07
3174091002,JAKARTA SELATAN,JAGAKARSA,SRENGSENG SAWAH,57480,33850,23630,8903,32533,2021-07-07
3173051003,JAKARTA BARAT,KEBON JERUK,SUKABUMI SELATAN,35170,24662,10508,3483,13991,2021-07-07
3173051002,JAKARTA BARAT,KEBON JERUK,SUKABUMI UTARA,37628,27307,10321,4022,14343,2021-07-07
3172041002,JAKARTA UTARA,CILINCING,SUKAPURA,53786,36569,17217,5467,22684,2021-07-07
3171031007,JAKARTA PUSAT,KEMAYORAN,SUMUR BATU,22506,14205,8301,3410,11711,2021-07-07
3172021004,JAKARTA UTARA,TANJUNG PRIOK,SUNGAI BAMBU,29115,18009,11106,3560,14666,2021-07-07
3172021006,JAKARTA UTARA,TANJUNG PRIOK,SUNTER AGUNG,70860,39628,31232,13534,44766,2021-07-07
3172021002,JAKARTA UTARA,TANJUNG PRIOK,SUNTER JAYA,62516,38056,24460,10490,34950,2021-07-07
3175091004,JAKARTA TIMUR,CIRACAS,SUSUKAN,33525,22020,11505,4618,16123,2021-07-07
3173031001,JAKARTA BARAT,TAMAN SARI,TAMAN SARI,14281,8770,5511,2396,7907,2021-07-07
3173041001,JAKARTA BARAT,TAMBORA,TAMBORA,10177,6620,3557,1521,5078,2021-07-07
3173041004,JAKARTA BARAT,TAMBORA,TANAH SEREAL,25944,15515,10429,3890,14319,2021-07-07
3171081004,JAKARTA PUSAT,JOHAR BARU,TANAH TINGGI,37800,23898,13902,4259,18161,2021-07-07
3173031004,JAKARTA BARAT,TAMAN SARI,TANGKI,12991,8006,4985,1931,6916,2021-07-07
3174091005,JAKARTA SELATAN,JAGAKARSA,TANJUNG BARAT,39368,26915,12453,5698,18151,2021-07-07
3173021005,JAKARTA BARAT,GROGOL PETAMBURAN,TANJUNG DUREN SELATAN,24917,13995,10922,4489,15411,2021-07-07
3173021002,JAKARTA BARAT,GROGOL PETAMBURAN,TANJUNG DUREN UTARA,16940,9006,7934,3536,11470,2021-07-07
3172021001,JAKARTA UTARA,TANJUNG PRIOK,TANJUNG PRIOK,34316,21095,13221,3840,17061,2021-07-07
3174011002,JAKARTA SELATAN,TEBET,TEBET BARAT,21164,12634,8530,4209,12739,2021-07-07
3174011001,JAKARTA SELATAN,TEBET,TEBET TIMUR,18030,10026,8004,3761,11765,2021-07-07
3173061003,JAKARTA BARAT,KALI DERES,TEGAL ALUR,82647,58096,24551,6866,31417,2021-07-07
3174031004,JAKARTA SELATAN,MAMPANG PRAPATAN,TEGAL PARANG,32174,23587,8587,3320,11907,2021-07-07
3173021003,JAKARTA BARAT,GROGOL PETAMBURAN,TOMANG,28665,17113,11552,4991,16543,2021-07-07
3172031005,JAKARTA UTARA,KOJA,TUGU SELATAN,38749,27438,11311,3834,15145,2021-07-07
3172031002,JAKARTA UTARA,KOJA,TUGU UTARA,67211,47936,19275,6759,26034,2021-07-07
3175061006,JAKARTA TIMUR,CAKUNG,UJUNG MENTENG,29527,19587,9940,3992,13932,2021-07-07
3174101005,JAKARTA SELATAN,PESANGGRAHAN,ULUJAMI,40120,28179,11941,4950,16891,2021-07-07
3175011006,JAKARTA TIMUR,MATRAMAN,UTAN KAYU SELATAN,33233,21228,12005,5063,17068,2021-07-07
3175011002,JAKARTA TIMUR,MATRAMAN,UTAN KAYU UTARA,27995,18074,9921,3834,13755,2021-07-07
3171031008,JAKARTA PUSAT,KEMAYORAN,UTAN PANJANG,29260,20964,8296,2806,11102,2021-07-07
3172021007,JAKARTA UTARA,TANJUNG PRIOK,WARAKAS,43754,28384,15370,5234,20604,2021-07-07
3173021007,JAKARTA BARAT,GROGOL PETAMBURAN,WIJAYA KUSUMA,38584,25455,13129,4870,17999,2021-07-07
3172051003,JAKARTA UTARA,PADEMANGAN,ANCOL,23379,15492,7887,3310,11197,2021-07-08
3173041007,JAKARTA BARAT,TAMBORA,ANGKE,29230,18677,10553,3247,13800,2021-07-08
3175041005,JAKARTA TIMUR,KRAMAT JATI,BALE KAMBANG,28803,21759,7044,2678,9722,2021-07-08
3175031003,JAKARTA TIMUR,JATINEGARA,BALI MESTER,9675,6391,3284,1536,4820,2021-07-08
3175101006,JAKARTA TIMUR,CIPAYUNG,BAMBU APUS,25985,17727,8258,4012,12270,2021-07-08
3174031002,JAKARTA SELATAN,MAMPANG PRAPATAN,BANGKA,21356,14147,7209,2738,9947,2021-07-08
3175051002,JAKARTA TIMUR,PASAR REBO,BARU,23514,13776,9738,4711,14449,2021-07-08
3175041004,JAKARTA TIMUR,KRAMAT JATI,BATU AMPAR,47416,34979,12437,5318,17755,2021-07-08
3171071002,JAKARTA PUSAT,TANAH ABANG,BENDUNGAN HILIR,21374,13069,8305,3603,11908,2021-07-08
3175031002,JAKARTA TIMUR,JATINEGARA,BIDARA CINA,36461,26333,10128,4071,14199,2021-07-08
3174101002,JAKARTA SELATAN,PESANGGRAHAN,BINTARO,52402,35455,16947,7133,24080,2021-07-08
3174011005,JAKARTA SELATAN,TEBET,BUKIT DURI,33953,23188,10765,3983,14748,2021-07-08
3171041006,JAKARTA PUSAT,SENEN,BUNGUR,17929,11125,6804,2765,9569,2021-07-08
3175061007,JAKARTA TIMUR,CAKUNG,CAKUNG BARAT,57222,38460,18762,4055,22817,2021-07-08
3175061004,JAKARTA TIMUR,CAKUNG,CAKUNG TIMUR,57655,38365,19290,6460,25750,2021-07-08
3175041007,JAKARTA TIMUR,KRAMAT JATI,CAWANG,32481,22200,10281,4324,14605,2021-07-08
3175101008,JAKARTA TIMUR,CIPAYUNG,CEGER,18740,12564,6176,2589,8765,2021-07-08
3171031006,JAKARTA PUSAT,KEMAYORAN,CEMPAKA BARU,31257,21352,9905,4044,13949,2021-07-08
3171051002,JAKARTA PUSAT,CEMPAKA PUTIH,CEMPAKA PUTIH BARAT,34725,23651,11074,5002,16076,2021-07-08
3171051001,JAKARTA PUSAT,CEMPAKA PUTIH,CEMPAKA PUTIH TIMUR,24170,14866,9304,4488,13792,2021-07-08
3173011001,JAKARTA BARAT,CENGKARENG,CENGKARENG BARAT,65702,40354,25348,8282,33630,2021-07-08
3173011006,JAKARTA BARAT,CENGKARENG,CENGKARENG TIMUR,80100,52726,27374,8551,35925,2021-07-08
3175091002,JAKARTA TIMUR,CIRACAS,CIBUBUR,65231,42064,23167,9574,32741,2021-07-08
3171011002,JAKARTA PUSAT,GAMBIR,CIDENG,15696,9071,6625,3208,9833,2021-07-08
3174091003,JAKARTA SELATAN,JAGAKARSA,CIGANJUR,38048,25058,12990,5206,18196,2021-07-08
3175051003,JAKARTA TIMUR,PASAR REBO,CIJANTUNG,41013,26443,14570,6245,20815,2021-07-08
3171061003,JAKARTA PUSAT,MENTENG,CIKINI,8260,5449,2811,1378,4189,2021-07-08
3174081006,JAKARTA SELATAN,PANCORAN,CIKOKO,10503,6250,4253,1765,6018,2021-07-08
3174061001,JAKARTA SELATAN,CILANDAK,CILANDAK BARAT,51346,30488,20858,7946,28804,2021-07-08
3174041003,JAKARTA SELATAN,PASAR MINGGU,CILANDAK TIMUR,24239,14689,9550,4878,14428,2021-07-08
3175101002,JAKARTA TIMUR,CIPAYUNG,CILANGKAP,27179,18167,9012,3834,12846,2021-07-08
3175041006,JAKARTA TIMUR,KRAMAT JATI,CILILITAN,39984,28090,11894,5308,17202,2021-07-08
3172041001,JAKARTA UTARA,CILINCING,CILINCING,42677,30205,12472,3957,16429,2021-07-08
3175101001,JAKARTA TIMUR,CIPAYUNG,CIPAYUNG,25747,16016,9731,4268,13999,2021-07-08
3174091006,JAKARTA SELATAN,JAGAKARSA,CIPEDAK,37809,24075,13734,4838,18572,2021-07-08
3174061005,JAKARTA SELATAN,CILANDAK,CIPETE SELATAN,26500,16831,9669,3844,13513,2021-07-08
3174071010,JAKARTA SELATAN,KEBAYORAN BARU,CIPETE UTARA,33902,21061,12841,4128,16969,2021-07-08
3175021003,JAKARTA TIMUR,PULO GADUNG,CIPINANG,39069,25563,13506,6096,19602,2021-07-08
3175031007,JAKARTA TIMUR,JATINEGARA,CIPINANG BESAR SELATAN,34938,25767,9171,3931,13102,2021-07-08
3175031008,JAKARTA TIMUR,JATINEGARA,CIPINANG BESAR UTARA,44479,34192,10287,4220,14507,2021-07-08
3175031005,JAKARTA TIMUR,JATINEGARA,CIPINANG CEMPEDAK,32695,22483,10212,4731,14943,2021-07-08
3175081005,JAKARTA TIMUR,MAKASAR,CIPINANG MELAYU,42144,27202,14942,6448,21390,2021-07-08
3175031006,JAKARTA TIMUR,JATINEGARA,CIPINANG MUARA,53251,37972,15279,7351,22630,2021-07-08
3174051003,JAKARTA SELATAN,KEBAYORAN LAMA,CIPULIR,39635,27151,12484,4832,17316,2021-07-08
3175091001,JAKARTA TIMUR,CIRACAS,CIRACAS,63801,41587,22214,8487,30701,2021-07-08
3175041003,JAKARTA TIMUR,KRAMAT JATI,DUKUH,24404,16685,7719,3535,11254,2021-07-08
3175071001,JAKARTA TIMUR,DUREN SAWIT,DUREN SAWIT,60443,40319,20124,9309,29433,2021-07-08
3174081004,JAKARTA SELATAN,PANCORAN,DUREN TIGA,28099,18021,10078,3858,13936,2021-07-08
3173051005,JAKARTA BARAT,KEBON JERUK,DURI KEPA,59448,35510,23938,10032,33970,2021-07-08
3173011002,JAKARTA BARAT,CENGKARENG,DURI KOSAMBI,75895,50190,25705,8240,33945,2021-07-08
3171011006,JAKARTA PUSAT,GAMBIR,DURI PULO,19986,13837,6149,2406,8555,2021-07-08
3173041011,JAKARTA BARAT,TAMBORA,DURI SELATAN,14099,8773,5326,2374,7700,2021-07-08
3173041003,JAKARTA BARAT,TAMBORA,DURI UTARA,19768,13037,6731,2648,9379,2021-07-08
3171081003,JAKARTA PUSAT,JOHAR BARU,GALUR,18098,10830,7268,1978,9246,2021-07-08
3171011001,JAKARTA PUSAT,GAMBIR,GAMBIR,2434,1366,1068,582,1650,2021-07-08
3174061004,JAKARTA SELATAN,CILANDAK,GANDARIA SELATAN,21926,13901,8025,2855,10880,2021-07-08
3174071009,JAKARTA SELATAN,KEBAYORAN BARU,GANDARIA UTARA,39609,25275,14334,5385,19719,2021-07-08
3175051001,JAKARTA TIMUR,PASAR REBO,GEDONG,35444,23620,11824,5326,17150,2021-07-08
3171071001,JAKARTA PUSAT,TANAH ABANG,GELORA,3106,1963,1143,571,1714,2021-07-08
3173031007,JAKARTA BARAT,TAMAN SARI,GLODOK,7836,3776,4060,1982,6042,2021-07-08
3171061004,JAKARTA PUSAT,MENTENG,GONDANGDIA,4093,2097,1996,1298,3294,2021-07-08
3173021001,JAKARTA BARAT,GROGOL PETAMBURAN,GROGOL,16815,10591,6224,2617,8841,2021-07-08
3174051005,JAKARTA SELATAN,KEBAYORAN LAMA,GROGOL SELATAN,43915,30447,13468,5483,18951,2021-07-08
3174051004,JAKARTA SELATAN,KEBAYORAN LAMA,GROGOL UTARA,42216,28908,13308,5871,19179,2021-07-08
3174021007,JAKARTA SELATAN,SETIA BUDI,GUNTUR,3962,2165,1797,993,2790,2021-07-08
3174071002,JAKARTA SELATAN,KEBAYORAN BARU,GUNUNG,9344,5433,3911,2047,5958,2021-07-08
3171031005,JAKARTA PUSAT,KEMAYORAN,GUNUNG SAHARI SELATAN,19380,12307,7073,2829,9902,2021-07-08
3171021004,JAKARTA PUSAT,SAWAH BESAR,GUNUNG SAHARI UTARA,15647,8252,7395,3387,10782,2021-07-08
3175081004,JAKARTA TIMUR,MAKASAR,HALIM PERDANA KUSUMAH,28110,13560,14550,9328,23878,2021-07-08
3171031003,JAKARTA PUSAT,KEMAYORAN,HARAPAN MULIA,22700,15499,7201,2707,9908,2021-07-08
3174091001,JAKARTA SELATAN,JAGAKARSA,JAGAKARSA,61552,38107,23445,8565,32010,2021-07-08
3175021007,JAKARTA TIMUR,PULO GADUNG,JATI,32443,20910,11533,5640,17173,2021-07-08
3174041002,JAKARTA SELATAN,PASAR MINGGU,JATI PADANG,37250,23731,13519,5884,19403,2021-07-08
3173071004,JAKARTA BARAT,PALMERAH,JATI PULO,27994,16890,11104,3678,14782,2021-07-08
3175061001,JAKARTA TIMUR,CAKUNG,JATINEGARA,83563,63007,20556,6822,27378,2021-07-08
3175021004,JAKARTA TIMUR,PULO GADUNG,JATINEGARA KAUM,24364,16715,7649,2949,10598,2021-07-08
3173021004,JAKARTA BARAT,GROGOL PETAMBURAN,JELAMBAR,30180,18008,12172,5497,17669,2021-07-08
3173021006,JAKARTA BARAT,GROGOL PETAMBURAN,JELAMBAR BARU,37799,23223,14576,6096,20672,2021-07-08
3173041006,JAKARTA BARAT,TAMBORA,JEMBATAN BESI,29182,22242,6940,2431,9371,2021-07-08
3173041008,JAKARTA BARAT,TAMBORA,JEMBATAN LIMA,20627,14578,6049,2274,8323,2021-07-08
3173081005,JAKARTA BARAT,KEMBANGAN,JOGLO,40475,26679,13796,5972,19768,2021-07-08
3171081001,JAKARTA PUSAT,JOHAR BARU,JOHAR BARU,32845,18773,14072,5360,19432,2021-07-08
3173041002,JAKARTA BARAT,TAMBORA,KALI ANYAR,23582,17410,6172,2250,8422,2021-07-08
3172041004,JAKARTA UTARA,CILINCING,KALIBARU,67165,50308,16857,4365,21222,2021-07-08
3174081002,JAKARTA SELATAN,PANCORAN,KALIBATA,41464,28714,12750,4944,17694,2021-07-08
3173061001,JAKARTA BARAT,KALI DERES,KALIDERES,69014,46507,22507,7624,30131,2021-07-08
3175051004,JAKARTA TIMUR,PASAR REBO,KALISARI,42557,27500,15057,6816,21873,2021-07-08
3173061004,JAKARTA BARAT,KALI DERES,KAMAL,53180,40243,12937,3669,16606,2021-07-08
3172011002,JAKARTA UTARA,PENJARINGAN,KAMAL MUARA,12679,6662,6017,2522,8539,2021-07-08
3171071007,JAKARTA PUSAT,TANAH ABANG,KAMPUNG BALI,11551,8148,3403,1519,4922,2021-07-08
3175031001,JAKARTA TIMUR,JATINEGARA,KAMPUNG MELAYU,25476,19008,6468,2251,8719,2021-07-08
3171081002,JAKARTA PUSAT,JOHAR BARU,KAMPUNG RAWA,18247,9400,8847,2551,11398,2021-07-08
3175041002,JAKARTA TIMUR,KRAMAT JATI,KAMPUNG TENGAH,43668,31585,12083,5287,17370,2021-07-08
3173011005,JAKARTA BARAT,CENGKARENG,KAPUK,121994,86229,35765,9524,45289,2021-07-08
3172011003,JAKARTA UTARA,PENJARINGAN,KAPUK MUARA,35498,20786,14712,6689,21401,2021-07-08
3171021002,JAKARTA PUSAT,SAWAH BESAR,KARANG ANYAR,25865,16742,9123,3413,12536,2021-07-08
3174021004,JAKARTA SELATAN,SETIA BUDI,KARET,9581,5765,3816,1440,5256,2021-07-08
3174021003,JAKARTA SELATAN,SETIA BUDI,KARET KUNINGAN,15939,9522,6417,2340,8757,2021-07-08
3174021002,JAKARTA SELATAN,SETIA BUDI,KARET SEMANGGI,2746,1398,1348,602,1950,2021-07-08
3171071003,JAKARTA PUSAT,TANAH ABANG,KARET TENGSIN,19113,12821,6292,2219,8511,2021-07-08
3171021003,JAKARTA PUSAT,SAWAH BESAR,KARTINI,22303,13734,8569,3466,12035,2021-07-08
3175011003,JAKARTA TIMUR,MATRAMAN,KAYU MANIS,25138,17243,7895,3017,10912,2021-07-08
3175021006,JAKARTA TIMUR,PULO GADUNG,KAYU PUTIH,40378,24381,15997,7101,23098,2021-07-08
3173031006,JAKARTA BARAT,TAMAN SARI,KEAGUNGAN,17231,10910,6321,2006,8327,2021-07-08
3174041007,JAKARTA SELATAN,PASAR MINGGU,KEBAGUSAN,44010,29933,14077,5218,19295,2021-07-08
3174051006,JAKARTA SELATAN,KEBAYORAN LAMA,KEBAYORAN LAMA SELATAN,40895,25543,15352,5822,21174,2021-07-08
3174051001,JAKARTA SELATAN,KEBAYORAN LAMA,KEBAYORAN LAMA UTARA,42214,28757,13457,5278,18735,2021-07-08
3174011004,JAKARTA SELATAN,TEBET,KEBON BARU,34878,22570,12308,5148,17456,2021-07-08
3172021005,JAKARTA UTARA,TANJUNG PRIOK,KEBON BAWANG,50597,32099,18498,6957,25455,2021-07-08
3173051001,JAKARTA BARAT,KEBON JERUK,KEBON JERUK,53296,36917,16379,6810,23189,2021-07-08
3171071006,JAKARTA PUSAT,TANAH ABANG,KEBON KACANG,21376,15690,5686,2638,8324,2021-07-08
3171011005,JAKARTA PUSAT,GAMBIR,KEBON KELAPA,10380,6771,3609,1660,5269,2021-07-08
3171031002,JAKARTA PUSAT,KEMAYORAN,KEBON KOSONG,30003,19930,10073,3473,13546,2021-07-08
3175011005,JAKARTA TIMUR,MATRAMAN,KEBON MANGGIS,16393,10300,6093,2783,8876,2021-07-08
3171071005,JAKARTA PUSAT,TANAH ABANG,KEBON MELATI,31355,24467,6888,2867,9755,2021-07-08
3175081003,JAKARTA TIMUR,MAKASAR,KEBON PALA,46176,31512,14664,6201,20865,2021-07-08
3171061005,JAKARTA PUSAT,MENTENG,KEBON SIRIH,12256,8836,3420,1552,4972,2021-07-08
3173011004,JAKARTA BARAT,CENGKARENG,KEDAUNG KALI ANGKE,32185,19067,13118,3231,16349,2021-07-08
3173051007,JAKARTA BARAT,KEBON JERUK,KEDOYA SELATAN,31907,20253,11654,4622,16276,2021-07-08
3173051006,JAKARTA BARAT,KEBON JERUK,KEDOYA UTARA,43826,26000,17826,7010,24836,2021-07-08
3173051004,JAKARTA BARAT,KEBON JERUK,KELAPA DUA,23293,15222,8071,3148,11219,2021-07-08
3175091003,JAKARTA TIMUR,CIRACAS,KELAPA DUA WETAN,46441,29999,16442,7283,23725,2021-07-08
3172061003,JAKARTA UTARA,KELAPA GADING,KELAPA GADING BARAT,35403,18405,16998,8855,25853,2021-07-08
3172061001,JAKARTA UTARA,KELAPA GADING,KELAPA GADING TIMUR,33472,15678,17794,9156,26950,2021-07-08
3173071005,JAKARTA BARAT,PALMERAH,KEMANGGISAN,31952,20314,11638,5217,16855,2021-07-08
3171031001,JAKARTA PUSAT,KEMAYORAN,KEMAYORAN,20947,12999,7948,2828,10776,2021-07-08
3173081006,JAKARTA BARAT,KEMBANGAN,KEMBANGAN SELATAN,26920,16671,10249,5031,15280,2021-07-08
3173081001,JAKARTA BARAT,KEMBANGAN,KEMBANGAN UTARA,52368,33661,18707,6623,25330,2021-07-08
3171041002,JAKARTA PUSAT,SENEN,KENARI,9317,5385,3932,1746,5678,2021-07-08
3173041005,JAKARTA BARAT,TAMBORA,KERENDANG,19869,13826,6043,2225,8268,2021-07-08
3175071003,JAKARTA TIMUR,DUREN SAWIT,KLENDER,69321,50258,19063,7452,26515,2021-07-08
3172031001,JAKARTA UTARA,KOJA,KOJA,28036,19031,9005,2756,11761,2021-07-08
3173071006,JAKARTA BARAT,PALMERAH,KOTA BAMBU SELATAN,20926,14016,6910,2245,9155,2021-07-08
3173071003,JAKARTA BARAT,PALMERAH,KOTA BAMBU UTARA,24416,16847,7569,2778,10347,2021-07-08
3171041004,JAKARTA PUSAT,SENEN,KRAMAT,28661,20290,8371,2996,11367,2021-07-08
3175041001,JAKARTA TIMUR,KRAMAT JATI,KRAMAT JATI,33851,22641,11210,5039,16249,2021-07-08
3174071003,JAKARTA SELATAN,KEBAYORAN BARU,KRAMAT PELA,14340,8378,5962,2379,8341,2021-07-08
3173031002,JAKARTA BARAT,TAMAN SARI,KRUKUT,19130,12148,6982,2292,9274,2021-07-08
3174031005,JAKARTA SELATAN,MAMPANG PRAPATAN,KUNINGAN BARAT,12675,7776,4899,1550,6449,2021-07-08
3174021008,JAKARTA SELATAN,SETIA BUDI,KUNINGAN TIMUR,5982,3671,2311,1063,3374,2021-07-08
3171041005,JAKARTA PUSAT,SENEN,KWITANG,15295,9808,5487,2100,7587,2021-07-08
3172031003,JAKARTA UTARA,KOJA,LAGOA,58726,41562,17164,5660,22824,2021-07-08
3174061002,JAKARTA SELATAN,CILANDAK,LEBAK BULUS,37213,23806,13407,5917,19324,2021-07-08
3174091004,JAKARTA SELATAN,JAGAKARSA,LENTENG AGUNG,53453,37786,15667,6164,21831,2021-07-08
3175101007,JAKARTA TIMUR,CIPAYUNG,LUBANG BUAYA,62984,41070,21914,8430,30344,2021-07-08
3175081001,JAKARTA TIMUR,MAKASAR,MAKASAR,34062,21665,12397,4978,17375,2021-07-08
3175071006,JAKARTA TIMUR,DUREN SAWIT,MALAKA JAYA,30744,19303,11441,5504,16945,2021-07-08
3175071005,JAKARTA TIMUR,DUREN SAWIT,MALAKA SARI,27015,16431,10584,5434,16018,2021-07-08
3174031001,JAKARTA SELATAN,MAMPANG PRAPATAN,MAMPANG PRAPATAN,18046,12113,5933,2060,7993,2021-07-08
3173031005,JAKARTA BARAT,TAMAN SARI,MANGGA BESAR,7439,3924,3515,1450,4965,2021-07-08
3171021005,JAKARTA PUSAT,SAWAH BESAR,MANGGA DUA SELATAN,27767,17897,9870,3866,13736,2021-07-08
3174011007,JAKARTA SELATAN,TEBET,MANGGARAI,28388,19108,9280,3565,12845,2021-07-08
3174011006,JAKARTA SELATAN,TEBET,MANGGARAI SELATAN,22902,13966,8936,3220,12156,2021-07-08
3173031003,JAKARTA BARAT,TAMAN SARI,MAPHAR,16385,10007,6378,2571,8949,2021-07-08
3172041003,JAKARTA UTARA,CILINCING,MARUNDA,28614,17596,11018,2588,13606,2021-07-08
3174071001,JAKARTA SELATAN,KEBAYORAN BARU,MELAWAI,2634,1277,1357,832,2189,2021-07-08
3171061001,JAKARTA PUSAT,MENTENG,MENTENG,25280,18043,7237,3534,10771,2021-07-08
3174021005,JAKARTA SELATAN,SETIA BUDI,MENTENG ATAS,27671,16987,10684,4042,14726,2021-07-08
3174011003,JAKARTA SELATAN,TEBET,MENTENG DALAM,35936,23704,12232,5200,17432,2021-07-08
3173081003,JAKARTA BARAT,KEMBANGAN,MERUYA SELATAN,31227,20346,10881,4338,15219,2021-07-08
3173081002,JAKARTA BARAT,KEMBANGAN,MERUYA UTARA,43382,28075,15307,6969,22276,2021-07-08
3175101004,JAKARTA TIMUR,CIPAYUNG,MUNJUL,23570,15837,7733,3610,11343,2021-07-08
3172051002,JAKARTA UTARA,PADEMANGAN,PADEMANGAN BARAT,73841,50584,23257,7816,31073,2021-07-08
3172051001,JAKARTA UTARA,PADEMANGAN,PADEMANGAN TIMUR,36757,20138,16619,6899,23518,2021-07-08
3175011004,JAKARTA TIMUR,MATRAMAN,PAL MERIAM,19632,12798,6834,2723,9557,2021-07-08
3173071001,JAKARTA BARAT,PALMERAH,PALMERAH,62175,40840,21335,8026,29361,2021-07-08
3174081001,JAKARTA SELATAN,PANCORAN,PANCORAN,19301,12505,6796,2659,9455,2021-07-08
3172021003,JAKARTA UTARA,TANJUNG PRIOK,PAPANGGO,38871,24461,14410,4740,19150,2021-07-08
3171021001,JAKARTA PUSAT,SAWAH BESAR,PASAR BARU,12710,6692,6018,2919,8937,2021-07-08
3174021006,JAKARTA SELATAN,SETIA BUDI,PASAR MANGGIS,26572,16929,9643,3553,13196,2021-07-08
3174041001,JAKARTA SELATAN,PASAR MINGGU,PASAR MINGGU,24670,15787,8883,4583,13466,2021-07-08
3171041003,JAKARTA PUSAT,SENEN,PASEBAN,23321,15097,8224,3312,11536,2021-07-08
3173061005,JAKARTA BARAT,KALI DERES,PEGADUNGAN,74685,48943,25742,9144,34886,2021-07-08
3171061002,JAKARTA PUSAT,MENTENG,PEGANGSAAN,21120,14176,6944,2952,9896,2021-07-08
3172061002,JAKARTA UTARA,KELAPA GADING,PEGANGSAAN DUA,49632,25199,24433,10531,34964,2021-07-08
3172011004,JAKARTA UTARA,PENJARINGAN,PEJAGALAN,74043,45662,28381,10936,39317,2021-07-08
3174041006,JAKARTA SELATAN,PASAR MINGGU,PEJATEN BARAT,35061,21733,13328,5622,18950,2021-07-08
3174041005,JAKARTA SELATAN,PASAR MINGGU,PEJATEN TIMUR,57257,39407,17850,6073,23923,2021-07-08
3175051005,JAKARTA TIMUR,PASAR REBO,PEKAYON,42705,27528,15177,6118,21295,2021-07-08
3173041009,JAKARTA BARAT,TAMBORA,PEKOJAN,23428,14697,8731,3427,12158,2021-07-08
3174031003,JAKARTA SELATAN,MAMPANG PRAPATAN,PELA MAMPANG,42709,27741,14968,5652,20620,2021-07-08
3174081005,JAKARTA SELATAN,PANCORAN,PENGADEGAN,21111,11954,9157,3335,12492,2021-07-08
3175061003,JAKARTA TIMUR,CAKUNG,PENGGILINGAN,97138,72806,24332,9396,33728,2021-07-08
3172011001,JAKARTA UTARA,PENJARINGAN,PENJARINGAN,86712,59836,26876,7860,34736,2021-07-08
3174101001,JAKARTA SELATAN,PESANGGRAHAN,PESANGGRAHAN,27215,15979,11236,4890,16126,2021-07-08
3171071004,JAKARTA PUSAT,TANAH ABANG,PETAMBURAN,33060,25480,7580,2941,10521,2021-07-08
3174071008,JAKARTA SELATAN,KEBAYORAN BARU,PETOGOGAN,11418,6982,4436,1861,6297,2021-07-08
3171011004,JAKARTA PUSAT,GAMBIR,PETOJO SELATAN,14946,9154,5792,3005,8797,2021-07-08
3171011003,JAKARTA PUSAT,GAMBIR,PETOJO UTARA,17843,11734,6109,2701,8810,2021-07-08
3174101004,JAKARTA SELATAN,PESANGGRAHAN,PETUKANGAN SELATAN,36769,23527,13242,4929,18171,2021-07-08
3174101003,JAKARTA SELATAN,PESANGGRAHAN,PETUKANGAN UTARA,53184,35312,17872,6752,24624,2021-07-08
3175081002,JAKARTA TIMUR,MAKASAR,PINANG RANTI,26915,17323,9592,3466,13058,2021-07-08
3173031008,JAKARTA BARAT,TAMAN SARI,PINANGSIA,10583,6102,4481,1635,6116,2021-07-08
3175011001,JAKARTA TIMUR,MATRAMAN,PISANGAN BARU,31537,22586,8951,3826,12777,2021-07-08
3175021002,JAKARTA TIMUR,PULO GADUNG,PISANGAN TIMUR,40576,26531,14045,5686,19731,2021-07-08
3172011005,JAKARTA UTARA,PENJARINGAN,PLUIT,47433,25471,21962,12356,34318,2021-07-08
3175071002,JAKARTA TIMUR,DUREN SAWIT,PONDOK BAMBU,61047,40160,20887,8912,29799,2021-07-08
3175071004,JAKARTA TIMUR,DUREN SAWIT,PONDOK KELAPA,71347,46073,25274,11008,36282,2021-07-08
3175071007,JAKARTA TIMUR,DUREN SAWIT,PONDOK KOPI,35051,24819,10232,4364,14596,2021-07-08
3174061003,JAKARTA SELATAN,CILANDAK,PONDOK LABU,45944,28732,17212,6903,24115,2021-07-08
3174051002,JAKARTA SELATAN,KEBAYORAN LAMA,PONDOK PINANG,55724,36368,19356,9558,28914,2021-07-08
3175101003,JAKARTA TIMUR,CIPAYUNG,PONDOK RANGGON,25123,17274,7849,3796,11645,2021-07-08
3101011003,KAB.ADM.KEP.SERIBU,KEP. SERIBU UTARA,PULAU HARAPAN,2036,650,1386,670,2056,2021-07-08
3101011002,KAB.ADM.KEP.SERIBU,KEP. SERIBU UTARA,PULAU KELAPA,5460,1745,3715,1082,4797,2021-07-08
3101011001,KAB.ADM.KEP.SERIBU,KEP. SERIBU UTARA,PULAU PANGGANG,5395,1665,3730,1147,4877,2021-07-08
3101021003,KAB.ADM.KEP.SERIBU,KEP. SERIBU SELATAN,PULAU PARI,2736,607,2129,614,2743,2021-07-08
3101021002,KAB.ADM.KEP.SERIBU,KEP. SERIBU SELATAN,PULAU TIDUNG,4528,1349,3179,1133,4312,2021-07-08
3101021001,KAB.ADM.KEP.SERIBU,KEP. SERIBU SELATAN,PULAU UNTUNG JAWA,1918,546,1372,559,1931,2021-07-08
3174071007,JAKARTA SELATAN,KEBAYORAN BARU,PULO,5777,3078,2699,1353,4052,2021-07-08
3175021001,JAKARTA TIMUR,PULO GADUNG,PULO GADUNG,34175,23128,11047,4676,15723,2021-07-08
3175061005,JAKARTA TIMUR,CAKUNG,PULO GEBANG,95947,68071,27876,10714,38590,2021-07-08
3174041004,JAKARTA SELATAN,PASAR MINGGU,RAGUNAN,39233,23961,15272,5829,21101,2021-07-08
3175091005,JAKARTA TIMUR,CIRACAS,RAMBUTAN,36368,26658,9710,4309,14019,2021-07-08
3172031006,JAKARTA UTARA,KOJA,RAWA BADAK SELATAN,41895,30231,11664,3951,15615,2021-07-08
3172031004,JAKARTA UTARA,KOJA,RAWA BADAK UTARA,33538,21549,11989,3871,15860,2021-07-08
3174071005,JAKARTA SELATAN,KEBAYORAN BARU,RAWA BARAT,5574,3155,2419,1330,3749,2021-07-08
3173011003,JAKARTA BARAT,CENGKARENG,RAWA BUAYA,59533,39617,19916,6007,25923,2021-07-08
3175031004,JAKARTA TIMUR,JATINEGARA,RAWA BUNGA,21272,15275,5997,2475,8472,2021-07-08
3174081003,JAKARTA SELATAN,PANCORAN,RAWA JATI,20321,12530,7791,3436,11227,2021-07-08
3175061002,JAKARTA TIMUR,CAKUNG,RAWA TERATE,24433,15727,8706,2131,10837,2021-07-08
3175021005,JAKARTA TIMUR,PULO GADUNG,RAWAMANGUN,36788,23886,12902,5870,18772,2021-07-08
3171051003,JAKARTA PUSAT,CEMPAKA PUTIH,RAWASARI,21770,13797,7973,3495,11468,2021-07-08
3173041010,JAKARTA BARAT,TAMBORA,ROA MALAKA,3449,1728,1721,883,2604,2021-07-08
3172041006,JAKARTA UTARA,CILINCING,ROROTAN,40953,26225,14728,4611,19339,2021-07-08
3174071004,JAKARTA SELATAN,KEBAYORAN BARU,SELONG,2843,1437,1406,884,2290,2021-07-08
3173061002,JAKARTA BARAT,KALI DERES,SEMANAN,70293,51764,18529,5006,23535,2021-07-08
3172041007,JAKARTA UTARA,CILINCING,SEMPER BARAT,67899,42077,25822,9107,34929,2021-07-08
3172041005,JAKARTA UTARA,CILINCING,SEMPER TIMUR,36029,23221,12808,4322,17130,2021-07-08
3174071006,JAKARTA SELATAN,KEBAYORAN BARU,SENAYAN,2780,1771,1009,574,1583,2021-07-08
3171041001,JAKARTA PUSAT,SENEN,SENEN,6757,4121,2636,1187,3823,2021-07-08
3171031004,JAKARTA PUSAT,KEMAYORAN,SERDANG,29730,19305,10425,3953,14378,2021-07-08
3174021001,JAKARTA SELATAN,SETIA BUDI,SETIA BUDI,2841,1649,1192,646,1838,2021-07-08
3175101005,JAKARTA TIMUR,CIPAYUNG,SETU,20306,14553,5753,2682,8435,2021-07-08
3173071002,JAKARTA BARAT,PALMERAH,SLIPI,16475,10102,6373,2735,9108,2021-07-08
3173081004,JAKARTA BARAT,KEMBANGAN,SRENGSENG,44969,31028,13941,6180,20121,2021-07-08
3174091002,JAKARTA SELATAN,JAGAKARSA,SRENGSENG SAWAH,57480,33545,23935,8904,32839,2021-07-08
3173051003,JAKARTA BARAT,KEBON JERUK,SUKABUMI SELATAN,35170,24501,10669,3489,14158,2021-07-08
3173051002,JAKARTA BARAT,KEBON JERUK,SUKABUMI UTARA,37628,27152,10476,4022,14498,2021-07-08
3172041002,JAKARTA UTARA,CILINCING,SUKAPURA,53786,36237,17549,5470,23019,2021-07-08
3171031007,JAKARTA PUSAT,KEMAYORAN,SUMUR BATU,22506,14146,8360,3410,11770,2021-07-08
3172021004,JAKARTA UTARA,TANJUNG PRIOK,SUNGAI BAMBU,29115,17846,11269,3561,14830,2021-07-08
3172021006,JAKARTA UTARA,TANJUNG PRIOK,SUNTER AGUNG,70860,39292,31568,13550,45118,2021-07-08
3172021002,JAKARTA UTARA,TANJUNG PRIOK,SUNTER JAYA,62516,37650,24866,10494,35360,2021-07-08
3175091004,JAKARTA TIMUR,CIRACAS,SUSUKAN,33525,21839,11686,4624,16310,2021-07-08
3173031001,JAKARTA BARAT,TAMAN SARI,TAMAN SARI,14281,8700,5581,2398,7979,2021-07-08
3173041001,JAKARTA BARAT,TAMBORA,TAMBORA,10177,6609,3568,1521,5089,2021-07-08
3173041004,JAKARTA BARAT,TAMBORA,TANAH SEREAL,25944,15434,10510,3893,14403,2021-07-08
3171081004,JAKARTA PUSAT,JOHAR BARU,TANAH TINGGI,37800,23665,14135,4262,18397,2021-07-08
3173031004,JAKARTA BARAT,TAMAN SARI,TANGKI,12991,7946,5045,1933,6978,2021-07-08
3174091005,JAKARTA SELATAN,JAGAKARSA,TANJUNG BARAT,39368,26763,12605,5707,18312,2021-07-08
3173021005,JAKARTA BARAT,GROGOL PETAMBURAN,TANJUNG DUREN SELATAN,24917,13933,10984,4493,15477,2021-07-08
3173021002,JAKARTA BARAT,GROGOL PETAMBURAN,TANJUNG DUREN UTARA,16940,8917,8023,3539,11562,2021-07-08
3172021001,JAKARTA UTARA,TANJUNG PRIOK,TANJUNG PRIOK,34316,20952,13364,3841,17205,2021-07-08
3174011002,JAKARTA SELATAN,TEBET,TEBET BARAT,21164,12541,8623,4214,12837,2021-07-08
3174011001,JAKARTA SELATAN,TEBET,TEBET TIMUR,18030,9961,8069,3768,11837,2021-07-08
3173061003,JAKARTA BARAT,KALI DERES,TEGAL ALUR,82647,57755,24892,6870,31762,2021-07-08
3174031004,JAKARTA SELATAN,MAMPANG PRAPATAN,TEGAL PARANG,32174,23472,8702,3322,12024,2021-07-08
3173021003,JAKARTA BARAT,GROGOL PETAMBURAN,TOMANG,28665,17000,11665,4993,16658,2021-07-08
3172031005,JAKARTA UTARA,KOJA,TUGU SELATAN,38749,27199,11550,3838,15388,2021-07-08
3172031002,JAKARTA UTARA,KOJA,TUGU UTARA,67211,47510,19701,6765,26466,2021-07-08
3175061006,JAKARTA TIMUR,CAKUNG,UJUNG MENTENG,29527,19449,10078,3994,14072,2021-07-08
3174101005,JAKARTA SELATAN,PESANGGRAHAN,ULUJAMI,40120,28024,12096,4951,17047,2021-07-08
3175011006,JAKARTA TIMUR,MATRAMAN,UTAN KAYU SELATAN,33233,21109,12124,5065,17189,2021-07-08
3175011002,JAKARTA TIMUR,MATRAMAN,UTAN KAYU UTARA,27995,17981,10014,3838,13852,2021-07-08
3171031008,JAKARTA PUSAT,KEMAYORAN,UTAN PANJANG,29260,20840,8420,2808,11228,2021-07-08
3172021007,JAKARTA UTARA,TANJUNG PRIOK,WARAKAS,43754,28201,15553,5237,20790,2021-07-08
3173021007,JAKARTA BARAT,GROGOL PETAMBURAN,WIJAYA KUSUMA,38584,25336,13248,4876,18124,2021-07-08
3172051003,JAKARTA UTARA,PADEMANGAN,ANCOL,23379,15504,7875,3318,11193,2021-07-09
3173041007,JAKARTA BARAT,TAMBORA,ANGKE,29230,18482,10748,3249,13997,2021-07-09
3175041005,JAKARTA TIMUR,KRAMAT JATI,BALE KAMBANG,28803,21649,7154,2680,9834,2021-07-09
3175031003,JAKARTA TIMUR,JATINEGARA,BALI MESTER,9675,6358,3317,1536,4853,2021-07-09
3175101006,JAKARTA TIMUR,CIPAYUNG,BAMBU APUS,25985,17646,8339,4017,12356,2021-07-09
3174031002,JAKARTA SELATAN,MAMPANG PRAPATAN,BANGKA,21356,14032,7324,2745,10069,2021-07-09
3175051002,JAKARTA TIMUR,PASAR REBO,BARU,23514,13728,9786,4723,14509,2021-07-09
3175041004,JAKARTA TIMUR,KRAMAT JATI,BATU AMPAR,47416,34850,12566,5327,17893,2021-07-09
3171071002,JAKARTA PUSAT,TANAH ABANG,BENDUNGAN HILIR,21374,13071,8303,3606,11909,2021-07-09
3175031002,JAKARTA TIMUR,JATINEGARA,BIDARA CINA,36461,26193,10268,4074,14342,2021-07-09
3174101002,JAKARTA SELATAN,PESANGGRAHAN,BINTARO,52402,35059,17343,7157,24500,2021-07-09
3174011005,JAKARTA SELATAN,TEBET,BUKIT DURI,33953,23021,10932,3986,14918,2021-07-09
3171041006,JAKARTA PUSAT,SENEN,BUNGUR,17929,11269,6660,2770,9430,2021-07-09
3175061007,JAKARTA TIMUR,CAKUNG,CAKUNG BARAT,57222,38295,18927,4062,22989,2021-07-09
3175061004,JAKARTA TIMUR,CAKUNG,CAKUNG TIMUR,57655,38154,19501,6463,25964,2021-07-09
3175041007,JAKARTA TIMUR,KRAMAT JATI,CAWANG,32481,22088,10393,4333,14726,2021-07-09
3175101008,JAKARTA TIMUR,CIPAYUNG,CEGER,18740,12554,6186,2591,8777,2021-07-09
3171031006,JAKARTA PUSAT,KEMAYORAN,CEMPAKA BARU,31257,21257,10000,4051,14051,2021-07-09
3171051002,JAKARTA PUSAT,CEMPAKA PUTIH,CEMPAKA PUTIH BARAT,34725,23638,11087,5011,16098,2021-07-09
3171051001,JAKARTA PUSAT,CEMPAKA PUTIH,CEMPAKA PUTIH TIMUR,24170,14923,9247,4500,13747,2021-07-09
3173011001,JAKARTA BARAT,CENGKARENG,CENGKARENG BARAT,65702,40250,25452,8290,33742,2021-07-09
3173011006,JAKARTA BARAT,CENGKARENG,CENGKARENG TIMUR,80100,52271,27829,8560,36389,2021-07-09
3175091002,JAKARTA TIMUR,CIRACAS,CIBUBUR,65231,41792,23439,9598,33037,2021-07-09
3171011002,JAKARTA PUSAT,GAMBIR,CIDENG,15696,9070,6626,3213,9839,2021-07-09
3174091003,JAKARTA SELATAN,JAGAKARSA,CIGANJUR,38048,24956,13092,5214,18306,2021-07-09
3175051003,JAKARTA TIMUR,PASAR REBO,CIJANTUNG,41013,26322,14691,6260,20951,2021-07-09
3171061003,JAKARTA PUSAT,MENTENG,CIKINI,8260,5439,2821,1378,4199,2021-07-09
3174081006,JAKARTA SELATAN,PANCORAN,CIKOKO,10503,6112,4391,1771,6162,2021-07-09
3174061001,JAKARTA SELATAN,CILANDAK,CILANDAK BARAT,51346,30667,20679,7955,28634,2021-07-09
3174041003,JAKARTA SELATAN,PASAR MINGGU,CILANDAK TIMUR,24239,14624,9615,4887,14502,2021-07-09
3175101002,JAKARTA TIMUR,CIPAYUNG,CILANGKAP,27179,18109,9070,3842,12912,2021-07-09
3175041006,JAKARTA TIMUR,KRAMAT JATI,CILILITAN,39984,28018,11966,5312,17278,2021-07-09
3172041001,JAKARTA UTARA,CILINCING,CILINCING,42677,30196,12481,3959,16440,2021-07-09
3175101001,JAKARTA TIMUR,CIPAYUNG,CIPAYUNG,25747,15941,9806,4272,14078,2021-07-09
3174091006,JAKARTA SELATAN,JAGAKARSA,CIPEDAK,37809,24121,13688,4842,18530,2021-07-09
3174061005,JAKARTA SELATAN,CILANDAK,CIPETE SELATAN,26500,16756,9744,3854,13598,2021-07-09
3174071010,JAKARTA SELATAN,KEBAYORAN BARU,CIPETE UTARA,33902,21008,12894,4128,17022,2021-07-09
3175021003,JAKARTA TIMUR,PULO GADUNG,CIPINANG,39069,25469,13600,6109,19709,2021-07-09
3175031007,JAKARTA TIMUR,JATINEGARA,CIPINANG BESAR SELATAN,34938,25683,9255,3937,13192,2021-07-09
3175031008,JAKARTA TIMUR,JATINEGARA,CIPINANG BESAR UTARA,44479,33777,10702,4220,14922,2021-07-09
3175031005,JAKARTA TIMUR,JATINEGARA,CIPINANG CEMPEDAK,32695,22396,10299,4734,15033,2021-07-09
3175081005,JAKARTA TIMUR,MAKASAR,CIPINANG MELAYU,42144,27037,15107,6455,21562,2021-07-09
3175031006,JAKARTA TIMUR,JATINEGARA,CIPINANG MUARA,53251,37615,15636,7360,22996,2021-07-09
3174051003,JAKARTA SELATAN,KEBAYORAN LAMA,CIPULIR,39635,27047,12588,4836,17424,2021-07-09
3175091001,JAKARTA TIMUR,CIRACAS,CIRACAS,63801,41422,22379,8508,30887,2021-07-09
3175041003,JAKARTA TIMUR,KRAMAT JATI,DUKUH,24404,16596,7808,3540,11348,2021-07-09
3175071001,JAKARTA TIMUR,DUREN SAWIT,DUREN SAWIT,60443,40287,20156,9321,29477,2021-07-09
3174081004,JAKARTA SELATAN,PANCORAN,DUREN TIGA,28099,17812,10287,3864,14151,2021-07-09
3173051005,JAKARTA BARAT,KEBON JERUK,DURI KEPA,59448,35537,23911,10054,33965,2021-07-09
3173011002,JAKARTA BARAT,CENGKARENG,DURI KOSAMBI,75895,49935,25960,8254,34214,2021-07-09
3171011006,JAKARTA PUSAT,GAMBIR,DURI PULO,19986,13758,6228,2408,8636,2021-07-09
3173041011,JAKARTA BARAT,TAMBORA,DURI SELATAN,14099,8742,5357,2378,7735,2021-07-09
3173041003,JAKARTA BARAT,TAMBORA,DURI UTARA,19768,12932,6836,2648,9484,2021-07-09
3171081003,JAKARTA PUSAT,JOHAR BARU,GALUR,18098,10758,7340,1980,9320,2021-07-09
3171011001,JAKARTA PUSAT,GAMBIR,GAMBIR,2434,1369,1065,582,1647,2021-07-09
3174061004,JAKARTA SELATAN,CILANDAK,GANDARIA SELATAN,21926,13929,7997,2860,10857,2021-07-09
3174071009,JAKARTA SELATAN,KEBAYORAN BARU,GANDARIA UTARA,39609,25213,14396,5391,19787,2021-07-09
3175051001,JAKARTA TIMUR,PASAR REBO,GEDONG,35444,23679,11765,5336,17101,2021-07-09
3171071001,JAKARTA PUSAT,TANAH ABANG,GELORA,3106,1970,1136,572,1708,2021-07-09
3173031007,JAKARTA BARAT,TAMAN SARI,GLODOK,7836,3773,4063,1986,6049,2021-07-09
3171061004,JAKARTA PUSAT,MENTENG,GONDANGDIA,4093,2118,1975,1299,3274,2021-07-09
3173021001,JAKARTA BARAT,GROGOL PETAMBURAN,GROGOL,16815,10621,6194,2619,8813,2021-07-09
3174051005,JAKARTA SELATAN,KEBAYORAN LAMA,GROGOL SELATAN,43915,30389,13526,5494,19020,2021-07-09
3174051004,JAKARTA SELATAN,KEBAYORAN LAMA,GROGOL UTARA,42216,28843,13373,5878,19251,2021-07-09
3174021007,JAKARTA SELATAN,SETIA BUDI,GUNTUR,3962,2171,1791,996,2787,2021-07-09
3174071002,JAKARTA SELATAN,KEBAYORAN BARU,GUNUNG,9344,5414,3930,2047,5977,2021-07-09
3171031005,JAKARTA PUSAT,KEMAYORAN,GUNUNG SAHARI SELATAN,19380,12260,7120,2834,9954,2021-07-09
3171021004,JAKARTA PUSAT,SAWAH BESAR,GUNUNG SAHARI UTARA,15647,8312,7335,3394,10729,2021-07-09
3175081004,JAKARTA TIMUR,MAKASAR,HALIM PERDANA KUSUMAH,28110,13798,14312,9334,23646,2021-07-09
3171031003,JAKARTA PUSAT,KEMAYORAN,HARAPAN MULIA,22700,15429,7271,2711,9982,2021-07-09
3174091001,JAKARTA SELATAN,JAGAKARSA,JAGAKARSA,61552,38067,23485,8582,32067,2021-07-09
3175021007,JAKARTA TIMUR,PULO GADUNG,JATI,32443,20866,11577,5647,17224,2021-07-09
3174041002,JAKARTA SELATAN,PASAR MINGGU,JATI PADANG,37250,23653,13597,5892,19489,2021-07-09
3173071004,JAKARTA BARAT,PALMERAH,JATI PULO,27994,16819,11175,3679,14854,2021-07-09
3175061001,JAKARTA TIMUR,CAKUNG,JATINEGARA,83563,62280,21283,6831,28114,2021-07-09
3175021004,JAKARTA TIMUR,PULO GADUNG,JATINEGARA KAUM,24364,16618,7746,2950,10696,2021-07-09
3173021004,JAKARTA BARAT,GROGOL PETAMBURAN,JELAMBAR,30180,17912,12268,5502,17770,2021-07-09
3173021006,JAKARTA BARAT,GROGOL PETAMBURAN,JELAMBAR BARU,37799,23143,14656,6102,20758,2021-07-09
3173041006,JAKARTA BARAT,TAMBORA,JEMBATAN BESI,29182,22129,7053,2436,9489,2021-07-09
3173041008,JAKARTA BARAT,TAMBORA,JEMBATAN LIMA,20627,14504,6123,2275,8398,2021-07-09
3173081005,JAKARTA BARAT,KEMBANGAN,JOGLO,40475,26669,13806,5982,19788,2021-07-09
3171081001,JAKARTA PUSAT,JOHAR BARU,JOHAR BARU,32845,18707,14138,5361,19499,2021-07-09
3173041002,JAKARTA BARAT,TAMBORA,KALI ANYAR,23582,17324,6258,2251,8509,2021-07-09
3172041004,JAKARTA UTARA,CILINCING,KALIBARU,67165,50341,16824,4367,21191,2021-07-09
3174081002,JAKARTA SELATAN,PANCORAN,KALIBATA,41464,28465,12999,4956,17955,2021-07-09
3173061001,JAKARTA BARAT,KALI DERES,KALIDERES,69014,46121,22893,7632,30525,2021-07-09
3175051004,JAKARTA TIMUR,PASAR REBO,KALISARI,42557,27425,15132,6831,21963,2021-07-09
3173061004,JAKARTA BARAT,KALI DERES,KAMAL,53180,39872,13308,3672,16980,2021-07-09
3172011002,JAKARTA UTARA,PENJARINGAN,KAMAL MUARA,12679,6727,5952,2524,8476,2021-07-09
3171071007,JAKARTA PUSAT,TANAH ABANG,KAMPUNG BALI,11551,8054,3497,1520,5017,2021-07-09
3175031001,JAKARTA TIMUR,JATINEGARA,KAMPUNG MELAYU,25476,18992,6484,2252,8736,2021-07-09
3171081002,JAKARTA PUSAT,JOHAR BARU,KAMPUNG RAWA,18247,9322,8925,2554,11479,2021-07-09
3175041002,JAKARTA TIMUR,KRAMAT JATI,KAMPUNG TENGAH,43668,31605,12063,5294,17357,2021-07-09
3173011005,JAKARTA BARAT,CENGKARENG,KAPUK,121994,85602,36392,9537,45929,2021-07-09
3172011003,JAKARTA UTARA,PENJARINGAN,KAPUK MUARA,35498,20917,14581,6708,21289,2021-07-09
3171021002,JAKARTA PUSAT,SAWAH BESAR,KARANG ANYAR,25865,16661,9204,3416,12620,2021-07-09
3174021004,JAKARTA SELATAN,SETIA BUDI,KARET,9581,5786,3795,1440,5235,2021-07-09
3174021003,JAKARTA SELATAN,SETIA BUDI,KARET KUNINGAN,15939,9519,6420,2345,8765,2021-07-09
3174021002,JAKARTA SELATAN,SETIA BUDI,KARET SEMANGGI,2746,1413,1333,602,1935,2021-07-09
3171071003,JAKARTA PUSAT,TANAH ABANG,KARET TENGSIN,19113,12773,6340,2222,8562,2021-07-09
3171021003,JAKARTA PUSAT,SAWAH BESAR,KARTINI,22303,13686,8617,3468,12085,2021-07-09
3175011003,JAKARTA TIMUR,MATRAMAN,KAYU MANIS,25138,17213,7925,3019,10944,2021-07-09
3175021006,JAKARTA TIMUR,PULO GADUNG,KAYU PUTIH,40378,24187,16191,7117,23308,2021-07-09
3173031006,JAKARTA BARAT,TAMAN SARI,KEAGUNGAN,17231,10871,6360,2006,8366,2021-07-09
3174041007,JAKARTA SELATAN,PASAR MINGGU,KEBAGUSAN,44010,29776,14234,5227,19461,2021-07-09
3174051006,JAKARTA SELATAN,KEBAYORAN LAMA,KEBAYORAN LAMA SELATAN,40895,25522,15373,5830,21203,2021-07-09
3174051001,JAKARTA SELATAN,KEBAYORAN LAMA,KEBAYORAN LAMA UTARA,42214,28519,13695,5289,18984,2021-07-09
3174011004,JAKARTA SELATAN,TEBET,KEBON BARU,34878,22468,12410,5155,17565,2021-07-09
3172021005,JAKARTA UTARA,TANJUNG PRIOK,KEBON BAWANG,50597,32353,18244,6975,25219,2021-07-09
3173051001,JAKARTA BARAT,KEBON JERUK,KEBON JERUK,53296,36891,16405,6818,23223,2021-07-09
3171071006,JAKARTA PUSAT,TANAH ABANG,KEBON KACANG,21376,15609,5767,2639,8406,2021-07-09
3171011005,JAKARTA PUSAT,GAMBIR,KEBON KELAPA,10380,6739,3641,1660,5301,2021-07-09
3171031002,JAKARTA PUSAT,KEMAYORAN,KEBON KOSONG,30003,19924,10079,3485,13564,2021-07-09
3175011005,JAKARTA TIMUR,MATRAMAN,KEBON MANGGIS,16393,10279,6114,2787,8901,2021-07-09
3171071005,JAKARTA PUSAT,TANAH ABANG,KEBON MELATI,31355,24361,6994,2871,9865,2021-07-09
3175081003,JAKARTA TIMUR,MAKASAR,KEBON PALA,46176,31302,14874,6208,21082,2021-07-09
3171061005,JAKARTA PUSAT,MENTENG,KEBON SIRIH,12256,8834,3422,1553,4975,2021-07-09
3173011004,JAKARTA BARAT,CENGKARENG,KEDAUNG KALI ANGKE,32185,18825,13360,3235,16595,2021-07-09
3173051007,JAKARTA BARAT,KEBON JERUK,KEDOYA SELATAN,31907,20234,11673,4631,16304,2021-07-09
3173051006,JAKARTA BARAT,KEBON JERUK,KEDOYA UTARA,43826,25911,17915,7018,24933,2021-07-09
3173051004,JAKARTA BARAT,KEBON JERUK,KELAPA DUA,23293,15299,7994,3149,11143,2021-07-09
3175091003,JAKARTA TIMUR,CIRACAS,KELAPA DUA WETAN,46441,29893,16548,7313,23861,2021-07-09
3172061003,JAKARTA UTARA,KELAPA GADING,KELAPA GADING BARAT,35403,18687,16716,8878,25594,2021-07-09
3172061001,JAKARTA UTARA,KELAPA GADING,KELAPA GADING TIMUR,33472,15853,17619,9170,26789,2021-07-09
3173071005,JAKARTA BARAT,PALMERAH,KEMANGGISAN,31952,20289,11663,5225,16888,2021-07-09
3171031001,JAKARTA PUSAT,KEMAYORAN,KEMAYORAN,20947,12921,8026,2837,10863,2021-07-09
3173081006,JAKARTA BARAT,KEMBANGAN,KEMBANGAN SELATAN,26920,16645,10275,5041,15316,2021-07-09
3173081001,JAKARTA BARAT,KEMBANGAN,KEMBANGAN UTARA,52368,33625,18743,6637,25380,2021-07-09
3171041002,JAKARTA PUSAT,SENEN,KENARI,9317,5408,3909,1749,5658,2021-07-09
3173041005,JAKARTA BARAT,TAMBORA,KERENDANG,19869,13723,6146,2231,8377,2021-07-09
3175071003,JAKARTA TIMUR,DUREN SAWIT,KLENDER,69321,50042,19279,7459,26738,2021-07-09
3172031001,JAKARTA UTARA,KOJA,KOJA,28036,18822,9214,2762,11976,2021-07-09
3173071006,JAKARTA BARAT,PALMERAH,KOTA BAMBU SELATAN,20926,13997,6929,2248,9177,2021-07-09
3173071003,JAKARTA BARAT,PALMERAH,KOTA BAMBU UTARA,24416,16718,7698,2782,10480,2021-07-09
3171041004,JAKARTA PUSAT,SENEN,KRAMAT,28661,20173,8488,3002,11490,2021-07-09
3175041001,JAKARTA TIMUR,KRAMAT JATI,KRAMAT JATI,33851,22646,11205,5045,16250,2021-07-09
3174071003,JAKARTA SELATAN,KEBAYORAN BARU,KRAMAT PELA,14340,8412,5928,2381,8309,2021-07-09
3173031002,JAKARTA BARAT,TAMAN SARI,KRUKUT,19130,12147,6983,2295,9278,2021-07-09
3174031005,JAKARTA SELATAN,MAMPANG PRAPATAN,KUNINGAN BARAT,12675,7913,4762,1552,6314,2021-07-09
3174021008,JAKARTA SELATAN,SETIA BUDI,KUNINGAN TIMUR,5982,3674,2308,1063,3371,2021-07-09
3171041005,JAKARTA PUSAT,SENEN,KWITANG,15295,9797,5498,2103,7601,2021-07-09
3172031003,JAKARTA UTARA,KOJA,LAGOA,58726,41498,17228,5669,22897,2021-07-09
3174061002,JAKARTA SELATAN,CILANDAK,LEBAK BULUS,37213,23831,13382,5943,19325,2021-07-09
3174091004,JAKARTA SELATAN,JAGAKARSA,LENTENG AGUNG,53453,37575,15878,6173,22051,2021-07-09
3175101007,JAKARTA TIMUR,CIPAYUNG,LUBANG BUAYA,62984,40774,22210,8440,30650,2021-07-09
3175081001,JAKARTA TIMUR,MAKASAR,MAKASAR,34062,21537,12525,4985,17510,2021-07-09
3175071006,JAKARTA TIMUR,DUREN SAWIT,MALAKA JAYA,30744,19168,11576,5507,17083,2021-07-09
3175071005,JAKARTA TIMUR,DUREN SAWIT,MALAKA SARI,27015,16386,10629,5445,16074,2021-07-09
3174031001,JAKARTA SELATAN,MAMPANG PRAPATAN,MAMPANG PRAPATAN,18046,12147,5899,2060,7959,2021-07-09
3173031005,JAKARTA BARAT,TAMAN SARI,MANGGA BESAR,7439,3926,3513,1452,4965,2021-07-09
3171021005,JAKARTA PUSAT,SAWAH BESAR,MANGGA DUA SELATAN,27767,17827,9940,3871,13811,2021-07-09
3174011007,JAKARTA SELATAN,TEBET,MANGGARAI,28388,19017,9371,3569,12940,2021-07-09
3174011006,JAKARTA SELATAN,TEBET,MANGGARAI SELATAN,22902,13897,9005,3225,12230,2021-07-09
3173031003,JAKARTA BARAT,TAMAN SARI,MAPHAR,16385,9891,6494,2579,9073,2021-07-09
3172041003,JAKARTA UTARA,CILINCING,MARUNDA,28614,17968,10646,2590,13236,2021-07-09
3174071001,JAKARTA SELATAN,KEBAYORAN BARU,MELAWAI,2634,1310,1324,834,2158,2021-07-09
3171061001,JAKARTA PUSAT,MENTENG,MENTENG,25280,18025,7255,3539,10794,2021-07-09
3174021005,JAKARTA SELATAN,SETIA BUDI,MENTENG ATAS,27671,17071,10600,4048,14648,2021-07-09
3174011003,JAKARTA SELATAN,TEBET,MENTENG DALAM,35936,23520,12416,5207,17623,2021-07-09
3173081003,JAKARTA BARAT,KEMBANGAN,MERUYA SELATAN,31227,20277,10950,4342,15292,2021-07-09
3173081002,JAKARTA BARAT,KEMBANGAN,MERUYA UTARA,43382,27994,15388,6976,22364,2021-07-09
3175101004,JAKARTA TIMUR,CIPAYUNG,MUNJUL,23570,15747,7823,3612,11435,2021-07-09
3172051002,JAKARTA UTARA,PADEMANGAN,PADEMANGAN BARAT,73841,50345,23496,7825,31321,2021-07-09
3172051001,JAKARTA UTARA,PADEMANGAN,PADEMANGAN TIMUR,36757,20195,16562,6906,23468,2021-07-09
3175011004,JAKARTA TIMUR,MATRAMAN,PAL MERIAM,19632,12789,6843,2727,9570,2021-07-09
3173071001,JAKARTA BARAT,PALMERAH,PALMERAH,62175,40674,21501,8032,29533,2021-07-09
3174081001,JAKARTA SELATAN,PANCORAN,PANCORAN,19301,12249,7052,2662,9714,2021-07-09
3172021003,JAKARTA UTARA,TANJUNG PRIOK,PAPANGGO,38871,24880,13991,4748,18739,2021-07-09
3171021001,JAKARTA PUSAT,SAWAH BESAR,PASAR BARU,12710,6722,5988,2922,8910,2021-07-09
3174021006,JAKARTA SELATAN,SETIA BUDI,PASAR MANGGIS,26572,16918,9654,3556,13210,2021-07-09
3174041001,JAKARTA SELATAN,PASAR MINGGU,PASAR MINGGU,24670,15805,8865,4592,13457,2021-07-09
3171041003,JAKARTA PUSAT,SENEN,PASEBAN,23321,15021,8300,3314,11614,2021-07-09
3173061005,JAKARTA BARAT,KALI DERES,PEGADUNGAN,74685,48290,26395,9160,35555,2021-07-09
3171061002,JAKARTA PUSAT,MENTENG,PEGANGSAAN,21120,14204,6916,2958,9874,2021-07-09
3172061002,JAKARTA UTARA,KELAPA GADING,PEGANGSAAN DUA,49632,25453,24179,10548,34727,2021-07-09
3172011004,JAKARTA UTARA,PENJARINGAN,PEJAGALAN,74043,45501,28542,10952,39494,2021-07-09
3174041006,JAKARTA SELATAN,PASAR MINGGU,PEJATEN BARAT,35061,21716,13345,5650,18995,2021-07-09
3174041005,JAKARTA SELATAN,PASAR MINGGU,PEJATEN TIMUR,57257,39464,17793,6092,23885,2021-07-09
3175051005,JAKARTA TIMUR,PASAR REBO,PEKAYON,42705,27481,15224,6141,21365,2021-07-09
3173041009,JAKARTA BARAT,TAMBORA,PEKOJAN,23428,14607,8821,3430,12251,2021-07-09
3174031003,JAKARTA SELATAN,MAMPANG PRAPATAN,PELA MAMPANG,42709,27505,15204,5662,20866,2021-07-09
3174081005,JAKARTA SELATAN,PANCORAN,PENGADEGAN,21111,11873,9238,3338,12576,2021-07-09
3175061003,JAKARTA TIMUR,CAKUNG,PENGGILINGAN,97138,72347,24791,9405,34196,2021-07-09
3172011001,JAKARTA UTARA,PENJARINGAN,PENJARINGAN,86712,59772,26940,7864,34804,2021-07-09
3174101001,JAKARTA SELATAN,PESANGGRAHAN,PESANGGRAHAN,27215,16191,11024,4894,15918,2021-07-09
3171071004,JAKARTA PUSAT,TANAH ABANG,PETAMBURAN,33060,25381,7679,2947,10626,2021-07-09
3174071008,JAKARTA SELATAN,KEBAYORAN BARU,PETOGOGAN,11418,6991,4427,1864,6291,2021-07-09
3171011004,JAKARTA PUSAT,GAMBIR,PETOJO SELATAN,14946,9154,5792,3008,8800,2021-07-09
3171011003,JAKARTA PUSAT,GAMBIR,PETOJO UTARA,17843,11709,6134,2703,8837,2021-07-09
3174101004,JAKARTA SELATAN,PESANGGRAHAN,PETUKANGAN SELATAN,36769,23365,13404,4934,18338,2021-07-09
3174101003,JAKARTA SELATAN,PESANGGRAHAN,PETUKANGAN UTARA,53184,35104,18080,6764,24844,2021-07-09
3175081002,JAKARTA TIMUR,MAKASAR,PINANG RANTI,26915,17272,9643,3475,13118,2021-07-09
3173031008,JAKARTA BARAT,TAMAN SARI,PINANGSIA,10583,6031,4552,1635,6187,2021-07-09
3175011001,JAKARTA TIMUR,MATRAMAN,PISANGAN BARU,31537,22520,9017,3827,12844,2021-07-09
3175021002,JAKARTA TIMUR,PULO GADUNG,PISANGAN TIMUR,40576,26377,14199,5699,19898,2021-07-09
3172011005,JAKARTA UTARA,PENJARINGAN,PLUIT,47433,25555,21878,12366,34244,2021-07-09
3175071002,JAKARTA TIMUR,DUREN SAWIT,PONDOK BAMBU,61047,40068,20979,8935,29914,2021-07-09
3175071004,JAKARTA TIMUR,DUREN SAWIT,PONDOK KELAPA,71347,45589,25758,11029,36787,2021-07-09
3175071007,JAKARTA TIMUR,DUREN SAWIT,PONDOK KOPI,35051,24746,10305,4368,14673,2021-07-09
3174061003,JAKARTA SELATAN,CILANDAK,PONDOK LABU,45944,28488,17456,6916,24372,2021-07-09
3174051002,JAKARTA SELATAN,KEBAYORAN LAMA,PONDOK PINANG,55724,36258,19466,9684,29150,2021-07-09
3175101003,JAKARTA TIMUR,CIPAYUNG,PONDOK RANGGON,25123,17227,7896,3799,11695,2021-07-09
3101011003,KAB.ADM.KEP.SERIBU,KEP. SERIBU UTARA,PULAU HARAPAN,2036,735,1301,670,1971,2021-07-09
3101011002,KAB.ADM.KEP.SERIBU,KEP. SERIBU UTARA,PULAU KELAPA,5460,2000,3460,1083,4543,2021-07-09
3101011001,KAB.ADM.KEP.SERIBU,KEP. SERIBU UTARA,PULAU PANGGANG,5395,1882,3513,1148,4661,2021-07-09
3101021003,KAB.ADM.KEP.SERIBU,KEP. SERIBU SELATAN,PULAU PARI,2736,799,1937,614,2551,2021-07-09
3101021002,KAB.ADM.KEP.SERIBU,KEP. SERIBU SELATAN,PULAU TIDUNG,4528,1701,2827,1133,3960,2021-07-09
3101021001,KAB.ADM.KEP.SERIBU,KEP. SERIBU SELATAN,PULAU UNTUNG JAWA,1918,673,1245,559,1804,2021-07-09
3174071007,JAKARTA SELATAN,KEBAYORAN BARU,PULO,5777,3094,2683,1356,4039,2021-07-09
3175021001,JAKARTA TIMUR,PULO GADUNG,PULO GADUNG,34175,23045,11130,4681,15811,2021-07-09
3175061005,JAKARTA TIMUR,CAKUNG,PULO GEBANG,95947,67659,28288,10732,39020,2021-07-09
3174041004,JAKARTA SELATAN,PASAR MINGGU,RAGUNAN,39233,23905,15328,5833,21161,2021-07-09
3175091005,JAKARTA TIMUR,CIRACAS,RAMBUTAN,36368,26622,9746,4319,14065,2021-07-09
3172031006,JAKARTA UTARA,KOJA,RAWA BADAK SELATAN,41895,29743,12152,3957,16109,2021-07-09
3172031004,JAKARTA UTARA,KOJA,RAWA BADAK UTARA,33538,21952,11586,3877,15463,2021-07-09
3174071005,JAKARTA SELATAN,KEBAYORAN BARU,RAWA BARAT,5574,3153,2421,1333,3754,2021-07-09
3173011003,JAKARTA BARAT,CENGKARENG,RAWA BUAYA,59533,39444,20089,6013,26102,2021-07-09
3175031004,JAKARTA TIMUR,JATINEGARA,RAWA BUNGA,21272,15104,6168,2479,8647,2021-07-09
3174081003,JAKARTA SELATAN,PANCORAN,RAWA JATI,20321,12379,7942,3442,11384,2021-07-09
3175061002,JAKARTA TIMUR,CAKUNG,RAWA TERATE,24433,15557,8876,2132,11008,2021-07-09
3175021005,JAKARTA TIMUR,PULO GADUNG,RAWAMANGUN,36788,23799,12989,5876,18865,2021-07-09
3171051003,JAKARTA PUSAT,CEMPAKA PUTIH,RAWASARI,21770,13792,7978,3498,11476,2021-07-09
3173041010,JAKARTA BARAT,TAMBORA,ROA MALAKA,3449,1730,1719,886,2605,2021-07-09
3172041006,JAKARTA UTARA,CILINCING,ROROTAN,40953,26206,14747,4616,19363,2021-07-09
3174071004,JAKARTA SELATAN,KEBAYORAN BARU,SELONG,2843,1445,1398,886,2284,2021-07-09
3173061002,JAKARTA BARAT,KALI DERES,SEMANAN,70293,51277,19016,5019,24035,2021-07-09
3172041007,JAKARTA UTARA,CILINCING,SEMPER BARAT,67899,42510,25389,9115,34504,2021-07-09
3172041005,JAKARTA UTARA,CILINCING,SEMPER TIMUR,36029,23429,12600,4332,16932,2021-07-09
3174071006,JAKARTA SELATAN,KEBAYORAN BARU,SENAYAN,2780,1764,1016,574,1590,2021-07-09
3171041001,JAKARTA PUSAT,SENEN,SENEN,6757,4148,2609,1191,3800,2021-07-09
3171031004,JAKARTA PUSAT,KEMAYORAN,SERDANG,29730,19274,10456,3958,14414,2021-07-09
3174021001,JAKARTA SELATAN,SETIA BUDI,SETIA BUDI,2841,1648,1193,650,1843,2021-07-09
3175101005,JAKARTA TIMUR,CIPAYUNG,SETU,20306,14547,5759,2683,8442,2021-07-09
3173071002,JAKARTA BARAT,PALMERAH,SLIPI,16475,10112,6363,2741,9104,2021-07-09
3173081004,JAKARTA BARAT,KEMBANGAN,SRENGSENG,44969,30968,14001,6196,20197,2021-07-09
3174091002,JAKARTA SELATAN,JAGAKARSA,SRENGSENG SAWAH,57480,33803,23677,8919,32596,2021-07-09
3173051003,JAKARTA BARAT,KEBON JERUK,SUKABUMI SELATAN,35170,24685,10485,3496,13981,2021-07-09
3173051002,JAKARTA BARAT,KEBON JERUK,SUKABUMI UTARA,37628,27231,10397,4026,14423,2021-07-09
3172041002,JAKARTA UTARA,CILINCING,SUKAPURA,53786,36164,17622,5476,23098,2021-07-09
3171031007,JAKARTA PUSAT,KEMAYORAN,SUMUR BATU,22506,14091,8415,3413,11828,2021-07-09
3172021004,JAKARTA UTARA,TANJUNG PRIOK,SUNGAI BAMBU,29115,18459,10656,3569,14225,2021-07-09
3172021006,JAKARTA UTARA,TANJUNG PRIOK,SUNTER AGUNG,70860,39736,31124,13579,44703,2021-07-09
3172021002,JAKARTA UTARA,TANJUNG PRIOK,SUNTER JAYA,62516,37877,24639,10514,35153,2021-07-09
3175091004,JAKARTA TIMUR,CIRACAS,SUSUKAN,33525,21673,11852,4633,16485,2021-07-09
3173031001,JAKARTA BARAT,TAMAN SARI,TAMAN SARI,14281,8629,5652,2405,8057,2021-07-09
3173041001,JAKARTA BARAT,TAMBORA,TAMBORA,10177,6577,3600,1524,5124,2021-07-09
3173041004,JAKARTA BARAT,TAMBORA,TANAH SEREAL,25944,15329,10615,3898,14513,2021-07-09
3171081004,JAKARTA PUSAT,JOHAR BARU,TANAH TINGGI,37800,23553,14247,4270,18517,2021-07-09
3173031004,JAKARTA BARAT,TAMAN SARI,TANGKI,12991,7901,5090,1935,7025,2021-07-09
3174091005,JAKARTA SELATAN,JAGAKARSA,TANJUNG BARAT,39368,26641,12727,5715,18442,2021-07-09
3173021005,JAKARTA BARAT,GROGOL PETAMBURAN,TANJUNG DUREN SELATAN,24917,13934,10983,4501,15484,2021-07-09
3173021002,JAKARTA BARAT,GROGOL PETAMBURAN,TANJUNG DUREN UTARA,16940,8950,7990,3543,11533,2021-07-09
3172021001,JAKARTA UTARA,TANJUNG PRIOK,TANJUNG PRIOK,34316,21279,13037,3849,16886,2021-07-09
3174011002,JAKARTA SELATAN,TEBET,TEBET BARAT,21164,12434,8730,4223,12953,2021-07-09
3174011001,JAKARTA SELATAN,TEBET,TEBET TIMUR,18030,9933,8097,3777,11874,2021-07-09
3173061003,JAKARTA BARAT,KALI DERES,TEGAL ALUR,82647,57074,25573,6886,32459,2021-07-09
3174031004,JAKARTA SELATAN,MAMPANG PRAPATAN,TEGAL PARANG,32174,23254,8920,3326,12246,2021-07-09
3173021003,JAKARTA BARAT,GROGOL PETAMBURAN,TOMANG,28665,16955,11710,5000,16710,2021-07-09
3172031005,JAKARTA UTARA,KOJA,TUGU SELATAN,38749,27383,11366,3838,15204,2021-07-09
3172031002,JAKARTA UTARA,KOJA,TUGU UTARA,67211,47177,20034,6778,26812,2021-07-09
3175061006,JAKARTA TIMUR,CAKUNG,UJUNG MENTENG,29527,19425,10102,3998,14100,2021-07-09
3174101005,JAKARTA SELATAN,PESANGGRAHAN,ULUJAMI,40120,27893,12227,4956,17183,2021-07-09
3175011006,JAKARTA TIMUR,MATRAMAN,UTAN KAYU SELATAN,33233,21053,12180,5076,17256,2021-07-09
3175011002,JAKARTA TIMUR,MATRAMAN,UTAN KAYU UTARA,27995,17933,10062,3839,13901,2021-07-09
3171031008,JAKARTA PUSAT,KEMAYORAN,UTAN PANJANG,29260,20770,8490,2816,11306,2021-07-09
3172021007,JAKARTA UTARA,TANJUNG PRIOK,WARAKAS,43754,28239,15515,5245,20760,2021-07-09
3173021007,JAKARTA BARAT,GROGOL PETAMBURAN,WIJAYA KUSUMA,38584,25298,13286,4880,18166,2021-07-09
3172051003,JAKARTA UTARA,PADEMANGAN,ANCOL,23379,15452,7927,3318,11245,2021-07-10
3173041007,JAKARTA BARAT,TAMBORA,ANGKE,29230,18297,10933,3253,14186,2021-07-10
3175041005,JAKARTA TIMUR,KRAMAT JATI,BALE KAMBANG,28803,21563,7240,2683,9923,2021-07-10
3175031003,JAKARTA TIMUR,JATINEGARA,BALI MESTER,9675,6338,3337,1538,4875,2021-07-10
3175101006,JAKARTA TIMUR,CIPAYUNG,BAMBU APUS,25985,17584,8401,4019,12420,2021-07-10
3174031002,JAKARTA SELATAN,MAMPANG PRAPATAN,BANGKA,21356,13926,7430,2746,10176,2021-07-10
3175051002,JAKARTA TIMUR,PASAR REBO,BARU,23514,13457,10057,4729,14786,2021-07-10
3175041004,JAKARTA TIMUR,KRAMAT JATI,BATU AMPAR,47416,34654,12762,5332,18094,2021-07-10
3171071002,JAKARTA PUSAT,TANAH ABANG,BENDUNGAN HILIR,21374,12994,8380,3613,11993,2021-07-10
3175031002,JAKARTA TIMUR,JATINEGARA,BIDARA CINA,36461,26038,10423,4076,14499,2021-07-10
3174101002,JAKARTA SELATAN,PESANGGRAHAN,BINTARO,52402,34718,17684,7163,24847,2021-07-10
3174011005,JAKARTA SELATAN,TEBET,BUKIT DURI,33953,22810,11143,3990,15133,2021-07-10
3171041006,JAKARTA PUSAT,SENEN,BUNGUR,17929,11206,6723,2775,9498,2021-07-10
3175061007,JAKARTA TIMUR,CAKUNG,CAKUNG BARAT,57222,37910,19312,4067,23379,2021-07-10
3175061004,JAKARTA TIMUR,CAKUNG,CAKUNG TIMUR,57655,37924,19731,6468,26199,2021-07-10
3175041007,JAKARTA TIMUR,KRAMAT JATI,CAWANG,32481,21912,10569,4341,14910,2021-07-10
3175101008,JAKARTA TIMUR,CIPAYUNG,CEGER,18740,12510,6230,2593,8823,2021-07-10
3171031006,JAKARTA PUSAT,KEMAYORAN,CEMPAKA BARU,31257,21003,10254,4055,14309,2021-07-10
3171051002,JAKARTA PUSAT,CEMPAKA PUTIH,CEMPAKA PUTIH BARAT,34725,23298,11427,5013,16440,2021-07-10
3171051001,JAKARTA PUSAT,CEMPAKA PUTIH,CEMPAKA PUTIH TIMUR,24170,14756,9414,4507,13921,2021-07-10
3173011001,JAKARTA BARAT,CENGKARENG,CENGKARENG BARAT,65702,39986,25716,8297,34013,2021-07-10
3173011006,JAKARTA BARAT,CENGKARENG,CENGKARENG TIMUR,80100,52008,28092,8566,36658,2021-07-10
3175091002,JAKARTA TIMUR,CIRACAS,CIBUBUR,65231,41598,23633,9608,33241,2021-07-10
3171011002,JAKARTA PUSAT,GAMBIR,CIDENG,15696,9036,6660,3213,9873,2021-07-10
3174091003,JAKARTA SELATAN,JAGAKARSA,CIGANJUR,38048,24728,13320,5216,18536,2021-07-10
3175051003,JAKARTA TIMUR,PASAR REBO,CIJANTUNG,41013,26073,14940,6269,21209,2021-07-10
3171061003,JAKARTA PUSAT,MENTENG,CIKINI,8260,5411,2849,1379,4228,2021-07-10
3174081006,JAKARTA SELATAN,PANCORAN,CIKOKO,10503,6035,4468,1772,6240,2021-07-10
3174061001,JAKARTA SELATAN,CILANDAK,CILANDAK BARAT,51346,30352,20994,7957,28951,2021-07-10
3174041003,JAKARTA SELATAN,PASAR MINGGU,CILANDAK TIMUR,24239,14512,9727,4896,14623,2021-07-10
3175101002,JAKARTA TIMUR,CIPAYUNG,CILANGKAP,27179,17990,9189,3847,13036,2021-07-10
3175041006,JAKARTA TIMUR,KRAMAT JATI,CILILITAN,39984,27874,12110,5325,17435,2021-07-10
3172041001,JAKARTA UTARA,CILINCING,CILINCING,42677,30113,12564,3960,16524,2021-07-10
3175101001,JAKARTA TIMUR,CIPAYUNG,CIPAYUNG,25747,15852,9895,4273,14168,2021-07-10
3174091006,JAKARTA SELATAN,JAGAKARSA,CIPEDAK,37809,23790,14019,4848,18867,2021-07-10
3174061005,JAKARTA SELATAN,CILANDAK,CIPETE SELATAN,26500,16549,9951,3856,13807,2021-07-10
3174071010,JAKARTA SELATAN,KEBAYORAN BARU,CIPETE UTARA,33902,20824,13078,4132,17210,2021-07-10
3175021003,JAKARTA TIMUR,PULO GADUNG,CIPINANG,39069,25314,13755,6115,19870,2021-07-10
3175031007,JAKARTA TIMUR,JATINEGARA,CIPINANG BESAR SELATAN,34938,25498,9440,3939,13379,2021-07-10
3175031008,JAKARTA TIMUR,JATINEGARA,CIPINANG BESAR UTARA,44479,33449,11030,4220,15250,2021-07-10
3175031005,JAKARTA TIMUR,JATINEGARA,CIPINANG CEMPEDAK,32695,22266,10429,4736,15165,2021-07-10
3175081005,JAKARTA TIMUR,MAKASAR,CIPINANG MELAYU,42144,26876,15268,6460,21728,2021-07-10
3175031006,JAKARTA TIMUR,JATINEGARA,CIPINANG MUARA,53251,37421,15830,7366,23196,2021-07-10
3174051003,JAKARTA SELATAN,KEBAYORAN LAMA,CIPULIR,39635,26862,12773,4839,17612,2021-07-10
3175091001,JAKARTA TIMUR,CIRACAS,CIRACAS,63801,41186,22615,8523,31138,2021-07-10
3175041003,JAKARTA TIMUR,KRAMAT JATI,DUKUH,24404,16559,7845,3548,11393,2021-07-10
3175071001,JAKARTA TIMUR,DUREN SAWIT,DUREN SAWIT,60443,40096,20347,9332,29679,2021-07-10
3174081004,JAKARTA SELATAN,PANCORAN,DUREN TIGA,28099,17633,10466,3865,14331,2021-07-10
3173051005,JAKARTA BARAT,KEBON JERUK,DURI KEPA,59448,35395,24053,10065,34118,2021-07-10
3173011002,JAKARTA BARAT,CENGKARENG,DURI KOSAMBI,75895,49600,26295,8259,34554,2021-07-10
3171011006,JAKARTA PUSAT,GAMBIR,DURI PULO,19986,13718,6268,2409,8677,2021-07-10
3173041011,JAKARTA BARAT,TAMBORA,DURI SELATAN,14099,8695,5404,2378,7782,2021-07-10
3173041003,JAKARTA BARAT,TAMBORA,DURI UTARA,19768,12751,7017,2653,9670,2021-07-10
3171081003,JAKARTA PUSAT,JOHAR BARU,GALUR,18098,10626,7472,1980,9452,2021-07-10
3171011001,JAKARTA PUSAT,GAMBIR,GAMBIR,2434,1363,1071,582,1653,2021-07-10
3174061004,JAKARTA SELATAN,CILANDAK,GANDARIA SELATAN,21926,13872,8054,2861,10915,2021-07-10
3174071009,JAKARTA SELATAN,KEBAYORAN BARU,GANDARIA UTARA,39609,25037,14572,5395,19967,2021-07-10
3175051001,JAKARTA TIMUR,PASAR REBO,GEDONG,35444,23449,11995,5351,17346,2021-07-10
3171071001,JAKARTA PUSAT,TANAH ABANG,GELORA,3106,1946,1160,572,1732,2021-07-10
3173031007,JAKARTA BARAT,TAMAN SARI,GLODOK,7836,3755,4081,1986,6067,2021-07-10
3171061004,JAKARTA PUSAT,MENTENG,GONDANGDIA,4093,2113,1980,1299,3279,2021-07-10
3173021001,JAKARTA BARAT,GROGOL PETAMBURAN,GROGOL,16815,10513,6302,2625,8927,2021-07-10
3174051005,JAKARTA SELATAN,KEBAYORAN LAMA,GROGOL SELATAN,43915,30165,13750,5499,19249,2021-07-10
3174051004,JAKARTA SELATAN,KEBAYORAN LAMA,GROGOL UTARA,42216,28405,13811,5880,19691,2021-07-10
3174021007,JAKARTA SELATAN,SETIA BUDI,GUNTUR,3962,2162,1800,997,2797,2021-07-10
3174071002,JAKARTA SELATAN,KEBAYORAN BARU,GUNUNG,9344,5366,3978,2047,6025,2021-07-10
3171031005,JAKARTA PUSAT,KEMAYORAN,GUNUNG SAHARI SELATAN,19380,12139,7241,2838,10079,2021-07-10
3171021004,JAKARTA PUSAT,SAWAH BESAR,GUNUNG SAHARI UTARA,15647,8274,7373,3395,10768,2021-07-10
3175081004,JAKARTA TIMUR,MAKASAR,HALIM PERDANA KUSUMAH,28110,13677,14433,9346,23779,2021-07-10
3171031003,JAKARTA PUSAT,KEMAYORAN,HARAPAN MULIA,22700,15235,7465,2714,10179,2021-07-10
3174091001,JAKARTA SELATAN,JAGAKARSA,JAGAKARSA,61552,37670,23882,8586,32468,2021-07-10
3175021007,JAKARTA TIMUR,PULO GADUNG,JATI,32443,20690,11753,5651,17404,2021-07-10
3174041002,JAKARTA SELATAN,PASAR MINGGU,JATI PADANG,37250,23454,13796,5897,19693,2021-07-10
3173071004,JAKARTA BARAT,PALMERAH,JATI PULO,27994,16791,11203,3681,14884,2021-07-10
3175061001,JAKARTA TIMUR,CAKUNG,JATINEGARA,83563,61668,21895,6836,28731,2021-07-10
3175021004,JAKARTA TIMUR,PULO GADUNG,JATINEGARA KAUM,24364,16509,7855,2953,10808,2021-07-10
3173021004,JAKARTA BARAT,GROGOL PETAMBURAN,JELAMBAR,30180,17756,12424,5505,17929,2021-07-10
3173021006,JAKARTA BARAT,GROGOL PETAMBURAN,JELAMBAR BARU,37799,22923,14876,6106,20982,2021-07-10
3173041006,JAKARTA BARAT,TAMBORA,JEMBATAN BESI,29182,22016,7166,2444,9610,2021-07-10
3173041008,JAKARTA BARAT,TAMBORA,JEMBATAN LIMA,20627,14443,6184,2279,8463,2021-07-10
3173081005,JAKARTA BARAT,KEMBANGAN,JOGLO,40475,26483,13992,5984,19976,2021-07-10
3171081001,JAKARTA PUSAT,JOHAR BARU,JOHAR BARU,32845,18531,14314,5364,19678,2021-07-10
3173041002,JAKARTA BARAT,TAMBORA,KALI ANYAR,23582,17271,6311,2252,8563,2021-07-10
3172041004,JAKARTA UTARA,CILINCING,KALIBARU,67165,50200,16965,4368,21333,2021-07-10
3174081002,JAKARTA SELATAN,PANCORAN,KALIBATA,41464,28176,13288,4958,18246,2021-07-10
3173061001,JAKARTA BARAT,KALI DERES,KALIDERES,69014,45824,23190,7638,30828,2021-07-10
3175051004,JAKARTA TIMUR,PASAR REBO,KALISARI,42557,27159,15398,6850,22248,2021-07-10
3173061004,JAKARTA BARAT,KALI DERES,KAMAL,53180,39424,13756,3674,17430,2021-07-10
3172011002,JAKARTA UTARA,PENJARINGAN,KAMAL MUARA,12679,6674,6005,2525,8530,2021-07-10
3171071007,JAKARTA PUSAT,TANAH ABANG,KAMPUNG BALI,11551,8008,3543,1521,5064,2021-07-10
3175031001,JAKARTA TIMUR,JATINEGARA,KAMPUNG MELAYU,25476,18931,6545,2252,8797,2021-07-10
3171081002,JAKARTA PUSAT,JOHAR BARU,KAMPUNG RAWA,18247,9204,9043,2554,11597,2021-07-10
3175041002,JAKARTA TIMUR,KRAMAT JATI,KAMPUNG TENGAH,43668,31324,12344,5298,17642,2021-07-10
3173011005,JAKARTA BARAT,CENGKARENG,KAPUK,121994,84970,37024,9543,46567,2021-07-10
3172011003,JAKARTA UTARA,PENJARINGAN,KAPUK MUARA,35498,20710,14788,6715,21503,2021-07-10
3171021002,JAKARTA PUSAT,SAWAH BESAR,KARANG ANYAR,25865,16433,9432,3417,12849,2021-07-10
3174021004,JAKARTA SELATAN,SETIA BUDI,KARET,9581,5765,3816,1441,5257,2021-07-10
3174021003,JAKARTA SELATAN,SETIA BUDI,KARET KUNINGAN,15939,9460,6479,2346,8825,2021-07-10
3174021002,JAKARTA SELATAN,SETIA BUDI,KARET SEMANGGI,2746,1400,1346,603,1949,2021-07-10
3171071003,JAKARTA PUSAT,TANAH ABANG,KARET TENGSIN,19113,12714,6399,2222,8621,2021-07-10
3171021003,JAKARTA PUSAT,SAWAH BESAR,KARTINI,22303,13543,8760,3472,12232,2021-07-10
3175011003,JAKARTA TIMUR,MATRAMAN,KAYU MANIS,25138,17124,8014,3021,11035,2021-07-10
3175021006,JAKARTA TIMUR,PULO GADUNG,KAYU PUTIH,40378,24015,16363,7125,23488,2021-07-10
3173031006,JAKARTA BARAT,TAMAN SARI,KEAGUNGAN,17231,10842,6389,2007,8396,2021-07-10
3174041007,JAKARTA SELATAN,PASAR MINGGU,KEBAGUSAN,44010,29545,14465,5232,19697,2021-07-10
3174051006,JAKARTA SELATAN,KEBAYORAN LAMA,KEBAYORAN LAMA SELATAN,40895,25337,15558,5832,21390,2021-07-10
3174051001,JAKARTA SELATAN,KEBAYORAN LAMA,KEBAYORAN LAMA UTARA,42214,28297,13917,5293,19210,2021-07-10
3174011004,JAKARTA SELATAN,TEBET,KEBON BARU,34878,22265,12613,5155,17768,2021-07-10
3172021005,JAKARTA UTARA,TANJUNG PRIOK,KEBON BAWANG,50597,32060,18537,6979,25516,2021-07-10
3173051001,JAKARTA BARAT,KEBON JERUK,KEBON JERUK,53296,36720,16576,6820,23396,2021-07-10
3171071006,JAKARTA PUSAT,TANAH ABANG,KEBON KACANG,21376,15562,5814,2640,8454,2021-07-10
3171011005,JAKARTA PUSAT,GAMBIR,KEBON KELAPA,10380,6715,3665,1660,5325,2021-07-10
3171031002,JAKARTA PUSAT,KEMAYORAN,KEBON KOSONG,30003,19662,10341,3487,13828,2021-07-10
3175011005,JAKARTA TIMUR,MATRAMAN,KEBON MANGGIS,16393,10177,6216,2791,9007,2021-07-10
3171071005,JAKARTA PUSAT,TANAH ABANG,KEBON MELATI,31355,24293,7062,2873,9935,2021-07-10
3175081003,JAKARTA TIMUR,MAKASAR,KEBON PALA,46176,31061,15115,6215,21330,2021-07-10
3171061005,JAKARTA PUSAT,MENTENG,KEBON SIRIH,12256,8796,3460,1554,5014,2021-07-10
3173011004,JAKARTA BARAT,CENGKARENG,KEDAUNG KALI ANGKE,32185,18760,13425,3236,16661,2021-07-10
3173051007,JAKARTA BARAT,KEBON JERUK,KEDOYA SELATAN,31907,20161,11746,4635,16381,2021-07-10
3173051006,JAKARTA BARAT,KEBON JERUK,KEDOYA UTARA,43826,25798,18028,7020,25048,2021-07-10
3173051004,JAKARTA BARAT,KEBON JERUK,KELAPA DUA,23293,15237,8056,3150,11206,2021-07-10
3175091003,JAKARTA TIMUR,CIRACAS,KELAPA DUA WETAN,46441,29748,16693,7323,24016,2021-07-10
3172061003,JAKARTA UTARA,KELAPA GADING,KELAPA GADING BARAT,35403,18553,16850,8889,25739,2021-07-10
3172061001,JAKARTA UTARA,KELAPA GADING,KELAPA GADING TIMUR,33472,15741,17731,9177,26908,2021-07-10
3173071005,JAKARTA BARAT,PALMERAH,KEMANGGISAN,31952,20209,11743,5233,16976,2021-07-10
3171031001,JAKARTA PUSAT,KEMAYORAN,KEMAYORAN,20947,12720,8227,2840,11067,2021-07-10
3173081006,JAKARTA BARAT,KEMBANGAN,KEMBANGAN SELATAN,26920,16545,10375,5046,15421,2021-07-10
3173081001,JAKARTA BARAT,KEMBANGAN,KEMBANGAN UTARA,52368,33504,18864,6643,25507,2021-07-10
3171041002,JAKARTA PUSAT,SENEN,KENARI,9317,5371,3946,1750,5696,2021-07-10
3173041005,JAKARTA BARAT,TAMBORA,KERENDANG,19869,13594,6275,2232,8507,2021-07-10
3175071003,JAKARTA TIMUR,DUREN SAWIT,KLENDER,69321,49829,19492,7466,26958,2021-07-10
3172031001,JAKARTA UTARA,KOJA,KOJA,28036,18712,9324,2764,12088,2021-07-10
3173071006,JAKARTA BARAT,PALMERAH,KOTA BAMBU SELATAN,20926,13966,6960,2248,9208,2021-07-10
3173071003,JAKARTA BARAT,PALMERAH,KOTA BAMBU UTARA,24416,16564,7852,2786,10638,2021-07-10
3171041004,JAKARTA PUSAT,SENEN,KRAMAT,28661,19944,8717,3004,11721,2021-07-10
3175041001,JAKARTA TIMUR,KRAMAT JATI,KRAMAT JATI,33851,22516,11335,5064,16399,2021-07-10
3174071003,JAKARTA SELATAN,KEBAYORAN BARU,KRAMAT PELA,14340,8377,5963,2382,8345,2021-07-10
3173031002,JAKARTA BARAT,TAMAN SARI,KRUKUT,19130,12121,7009,2295,9304,2021-07-10
3174031005,JAKARTA SELATAN,MAMPANG PRAPATAN,KUNINGAN BARAT,12675,7816,4859,1552,6411,2021-07-10
3174021008,JAKARTA SELATAN,SETIA BUDI,KUNINGAN TIMUR,5982,3661,2321,1064,3385,2021-07-10
3171041005,JAKARTA PUSAT,SENEN,KWITANG,15295,9681,5614,2105,7719,2021-07-10
3172031003,JAKARTA UTARA,KOJA,LAGOA,58726,41311,17415,5674,23089,2021-07-10
3174061002,JAKARTA SELATAN,CILANDAK,LEBAK BULUS,37213,23528,13685,5948,19633,2021-07-10
3174091004,JAKARTA SELATAN,JAGAKARSA,LENTENG AGUNG,53453,37229,16224,6177,22401,2021-07-10
3175101007,JAKARTA TIMUR,CIPAYUNG,LUBANG BUAYA,62984,40592,22392,8445,30837,2021-07-10
3175081001,JAKARTA TIMUR,MAKASAR,MAKASAR,34062,21406,12656,4992,17648,2021-07-10
3175071006,JAKARTA TIMUR,DUREN SAWIT,MALAKA JAYA,30744,18987,11757,5512,17269,2021-07-10
3175071005,JAKARTA TIMUR,DUREN SAWIT,MALAKA SARI,27015,16243,10772,5449,16221,2021-07-10
3174031001,JAKARTA SELATAN,MAMPANG PRAPATAN,MAMPANG PRAPATAN,18046,12025,6021,2060,8081,2021-07-10
3173031005,JAKARTA BARAT,TAMAN SARI,MANGGA BESAR,7439,3912,3527,1452,4979,2021-07-10
3171021005,JAKARTA PUSAT,SAWAH BESAR,MANGGA DUA SELATAN,27767,17646,10121,3873,13994,2021-07-10
3174011007,JAKARTA SELATAN,TEBET,MANGGARAI,28388,18829,9559,3570,13129,2021-07-10
3174011006,JAKARTA SELATAN,TEBET,MANGGARAI SELATAN,22902,13845,9057,3227,12284,2021-07-10
3173031003,JAKARTA BARAT,TAMAN SARI,MAPHAR,16385,9863,6522,2580,9102,2021-07-10
3172041003,JAKARTA UTARA,CILINCING,MARUNDA,28614,17912,10702,2591,13293,2021-07-10
3174071001,JAKARTA SELATAN,KEBAYORAN BARU,MELAWAI,2634,1307,1327,834,2161,2021-07-10
3171061001,JAKARTA PUSAT,MENTENG,MENTENG,25280,17874,7406,3552,10958,2021-07-10
3174021005,JAKARTA SELATAN,SETIA BUDI,MENTENG ATAS,27671,16877,10794,4049,14843,2021-07-10
3174011003,JAKARTA SELATAN,TEBET,MENTENG DALAM,35936,23306,12630,5209,17839,2021-07-10
3173081003,JAKARTA BARAT,KEMBANGAN,MERUYA SELATAN,31227,20174,11053,4343,15396,2021-07-10
3173081002,JAKARTA BARAT,KEMBANGAN,MERUYA UTARA,43382,27836,15546,6980,22526,2021-07-10
3175101004,JAKARTA TIMUR,CIPAYUNG,MUNJUL,23570,15619,7951,3619,11570,2021-07-10
3172051002,JAKARTA UTARA,PADEMANGAN,PADEMANGAN BARAT,73841,50062,23779,7827,31606,2021-07-10
3172051001,JAKARTA UTARA,PADEMANGAN,PADEMANGAN TIMUR,36757,20068,16689,6911,23600,2021-07-10
3175011004,JAKARTA TIMUR,MATRAMAN,PAL MERIAM,19632,12708,6924,2730,9654,2021-07-10
3173071001,JAKARTA BARAT,PALMERAH,PALMERAH,62175,40550,21625,8036,29661,2021-07-10
3174081001,JAKARTA SELATAN,PANCORAN,PANCORAN,19301,12092,7209,2664,9873,2021-07-10
3172021003,JAKARTA UTARA,TANJUNG PRIOK,PAPANGGO,38871,24691,14180,4751,18931,2021-07-10
3171021001,JAKARTA PUSAT,SAWAH BESAR,PASAR BARU,12710,6673,6037,2924,8961,2021-07-10
3174021006,JAKARTA SELATAN,SETIA BUDI,PASAR MANGGIS,26572,16654,9918,3561,13479,2021-07-10
3174041001,JAKARTA SELATAN,PASAR MINGGU,PASAR MINGGU,24670,15704,8966,4594,13560,2021-07-10
3171041003,JAKARTA PUSAT,SENEN,PASEBAN,23321,14864,8457,3315,11772,2021-07-10
3173061005,JAKARTA BARAT,KALI DERES,PEGADUNGAN,74685,47820,26865,9169,36034,2021-07-10
3171061002,JAKARTA PUSAT,MENTENG,PEGANGSAAN,21120,14086,7034,2967,10001,2021-07-10
3172061002,JAKARTA UTARA,KELAPA GADING,PEGANGSAAN DUA,49632,25267,24365,10550,34915,2021-07-10
3172011004,JAKARTA UTARA,PENJARINGAN,PEJAGALAN,74043,45090,28953,10960,39913,2021-07-10
3174041006,JAKARTA SELATAN,PASAR MINGGU,PEJATEN BARAT,35061,21565,13496,5657,19153,2021-07-10
3174041005,JAKARTA SELATAN,PASAR MINGGU,PEJATEN TIMUR,57257,39243,18014,6099,24113,2021-07-10
3175051005,JAKARTA TIMUR,PASAR REBO,PEKAYON,42705,27282,15423,6149,21572,2021-07-10
3173041009,JAKARTA BARAT,TAMBORA,PEKOJAN,23428,14450,8978,3432,12410,2021-07-10
3174031003,JAKARTA SELATAN,MAMPANG PRAPATAN,PELA MAMPANG,42709,27212,15497,5669,21166,2021-07-10
3174081005,JAKARTA SELATAN,PANCORAN,PENGADEGAN,21111,11755,9356,3339,12695,2021-07-10
3175061003,JAKARTA TIMUR,CAKUNG,PENGGILINGAN,97138,71838,25300,9410,34710,2021-07-10
3172011001,JAKARTA UTARA,PENJARINGAN,PENJARINGAN,86712,59336,27376,7873,35249,2021-07-10
3174101001,JAKARTA SELATAN,PESANGGRAHAN,PESANGGRAHAN,27215,16072,11143,4899,16042,2021-07-10
3171071004,JAKARTA PUSAT,TANAH ABANG,PETAMBURAN,33060,25211,7849,2951,10800,2021-07-10
3174071008,JAKARTA SELATAN,KEBAYORAN BARU,PETOGOGAN,11418,6932,4486,1866,6352,2021-07-10
3171011004,JAKARTA PUSAT,GAMBIR,PETOJO SELATAN,14946,9099,5847,3009,8856,2021-07-10
3171011003,JAKARTA PUSAT,GAMBIR,PETOJO UTARA,17843,11675,6168,2705,8873,2021-07-10
3174101004,JAKARTA SELATAN,PESANGGRAHAN,PETUKANGAN SELATAN,36769,23204,13565,4939,18504,2021-07-10
3174101003,JAKARTA SELATAN,PESANGGRAHAN,PETUKANGAN UTARA,53184,34613,18571,6765,25336,2021-07-10
3175081002,JAKARTA TIMUR,MAKASAR,PINANG RANTI,26915,17164,9751,3481,13232,2021-07-10
3173031008,JAKARTA BARAT,TAMAN SARI,PINANGSIA,10583,6004,4579,1636,6215,2021-07-10
3175011001,JAKARTA TIMUR,MATRAMAN,PISANGAN BARU,31537,22395,9142,3829,12971,2021-07-10
3175021002,JAKARTA TIMUR,PULO GADUNG,PISANGAN TIMUR,40576,26161,14415,5709,20124,2021-07-10
3172011005,JAKARTA UTARA,PENJARINGAN,PLUIT,47433,25312,22121,12379,34500,2021-07-10
3175071002,JAKARTA TIMUR,DUREN SAWIT,PONDOK BAMBU,61047,39873,21174,8949,30123,2021-07-10
3175071004,JAKARTA TIMUR,DUREN SAWIT,PONDOK KELAPA,71347,45105,26242,11042,37284,2021-07-10
3175071007,JAKARTA TIMUR,DUREN SAWIT,PONDOK KOPI,35051,24637,10414,4373,14787,2021-07-10
3174061003,JAKARTA SELATAN,CILANDAK,PONDOK LABU,45944,28147,17797,6916,24713,2021-07-10
3174051002,JAKARTA SELATAN,KEBAYORAN LAMA,PONDOK PINANG,55724,36013,19711,9688,29399,2021-07-10
3175101003,JAKARTA TIMUR,CIPAYUNG,PONDOK RANGGON,25123,17148,7975,3804,11779,2021-07-10
3101011003,KAB.ADM.KEP.SERIBU,KEP. SERIBU UTARA,PULAU HARAPAN,2036,731,1305,670,1975,2021-07-10
3101011002,KAB.ADM.KEP.SERIBU,KEP. SERIBU UTARA,PULAU KELAPA,5460,1989,3471,1084,4555,2021-07-10
3101011001,KAB.ADM.KEP.SERIBU,KEP. SERIBU UTARA,PULAU PANGGANG,5395,1863,3532,1148,4680,2021-07-10
3101021003,KAB.ADM.KEP.SERIBU,KEP. SERIBU SELATAN,PULAU PARI,2736,799,1937,614,2551,2021-07-10
3101021002,KAB.ADM.KEP.SERIBU,KEP. SERIBU SELATAN,PULAU TIDUNG,4528,1660,2868,1133,4001,2021-07-10
3101021001,KAB.ADM.KEP.SERIBU,KEP. SERIBU SELATAN,PULAU UNTUNG JAWA,1918,672,1246,559,1805,2021-07-10
3174071007,JAKARTA SELATAN,KEBAYORAN BARU,PULO,5777,3068,2709,1356,4065,2021-07-10
3175021001,JAKARTA TIMUR,PULO GADUNG,PULO GADUNG,34175,22897,11278,4686,15964,2021-07-10
3175061005,JAKARTA TIMUR,CAKUNG,PULO GEBANG,95947,67260,28687,10738,39425,2021-07-10
3174041004,JAKARTA SELATAN,PASAR MINGGU,RAGUNAN,39233,23643,15590,5842,21432,2021-07-10
3175091005,JAKARTA TIMUR,CIRACAS,RAMBUTAN,36368,26533,9835,4320,14155,2021-07-10
3172031006,JAKARTA UTARA,KOJA,RAWA BADAK SELATAN,41895,29386,12509,3963,16472,2021-07-10
3172031004,JAKARTA UTARA,KOJA,RAWA BADAK UTARA,33538,21875,11663,3879,15542,2021-07-10
3174071005,JAKARTA SELATAN,KEBAYORAN BARU,RAWA BARAT,5574,3140,2434,1334,3768,2021-07-10
3173011003,JAKARTA BARAT,CENGKARENG,RAWA BUAYA,59533,38939,20594,6019,26613,2021-07-10
3175031004,JAKARTA TIMUR,JATINEGARA,RAWA BUNGA,21272,14980,6292,2483,8775,2021-07-10
3174081003,JAKARTA SELATAN,PANCORAN,RAWA JATI,20321,12281,8040,3444,11484,2021-07-10
3175061002,JAKARTA TIMUR,CAKUNG,RAWA TERATE,24433,15417,9016,2132,11148,2021-07-10
3175021005,JAKARTA TIMUR,PULO GADUNG,RAWAMANGUN,36788,23592,13196,5884,19080,2021-07-10
3171051003,JAKARTA PUSAT,CEMPAKA PUTIH,RAWASARI,21770,13591,8179,3503,11682,2021-07-10
3173041010,JAKARTA BARAT,TAMBORA,ROA MALAKA,3449,1704,1745,887,2632,2021-07-10
3172041006,JAKARTA UTARA,CILINCING,ROROTAN,40953,26113,14840,4617,19457,2021-07-10
3174071004,JAKARTA SELATAN,KEBAYORAN BARU,SELONG,2843,1439,1404,886,2290,2021-07-10
3173061002,JAKARTA BARAT,KALI DERES,SEMANAN,70293,50894,19399,5023,24422,2021-07-10
3172041007,JAKARTA UTARA,CILINCING,SEMPER BARAT,67899,42332,25567,9118,34685,2021-07-10
3172041005,JAKARTA UTARA,CILINCING,SEMPER TIMUR,36029,23314,12715,4336,17051,2021-07-10
3174071006,JAKARTA SELATAN,KEBAYORAN BARU,SENAYAN,2780,1756,1024,574,1598,2021-07-10
3171041001,JAKARTA PUSAT,SENEN,SENEN,6757,4127,2630,1191,3821,2021-07-10
3171031004,JAKARTA PUSAT,KEMAYORAN,SERDANG,29730,19116,10614,3962,14576,2021-07-10
3174021001,JAKARTA SELATAN,SETIA BUDI,SETIA BUDI,2841,1642,1199,650,1849,2021-07-10
3175101005,JAKARTA TIMUR,CIPAYUNG,SETU,20306,14481,5825,2684,8509,2021-07-10
3173071002,JAKARTA BARAT,PALMERAH,SLIPI,16475,10022,6453,2744,9197,2021-07-10
3173081004,JAKARTA BARAT,KEMBANGAN,SRENGSENG,44969,30740,14229,6201,20430,2021-07-10
3174091002,JAKARTA SELATAN,JAGAKARSA,SRENGSENG SAWAH,57480,33445,24035,8930,32965,2021-07-10
3173051003,JAKARTA BARAT,KEBON JERUK,SUKABUMI SELATAN,35170,24631,10539,3496,14035,2021-07-10
3173051002,JAKARTA BARAT,KEBON JERUK,SUKABUMI UTARA,37628,27143,10485,4027,14512,2021-07-10
3172041002,JAKARTA UTARA,CILINCING,SUKAPURA,53786,35906,17880,5478,23358,2021-07-10
3171031007,JAKARTA PUSAT,KEMAYORAN,SUMUR BATU,22506,13976,8530,3413,11943,2021-07-10
3172021004,JAKARTA UTARA,TANJUNG PRIOK,SUNGAI BAMBU,29115,18305,10810,3569,14379,2021-07-10
3172021006,JAKARTA UTARA,TANJUNG PRIOK,SUNTER AGUNG,70860,39272,31588,13595,45183,2021-07-10
3172021002,JAKARTA UTARA,TANJUNG PRIOK,SUNTER JAYA,62516,37663,24853,10519,35372,2021-07-10
3175091004,JAKARTA TIMUR,CIRACAS,SUSUKAN,33525,21408,12117,4639,16756,2021-07-10
3173031001,JAKARTA BARAT,TAMAN SARI,TAMAN SARI,14281,8582,5699,2405,8104,2021-07-10
3173041001,JAKARTA BARAT,TAMBORA,TAMBORA,10177,6558,3619,1524,5143,2021-07-10
3173041004,JAKARTA BARAT,TAMBORA,TANAH SEREAL,25944,15279,10665,3900,14565,2021-07-10
3171081004,JAKARTA PUSAT,JOHAR BARU,TANAH TINGGI,37800,23295,14505,4271,18776,2021-07-10
3173031004,JAKARTA BARAT,TAMAN SARI,TANGKI,12991,7849,5142,1935,7077,2021-07-10
3174091005,JAKARTA SELATAN,JAGAKARSA,TANJUNG BARAT,39368,26491,12877,5722,18599,2021-07-10
3173021005,JAKARTA BARAT,GROGOL PETAMBURAN,TANJUNG DUREN SELATAN,24917,13888,11029,4503,15532,2021-07-10
3173021002,JAKARTA BARAT,GROGOL PETAMBURAN,TANJUNG DUREN UTARA,16940,8882,8058,3546,11604,2021-07-10
3172021001,JAKARTA UTARA,TANJUNG PRIOK,TANJUNG PRIOK,34316,21141,13175,3851,17026,2021-07-10
3174011002,JAKARTA SELATAN,TEBET,TEBET BARAT,21164,12330,8834,4224,13058,2021-07-10
3174011001,JAKARTA SELATAN,TEBET,TEBET TIMUR,18030,9880,8150,3779,11929,2021-07-10
3173061003,JAKARTA BARAT,KALI DERES,TEGAL ALUR,82647,56518,26129,6891,33020,2021-07-10
3174031004,JAKARTA SELATAN,MAMPANG PRAPATAN,TEGAL PARANG,32174,23002,9172,3331,12503,2021-07-10
3173021003,JAKARTA BARAT,GROGOL PETAMBURAN,TOMANG,28665,16774,11891,5006,16897,2021-07-10
3172031005,JAKARTA UTARA,KOJA,TUGU SELATAN,38749,27224,11525,3839,15364,2021-07-10
3172031002,JAKARTA UTARA,KOJA,TUGU UTARA,67211,46676,20535,6782,27317,2021-07-10
3175061006,JAKARTA TIMUR,CAKUNG,UJUNG MENTENG,29527,19288,10239,4000,14239,2021-07-10
3174101005,JAKARTA SELATAN,PESANGGRAHAN,ULUJAMI,40120,27710,12410,4960,17370,2021-07-10
3175011006,JAKARTA TIMUR,MATRAMAN,UTAN KAYU SELATAN,33233,20929,12304,5080,17384,2021-07-10
3175011002,JAKARTA TIMUR,MATRAMAN,UTAN KAYU UTARA,27995,17833,10162,3839,14001,2021-07-10
3171031008,JAKARTA PUSAT,KEMAYORAN,UTAN PANJANG,29260,20505,8755,2819,11574,2021-07-10
3172021007,JAKARTA UTARA,TANJUNG PRIOK,WARAKAS,43754,28002,15752,5246,20998,2021-07-10
3173021007,JAKARTA BARAT,GROGOL PETAMBURAN,WIJAYA KUSUMA,38584,25134,13450,4881,18331,2021-07-10
3172051003,JAKARTA UTARA,PADEMANGAN,ANCOL,23379,15449,7930,3318,11248,2021-07-11
3173041007,JAKARTA BARAT,TAMBORA,ANGKE,29230,18290,10940,3254,14194,2021-07-11
3175041005,JAKARTA TIMUR,KRAMAT JATI,BALE KAMBANG,28803,21558,7245,2685,9930,2021-07-11
3175031003,JAKARTA TIMUR,JATINEGARA,BALI MESTER,9675,6334,3341,1538,4879,2021-07-11
3175101006,JAKARTA TIMUR,CIPAYUNG,BAMBU APUS,25985,17580,8405,4019,12424,2021-07-11
3174031002,JAKARTA SELATAN,MAMPANG PRAPATAN,BANGKA,21356,13925,7431,2746,10177,2021-07-11
3175051002,JAKARTA TIMUR,PASAR REBO,BARU,23514,13446,10068,4729,14797,2021-07-11
3175041004,JAKARTA TIMUR,KRAMAT JATI,BATU AMPAR,47416,34633,12783,5334,18117,2021-07-11
3171071002,JAKARTA PUSAT,TANAH ABANG,BENDUNGAN HILIR,21374,12970,8404,3614,12018,2021-07-11
3175031002,JAKARTA TIMUR,JATINEGARA,BIDARA CINA,36461,26029,10432,4076,14508,2021-07-11
3174101002,JAKARTA SELATAN,PESANGGRAHAN,BINTARO,52402,34703,17699,7163,24862,2021-07-11
3174011005,JAKARTA SELATAN,TEBET,BUKIT DURI,33953,22799,11154,3990,15144,2021-07-11
3171041006,JAKARTA PUSAT,SENEN,BUNGUR,17929,11186,6743,2776,9519,2021-07-11
3175061007,JAKARTA TIMUR,CAKUNG,CAKUNG BARAT,57222,37896,19326,4067,23393,2021-07-11
3175061004,JAKARTA TIMUR,CAKUNG,CAKUNG TIMUR,57655,37907,19748,6468,26216,2021-07-11
3175041007,JAKARTA TIMUR,KRAMAT JATI,CAWANG,32481,21902,10579,4341,14920,2021-07-11
3175101008,JAKARTA TIMUR,CIPAYUNG,CEGER,18740,12506,6234,2593,8827,2021-07-11
3171031006,JAKARTA PUSAT,KEMAYORAN,CEMPAKA BARU,31257,20945,10312,4056,14368,2021-07-11
3171051002,JAKARTA PUSAT,CEMPAKA PUTIH,CEMPAKA PUTIH BARAT,34725,23190,11535,5014,16549,2021-07-11
3171051001,JAKARTA PUSAT,CEMPAKA PUTIH,CEMPAKA PUTIH TIMUR,24170,14694,9476,4508,13984,2021-07-11
3173011001,JAKARTA BARAT,CENGKARENG,CENGKARENG BARAT,65702,39977,25725,8298,34023,2021-07-11
3173011006,JAKARTA BARAT,CENGKARENG,CENGKARENG TIMUR,80100,51994,28106,8568,36674,2021-07-11
3175091002,JAKARTA TIMUR,CIRACAS,CIBUBUR,65231,41577,23654,9609,33263,2021-07-11
3171011002,JAKARTA PUSAT,GAMBIR,CIDENG,15696,9022,6674,3214,9888,2021-07-11
3174091003,JAKARTA SELATAN,JAGAKARSA,CIGANJUR,38048,24720,13328,5216,18544,2021-07-11
3175051003,JAKARTA TIMUR,PASAR REBO,CIJANTUNG,41013,26059,14954,6269,21223,2021-07-11
3171061003,JAKARTA PUSAT,MENTENG,CIKINI,8260,5408,2852,1380,4232,2021-07-11
3174081006,JAKARTA SELATAN,PANCORAN,CIKOKO,10503,6035,4468,1772,6240,2021-07-11
3174061001,JAKARTA SELATAN,CILANDAK,CILANDAK BARAT,51346,30344,21002,7957,28959,2021-07-11
3174041003,JAKARTA SELATAN,PASAR MINGGU,CILANDAK TIMUR,24239,14505,9734,4896,14630,2021-07-11
3175101002,JAKARTA TIMUR,CIPAYUNG,CILANGKAP,27179,17985,9194,3847,13041,2021-07-11
3175041006,JAKARTA TIMUR,KRAMAT JATI,CILILITAN,39984,27861,12123,5325,17448,2021-07-11
3172041001,JAKARTA UTARA,CILINCING,CILINCING,42677,30109,12568,3960,16528,2021-07-11
3175101001,JAKARTA TIMUR,CIPAYUNG,CIPAYUNG,25747,15848,9899,4273,14172,2021-07-11
3174091006,JAKARTA SELATAN,JAGAKARSA,CIPEDAK,37809,23784,14025,4849,18874,2021-07-11
3174061005,JAKARTA SELATAN,CILANDAK,CIPETE SELATAN,26500,16547,9953,3856,13809,2021-07-11
3174071010,JAKARTA SELATAN,KEBAYORAN BARU,CIPETE UTARA,33902,20821,13081,4132,17213,2021-07-11
3175021003,JAKARTA TIMUR,PULO GADUNG,CIPINANG,39069,25296,13773,6115,19888,2021-07-11
3175031007,JAKARTA TIMUR,JATINEGARA,CIPINANG BESAR SELATAN,34938,25488,9450,3940,13390,2021-07-11
3175031008,JAKARTA TIMUR,JATINEGARA,CIPINANG BESAR UTARA,44479,33439,11040,4220,15260,2021-07-11
3175031005,JAKARTA TIMUR,JATINEGARA,CIPINANG CEMPEDAK,32695,22247,10448,4736,15184,2021-07-11
3175081005,JAKARTA TIMUR,MAKASAR,CIPINANG MELAYU,42144,26866,15278,6460,21738,2021-07-11
3175031006,JAKARTA TIMUR,JATINEGARA,CIPINANG MUARA,53251,37403,15848,7366,23214,2021-07-11
3174051003,JAKARTA SELATAN,KEBAYORAN LAMA,CIPULIR,39635,26859,12776,4839,17615,2021-07-11
3175091001,JAKARTA TIMUR,CIRACAS,CIRACAS,63801,41178,22623,8523,31146,2021-07-11
3175041003,JAKARTA TIMUR,KRAMAT JATI,DUKUH,24404,16557,7847,3548,11395,2021-07-11
3175071001,JAKARTA TIMUR,DUREN SAWIT,DUREN SAWIT,60443,40076,20367,9335,29702,2021-07-11
3174081004,JAKARTA SELATAN,PANCORAN,DUREN TIGA,28099,17630,10469,3865,14334,2021-07-11
3173051005,JAKARTA BARAT,KEBON JERUK,DURI KEPA,59448,35388,24060,10066,34126,2021-07-11
3173011002,JAKARTA BARAT,CENGKARENG,DURI KOSAMBI,75895,49592,26303,8264,34567,2021-07-11
3171011006,JAKARTA PUSAT,GAMBIR,DURI PULO,19986,13702,6284,2409,8693,2021-07-11
3173041011,JAKARTA BARAT,TAMBORA,DURI SELATAN,14099,8687,5412,2379,7791,2021-07-11
3173041003,JAKARTA BARAT,TAMBORA,DURI UTARA,19768,12741,7027,2653,9680,2021-07-11
3171081003,JAKARTA PUSAT,JOHAR BARU,GALUR,18098,10541,7557,1980,9537,2021-07-11
3171011001,JAKARTA PUSAT,GAMBIR,GAMBIR,2434,1362,1072,582,1654,2021-07-11
3174061004,JAKARTA SELATAN,CILANDAK,GANDARIA SELATAN,21926,13867,8059,2862,10921,2021-07-11
3174071009,JAKARTA SELATAN,KEBAYORAN BARU,GANDARIA UTARA,39609,25030,14579,5395,19974,2021-07-11
3175051001,JAKARTA TIMUR,PASAR REBO,GEDONG,35444,23439,12005,5351,17356,2021-07-11
3171071001,JAKARTA PUSAT,TANAH ABANG,GELORA,3106,1943,1163,572,1735,2021-07-11
3173031007,JAKARTA BARAT,TAMAN SARI,GLODOK,7836,3752,4084,1986,6070,2021-07-11
3171061004,JAKARTA PUSAT,MENTENG,GONDANGDIA,4093,2107,1986,1299,3285,2021-07-11
3173021001,JAKARTA BARAT,GROGOL PETAMBURAN,GROGOL,16815,10507,6308,2625,8933,2021-07-11
3174051005,JAKARTA SELATAN,KEBAYORAN LAMA,GROGOL SELATAN,43915,30153,13762,5500,19262,2021-07-11
3174051004,JAKARTA SELATAN,KEBAYORAN LAMA,GROGOL UTARA,42216,28385,13831,5882,19713,2021-07-11
3174021007,JAKARTA SELATAN,SETIA BUDI,GUNTUR,3962,2107,1855,997,2852,2021-07-11
3174071002,JAKARTA SELATAN,KEBAYORAN BARU,GUNUNG,9344,5365,3979,2047,6026,2021-07-11
3171031005,JAKARTA PUSAT,KEMAYORAN,GUNUNG SAHARI SELATAN,19380,12120,7260,2838,10098,2021-07-11
3171021004,JAKARTA PUSAT,SAWAH BESAR,GUNUNG SAHARI UTARA,15647,8203,7444,3396,10840,2021-07-11
3175081004,JAKARTA TIMUR,MAKASAR,HALIM PERDANA KUSUMAH,28110,13662,14448,9347,23795,2021-07-11
3171031003,JAKARTA PUSAT,KEMAYORAN,HARAPAN MULIA,22700,15204,7496,2714,10210,2021-07-11
3174091001,JAKARTA SELATAN,JAGAKARSA,JAGAKARSA,61552,37662,23890,8587,32477,2021-07-11
3175021007,JAKARTA TIMUR,PULO GADUNG,JATI,32443,20676,11767,5652,17419,2021-07-11
3174041002,JAKARTA SELATAN,PASAR MINGGU,JATI PADANG,37250,23443,13807,5898,19705,2021-07-11
3173071004,JAKARTA BARAT,PALMERAH,JATI PULO,27994,16772,11222,3681,14903,2021-07-11
3175061001,JAKARTA TIMUR,CAKUNG,JATINEGARA,83563,61645,21918,6836,28754,2021-07-11
3175021004,JAKARTA TIMUR,PULO GADUNG,JATINEGARA KAUM,24364,16501,7863,2954,10817,2021-07-11
3173021004,JAKARTA BARAT,GROGOL PETAMBURAN,JELAMBAR,30180,17753,12427,5505,17932,2021-07-11
3173021006,JAKARTA BARAT,GROGOL PETAMBURAN,JELAMBAR BARU,37799,22918,14881,6106,20987,2021-07-11
3173041006,JAKARTA BARAT,TAMBORA,JEMBATAN BESI,29182,22002,7180,2444,9624,2021-07-11
3173041008,JAKARTA BARAT,TAMBORA,JEMBATAN LIMA,20627,14439,6188,2279,8467,2021-07-11
3173081005,JAKARTA BARAT,KEMBANGAN,JOGLO,40475,26479,13996,5985,19981,2021-07-11
3171081001,JAKARTA PUSAT,JOHAR BARU,JOHAR BARU,32845,18362,14483,5366,19849,2021-07-11
3173041002,JAKARTA BARAT,TAMBORA,KALI ANYAR,23582,17251,6331,2252,8583,2021-07-11
3172041004,JAKARTA UTARA,CILINCING,KALIBARU,67165,50198,16967,4368,21335,2021-07-11
3174081002,JAKARTA SELATAN,PANCORAN,KALIBATA,41464,28170,13294,4959,18253,2021-07-11
3173061001,JAKARTA BARAT,KALI DERES,KALIDERES,69014,45820,23194,7638,30832,2021-07-11
3175051004,JAKARTA TIMUR,PASAR REBO,KALISARI,42557,27147,15410,6851,22261,2021-07-11
3173061004,JAKARTA BARAT,KALI DERES,KAMAL,53180,39417,13763,3674,17437,2021-07-11
3172011002,JAKARTA UTARA,PENJARINGAN,KAMAL MUARA,12679,6672,6007,2525,8532,2021-07-11
3171071007,JAKARTA PUSAT,TANAH ABANG,KAMPUNG BALI,11551,7971,3580,1521,5101,2021-07-11
3175031001,JAKARTA TIMUR,JATINEGARA,KAMPUNG MELAYU,25476,18925,6551,2252,8803,2021-07-11
3171081002,JAKARTA PUSAT,JOHAR BARU,KAMPUNG RAWA,18247,9104,9143,2554,11697,2021-07-11
3175041002,JAKARTA TIMUR,KRAMAT JATI,KAMPUNG TENGAH,43668,31315,12353,5298,17651,2021-07-11
3173011005,JAKARTA BARAT,CENGKARENG,KAPUK,121994,84954,37040,9545,46585,2021-07-11
3172011003,JAKARTA UTARA,PENJARINGAN,KAPUK MUARA,35498,20709,14789,6715,21504,2021-07-11
3171021002,JAKARTA PUSAT,SAWAH BESAR,KARANG ANYAR,25865,16414,9451,3417,12868,2021-07-11
3174021004,JAKARTA SELATAN,SETIA BUDI,KARET,9581,5762,3819,1441,5260,2021-07-11
3174021003,JAKARTA SELATAN,SETIA BUDI,KARET KUNINGAN,15939,9452,6487,2346,8833,2021-07-11
3174021002,JAKARTA SELATAN,SETIA BUDI,KARET SEMANGGI,2746,1399,1347,603,1950,2021-07-11
3171071003,JAKARTA PUSAT,TANAH ABANG,KARET TENGSIN,19113,12661,6452,2222,8674,2021-07-11
3171021003,JAKARTA PUSAT,SAWAH BESAR,KARTINI,22303,13524,8779,3472,12251,2021-07-11
3175011003,JAKARTA TIMUR,MATRAMAN,KAYU MANIS,25138,17109,8029,3021,11050,2021-07-11
3175021006,JAKARTA TIMUR,PULO GADUNG,KAYU PUTIH,40378,23987,16391,7126,23517,2021-07-11
3173031006,JAKARTA BARAT,TAMAN SARI,KEAGUNGAN,17231,10837,6394,2007,8401,2021-07-11
3174041007,JAKARTA SELATAN,PASAR MINGGU,KEBAGUSAN,44010,29533,14477,5232,19709,2021-07-11
3174051006,JAKARTA SELATAN,KEBAYORAN LAMA,KEBAYORAN LAMA SELATAN,40895,25324,15571,5833,21404,2021-07-11
3174051001,JAKARTA SELATAN,KEBAYORAN LAMA,KEBAYORAN LAMA UTARA,42214,28287,13927,5293,19220,2021-07-11
3174011004,JAKARTA SELATAN,TEBET,KEBON BARU,34878,22258,12620,5155,17775,2021-07-11
3172021005,JAKARTA UTARA,TANJUNG PRIOK,KEBON BAWANG,50597,32052,18545,6979,25524,2021-07-11
3173051001,JAKARTA BARAT,KEBON JERUK,KEBON JERUK,53296,36696,16600,6821,23421,2021-07-11
3171071006,JAKARTA PUSAT,TANAH ABANG,KEBON KACANG,21376,15420,5956,2641,8597,2021-07-11
3171011005,JAKARTA PUSAT,GAMBIR,KEBON KELAPA,10380,6707,3673,1660,5333,2021-07-11
3171031002,JAKARTA PUSAT,KEMAYORAN,KEBON KOSONG,30003,19644,10359,3487,13846,2021-07-11
3175011005,JAKARTA TIMUR,MATRAMAN,KEBON MANGGIS,16393,10166,6227,2792,9019,2021-07-11
3171071005,JAKARTA PUSAT,TANAH ABANG,KEBON MELATI,31355,24200,7155,2875,10030,2021-07-11
3175081003,JAKARTA TIMUR,MAKASAR,KEBON PALA,46176,31040,15136,6216,21352,2021-07-11
3171061005,JAKARTA PUSAT,MENTENG,KEBON SIRIH,12256,8711,3545,1555,5100,2021-07-11
3173011004,JAKARTA BARAT,CENGKARENG,KEDAUNG KALI ANGKE,32185,18747,13438,3236,16674,2021-07-11
3173051007,JAKARTA BARAT,KEBON JERUK,KEDOYA SELATAN,31907,20157,11750,4635,16385,2021-07-11
3173051006,JAKARTA BARAT,KEBON JERUK,KEDOYA UTARA,43826,25789,18037,7020,25057,2021-07-11
3173051004,JAKARTA BARAT,KEBON JERUK,KELAPA DUA,23293,15233,8060,3150,11210,2021-07-11
3175091003,JAKARTA TIMUR,CIRACAS,KELAPA DUA WETAN,46441,29735,16706,7324,24030,2021-07-11
3172061003,JAKARTA UTARA,KELAPA GADING,KELAPA GADING BARAT,35403,18533,16870,8889,25759,2021-07-11
3172061001,JAKARTA UTARA,KELAPA GADING,KELAPA GADING TIMUR,33472,15731,17741,9178,26919,2021-07-11
3173071005,JAKARTA BARAT,PALMERAH,KEMANGGISAN,31952,20202,11750,5233,16983,2021-07-11
3171031001,JAKARTA PUSAT,KEMAYORAN,KEMAYORAN,20947,12704,8243,2840,11083,2021-07-11
3173081006,JAKARTA BARAT,KEMBANGAN,KEMBANGAN SELATAN,26920,16544,10376,5046,15422,2021-07-11
3173081001,JAKARTA BARAT,KEMBANGAN,KEMBANGAN UTARA,52368,33495,18873,6643,25516,2021-07-11
3171041002,JAKARTA PUSAT,SENEN,KENARI,9317,5362,3955,1750,5705,2021-07-11
3173041005,JAKARTA BARAT,TAMBORA,KERENDANG,19869,13590,6279,2233,8512,2021-07-11
3175071003,JAKARTA TIMUR,DUREN SAWIT,KLENDER,69321,49808,19513,7466,26979,2021-07-11
3172031001,JAKARTA UTARA,KOJA,KOJA,28036,18707,9329,2764,12093,2021-07-11
3173071006,JAKARTA BARAT,PALMERAH,KOTA BAMBU SELATAN,20926,13954,6972,2248,9220,2021-07-11
3173071003,JAKARTA BARAT,PALMERAH,KOTA BAMBU UTARA,24416,16557,7859,2786,10645,2021-07-11
3171041004,JAKARTA PUSAT,SENEN,KRAMAT,28661,19893,8768,3006,11774,2021-07-11
3175041001,JAKARTA TIMUR,KRAMAT JATI,KRAMAT JATI,33851,22512,11339,5064,16403,2021-07-11
3174071003,JAKARTA SELATAN,KEBAYORAN BARU,KRAMAT PELA,14340,8376,5964,2382,8346,2021-07-11
3173031002,JAKARTA BARAT,TAMAN SARI,KRUKUT,19130,12116,7014,2295,9309,2021-07-11
3174031005,JAKARTA SELATAN,MAMPANG PRAPATAN,KUNINGAN BARAT,12675,7814,4861,1552,6413,2021-07-11
3174021008,JAKARTA SELATAN,SETIA BUDI,KUNINGAN TIMUR,5982,3660,2322,1065,3387,2021-07-11
3171041005,JAKARTA PUSAT,SENEN,KWITANG,15295,9665,5630,2105,7735,2021-07-11
3172031003,JAKARTA UTARA,KOJA,LAGOA,58726,41298,17428,5675,23103,2021-07-11
3174061002,JAKARTA SELATAN,CILANDAK,LEBAK BULUS,37213,23523,13690,5949,19639,2021-07-11
3174091004,JAKARTA SELATAN,JAGAKARSA,LENTENG AGUNG,53453,37216,16237,6177,22414,2021-07-11
3175101007,JAKARTA TIMUR,CIPAYUNG,LUBANG BUAYA,62984,40574,22410,8445,30855,2021-07-11
3175081001,JAKARTA TIMUR,MAKASAR,MAKASAR,34062,21394,12668,4992,17660,2021-07-11
3175071006,JAKARTA TIMUR,DUREN SAWIT,MALAKA JAYA,30744,18976,11768,5512,17280,2021-07-11
3175071005,JAKARTA TIMUR,DUREN SAWIT,MALAKA SARI,27015,16237,10778,5449,16227,2021-07-11
3174031001,JAKARTA SELATAN,MAMPANG PRAPATAN,MAMPANG PRAPATAN,18046,12021,6025,2060,8085,2021-07-11
3173031005,JAKARTA BARAT,TAMAN SARI,MANGGA BESAR,7439,3911,3528,1452,4980,2021-07-11
3171021005,JAKARTA PUSAT,SAWAH BESAR,MANGGA DUA SELATAN,27767,17608,10159,3873,14032,2021-07-11
3174011007,JAKARTA SELATAN,TEBET,MANGGARAI,28388,18820,9568,3570,13138,2021-07-11
3174011006,JAKARTA SELATAN,TEBET,MANGGARAI SELATAN,22902,13841,9061,3227,12288,2021-07-11
3173031003,JAKARTA BARAT,TAMAN SARI,MAPHAR,16385,9856,6529,2580,9109,2021-07-11
3172041003,JAKARTA UTARA,CILINCING,MARUNDA,28614,17911,10703,2591,13294,2021-07-11
3174071001,JAKARTA SELATAN,KEBAYORAN BARU,MELAWAI,2634,1307,1327,834,2161,2021-07-11
3171061001,JAKARTA PUSAT,MENTENG,MENTENG,25280,17861,7419,3552,10971,2021-07-11
3174021005,JAKARTA SELATAN,SETIA BUDI,MENTENG ATAS,27671,16868,10803,4050,14853,2021-07-11
3174011003,JAKARTA SELATAN,TEBET,MENTENG DALAM,35936,23302,12634,5209,17843,2021-07-11
3173081003,JAKARTA BARAT,KEMBANGAN,MERUYA SELATAN,31227,20174,11053,4343,15396,2021-07-11
3173081002,JAKARTA BARAT,KEMBANGAN,MERUYA UTARA,43382,27828,15554,6980,22534,2021-07-11
3175101004,JAKARTA TIMUR,CIPAYUNG,MUNJUL,23570,15618,7952,3621,11573,2021-07-11
3172051002,JAKARTA UTARA,PADEMANGAN,PADEMANGAN BARAT,73841,50043,23798,7827,31625,2021-07-11
3172051001,JAKARTA UTARA,PADEMANGAN,PADEMANGAN TIMUR,36757,20060,16697,6912,23609,2021-07-11
3175011004,JAKARTA TIMUR,MATRAMAN,PAL MERIAM,19632,12702,6930,2732,9662,2021-07-11
3173071001,JAKARTA BARAT,PALMERAH,PALMERAH,62175,40538,21637,8038,29675,2021-07-11
3174081001,JAKARTA SELATAN,PANCORAN,PANCORAN,19301,12090,7211,2665,9876,2021-07-11
3172021003,JAKARTA UTARA,TANJUNG PRIOK,PAPANGGO,38871,24685,14186,4753,18939,2021-07-11
3171021001,JAKARTA PUSAT,SAWAH BESAR,PASAR BARU,12710,6666,6044,2924,8968,2021-07-11
3174021006,JAKARTA SELATAN,SETIA BUDI,PASAR MANGGIS,26572,16637,9935,3561,13496,2021-07-11
3174041001,JAKARTA SELATAN,PASAR MINGGU,PASAR MINGGU,24670,15700,8970,4594,13564,2021-07-11
3171041003,JAKARTA PUSAT,SENEN,PASEBAN,23321,14842,8479,3317,11796,2021-07-11
3173061005,JAKARTA BARAT,KALI DERES,PEGADUNGAN,74685,47818,26867,9169,36036,2021-07-11
3171061002,JAKARTA PUSAT,MENTENG,PEGANGSAAN,21120,14075,7045,2967,10012,2021-07-11
3172061002,JAKARTA UTARA,KELAPA GADING,PEGANGSAAN DUA,49632,25253,24379,10551,34930,2021-07-11
3172011004,JAKARTA UTARA,PENJARINGAN,PEJAGALAN,74043,45079,28964,10961,39925,2021-07-11
3174041006,JAKARTA SELATAN,PASAR MINGGU,PEJATEN BARAT,35061,21562,13499,5657,19156,2021-07-11
3174041005,JAKARTA SELATAN,PASAR MINGGU,PEJATEN TIMUR,57257,39231,18026,6102,24128,2021-07-11
3175051005,JAKARTA TIMUR,PASAR REBO,PEKAYON,42705,27272,15433,6149,21582,2021-07-11
3173041009,JAKARTA BARAT,TAMBORA,PEKOJAN,23428,14447,8981,3432,12413,2021-07-11
3174031003,JAKARTA SELATAN,MAMPANG PRAPATAN,PELA MAMPANG,42709,27199,15510,5670,21180,2021-07-11
3174081005,JAKARTA SELATAN,PANCORAN,PENGADEGAN,21111,11752,9359,3339,12698,2021-07-11
3175061003,JAKARTA TIMUR,CAKUNG,PENGGILINGAN,97138,71752,25386,9411,34797,2021-07-11
3172011001,JAKARTA UTARA,PENJARINGAN,PENJARINGAN,86712,59328,27384,7873,35257,2021-07-11
3174101001,JAKARTA SELATAN,PESANGGRAHAN,PESANGGRAHAN,27215,16062,11153,4899,16052,2021-07-11
3171071004,JAKARTA PUSAT,TANAH ABANG,PETAMBURAN,33060,25133,7927,2951,10878,2021-07-11
3174071008,JAKARTA SELATAN,KEBAYORAN BARU,PETOGOGAN,11418,6930,4488,1866,6354,2021-07-11
3171011004,JAKARTA PUSAT,GAMBIR,PETOJO SELATAN,14946,9085,5861,3009,8870,2021-07-11
3171011003,JAKARTA PUSAT,GAMBIR,PETOJO UTARA,17843,11645,6198,2705,8903,2021-07-11
3174101004,JAKARTA SELATAN,PESANGGRAHAN,PETUKANGAN SELATAN,36769,23197,13572,4939,18511,2021-07-11
3174101003,JAKARTA SELATAN,PESANGGRAHAN,PETUKANGAN UTARA,53184,34603,18581,6765,25346,2021-07-11
3175081002,JAKARTA TIMUR,MAKASAR,PINANG RANTI,26915,17161,9754,3481,13235,2021-07-11
3173031008,JAKARTA BARAT,TAMAN SARI,PINANGSIA,10583,5998,4585,1636,6221,2021-07-11
3175011001,JAKARTA TIMUR,MATRAMAN,PISANGAN BARU,31537,22373,9164,3829,12993,2021-07-11
3175021002,JAKARTA TIMUR,PULO GADUNG,PISANGAN TIMUR,40576,26143,14433,5710,20143,2021-07-11
3172011005,JAKARTA UTARA,PENJARINGAN,PLUIT,47433,25308,22125,12379,34504,2021-07-11
3175071002,JAKARTA TIMUR,DUREN SAWIT,PONDOK BAMBU,61047,39854,21193,8949,30142,2021-07-11
3175071004,JAKARTA TIMUR,DUREN SAWIT,PONDOK KELAPA,71347,45088,26259,11043,37302,2021-07-11
3175071007,JAKARTA TIMUR,DUREN SAWIT,PONDOK KOPI,35051,24632,10419,4374,14793,2021-07-11
3174061003,JAKARTA SELATAN,CILANDAK,PONDOK LABU,45944,28138,17806,6916,24722,2021-07-11
3174051002,JAKARTA SELATAN,KEBAYORAN LAMA,PONDOK PINANG,55724,35996,19728,9688,29416,2021-07-11
3175101003,JAKARTA TIMUR,CIPAYUNG,PONDOK RANGGON,25123,17141,7982,3805,11787,2021-07-11
3101011003,KAB.ADM.KEP.SERIBU,KEP. SERIBU UTARA,PULAU HARAPAN,2036,731,1305,670,1975,2021-07-11
3101011002,KAB.ADM.KEP.SERIBU,KEP. SERIBU UTARA,PULAU KELAPA,5460,1988,3472,1084,4556,2021-07-11
3101011001,KAB.ADM.KEP.SERIBU,KEP. SERIBU UTARA,PULAU PANGGANG,5395,1862,3533,1148,4681,2021-07-11
3101021003,KAB.ADM.KEP.SERIBU,KEP. SERIBU SELATAN,PULAU PARI,2736,799,1937,614,2551,2021-07-11
3101021002,KAB.ADM.KEP.SERIBU,KEP. SERIBU SELATAN,PULAU TIDUNG,4528,1660,2868,1133,4001,2021-07-11
3101021001,KAB.ADM.KEP.SERIBU,KEP. SERIBU SELATAN,PULAU UNTUNG JAWA,1918,672,1246,559,1805,2021-07-11
3174071007,JAKARTA SELATAN,KEBAYORAN BARU,PULO,5777,3068,2709,1356,4065,2021-07-11
3175021001,JAKARTA TIMUR,PULO GADUNG,PULO GADUNG,34175,22885,11290,4686,15976,2021-07-11
3175061005,JAKARTA TIMUR,CAKUNG,PULO GEBANG,95947,67229,28718,10739,39457,2021-07-11
3174041004,JAKARTA SELATAN,PASAR MINGGU,RAGUNAN,39233,23638,15595,5842,21437,2021-07-11
3175091005,JAKARTA TIMUR,CIRACAS,RAMBUTAN,36368,26526,9842,4320,14162,2021-07-11
3172031006,JAKARTA UTARA,KOJA,RAWA BADAK SELATAN,41895,29313,12582,3965,16547,2021-07-11
3172031004,JAKARTA UTARA,KOJA,RAWA BADAK UTARA,33538,21869,11669,3879,15548,2021-07-11
3174071005,JAKARTA SELATAN,KEBAYORAN BARU,RAWA BARAT,5574,3137,2437,1334,3771,2021-07-11
3173011003,JAKARTA BARAT,CENGKARENG,RAWA BUAYA,59533,38934,20599,6020,26619,2021-07-11
3175031004,JAKARTA TIMUR,JATINEGARA,RAWA BUNGA,21272,14977,6295,2484,8779,2021-07-11
3174081003,JAKARTA SELATAN,PANCORAN,RAWA JATI,20321,12273,8048,3445,11493,2021-07-11
3175061002,JAKARTA TIMUR,CAKUNG,RAWA TERATE,24433,15405,9028,2132,11160,2021-07-11
3175021005,JAKARTA TIMUR,PULO GADUNG,RAWAMANGUN,36788,23583,13205,5884,19089,2021-07-11
3171051003,JAKARTA PUSAT,CEMPAKA PUTIH,RAWASARI,21770,13567,8203,3504,11707,2021-07-11
3173041010,JAKARTA BARAT,TAMBORA,ROA MALAKA,3449,1702,1747,887,2634,2021-07-11
3172041006,JAKARTA UTARA,CILINCING,ROROTAN,40953,26111,14842,4617,19459,2021-07-11
3174071004,JAKARTA SELATAN,KEBAYORAN BARU,SELONG,2843,1439,1404,886,2290,2021-07-11
3173061002,JAKARTA BARAT,KALI DERES,SEMANAN,70293,50888,19405,5023,24428,2021-07-11
3172041007,JAKARTA UTARA,CILINCING,SEMPER BARAT,67899,42322,25577,9118,34695,2021-07-11
3172041005,JAKARTA UTARA,CILINCING,SEMPER TIMUR,36029,23308,12721,4337,17058,2021-07-11
3174071006,JAKARTA SELATAN,KEBAYORAN BARU,SENAYAN,2780,1756,1024,574,1598,2021-07-11
3171041001,JAKARTA PUSAT,SENEN,SENEN,6757,4116,2641,1191,3832,2021-07-11
3171031004,JAKARTA PUSAT,KEMAYORAN,SERDANG,29730,19048,10682,3962,14644,2021-07-11
3174021001,JAKARTA SELATAN,SETIA BUDI,SETIA BUDI,2841,1641,1200,650,1850,2021-07-11
3175101005,JAKARTA TIMUR,CIPAYUNG,SETU,20306,14480,5826,2685,8511,2021-07-11
3173071002,JAKARTA BARAT,PALMERAH,SLIPI,16475,10021,6454,2744,9198,2021-07-11
3173081004,JAKARTA BARAT,KEMBANGAN,SRENGSENG,44969,30731,14238,6201,20439,2021-07-11
3174091002,JAKARTA SELATAN,JAGAKARSA,SRENGSENG SAWAH,57480,33438,24042,8933,32975,2021-07-11
3173051003,JAKARTA BARAT,KEBON JERUK,SUKABUMI SELATAN,35170,24628,10542,3496,14038,2021-07-11
3173051002,JAKARTA BARAT,KEBON JERUK,SUKABUMI UTARA,37628,27125,10503,4029,14532,2021-07-11
3172041002,JAKARTA UTARA,CILINCING,SUKAPURA,53786,35898,17888,5478,23366,2021-07-11
3171031007,JAKARTA PUSAT,KEMAYORAN,SUMUR BATU,22506,13959,8547,3413,11960,2021-07-11
3172021004,JAKARTA UTARA,TANJUNG PRIOK,SUNGAI BAMBU,29115,18300,10815,3569,14384,2021-07-11
3172021006,JAKARTA UTARA,TANJUNG PRIOK,SUNTER AGUNG,70860,39249,31611,13597,45208,2021-07-11
3172021002,JAKARTA UTARA,TANJUNG PRIOK,SUNTER JAYA,62516,37631,24885,10522,35407,2021-07-11
3175091004,JAKARTA TIMUR,CIRACAS,SUSUKAN,33525,21398,12127,4639,16766,2021-07-11
3173031001,JAKARTA BARAT,TAMAN SARI,TAMAN SARI,14281,8568,5713,2405,8118,2021-07-11
3173041001,JAKARTA BARAT,TAMBORA,TAMBORA,10177,6557,3620,1524,5144,2021-07-11
3173041004,JAKARTA BARAT,TAMBORA,TANAH SEREAL,25944,15265,10679,3900,14579,2021-07-11
3171081004,JAKARTA PUSAT,JOHAR BARU,TANAH TINGGI,37800,23015,14785,4277,19062,2021-07-11
3173031004,JAKARTA BARAT,TAMAN SARI,TANGKI,12991,7844,5147,1935,7082,2021-07-11
3174091005,JAKARTA SELATAN,JAGAKARSA,TANJUNG BARAT,39368,26480,12888,5722,18610,2021-07-11
3173021005,JAKARTA BARAT,GROGOL PETAMBURAN,TANJUNG DUREN SELATAN,24917,13885,11032,4503,15535,2021-07-11
3173021002,JAKARTA BARAT,GROGOL PETAMBURAN,TANJUNG DUREN UTARA,16940,8870,8070,3547,11617,2021-07-11
3172021001,JAKARTA UTARA,TANJUNG PRIOK,TANJUNG PRIOK,34316,21134,13182,3851,17033,2021-07-11
3174011002,JAKARTA SELATAN,TEBET,TEBET BARAT,21164,12319,8845,4224,13069,2021-07-11
3174011001,JAKARTA SELATAN,TEBET,TEBET TIMUR,18030,9873,8157,3779,11936,2021-07-11
3173061003,JAKARTA BARAT,KALI DERES,TEGAL ALUR,82647,56509,26138,6892,33030,2021-07-11
3174031004,JAKARTA SELATAN,MAMPANG PRAPATAN,TEGAL PARANG,32174,22995,9179,3332,12511,2021-07-11
3173021003,JAKARTA BARAT,GROGOL PETAMBURAN,TOMANG,28665,16768,11897,5008,16905,2021-07-11
3172031005,JAKARTA UTARA,KOJA,TUGU SELATAN,38749,27210,11539,3839,15378,2021-07-11
3172031002,JAKARTA UTARA,KOJA,TUGU UTARA,67211,46661,20550,6786,27336,2021-07-11
3175061006,JAKARTA TIMUR,CAKUNG,UJUNG MENTENG,29527,19279,10248,4000,14248,2021-07-11
3174101005,JAKARTA SELATAN,PESANGGRAHAN,ULUJAMI,40120,27704,12416,4960,17376,2021-07-11
3175011006,JAKARTA TIMUR,MATRAMAN,UTAN KAYU SELATAN,33233,20919,12314,5080,17394,2021-07-11
3175011002,JAKARTA TIMUR,MATRAMAN,UTAN KAYU UTARA,27995,17828,10167,3841,14008,2021-07-11
3171031008,JAKARTA PUSAT,KEMAYORAN,UTAN PANJANG,29260,20475,8785,2819,11604,2021-07-11
3172021007,JAKARTA UTARA,TANJUNG PRIOK,WARAKAS,43754,27979,15775,5246,21021,2021-07-11
3173021007,JAKARTA BARAT,GROGOL PETAMBURAN,WIJAYA KUSUMA,38584,25130,13454,4881,18335,2021-07-11
3172051003,JAKARTA UTARA,PADEMANGAN,ANCOL,23379,15436,7943,3319,11262,2021-07-12
3173041007,JAKARTA BARAT,TAMBORA,ANGKE,29230,18269,10961,3254,14215,2021-07-12
3175041005,JAKARTA TIMUR,KRAMAT JATI,BALE KAMBANG,28803,21547,7256,2685,9941,2021-07-12
3175031003,JAKARTA TIMUR,JATINEGARA,BALI MESTER,9675,6318,3357,1539,4896,2021-07-12
3175101006,JAKARTA TIMUR,CIPAYUNG,BAMBU APUS,25985,17570,8415,4022,12437,2021-07-12
3174031002,JAKARTA SELATAN,MAMPANG PRAPATAN,BANGKA,21356,13906,7450,2746,10196,2021-07-12
3175051002,JAKARTA TIMUR,PASAR REBO,BARU,23514,13437,10077,4730,14807,2021-07-12
3175041004,JAKARTA TIMUR,KRAMAT JATI,BATU AMPAR,47416,34599,12817,5336,18153,2021-07-12
3171071002,JAKARTA PUSAT,TANAH ABANG,BENDUNGAN HILIR,21374,12918,8456,3614,12070,2021-07-12
3175031002,JAKARTA TIMUR,JATINEGARA,BIDARA CINA,36461,25978,10483,4078,14561,2021-07-12
3174101002,JAKARTA SELATAN,PESANGGRAHAN,BINTARO,52402,34659,17743,7163,24906,2021-07-12
3174011005,JAKARTA SELATAN,TEBET,BUKIT DURI,33953,22766,11187,3991,15178,2021-07-12
3171041006,JAKARTA PUSAT,SENEN,BUNGUR,17929,11174,6755,2776,9531,2021-07-12
3175061007,JAKARTA TIMUR,CAKUNG,CAKUNG BARAT,57222,37878,19344,4067,23411,2021-07-12
3175061004,JAKARTA TIMUR,CAKUNG,CAKUNG TIMUR,57655,37886,19769,6469,26238,2021-07-12
3175041007,JAKARTA TIMUR,KRAMAT JATI,CAWANG,32481,21872,10609,4342,14951,2021-07-12
3175101008,JAKARTA TIMUR,CIPAYUNG,CEGER,18740,12490,6250,2593,8843,2021-07-12
3171031006,JAKARTA PUSAT,KEMAYORAN,CEMPAKA BARU,31257,20911,10346,4056,14402,2021-07-12
3171051002,JAKARTA PUSAT,CEMPAKA PUTIH,CEMPAKA PUTIH BARAT,34725,23068,11657,5015,16672,2021-07-12
3171051001,JAKARTA PUSAT,CEMPAKA PUTIH,CEMPAKA PUTIH TIMUR,24170,14656,9514,4511,14025,2021-07-12
3173011001,JAKARTA BARAT,CENGKARENG,CENGKARENG BARAT,65702,39933,25769,8300,34069,2021-07-12
3173011006,JAKARTA BARAT,CENGKARENG,CENGKARENG TIMUR,80100,51958,28142,8568,36710,2021-07-12
3175091002,JAKARTA TIMUR,CIRACAS,CIBUBUR,65231,41536,23695,9613,33308,2021-07-12
3171011002,JAKARTA PUSAT,GAMBIR,CIDENG,15696,8983,6713,3214,9927,2021-07-12
3174091003,JAKARTA SELATAN,JAGAKARSA,CIGANJUR,38048,24693,13355,5218,18573,2021-07-12
3175051003,JAKARTA TIMUR,PASAR REBO,CIJANTUNG,41013,26018,14995,6270,21265,2021-07-12
3171061003,JAKARTA PUSAT,MENTENG,CIKINI,8260,5396,2864,1388,4252,2021-07-12
3174081006,JAKARTA SELATAN,PANCORAN,CIKOKO,10503,6028,4475,1773,6248,2021-07-12
3174061001,JAKARTA SELATAN,CILANDAK,CILANDAK BARAT,51346,30300,21046,7958,29004,2021-07-12
3174041003,JAKARTA SELATAN,PASAR MINGGU,CILANDAK TIMUR,24239,14491,9748,4896,14644,2021-07-12
3175101002,JAKARTA TIMUR,CIPAYUNG,CILANGKAP,27179,17964,9215,3847,13062,2021-07-12
3175041006,JAKARTA TIMUR,KRAMAT JATI,CILILITAN,39984,27832,12152,5325,17477,2021-07-12
3172041001,JAKARTA UTARA,CILINCING,CILINCING,42677,30091,12586,3960,16546,2021-07-12
3175101001,JAKARTA TIMUR,CIPAYUNG,CIPAYUNG,25747,15829,9918,4273,14191,2021-07-12
3174091006,JAKARTA SELATAN,JAGAKARSA,CIPEDAK,37809,23770,14039,4849,18888,2021-07-12
3174061005,JAKARTA SELATAN,CILANDAK,CIPETE SELATAN,26500,16521,9979,3857,13836,2021-07-12
3174071010,JAKARTA SELATAN,KEBAYORAN BARU,CIPETE UTARA,33902,20800,13102,4133,17235,2021-07-12
3175021003,JAKARTA TIMUR,PULO GADUNG,CIPINANG,39069,25265,13804,6116,19920,2021-07-12
3175031007,JAKARTA TIMUR,JATINEGARA,CIPINANG BESAR SELATAN,34938,25457,9481,3940,13421,2021-07-12
3175031008,JAKARTA TIMUR,JATINEGARA,CIPINANG BESAR UTARA,44479,33410,11069,4220,15289,2021-07-12
3175031005,JAKARTA TIMUR,JATINEGARA,CIPINANG CEMPEDAK,32695,22200,10495,4737,15232,2021-07-12
3175081005,JAKARTA TIMUR,MAKASAR,CIPINANG MELAYU,42144,26821,15323,6464,21787,2021-07-12
3175031006,JAKARTA TIMUR,JATINEGARA,CIPINANG MUARA,53251,37326,15925,7369,23294,2021-07-12
3174051003,JAKARTA SELATAN,KEBAYORAN LAMA,CIPULIR,39635,26814,12821,4839,17660,2021-07-12
3175091001,JAKARTA TIMUR,CIRACAS,CIRACAS,63801,41139,22662,8524,31186,2021-07-12
3175041003,JAKARTA TIMUR,KRAMAT JATI,DUKUH,24404,16540,7864,3550,11414,2021-07-12
3175071001,JAKARTA TIMUR,DUREN SAWIT,DUREN SAWIT,60443,40019,20424,9336,29760,2021-07-12
3174081004,JAKARTA SELATAN,PANCORAN,DUREN TIGA,28099,17605,10494,3865,14359,2021-07-12
3173051005,JAKARTA BARAT,KEBON JERUK,DURI KEPA,59448,35291,24157,10067,34224,2021-07-12
3173011002,JAKARTA BARAT,CENGKARENG,DURI KOSAMBI,75895,49552,26343,8266,34609,2021-07-12
3171011006,JAKARTA PUSAT,GAMBIR,DURI PULO,19986,13555,6431,2409,8840,2021-07-12
3173041011,JAKARTA BARAT,TAMBORA,DURI SELATAN,14099,8666,5433,2379,7812,2021-07-12
3173041003,JAKARTA BARAT,TAMBORA,DURI UTARA,19768,12706,7062,2653,9715,2021-07-12
3171081003,JAKARTA PUSAT,JOHAR BARU,GALUR,18098,10522,7576,1980,9556,2021-07-12
3171011001,JAKARTA PUSAT,GAMBIR,GAMBIR,2434,1350,1084,582,1666,2021-07-12
3174061004,JAKARTA SELATAN,CILANDAK,GANDARIA SELATAN,21926,13848,8078,2862,10940,2021-07-12
3174071009,JAKARTA SELATAN,KEBAYORAN BARU,GANDARIA UTARA,39609,24974,14635,5397,20032,2021-07-12
3175051001,JAKARTA TIMUR,PASAR REBO,GEDONG,35444,23420,12024,5351,17375,2021-07-12
3171071001,JAKARTA PUSAT,TANAH ABANG,GELORA,3106,1938,1168,572,1740,2021-07-12
3173031007,JAKARTA BARAT,TAMAN SARI,GLODOK,7836,3743,4093,1986,6079,2021-07-12
3171061004,JAKARTA PUSAT,MENTENG,GONDANGDIA,4093,2095,1998,1299,3297,2021-07-12
3173021001,JAKARTA BARAT,GROGOL PETAMBURAN,GROGOL,16815,10488,6327,2625,8952,2021-07-12
3174051005,JAKARTA SELATAN,KEBAYORAN LAMA,GROGOL SELATAN,43915,30089,13826,5502,19328,2021-07-12
3174051004,JAKARTA SELATAN,KEBAYORAN LAMA,GROGOL UTARA,42216,28311,13905,5883,19788,2021-07-12
3174021007,JAKARTA SELATAN,SETIA BUDI,GUNTUR,3962,2095,1867,997,2864,2021-07-12
3174071002,JAKARTA SELATAN,KEBAYORAN BARU,GUNUNG,9344,5350,3994,2047,6041,2021-07-12
3171031005,JAKARTA PUSAT,KEMAYORAN,GUNUNG SAHARI SELATAN,19380,12099,7281,2838,10119,2021-07-12
3171021004,JAKARTA PUSAT,SAWAH BESAR,GUNUNG SAHARI UTARA,15647,8184,7463,3400,10863,2021-07-12
3175081004,JAKARTA TIMUR,MAKASAR,HALIM PERDANA KUSUMAH,28110,13654,14456,9348,23804,2021-07-12
3171031003,JAKARTA PUSAT,KEMAYORAN,HARAPAN MULIA,22700,15176,7524,2714,10238,2021-07-12
3174091001,JAKARTA SELATAN,JAGAKARSA,JAGAKARSA,61552,37616,23936,8589,32525,2021-07-12
3175021007,JAKARTA TIMUR,PULO GADUNG,JATI,32443,20610,11833,5652,17485,2021-07-12
3174041002,JAKARTA SELATAN,PASAR MINGGU,JATI PADANG,37250,23412,13838,5900,19738,2021-07-12
3173071004,JAKARTA BARAT,PALMERAH,JATI PULO,27994,16743,11251,3681,14932,2021-07-12
3175061001,JAKARTA TIMUR,CAKUNG,JATINEGARA,83563,61570,21993,6837,28830,2021-07-12
3175021004,JAKARTA TIMUR,PULO GADUNG,JATINEGARA KAUM,24364,16482,7882,2954,10836,2021-07-12
3173021004,JAKARTA BARAT,GROGOL PETAMBURAN,JELAMBAR,30180,17710,12470,5505,17975,2021-07-12
3173021006,JAKARTA BARAT,GROGOL PETAMBURAN,JELAMBAR BARU,37799,22890,14909,6107,21016,2021-07-12
3173041006,JAKARTA BARAT,TAMBORA,JEMBATAN BESI,29182,21985,7197,2444,9641,2021-07-12
3173041008,JAKARTA BARAT,TAMBORA,JEMBATAN LIMA,20627,14428,6199,2279,8478,2021-07-12
3173081005,JAKARTA BARAT,KEMBANGAN,JOGLO,40475,26437,14038,5986,20024,2021-07-12
3171081001,JAKARTA PUSAT,JOHAR BARU,JOHAR BARU,32845,18332,14513,5370,19883,2021-07-12
3173041002,JAKARTA BARAT,TAMBORA,KALI ANYAR,23582,17227,6355,2252,8607,2021-07-12
3172041004,JAKARTA UTARA,CILINCING,KALIBARU,67165,50183,16982,4369,21351,2021-07-12
3174081002,JAKARTA SELATAN,PANCORAN,KALIBATA,41464,28125,13339,4959,18298,2021-07-12
3173061001,JAKARTA BARAT,KALI DERES,KALIDERES,69014,45775,23239,7639,30878,2021-07-12
3175051004,JAKARTA TIMUR,PASAR REBO,KALISARI,42557,27118,15439,6852,22291,2021-07-12
3173061004,JAKARTA BARAT,KALI DERES,KAMAL,53180,39388,13792,3674,17466,2021-07-12
3172011002,JAKARTA UTARA,PENJARINGAN,KAMAL MUARA,12679,6663,6016,2527,8543,2021-07-12
3171071007,JAKARTA PUSAT,TANAH ABANG,KAMPUNG BALI,11551,7959,3592,1521,5113,2021-07-12
3175031001,JAKARTA TIMUR,JATINEGARA,KAMPUNG MELAYU,25476,18913,6563,2252,8815,2021-07-12
3171081002,JAKARTA PUSAT,JOHAR BARU,KAMPUNG RAWA,18247,9093,9154,2556,11710,2021-07-12
3175041002,JAKARTA TIMUR,KRAMAT JATI,KAMPUNG TENGAH,43668,31303,12365,5298,17663,2021-07-12
3173011005,JAKARTA BARAT,CENGKARENG,KAPUK,121994,84870,37124,9546,46670,2021-07-12
3172011003,JAKARTA UTARA,PENJARINGAN,KAPUK MUARA,35498,20677,14821,6722,21543,2021-07-12
3171021002,JAKARTA PUSAT,SAWAH BESAR,KARANG ANYAR,25865,16383,9482,3417,12899,2021-07-12
3174021004,JAKARTA SELATAN,SETIA BUDI,KARET,9581,5754,3827,1441,5268,2021-07-12
3174021003,JAKARTA SELATAN,SETIA BUDI,KARET KUNINGAN,15939,9431,6508,2347,8855,2021-07-12
3174021002,JAKARTA SELATAN,SETIA BUDI,KARET SEMANGGI,2746,1397,1349,603,1952,2021-07-12
3171071003,JAKARTA PUSAT,TANAH ABANG,KARET TENGSIN,19113,12636,6477,2222,8699,2021-07-12
3171021003,JAKARTA PUSAT,SAWAH BESAR,KARTINI,22303,13493,8810,3473,12283,2021-07-12
3175011003,JAKARTA TIMUR,MATRAMAN,KAYU MANIS,25138,17084,8054,3021,11075,2021-07-12
3175021006,JAKARTA TIMUR,PULO GADUNG,KAYU PUTIH,40378,23927,16451,7128,23579,2021-07-12
3173031006,JAKARTA BARAT,TAMAN SARI,KEAGUNGAN,17231,10816,6415,2007,8422,2021-07-12
3174041007,JAKARTA SELATAN,PASAR MINGGU,KEBAGUSAN,44010,29506,14504,5236,19740,2021-07-12
3174051006,JAKARTA SELATAN,KEBAYORAN LAMA,KEBAYORAN LAMA SELATAN,40895,25290,15605,5836,21441,2021-07-12
3174051001,JAKARTA SELATAN,KEBAYORAN LAMA,KEBAYORAN LAMA UTARA,42214,28247,13967,5295,19262,2021-07-12
3174011004,JAKARTA SELATAN,TEBET,KEBON BARU,34878,22229,12649,5156,17805,2021-07-12
3172021005,JAKARTA UTARA,TANJUNG PRIOK,KEBON BAWANG,50597,32039,18558,6979,25537,2021-07-12
3173051001,JAKARTA BARAT,KEBON JERUK,KEBON JERUK,53296,36615,16681,6821,23502,2021-07-12
3171071006,JAKARTA PUSAT,TANAH ABANG,KEBON KACANG,21376,15373,6003,2641,8644,2021-07-12
3171011005,JAKARTA PUSAT,GAMBIR,KEBON KELAPA,10380,6625,3755,1660,5415,2021-07-12
3171031002,JAKARTA PUSAT,KEMAYORAN,KEBON KOSONG,30003,19617,10386,3490,13876,2021-07-12
3175011005,JAKARTA TIMUR,MATRAMAN,KEBON MANGGIS,16393,10147,6246,2792,9038,2021-07-12
3171071005,JAKARTA PUSAT,TANAH ABANG,KEBON MELATI,31355,24132,7223,2875,10098,2021-07-12
3175081003,JAKARTA TIMUR,MAKASAR,KEBON PALA,46176,30990,15186,6216,21402,2021-07-12
3171061005,JAKARTA PUSAT,MENTENG,KEBON SIRIH,12256,8703,3553,1556,5109,2021-07-12
3173011004,JAKARTA BARAT,CENGKARENG,KEDAUNG KALI ANGKE,32185,18730,13455,3236,16691,2021-07-12
3173051007,JAKARTA BARAT,KEBON JERUK,KEDOYA SELATAN,31907,20114,11793,4635,16428,2021-07-12
3173051006,JAKARTA BARAT,KEBON JERUK,KEDOYA UTARA,43826,25737,18089,7020,25109,2021-07-12
3173051004,JAKARTA BARAT,KEBON JERUK,KELAPA DUA,23293,15219,8074,3150,11224,2021-07-12
3175091003,JAKARTA TIMUR,CIRACAS,KELAPA DUA WETAN,46441,29716,16725,7324,24049,2021-07-12
3172061003,JAKARTA UTARA,KELAPA GADING,KELAPA GADING BARAT,35403,18490,16913,8889,25802,2021-07-12
3172061001,JAKARTA UTARA,KELAPA GADING,KELAPA GADING TIMUR,33472,15697,17775,9178,26953,2021-07-12
3173071005,JAKARTA BARAT,PALMERAH,KEMANGGISAN,31952,20156,11796,5236,17032,2021-07-12
3171031001,JAKARTA PUSAT,KEMAYORAN,KEMAYORAN,20947,12681,8266,2841,11107,2021-07-12
3173081006,JAKARTA BARAT,KEMBANGAN,KEMBANGAN SELATAN,26920,16524,10396,5046,15442,2021-07-12
3173081001,JAKARTA BARAT,KEMBANGAN,KEMBANGAN UTARA,52368,33460,18908,6644,25552,2021-07-12
3171041002,JAKARTA PUSAT,SENEN,KENARI,9317,5347,3970,1750,5720,2021-07-12
3173041005,JAKARTA BARAT,TAMBORA,KERENDANG,19869,13572,6297,2233,8530,2021-07-12
3175071003,JAKARTA TIMUR,DUREN SAWIT,KLENDER,69321,49733,19588,7466,27054,2021-07-12
3172031001,JAKARTA UTARA,KOJA,KOJA,28036,18691,9345,2764,12109,2021-07-12
3173071006,JAKARTA BARAT,PALMERAH,KOTA BAMBU SELATAN,20926,13938,6988,2248,9236,2021-07-12
3173071003,JAKARTA BARAT,PALMERAH,KOTA BAMBU UTARA,24416,16534,7882,2787,10669,2021-07-12
3171041004,JAKARTA PUSAT,SENEN,KRAMAT,28661,19855,8806,3009,11815,2021-07-12
3175041001,JAKARTA TIMUR,KRAMAT JATI,KRAMAT JATI,33851,22491,11360,5064,16424,2021-07-12
3174071003,JAKARTA SELATAN,KEBAYORAN BARU,KRAMAT PELA,14340,8364,5976,2382,8358,2021-07-12
3173031002,JAKARTA BARAT,TAMAN SARI,KRUKUT,19130,12093,7037,2298,9335,2021-07-12
3174031005,JAKARTA SELATAN,MAMPANG PRAPATAN,KUNINGAN BARAT,12675,7800,4875,1552,6427,2021-07-12
3174021008,JAKARTA SELATAN,SETIA BUDI,KUNINGAN TIMUR,5982,3658,2324,1065,3389,2021-07-12
3171041005,JAKARTA PUSAT,SENEN,KWITANG,15295,9653,5642,2105,7747,2021-07-12
3172031003,JAKARTA UTARA,KOJA,LAGOA,58726,41273,17453,5677,23130,2021-07-12
3174061002,JAKARTA SELATAN,CILANDAK,LEBAK BULUS,37213,23468,13745,5950,19695,2021-07-12
3174091004,JAKARTA SELATAN,JAGAKARSA,LENTENG AGUNG,53453,37194,16259,6177,22436,2021-07-12
3175101007,JAKARTA TIMUR,CIPAYUNG,LUBANG BUAYA,62984,40542,22442,8445,30887,2021-07-12
3175081001,JAKARTA TIMUR,MAKASAR,MAKASAR,34062,21372,12690,4994,17684,2021-07-12
3175071006,JAKARTA TIMUR,DUREN SAWIT,MALAKA JAYA,30744,18939,11805,5513,17318,2021-07-12
3175071005,JAKARTA TIMUR,DUREN SAWIT,MALAKA SARI,27015,16215,10800,5449,16249,2021-07-12
3174031001,JAKARTA SELATAN,MAMPANG PRAPATAN,MAMPANG PRAPATAN,18046,11997,6049,2060,8109,2021-07-12
3173031005,JAKARTA BARAT,TAMAN SARI,MANGGA BESAR,7439,3904,3535,1452,4987,2021-07-12
3171021005,JAKARTA PUSAT,SAWAH BESAR,MANGGA DUA SELATAN,27767,17594,10173,3874,14047,2021-07-12
3174011007,JAKARTA SELATAN,TEBET,MANGGARAI,28388,18790,9598,3570,13168,2021-07-12
3174011006,JAKARTA SELATAN,TEBET,MANGGARAI SELATAN,22902,13820,9082,3227,12309,2021-07-12
3173031003,JAKARTA BARAT,TAMAN SARI,MAPHAR,16385,9846,6539,2580,9119,2021-07-12
3172041003,JAKARTA UTARA,CILINCING,MARUNDA,28614,17903,10711,2591,13302,2021-07-12
3174071001,JAKARTA SELATAN,KEBAYORAN BARU,MELAWAI,2634,1304,1330,834,2164,2021-07-12
3171061001,JAKARTA PUSAT,MENTENG,MENTENG,25280,17821,7459,3555,11014,2021-07-12
3174021005,JAKARTA SELATAN,SETIA BUDI,MENTENG ATAS,27671,16837,10834,4052,14886,2021-07-12
3174011003,JAKARTA SELATAN,TEBET,MENTENG DALAM,35936,23254,12682,5209,17891,2021-07-12
3173081003,JAKARTA BARAT,KEMBANGAN,MERUYA SELATAN,31227,20144,11083,4343,15426,2021-07-12
3173081002,JAKARTA BARAT,KEMBANGAN,MERUYA UTARA,43382,27761,15621,6981,22602,2021-07-12
3175101004,JAKARTA TIMUR,CIPAYUNG,MUNJUL,23570,15611,7959,3621,11580,2021-07-12
3172051002,JAKARTA UTARA,PADEMANGAN,PADEMANGAN BARAT,73841,49987,23854,7829,31683,2021-07-12
3172051001,JAKARTA UTARA,PADEMANGAN,PADEMANGAN TIMUR,36757,20042,16715,6913,23628,2021-07-12
3175011004,JAKARTA TIMUR,MATRAMAN,PAL MERIAM,19632,12679,6953,2732,9685,2021-07-12
3173071001,JAKARTA BARAT,PALMERAH,PALMERAH,62175,40487,21688,8038,29726,2021-07-12
3174081001,JAKARTA SELATAN,PANCORAN,PANCORAN,19301,12078,7223,2665,9888,2021-07-12
3172021003,JAKARTA UTARA,TANJUNG PRIOK,PAPANGGO,38871,24665,14206,4753,18959,2021-07-12
3171021001,JAKARTA PUSAT,SAWAH BESAR,PASAR BARU,12710,6637,6073,2924,8997,2021-07-12
3174021006,JAKARTA SELATAN,SETIA BUDI,PASAR MANGGIS,26572,16607,9965,3561,13526,2021-07-12
3174041001,JAKARTA SELATAN,PASAR MINGGU,PASAR MINGGU,24670,15684,8986,4594,13580,2021-07-12
3171041003,JAKARTA PUSAT,SENEN,PASEBAN,23321,14811,8510,3318,11828,2021-07-12
3173061005,JAKARTA BARAT,KALI DERES,PEGADUNGAN,74685,47773,26912,9170,36082,2021-07-12
3171061002,JAKARTA PUSAT,MENTENG,PEGANGSAAN,21120,14059,7061,2968,10029,2021-07-12
3172061002,JAKARTA UTARA,KELAPA GADING,PEGANGSAAN DUA,49632,25224,24408,10556,34964,2021-07-12
3172011004,JAKARTA UTARA,PENJARINGAN,PEJAGALAN,74043,44999,29044,10961,40005,2021-07-12
3174041006,JAKARTA SELATAN,PASAR MINGGU,PEJATEN BARAT,35061,21542,13519,5658,19177,2021-07-12
3174041005,JAKARTA SELATAN,PASAR MINGGU,PEJATEN TIMUR,57257,39171,18086,6102,24188,2021-07-12
3175051005,JAKARTA TIMUR,PASAR REBO,PEKAYON,42705,27257,15448,6149,21597,2021-07-12
3173041009,JAKARTA BARAT,TAMBORA,PEKOJAN,23428,14419,9009,3432,12441,2021-07-12
3174031003,JAKARTA SELATAN,MAMPANG PRAPATAN,PELA MAMPANG,42709,27167,15542,5670,21212,2021-07-12
3174081005,JAKARTA SELATAN,PANCORAN,PENGADEGAN,21111,11741,9370,3342,12712,2021-07-12
3175061003,JAKARTA TIMUR,CAKUNG,PENGGILINGAN,97138,71667,25471,9411,34882,2021-07-12
3172011001,JAKARTA UTARA,PENJARINGAN,PENJARINGAN,86712,59260,27452,7873,35325,2021-07-12
3174101001,JAKARTA SELATAN,PESANGGRAHAN,PESANGGRAHAN,27215,16044,11171,4900,16071,2021-07-12
3171071004,JAKARTA PUSAT,TANAH ABANG,PETAMBURAN,33060,25099,7961,2951,10912,2021-07-12
3174071008,JAKARTA SELATAN,KEBAYORAN BARU,PETOGOGAN,11418,6921,4497,1866,6363,2021-07-12
3171011004,JAKARTA PUSAT,GAMBIR,PETOJO SELATAN,14946,9060,5886,3012,8898,2021-07-12
3171011003,JAKARTA PUSAT,GAMBIR,PETOJO UTARA,17843,11553,6290,2706,8996,2021-07-12
3174101004,JAKARTA SELATAN,PESANGGRAHAN,PETUKANGAN SELATAN,36769,23164,13605,4939,18544,2021-07-12
3174101003,JAKARTA SELATAN,PESANGGRAHAN,PETUKANGAN UTARA,53184,34561,18623,6765,25388,2021-07-12
3175081002,JAKARTA TIMUR,MAKASAR,PINANG RANTI,26915,17147,9768,3483,13251,2021-07-12
3173031008,JAKARTA BARAT,TAMAN SARI,PINANGSIA,10583,5990,4593,1636,6229,2021-07-12
3175011001,JAKARTA TIMUR,MATRAMAN,PISANGAN BARU,31537,22334,9203,3830,13033,2021-07-12
3175021002,JAKARTA TIMUR,PULO GADUNG,PISANGAN TIMUR,40576,26102,14474,5711,20185,2021-07-12
3172011005,JAKARTA UTARA,PENJARINGAN,PLUIT,47433,25267,22166,12379,34545,2021-07-12
3175071002,JAKARTA TIMUR,DUREN SAWIT,PONDOK BAMBU,61047,39792,21255,8952,30207,2021-07-12
3175071004,JAKARTA TIMUR,DUREN SAWIT,PONDOK KELAPA,71347,45024,26323,11044,37367,2021-07-12
3175071007,JAKARTA TIMUR,DUREN SAWIT,PONDOK KOPI,35051,24600,10451,4375,14826,2021-07-12
3174061003,JAKARTA SELATAN,CILANDAK,PONDOK LABU,45944,28101,17843,6916,24759,2021-07-12
3174051002,JAKARTA SELATAN,KEBAYORAN LAMA,PONDOK PINANG,55724,35932,19792,9689,29481,2021-07-12
3175101003,JAKARTA TIMUR,CIPAYUNG,PONDOK RANGGON,25123,17132,7991,3805,11796,2021-07-12
3101011003,KAB.ADM.KEP.SERIBU,KEP. SERIBU UTARA,PULAU HARAPAN,2036,731,1305,670,1975,2021-07-12
3101011002,KAB.ADM.KEP.SERIBU,KEP. SERIBU UTARA,PULAU KELAPA,5460,1988,3472,1084,4556,2021-07-12
3101011001,KAB.ADM.KEP.SERIBU,KEP. SERIBU UTARA,PULAU PANGGANG,5395,1862,3533,1148,4681,2021-07-12
3101021003,KAB.ADM.KEP.SERIBU,KEP. SERIBU SELATAN,PULAU PARI,2736,799,1937,614,2551,2021-07-12
3101021002,KAB.ADM.KEP.SERIBU,KEP. SERIBU SELATAN,PULAU TIDUNG,4528,1660,2868,1133,4001,2021-07-12
3101021001,KAB.ADM.KEP.SERIBU,KEP. SERIBU SELATAN,PULAU UNTUNG JAWA,1918,672,1246,559,1805,2021-07-12
3174071007,JAKARTA SELATAN,KEBAYORAN BARU,PULO,5777,3058,2719,1356,4075,2021-07-12
3175021001,JAKARTA TIMUR,PULO GADUNG,PULO GADUNG,34175,22855,11320,4686,16006,2021-07-12
3175061005,JAKARTA TIMUR,CAKUNG,PULO GEBANG,95947,67159,28788,10741,39529,2021-07-12
3174041004,JAKARTA SELATAN,PASAR MINGGU,RAGUNAN,39233,23605,15628,5842,21470,2021-07-12
3175091005,JAKARTA TIMUR,CIRACAS,RAMBUTAN,36368,26504,9864,4321,14185,2021-07-12
3172031006,JAKARTA UTARA,KOJA,RAWA BADAK SELATAN,41895,29299,12596,3965,16561,2021-07-12
3172031004,JAKARTA UTARA,KOJA,RAWA BADAK UTARA,33538,21857,11681,3879,15560,2021-07-12
3174071005,JAKARTA SELATAN,KEBAYORAN BARU,RAWA BARAT,5574,3136,2438,1335,3773,2021-07-12
3173011003,JAKARTA BARAT,CENGKARENG,RAWA BUAYA,59533,38894,20639,6023,26662,2021-07-12
3175031004,JAKARTA TIMUR,JATINEGARA,RAWA BUNGA,21272,14953,6319,2486,8805,2021-07-12
3174081003,JAKARTA SELATAN,PANCORAN,RAWA JATI,20321,12251,8070,3445,11515,2021-07-12
3175061002,JAKARTA TIMUR,CAKUNG,RAWA TERATE,24433,15393,9040,2133,11173,2021-07-12
3175021005,JAKARTA TIMUR,PULO GADUNG,RAWAMANGUN,36788,23548,13240,5885,19125,2021-07-12
3171051003,JAKARTA PUSAT,CEMPAKA PUTIH,RAWASARI,21770,13531,8239,3505,11744,2021-07-12
3173041010,JAKARTA BARAT,TAMBORA,ROA MALAKA,3449,1695,1754,887,2641,2021-07-12
3172041006,JAKARTA UTARA,CILINCING,ROROTAN,40953,26106,14847,4617,19464,2021-07-12
3174071004,JAKARTA SELATAN,KEBAYORAN BARU,SELONG,2843,1437,1406,886,2292,2021-07-12
3173061002,JAKARTA BARAT,KALI DERES,SEMANAN,70293,50846,19447,5023,24470,2021-07-12
3172041007,JAKARTA UTARA,CILINCING,SEMPER BARAT,67899,42295,25604,9118,34722,2021-07-12
3172041005,JAKARTA UTARA,CILINCING,SEMPER TIMUR,36029,23298,12731,4338,17069,2021-07-12
3174071006,JAKARTA SELATAN,KEBAYORAN BARU,SENAYAN,2780,1755,1025,575,1600,2021-07-12
3171041001,JAKARTA PUSAT,SENEN,SENEN,6757,4113,2644,1191,3835,2021-07-12
3171031004,JAKARTA PUSAT,KEMAYORAN,SERDANG,29730,19028,10702,3963,14665,2021-07-12
3174021001,JAKARTA SELATAN,SETIA BUDI,SETIA BUDI,2841,1639,1202,650,1852,2021-07-12
3175101005,JAKARTA TIMUR,CIPAYUNG,SETU,20306,14473,5833,2685,8518,2021-07-12
3173071002,JAKARTA BARAT,PALMERAH,SLIPI,16475,10007,6468,2744,9212,2021-07-12
3173081004,JAKARTA BARAT,KEMBANGAN,SRENGSENG,44969,30680,14289,6201,20490,2021-07-12
3174091002,JAKARTA SELATAN,JAGAKARSA,SRENGSENG SAWAH,57480,33417,24063,8933,32996,2021-07-12
3173051003,JAKARTA BARAT,KEBON JERUK,SUKABUMI SELATAN,35170,24607,10563,3496,14059,2021-07-12
3173051002,JAKARTA BARAT,KEBON JERUK,SUKABUMI UTARA,37628,27087,10541,4030,14571,2021-07-12
3172041002,JAKARTA UTARA,CILINCING,SUKAPURA,53786,35882,17904,5479,23383,2021-07-12
3171031007,JAKARTA PUSAT,KEMAYORAN,SUMUR BATU,22506,13947,8559,3415,11974,2021-07-12
3172021004,JAKARTA UTARA,TANJUNG PRIOK,SUNGAI BAMBU,29115,18281,10834,3571,14405,2021-07-12
3172021006,JAKARTA UTARA,TANJUNG PRIOK,SUNTER AGUNG,70860,39182,31678,13600,45278,2021-07-12
3172021002,JAKARTA UTARA,TANJUNG PRIOK,SUNTER JAYA,62516,37571,24945,10524,35469,2021-07-12
3175091004,JAKARTA TIMUR,CIRACAS,SUSUKAN,33525,21386,12139,4639,16778,2021-07-12
3173031001,JAKARTA BARAT,TAMAN SARI,TAMAN SARI,14281,8552,5729,2405,8134,2021-07-12
3173041001,JAKARTA BARAT,TAMBORA,TAMBORA,10177,6552,3625,1524,5149,2021-07-12
3173041004,JAKARTA BARAT,TAMBORA,TANAH SEREAL,25944,15228,10716,3900,14616,2021-07-12
3171081004,JAKARTA PUSAT,JOHAR BARU,TANAH TINGGI,37800,22909,14891,4277,19168,2021-07-12
3173031004,JAKARTA BARAT,TAMAN SARI,TANGKI,12991,7834,5157,1936,7093,2021-07-12
3174091005,JAKARTA SELATAN,JAGAKARSA,TANJUNG BARAT,39368,26440,12928,5722,18650,2021-07-12
3173021005,JAKARTA BARAT,GROGOL PETAMBURAN,TANJUNG DUREN SELATAN,24917,13848,11069,4506,15575,2021-07-12
3173021002,JAKARTA BARAT,GROGOL PETAMBURAN,TANJUNG DUREN UTARA,16940,8851,8089,3547,11636,2021-07-12
3172021001,JAKARTA UTARA,TANJUNG PRIOK,TANJUNG PRIOK,34316,21122,13194,3851,17045,2021-07-12
3174011002,JAKARTA SELATAN,TEBET,TEBET BARAT,21164,12290,8874,4225,13099,2021-07-12
3174011001,JAKARTA SELATAN,TEBET,TEBET TIMUR,18030,9852,8178,3782,11960,2021-07-12
3173061003,JAKARTA BARAT,KALI DERES,TEGAL ALUR,82647,56482,26165,6894,33059,2021-07-12
3174031004,JAKARTA SELATAN,MAMPANG PRAPATAN,TEGAL PARANG,32174,22965,9209,3332,12541,2021-07-12
3173021003,JAKARTA BARAT,GROGOL PETAMBURAN,TOMANG,28665,16734,11931,5008,16939,2021-07-12
3172031005,JAKARTA UTARA,KOJA,TUGU SELATAN,38749,27192,11557,3841,15398,2021-07-12
3172031002,JAKARTA UTARA,KOJA,TUGU UTARA,67211,46636,20575,6789,27364,2021-07-12
3175061006,JAKARTA TIMUR,CAKUNG,UJUNG MENTENG,29527,19248,10279,4001,14280,2021-07-12
3174101005,JAKARTA SELATAN,PESANGGRAHAN,ULUJAMI,40120,27664,12456,4960,17416,2021-07-12
3175011006,JAKARTA TIMUR,MATRAMAN,UTAN KAYU SELATAN,33233,20884,12349,5081,17430,2021-07-12
3175011002,JAKARTA TIMUR,MATRAMAN,UTAN KAYU UTARA,27995,17796,10199,3841,14040,2021-07-12
3171031008,JAKARTA PUSAT,KEMAYORAN,UTAN PANJANG,29260,20454,8806,2819,11625,2021-07-12
3172021007,JAKARTA UTARA,TANJUNG PRIOK,WARAKAS,43754,27965,15789,5246,21035,2021-07-12
3173021007,JAKARTA BARAT,GROGOL PETAMBURAN,WIJAYA KUSUMA,38584,25098,13486,4882,18368,2021-07-12
3172051003,JAKARTA UTARA,PADEMANGAN,ANCOL,23379,15431,7948,3321,11269,2021-07-13
3173041007,JAKARTA BARAT,TAMBORA,ANGKE,29230,18259,10971,3254,14225,2021-07-13
3175041005,JAKARTA TIMUR,KRAMAT JATI,BALE KAMBANG,28803,21529,7274,2688,9962,2021-07-13
3175031003,JAKARTA TIMUR,JATINEGARA,BALI MESTER,9675,6314,3361,1540,4901,2021-07-13
3175101006,JAKARTA TIMUR,CIPAYUNG,BAMBU APUS,25985,17549,8436,4023,12459,2021-07-13
3174031002,JAKARTA SELATAN,MAMPANG PRAPATAN,BANGKA,21356,13844,7512,2746,10258,2021-07-13
3175051002,JAKARTA TIMUR,PASAR REBO,BARU,23514,13427,10087,4731,14818,2021-07-13
3175041004,JAKARTA TIMUR,KRAMAT JATI,BATU AMPAR,47416,34563,12853,5339,18192,2021-07-13
3171071002,JAKARTA PUSAT,TANAH ABANG,BENDUNGAN HILIR,21374,12908,8466,3615,12081,2021-07-13
3175031002,JAKARTA TIMUR,JATINEGARA,BIDARA CINA,36461,25953,10508,4079,14587,2021-07-13
3174101002,JAKARTA SELATAN,PESANGGRAHAN,BINTARO,52402,34611,17791,7164,24955,2021-07-13
3174011005,JAKARTA SELATAN,TEBET,BUKIT DURI,33953,22661,11292,3992,15284,2021-07-13
3171041006,JAKARTA PUSAT,SENEN,BUNGUR,17929,11164,6765,2778,9543,2021-07-13
3175061007,JAKARTA TIMUR,CAKUNG,CAKUNG BARAT,57222,37845,19377,4069,23446,2021-07-13
3175061004,JAKARTA TIMUR,CAKUNG,CAKUNG TIMUR,57655,37859,19796,6472,26268,2021-07-13
3175041007,JAKARTA TIMUR,KRAMAT JATI,CAWANG,32481,21827,10654,4345,14999,2021-07-13
3175101008,JAKARTA TIMUR,CIPAYUNG,CEGER,18740,12469,6271,2593,8864,2021-07-13
3171031006,JAKARTA PUSAT,KEMAYORAN,CEMPAKA BARU,31257,20902,10355,4056,14411,2021-07-13
3171051002,JAKARTA PUSAT,CEMPAKA PUTIH,CEMPAKA PUTIH BARAT,34725,23043,11682,5016,16698,2021-07-13
3171051001,JAKARTA PUSAT,CEMPAKA PUTIH,CEMPAKA PUTIH TIMUR,24170,14649,9521,4511,14032,2021-07-13
3173011001,JAKARTA BARAT,CENGKARENG,CENGKARENG BARAT,65702,39925,25777,8301,34078,2021-07-13
3173011006,JAKARTA BARAT,CENGKARENG,CENGKARENG TIMUR,80100,51933,28167,8568,36735,2021-07-13
3175091002,JAKARTA TIMUR,CIRACAS,CIBUBUR,65231,41495,23736,9616,33352,2021-07-13
3171011002,JAKARTA PUSAT,GAMBIR,CIDENG,15696,8980,6716,3214,9930,2021-07-13
3174091003,JAKARTA SELATAN,JAGAKARSA,CIGANJUR,38048,24630,13418,5220,18638,2021-07-13
3175051003,JAKARTA TIMUR,PASAR REBO,CIJANTUNG,41013,25988,15025,6274,21299,2021-07-13
3171061003,JAKARTA PUSAT,MENTENG,CIKINI,8260,5390,2870,1388,4258,2021-07-13
3174081006,JAKARTA SELATAN,PANCORAN,CIKOKO,10503,5974,4529,1773,6302,2021-07-13
3174061001,JAKARTA SELATAN,CILANDAK,CILANDAK BARAT,51346,30034,21312,7964,29276,2021-07-13
3174041003,JAKARTA SELATAN,PASAR MINGGU,CILANDAK TIMUR,24239,14455,9784,4896,14680,2021-07-13
3175101002,JAKARTA TIMUR,CIPAYUNG,CILANGKAP,27179,17914,9265,3849,13114,2021-07-13
3175041006,JAKARTA TIMUR,KRAMAT JATI,CILILITAN,39984,27794,12190,5327,17517,2021-07-13
3172041001,JAKARTA UTARA,CILINCING,CILINCING,42677,30018,12659,3960,16619,2021-07-13
3175101001,JAKARTA TIMUR,CIPAYUNG,CIPAYUNG,25747,15811,9936,4278,14214,2021-07-13
3174091006,JAKARTA SELATAN,JAGAKARSA,CIPEDAK,37809,23591,14218,4853,19071,2021-07-13
3174061005,JAKARTA SELATAN,CILANDAK,CIPETE SELATAN,26500,16497,10003,3858,13861,2021-07-13
3174071010,JAKARTA SELATAN,KEBAYORAN BARU,CIPETE UTARA,33902,20715,13187,4137,17324,2021-07-13
3175021003,JAKARTA TIMUR,PULO GADUNG,CIPINANG,39069,25249,13820,6122,19942,2021-07-13
3175031007,JAKARTA TIMUR,JATINEGARA,CIPINANG BESAR SELATAN,34938,25428,9510,3940,13450,2021-07-13
3175031008,JAKARTA TIMUR,JATINEGARA,CIPINANG BESAR UTARA,44479,33394,11085,4221,15306,2021-07-13
3175031005,JAKARTA TIMUR,JATINEGARA,CIPINANG CEMPEDAK,32695,22178,10517,4741,15258,2021-07-13
3175081005,JAKARTA TIMUR,MAKASAR,CIPINANG MELAYU,42144,26793,15351,6465,21816,2021-07-13
3175031006,JAKARTA TIMUR,JATINEGARA,CIPINANG MUARA,53251,37294,15957,7370,23327,2021-07-13
3174051003,JAKARTA SELATAN,KEBAYORAN LAMA,CIPULIR,39635,26650,12985,4844,17829,2021-07-13
3175091001,JAKARTA TIMUR,CIRACAS,CIRACAS,63801,41107,22694,8529,31223,2021-07-13
3175041003,JAKARTA TIMUR,KRAMAT JATI,DUKUH,24404,16529,7875,3552,11427,2021-07-13
3175071001,JAKARTA TIMUR,DUREN SAWIT,DUREN SAWIT,60443,39997,20446,9337,29783,2021-07-13
3174081004,JAKARTA SELATAN,PANCORAN,DUREN TIGA,28099,17505,10594,3868,14462,2021-07-13
3173051005,JAKARTA BARAT,KEBON JERUK,DURI KEPA,59448,35269,24179,10071,34250,2021-07-13
3173011002,JAKARTA BARAT,CENGKARENG,DURI KOSAMBI,75895,49534,26361,8269,34630,2021-07-13
3171011006,JAKARTA PUSAT,GAMBIR,DURI PULO,19986,13546,6440,2411,8851,2021-07-13
3173041011,JAKARTA BARAT,TAMBORA,DURI SELATAN,14099,8663,5436,2380,7816,2021-07-13
3173041003,JAKARTA BARAT,TAMBORA,DURI UTARA,19768,12701,7067,2653,9720,2021-07-13
3171081003,JAKARTA PUSAT,JOHAR BARU,GALUR,18098,10509,7589,1980,9569,2021-07-13
3171011001,JAKARTA PUSAT,GAMBIR,GAMBIR,2434,1349,1085,582,1667,2021-07-13
3174061004,JAKARTA SELATAN,CILANDAK,GANDARIA SELATAN,21926,13785,8141,2862,11003,2021-07-13
3174071009,JAKARTA SELATAN,KEBAYORAN BARU,GANDARIA UTARA,39609,24886,14723,5398,20121,2021-07-13
3175051001,JAKARTA TIMUR,PASAR REBO,GEDONG,35444,23405,12039,5351,17390,2021-07-13
3171071001,JAKARTA PUSAT,TANAH ABANG,GELORA,3106,1936,1170,572,1742,2021-07-13
3173031007,JAKARTA BARAT,TAMAN SARI,GLODOK,7836,3742,4094,1987,6081,2021-07-13
3171061004,JAKARTA PUSAT,MENTENG,GONDANGDIA,4093,2087,2006,1299,3305,2021-07-13
3173021001,JAKARTA BARAT,GROGOL PETAMBURAN,GROGOL,16815,10483,6332,2625,8957,2021-07-13
3174051005,JAKARTA SELATAN,KEBAYORAN LAMA,GROGOL SELATAN,43915,29968,13947,5507,19454,2021-07-13
3174051004,JAKARTA SELATAN,KEBAYORAN LAMA,GROGOL UTARA,42216,28198,14018,5887,19905,2021-07-13
3174021007,JAKARTA SELATAN,SETIA BUDI,GUNTUR,3962,2090,1872,997,2869,2021-07-13
3174071002,JAKARTA SELATAN,KEBAYORAN BARU,GUNUNG,9344,5337,4007,2048,6055,2021-07-13
3171031005,JAKARTA PUSAT,KEMAYORAN,GUNUNG SAHARI SELATAN,19380,12094,7286,2838,10124,2021-07-13
3171021004,JAKARTA PUSAT,SAWAH BESAR,GUNUNG SAHARI UTARA,15647,8178,7469,3400,10869,2021-07-13
3175081004,JAKARTA TIMUR,MAKASAR,HALIM PERDANA KUSUMAH,28110,13634,14476,9349,23825,2021-07-13
3171031003,JAKARTA PUSAT,KEMAYORAN,HARAPAN MULIA,22700,15171,7529,2714,10243,2021-07-13
3174091001,JAKARTA SELATAN,JAGAKARSA,JAGAKARSA,61552,37379,24173,8592,32765,2021-07-13
3175021007,JAKARTA TIMUR,PULO GADUNG,JATI,32443,20575,11868,5652,17520,2021-07-13
3174041002,JAKARTA SELATAN,PASAR MINGGU,JATI PADANG,37250,23294,13956,5903,19859,2021-07-13
3173071004,JAKARTA BARAT,PALMERAH,JATI PULO,27994,16730,11264,3681,14945,2021-07-13
3175061001,JAKARTA TIMUR,CAKUNG,JATINEGARA,83563,61493,22070,6841,28911,2021-07-13
3175021004,JAKARTA TIMUR,PULO GADUNG,JATINEGARA KAUM,24364,16474,7890,2955,10845,2021-07-13
3173021004,JAKARTA BARAT,GROGOL PETAMBURAN,JELAMBAR,30180,17691,12489,5505,17994,2021-07-13
3173021006,JAKARTA BARAT,GROGOL PETAMBURAN,JELAMBAR BARU,37799,22882,14917,6108,21025,2021-07-13
3173041006,JAKARTA BARAT,TAMBORA,JEMBATAN BESI,29182,21977,7205,2447,9652,2021-07-13
3173041008,JAKARTA BARAT,TAMBORA,JEMBATAN LIMA,20627,14422,6205,2280,8485,2021-07-13
3173081005,JAKARTA BARAT,KEMBANGAN,JOGLO,40475,26414,14061,5986,20047,2021-07-13
3171081001,JAKARTA PUSAT,JOHAR BARU,JOHAR BARU,32845,18325,14520,5370,19890,2021-07-13
3173041002,JAKARTA BARAT,TAMBORA,KALI ANYAR,23582,17221,6361,2254,8615,2021-07-13
3172041004,JAKARTA UTARA,CILINCING,KALIBARU,67165,50144,17021,4369,21390,2021-07-13
3174081002,JAKARTA SELATAN,PANCORAN,KALIBATA,41464,27984,13480,4959,18439,2021-07-13
3173061001,JAKARTA BARAT,KALI DERES,KALIDERES,69014,45755,23259,7641,30900,2021-07-13
3175051004,JAKARTA TIMUR,PASAR REBO,KALISARI,42557,27096,15461,6854,22315,2021-07-13
3173061004,JAKARTA BARAT,KALI DERES,KAMAL,53180,39379,13801,3674,17475,2021-07-13
3172011002,JAKARTA UTARA,PENJARINGAN,KAMAL MUARA,12679,6661,6018,2527,8545,2021-07-13
3171071007,JAKARTA PUSAT,TANAH ABANG,KAMPUNG BALI,11551,7950,3601,1521,5122,2021-07-13
3175031001,JAKARTA TIMUR,JATINEGARA,KAMPUNG MELAYU,25476,18892,6584,2252,8836,2021-07-13
3171081002,JAKARTA PUSAT,JOHAR BARU,KAMPUNG RAWA,18247,9083,9164,2557,11721,2021-07-13
3175041002,JAKARTA TIMUR,KRAMAT JATI,KAMPUNG TENGAH,43668,31290,12378,5300,17678,2021-07-13
3173011005,JAKARTA BARAT,CENGKARENG,KAPUK,121994,84843,37151,9547,46698,2021-07-13
3172011003,JAKARTA UTARA,PENJARINGAN,KAPUK MUARA,35498,20672,14826,6723,21549,2021-07-13
3171021002,JAKARTA PUSAT,SAWAH BESAR,KARANG ANYAR,25865,16376,9489,3417,12906,2021-07-13
3174021004,JAKARTA SELATAN,SETIA BUDI,KARET,9581,5733,3848,1441,5289,2021-07-13
3174021003,JAKARTA SELATAN,SETIA BUDI,KARET KUNINGAN,15939,9404,6535,2348,8883,2021-07-13
3174021002,JAKARTA SELATAN,SETIA BUDI,KARET SEMANGGI,2746,1391,1355,603,1958,2021-07-13
3171071003,JAKARTA PUSAT,TANAH ABANG,KARET TENGSIN,19113,12624,6489,2222,8711,2021-07-13
3171021003,JAKARTA PUSAT,SAWAH BESAR,KARTINI,22303,13485,8818,3473,12291,2021-07-13
3175011003,JAKARTA TIMUR,MATRAMAN,KAYU MANIS,25138,17062,8076,3022,11098,2021-07-13
3175021006,JAKARTA TIMUR,PULO GADUNG,KAYU PUTIH,40378,23909,16469,7128,23597,2021-07-13
3173031006,JAKARTA BARAT,TAMAN SARI,KEAGUNGAN,17231,10810,6421,2007,8428,2021-07-13
3174041007,JAKARTA SELATAN,PASAR MINGGU,KEBAGUSAN,44010,29365,14645,5240,19885,2021-07-13
3174051006,JAKARTA SELATAN,KEBAYORAN LAMA,KEBAYORAN LAMA SELATAN,40895,25229,15666,5837,21503,2021-07-13
3174051001,JAKARTA SELATAN,KEBAYORAN LAMA,KEBAYORAN LAMA UTARA,42214,28188,14026,5298,19324,2021-07-13
3174011004,JAKARTA SELATAN,TEBET,KEBON BARU,34878,22207,12671,5158,17829,2021-07-13
3172021005,JAKARTA UTARA,TANJUNG PRIOK,KEBON BAWANG,50597,32014,18583,6980,25563,2021-07-13
3173051001,JAKARTA BARAT,KEBON JERUK,KEBON JERUK,53296,36583,16713,6825,23538,2021-07-13
3171071006,JAKARTA PUSAT,TANAH ABANG,KEBON KACANG,21376,15359,6017,2641,8658,2021-07-13
3171011005,JAKARTA PUSAT,GAMBIR,KEBON KELAPA,10380,6624,3756,1660,5416,2021-07-13
3171031002,JAKARTA PUSAT,KEMAYORAN,KEBON KOSONG,30003,19603,10400,3490,13890,2021-07-13
3175011005,JAKARTA TIMUR,MATRAMAN,KEBON MANGGIS,16393,10144,6249,2793,9042,2021-07-13
3171071005,JAKARTA PUSAT,TANAH ABANG,KEBON MELATI,31355,24116,7239,2875,10114,2021-07-13
3175081003,JAKARTA TIMUR,MAKASAR,KEBON PALA,46176,30964,15212,6218,21430,2021-07-13
3171061005,JAKARTA PUSAT,MENTENG,KEBON SIRIH,12256,8697,3559,1556,5115,2021-07-13
3173011004,JAKARTA BARAT,CENGKARENG,KEDAUNG KALI ANGKE,32185,18712,13473,3236,16709,2021-07-13
3173051007,JAKARTA BARAT,KEBON JERUK,KEDOYA SELATAN,31907,20110,11797,4635,16432,2021-07-13
3173051006,JAKARTA BARAT,KEBON JERUK,KEDOYA UTARA,43826,25724,18102,7022,25124,2021-07-13
3173051004,JAKARTA BARAT,KEBON JERUK,KELAPA DUA,23293,15206,8087,3150,11237,2021-07-13
3175091003,JAKARTA TIMUR,CIRACAS,KELAPA DUA WETAN,46441,29679,16762,7326,24088,2021-07-13
3172061003,JAKARTA UTARA,KELAPA GADING,KELAPA GADING BARAT,35403,18481,16922,8894,25816,2021-07-13
3172061001,JAKARTA UTARA,KELAPA GADING,KELAPA GADING TIMUR,33472,15652,17820,9182,27002,2021-07-13
3173071005,JAKARTA BARAT,PALMERAH,KEMANGGISAN,31952,20140,11812,5238,17050,2021-07-13
3171031001,JAKARTA PUSAT,KEMAYORAN,KEMAYORAN,20947,12675,8272,2841,11113,2021-07-13
3173081006,JAKARTA BARAT,KEMBANGAN,KEMBANGAN SELATAN,26920,16515,10405,5047,15452,2021-07-13
3173081001,JAKARTA BARAT,KEMBANGAN,KEMBANGAN UTARA,52368,33438,18930,6645,25575,2021-07-13
3171041002,JAKARTA PUSAT,SENEN,KENARI,9317,5346,3971,1750,5721,2021-07-13
3173041005,JAKARTA BARAT,TAMBORA,KERENDANG,19869,13569,6300,2234,8534,2021-07-13
3175071003,JAKARTA TIMUR,DUREN SAWIT,KLENDER,69321,49709,19612,7468,27080,2021-07-13
3172031001,JAKARTA UTARA,KOJA,KOJA,28036,18682,9354,2767,12121,2021-07-13
3173071006,JAKARTA BARAT,PALMERAH,KOTA BAMBU SELATAN,20926,13927,6999,2248,9247,2021-07-13
3173071003,JAKARTA BARAT,PALMERAH,KOTA BAMBU UTARA,24416,16528,7888,2787,10675,2021-07-13
3171041004,JAKARTA PUSAT,SENEN,KRAMAT,28661,19845,8816,3011,11827,2021-07-13
3175041001,JAKARTA TIMUR,KRAMAT JATI,KRAMAT JATI,33851,22469,11382,5066,16448,2021-07-13
3174071003,JAKARTA SELATAN,KEBAYORAN BARU,KRAMAT PELA,14340,8337,6003,2382,8385,2021-07-13
3173031002,JAKARTA BARAT,TAMAN SARI,KRUKUT,19130,12082,7048,2299,9347,2021-07-13
3174031005,JAKARTA SELATAN,MAMPANG PRAPATAN,KUNINGAN BARAT,12675,7716,4959,1552,6511,2021-07-13
3174021008,JAKARTA SELATAN,SETIA BUDI,KUNINGAN TIMUR,5982,3654,2328,1065,3393,2021-07-13
3171041005,JAKARTA PUSAT,SENEN,KWITANG,15295,9647,5648,2106,7754,2021-07-13
3172031003,JAKARTA UTARA,KOJA,LAGOA,58726,41218,17508,5678,23186,2021-07-13
3174061002,JAKARTA SELATAN,CILANDAK,LEBAK BULUS,37213,23426,13787,5953,19740,2021-07-13
3174091004,JAKARTA SELATAN,JAGAKARSA,LENTENG AGUNG,53453,37053,16400,6181,22581,2021-07-13
3175101007,JAKARTA TIMUR,CIPAYUNG,LUBANG BUAYA,62984,40510,22474,8447,30921,2021-07-13
3175081001,JAKARTA TIMUR,MAKASAR,MAKASAR,34062,21344,12718,4994,17712,2021-07-13
3175071006,JAKARTA TIMUR,DUREN SAWIT,MALAKA JAYA,30744,18929,11815,5515,17330,2021-07-13
3175071005,JAKARTA TIMUR,DUREN SAWIT,MALAKA SARI,27015,16205,10810,5450,16260,2021-07-13
3174031001,JAKARTA SELATAN,MAMPANG PRAPATAN,MAMPANG PRAPATAN,18046,11934,6112,2061,8173,2021-07-13
3173031005,JAKARTA BARAT,TAMAN SARI,MANGGA BESAR,7439,3904,3535,1452,4987,2021-07-13
3171021005,JAKARTA PUSAT,SAWAH BESAR,MANGGA DUA SELATAN,27767,17591,10176,3875,14051,2021-07-13
3174011007,JAKARTA SELATAN,TEBET,MANGGARAI,28388,18768,9620,3572,13192,2021-07-13
3174011006,JAKARTA SELATAN,TEBET,MANGGARAI SELATAN,22902,13689,9213,3228,12441,2021-07-13
3173031003,JAKARTA BARAT,TAMAN SARI,MAPHAR,16385,9836,6549,2581,9130,2021-07-13
3172041003,JAKARTA UTARA,CILINCING,MARUNDA,28614,17897,10717,2591,13308,2021-07-13
3174071001,JAKARTA SELATAN,KEBAYORAN BARU,MELAWAI,2634,1301,1333,834,2167,2021-07-13
3171061001,JAKARTA PUSAT,MENTENG,MENTENG,25280,17800,7480,3557,11037,2021-07-13
3174021005,JAKARTA SELATAN,SETIA BUDI,MENTENG ATAS,27671,16701,10970,4054,15024,2021-07-13
3174011003,JAKARTA SELATAN,TEBET,MENTENG DALAM,35936,23144,12792,5212,18004,2021-07-13
3173081003,JAKARTA BARAT,KEMBANGAN,MERUYA SELATAN,31227,20136,11091,4344,15435,2021-07-13
3173081002,JAKARTA BARAT,KEMBANGAN,MERUYA UTARA,43382,27735,15647,6982,22629,2021-07-13
3175101004,JAKARTA TIMUR,CIPAYUNG,MUNJUL,23570,15575,7995,3622,11617,2021-07-13
3172051002,JAKARTA UTARA,PADEMANGAN,PADEMANGAN BARAT,73841,49972,23869,7833,31702,2021-07-13
3172051001,JAKARTA UTARA,PADEMANGAN,PADEMANGAN TIMUR,36757,20033,16724,6915,23639,2021-07-13
3175011004,JAKARTA TIMUR,MATRAMAN,PAL MERIAM,19632,12668,6964,2732,9696,2021-07-13
3173071001,JAKARTA BARAT,PALMERAH,PALMERAH,62175,40459,21716,8040,29756,2021-07-13
3174081001,JAKARTA SELATAN,PANCORAN,PANCORAN,19301,11960,7341,2666,10007,2021-07-13
3172021003,JAKARTA UTARA,TANJUNG PRIOK,PAPANGGO,38871,24649,14222,4755,18977,2021-07-13
3171021001,JAKARTA PUSAT,SAWAH BESAR,PASAR BARU,12710,6630,6080,2924,9004,2021-07-13
3174021006,JAKARTA SELATAN,SETIA BUDI,PASAR MANGGIS,26572,16564,10008,3563,13571,2021-07-13
3174041001,JAKARTA SELATAN,PASAR MINGGU,PASAR MINGGU,24670,15644,9026,4595,13621,2021-07-13
3171041003,JAKARTA PUSAT,SENEN,PASEBAN,23321,14804,8517,3318,11835,2021-07-13
3173061005,JAKARTA BARAT,KALI DERES,PEGADUNGAN,74685,47749,26936,9171,36107,2021-07-13
3171061002,JAKARTA PUSAT,MENTENG,PEGANGSAAN,21120,14044,7076,2968,10044,2021-07-13
3172061002,JAKARTA UTARA,KELAPA GADING,PEGANGSAAN DUA,49632,25198,24434,10558,34992,2021-07-13
3172011004,JAKARTA UTARA,PENJARINGAN,PEJAGALAN,74043,44989,29054,10966,40020,2021-07-13
3174041006,JAKARTA SELATAN,PASAR MINGGU,PEJATEN BARAT,35061,21395,13666,5662,19328,2021-07-13
3174041005,JAKARTA SELATAN,PASAR MINGGU,PEJATEN TIMUR,57257,39004,18253,6106,24359,2021-07-13
3175051005,JAKARTA TIMUR,PASAR REBO,PEKAYON,42705,27236,15469,6149,21618,2021-07-13
3173041009,JAKARTA BARAT,TAMBORA,PEKOJAN,23428,14412,9016,3432,12448,2021-07-13
3174031003,JAKARTA SELATAN,MAMPANG PRAPATAN,PELA MAMPANG,42709,26779,15930,5675,21605,2021-07-13
3174081005,JAKARTA SELATAN,PANCORAN,PENGADEGAN,21111,11713,9398,3342,12740,2021-07-13
3175061003,JAKARTA TIMUR,CAKUNG,PENGGILINGAN,97138,71616,25522,9413,34935,2021-07-13
3172011001,JAKARTA UTARA,PENJARINGAN,PENJARINGAN,86712,59234,27478,7874,35352,2021-07-13
3174101001,JAKARTA SELATAN,PESANGGRAHAN,PESANGGRAHAN,27215,16030,11185,4902,16087,2021-07-13
3171071004,JAKARTA PUSAT,TANAH ABANG,PETAMBURAN,33060,25061,7999,2952,10951,2021-07-13
3174071008,JAKARTA SELATAN,KEBAYORAN BARU,PETOGOGAN,11418,6874,4544,1866,6410,2021-07-13
3171011004,JAKARTA PUSAT,GAMBIR,PETOJO SELATAN,14946,9055,5891,3013,8904,2021-07-13
3171011003,JAKARTA PUSAT,GAMBIR,PETOJO UTARA,17843,11545,6298,2710,9008,2021-07-13
3174101004,JAKARTA SELATAN,PESANGGRAHAN,PETUKANGAN SELATAN,36769,23149,13620,4940,18560,2021-07-13
3174101003,JAKARTA SELATAN,PESANGGRAHAN,PETUKANGAN UTARA,53184,34532,18652,6766,25418,2021-07-13
3175081002,JAKARTA TIMUR,MAKASAR,PINANG RANTI,26915,17137,9778,3483,13261,2021-07-13
3173031008,JAKARTA BARAT,TAMAN SARI,PINANGSIA,10583,5988,4595,1637,6232,2021-07-13
3175011001,JAKARTA TIMUR,MATRAMAN,PISANGAN BARU,31537,22310,9227,3830,13057,2021-07-13
3175021002,JAKARTA TIMUR,PULO GADUNG,PISANGAN TIMUR,40576,26076,14500,5711,20211,2021-07-13
3172011005,JAKARTA UTARA,PENJARINGAN,PLUIT,47433,25246,22187,12380,34567,2021-07-13
3175071002,JAKARTA TIMUR,DUREN SAWIT,PONDOK BAMBU,61047,39768,21279,8954,30233,2021-07-13
3175071004,JAKARTA TIMUR,DUREN SAWIT,PONDOK KELAPA,71347,44992,26355,11046,37401,2021-07-13
3175071007,JAKARTA TIMUR,DUREN SAWIT,PONDOK KOPI,35051,24589,10462,4375,14837,2021-07-13
3174061003,JAKARTA SELATAN,CILANDAK,PONDOK LABU,45944,27865,18079,6916,24995,2021-07-13
3174051002,JAKARTA SELATAN,KEBAYORAN LAMA,PONDOK PINANG,55724,35816,19908,9691,29599,2021-07-13
3175101003,JAKARTA TIMUR,CIPAYUNG,PONDOK RANGGON,25123,17057,8066,3807,11873,2021-07-13
3101011003,KAB.ADM.KEP.SERIBU,KEP. SERIBU UTARA,PULAU HARAPAN,2036,731,1305,670,1975,2021-07-13
3101011002,KAB.ADM.KEP.SERIBU,KEP. SERIBU UTARA,PULAU KELAPA,5460,1983,3477,1084,4561,2021-07-13
3101011001,KAB.ADM.KEP.SERIBU,KEP. SERIBU UTARA,PULAU PANGGANG,5395,1853,3542,1148,4690,2021-07-13
3101021003,KAB.ADM.KEP.SERIBU,KEP. SERIBU SELATAN,PULAU PARI,2736,799,1937,614,2551,2021-07-13
3101021002,KAB.ADM.KEP.SERIBU,KEP. SERIBU SELATAN,PULAU TIDUNG,4528,1658,2870,1133,4003,2021-07-13
3101021001,KAB.ADM.KEP.SERIBU,KEP. SERIBU SELATAN,PULAU UNTUNG JAWA,1918,672,1246,559,1805,2021-07-13
3174071007,JAKARTA SELATAN,KEBAYORAN BARU,PULO,5777,3048,2729,1356,4085,2021-07-13
3175021001,JAKARTA TIMUR,PULO GADUNG,PULO GADUNG,34175,22848,11327,4689,16016,2021-07-13
3175061005,JAKARTA TIMUR,CAKUNG,PULO GEBANG,95947,67090,28857,10746,39603,2021-07-13
3174041004,JAKARTA SELATAN,PASAR MINGGU,RAGUNAN,39233,23427,15806,5847,21653,2021-07-13
3175091005,JAKARTA TIMUR,CIRACAS,RAMBUTAN,36368,26487,9881,4321,14202,2021-07-13
3172031006,JAKARTA UTARA,KOJA,RAWA BADAK SELATAN,41895,29282,12613,3967,16580,2021-07-13
3172031004,JAKARTA UTARA,KOJA,RAWA BADAK UTARA,33538,21850,11688,3880,15568,2021-07-13
3174071005,JAKARTA SELATAN,KEBAYORAN BARU,RAWA BARAT,5574,3124,2450,1336,3786,2021-07-13
3173011003,JAKARTA BARAT,CENGKARENG,RAWA BUAYA,59533,38883,20650,6024,26674,2021-07-13
3175031004,JAKARTA TIMUR,JATINEGARA,RAWA BUNGA,21272,14947,6325,2489,8814,2021-07-13
3174081003,JAKARTA SELATAN,PANCORAN,RAWA JATI,20321,12203,8118,3450,11568,2021-07-13
3175061002,JAKARTA TIMUR,CAKUNG,RAWA TERATE,24433,15373,9060,2134,11194,2021-07-13
3175021005,JAKARTA TIMUR,PULO GADUNG,RAWAMANGUN,36788,23535,13253,5886,19139,2021-07-13
3171051003,JAKARTA PUSAT,CEMPAKA PUTIH,RAWASARI,21770,13523,8247,3506,11753,2021-07-13
3173041010,JAKARTA BARAT,TAMBORA,ROA MALAKA,3449,1695,1754,890,2644,2021-07-13
3172041006,JAKARTA UTARA,CILINCING,ROROTAN,40953,26098,14855,4619,19474,2021-07-13
3174071004,JAKARTA SELATAN,KEBAYORAN BARU,SELONG,2843,1436,1407,886,2293,2021-07-13
3173061002,JAKARTA BARAT,KALI DERES,SEMANAN,70293,50819,19474,5024,24498,2021-07-13
3172041007,JAKARTA UTARA,CILINCING,SEMPER BARAT,67899,42262,25637,9121,34758,2021-07-13
3172041005,JAKARTA UTARA,CILINCING,SEMPER TIMUR,36029,23283,12746,4338,17084,2021-07-13
3174071006,JAKARTA SELATAN,KEBAYORAN BARU,SENAYAN,2780,1751,1029,576,1605,2021-07-13
3171041001,JAKARTA PUSAT,SENEN,SENEN,6757,4110,2647,1191,3838,2021-07-13
3171031004,JAKARTA PUSAT,KEMAYORAN,SERDANG,29730,19016,10714,3964,14678,2021-07-13
3174021001,JAKARTA SELATAN,SETIA BUDI,SETIA BUDI,2841,1635,1206,650,1856,2021-07-13
3175101005,JAKARTA TIMUR,CIPAYUNG,SETU,20306,14462,5844,2686,8530,2021-07-13
3173071002,JAKARTA BARAT,PALMERAH,SLIPI,16475,9999,6476,2745,9221,2021-07-13
3173081004,JAKARTA BARAT,KEMBANGAN,SRENGSENG,44969,30664,14305,6205,20510,2021-07-13
3174091002,JAKARTA SELATAN,JAGAKARSA,SRENGSENG SAWAH,57480,33281,24199,8936,33135,2021-07-13
3173051003,JAKARTA BARAT,KEBON JERUK,SUKABUMI SELATAN,35170,24579,10591,3497,14088,2021-07-13
3173051002,JAKARTA BARAT,KEBON JERUK,SUKABUMI UTARA,37628,27082,10546,4030,14576,2021-07-13
3172041002,JAKARTA UTARA,CILINCING,SUKAPURA,53786,35858,17928,5479,23407,2021-07-13
3171031007,JAKARTA PUSAT,KEMAYORAN,SUMUR BATU,22506,13938,8568,3418,11986,2021-07-13
3172021004,JAKARTA UTARA,TANJUNG PRIOK,SUNGAI BAMBU,29115,18269,10846,3571,14417,2021-07-13
3172021006,JAKARTA UTARA,TANJUNG PRIOK,SUNTER AGUNG,70860,39152,31708,13602,45310,2021-07-13
3172021002,JAKARTA UTARA,TANJUNG PRIOK,SUNTER JAYA,62516,37542,24974,10526,35500,2021-07-13
3175091004,JAKARTA TIMUR,CIRACAS,SUSUKAN,33525,21367,12158,4639,16797,2021-07-13
3173031001,JAKARTA BARAT,TAMAN SARI,TAMAN SARI,14281,8548,5733,2405,8138,2021-07-13
3173041001,JAKARTA BARAT,TAMBORA,TAMBORA,10177,6547,3630,1524,5154,2021-07-13
3173041004,JAKARTA BARAT,TAMBORA,TANAH SEREAL,25944,15221,10723,3900,14623,2021-07-13
3171081004,JAKARTA PUSAT,JOHAR BARU,TANAH TINGGI,37800,22895,14905,4278,19183,2021-07-13
3173031004,JAKARTA BARAT,TAMAN SARI,TANGKI,12991,7831,5160,1936,7096,2021-07-13
3174091005,JAKARTA SELATAN,JAGAKARSA,TANJUNG BARAT,39368,26370,12998,5724,18722,2021-07-13
3173021005,JAKARTA BARAT,GROGOL PETAMBURAN,TANJUNG DUREN SELATAN,24917,13840,11077,4507,15584,2021-07-13
3173021002,JAKARTA BARAT,GROGOL PETAMBURAN,TANJUNG DUREN UTARA,16940,8843,8097,3547,11644,2021-07-13
3172021001,JAKARTA UTARA,TANJUNG PRIOK,TANJUNG PRIOK,34316,21111,13205,3852,17057,2021-07-13
3174011002,JAKARTA SELATAN,TEBET,TEBET BARAT,21164,12193,8971,4226,13197,2021-07-13
3174011001,JAKARTA SELATAN,TEBET,TEBET TIMUR,18030,9779,8251,3784,12035,2021-07-13
3173061003,JAKARTA BARAT,KALI DERES,TEGAL ALUR,82647,56457,26190,6895,33085,2021-07-13
3174031004,JAKARTA SELATAN,MAMPANG PRAPATAN,TEGAL PARANG,32174,22794,9380,3335,12715,2021-07-13
3173021003,JAKARTA BARAT,GROGOL PETAMBURAN,TOMANG,28665,16731,11934,5011,16945,2021-07-13
3172031005,JAKARTA UTARA,KOJA,TUGU SELATAN,38749,27170,11579,3841,15420,2021-07-13
3172031002,JAKARTA UTARA,KOJA,TUGU UTARA,67211,46577,20634,6790,27424,2021-07-13
3175061006,JAKARTA TIMUR,CAKUNG,UJUNG MENTENG,29527,19225,10302,4001,14303,2021-07-13
3174101005,JAKARTA SELATAN,PESANGGRAHAN,ULUJAMI,40120,27645,12475,4961,17436,2021-07-13
3175011006,JAKARTA TIMUR,MATRAMAN,UTAN KAYU SELATAN,33233,20863,12370,5085,17455,2021-07-13
3175011002,JAKARTA TIMUR,MATRAMAN,UTAN KAYU UTARA,27995,17783,10212,3841,14053,2021-07-13
3171031008,JAKARTA PUSAT,KEMAYORAN,UTAN PANJANG,29260,20448,8812,2819,11631,2021-07-13
3172021007,JAKARTA UTARA,TANJUNG PRIOK,WARAKAS,43754,27953,15801,5248,21049,2021-07-13
3173021007,JAKARTA BARAT,GROGOL PETAMBURAN,WIJAYA KUSUMA,38584,25075,13509,4882,18391,2021-07-13
3172051003,JAKARTA UTARA,PADEMANGAN,ANCOL,23379,15158,8221,3328,11549,2021-07-14
3173041007,JAKARTA BARAT,TAMBORA,ANGKE,29230,17842,11388,3261,14649,2021-07-14
3175041005,JAKARTA TIMUR,KRAMAT JATI,BALE KAMBANG,28803,21124,7679,2703,10382,2021-07-14
3175031003,JAKARTA TIMUR,JATINEGARA,BALI MESTER,9675,6216,3459,1545,5004,2021-07-14
3175101006,JAKARTA TIMUR,CIPAYUNG,BAMBU APUS,25985,17150,8835,4038,12873,2021-07-14
3174031002,JAKARTA SELATAN,MAMPANG PRAPATAN,BANGKA,21356,13405,7951,2757,10708,2021-07-14
3175051002,JAKARTA TIMUR,PASAR REBO,BARU,23514,13080,10434,4757,15191,2021-07-14
3175041004,JAKARTA TIMUR,KRAMAT JATI,BATU AMPAR,47416,34008,13408,5371,18779,2021-07-14
3171071002,JAKARTA PUSAT,TANAH ABANG,BENDUNGAN HILIR,21374,12620,8754,3628,12382,2021-07-14
3175031002,JAKARTA TIMUR,JATINEGARA,BIDARA CINA,36461,25546,10915,4099,15014,2021-07-14
3174101002,JAKARTA SELATAN,PESANGGRAHAN,BINTARO,52402,33583,18819,7197,26016,2021-07-14
3174011005,JAKARTA SELATAN,TEBET,BUKIT DURI,33953,22299,11654,4009,15663,2021-07-14
3171041006,JAKARTA PUSAT,SENEN,BUNGUR,17929,10892,7037,2791,9828,2021-07-14
3175061007,JAKARTA TIMUR,CAKUNG,CAKUNG BARAT,57222,36864,20358,4082,24440,2021-07-14
3175061004,JAKARTA TIMUR,CAKUNG,CAKUNG TIMUR,57655,36877,20778,6486,27264,2021-07-14
3175041007,JAKARTA TIMUR,KRAMAT JATI,CAWANG,32481,21388,11093,4364,15457,2021-07-14
3175101008,JAKARTA TIMUR,CIPAYUNG,CEGER,18740,12047,6693,2609,9302,2021-07-14
3171031006,JAKARTA PUSAT,KEMAYORAN,CEMPAKA BARU,31257,20490,10767,4074,14841,2021-07-14
3171051002,JAKARTA PUSAT,CEMPAKA PUTIH,CEMPAKA PUTIH BARAT,34725,22563,12162,5032,17194,2021-07-14
3171051001,JAKARTA PUSAT,CEMPAKA PUTIH,CEMPAKA PUTIH TIMUR,24170,14450,9720,4525,14245,2021-07-14
3173011001,JAKARTA BARAT,CENGKARENG,CENGKARENG BARAT,65702,38855,26847,8320,35167,2021-07-14
3173011006,JAKARTA BARAT,CENGKARENG,CENGKARENG TIMUR,80100,51067,29033,8582,37615,2021-07-14
3175091002,JAKARTA TIMUR,CIRACAS,CIBUBUR,65231,40252,24979,9683,34662,2021-07-14
3171011002,JAKARTA PUSAT,GAMBIR,CIDENG,15696,8725,6971,3228,10199,2021-07-14
3174091003,JAKARTA SELATAN,JAGAKARSA,CIGANJUR,38048,24015,14033,5248,19281,2021-07-14
3175051003,JAKARTA TIMUR,PASAR REBO,CIJANTUNG,41013,25263,15750,6312,22062,2021-07-14
3171061003,JAKARTA PUSAT,MENTENG,CIKINI,8260,5325,2935,1391,4326,2021-07-14
3174081006,JAKARTA SELATAN,PANCORAN,CIKOKO,10503,5873,4630,1778,6408,2021-07-14
3174061001,JAKARTA SELATAN,CILANDAK,CILANDAK BARAT,51346,29492,21854,7994,29848,2021-07-14
3174041003,JAKARTA SELATAN,PASAR MINGGU,CILANDAK TIMUR,24239,14097,10142,4919,15061,2021-07-14
3175101002,JAKARTA TIMUR,CIPAYUNG,CILANGKAP,27179,17370,9809,3866,13675,2021-07-14
3175041006,JAKARTA TIMUR,KRAMAT JATI,CILILITAN,39984,27315,12669,5351,18020,2021-07-14
3172041001,JAKARTA UTARA,CILINCING,CILINCING,42677,28903,13774,3981,17755,2021-07-14
3175101001,JAKARTA TIMUR,CIPAYUNG,CIPAYUNG,25747,15203,10544,4292,14836,2021-07-14
3174091006,JAKARTA SELATAN,JAGAKARSA,CIPEDAK,37809,23078,14731,4880,19611,2021-07-14
3174061005,JAKARTA SELATAN,CILANDAK,CIPETE SELATAN,26500,16221,10279,3875,14154,2021-07-14
3174071010,JAKARTA SELATAN,KEBAYORAN BARU,CIPETE UTARA,33902,20281,13621,4166,17787,2021-07-14
3175021003,JAKARTA TIMUR,PULO GADUNG,CIPINANG,39069,24741,14328,6162,20490,2021-07-14
3175031007,JAKARTA TIMUR,JATINEGARA,CIPINANG BESAR SELATAN,34938,24907,10031,3967,13998,2021-07-14
3175031008,JAKARTA TIMUR,JATINEGARA,CIPINANG BESAR UTARA,44479,32489,11990,4240,16230,2021-07-14
3175031005,JAKARTA TIMUR,JATINEGARA,CIPINANG CEMPEDAK,32695,21721,10974,4758,15732,2021-07-14
3175081005,JAKARTA TIMUR,MAKASAR,CIPINANG MELAYU,42144,26203,15941,6491,22432,2021-07-14
3175031006,JAKARTA TIMUR,JATINEGARA,CIPINANG MUARA,53251,36579,16672,7401,24073,2021-07-14
3174051003,JAKARTA SELATAN,KEBAYORAN LAMA,CIPULIR,39635,26235,13400,4850,18250,2021-07-14
3175091001,JAKARTA TIMUR,CIRACAS,CIRACAS,63801,40097,23704,8592,32296,2021-07-14
3175041003,JAKARTA TIMUR,KRAMAT JATI,DUKUH,24404,16136,8268,3570,11838,2021-07-14
3175071001,JAKARTA TIMUR,DUREN SAWIT,DUREN SAWIT,60443,39339,21104,9395,30499,2021-07-14
3174081004,JAKARTA SELATAN,PANCORAN,DUREN TIGA,28099,17096,11003,3888,14891,2021-07-14
3173051005,JAKARTA BARAT,KEBON JERUK,DURI KEPA,59448,34381,25067,10118,35185,2021-07-14
3173011002,JAKARTA BARAT,CENGKARENG,DURI KOSAMBI,75895,48561,27334,8286,35620,2021-07-14
3171011006,JAKARTA PUSAT,GAMBIR,DURI PULO,19986,13342,6644,2412,9056,2021-07-14
3173041011,JAKARTA BARAT,TAMBORA,DURI SELATAN,14099,8493,5606,2383,7989,2021-07-14
3173041003,JAKARTA BARAT,TAMBORA,DURI UTARA,19768,12358,7410,2664,10074,2021-07-14
3171081003,JAKARTA PUSAT,JOHAR BARU,GALUR,18098,10336,7762,1989,9751,2021-07-14
3171011001,JAKARTA PUSAT,GAMBIR,GAMBIR,2434,1331,1103,582,1685,2021-07-14
3174061004,JAKARTA SELATAN,CILANDAK,GANDARIA SELATAN,21926,13477,8449,2870,11319,2021-07-14
3174071009,JAKARTA SELATAN,KEBAYORAN BARU,GANDARIA UTARA,39609,24337,15272,5418,20690,2021-07-14
3175051001,JAKARTA TIMUR,PASAR REBO,GEDONG,35444,22757,12687,5376,18063,2021-07-14
3171071001,JAKARTA PUSAT,TANAH ABANG,GELORA,3106,1895,1211,578,1789,2021-07-14
3173031007,JAKARTA BARAT,TAMAN SARI,GLODOK,7836,3670,4166,1994,6160,2021-07-14
3171061004,JAKARTA PUSAT,MENTENG,GONDANGDIA,4093,2069,2024,1304,3328,2021-07-14
3173021001,JAKARTA BARAT,GROGOL PETAMBURAN,GROGOL,16815,10247,6568,2635,9203,2021-07-14
3174051005,JAKARTA SELATAN,KEBAYORAN LAMA,GROGOL SELATAN,43915,29439,14476,5527,20003,2021-07-14
3174051004,JAKARTA SELATAN,KEBAYORAN LAMA,GROGOL UTARA,42216,27632,14584,5917,20501,2021-07-14
3174021007,JAKARTA SELATAN,SETIA BUDI,GUNTUR,3962,2056,1906,1001,2907,2021-07-14
3174071002,JAKARTA SELATAN,KEBAYORAN BARU,GUNUNG,9344,5217,4127,2060,6187,2021-07-14
3171031005,JAKARTA PUSAT,KEMAYORAN,GUNUNG SAHARI SELATAN,19380,11845,7535,2848,10383,2021-07-14
3171021004,JAKARTA PUSAT,SAWAH BESAR,GUNUNG SAHARI UTARA,15647,8032,7615,3413,11028,2021-07-14
3175081004,JAKARTA TIMUR,MAKASAR,HALIM PERDANA KUSUMAH,28110,13348,14762,9374,24136,2021-07-14
3171031003,JAKARTA PUSAT,KEMAYORAN,HARAPAN MULIA,22700,14872,7828,2724,10552,2021-07-14
3174091001,JAKARTA SELATAN,JAGAKARSA,JAGAKARSA,61552,36647,24905,8633,33538,2021-07-14
3175021007,JAKARTA TIMUR,PULO GADUNG,JATI,32443,20153,12290,5682,17972,2021-07-14
3174041002,JAKARTA SELATAN,PASAR MINGGU,JATI PADANG,37250,22849,14401,5925,20326,2021-07-14
3173071004,JAKARTA BARAT,PALMERAH,JATI PULO,27994,16312,11682,3695,15377,2021-07-14
3175061001,JAKARTA TIMUR,CAKUNG,JATINEGARA,83563,60116,23447,6872,30319,2021-07-14
3175021004,JAKARTA TIMUR,PULO GADUNG,JATINEGARA KAUM,24364,16114,8250,2966,11216,2021-07-14
3173021004,JAKARTA BARAT,GROGOL PETAMBURAN,JELAMBAR,30180,17401,12779,5515,18294,2021-07-14
3173021006,JAKARTA BARAT,GROGOL PETAMBURAN,JELAMBAR BARU,37799,22430,15369,6125,21494,2021-07-14
3173041006,JAKARTA BARAT,TAMBORA,JEMBATAN BESI,29182,21676,7506,2453,9959,2021-07-14
3173041008,JAKARTA BARAT,TAMBORA,JEMBATAN LIMA,20627,14113,6514,2294,8808,2021-07-14
3173081005,JAKARTA BARAT,KEMBANGAN,JOGLO,40475,25938,14537,5999,20536,2021-07-14
3171081001,JAKARTA PUSAT,JOHAR BARU,JOHAR BARU,32845,17965,14880,5386,20266,2021-07-14
3173041002,JAKARTA BARAT,TAMBORA,KALI ANYAR,23582,16886,6696,2258,8954,2021-07-14
3172041004,JAKARTA UTARA,CILINCING,KALIBARU,67165,48317,18848,4395,23243,2021-07-14
3174081002,JAKARTA SELATAN,PANCORAN,KALIBATA,41464,27556,13908,4988,18896,2021-07-14
3173061001,JAKARTA BARAT,KALI DERES,KALIDERES,69014,44807,24207,7660,31867,2021-07-14
3175051004,JAKARTA TIMUR,PASAR REBO,KALISARI,42557,26408,16149,6896,23045,2021-07-14
3173061004,JAKARTA BARAT,KALI DERES,KAMAL,53180,38891,14289,3681,17970,2021-07-14
3172011002,JAKARTA UTARA,PENJARINGAN,KAMAL MUARA,12679,6446,6233,2541,8774,2021-07-14
3171071007,JAKARTA PUSAT,TANAH ABANG,KAMPUNG BALI,11551,7779,3772,1526,5298,2021-07-14
3175031001,JAKARTA TIMUR,JATINEGARA,KAMPUNG MELAYU,25476,18403,7073,2262,9335,2021-07-14
3171081002,JAKARTA PUSAT,JOHAR BARU,KAMPUNG RAWA,18247,8860,9387,2562,11949,2021-07-14
3175041002,JAKARTA TIMUR,KRAMAT JATI,KAMPUNG TENGAH,43668,30798,12870,5322,18192,2021-07-14
3173011005,JAKARTA BARAT,CENGKARENG,KAPUK,121994,83517,38477,9575,48052,2021-07-14
3172011003,JAKARTA UTARA,PENJARINGAN,KAPUK MUARA,35498,20208,15290,6749,22039,2021-07-14
3171021002,JAKARTA PUSAT,SAWAH BESAR,KARANG ANYAR,25865,16072,9793,3433,13226,2021-07-14
3174021004,JAKARTA SELATAN,SETIA BUDI,KARET,9581,5636,3945,1451,5396,2021-07-14
3174021003,JAKARTA SELATAN,SETIA BUDI,KARET KUNINGAN,15939,9069,6870,2352,9222,2021-07-14
3174021002,JAKARTA SELATAN,SETIA BUDI,KARET SEMANGGI,2746,1370,1376,604,1980,2021-07-14
3171071003,JAKARTA PUSAT,TANAH ABANG,KARET TENGSIN,19113,12321,6792,2235,9027,2021-07-14
3171021003,JAKARTA PUSAT,SAWAH BESAR,KARTINI,22303,13228,9075,3483,12558,2021-07-14
3175011003,JAKARTA TIMUR,MATRAMAN,KAYU MANIS,25138,16780,8358,3040,11398,2021-07-14
3175021006,JAKARTA TIMUR,PULO GADUNG,KAYU PUTIH,40378,23400,16978,7172,24150,2021-07-14
3173031006,JAKARTA BARAT,TAMAN SARI,KEAGUNGAN,17231,10485,6746,2015,8761,2021-07-14
3174041007,JAKARTA SELATAN,PASAR MINGGU,KEBAGUSAN,44010,28821,15189,5259,20448,2021-07-14
3174051006,JAKARTA SELATAN,KEBAYORAN LAMA,KEBAYORAN LAMA SELATAN,40895,24703,16192,5865,22057,2021-07-14
3174051001,JAKARTA SELATAN,KEBAYORAN LAMA,KEBAYORAN LAMA UTARA,42214,27754,14460,5316,19776,2021-07-14
3174011004,JAKARTA SELATAN,TEBET,KEBON BARU,34878,21772,13106,5178,18284,2021-07-14
3172021005,JAKARTA UTARA,TANJUNG PRIOK,KEBON BAWANG,50597,31169,19428,7004,26432,2021-07-14
3173051001,JAKARTA BARAT,KEBON JERUK,KEBON JERUK,53296,35887,17409,6851,24260,2021-07-14
3171071006,JAKARTA PUSAT,TANAH ABANG,KEBON KACANG,21376,15028,6348,2653,9001,2021-07-14
3171011005,JAKARTA PUSAT,GAMBIR,KEBON KELAPA,10380,6481,3899,1669,5568,2021-07-14
3171031002,JAKARTA PUSAT,KEMAYORAN,KEBON KOSONG,30003,19171,10832,3500,14332,2021-07-14
3175011005,JAKARTA TIMUR,MATRAMAN,KEBON MANGGIS,16393,9942,6451,2802,9253,2021-07-14
3171071005,JAKARTA PUSAT,TANAH ABANG,KEBON MELATI,31355,23676,7679,2884,10563,2021-07-14
3175081003,JAKARTA TIMUR,MAKASAR,KEBON PALA,46176,30379,15797,6319,22116,2021-07-14
3171061005,JAKARTA PUSAT,MENTENG,KEBON SIRIH,12256,8541,3715,1558,5273,2021-07-14
3173011004,JAKARTA BARAT,CENGKARENG,KEDAUNG KALI ANGKE,32185,18228,13957,3246,17203,2021-07-14
3173051007,JAKARTA BARAT,KEBON JERUK,KEDOYA SELATAN,31907,19776,12131,4648,16779,2021-07-14
3173051006,JAKARTA BARAT,KEBON JERUK,KEDOYA UTARA,43826,25312,18514,7051,25565,2021-07-14
3173051004,JAKARTA BARAT,KEBON JERUK,KELAPA DUA,23293,14993,8300,3158,11458,2021-07-14
3175091003,JAKARTA TIMUR,CIRACAS,KELAPA DUA WETAN,46441,28823,17618,7376,24994,2021-07-14
3172061003,JAKARTA UTARA,KELAPA GADING,KELAPA GADING BARAT,35403,18074,17329,8936,26265,2021-07-14
3172061001,JAKARTA UTARA,KELAPA GADING,KELAPA GADING TIMUR,33472,15388,18084,9213,27297,2021-07-14
3173071005,JAKARTA BARAT,PALMERAH,KEMANGGISAN,31952,19723,12229,5259,17488,2021-07-14
3171031001,JAKARTA PUSAT,KEMAYORAN,KEMAYORAN,20947,12438,8509,2854,11363,2021-07-14
3173081006,JAKARTA BARAT,KEMBANGAN,KEMBANGAN SELATAN,26920,16216,10704,5070,15774,2021-07-14
3173081001,JAKARTA BARAT,KEMBANGAN,KEMBANGAN UTARA,52368,32555,19813,6681,26494,2021-07-14
3171041002,JAKARTA PUSAT,SENEN,KENARI,9317,5281,4036,1757,5793,2021-07-14
3173041005,JAKARTA BARAT,TAMBORA,KERENDANG,19869,13163,6706,2242,8948,2021-07-14
3175071003,JAKARTA TIMUR,DUREN SAWIT,KLENDER,69321,48975,20346,7507,27853,2021-07-14
3172031001,JAKARTA UTARA,KOJA,KOJA,28036,17579,10457,2777,13234,2021-07-14
3173071006,JAKARTA BARAT,PALMERAH,KOTA BAMBU SELATAN,20926,13593,7333,2258,9591,2021-07-14
3173071003,JAKARTA BARAT,PALMERAH,KOTA BAMBU UTARA,24416,16112,8304,2793,11097,2021-07-14
3171041004,JAKARTA PUSAT,SENEN,KRAMAT,28661,19552,9109,3018,12127,2021-07-14
3175041001,JAKARTA TIMUR,KRAMAT JATI,KRAMAT JATI,33851,22066,11785,5109,16894,2021-07-14
3174071003,JAKARTA SELATAN,KEBAYORAN BARU,KRAMAT PELA,14340,8175,6165,2387,8552,2021-07-14
3173031002,JAKARTA BARAT,TAMAN SARI,KRUKUT,19130,11819,7311,2305,9616,2021-07-14
3174031005,JAKARTA SELATAN,MAMPANG PRAPATAN,KUNINGAN BARAT,12675,7574,5101,1557,6658,2021-07-14
3174021008,JAKARTA SELATAN,SETIA BUDI,KUNINGAN TIMUR,5982,3611,2371,1068,3439,2021-07-14
3171041005,JAKARTA PUSAT,SENEN,KWITANG,15295,9533,5762,2109,7871,2021-07-14
3172031003,JAKARTA UTARA,KOJA,LAGOA,58726,39756,18970,5695,24665,2021-07-14
3174061002,JAKARTA SELATAN,CILANDAK,LEBAK BULUS,37213,22913,14300,5984,20284,2021-07-14
3174091004,JAKARTA SELATAN,JAGAKARSA,LENTENG AGUNG,53453,36305,17148,6213,23361,2021-07-14
3175101007,JAKARTA TIMUR,CIPAYUNG,LUBANG BUAYA,62984,39561,23423,8472,31895,2021-07-14
3175081001,JAKARTA TIMUR,MAKASAR,MAKASAR,34062,20933,13129,5015,18144,2021-07-14
3175071006,JAKARTA TIMUR,DUREN SAWIT,MALAKA JAYA,30744,18531,12213,5535,17748,2021-07-14
3175071005,JAKARTA TIMUR,DUREN SAWIT,MALAKA SARI,27015,15817,11198,5477,16675,2021-07-14
3174031001,JAKARTA SELATAN,MAMPANG PRAPATAN,MAMPANG PRAPATAN,18046,11522,6524,2070,8594,2021-07-14
3173031005,JAKARTA BARAT,TAMAN SARI,MANGGA BESAR,7439,3848,3591,1456,5047,2021-07-14
3171021005,JAKARTA PUSAT,SAWAH BESAR,MANGGA DUA SELATAN,27767,17159,10608,3883,14491,2021-07-14
3174011007,JAKARTA SELATAN,TEBET,MANGGARAI,28388,18310,10078,3586,13664,2021-07-14
3174011006,JAKARTA SELATAN,TEBET,MANGGARAI SELATAN,22902,13482,9420,3238,12658,2021-07-14
3173031003,JAKARTA BARAT,TAMAN SARI,MAPHAR,16385,9622,6763,2591,9354,2021-07-14
3172041003,JAKARTA UTARA,CILINCING,MARUNDA,28614,17425,11189,2593,13782,2021-07-14
3174071001,JAKARTA SELATAN,KEBAYORAN BARU,MELAWAI,2634,1269,1365,838,2203,2021-07-14
3171061001,JAKARTA PUSAT,MENTENG,MENTENG,25280,17519,7761,3567,11328,2021-07-14
3174021005,JAKARTA SELATAN,SETIA BUDI,MENTENG ATAS,27671,16423,11248,4073,15321,2021-07-14
3174011003,JAKARTA SELATAN,TEBET,MENTENG DALAM,35936,22767,13169,5239,18408,2021-07-14
3173081003,JAKARTA BARAT,KEMBANGAN,MERUYA SELATAN,31227,19823,11404,4358,15762,2021-07-14
3173081002,JAKARTA BARAT,KEMBANGAN,MERUYA UTARA,43382,27137,16245,7019,23264,2021-07-14
3175101004,JAKARTA TIMUR,CIPAYUNG,MUNJUL,23570,15165,8405,3639,12044,2021-07-14
3172051002,JAKARTA UTARA,PADEMANGAN,PADEMANGAN BARAT,73841,49122,24719,7860,32579,2021-07-14
3172051001,JAKARTA UTARA,PADEMANGAN,PADEMANGAN TIMUR,36757,19700,17057,6936,23993,2021-07-14
3175011004,JAKARTA TIMUR,MATRAMAN,PAL MERIAM,19632,12467,7165,2741,9906,2021-07-14
3173071001,JAKARTA BARAT,PALMERAH,PALMERAH,62175,39610,22565,8069,30634,2021-07-14
3174081001,JAKARTA SELATAN,PANCORAN,PANCORAN,19301,11772,7529,2671,10200,2021-07-14
3172021003,JAKARTA UTARA,TANJUNG PRIOK,PAPANGGO,38871,23965,14906,4775,19681,2021-07-14
3171021001,JAKARTA PUSAT,SAWAH BESAR,PASAR BARU,12710,6516,6194,2930,9124,2021-07-14
3174021006,JAKARTA SELATAN,SETIA BUDI,PASAR MANGGIS,26572,16082,10490,3576,14066,2021-07-14
3174041001,JAKARTA SELATAN,PASAR MINGGU,PASAR MINGGU,24670,15374,9296,4617,13913,2021-07-14
3171041003,JAKARTA PUSAT,SENEN,PASEBAN,23321,14583,8738,3333,12071,2021-07-14
3173061005,JAKARTA BARAT,KALI DERES,PEGADUNGAN,74685,47014,27671,9201,36872,2021-07-14
3171061002,JAKARTA PUSAT,MENTENG,PEGANGSAAN,21120,13865,7255,2977,10232,2021-07-14
3172061002,JAKARTA UTARA,KELAPA GADING,PEGANGSAAN DUA,49632,24743,24889,10605,35494,2021-07-14
3172011004,JAKARTA UTARA,PENJARINGAN,PEJAGALAN,74043,44105,29938,10982,40920,2021-07-14
3174041006,JAKARTA SELATAN,PASAR MINGGU,PEJATEN BARAT,35061,20994,14067,5686,19753,2021-07-14
3174041005,JAKARTA SELATAN,PASAR MINGGU,PEJATEN TIMUR,57257,38464,18793,6175,24968,2021-07-14
3175051005,JAKARTA TIMUR,PASAR REBO,PEKAYON,42705,26592,16113,6189,22302,2021-07-14
3173041009,JAKARTA BARAT,TAMBORA,PEKOJAN,23428,13996,9432,3447,12879,2021-07-14
3174031003,JAKARTA SELATAN,MAMPANG PRAPATAN,PELA MAMPANG,42709,25934,16775,5695,22470,2021-07-14
3174081005,JAKARTA SELATAN,PANCORAN,PENGADEGAN,21111,11435,9676,3363,13039,2021-07-14
3175061003,JAKARTA TIMUR,CAKUNG,PENGGILINGAN,97138,70461,26677,9445,36122,2021-07-14
3172011001,JAKARTA UTARA,PENJARINGAN,PENJARINGAN,86712,58378,28334,7894,36228,2021-07-14
3174101001,JAKARTA SELATAN,PESANGGRAHAN,PESANGGRAHAN,27215,15697,11518,4911,16429,2021-07-14
3171071004,JAKARTA PUSAT,TANAH ABANG,PETAMBURAN,33060,24715,8345,2962,11307,2021-07-14
3174071008,JAKARTA SELATAN,KEBAYORAN BARU,PETOGOGAN,11418,6748,4670,1904,6574,2021-07-14
3171011004,JAKARTA PUSAT,GAMBIR,PETOJO SELATAN,14946,8894,6052,3016,9068,2021-07-14
3171011003,JAKARTA PUSAT,GAMBIR,PETOJO UTARA,17843,11343,6500,2724,9224,2021-07-14
3174101004,JAKARTA SELATAN,PESANGGRAHAN,PETUKANGAN SELATAN,36769,22259,14510,4960,19470,2021-07-14
3174101003,JAKARTA SELATAN,PESANGGRAHAN,PETUKANGAN UTARA,53184,33929,19255,6784,26039,2021-07-14
3175081002,JAKARTA TIMUR,MAKASAR,PINANG RANTI,26915,16787,10128,3511,13639,2021-07-14
3173031008,JAKARTA BARAT,TAMAN SARI,PINANGSIA,10583,5812,4771,1643,6414,2021-07-14
3175011001,JAKARTA TIMUR,MATRAMAN,PISANGAN BARU,31537,21967,9570,3842,13412,2021-07-14
3175021002,JAKARTA TIMUR,PULO GADUNG,PISANGAN TIMUR,40576,25556,15020,5732,20752,2021-07-14
3172011005,JAKARTA UTARA,PENJARINGAN,PLUIT,47433,24891,22542,12412,34954,2021-07-14
3175071002,JAKARTA TIMUR,DUREN SAWIT,PONDOK BAMBU,61047,39184,21863,9010,30873,2021-07-14
3175071004,JAKARTA TIMUR,DUREN SAWIT,PONDOK KELAPA,71347,44045,27302,11113,38415,2021-07-14
3175071007,JAKARTA TIMUR,DUREN SAWIT,PONDOK KOPI,35051,24201,10850,4396,15246,2021-07-14
3174061003,JAKARTA SELATAN,CILANDAK,PONDOK LABU,45944,27298,18646,6956,25602,2021-07-14
3174051002,JAKARTA SELATAN,KEBAYORAN LAMA,PONDOK PINANG,55724,35021,20703,9732,30435,2021-07-14
3175101003,JAKARTA TIMUR,CIPAYUNG,PONDOK RANGGON,25123,16571,8552,3823,12375,2021-07-14
3101011003,KAB.ADM.KEP.SERIBU,KEP. SERIBU UTARA,PULAU HARAPAN,2036,726,1310,670,1980,2021-07-14
3101011002,KAB.ADM.KEP.SERIBU,KEP. SERIBU UTARA,PULAU KELAPA,5460,1958,3502,1086,4588,2021-07-14
3101011001,KAB.ADM.KEP.SERIBU,KEP. SERIBU UTARA,PULAU PANGGANG,5395,1827,3568,1150,4718,2021-07-14
3101021003,KAB.ADM.KEP.SERIBU,KEP. SERIBU SELATAN,PULAU PARI,2736,786,1950,614,2564,2021-07-14
3101021002,KAB.ADM.KEP.SERIBU,KEP. SERIBU SELATAN,PULAU TIDUNG,4528,1607,2921,1133,4054,2021-07-14
3101021001,KAB.ADM.KEP.SERIBU,KEP. SERIBU SELATAN,PULAU UNTUNG JAWA,1918,670,1248,559,1807,2021-07-14
3174071007,JAKARTA SELATAN,KEBAYORAN BARU,PULO,5777,2976,2801,1363,4164,2021-07-14
3175021001,JAKARTA TIMUR,PULO GADUNG,PULO GADUNG,34175,22343,11832,4714,16546,2021-07-14
3175061005,JAKARTA TIMUR,CAKUNG,PULO GEBANG,95947,65729,30218,10795,41013,2021-07-14
3174041004,JAKARTA SELATAN,PASAR MINGGU,RAGUNAN,39233,22952,16281,5872,22153,2021-07-14
3175091005,JAKARTA TIMUR,CIRACAS,RAMBUTAN,36368,25894,10474,4341,14815,2021-07-14
3172031006,JAKARTA UTARA,KOJA,RAWA BADAK SELATAN,41895,28844,13051,3976,17027,2021-07-14
3172031004,JAKARTA UTARA,KOJA,RAWA BADAK UTARA,33538,21025,12513,3900,16413,2021-07-14
3174071005,JAKARTA SELATAN,KEBAYORAN BARU,RAWA BARAT,5574,3071,2503,1346,3849,2021-07-14
3173011003,JAKARTA BARAT,CENGKARENG,RAWA BUAYA,59533,38287,21246,6046,27292,2021-07-14
3175031004,JAKARTA TIMUR,JATINEGARA,RAWA BUNGA,21272,14676,6596,2498,9094,2021-07-14
3174081003,JAKARTA SELATAN,PANCORAN,RAWA JATI,20321,11833,8488,3463,11951,2021-07-14
3175061002,JAKARTA TIMUR,CAKUNG,RAWA TERATE,24433,14947,9486,2144,11630,2021-07-14
3175021005,JAKARTA TIMUR,PULO GADUNG,RAWAMANGUN,36788,23056,13732,5920,19652,2021-07-14
3171051003,JAKARTA PUSAT,CEMPAKA PUTIH,RAWASARI,21770,13259,8511,3530,12041,2021-07-14
3173041010,JAKARTA BARAT,TAMBORA,ROA MALAKA,3449,1670,1779,894,2673,2021-07-14
3172041006,JAKARTA UTARA,CILINCING,ROROTAN,40953,25475,15478,4638,20116,2021-07-14
3174071004,JAKARTA SELATAN,KEBAYORAN BARU,SELONG,2843,1400,1443,889,2332,2021-07-14
3173061002,JAKARTA BARAT,KALI DERES,SEMANAN,70293,50065,20228,5040,25268,2021-07-14
3172041007,JAKARTA UTARA,CILINCING,SEMPER BARAT,67899,40596,27303,9148,36451,2021-07-14
3172041005,JAKARTA UTARA,CILINCING,SEMPER TIMUR,36029,22403,13626,4347,17973,2021-07-14
3174071006,JAKARTA SELATAN,KEBAYORAN BARU,SENAYAN,2780,1720,1060,577,1637,2021-07-14
3171041001,JAKARTA PUSAT,SENEN,SENEN,6757,4052,2705,1193,3898,2021-07-14
3171031004,JAKARTA PUSAT,KEMAYORAN,SERDANG,29730,18613,11117,3973,15090,2021-07-14
3174021001,JAKARTA SELATAN,SETIA BUDI,SETIA BUDI,2841,1611,1230,652,1882,2021-07-14
3175101005,JAKARTA TIMUR,CIPAYUNG,SETU,20306,14130,6176,2705,8881,2021-07-14
3173071002,JAKARTA BARAT,PALMERAH,SLIPI,16475,9763,6712,2748,9460,2021-07-14
3173081004,JAKARTA BARAT,KEMBANGAN,SRENGSENG,44969,30040,14929,6238,21167,2021-07-14
3174091002,JAKARTA SELATAN,JAGAKARSA,SRENGSENG SAWAH,57480,32659,24821,8972,33793,2021-07-14
3173051003,JAKARTA BARAT,KEBON JERUK,SUKABUMI SELATAN,35170,24099,11071,3515,14586,2021-07-14
3173051002,JAKARTA BARAT,KEBON JERUK,SUKABUMI UTARA,37628,26647,10981,4044,15025,2021-07-14
3172041002,JAKARTA UTARA,CILINCING,SUKAPURA,53786,34504,19282,5499,24781,2021-07-14
3171031007,JAKARTA PUSAT,KEMAYORAN,SUMUR BATU,22506,13650,8856,3432,12288,2021-07-14
3172021004,JAKARTA UTARA,TANJUNG PRIOK,SUNGAI BAMBU,29115,17744,11371,3588,14959,2021-07-14
3172021006,JAKARTA UTARA,TANJUNG PRIOK,SUNTER AGUNG,70860,38166,32694,13652,46346,2021-07-14
3172021002,JAKARTA UTARA,TANJUNG PRIOK,SUNTER JAYA,62516,36596,25920,10559,36479,2021-07-14
3175091004,JAKARTA TIMUR,CIRACAS,SUSUKAN,33525,20701,12824,4658,17482,2021-07-14
3173031001,JAKARTA BARAT,TAMAN SARI,TAMAN SARI,14281,8334,5947,2413,8360,2021-07-14
3173041001,JAKARTA BARAT,TAMBORA,TAMBORA,10177,6455,3722,1526,5248,2021-07-14
3173041004,JAKARTA BARAT,TAMBORA,TANAH SEREAL,25944,14765,11179,3915,15094,2021-07-14
3171081004,JAKARTA PUSAT,JOHAR BARU,TANAH TINGGI,37800,22366,15434,4287,19721,2021-07-14
3173031004,JAKARTA BARAT,TAMAN SARI,TANGKI,12991,7644,5347,1941,7288,2021-07-14
3174091005,JAKARTA SELATAN,JAGAKARSA,TANJUNG BARAT,39368,25803,13565,5750,19315,2021-07-14
3173021005,JAKARTA BARAT,GROGOL PETAMBURAN,TANJUNG DUREN SELATAN,24917,13544,11373,4525,15898,2021-07-14
3173021002,JAKARTA BARAT,GROGOL PETAMBURAN,TANJUNG DUREN UTARA,16940,8654,8286,3555,11841,2021-07-14
3172021001,JAKARTA UTARA,TANJUNG PRIOK,TANJUNG PRIOK,34316,20637,13679,3864,17543,2021-07-14
3174011002,JAKARTA SELATAN,TEBET,TEBET BARAT,21164,11863,9301,4240,13541,2021-07-14
3174011001,JAKARTA SELATAN,TEBET,TEBET TIMUR,18030,9617,8413,3804,12217,2021-07-14
3173061003,JAKARTA BARAT,KALI DERES,TEGAL ALUR,82647,55621,27026,6916,33942,2021-07-14
3174031004,JAKARTA SELATAN,MAMPANG PRAPATAN,TEGAL PARANG,32174,22130,10044,3352,13396,2021-07-14
3173021003,JAKARTA BARAT,GROGOL PETAMBURAN,TOMANG,28665,16323,12342,5024,17366,2021-07-14
3172031005,JAKARTA UTARA,KOJA,TUGU SELATAN,38749,26172,12577,3858,16435,2021-07-14
3172031002,JAKARTA UTARA,KOJA,TUGU UTARA,67211,45386,21825,6811,28636,2021-07-14
3175061006,JAKARTA TIMUR,CAKUNG,UJUNG MENTENG,29527,18577,10950,4015,14965,2021-07-14
3174101005,JAKARTA SELATAN,PESANGGRAHAN,ULUJAMI,40120,26977,13143,4974,18117,2021-07-14
3175011006,JAKARTA TIMUR,MATRAMAN,UTAN KAYU SELATAN,33233,20389,12844,5114,17958,2021-07-14
3175011002,JAKARTA TIMUR,MATRAMAN,UTAN KAYU UTARA,27995,17481,10514,3858,14372,2021-07-14
3171031008,JAKARTA PUSAT,KEMAYORAN,UTAN PANJANG,29260,20037,9223,2834,12057,2021-07-14
3172021007,JAKARTA UTARA,TANJUNG PRIOK,WARAKAS,43754,27135,16619,5266,21885,2021-07-14
3173021007,JAKARTA BARAT,GROGOL PETAMBURAN,WIJAYA KUSUMA,38584,24687,13897,4899,18796,2021-07-14
3172051003,JAKARTA UTARA,PADEMANGAN,ANCOL,23379,14884,8495,3331,11826,2021-07-15
3173041007,JAKARTA BARAT,TAMBORA,ANGKE,29230,17480,11750,3267,15017,2021-07-15
3175041005,JAKARTA TIMUR,KRAMAT JATI,BALE KAMBANG,28803,20889,7914,2710,10624,2021-07-15
3175031003,JAKARTA TIMUR,JATINEGARA,BALI MESTER,9675,6126,3549,1546,5095,2021-07-15
3175101006,JAKARTA TIMUR,CIPAYUNG,BAMBU APUS,25985,16870,9115,4046,13161,2021-07-15
3174031002,JAKARTA SELATAN,MAMPANG PRAPATAN,BANGKA,21356,13135,8221,2767,10988,2021-07-15
3175051002,JAKARTA TIMUR,PASAR REBO,BARU,23514,12865,10649,4800,15449,2021-07-15
3175041004,JAKARTA TIMUR,KRAMAT JATI,BATU AMPAR,47416,33639,13777,5396,19173,2021-07-15
3171071002,JAKARTA PUSAT,TANAH ABANG,BENDUNGAN HILIR,21374,12418,8956,3641,12597,2021-07-15
3175031002,JAKARTA TIMUR,JATINEGARA,BIDARA CINA,36461,25297,11164,4110,15274,2021-07-15
3174101002,JAKARTA SELATAN,PESANGGRAHAN,BINTARO,52402,32951,19451,7219,26670,2021-07-15
3174011005,JAKARTA SELATAN,TEBET,BUKIT DURI,33953,21952,12001,4029,16030,2021-07-15
3171041006,JAKARTA PUSAT,SENEN,BUNGUR,17929,10785,7144,2795,9939,2021-07-15
3175061007,JAKARTA TIMUR,CAKUNG,CAKUNG BARAT,57222,35991,21231,4093,25324,2021-07-15
3175061004,JAKARTA TIMUR,CAKUNG,CAKUNG TIMUR,57655,36066,21589,6496,28085,2021-07-15
3175041007,JAKARTA TIMUR,KRAMAT JATI,CAWANG,32481,21141,11340,4381,15721,2021-07-15
3175101008,JAKARTA TIMUR,CIPAYUNG,CEGER,18740,11860,6880,2615,9495,2021-07-15
3171031006,JAKARTA PUSAT,KEMAYORAN,CEMPAKA BARU,31257,20252,11005,4096,15101,2021-07-15
3171051002,JAKARTA PUSAT,CEMPAKA PUTIH,CEMPAKA PUTIH BARAT,34725,22157,12568,5048,17616,2021-07-15
3171051001,JAKARTA PUSAT,CEMPAKA PUTIH,CEMPAKA PUTIH TIMUR,24170,14328,9842,4540,14382,2021-07-15
3173011001,JAKARTA BARAT,CENGKARENG,CENGKARENG BARAT,65702,38012,27690,8334,36024,2021-07-15
3173011006,JAKARTA BARAT,CENGKARENG,CENGKARENG TIMUR,80100,50085,30015,8596,38611,2021-07-15
3175091002,JAKARTA TIMUR,CIRACAS,CIBUBUR,65231,38798,26433,9724,36157,2021-07-15
3171011002,JAKARTA PUSAT,GAMBIR,CIDENG,15696,8619,7077,3239,10316,2021-07-15
3174091003,JAKARTA SELATAN,JAGAKARSA,CIGANJUR,38048,23549,14499,5265,19764,2021-07-15
3175051003,JAKARTA TIMUR,PASAR REBO,CIJANTUNG,41013,24801,16212,6337,22549,2021-07-15
3171061003,JAKARTA PUSAT,MENTENG,CIKINI,8260,5265,2995,1395,4390,2021-07-15
3174081006,JAKARTA SELATAN,PANCORAN,CIKOKO,10503,5780,4723,1783,6506,2021-07-15
3174061001,JAKARTA SELATAN,CILANDAK,CILANDAK BARAT,51346,29061,22285,8025,30310,2021-07-15
3174041003,JAKARTA SELATAN,PASAR MINGGU,CILANDAK TIMUR,24239,13855,10384,4932,15316,2021-07-15
3175101002,JAKARTA TIMUR,CIPAYUNG,CILANGKAP,27179,17088,10091,3882,13973,2021-07-15
3175041006,JAKARTA TIMUR,KRAMAT JATI,CILILITAN,39984,27010,12974,5365,18339,2021-07-15
3172041001,JAKARTA UTARA,CILINCING,CILINCING,42677,28053,14624,4001,18625,2021-07-15
3175101001,JAKARTA TIMUR,CIPAYUNG,CIPAYUNG,25747,14956,10791,4302,15093,2021-07-15
3174091006,JAKARTA SELATAN,JAGAKARSA,CIPEDAK,37809,22623,15186,4897,20083,2021-07-15
3174061005,JAKARTA SELATAN,CILANDAK,CIPETE SELATAN,26500,15947,10553,3886,14439,2021-07-15
3174071010,JAKARTA SELATAN,KEBAYORAN BARU,CIPETE UTARA,33902,19950,13952,4181,18133,2021-07-15
3175021003,JAKARTA TIMUR,PULO GADUNG,CIPINANG,39069,24431,14638,6182,20820,2021-07-15
3175031007,JAKARTA TIMUR,JATINEGARA,CIPINANG BESAR SELATAN,34938,24606,10332,3974,14306,2021-07-15
3175031008,JAKARTA TIMUR,JATINEGARA,CIPINANG BESAR UTARA,44479,31958,12521,4259,16780,2021-07-15
3175031005,JAKARTA TIMUR,JATINEGARA,CIPINANG CEMPEDAK,32695,21411,11284,4772,16056,2021-07-15
3175081005,JAKARTA TIMUR,MAKASAR,CIPINANG MELAYU,42144,25879,16265,6512,22777,2021-07-15
3175031006,JAKARTA TIMUR,JATINEGARA,CIPINANG MUARA,53251,36103,17148,7430,24578,2021-07-15
3174051003,JAKARTA SELATAN,KEBAYORAN LAMA,CIPULIR,39635,25945,13690,4855,18545,2021-07-15
3175091001,JAKARTA TIMUR,CIRACAS,CIRACAS,63801,39367,24434,8630,33064,2021-07-15
3175041003,JAKARTA TIMUR,KRAMAT JATI,DUKUH,24404,15931,8473,3584,12057,2021-07-15
3175071001,JAKARTA TIMUR,DUREN SAWIT,DUREN SAWIT,60443,38935,21508,9437,30945,2021-07-15
3174081004,JAKARTA SELATAN,PANCORAN,DUREN TIGA,28099,16776,11323,3900,15223,2021-07-15
3173051005,JAKARTA BARAT,KEBON JERUK,DURI KEPA,59448,33554,25894,10151,36045,2021-07-15
3173011002,JAKARTA BARAT,CENGKARENG,DURI KOSAMBI,75895,47624,28271,8308,36579,2021-07-15
3171011006,JAKARTA PUSAT,GAMBIR,DURI PULO,19986,13186,6800,2420,9220,2021-07-15
3173041011,JAKARTA BARAT,TAMBORA,DURI SELATAN,14099,8262,5837,2389,8226,2021-07-15
3173041003,JAKARTA BARAT,TAMBORA,DURI UTARA,19768,12076,7692,2671,10363,2021-07-15
3171081003,JAKARTA PUSAT,JOHAR BARU,GALUR,18098,10192,7906,1999,9905,2021-07-15
3171011001,JAKARTA PUSAT,GAMBIR,GAMBIR,2434,1325,1109,584,1693,2021-07-15
3174061004,JAKARTA SELATAN,CILANDAK,GANDARIA SELATAN,21926,13287,8639,2875,11514,2021-07-15
3174071009,JAKARTA SELATAN,KEBAYORAN BARU,GANDARIA UTARA,39609,23960,15649,5441,21090,2021-07-15
3175051001,JAKARTA TIMUR,PASAR REBO,GEDONG,35444,22414,13030,5390,18420,2021-07-15
3171071001,JAKARTA PUSAT,TANAH ABANG,GELORA,3106,1868,1238,582,1820,2021-07-15
3173031007,JAKARTA BARAT,TAMAN SARI,GLODOK,7836,3619,4217,1999,6216,2021-07-15
3171061004,JAKARTA PUSAT,MENTENG,GONDANGDIA,4093,2053,2040,1307,3347,2021-07-15
3173021001,JAKARTA BARAT,GROGOL PETAMBURAN,GROGOL,16815,10032,6783,2645,9428,2021-07-15
3174051005,JAKARTA SELATAN,KEBAYORAN LAMA,GROGOL SELATAN,43915,29051,14864,5544,20408,2021-07-15
3174051004,JAKARTA SELATAN,KEBAYORAN LAMA,GROGOL UTARA,42216,27216,15000,5931,20931,2021-07-15
3174021007,JAKARTA SELATAN,SETIA BUDI,GUNTUR,3962,2045,1917,1004,2921,2021-07-15
3174071002,JAKARTA SELATAN,KEBAYORAN BARU,GUNUNG,9344,5150,4194,2064,6258,2021-07-15
3171031005,JAKARTA PUSAT,KEMAYORAN,GUNUNG SAHARI SELATAN,19380,11717,7663,2853,10516,2021-07-15
3171021004,JAKARTA PUSAT,SAWAH BESAR,GUNUNG SAHARI UTARA,15647,7956,7691,3418,11109,2021-07-15
3175081004,JAKARTA TIMUR,MAKASAR,HALIM PERDANA KUSUMAH,28110,13179,14931,9401,24332,2021-07-15
3171031003,JAKARTA PUSAT,KEMAYORAN,HARAPAN MULIA,22700,14699,8001,2734,10735,2021-07-15
3174091001,JAKARTA SELATAN,JAGAKARSA,JAGAKARSA,61552,36057,25495,8664,34159,2021-07-15
3175021007,JAKARTA TIMUR,PULO GADUNG,JATI,32443,19894,12549,5712,18261,2021-07-15
3174041002,JAKARTA SELATAN,PASAR MINGGU,JATI PADANG,37250,22537,14713,5939,20652,2021-07-15
3173071004,JAKARTA BARAT,PALMERAH,JATI PULO,27994,16036,11958,3704,15662,2021-07-15
3175061001,JAKARTA TIMUR,CAKUNG,JATINEGARA,83563,59112,24451,6893,31344,2021-07-15
3175021004,JAKARTA TIMUR,PULO GADUNG,JATINEGARA KAUM,24364,15878,8486,2973,11459,2021-07-15
3173021004,JAKARTA BARAT,GROGOL PETAMBURAN,JELAMBAR,30180,17142,13038,5530,18568,2021-07-15
3173021006,JAKARTA BARAT,GROGOL PETAMBURAN,JELAMBAR BARU,37799,22001,15798,6144,21942,2021-07-15
3173041006,JAKARTA BARAT,TAMBORA,JEMBATAN BESI,29182,21308,7874,2456,10330,2021-07-15
3173041008,JAKARTA BARAT,TAMBORA,JEMBATAN LIMA,20627,13698,6929,2306,9235,2021-07-15
3173081005,JAKARTA BARAT,KEMBANGAN,JOGLO,40475,25454,15021,6021,21042,2021-07-15
3171081001,JAKARTA PUSAT,JOHAR BARU,JOHAR BARU,32845,17723,15122,5397,20519,2021-07-15
3173041002,JAKARTA BARAT,TAMBORA,KALI ANYAR,23582,16475,7107,2270,9377,2021-07-15
3172041004,JAKARTA UTARA,CILINCING,KALIBARU,67165,46867,20298,4415,24713,2021-07-15
3174081002,JAKARTA SELATAN,PANCORAN,KALIBATA,41464,27218,14246,5010,19256,2021-07-15
3173061001,JAKARTA BARAT,KALI DERES,KALIDERES,69014,43895,25119,7682,32801,2021-07-15
3175051004,JAKARTA TIMUR,PASAR REBO,KALISARI,42557,25957,16600,6930,23530,2021-07-15
3173061004,JAKARTA BARAT,KALI DERES,KAMAL,53180,38327,14853,3690,18543,2021-07-15
3172011002,JAKARTA UTARA,PENJARINGAN,KAMAL MUARA,12679,6231,6448,2544,8992,2021-07-15
3171071007,JAKARTA PUSAT,TANAH ABANG,KAMPUNG BALI,11551,7629,3922,1529,5451,2021-07-15
3175031001,JAKARTA TIMUR,JATINEGARA,KAMPUNG MELAYU,25476,18087,7389,2270,9659,2021-07-15
3171081002,JAKARTA PUSAT,JOHAR BARU,KAMPUNG RAWA,18247,8722,9525,2567,12092,2021-07-15
3175041002,JAKARTA TIMUR,KRAMAT JATI,KAMPUNG TENGAH,43668,30463,13205,5348,18553,2021-07-15
3173011005,JAKARTA BARAT,CENGKARENG,KAPUK,121994,81733,40261,9593,49854,2021-07-15
3172011003,JAKARTA UTARA,PENJARINGAN,KAPUK MUARA,35498,19623,15875,6767,22642,2021-07-15
3171021002,JAKARTA PUSAT,SAWAH BESAR,KARANG ANYAR,25865,15842,10023,3436,13459,2021-07-15
3174021004,JAKARTA SELATAN,SETIA BUDI,KARET,9581,5581,4000,1460,5460,2021-07-15
3174021003,JAKARTA SELATAN,SETIA BUDI,KARET KUNINGAN,15939,8895,7044,2362,9406,2021-07-15
3174021002,JAKARTA SELATAN,SETIA BUDI,KARET SEMANGGI,2746,1350,1396,605,2001,2021-07-15
3171071003,JAKARTA PUSAT,TANAH ABANG,KARET TENGSIN,19113,12101,7012,2249,9261,2021-07-15
3171021003,JAKARTA PUSAT,SAWAH BESAR,KARTINI,22303,13002,9301,3492,12793,2021-07-15
3175011003,JAKARTA TIMUR,MATRAMAN,KAYU MANIS,25138,16565,8573,3052,11625,2021-07-15
3175021006,JAKARTA TIMUR,PULO GADUNG,KAYU PUTIH,40378,23096,17282,7200,24482,2021-07-15
3173031006,JAKARTA BARAT,TAMAN SARI,KEAGUNGAN,17231,10245,6986,2021,9007,2021-07-15
3174041007,JAKARTA SELATAN,PASAR MINGGU,KEBAGUSAN,44010,28306,15704,5275,20979,2021-07-15
3174051006,JAKARTA SELATAN,KEBAYORAN LAMA,KEBAYORAN LAMA SELATAN,40895,24324,16571,5878,22449,2021-07-15
3174051001,JAKARTA SELATAN,KEBAYORAN LAMA,KEBAYORAN LAMA UTARA,42214,27415,14799,5334,20133,2021-07-15
3174011004,JAKARTA SELATAN,TEBET,KEBON BARU,34878,21487,13391,5196,18587,2021-07-15
3172021005,JAKARTA UTARA,TANJUNG PRIOK,KEBON BAWANG,50597,30576,20021,7048,27069,2021-07-15
3173051001,JAKARTA BARAT,KEBON JERUK,KEBON JERUK,53296,35238,18058,6867,24925,2021-07-15
3171071006,JAKARTA PUSAT,TANAH ABANG,KEBON KACANG,21376,14828,6548,2655,9203,2021-07-15
3171011005,JAKARTA PUSAT,GAMBIR,KEBON KELAPA,10380,6416,3964,1674,5638,2021-07-15
3171031002,JAKARTA PUSAT,KEMAYORAN,KEBON KOSONG,30003,18897,11106,3527,14633,2021-07-15
3175011005,JAKARTA TIMUR,MATRAMAN,KEBON MANGGIS,16393,9803,6590,2813,9403,2021-07-15
3171071005,JAKARTA PUSAT,TANAH ABANG,KEBON MELATI,31355,23284,8071,2898,10969,2021-07-15
3175081003,JAKARTA TIMUR,MAKASAR,KEBON PALA,46176,29891,16285,6378,22663,2021-07-15
3171061005,JAKARTA PUSAT,MENTENG,KEBON SIRIH,12256,8419,3837,1562,5399,2021-07-15
3173011004,JAKARTA BARAT,CENGKARENG,KEDAUNG KALI ANGKE,32185,17769,14416,3253,17669,2021-07-15
3173051007,JAKARTA BARAT,KEBON JERUK,KEDOYA SELATAN,31907,19287,12620,4668,17288,2021-07-15
3173051006,JAKARTA BARAT,KEBON JERUK,KEDOYA UTARA,43826,24851,18975,7063,26038,2021-07-15
3173051004,JAKARTA BARAT,KEBON JERUK,KELAPA DUA,23293,14800,8493,3168,11661,2021-07-15
3175091003,JAKARTA TIMUR,CIRACAS,KELAPA DUA WETAN,46441,28262,18179,7408,25587,2021-07-15
3172061003,JAKARTA UTARA,KELAPA GADING,KELAPA GADING BARAT,35403,17624,17779,8955,26734,2021-07-15
3172061001,JAKARTA UTARA,KELAPA GADING,KELAPA GADING TIMUR,33472,15121,18351,9249,27600,2021-07-15
3173071005,JAKARTA BARAT,PALMERAH,KEMANGGISAN,31952,19349,12603,5278,17881,2021-07-15
3171031001,JAKARTA PUSAT,KEMAYORAN,KEMAYORAN,20947,12273,8674,2860,11534,2021-07-15
3173081006,JAKARTA BARAT,KEMBANGAN,KEMBANGAN SELATAN,26920,15894,11026,5082,16108,2021-07-15
3173081001,JAKARTA BARAT,KEMBANGAN,KEMBANGAN UTARA,52368,31660,20708,6703,27411,2021-07-15
3171041002,JAKARTA PUSAT,SENEN,KENARI,9317,5235,4082,1760,5842,2021-07-15
3173041005,JAKARTA BARAT,TAMBORA,KERENDANG,19869,12719,7150,2246,9396,2021-07-15
3175071003,JAKARTA TIMUR,DUREN SAWIT,KLENDER,69321,48506,20815,7539,28354,2021-07-15
3172031001,JAKARTA UTARA,KOJA,KOJA,28036,17176,10860,2787,13647,2021-07-15
3173071006,JAKARTA BARAT,PALMERAH,KOTA BAMBU SELATAN,20926,13313,7613,2265,9878,2021-07-15
3173071003,JAKARTA BARAT,PALMERAH,KOTA BAMBU UTARA,24416,15775,8641,2800,11441,2021-07-15
3171041004,JAKARTA PUSAT,SENEN,KRAMAT,28661,19330,9331,3027,12358,2021-07-15
3175041001,JAKARTA TIMUR,KRAMAT JATI,KRAMAT JATI,33851,21820,12031,5132,17163,2021-07-15
3174071003,JAKARTA SELATAN,KEBAYORAN BARU,KRAMAT PELA,14340,8041,6299,2391,8690,2021-07-15
3173031002,JAKARTA BARAT,TAMAN SARI,KRUKUT,19130,11504,7626,2313,9939,2021-07-15
3174031005,JAKARTA SELATAN,MAMPANG PRAPATAN,KUNINGAN BARAT,12675,7459,5216,1558,6774,2021-07-15
3174021008,JAKARTA SELATAN,SETIA BUDI,KUNINGAN TIMUR,5982,3575,2407,1073,3480,2021-07-15
3171041005,JAKARTA PUSAT,SENEN,KWITANG,15295,9359,5936,2116,8052,2021-07-15
3172031003,JAKARTA UTARA,KOJA,LAGOA,58726,38833,19893,5737,25630,2021-07-15
3174061002,JAKARTA SELATAN,CILANDAK,LEBAK BULUS,37213,22510,14703,6004,20707,2021-07-15
3174091004,JAKARTA SELATAN,JAGAKARSA,LENTENG AGUNG,53453,35620,17833,6240,24073,2021-07-15
3175101007,JAKARTA TIMUR,CIPAYUNG,LUBANG BUAYA,62984,38874,24110,8490,32600,2021-07-15
3175081001,JAKARTA TIMUR,MAKASAR,MAKASAR,34062,20634,13428,5025,18453,2021-07-15
3175071006,JAKARTA TIMUR,DUREN SAWIT,MALAKA JAYA,30744,18313,12431,5557,17988,2021-07-15
3175071005,JAKARTA TIMUR,DUREN SAWIT,MALAKA SARI,27015,15601,11414,5496,16910,2021-07-15
3174031001,JAKARTA SELATAN,MAMPANG PRAPATAN,MAMPANG PRAPATAN,18046,11290,6756,2073,8829,2021-07-15
3173031005,JAKARTA BARAT,TAMAN SARI,MANGGA BESAR,7439,3751,3688,1464,5152,2021-07-15
3171021005,JAKARTA PUSAT,SAWAH BESAR,MANGGA DUA SELATAN,27767,16831,10936,3885,14821,2021-07-15
3174011007,JAKARTA SELATAN,TEBET,MANGGARAI,28388,17973,10415,3596,14011,2021-07-15
3174011006,JAKARTA SELATAN,TEBET,MANGGARAI SELATAN,22902,13301,9601,3247,12848,2021-07-15
3173031003,JAKARTA BARAT,TAMAN SARI,MAPHAR,16385,9337,7048,2596,9644,2021-07-15
3172041003,JAKARTA UTARA,CILINCING,MARUNDA,28614,17047,11567,2595,14162,2021-07-15
3174071001,JAKARTA SELATAN,KEBAYORAN BARU,MELAWAI,2634,1249,1385,846,2231,2021-07-15
3171061001,JAKARTA PUSAT,MENTENG,MENTENG,25280,17347,7933,3580,11513,2021-07-15
3174021005,JAKARTA SELATAN,SETIA BUDI,MENTENG ATAS,27671,16151,11520,4086,15606,2021-07-15
3174011003,JAKARTA SELATAN,TEBET,MENTENG DALAM,35936,22475,13461,5267,18728,2021-07-15
3173081003,JAKARTA BARAT,KEMBANGAN,MERUYA SELATAN,31227,19282,11945,4365,16310,2021-07-15
3173081002,JAKARTA BARAT,KEMBANGAN,MERUYA UTARA,43382,26701,16681,7048,23729,2021-07-15
3175101004,JAKARTA TIMUR,CIPAYUNG,MUNJUL,23570,14885,8685,3644,12329,2021-07-15
3172051002,JAKARTA UTARA,PADEMANGAN,PADEMANGAN BARAT,73841,47482,26359,7884,34243,2021-07-15
3172051001,JAKARTA UTARA,PADEMANGAN,PADEMANGAN TIMUR,36757,19257,17500,6958,24458,2021-07-15
3175011004,JAKARTA TIMUR,MATRAMAN,PAL MERIAM,19632,12316,7316,2752,10068,2021-07-15
3173071001,JAKARTA BARAT,PALMERAH,PALMERAH,62175,38810,23365,8089,31454,2021-07-15
3174081001,JAKARTA SELATAN,PANCORAN,PANCORAN,19301,11644,7657,2680,10337,2021-07-15
3172021003,JAKARTA UTARA,TANJUNG PRIOK,PAPANGGO,38871,23405,15466,4805,20271,2021-07-15
3171021001,JAKARTA PUSAT,SAWAH BESAR,PASAR BARU,12710,6432,6278,2937,9215,2021-07-15
3174021006,JAKARTA SELATAN,SETIA BUDI,PASAR MANGGIS,26572,15910,10662,3584,14246,2021-07-15
3174041001,JAKARTA SELATAN,PASAR MINGGU,PASAR MINGGU,24670,15202,9468,4633,14101,2021-07-15
3171041003,JAKARTA PUSAT,SENEN,PASEBAN,23321,14438,8883,3337,12220,2021-07-15
3173061005,JAKARTA BARAT,KALI DERES,PEGADUNGAN,74685,46373,28312,9221,37533,2021-07-15
3171061002,JAKARTA PUSAT,MENTENG,PEGANGSAAN,21120,13731,7389,2985,10374,2021-07-15
3172061002,JAKARTA UTARA,KELAPA GADING,PEGANGSAAN DUA,49632,24115,25517,10628,36145,2021-07-15
3172011004,JAKARTA UTARA,PENJARINGAN,PEJAGALAN,74043,42965,31078,11024,42102,2021-07-15
3174041006,JAKARTA SELATAN,PASAR MINGGU,PEJATEN BARAT,35061,20667,14394,5703,20097,2021-07-15
3174041005,JAKARTA SELATAN,PASAR MINGGU,PEJATEN TIMUR,57257,37914,19343,6256,25599,2021-07-15
3175051005,JAKARTA TIMUR,PASAR REBO,PEKAYON,42705,26130,16575,6212,22787,2021-07-15
3173041009,JAKARTA BARAT,TAMBORA,PEKOJAN,23428,13683,9745,3451,13196,2021-07-15
3174031003,JAKARTA SELATAN,MAMPANG PRAPATAN,PELA MAMPANG,42709,25469,17240,5707,22947,2021-07-15
3174081005,JAKARTA SELATAN,PANCORAN,PENGADEGAN,21111,11214,9897,3375,13272,2021-07-15
3175061003,JAKARTA TIMUR,CAKUNG,PENGGILINGAN,97138,69646,27492,9469,36961,2021-07-15
3172011001,JAKARTA UTARA,PENJARINGAN,PENJARINGAN,86712,57255,29457,7916,37373,2021-07-15
3174101001,JAKARTA SELATAN,PESANGGRAHAN,PESANGGRAHAN,27215,15490,11725,4922,16647,2021-07-15
3171071004,JAKARTA PUSAT,TANAH ABANG,PETAMBURAN,33060,24379,8681,2973,11654,2021-07-15
3174071008,JAKARTA SELATAN,KEBAYORAN BARU,PETOGOGAN,11418,6670,4748,1930,6678,2021-07-15
3171011004,JAKARTA PUSAT,GAMBIR,PETOJO SELATAN,14946,8795,6151,3023,9174,2021-07-15
3171011003,JAKARTA PUSAT,GAMBIR,PETOJO UTARA,17843,11196,6647,2732,9379,2021-07-15
3174101004,JAKARTA SELATAN,PESANGGRAHAN,PETUKANGAN SELATAN,36769,21782,14987,4969,19956,2021-07-15
3174101003,JAKARTA SELATAN,PESANGGRAHAN,PETUKANGAN UTARA,53184,33442,19742,6810,26552,2021-07-15
3175081002,JAKARTA TIMUR,MAKASAR,PINANG RANTI,26915,16534,10381,3530,13911,2021-07-15
3173031008,JAKARTA BARAT,TAMAN SARI,PINANGSIA,10583,5580,5003,1647,6650,2021-07-15
3175011001,JAKARTA TIMUR,MATRAMAN,PISANGAN BARU,31537,21645,9892,3859,13751,2021-07-15
3175021002,JAKARTA TIMUR,PULO GADUNG,PISANGAN TIMUR,40576,25237,15339,5749,21088,2021-07-15
3172011005,JAKARTA UTARA,PENJARINGAN,PLUIT,47433,24578,22855,12442,35297,2021-07-15
3175071002,JAKARTA TIMUR,DUREN SAWIT,PONDOK BAMBU,61047,38765,22282,9062,31344,2021-07-15
3175071004,JAKARTA TIMUR,DUREN SAWIT,PONDOK KELAPA,71347,43393,27954,11165,39119,2021-07-15
3175071007,JAKARTA TIMUR,DUREN SAWIT,PONDOK KOPI,35051,23935,11116,4411,15527,2021-07-15
3174061003,JAKARTA SELATAN,CILANDAK,PONDOK LABU,45944,26726,19218,6983,26201,2021-07-15
3174051002,JAKARTA SELATAN,KEBAYORAN LAMA,PONDOK PINANG,55724,34479,21245,9765,31010,2021-07-15
3175101003,JAKARTA TIMUR,CIPAYUNG,PONDOK RANGGON,25123,16255,8868,3836,12704,2021-07-15
3101011003,KAB.ADM.KEP.SERIBU,KEP. SERIBU UTARA,PULAU HARAPAN,2036,718,1318,670,1988,2021-07-15
3101011002,KAB.ADM.KEP.SERIBU,KEP. SERIBU UTARA,PULAU KELAPA,5460,1939,3521,1087,4608,2021-07-15
3101011001,KAB.ADM.KEP.SERIBU,KEP. SERIBU UTARA,PULAU PANGGANG,5395,1815,3580,1154,4734,2021-07-15
3101021003,KAB.ADM.KEP.SERIBU,KEP. SERIBU SELATAN,PULAU PARI,2736,775,1961,614,2575,2021-07-15
3101021002,KAB.ADM.KEP.SERIBU,KEP. SERIBU SELATAN,PULAU TIDUNG,4528,1553,2975,1133,4108,2021-07-15
3101021001,KAB.ADM.KEP.SERIBU,KEP. SERIBU SELATAN,PULAU UNTUNG JAWA,1918,666,1252,559,1811,2021-07-15
3174071007,JAKARTA SELATAN,KEBAYORAN BARU,PULO,5777,2926,2851,1364,4215,2021-07-15
3175021001,JAKARTA TIMUR,PULO GADUNG,PULO GADUNG,34175,22057,12118,4727,16845,2021-07-15
3175061005,JAKARTA TIMUR,CAKUNG,PULO GEBANG,95947,64902,31045,10825,41870,2021-07-15
3174041004,JAKARTA SELATAN,PASAR MINGGU,RAGUNAN,39233,22587,16646,5895,22541,2021-07-15
3175091005,JAKARTA TIMUR,CIRACAS,RAMBUTAN,36368,25518,10850,4356,15206,2021-07-15
3172031006,JAKARTA UTARA,KOJA,RAWA BADAK SELATAN,41895,28203,13692,3989,17681,2021-07-15
3172031004,JAKARTA UTARA,KOJA,RAWA BADAK UTARA,33538,20699,12839,3913,16752,2021-07-15
3174071005,JAKARTA SELATAN,KEBAYORAN BARU,RAWA BARAT,5574,3030,2544,1356,3900,2021-07-15
3173011003,JAKARTA BARAT,CENGKARENG,RAWA BUAYA,59533,37796,21737,6053,27790,2021-07-15
3175031004,JAKARTA TIMUR,JATINEGARA,RAWA BUNGA,21272,14482,6790,2502,9292,2021-07-15
3174081003,JAKARTA SELATAN,PANCORAN,RAWA JATI,20321,11590,8731,3472,12203,2021-07-15
3175061002,JAKARTA TIMUR,CAKUNG,RAWA TERATE,24433,14618,9815,2151,11966,2021-07-15
3175021005,JAKARTA TIMUR,PULO GADUNG,RAWAMANGUN,36788,22756,14032,5942,19974,2021-07-15
3171051003,JAKARTA PUSAT,CEMPAKA PUTIH,RAWASARI,21770,13108,8662,3535,12197,2021-07-15
3173041010,JAKARTA BARAT,TAMBORA,ROA MALAKA,3449,1635,1814,895,2709,2021-07-15
3172041006,JAKARTA UTARA,CILINCING,ROROTAN,40953,24721,16232,4649,20881,2021-07-15
3174071004,JAKARTA SELATAN,KEBAYORAN BARU,SELONG,2843,1385,1458,891,2349,2021-07-15
3173061002,JAKARTA BARAT,KALI DERES,SEMANAN,70293,49116,21177,5052,26229,2021-07-15
3172041007,JAKARTA UTARA,CILINCING,SEMPER BARAT,67899,39224,28675,9172,37847,2021-07-15
3172041005,JAKARTA UTARA,CILINCING,SEMPER TIMUR,36029,21952,14077,4364,18441,2021-07-15
3174071006,JAKARTA SELATAN,KEBAYORAN BARU,SENAYAN,2780,1690,1090,579,1669,2021-07-15
3171041001,JAKARTA PUSAT,SENEN,SENEN,6757,3930,2827,1194,4021,2021-07-15
3171031004,JAKARTA PUSAT,KEMAYORAN,SERDANG,29730,18361,11369,3979,15348,2021-07-15
3174021001,JAKARTA SELATAN,SETIA BUDI,SETIA BUDI,2841,1595,1246,654,1900,2021-07-15
3175101005,JAKARTA TIMUR,CIPAYUNG,SETU,20306,13942,6364,2717,9081,2021-07-15
3173071002,JAKARTA BARAT,PALMERAH,SLIPI,16475,9581,6894,2751,9645,2021-07-15
3173081004,JAKARTA BARAT,KEMBANGAN,SRENGSENG,44969,29541,15428,6265,21693,2021-07-15
3174091002,JAKARTA SELATAN,JAGAKARSA,SRENGSENG SAWAH,57480,32056,25424,9011,34435,2021-07-15
3173051003,JAKARTA BARAT,KEBON JERUK,SUKABUMI SELATAN,35170,23729,11441,3525,14966,2021-07-15
3173051002,JAKARTA BARAT,KEBON JERUK,SUKABUMI UTARA,37628,26135,11493,4058,15551,2021-07-15
3172041002,JAKARTA UTARA,CILINCING,SUKAPURA,53786,33474,20312,5508,25820,2021-07-15
3171031007,JAKARTA PUSAT,KEMAYORAN,SUMUR BATU,22506,13494,9012,3448,12460,2021-07-15
3172021004,JAKARTA UTARA,TANJUNG PRIOK,SUNGAI BAMBU,29115,17407,11708,3609,15317,2021-07-15
3172021006,JAKARTA UTARA,TANJUNG PRIOK,SUNTER AGUNG,70860,37509,33351,13708,47059,2021-07-15
3172021002,JAKARTA UTARA,TANJUNG PRIOK,SUNTER JAYA,62516,35806,26710,10582,37292,2021-07-15
3175091004,JAKARTA TIMUR,CIRACAS,SUSUKAN,33525,20384,13141,4672,17813,2021-07-15
3173031001,JAKARTA BARAT,TAMAN SARI,TAMAN SARI,14281,8102,6179,2417,8596,2021-07-15
3173041001,JAKARTA BARAT,TAMBORA,TAMBORA,10177,6363,3814,1527,5341,2021-07-15
3173041004,JAKARTA BARAT,TAMBORA,TANAH SEREAL,25944,14258,11686,3932,15618,2021-07-15
3171081004,JAKARTA PUSAT,JOHAR BARU,TANAH TINGGI,37800,22070,15730,4296,20026,2021-07-15
3173031004,JAKARTA BARAT,TAMAN SARI,TANGKI,12991,7415,5576,1944,7520,2021-07-15
3174091005,JAKARTA SELATAN,JAGAKARSA,TANJUNG BARAT,39368,25423,13945,5773,19718,2021-07-15
3173021005,JAKARTA BARAT,GROGOL PETAMBURAN,TANJUNG DUREN SELATAN,24917,13302,11615,4533,16148,2021-07-15
3173021002,JAKARTA BARAT,GROGOL PETAMBURAN,TANJUNG DUREN UTARA,16940,8501,8439,3564,12003,2021-07-15
3172021001,JAKARTA UTARA,TANJUNG PRIOK,TANJUNG PRIOK,34316,20168,14148,3873,18021,2021-07-15
3174011002,JAKARTA SELATAN,TEBET,TEBET BARAT,21164,11686,9478,4256,13734,2021-07-15
3174011001,JAKARTA SELATAN,TEBET,TEBET TIMUR,18030,9488,8542,3828,12370,2021-07-15
3173061003,JAKARTA BARAT,KALI DERES,TEGAL ALUR,82647,54686,27961,6925,34886,2021-07-15
3174031004,JAKARTA SELATAN,MAMPANG PRAPATAN,TEGAL PARANG,32174,21673,10501,3361,13862,2021-07-15
3173021003,JAKARTA BARAT,GROGOL PETAMBURAN,TOMANG,28665,15950,12715,5037,17752,2021-07-15
3172031005,JAKARTA UTARA,KOJA,TUGU SELATAN,38749,25724,13025,3872,16897,2021-07-15
3172031002,JAKARTA UTARA,KOJA,TUGU UTARA,67211,44093,23118,6837,29955,2021-07-15
3175061006,JAKARTA TIMUR,CAKUNG,UJUNG MENTENG,29527,18061,11466,4027,15493,2021-07-15
3174101005,JAKARTA SELATAN,PESANGGRAHAN,ULUJAMI,40120,26509,13611,4981,18592,2021-07-15
3175011006,JAKARTA TIMUR,MATRAMAN,UTAN KAYU SELATAN,33233,20040,13193,5127,18320,2021-07-15
3175011002,JAKARTA TIMUR,MATRAMAN,UTAN KAYU UTARA,27995,17249,10746,3868,14614,2021-07-15
3171031008,JAKARTA PUSAT,KEMAYORAN,UTAN PANJANG,29260,19808,9452,2840,12292,2021-07-15
3172021007,JAKARTA UTARA,TANJUNG PRIOK,WARAKAS,43754,26565,17189,5289,22478,2021-07-15
3173021007,JAKARTA BARAT,GROGOL PETAMBURAN,WIJAYA KUSUMA,38584,24304,14280,4915,19195,2021-07-15
3172051003,JAKARTA UTARA,PADEMANGAN,ANCOL,23379,14772,8607,3337,11944,2021-07-16
3173041007,JAKARTA BARAT,TAMBORA,ANGKE,29230,17314,11916,3273,15189,2021-07-16
3175041005,JAKARTA TIMUR,KRAMAT JATI,BALE KAMBANG,28803,20714,8089,2724,10813,2021-07-16
3175031003,JAKARTA TIMUR,JATINEGARA,BALI MESTER,9675,6058,3617,1550,5167,2021-07-16
3175101006,JAKARTA TIMUR,CIPAYUNG,BAMBU APUS,25985,16710,9275,4049,13324,2021-07-16
3174031002,JAKARTA SELATAN,MAMPANG PRAPATAN,BANGKA,21356,12959,8397,2772,11169,2021-07-16
3175051002,JAKARTA TIMUR,PASAR REBO,BARU,23514,12736,10778,4820,15598,2021-07-16
3175041004,JAKARTA TIMUR,KRAMAT JATI,BATU AMPAR,47416,33373,14043,5414,19457,2021-07-16
3171071002,JAKARTA PUSAT,TANAH ABANG,BENDUNGAN HILIR,21374,12265,9109,3653,12762,2021-07-16
3175031002,JAKARTA TIMUR,JATINEGARA,BIDARA CINA,36461,25101,11360,4126,15486,2021-07-16
3174101002,JAKARTA SELATAN,PESANGGRAHAN,BINTARO,52402,32565,19837,7240,27077,2021-07-16
3174011005,JAKARTA SELATAN,TEBET,BUKIT DURI,33953,21701,12252,4039,16291,2021-07-16
3171041006,JAKARTA PUSAT,SENEN,BUNGUR,17929,10619,7310,2807,10117,2021-07-16
3175061007,JAKARTA TIMUR,CAKUNG,CAKUNG BARAT,57222,35595,21627,4107,25734,2021-07-16
3175061004,JAKARTA TIMUR,CAKUNG,CAKUNG TIMUR,57655,35714,21941,6504,28445,2021-07-16
3175041007,JAKARTA TIMUR,KRAMAT JATI,CAWANG,32481,20956,11525,4405,15930,2021-07-16
3175101008,JAKARTA TIMUR,CIPAYUNG,CEGER,18740,11766,6974,2623,9597,2021-07-16
3171031006,JAKARTA PUSAT,KEMAYORAN,CEMPAKA BARU,31257,20075,11182,4103,15285,2021-07-16
3171051002,JAKARTA PUSAT,CEMPAKA PUTIH,CEMPAKA PUTIH BARAT,34725,21822,12903,5063,17966,2021-07-16
3171051001,JAKARTA PUSAT,CEMPAKA PUTIH,CEMPAKA PUTIH TIMUR,24170,14220,9950,4550,14500,2021-07-16
3173011001,JAKARTA BARAT,CENGKARENG,CENGKARENG BARAT,65702,37694,28008,8346,36354,2021-07-16
3173011006,JAKARTA BARAT,CENGKARENG,CENGKARENG TIMUR,80100,49499,30601,8617,39218,2021-07-16
3175091002,JAKARTA TIMUR,CIRACAS,CIBUBUR,65231,38327,26904,9753,36657,2021-07-16
3171011002,JAKARTA PUSAT,GAMBIR,CIDENG,15696,8550,7146,3247,10393,2021-07-16
3174091003,JAKARTA SELATAN,JAGAKARSA,CIGANJUR,38048,23278,14770,5276,20046,2021-07-16
3175051003,JAKARTA TIMUR,PASAR REBO,CIJANTUNG,41013,24607,16406,6355,22761,2021-07-16
3171061003,JAKARTA PUSAT,MENTENG,CIKINI,8260,5231,3029,1396,4425,2021-07-16
3174081006,JAKARTA SELATAN,PANCORAN,CIKOKO,10503,5728,4775,1790,6565,2021-07-16
3174061001,JAKARTA SELATAN,CILANDAK,CILANDAK BARAT,51346,28703,22643,8045,30688,2021-07-16
3174041003,JAKARTA SELATAN,PASAR MINGGU,CILANDAK TIMUR,24239,13699,10540,4947,15487,2021-07-16
3175101002,JAKARTA TIMUR,CIPAYUNG,CILANGKAP,27179,16922,10257,3890,14147,2021-07-16
3175041006,JAKARTA TIMUR,KRAMAT JATI,CILILITAN,39984,26779,13205,5404,18609,2021-07-16
3172041001,JAKARTA UTARA,CILINCING,CILINCING,42677,27646,15031,4008,19039,2021-07-16
3175101001,JAKARTA TIMUR,CIPAYUNG,CIPAYUNG,25747,14822,10925,4318,15243,2021-07-16
3174091006,JAKARTA SELATAN,JAGAKARSA,CIPEDAK,37809,22217,15592,4914,20506,2021-07-16
3174061005,JAKARTA SELATAN,CILANDAK,CIPETE SELATAN,26500,15712,10788,3894,14682,2021-07-16
3174071010,JAKARTA SELATAN,KEBAYORAN BARU,CIPETE UTARA,33902,19764,14138,4191,18329,2021-07-16
3175021003,JAKARTA TIMUR,PULO GADUNG,CIPINANG,39069,24159,14910,6209,21119,2021-07-16
3175031007,JAKARTA TIMUR,JATINEGARA,CIPINANG BESAR SELATAN,34938,24404,10534,3984,14518,2021-07-16
3175031008,JAKARTA TIMUR,JATINEGARA,CIPINANG BESAR UTARA,44479,31541,12938,4268,17206,2021-07-16
3175031005,JAKARTA TIMUR,JATINEGARA,CIPINANG CEMPEDAK,32695,21216,11479,4785,16264,2021-07-16
3175081005,JAKARTA TIMUR,MAKASAR,CIPINANG MELAYU,42144,25627,16517,6529,23046,2021-07-16
3175031006,JAKARTA TIMUR,JATINEGARA,CIPINANG MUARA,53251,35784,17467,7452,24919,2021-07-16
3174051003,JAKARTA SELATAN,KEBAYORAN LAMA,CIPULIR,39635,25739,13896,4861,18757,2021-07-16
3175091001,JAKARTA TIMUR,CIRACAS,CIRACAS,63801,38905,24896,8643,33539,2021-07-16
3175041003,JAKARTA TIMUR,KRAMAT JATI,DUKUH,24404,15762,8642,3591,12233,2021-07-16
3175071001,JAKARTA TIMUR,DUREN SAWIT,DUREN SAWIT,60443,38680,21763,9462,31225,2021-07-16
3174081004,JAKARTA SELATAN,PANCORAN,DUREN TIGA,28099,16541,11558,3918,15476,2021-07-16
3173051005,JAKARTA BARAT,KEBON JERUK,DURI KEPA,59448,33190,26258,10184,36442,2021-07-16
3173011002,JAKARTA BARAT,CENGKARENG,DURI KOSAMBI,75895,47076,28819,8332,37151,2021-07-16
3171011006,JAKARTA PUSAT,GAMBIR,DURI PULO,19986,13069,6917,2427,9344,2021-07-16
3173041011,JAKARTA BARAT,TAMBORA,DURI SELATAN,14099,8151,5948,2393,8341,2021-07-16
3173041003,JAKARTA BARAT,TAMBORA,DURI UTARA,19768,11902,7866,2679,10545,2021-07-16
3171081003,JAKARTA PUSAT,JOHAR BARU,GALUR,18098,10119,7979,2006,9985,2021-07-16
3171011001,JAKARTA PUSAT,GAMBIR,GAMBIR,2434,1310,1124,584,1708,2021-07-16
3174061004,JAKARTA SELATAN,CILANDAK,GANDARIA SELATAN,21926,13103,8823,2887,11710,2021-07-16
3174071009,JAKARTA SELATAN,KEBAYORAN BARU,GANDARIA UTARA,39609,23629,15980,5454,21434,2021-07-16
3175051001,JAKARTA TIMUR,PASAR REBO,GEDONG,35444,22164,13280,5408,18688,2021-07-16
3171071001,JAKARTA PUSAT,TANAH ABANG,GELORA,3106,1852,1254,583,1837,2021-07-16
3173031007,JAKARTA BARAT,TAMAN SARI,GLODOK,7836,3595,4241,2004,6245,2021-07-16
3171061004,JAKARTA PUSAT,MENTENG,GONDANGDIA,4093,2036,2057,1308,3365,2021-07-16
3173021001,JAKARTA BARAT,GROGOL PETAMBURAN,GROGOL,16815,9930,6885,2651,9536,2021-07-16
3174051005,JAKARTA SELATAN,KEBAYORAN LAMA,GROGOL SELATAN,43915,28803,15112,5558,20670,2021-07-16
3174051004,JAKARTA SELATAN,KEBAYORAN LAMA,GROGOL UTARA,42216,26909,15307,5954,21261,2021-07-16
3174021007,JAKARTA SELATAN,SETIA BUDI,GUNTUR,3962,2015,1947,1004,2951,2021-07-16
3174071002,JAKARTA SELATAN,KEBAYORAN BARU,GUNUNG,9344,5111,4233,2073,6306,2021-07-16
3171031005,JAKARTA PUSAT,KEMAYORAN,GUNUNG SAHARI SELATAN,19380,11610,7770,2856,10626,2021-07-16
3171021004,JAKARTA PUSAT,SAWAH BESAR,GUNUNG SAHARI UTARA,15647,7884,7763,3428,11191,2021-07-16
3175081004,JAKARTA TIMUR,MAKASAR,HALIM PERDANA KUSUMAH,28110,13061,15049,9418,24467,2021-07-16
3171031003,JAKARTA PUSAT,KEMAYORAN,HARAPAN MULIA,22700,14571,8129,2742,10871,2021-07-16
3174091001,JAKARTA SELATAN,JAGAKARSA,JAGAKARSA,61552,35622,25930,8684,34614,2021-07-16
3175021007,JAKARTA TIMUR,PULO GADUNG,JATI,32443,19731,12712,5729,18441,2021-07-16
3174041002,JAKARTA SELATAN,PASAR MINGGU,JATI PADANG,37250,22294,14956,5949,20905,2021-07-16
3173071004,JAKARTA BARAT,PALMERAH,JATI PULO,27994,15824,12170,3713,15883,2021-07-16
3175061001,JAKARTA TIMUR,CAKUNG,JATINEGARA,83563,58190,25373,6906,32279,2021-07-16
3175021004,JAKARTA TIMUR,PULO GADUNG,JATINEGARA KAUM,24364,15675,8689,2983,11672,2021-07-16
3173021004,JAKARTA BARAT,GROGOL PETAMBURAN,JELAMBAR,30180,16969,13211,5544,18755,2021-07-16
3173021006,JAKARTA BARAT,GROGOL PETAMBURAN,JELAMBAR BARU,37799,21748,16051,6154,22205,2021-07-16
3173041006,JAKARTA BARAT,TAMBORA,JEMBATAN BESI,29182,21112,8070,2460,10530,2021-07-16
3173041008,JAKARTA BARAT,TAMBORA,JEMBATAN LIMA,20627,13508,7119,2311,9430,2021-07-16
3173081005,JAKARTA BARAT,KEMBANGAN,JOGLO,40475,25156,15319,6034,21353,2021-07-16
3171081001,JAKARTA PUSAT,JOHAR BARU,JOHAR BARU,32845,17537,15308,5415,20723,2021-07-16
3173041002,JAKARTA BARAT,TAMBORA,KALI ANYAR,23582,16274,7308,2272,9580,2021-07-16
3172041004,JAKARTA UTARA,CILINCING,KALIBARU,67165,46342,20823,4420,25243,2021-07-16
3174081002,JAKARTA SELATAN,PANCORAN,KALIBATA,41464,26962,14502,5027,19529,2021-07-16
3173061001,JAKARTA BARAT,KALI DERES,KALIDERES,69014,43330,25684,7701,33385,2021-07-16
3175051004,JAKARTA TIMUR,PASAR REBO,KALISARI,42557,25634,16923,6953,23876,2021-07-16
3173061004,JAKARTA BARAT,KALI DERES,KAMAL,53180,37792,15388,3691,19079,2021-07-16
3172011002,JAKARTA UTARA,PENJARINGAN,KAMAL MUARA,12679,6132,6547,2551,9098,2021-07-16
3171071007,JAKARTA PUSAT,TANAH ABANG,KAMPUNG BALI,11551,7559,3992,1530,5522,2021-07-16
3175031001,JAKARTA TIMUR,JATINEGARA,KAMPUNG MELAYU,25476,17904,7572,2277,9849,2021-07-16
3171081002,JAKARTA PUSAT,JOHAR BARU,KAMPUNG RAWA,18247,8571,9676,2569,12245,2021-07-16
3175041002,JAKARTA TIMUR,KRAMAT JATI,KAMPUNG TENGAH,43668,30287,13381,5360,18741,2021-07-16
3173011005,JAKARTA BARAT,CENGKARENG,KAPUK,121994,80781,41213,9616,50829,2021-07-16
3172011003,JAKARTA UTARA,PENJARINGAN,KAPUK MUARA,35498,19361,16137,6785,22922,2021-07-16
3171021002,JAKARTA PUSAT,SAWAH BESAR,KARANG ANYAR,25865,15686,10179,3446,13625,2021-07-16
3174021004,JAKARTA SELATAN,SETIA BUDI,KARET,9581,5535,4046,1466,5512,2021-07-16
3174021003,JAKARTA SELATAN,SETIA BUDI,KARET KUNINGAN,15939,8752,7187,2369,9556,2021-07-16
3174021002,JAKARTA SELATAN,SETIA BUDI,KARET SEMANGGI,2746,1335,1411,609,2020,2021-07-16
3171071003,JAKARTA PUSAT,TANAH ABANG,KARET TENGSIN,19113,11933,7180,2265,9445,2021-07-16
3171021003,JAKARTA PUSAT,SAWAH BESAR,KARTINI,22303,12819,9484,3501,12985,2021-07-16
3175011003,JAKARTA TIMUR,MATRAMAN,KAYU MANIS,25138,16425,8713,3056,11769,2021-07-16
3175021006,JAKARTA TIMUR,PULO GADUNG,KAYU PUTIH,40378,22862,17516,7224,24740,2021-07-16
3173031006,JAKARTA BARAT,TAMAN SARI,KEAGUNGAN,17231,10103,7128,2030,9158,2021-07-16
3174041007,JAKARTA SELATAN,PASAR MINGGU,KEBAGUSAN,44010,27958,16052,5301,21353,2021-07-16
3174051006,JAKARTA SELATAN,KEBAYORAN LAMA,KEBAYORAN LAMA SELATAN,40895,24040,16855,5899,22754,2021-07-16
3174051001,JAKARTA SELATAN,KEBAYORAN LAMA,KEBAYORAN LAMA UTARA,42214,27014,15200,5356,20556,2021-07-16
3174011004,JAKARTA SELATAN,TEBET,KEBON BARU,34878,21240,13638,5215,18853,2021-07-16
3172021005,JAKARTA UTARA,TANJUNG PRIOK,KEBON BAWANG,50597,30246,20351,7065,27416,2021-07-16
3173051001,JAKARTA BARAT,KEBON JERUK,KEBON JERUK,53296,34829,18467,6882,25349,2021-07-16
3171071006,JAKARTA PUSAT,TANAH ABANG,KEBON KACANG,21376,14675,6701,2659,9360,2021-07-16
3171011005,JAKARTA PUSAT,GAMBIR,KEBON KELAPA,10380,6378,4002,1678,5680,2021-07-16
3171031002,JAKARTA PUSAT,KEMAYORAN,KEBON KOSONG,30003,18692,11311,3542,14853,2021-07-16
3175011005,JAKARTA TIMUR,MATRAMAN,KEBON MANGGIS,16393,9706,6687,2823,9510,2021-07-16
3171071005,JAKARTA PUSAT,TANAH ABANG,KEBON MELATI,31355,22779,8576,2910,11486,2021-07-16
3175081003,JAKARTA TIMUR,MAKASAR,KEBON PALA,46176,29541,16635,6410,23045,2021-07-16
3171061005,JAKARTA PUSAT,MENTENG,KEBON SIRIH,12256,8370,3886,1564,5450,2021-07-16
3173011004,JAKARTA BARAT,CENGKARENG,KEDAUNG KALI ANGKE,32185,17420,14765,3258,18023,2021-07-16
3173051007,JAKARTA BARAT,KEBON JERUK,KEDOYA SELATAN,31907,18978,12929,4681,17610,2021-07-16
3173051006,JAKARTA BARAT,KEBON JERUK,KEDOYA UTARA,43826,24568,19258,7076,26334,2021-07-16
3173051004,JAKARTA BARAT,KEBON JERUK,KELAPA DUA,23293,14620,8673,3182,11855,2021-07-16
3175091003,JAKARTA TIMUR,CIRACAS,KELAPA DUA WETAN,46441,27989,18452,7426,25878,2021-07-16
3172061003,JAKARTA UTARA,KELAPA GADING,KELAPA GADING BARAT,35403,17419,17984,8979,26963,2021-07-16
3172061001,JAKARTA UTARA,KELAPA GADING,KELAPA GADING TIMUR,33472,15012,18460,9278,27738,2021-07-16
3173071005,JAKARTA BARAT,PALMERAH,KEMANGGISAN,31952,19114,12838,5300,18138,2021-07-16
3171031001,JAKARTA PUSAT,KEMAYORAN,KEMAYORAN,20947,12136,8811,2861,11672,2021-07-16
3173081006,JAKARTA BARAT,KEMBANGAN,KEMBANGAN SELATAN,26920,15761,11159,5089,16248,2021-07-16
3173081001,JAKARTA BARAT,KEMBANGAN,KEMBANGAN UTARA,52368,31253,21115,6713,27828,2021-07-16
3171041002,JAKARTA PUSAT,SENEN,KENARI,9317,5196,4121,1768,5889,2021-07-16
3173041005,JAKARTA BARAT,TAMBORA,KERENDANG,19869,12519,7350,2249,9599,2021-07-16
3175071003,JAKARTA TIMUR,DUREN SAWIT,KLENDER,69321,48127,21194,7564,28758,2021-07-16
3172031001,JAKARTA UTARA,KOJA,KOJA,28036,16948,11088,2789,13877,2021-07-16
3173071006,JAKARTA BARAT,PALMERAH,KOTA BAMBU SELATAN,20926,13137,7789,2273,10062,2021-07-16
3173071003,JAKARTA BARAT,PALMERAH,KOTA BAMBU UTARA,24416,15547,8869,2804,11673,2021-07-16
3171041004,JAKARTA PUSAT,SENEN,KRAMAT,28661,19180,9481,3031,12512,2021-07-16
3175041001,JAKARTA TIMUR,KRAMAT JATI,KRAMAT JATI,33851,21625,12226,5151,17377,2021-07-16
3174071003,JAKARTA SELATAN,KEBAYORAN BARU,KRAMAT PELA,14340,7982,6358,2397,8755,2021-07-16
3173031002,JAKARTA BARAT,TAMAN SARI,KRUKUT,19130,11412,7718,2317,10035,2021-07-16
3174031005,JAKARTA SELATAN,MAMPANG PRAPATAN,KUNINGAN BARAT,12675,7376,5299,1559,6858,2021-07-16
3174021008,JAKARTA SELATAN,SETIA BUDI,KUNINGAN TIMUR,5982,3559,2423,1075,3498,2021-07-16
3171041005,JAKARTA PUSAT,SENEN,KWITANG,15295,9284,6011,2119,8130,2021-07-16
3172031003,JAKARTA UTARA,KOJA,LAGOA,58726,38413,20313,5746,26059,2021-07-16
3174061002,JAKARTA SELATAN,CILANDAK,LEBAK BULUS,37213,22214,14999,6026,21025,2021-07-16
3174091004,JAKARTA SELATAN,JAGAKARSA,LENTENG AGUNG,53453,35175,18278,6252,24530,2021-07-16
3175101007,JAKARTA TIMUR,CIPAYUNG,LUBANG BUAYA,62984,38533,24451,8513,32964,2021-07-16
3175081001,JAKARTA TIMUR,MAKASAR,MAKASAR,34062,20459,13603,5036,18639,2021-07-16
3175071006,JAKARTA TIMUR,DUREN SAWIT,MALAKA JAYA,30744,18151,12593,5577,18170,2021-07-16
3175071005,JAKARTA TIMUR,DUREN SAWIT,MALAKA SARI,27015,15432,11583,5513,17096,2021-07-16
3174031001,JAKARTA SELATAN,MAMPANG PRAPATAN,MAMPANG PRAPATAN,18046,11121,6925,2077,9002,2021-07-16
3173031005,JAKARTA BARAT,TAMAN SARI,MANGGA BESAR,7439,3634,3805,1468,5273,2021-07-16
3171021005,JAKARTA PUSAT,SAWAH BESAR,MANGGA DUA SELATAN,27767,16654,11113,3896,15009,2021-07-16
3174011007,JAKARTA SELATAN,TEBET,MANGGARAI,28388,17629,10759,3605,14364,2021-07-16
3174011006,JAKARTA SELATAN,TEBET,MANGGARAI SELATAN,22902,13212,9690,3257,12947,2021-07-16
3173031003,JAKARTA BARAT,TAMAN SARI,MAPHAR,16385,9190,7195,2602,9797,2021-07-16
3172041003,JAKARTA UTARA,CILINCING,MARUNDA,28614,16895,11719,2608,14327,2021-07-16
3174071001,JAKARTA SELATAN,KEBAYORAN BARU,MELAWAI,2634,1244,1390,849,2239,2021-07-16
3171061001,JAKARTA PUSAT,MENTENG,MENTENG,25280,17203,8077,3588,11665,2021-07-16
3174021005,JAKARTA SELATAN,SETIA BUDI,MENTENG ATAS,27671,15931,11740,4099,15839,2021-07-16
3174011003,JAKARTA SELATAN,TEBET,MENTENG DALAM,35936,22258,13678,5289,18967,2021-07-16
3173081003,JAKARTA BARAT,KEMBANGAN,MERUYA SELATAN,31227,19090,12137,4378,16515,2021-07-16
3173081002,JAKARTA BARAT,KEMBANGAN,MERUYA UTARA,43382,26321,17061,7076,24137,2021-07-16
3175101004,JAKARTA TIMUR,CIPAYUNG,MUNJUL,23570,14694,8876,3649,12525,2021-07-16
3172051002,JAKARTA UTARA,PADEMANGAN,PADEMANGAN BARAT,73841,46892,26949,7901,34850,2021-07-16
3172051001,JAKARTA UTARA,PADEMANGAN,PADEMANGAN TIMUR,36757,19051,17706,6971,24677,2021-07-16
3175011004,JAKARTA TIMUR,MATRAMAN,PAL MERIAM,19632,12224,7408,2760,10168,2021-07-16
3173071001,JAKARTA BARAT,PALMERAH,PALMERAH,62175,38360,23815,8104,31919,2021-07-16
3174081001,JAKARTA SELATAN,PANCORAN,PANCORAN,19301,11488,7813,2688,10501,2021-07-16
3172021003,JAKARTA UTARA,TANJUNG PRIOK,PAPANGGO,38871,23149,15722,4820,20542,2021-07-16
3171021001,JAKARTA PUSAT,SAWAH BESAR,PASAR BARU,12710,6370,6340,2940,9280,2021-07-16
3174021006,JAKARTA SELATAN,SETIA BUDI,PASAR MANGGIS,26572,15759,10813,3595,14408,2021-07-16
3174041001,JAKARTA SELATAN,PASAR MINGGU,PASAR MINGGU,24670,15032,9638,4642,14280,2021-07-16
3171041003,JAKARTA PUSAT,SENEN,PASEBAN,23321,14239,9082,3345,12427,2021-07-16
3173061005,JAKARTA BARAT,KALI DERES,PEGADUNGAN,74685,46028,28657,9245,37902,2021-07-16
3171061002,JAKARTA PUSAT,MENTENG,PEGANGSAAN,21120,13623,7497,2994,10491,2021-07-16
3172061002,JAKARTA UTARA,KELAPA GADING,PEGANGSAAN DUA,49632,23852,25780,10657,36437,2021-07-16
3172011004,JAKARTA UTARA,PENJARINGAN,PEJAGALAN,74043,42443,31600,11066,42666,2021-07-16
3174041006,JAKARTA SELATAN,PASAR MINGGU,PEJATEN BARAT,35061,20429,14632,5722,20354,2021-07-16
3174041005,JAKARTA SELATAN,PASAR MINGGU,PEJATEN TIMUR,57257,37496,19761,6290,26051,2021-07-16
3175051005,JAKARTA TIMUR,PASAR REBO,PEKAYON,42705,25807,16898,6229,23127,2021-07-16
3173041009,JAKARTA BARAT,TAMBORA,PEKOJAN,23428,13470,9958,3459,13417,2021-07-16
3174031003,JAKARTA SELATAN,MAMPANG PRAPATAN,PELA MAMPANG,42709,25120,17589,5717,23306,2021-07-16
3174081005,JAKARTA SELATAN,PANCORAN,PENGADEGAN,21111,11078,10033,3381,13414,2021-07-16
3175061003,JAKARTA TIMUR,CAKUNG,PENGGILINGAN,97138,69049,28089,9496,37585,2021-07-16
3172011001,JAKARTA UTARA,PENJARINGAN,PENJARINGAN,86712,56755,29957,7934,37891,2021-07-16
3174101001,JAKARTA SELATAN,PESANGGRAHAN,PESANGGRAHAN,27215,15356,11859,4933,16792,2021-07-16
3171071004,JAKARTA PUSAT,TANAH ABANG,PETAMBURAN,33060,24089,8971,2984,11955,2021-07-16
3174071008,JAKARTA SELATAN,KEBAYORAN BARU,PETOGOGAN,11418,6604,4814,1935,6749,2021-07-16
3171011004,JAKARTA PUSAT,GAMBIR,PETOJO SELATAN,14946,8700,6246,3028,9274,2021-07-16
3171011003,JAKARTA PUSAT,GAMBIR,PETOJO UTARA,17843,11105,6738,2739,9477,2021-07-16
3174101004,JAKARTA SELATAN,PESANGGRAHAN,PETUKANGAN SELATAN,36769,21474,15295,4977,20272,2021-07-16
3174101003,JAKARTA SELATAN,PESANGGRAHAN,PETUKANGAN UTARA,53184,33025,20159,6828,26987,2021-07-16
3175081002,JAKARTA TIMUR,MAKASAR,PINANG RANTI,26915,16372,10543,3538,14081,2021-07-16
3173031008,JAKARTA BARAT,TAMAN SARI,PINANGSIA,10583,5525,5058,1651,6709,2021-07-16
3175011001,JAKARTA TIMUR,MATRAMAN,PISANGAN BARU,31537,21421,10116,3868,13984,2021-07-16
3175021002,JAKARTA TIMUR,PULO GADUNG,PISANGAN TIMUR,40576,24965,15611,5771,21382,2021-07-16
3172011005,JAKARTA UTARA,PENJARINGAN,PLUIT,47433,24421,23012,12472,35484,2021-07-16
3175071002,JAKARTA TIMUR,DUREN SAWIT,PONDOK BAMBU,61047,38431,22616,9112,31728,2021-07-16
3175071004,JAKARTA TIMUR,DUREN SAWIT,PONDOK KELAPA,71347,42866,28481,11214,39695,2021-07-16
3175071007,JAKARTA TIMUR,DUREN SAWIT,PONDOK KOPI,35051,23780,11271,4419,15690,2021-07-16
3174061003,JAKARTA SELATAN,CILANDAK,PONDOK LABU,45944,26338,19606,7005,26611,2021-07-16
3174051002,JAKARTA SELATAN,KEBAYORAN LAMA,PONDOK PINANG,55724,34029,21695,9786,31481,2021-07-16
3175101003,JAKARTA TIMUR,CIPAYUNG,PONDOK RANGGON,25123,16095,9028,3840,12868,2021-07-16
3101011003,KAB.ADM.KEP.SERIBU,KEP. SERIBU UTARA,PULAU HARAPAN,2036,718,1318,670,1988,2021-07-16
3101011002,KAB.ADM.KEP.SERIBU,KEP. SERIBU UTARA,PULAU KELAPA,5460,1933,3527,1088,4615,2021-07-16
3101011001,KAB.ADM.KEP.SERIBU,KEP. SERIBU UTARA,PULAU PANGGANG,5395,1809,3586,1154,4740,2021-07-16
3101021003,KAB.ADM.KEP.SERIBU,KEP. SERIBU SELATAN,PULAU PARI,2736,772,1964,614,2578,2021-07-16
3101021002,KAB.ADM.KEP.SERIBU,KEP. SERIBU SELATAN,PULAU TIDUNG,4528,1542,2986,1133,4119,2021-07-16
3101021001,KAB.ADM.KEP.SERIBU,KEP. SERIBU SELATAN,PULAU UNTUNG JAWA,1918,665,1253,559,1812,2021-07-16
3174071007,JAKARTA SELATAN,KEBAYORAN BARU,PULO,5777,2902,2875,1375,4250,2021-07-16
3175021001,JAKARTA TIMUR,PULO GADUNG,PULO GADUNG,34175,21833,12342,4746,17088,2021-07-16
3175061005,JAKARTA TIMUR,CAKUNG,PULO GEBANG,95947,64060,31887,10851,42738,2021-07-16
3174041004,JAKARTA SELATAN,PASAR MINGGU,RAGUNAN,39233,22364,16869,5912,22781,2021-07-16
3175091005,JAKARTA TIMUR,CIRACAS,RAMBUTAN,36368,25341,11027,4367,15394,2021-07-16
3172031006,JAKARTA UTARA,KOJA,RAWA BADAK SELATAN,41895,27820,14075,3992,18067,2021-07-16
3172031004,JAKARTA UTARA,KOJA,RAWA BADAK UTARA,33538,20520,13018,3921,16939,2021-07-16
3174071005,JAKARTA SELATAN,KEBAYORAN BARU,RAWA BARAT,5574,3005,2569,1358,3927,2021-07-16
3173011003,JAKARTA BARAT,CENGKARENG,RAWA BUAYA,59533,37469,22064,6065,28129,2021-07-16
3175031004,JAKARTA TIMUR,JATINEGARA,RAWA BUNGA,21272,14308,6964,2504,9468,2021-07-16
3174081003,JAKARTA SELATAN,PANCORAN,RAWA JATI,20321,11447,8874,3486,12360,2021-07-16
3175061002,JAKARTA TIMUR,CAKUNG,RAWA TERATE,24433,14450,9983,2155,12138,2021-07-16
3175021005,JAKARTA TIMUR,PULO GADUNG,RAWAMANGUN,36788,22526,14262,5963,20225,2021-07-16
3171051003,JAKARTA PUSAT,CEMPAKA PUTIH,RAWASARI,21770,12995,8775,3545,12320,2021-07-16
3173041010,JAKARTA BARAT,TAMBORA,ROA MALAKA,3449,1626,1823,896,2719,2021-07-16
3172041006,JAKARTA UTARA,CILINCING,ROROTAN,40953,24291,16662,4659,21321,2021-07-16
3174071004,JAKARTA SELATAN,KEBAYORAN BARU,SELONG,2843,1380,1463,893,2356,2021-07-16
3173061002,JAKARTA BARAT,KALI DERES,SEMANAN,70293,48521,21772,5061,26833,2021-07-16
3172041007,JAKARTA UTARA,CILINCING,SEMPER BARAT,67899,38624,29275,9187,38462,2021-07-16
3172041005,JAKARTA UTARA,CILINCING,SEMPER TIMUR,36029,21698,14331,4370,18701,2021-07-16
3174071006,JAKARTA SELATAN,KEBAYORAN BARU,SENAYAN,2780,1682,1098,585,1683,2021-07-16
3171041001,JAKARTA PUSAT,SENEN,SENEN,6757,3891,2866,1198,4064,2021-07-16
3171031004,JAKARTA PUSAT,KEMAYORAN,SERDANG,29730,18153,11577,3984,15561,2021-07-16
3174021001,JAKARTA SELATAN,SETIA BUDI,SETIA BUDI,2841,1576,1265,656,1921,2021-07-16
3175101005,JAKARTA TIMUR,CIPAYUNG,SETU,20306,13831,6475,2720,9195,2021-07-16
3173071002,JAKARTA BARAT,PALMERAH,SLIPI,16475,9465,7010,2756,9766,2021-07-16
3173081004,JAKARTA BARAT,KEMBANGAN,SRENGSENG,44969,29253,15716,6287,22003,2021-07-16
3174091002,JAKARTA SELATAN,JAGAKARSA,SRENGSENG SAWAH,57480,31565,25915,9024,34939,2021-07-16
3173051003,JAKARTA BARAT,KEBON JERUK,SUKABUMI SELATAN,35170,23491,11679,3531,15210,2021-07-16
3173051002,JAKARTA BARAT,KEBON JERUK,SUKABUMI UTARA,37628,25897,11731,4066,15797,2021-07-16
3172041002,JAKARTA UTARA,CILINCING,SUKAPURA,53786,33070,20716,5521,26237,2021-07-16
3171031007,JAKARTA PUSAT,KEMAYORAN,SUMUR BATU,22506,13405,9101,3457,12558,2021-07-16
3172021004,JAKARTA UTARA,TANJUNG PRIOK,SUNGAI BAMBU,29115,17221,11894,3617,15511,2021-07-16
3172021006,JAKARTA UTARA,TANJUNG PRIOK,SUNTER AGUNG,70860,37205,33655,13741,47396,2021-07-16
3172021002,JAKARTA UTARA,TANJUNG PRIOK,SUNTER JAYA,62516,35435,27081,10601,37682,2021-07-16
3175091004,JAKARTA TIMUR,CIRACAS,SUSUKAN,33525,20222,13303,4683,17986,2021-07-16
3173031001,JAKARTA BARAT,TAMAN SARI,TAMAN SARI,14281,7998,6283,2427,8710,2021-07-16
3173041001,JAKARTA BARAT,TAMBORA,TAMBORA,10177,6309,3868,1530,5398,2021-07-16
3173041004,JAKARTA BARAT,TAMBORA,TANAH SEREAL,25944,14026,11918,3950,15868,2021-07-16
3171081004,JAKARTA PUSAT,JOHAR BARU,TANAH TINGGI,37800,21800,16000,4301,20301,2021-07-16
3173031004,JAKARTA BARAT,TAMAN SARI,TANGKI,12991,7329,5662,1946,7608,2021-07-16
3174091005,JAKARTA SELATAN,JAGAKARSA,TANJUNG BARAT,39368,25075,14293,5787,20080,2021-07-16
3173021005,JAKARTA BARAT,GROGOL PETAMBURAN,TANJUNG DUREN SELATAN,24917,13199,11718,4543,16261,2021-07-16
3173021002,JAKARTA BARAT,GROGOL PETAMBURAN,TANJUNG DUREN UTARA,16940,8440,8500,3582,12082,2021-07-16
3172021001,JAKARTA UTARA,TANJUNG PRIOK,TANJUNG PRIOK,34316,19878,14438,3877,18315,2021-07-16
3174011002,JAKARTA SELATAN,TEBET,TEBET BARAT,21164,11521,9643,4270,13913,2021-07-16
3174011001,JAKARTA SELATAN,TEBET,TEBET TIMUR,18030,9423,8607,3848,12455,2021-07-16
3173061003,JAKARTA BARAT,KALI DERES,TEGAL ALUR,82647,53936,28711,6935,35646,2021-07-16
3174031004,JAKARTA SELATAN,MAMPANG PRAPATAN,TEGAL PARANG,32174,21326,10848,3370,14218,2021-07-16
3173021003,JAKARTA BARAT,GROGOL PETAMBURAN,TOMANG,28665,15757,12908,5045,17953,2021-07-16
3172031005,JAKARTA UTARA,KOJA,TUGU SELATAN,38749,25496,13253,3878,17131,2021-07-16
3172031002,JAKARTA UTARA,KOJA,TUGU UTARA,67211,43694,23517,6849,30366,2021-07-16
3175061006,JAKARTA TIMUR,CAKUNG,UJUNG MENTENG,29527,17889,11638,4035,15673,2021-07-16
3174101005,JAKARTA SELATAN,PESANGGRAHAN,ULUJAMI,40120,26259,13861,4999,18860,2021-07-16
3175011006,JAKARTA TIMUR,MATRAMAN,UTAN KAYU SELATAN,33233,19835,13398,5148,18546,2021-07-16
3175011002,JAKARTA TIMUR,MATRAMAN,UTAN KAYU UTARA,27995,17058,10937,3875,14812,2021-07-16
3171031008,JAKARTA PUSAT,KEMAYORAN,UTAN PANJANG,29260,19609,9651,2847,12498,2021-07-16
3172021007,JAKARTA UTARA,TANJUNG PRIOK,WARAKAS,43754,26282,17472,5300,22772,2021-07-16
3173021007,JAKARTA BARAT,GROGOL PETAMBURAN,WIJAYA KUSUMA,38584,24073,14511,4930,19441,2021-07-16
3172051003,JAKARTA UTARA,PADEMANGAN,ANCOL,23379,14676,8703,3341,12044,2021-07-17
3173041007,JAKARTA BARAT,TAMBORA,ANGKE,29230,17039,12191,3283,15474,2021-07-17
3175041005,JAKARTA TIMUR,KRAMAT JATI,BALE KAMBANG,28803,20555,8248,2740,10988,2021-07-17
3175031003,JAKARTA TIMUR,JATINEGARA,BALI MESTER,9675,6010,3665,1557,5222,2021-07-17
3175101006,JAKARTA TIMUR,CIPAYUNG,BAMBU APUS,25985,16521,9464,4057,13521,2021-07-17
3174031002,JAKARTA SELATAN,MAMPANG PRAPATAN,BANGKA,21356,12853,8503,2775,11278,2021-07-17
3175051002,JAKARTA TIMUR,PASAR REBO,BARU,23514,12611,10903,4854,15757,2021-07-17
3175041004,JAKARTA TIMUR,KRAMAT JATI,BATU AMPAR,47416,33144,14272,5444,19716,2021-07-17
3171071002,JAKARTA PUSAT,TANAH ABANG,BENDUNGAN HILIR,21374,12144,9230,3669,12899,2021-07-17
3175031002,JAKARTA TIMUR,JATINEGARA,BIDARA CINA,36461,24919,11542,4136,15678,2021-07-17
3174101002,JAKARTA SELATAN,PESANGGRAHAN,BINTARO,52402,32245,20157,7289,27446,2021-07-17
3174011005,JAKARTA SELATAN,TEBET,BUKIT DURI,33953,21499,12454,4059,16513,2021-07-17
3171041006,JAKARTA PUSAT,SENEN,BUNGUR,17929,10560,7369,2819,10188,2021-07-17
3175061007,JAKARTA TIMUR,CAKUNG,CAKUNG BARAT,57222,35106,22116,4128,26244,2021-07-17
3175061004,JAKARTA TIMUR,CAKUNG,CAKUNG TIMUR,57655,35269,22386,6538,28924,2021-07-17
3175041007,JAKARTA TIMUR,KRAMAT JATI,CAWANG,32481,20786,11695,4421,16116,2021-07-17
3175101008,JAKARTA TIMUR,CIPAYUNG,CEGER,18740,11706,7034,2634,9668,2021-07-17
3171031006,JAKARTA PUSAT,KEMAYORAN,CEMPAKA BARU,31257,19869,11388,4118,15506,2021-07-17
3171051002,JAKARTA PUSAT,CEMPAKA PUTIH,CEMPAKA PUTIH BARAT,34725,21608,13117,5089,18206,2021-07-17
3171051001,JAKARTA PUSAT,CEMPAKA PUTIH,CEMPAKA PUTIH TIMUR,24170,14112,10058,4568,14626,2021-07-17
3173011001,JAKARTA BARAT,CENGKARENG,CENGKARENG BARAT,65702,37398,28304,8376,36680,2021-07-17
3173011006,JAKARTA BARAT,CENGKARENG,CENGKARENG TIMUR,80100,48777,31323,8637,39960,2021-07-17
3175091002,JAKARTA TIMUR,CIRACAS,CIBUBUR,65231,37806,27425,9803,37228,2021-07-17
3171011002,JAKARTA PUSAT,GAMBIR,CIDENG,15696,8493,7203,3259,10462,2021-07-17
3174091003,JAKARTA SELATAN,JAGAKARSA,CIGANJUR,38048,22957,15091,5297,20388,2021-07-17
3175051003,JAKARTA TIMUR,PASAR REBO,CIJANTUNG,41013,24383,16630,6396,23026,2021-07-17
3171061003,JAKARTA PUSAT,MENTENG,CIKINI,8260,5198,3062,1402,4464,2021-07-17
3174081006,JAKARTA SELATAN,PANCORAN,CIKOKO,10503,5661,4842,1800,6642,2021-07-17
3174061001,JAKARTA SELATAN,CILANDAK,CILANDAK BARAT,51346,28429,22917,8099,31016,2021-07-17
3174041003,JAKARTA SELATAN,PASAR MINGGU,CILANDAK TIMUR,24239,13548,10691,4970,15661,2021-07-17
3175101002,JAKARTA TIMUR,CIPAYUNG,CILANGKAP,27179,16796,10383,3908,14291,2021-07-17
3175041006,JAKARTA TIMUR,KRAMAT JATI,CILILITAN,39984,26552,13432,5460,18892,2021-07-17
3172041001,JAKARTA UTARA,CILINCING,CILINCING,42677,27254,15423,4020,19443,2021-07-17
3175101001,JAKARTA TIMUR,CIPAYUNG,CIPAYUNG,25747,14672,11075,4337,15412,2021-07-17
3174091006,JAKARTA SELATAN,JAGAKARSA,CIPEDAK,37809,21901,15908,4924,20832,2021-07-17
3174061005,JAKARTA SELATAN,CILANDAK,CIPETE SELATAN,26500,15427,11073,3910,14983,2021-07-17
3174071010,JAKARTA SELATAN,KEBAYORAN BARU,CIPETE UTARA,33902,19535,14367,4211,18578,2021-07-17
3175021003,JAKARTA TIMUR,PULO GADUNG,CIPINANG,39069,23969,15100,6244,21344,2021-07-17
3175031007,JAKARTA TIMUR,JATINEGARA,CIPINANG BESAR SELATAN,34938,24212,10726,3994,14720,2021-07-17
3175031008,JAKARTA TIMUR,JATINEGARA,CIPINANG BESAR UTARA,44479,31142,13337,4282,17619,2021-07-17
3175031005,JAKARTA TIMUR,JATINEGARA,CIPINANG CEMPEDAK,32695,21070,11625,4811,16436,2021-07-17
3175081005,JAKARTA TIMUR,MAKASAR,CIPINANG MELAYU,42144,25416,16728,6564,23292,2021-07-17
3175031006,JAKARTA TIMUR,JATINEGARA,CIPINANG MUARA,53251,35516,17735,7487,25222,2021-07-17
3174051003,JAKARTA SELATAN,KEBAYORAN LAMA,CIPULIR,39635,25353,14282,4891,19173,2021-07-17
3175091001,JAKARTA TIMUR,CIRACAS,CIRACAS,63801,38519,25282,8689,33971,2021-07-17
3175041003,JAKARTA TIMUR,KRAMAT JATI,DUKUH,24404,15560,8844,3606,12450,2021-07-17
3175071001,JAKARTA TIMUR,DUREN SAWIT,DUREN SAWIT,60443,38428,22015,9516,31531,2021-07-17
3174081004,JAKARTA SELATAN,PANCORAN,DUREN TIGA,28099,16300,11799,3938,15737,2021-07-17
3173051005,JAKARTA BARAT,KEBON JERUK,DURI KEPA,59448,32875,26573,10234,36807,2021-07-17
3173011002,JAKARTA BARAT,CENGKARENG,DURI KOSAMBI,75895,46655,29240,8357,37597,2021-07-17
3171011006,JAKARTA PUSAT,GAMBIR,DURI PULO,19986,12836,7150,2435,9585,2021-07-17
3173041011,JAKARTA BARAT,TAMBORA,DURI SELATAN,14099,8067,6032,2396,8428,2021-07-17
3173041003,JAKARTA BARAT,TAMBORA,DURI UTARA,19768,11810,7958,2688,10646,2021-07-17
3171081003,JAKARTA PUSAT,JOHAR BARU,GALUR,18098,10041,8057,2018,10075,2021-07-17
3171011001,JAKARTA PUSAT,GAMBIR,GAMBIR,2434,1303,1131,586,1717,2021-07-17
3174061004,JAKARTA SELATAN,CILANDAK,GANDARIA SELATAN,21926,12984,8942,2913,11855,2021-07-17
3174071009,JAKARTA SELATAN,KEBAYORAN BARU,GANDARIA UTARA,39609,23232,16377,5474,21851,2021-07-17
3175051001,JAKARTA TIMUR,PASAR REBO,GEDONG,35444,21986,13458,5424,18882,2021-07-17
3171071001,JAKARTA PUSAT,TANAH ABANG,GELORA,3106,1835,1271,584,1855,2021-07-17
3173031007,JAKARTA BARAT,TAMAN SARI,GLODOK,7836,3580,4256,2013,6269,2021-07-17
3171061004,JAKARTA PUSAT,MENTENG,GONDANGDIA,4093,2029,2064,1312,3376,2021-07-17
3173021001,JAKARTA BARAT,GROGOL PETAMBURAN,GROGOL,16815,9831,6984,2665,9649,2021-07-17
3174051005,JAKARTA SELATAN,KEBAYORAN LAMA,GROGOL SELATAN,43915,28476,15439,5593,21032,2021-07-17
3174051004,JAKARTA SELATAN,KEBAYORAN LAMA,GROGOL UTARA,42216,26617,15599,5984,21583,2021-07-17
3174021007,JAKARTA SELATAN,SETIA BUDI,GUNTUR,3962,1998,1964,1007,2971,2021-07-17
3174071002,JAKARTA SELATAN,KEBAYORAN BARU,GUNUNG,9344,5059,4285,2082,6367,2021-07-17
3171031005,JAKARTA PUSAT,KEMAYORAN,GUNUNG SAHARI SELATAN,19380,11488,7892,2864,10756,2021-07-17
3171021004,JAKARTA PUSAT,SAWAH BESAR,GUNUNG SAHARI UTARA,15647,7830,7817,3442,11259,2021-07-17
3175081004,JAKARTA TIMUR,MAKASAR,HALIM PERDANA KUSUMAH,28110,12984,15126,9430,24556,2021-07-17
3171031003,JAKARTA PUSAT,KEMAYORAN,HARAPAN MULIA,22700,14443,8257,2745,11002,2021-07-17
3174091001,JAKARTA SELATAN,JAGAKARSA,JAGAKARSA,61552,35190,26362,8723,35085,2021-07-17
3175021007,JAKARTA TIMUR,PULO GADUNG,JATI,32443,19616,12827,5761,18588,2021-07-17
3174041002,JAKARTA SELATAN,PASAR MINGGU,JATI PADANG,37250,21984,15266,5965,21231,2021-07-17
3173071004,JAKARTA BARAT,PALMERAH,JATI PULO,27994,15664,12330,3721,16051,2021-07-17
3175061001,JAKARTA TIMUR,CAKUNG,JATINEGARA,83563,57284,26279,6938,33217,2021-07-17
3175021004,JAKARTA TIMUR,PULO GADUNG,JATINEGARA KAUM,24364,15519,8845,2993,11838,2021-07-17
3173021004,JAKARTA BARAT,GROGOL PETAMBURAN,JELAMBAR,30180,16821,13359,5572,18931,2021-07-17
3173021006,JAKARTA BARAT,GROGOL PETAMBURAN,JELAMBAR BARU,37799,21532,16267,6177,22444,2021-07-17
3173041006,JAKARTA BARAT,TAMBORA,JEMBATAN BESI,29182,20882,8300,2468,10768,2021-07-17
3173041008,JAKARTA BARAT,TAMBORA,JEMBATAN LIMA,20627,13444,7183,2318,9501,2021-07-17
3173081005,JAKARTA BARAT,KEMBANGAN,JOGLO,40475,24923,15552,6064,21616,2021-07-17
3171081001,JAKARTA PUSAT,JOHAR BARU,JOHAR BARU,32845,17354,15491,5434,20925,2021-07-17
3173041002,JAKARTA BARAT,TAMBORA,KALI ANYAR,23582,15982,7600,2278,9878,2021-07-17
3172041004,JAKARTA UTARA,CILINCING,KALIBARU,67165,45860,21305,4424,25729,2021-07-17
3174081002,JAKARTA SELATAN,PANCORAN,KALIBATA,41464,26743,14721,5063,19784,2021-07-17
3173061001,JAKARTA BARAT,KALI DERES,KALIDERES,69014,42872,26142,7720,33862,2021-07-17
3175051004,JAKARTA TIMUR,PASAR REBO,KALISARI,42557,25421,17136,7007,24143,2021-07-17
3173061004,JAKARTA BARAT,KALI DERES,KAMAL,53180,37469,15711,3703,19414,2021-07-17
3172011002,JAKARTA UTARA,PENJARINGAN,KAMAL MUARA,12679,6035,6644,2563,9207,2021-07-17
3171071007,JAKARTA PUSAT,TANAH ABANG,KAMPUNG BALI,11551,7498,4053,1535,5588,2021-07-17
3175031001,JAKARTA TIMUR,JATINEGARA,KAMPUNG MELAYU,25476,17753,7723,2283,10006,2021-07-17
3171081002,JAKARTA PUSAT,JOHAR BARU,KAMPUNG RAWA,18247,8472,9775,2572,12347,2021-07-17
3175041002,JAKARTA TIMUR,KRAMAT JATI,KAMPUNG TENGAH,43668,30081,13587,5384,18971,2021-07-17
3173011005,JAKARTA BARAT,CENGKARENG,KAPUK,121994,79801,42193,9636,51829,2021-07-17
3172011003,JAKARTA UTARA,PENJARINGAN,KAPUK MUARA,35498,19120,16378,6801,23179,2021-07-17
3171021002,JAKARTA PUSAT,SAWAH BESAR,KARANG ANYAR,25865,15486,10379,3454,13833,2021-07-17
3174021004,JAKARTA SELATAN,SETIA BUDI,KARET,9581,5503,4078,1470,5548,2021-07-17
3174021003,JAKARTA SELATAN,SETIA BUDI,KARET KUNINGAN,15939,8645,7294,2388,9682,2021-07-17
3174021002,JAKARTA SELATAN,SETIA BUDI,KARET SEMANGGI,2746,1331,1415,619,2034,2021-07-17
3171071003,JAKARTA PUSAT,TANAH ABANG,KARET TENGSIN,19113,11815,7298,2289,9587,2021-07-17
3171021003,JAKARTA PUSAT,SAWAH BESAR,KARTINI,22303,12698,9605,3511,13116,2021-07-17
3175011003,JAKARTA TIMUR,MATRAMAN,KAYU MANIS,25138,16280,8858,3062,11920,2021-07-17
3175021006,JAKARTA TIMUR,PULO GADUNG,KAYU PUTIH,40378,22721,17657,7269,24926,2021-07-17
3173031006,JAKARTA BARAT,TAMAN SARI,KEAGUNGAN,17231,9918,7313,2036,9349,2021-07-17
3174041007,JAKARTA SELATAN,PASAR MINGGU,KEBAGUSAN,44010,27721,16289,5323,21612,2021-07-17
3174051006,JAKARTA SELATAN,KEBAYORAN LAMA,KEBAYORAN LAMA SELATAN,40895,23624,17271,5926,23197,2021-07-17
3174051001,JAKARTA SELATAN,KEBAYORAN LAMA,KEBAYORAN LAMA UTARA,42214,26738,15476,5376,20852,2021-07-17
3174011004,JAKARTA SELATAN,TEBET,KEBON BARU,34878,21103,13775,5250,19025,2021-07-17
3172021005,JAKARTA UTARA,TANJUNG PRIOK,KEBON BAWANG,50597,29927,20670,7083,27753,2021-07-17
3173051001,JAKARTA BARAT,KEBON JERUK,KEBON JERUK,53296,34486,18810,6916,25726,2021-07-17
3171071006,JAKARTA PUSAT,TANAH ABANG,KEBON KACANG,21376,14486,6890,2672,9562,2021-07-17
3171011005,JAKARTA PUSAT,GAMBIR,KEBON KELAPA,10380,6350,4030,1683,5713,2021-07-17
3171031002,JAKARTA PUSAT,KEMAYORAN,KEBON KOSONG,30003,18534,11469,3555,15024,2021-07-17
3175011005,JAKARTA TIMUR,MATRAMAN,KEBON MANGGIS,16393,9605,6788,2832,9620,2021-07-17
3171071005,JAKARTA PUSAT,TANAH ABANG,KEBON MELATI,31355,22448,8907,2923,11830,2021-07-17
3175081003,JAKARTA TIMUR,MAKASAR,KEBON PALA,46176,29225,16951,6428,23379,2021-07-17
3171061005,JAKARTA PUSAT,MENTENG,KEBON SIRIH,12256,8301,3955,1569,5524,2021-07-17
3173011004,JAKARTA BARAT,CENGKARENG,KEDAUNG KALI ANGKE,32185,17252,14933,3265,18198,2021-07-17
3173051007,JAKARTA BARAT,KEBON JERUK,KEDOYA SELATAN,31907,18714,13193,4702,17895,2021-07-17
3173051006,JAKARTA BARAT,KEBON JERUK,KEDOYA UTARA,43826,24347,19479,7108,26587,2021-07-17
3173051004,JAKARTA BARAT,KEBON JERUK,KELAPA DUA,23293,14473,8820,3198,12018,2021-07-17
3175091003,JAKARTA TIMUR,CIRACAS,KELAPA DUA WETAN,46441,27687,18754,7454,26208,2021-07-17
3172061003,JAKARTA UTARA,KELAPA GADING,KELAPA GADING BARAT,35403,17246,18157,8999,27156,2021-07-17
3172061001,JAKARTA UTARA,KELAPA GADING,KELAPA GADING TIMUR,33472,14893,18579,9312,27891,2021-07-17
3173071005,JAKARTA BARAT,PALMERAH,KEMANGGISAN,31952,18920,13032,5318,18350,2021-07-17
3171031001,JAKARTA PUSAT,KEMAYORAN,KEMAYORAN,20947,12000,8947,2866,11813,2021-07-17
3173081006,JAKARTA BARAT,KEMBANGAN,KEMBANGAN SELATAN,26920,15635,11285,5116,16401,2021-07-17
3173081001,JAKARTA BARAT,KEMBANGAN,KEMBANGAN UTARA,52368,30902,21466,6746,28212,2021-07-17
3171041002,JAKARTA PUSAT,SENEN,KENARI,9317,5162,4155,1773,5928,2021-07-17
3173041005,JAKARTA BARAT,TAMBORA,KERENDANG,19869,12371,7498,2252,9750,2021-07-17
3175071003,JAKARTA TIMUR,DUREN SAWIT,KLENDER,69321,47820,21501,7599,29100,2021-07-17
3172031001,JAKARTA UTARA,KOJA,KOJA,28036,16821,11215,2793,14008,2021-07-17
3173071006,JAKARTA BARAT,PALMERAH,KOTA BAMBU SELATAN,20926,13002,7924,2286,10210,2021-07-17
3173071003,JAKARTA BARAT,PALMERAH,KOTA BAMBU UTARA,24416,15376,9040,2822,11862,2021-07-17
3171041004,JAKARTA PUSAT,SENEN,KRAMAT,28661,18993,9668,3044,12712,2021-07-17
3175041001,JAKARTA TIMUR,KRAMAT JATI,KRAMAT JATI,33851,21439,12412,5170,17582,2021-07-17
3174071003,JAKARTA SELATAN,KEBAYORAN BARU,KRAMAT PELA,14340,7915,6425,2406,8831,2021-07-17
3173031002,JAKARTA BARAT,TAMAN SARI,KRUKUT,19130,11338,7792,2323,10115,2021-07-17
3174031005,JAKARTA SELATAN,MAMPANG PRAPATAN,KUNINGAN BARAT,12675,7293,5382,1563,6945,2021-07-17
3174021008,JAKARTA SELATAN,SETIA BUDI,KUNINGAN TIMUR,5982,3532,2450,1079,3529,2021-07-17
3171041005,JAKARTA PUSAT,SENEN,KWITANG,15295,9222,6073,2124,8197,2021-07-17
3172031003,JAKARTA UTARA,KOJA,LAGOA,58726,37985,20741,5758,26499,2021-07-17
3174061002,JAKARTA SELATAN,CILANDAK,LEBAK BULUS,37213,22079,15134,6042,21176,2021-07-17
3174091004,JAKARTA SELATAN,JAGAKARSA,LENTENG AGUNG,53453,34692,18761,6292,25053,2021-07-17
3175101007,JAKARTA TIMUR,CIPAYUNG,LUBANG BUAYA,62984,38138,24846,8556,33402,2021-07-17
3175081001,JAKARTA TIMUR,MAKASAR,MAKASAR,34062,20261,13801,5049,18850,2021-07-17
3175071006,JAKARTA TIMUR,DUREN SAWIT,MALAKA JAYA,30744,17735,13009,5607,18616,2021-07-17
3175071005,JAKARTA TIMUR,DUREN SAWIT,MALAKA SARI,27015,15279,11736,5535,17271,2021-07-17
3174031001,JAKARTA SELATAN,MAMPANG PRAPATAN,MAMPANG PRAPATAN,18046,10991,7055,2089,9144,2021-07-17
3173031005,JAKARTA BARAT,TAMAN SARI,MANGGA BESAR,7439,3618,3821,1474,5295,2021-07-17
3171021005,JAKARTA PUSAT,SAWAH BESAR,MANGGA DUA SELATAN,27767,16493,11274,3912,15186,2021-07-17
3174011007,JAKARTA SELATAN,TEBET,MANGGARAI,28388,17519,10869,3618,14487,2021-07-17
3174011006,JAKARTA SELATAN,TEBET,MANGGARAI SELATAN,22902,12972,9930,3267,13197,2021-07-17
3173031003,JAKARTA BARAT,TAMAN SARI,MAPHAR,16385,9129,7256,2606,9862,2021-07-17
3172041003,JAKARTA UTARA,CILINCING,MARUNDA,28614,16756,11858,2619,14477,2021-07-17
3174071001,JAKARTA SELATAN,KEBAYORAN BARU,MELAWAI,2634,1235,1399,853,2252,2021-07-17
3171061001,JAKARTA PUSAT,MENTENG,MENTENG,25280,17062,8218,3602,11820,2021-07-17
3174021005,JAKARTA SELATAN,SETIA BUDI,MENTENG ATAS,27671,15744,11927,4110,16037,2021-07-17
3174011003,JAKARTA SELATAN,TEBET,MENTENG DALAM,35936,22102,13834,5318,19152,2021-07-17
3173081003,JAKARTA BARAT,KEMBANGAN,MERUYA SELATAN,31227,18959,12268,4396,16664,2021-07-17
3173081002,JAKARTA BARAT,KEMBANGAN,MERUYA UTARA,43382,25928,17454,7110,24564,2021-07-17
3175101004,JAKARTA TIMUR,CIPAYUNG,MUNJUL,23570,14553,9017,3667,12684,2021-07-17
3172051002,JAKARTA UTARA,PADEMANGAN,PADEMANGAN BARAT,73841,46522,27319,7928,35247,2021-07-17
3172051001,JAKARTA UTARA,PADEMANGAN,PADEMANGAN TIMUR,36757,18932,17825,6995,24820,2021-07-17
3175011004,JAKARTA TIMUR,MATRAMAN,PAL MERIAM,19632,12136,7496,2773,10269,2021-07-17
3173071001,JAKARTA BARAT,PALMERAH,PALMERAH,62175,37991,24184,8136,32320,2021-07-17
3174081001,JAKARTA SELATAN,PANCORAN,PANCORAN,19301,11319,7982,2707,10689,2021-07-17
3172021003,JAKARTA UTARA,TANJUNG PRIOK,PAPANGGO,38871,22930,15941,4829,20770,2021-07-17
3171021001,JAKARTA PUSAT,SAWAH BESAR,PASAR BARU,12710,6333,6377,2955,9332,2021-07-17
3174021006,JAKARTA SELATAN,SETIA BUDI,PASAR MANGGIS,26572,15640,10932,3605,14537,2021-07-17
3174041001,JAKARTA SELATAN,PASAR MINGGU,PASAR MINGGU,24670,14929,9741,4657,14398,2021-07-17
3171041003,JAKARTA PUSAT,SENEN,PASEBAN,23321,14074,9247,3360,12607,2021-07-17
3173061005,JAKARTA BARAT,KALI DERES,PEGADUNGAN,74685,45737,28948,9285,38233,2021-07-17
3171061002,JAKARTA PUSAT,MENTENG,PEGANGSAAN,21120,13507,7613,3007,10620,2021-07-17
3172061002,JAKARTA UTARA,KELAPA GADING,PEGANGSAAN DUA,49632,23670,25962,10697,36659,2021-07-17
3172011004,JAKARTA UTARA,PENJARINGAN,PEJAGALAN,74043,42035,32008,11094,43102,2021-07-17
3174041006,JAKARTA SELATAN,PASAR MINGGU,PEJATEN BARAT,35061,20252,14809,5753,20562,2021-07-17
3174041005,JAKARTA SELATAN,PASAR MINGGU,PEJATEN TIMUR,57257,37170,20087,6337,26424,2021-07-17
3175051005,JAKARTA TIMUR,PASAR REBO,PEKAYON,42705,25442,17263,6256,23519,2021-07-17
3173041009,JAKARTA BARAT,TAMBORA,PEKOJAN,23428,13273,10155,3471,13626,2021-07-17
3174031003,JAKARTA SELATAN,MAMPANG PRAPATAN,PELA MAMPANG,42709,24827,17882,5740,23622,2021-07-17
3174081005,JAKARTA SELATAN,PANCORAN,PENGADEGAN,21111,10946,10165,3398,13563,2021-07-17
3175061003,JAKARTA TIMUR,CAKUNG,PENGGILINGAN,97138,68247,28891,9535,38426,2021-07-17
3172011001,JAKARTA UTARA,PENJARINGAN,PENJARINGAN,86712,56265,30447,7945,38392,2021-07-17
3174101001,JAKARTA SELATAN,PESANGGRAHAN,PESANGGRAHAN,27215,15252,11963,4965,16928,2021-07-17
3171071004,JAKARTA PUSAT,TANAH ABANG,PETAMBURAN,33060,23770,9290,2998,12288,2021-07-17
3174071008,JAKARTA SELATAN,KEBAYORAN BARU,PETOGOGAN,11418,6518,4900,1941,6841,2021-07-17
3171011004,JAKARTA PUSAT,GAMBIR,PETOJO SELATAN,14946,8621,6325,3033,9358,2021-07-17
3171011003,JAKARTA PUSAT,GAMBIR,PETOJO UTARA,17843,10999,6844,2746,9590,2021-07-17
3174101004,JAKARTA SELATAN,PESANGGRAHAN,PETUKANGAN SELATAN,36769,21128,15641,4994,20635,2021-07-17
3174101003,JAKARTA SELATAN,PESANGGRAHAN,PETUKANGAN UTARA,53184,32639,20545,6859,27404,2021-07-17
3175081002,JAKARTA TIMUR,MAKASAR,PINANG RANTI,26915,16176,10739,3558,14297,2021-07-17
3173031008,JAKARTA BARAT,TAMAN SARI,PINANGSIA,10583,5480,5103,1654,6757,2021-07-17
3175011001,JAKARTA TIMUR,MATRAMAN,PISANGAN BARU,31537,21263,10274,3889,14163,2021-07-17
3175021002,JAKARTA TIMUR,PULO GADUNG,PISANGAN TIMUR,40576,24751,15825,5785,21610,2021-07-17
3172011005,JAKARTA UTARA,PENJARINGAN,PLUIT,47433,24229,23204,12505,35709,2021-07-17
3175071002,JAKARTA TIMUR,DUREN SAWIT,PONDOK BAMBU,61047,38203,22844,9165,32009,2021-07-17
3175071004,JAKARTA TIMUR,DUREN SAWIT,PONDOK KELAPA,71347,42317,29030,11274,40304,2021-07-17
3175071007,JAKARTA TIMUR,DUREN SAWIT,PONDOK KOPI,35051,23643,11408,4442,15850,2021-07-17
3174061003,JAKARTA SELATAN,CILANDAK,PONDOK LABU,45944,25917,20027,7029,27056,2021-07-17
3174051002,JAKARTA SELATAN,KEBAYORAN LAMA,PONDOK PINANG,55724,33710,22014,9838,31852,2021-07-17
3175101003,JAKARTA TIMUR,CIPAYUNG,PONDOK RANGGON,25123,15967,9156,3851,13007,2021-07-17
3101011003,KAB.ADM.KEP.SERIBU,KEP. SERIBU UTARA,PULAU HARAPAN,2036,717,1319,670,1989,2021-07-17
3101011002,KAB.ADM.KEP.SERIBU,KEP. SERIBU UTARA,PULAU KELAPA,5460,1929,3531,1088,4619,2021-07-17
3101011001,KAB.ADM.KEP.SERIBU,KEP. SERIBU UTARA,PULAU PANGGANG,5395,1772,3623,1158,4781,2021-07-17
3101021003,KAB.ADM.KEP.SERIBU,KEP. SERIBU SELATAN,PULAU PARI,2736,766,1970,615,2585,2021-07-17
3101021002,KAB.ADM.KEP.SERIBU,KEP. SERIBU SELATAN,PULAU TIDUNG,4528,1535,2993,1134,4127,2021-07-17
3101021001,KAB.ADM.KEP.SERIBU,KEP. SERIBU SELATAN,PULAU UNTUNG JAWA,1918,661,1257,559,1816,2021-07-17
3174071007,JAKARTA SELATAN,KEBAYORAN BARU,PULO,5777,2880,2897,1385,4282,2021-07-17
3175021001,JAKARTA TIMUR,PULO GADUNG,PULO GADUNG,34175,21593,12582,4771,17353,2021-07-17
3175061005,JAKARTA TIMUR,CAKUNG,PULO GEBANG,95947,63484,32463,10898,43361,2021-07-17
3174041004,JAKARTA SELATAN,PASAR MINGGU,RAGUNAN,39233,22147,17086,5940,23026,2021-07-17
3175091005,JAKARTA TIMUR,CIRACAS,RAMBUTAN,36368,25156,11212,4385,15597,2021-07-17
3172031006,JAKARTA UTARA,KOJA,RAWA BADAK SELATAN,41895,27627,14268,3999,18267,2021-07-17
3172031004,JAKARTA UTARA,KOJA,RAWA BADAK UTARA,33538,20351,13187,3930,17117,2021-07-17
3174071005,JAKARTA SELATAN,KEBAYORAN BARU,RAWA BARAT,5574,2950,2624,1366,3990,2021-07-17
3173011003,JAKARTA BARAT,CENGKARENG,RAWA BUAYA,59533,37176,22357,6081,28438,2021-07-17
3175031004,JAKARTA TIMUR,JATINEGARA,RAWA BUNGA,21272,14214,7058,2516,9574,2021-07-17
3174081003,JAKARTA SELATAN,PANCORAN,RAWA JATI,20321,11342,8979,3503,12482,2021-07-17
3175061002,JAKARTA TIMUR,CAKUNG,RAWA TERATE,24433,14266,10167,2163,12330,2021-07-17
3175021005,JAKARTA TIMUR,PULO GADUNG,RAWAMANGUN,36788,22297,14491,5992,20483,2021-07-17
3171051003,JAKARTA PUSAT,CEMPAKA PUTIH,RAWASARI,21770,12882,8888,3562,12450,2021-07-17
3173041010,JAKARTA BARAT,TAMBORA,ROA MALAKA,3449,1609,1840,896,2736,2021-07-17
3172041006,JAKARTA UTARA,CILINCING,ROROTAN,40953,23924,17029,4685,21714,2021-07-17
3174071004,JAKARTA SELATAN,KEBAYORAN BARU,SELONG,2843,1375,1468,896,2364,2021-07-17
3173061002,JAKARTA BARAT,KALI DERES,SEMANAN,70293,48038,22255,5077,27332,2021-07-17
3172041007,JAKARTA UTARA,CILINCING,SEMPER BARAT,67899,38203,29696,9210,38906,2021-07-17
3172041005,JAKARTA UTARA,CILINCING,SEMPER TIMUR,36029,21527,14502,4381,18883,2021-07-17
3174071006,JAKARTA SELATAN,KEBAYORAN BARU,SENAYAN,2780,1673,1107,590,1697,2021-07-17
3171041001,JAKARTA PUSAT,SENEN,SENEN,6757,3859,2898,1203,4101,2021-07-17
3171031004,JAKARTA PUSAT,KEMAYORAN,SERDANG,29730,18030,11700,4002,15702,2021-07-17
3174021001,JAKARTA SELATAN,SETIA BUDI,SETIA BUDI,2841,1567,1274,657,1931,2021-07-17
3175101005,JAKARTA TIMUR,CIPAYUNG,SETU,20306,13716,6590,2733,9323,2021-07-17
3173071002,JAKARTA BARAT,PALMERAH,SLIPI,16475,9377,7098,2766,9864,2021-07-17
3173081004,JAKARTA BARAT,KEMBANGAN,SRENGSENG,44969,29016,15953,6314,22267,2021-07-17
3174091002,JAKARTA SELATAN,JAGAKARSA,SRENGSENG SAWAH,57480,31078,26402,9052,35454,2021-07-17
3173051003,JAKARTA BARAT,KEBON JERUK,SUKABUMI SELATAN,35170,23324,11846,3551,15397,2021-07-17
3173051002,JAKARTA BARAT,KEBON JERUK,SUKABUMI UTARA,37628,25685,11943,4083,16026,2021-07-17
3172041002,JAKARTA UTARA,CILINCING,SUKAPURA,53786,32800,20986,5535,26521,2021-07-17
3171031007,JAKARTA PUSAT,KEMAYORAN,SUMUR BATU,22506,13257,9249,3472,12721,2021-07-17
3172021004,JAKARTA UTARA,TANJUNG PRIOK,SUNGAI BAMBU,29115,17075,12040,3634,15674,2021-07-17
3172021006,JAKARTA UTARA,TANJUNG PRIOK,SUNTER AGUNG,70860,36824,34036,13785,47821,2021-07-17
3172021002,JAKARTA UTARA,TANJUNG PRIOK,SUNTER JAYA,62516,35065,27451,10638,38089,2021-07-17
3175091004,JAKARTA TIMUR,CIRACAS,SUSUKAN,33525,20060,13465,4690,18155,2021-07-17
3173031001,JAKARTA BARAT,TAMAN SARI,TAMAN SARI,14281,7860,6421,2440,8861,2021-07-17
3173041001,JAKARTA BARAT,TAMBORA,TAMBORA,10177,6273,3904,1533,5437,2021-07-17
3173041004,JAKARTA BARAT,TAMBORA,TANAH SEREAL,25944,13883,12061,3970,16031,2021-07-17
3171081004,JAKARTA PUSAT,JOHAR BARU,TANAH TINGGI,37800,21599,16201,4315,20516,2021-07-17
3173031004,JAKARTA BARAT,TAMAN SARI,TANGKI,12991,7242,5749,1953,7702,2021-07-17
3174091005,JAKARTA SELATAN,JAGAKARSA,TANJUNG BARAT,39368,24787,14581,5820,20401,2021-07-17
3173021005,JAKARTA BARAT,GROGOL PETAMBURAN,TANJUNG DUREN SELATAN,24917,13079,11838,4573,16411,2021-07-17
3173021002,JAKARTA BARAT,GROGOL PETAMBURAN,TANJUNG DUREN UTARA,16940,8385,8555,3610,12165,2021-07-17
3172021001,JAKARTA UTARA,TANJUNG PRIOK,TANJUNG PRIOK,34316,19739,14577,3883,18460,2021-07-17
3174011002,JAKARTA SELATAN,TEBET,TEBET BARAT,21164,11403,9761,4297,14058,2021-07-17
3174011001,JAKARTA SELATAN,TEBET,TEBET TIMUR,18030,9340,8690,3886,12576,2021-07-17
3173061003,JAKARTA BARAT,KALI DERES,TEGAL ALUR,82647,53390,29257,6955,36212,2021-07-17
3174031004,JAKARTA SELATAN,MAMPANG PRAPATAN,TEGAL PARANG,32174,21055,11119,3387,14506,2021-07-17
3173021003,JAKARTA BARAT,GROGOL PETAMBURAN,TOMANG,28665,15596,13069,5065,18134,2021-07-17
3172031005,JAKARTA UTARA,KOJA,TUGU SELATAN,38749,25286,13463,3890,17353,2021-07-17
3172031002,JAKARTA UTARA,KOJA,TUGU UTARA,67211,43295,23916,6871,30787,2021-07-17
3175061006,JAKARTA TIMUR,CAKUNG,UJUNG MENTENG,29527,17712,11815,4054,15869,2021-07-17
3174101005,JAKARTA SELATAN,PESANGGRAHAN,ULUJAMI,40120,26053,14067,5023,19090,2021-07-17
3175011006,JAKARTA TIMUR,MATRAMAN,UTAN KAYU SELATAN,33233,19633,13600,5172,18772,2021-07-17
3175011002,JAKARTA TIMUR,MATRAMAN,UTAN KAYU UTARA,27995,16920,11075,3896,14971,2021-07-17
3171031008,JAKARTA PUSAT,KEMAYORAN,UTAN PANJANG,29260,19398,9862,2856,12718,2021-07-17
3172021007,JAKARTA UTARA,TANJUNG PRIOK,WARAKAS,43754,26067,17687,5319,23006,2021-07-17
3173021007,JAKARTA BARAT,GROGOL PETAMBURAN,WIJAYA KUSUMA,38584,23885,14699,4944,19643,2021-07-17
3172051003,JAKARTA UTARA,PADEMANGAN,ANCOL,24516,15485,9031,3375,12406,2021-07-18
3173041007,JAKARTA BARAT,TAMBORA,ANGKE,29988,17587,12401,3303,15704,2021-07-18
3175041005,JAKARTA TIMUR,KRAMAT JATI,BALE KAMBANG,29564,21161,8403,2762,11165,2021-07-18
3175031003,JAKARTA TIMUR,JATINEGARA,BALI MESTER,9926,6164,3762,1574,5336,2021-07-18
3175101006,JAKARTA TIMUR,CIPAYUNG,BAMBU APUS,26760,17025,9735,4122,13857,2021-07-18
3174031002,JAKARTA SELATAN,MAMPANG PRAPATAN,BANGKA,21936,13165,8771,2811,11582,2021-07-18
3175051002,JAKARTA TIMUR,PASAR REBO,BARU,24449,13218,11231,4947,16178,2021-07-18
3175041004,JAKARTA TIMUR,KRAMAT JATI,BATU AMPAR,48653,34003,14650,5505,20155,2021-07-18
3171071002,JAKARTA PUSAT,TANAH ABANG,BENDUNGAN HILIR,22126,12725,9401,3689,13090,2021-07-18
3175031002,JAKARTA TIMUR,JATINEGARA,BIDARA CINA,37414,25655,11759,4152,15911,2021-07-18
3174101002,JAKARTA SELATAN,PESANGGRAHAN,BINTARO,53940,33173,20767,7388,28155,2021-07-18
3174011005,JAKARTA SELATAN,TEBET,BUKIT DURI,34879,22160,12719,4108,16827,2021-07-18
3171041006,JAKARTA PUSAT,SENEN,BUNGUR,18681,11124,7557,2861,10418,2021-07-18
3175061007,JAKARTA TIMUR,CAKUNG,CAKUNG BARAT,59152,36316,22836,4170,27006,2021-07-18
3175061004,JAKARTA TIMUR,CAKUNG,CAKUNG TIMUR,59749,36535,23214,6645,29859,2021-07-18
3175041007,JAKARTA TIMUR,KRAMAT JATI,CAWANG,33478,21486,11992,4495,16487,2021-07-18
3175101008,JAKARTA TIMUR,CIPAYUNG,CEGER,19269,12073,7196,2659,9855,2021-07-18
3171031006,JAKARTA PUSAT,KEMAYORAN,CEMPAKA BARU,33463,21558,11905,4159,16064,2021-07-18
3171051002,JAKARTA PUSAT,CEMPAKA PUTIH,CEMPAKA PUTIH BARAT,36637,22953,13684,5149,18833,2021-07-18
3171051001,JAKARTA PUSAT,CEMPAKA PUTIH,CEMPAKA PUTIH TIMUR,24923,14657,10266,4641,14907,2021-07-18
3173011001,JAKARTA BARAT,CENGKARENG,CENGKARENG BARAT,67426,38629,28797,8429,37226,2021-07-18
3173011006,JAKARTA BARAT,CENGKARENG,CENGKARENG TIMUR,82441,50353,32088,8738,40826,2021-07-18
3175091002,JAKARTA TIMUR,CIRACAS,CIBUBUR,67471,39318,28153,9897,38050,2021-07-18
3171011002,JAKARTA PUSAT,GAMBIR,CIDENG,15791,8528,7263,3238,10501,2021-07-18
3174091003,JAKARTA SELATAN,JAGAKARSA,CIGANJUR,39104,23636,15468,5361,20829,2021-07-18
3175051003,JAKARTA TIMUR,PASAR REBO,CIJANTUNG,42211,25084,17127,6471,23598,2021-07-18
3171061003,JAKARTA PUSAT,MENTENG,CIKINI,8507,5396,3111,1407,4518,2021-07-18
3174081006,JAKARTA SELATAN,PANCORAN,CIKOKO,10777,5831,4946,1819,6765,2021-07-18
3174061001,JAKARTA SELATAN,CILANDAK,CILANDAK BARAT,52688,29248,23440,8179,31619,2021-07-18
3174041003,JAKARTA SELATAN,PASAR MINGGU,CILANDAK TIMUR,25805,14631,11174,5135,16309,2021-07-18
3175101002,JAKARTA TIMUR,CIPAYUNG,CILANGKAP,28082,17364,10718,3974,14692,2021-07-18
3175041006,JAKARTA TIMUR,KRAMAT JATI,CILILITAN,40978,27238,13740,5483,19223,2021-07-18
3172041001,JAKARTA UTARA,CILINCING,CILINCING,44480,28415,16065,4101,20166,2021-07-18
3175101001,JAKARTA TIMUR,CIPAYUNG,CIPAYUNG,26659,15330,11329,4381,15710,2021-07-18
3174091006,JAKARTA SELATAN,JAGAKARSA,CIPEDAK,38836,22507,16329,4984,21313,2021-07-18
3174061005,JAKARTA SELATAN,CILANDAK,CIPETE SELATAN,27193,15902,11291,3941,15232,2021-07-18
3174071010,JAKARTA SELATAN,KEBAYORAN BARU,CIPETE UTARA,34795,20111,14684,4243,18927,2021-07-18
3175021003,JAKARTA TIMUR,PULO GADUNG,CIPINANG,40086,24669,15417,6295,21712,2021-07-18
3175031007,JAKARTA TIMUR,JATINEGARA,CIPINANG BESAR SELATAN,35827,24890,10937,4033,14970,2021-07-18
3175031008,JAKARTA TIMUR,JATINEGARA,CIPINANG BESAR UTARA,46246,32555,13691,4307,17998,2021-07-18
3175031005,JAKARTA TIMUR,JATINEGARA,CIPINANG CEMPEDAK,33448,21615,11833,4847,16680,2021-07-18
3175081005,JAKARTA TIMUR,MAKASAR,CIPINANG MELAYU,43095,26159,16936,6567,23503,2021-07-18
3175031006,JAKARTA TIMUR,JATINEGARA,CIPINANG MUARA,56309,37929,18380,7580,25960,2021-07-18
3174051003,JAKARTA SELATAN,KEBAYORAN LAMA,CIPULIR,40688,26107,14581,4926,19507,2021-07-18
3175091001,JAKARTA TIMUR,CIRACAS,CIRACAS,65766,39706,26060,8759,34819,2021-07-18
3175041003,JAKARTA TIMUR,KRAMAT JATI,DUKUH,25034,16021,9013,3626,12639,2021-07-18
3175071001,JAKARTA TIMUR,DUREN SAWIT,DUREN SAWIT,62198,39689,22509,9603,32112,2021-07-18
3174081004,JAKARTA SELATAN,PANCORAN,DUREN TIGA,28806,16768,12038,3967,16005,2021-07-18
3173051005,JAKARTA BARAT,KEBON JERUK,DURI KEPA,61141,33923,27218,10327,37545,2021-07-18
3173011002,JAKARTA BARAT,CENGKARENG,DURI KOSAMBI,79279,49079,30200,8448,38648,2021-07-18
3171011006,JAKARTA PUSAT,GAMBIR,DURI PULO,20155,12781,7374,2399,9773,2021-07-18
3173041011,JAKARTA BARAT,TAMBORA,DURI SELATAN,14548,8318,6230,2407,8637,2021-07-18
3173041003,JAKARTA BARAT,TAMBORA,DURI UTARA,20213,12118,8095,2696,10791,2021-07-18
3171081003,JAKARTA PUSAT,JOHAR BARU,GALUR,18663,10495,8168,2024,10192,2021-07-18
3171011001,JAKARTA PUSAT,GAMBIR,GAMBIR,2284,1217,1067,561,1628,2021-07-18
3174061004,JAKARTA SELATAN,CILANDAK,GANDARIA SELATAN,22496,13399,9097,2929,12026,2021-07-18
3174071009,JAKARTA SELATAN,KEBAYORAN BARU,GANDARIA UTARA,40567,23847,16720,5531,22251,2021-07-18
3175051001,JAKARTA TIMUR,PASAR REBO,GEDONG,36445,22676,13769,5485,19254,2021-07-18
3171071001,JAKARTA PUSAT,TANAH ABANG,GELORA,3205,1907,1298,587,1885,2021-07-18
3173031007,JAKARTA BARAT,TAMAN SARI,GLODOK,7962,3654,4308,2023,6331,2021-07-18
3171061004,JAKARTA PUSAT,MENTENG,GONDANGDIA,4176,2099,2077,1316,3393,2021-07-18
3173021001,JAKARTA BARAT,GROGOL PETAMBURAN,GROGOL,17275,10137,7138,2698,9836,2021-07-18
3174051005,JAKARTA SELATAN,KEBAYORAN LAMA,GROGOL SELATAN,45028,29255,15773,5660,21433,2021-07-18
3174051004,JAKARTA SELATAN,KEBAYORAN LAMA,GROGOL UTARA,43272,27377,15895,6015,21910,2021-07-18
3174021007,JAKARTA SELATAN,SETIA BUDI,GUNTUR,4050,2040,2010,1011,3021,2021-07-18
3174071002,JAKARTA SELATAN,KEBAYORAN BARU,GUNUNG,9604,5212,4392,2107,6499,2021-07-18
3171031005,JAKARTA PUSAT,KEMAYORAN,GUNUNG SAHARI SELATAN,19670,11668,8002,2859,10861,2021-07-18
3171021004,JAKARTA PUSAT,SAWAH BESAR,GUNUNG SAHARI UTARA,17049,8843,8206,3422,11628,2021-07-18
3175081004,JAKARTA TIMUR,MAKASAR,HALIM PERDANA KUSUMAH,29162,13565,15597,9629,25226,2021-07-18
3171031003,JAKARTA PUSAT,KEMAYORAN,HARAPAN MULIA,23137,14736,8401,2754,11155,2021-07-18
3174091001,JAKARTA SELATAN,JAGAKARSA,JAGAKARSA,63301,36299,27002,8805,35807,2021-07-18
3175021007,JAKARTA TIMUR,PULO GADUNG,JATI,33382,20281,13101,5827,18928,2021-07-18
3174041002,JAKARTA SELATAN,PASAR MINGGU,JATI PADANG,38180,22623,15557,6020,21577,2021-07-18
3173071004,JAKARTA BARAT,PALMERAH,JATI PULO,29294,16665,12629,3755,16384,2021-07-18
3175061001,JAKARTA TIMUR,CAKUNG,JATINEGARA,86098,59119,26979,7024,34003,2021-07-18
3175021004,JAKARTA TIMUR,PULO GADUNG,JATINEGARA KAUM,25176,16098,9078,3020,12098,2021-07-18
3173021004,JAKARTA BARAT,GROGOL PETAMBURAN,JELAMBAR,30838,17274,13564,5603,19167,2021-07-18
3173021006,JAKARTA BARAT,GROGOL PETAMBURAN,JELAMBAR BARU,38942,22307,16635,6225,22860,2021-07-18
3173041006,JAKARTA BARAT,TAMBORA,JEMBATAN BESI,29948,21463,8485,2477,10962,2021-07-18
3173041008,JAKARTA BARAT,TAMBORA,JEMBATAN LIMA,21360,13956,7404,2332,9736,2021-07-18
3173081005,JAKARTA BARAT,KEMBANGAN,JOGLO,41569,25625,15944,6140,22084,2021-07-18
3171081001,JAKARTA PUSAT,JOHAR BARU,JOHAR BARU,38335,21670,16665,5503,22168,2021-07-18
3173041002,JAKARTA BARAT,TAMBORA,KALI ANYAR,24342,16549,7793,2291,10084,2021-07-18
3172041004,JAKARTA UTARA,CILINCING,KALIBARU,69169,47182,21987,4446,26433,2021-07-18
3174081002,JAKARTA SELATAN,PANCORAN,KALIBATA,42631,27515,15116,5114,20230,2021-07-18
3173061001,JAKARTA BARAT,KALI DERES,KALIDERES,73863,46633,27230,7783,35013,2021-07-18
3175051004,JAKARTA TIMUR,PASAR REBO,KALISARI,43984,26409,17575,7085,24660,2021-07-18
3173061004,JAKARTA BARAT,KALI DERES,KAMAL,54600,38515,16085,3731,19816,2021-07-18
3172011002,JAKARTA UTARA,PENJARINGAN,KAMAL MUARA,13142,6292,6850,2614,9464,2021-07-18
3171071007,JAKARTA PUSAT,TANAH ABANG,KAMPUNG BALI,11694,7693,4001,1501,5502,2021-07-18
3175031001,JAKARTA TIMUR,JATINEGARA,KAMPUNG MELAYU,26123,18227,7896,2363,10259,2021-07-18
3171081002,JAKARTA PUSAT,JOHAR BARU,KAMPUNG RAWA,21809,11383,10426,2589,13015,2021-07-18
3175041002,JAKARTA TIMUR,KRAMAT JATI,KAMPUNG TENGAH,44823,30893,13930,5435,19365,2021-07-18
3173011005,JAKARTA BARAT,CENGKARENG,KAPUK,137086,91239,45847,9710,55557,2021-07-18
3172011003,JAKARTA UTARA,PENJARINGAN,KAPUK MUARA,36293,19665,16628,6833,23461,2021-07-18
3171021002,JAKARTA PUSAT,SAWAH BESAR,KARANG ANYAR,26348,15815,10533,3443,13976,2021-07-18
3174021004,JAKARTA SELATAN,SETIA BUDI,KARET,9824,5674,4150,1484,5634,2021-07-18
3174021003,JAKARTA SELATAN,SETIA BUDI,KARET KUNINGAN,16354,8873,7481,2416,9897,2021-07-18
3174021002,JAKARTA SELATAN,SETIA BUDI,KARET SEMANGGI,2810,1370,1440,630,2070,2021-07-18
3171071003,JAKARTA PUSAT,TANAH ABANG,KARET TENGSIN,19698,12218,7480,2305,9785,2021-07-18
3171021003,JAKARTA PUSAT,SAWAH BESAR,KARTINI,22812,12979,9833,3527,13360,2021-07-18
3175011003,JAKARTA TIMUR,MATRAMAN,KAYU MANIS,25833,16783,9050,3089,12139,2021-07-18
3175021006,JAKARTA TIMUR,PULO GADUNG,KAYU PUTIH,41550,23516,18034,7345,25379,2021-07-18
3173031006,JAKARTA BARAT,TAMAN SARI,KEAGUNGAN,17729,10263,7466,2053,9519,2021-07-18
3174041007,JAKARTA SELATAN,PASAR MINGGU,KEBAGUSAN,45257,28570,16687,5396,22083,2021-07-18
3174051006,JAKARTA SELATAN,KEBAYORAN LAMA,KEBAYORAN LAMA SELATAN,41965,24343,17622,5992,23614,2021-07-18
3174051001,JAKARTA SELATAN,KEBAYORAN LAMA,KEBAYORAN LAMA UTARA,43328,27523,15805,5414,21219,2021-07-18
3174011004,JAKARTA SELATAN,TEBET,KEBON BARU,35871,21850,14021,5277,19298,2021-07-18
3172021005,JAKARTA UTARA,TANJUNG PRIOK,KEBON BAWANG,52097,30919,21178,7137,28315,2021-07-18
3173051001,JAKARTA BARAT,KEBON JERUK,KEBON JERUK,54764,35484,19280,6988,26268,2021-07-18
3171071006,JAKARTA PUSAT,TANAH ABANG,KEBON KACANG,22000,15001,6999,2689,9688,2021-07-18
3171011005,JAKARTA PUSAT,GAMBIR,KEBON KELAPA,10453,6276,4177,1693,5870,2021-07-18
3171031002,JAKARTA PUSAT,KEMAYORAN,KEBON KOSONG,30679,18909,11770,3587,15357,2021-07-18
3175011005,JAKARTA TIMUR,MATRAMAN,KEBON MANGGIS,16843,9824,7019,2861,9880,2021-07-18
3171071005,JAKARTA PUSAT,TANAH ABANG,KEBON MELATI,33177,23888,9289,2952,12241,2021-07-18
3175081003,JAKARTA TIMUR,MAKASAR,KEBON PALA,47563,30249,17314,6488,23802,2021-07-18
3171061005,JAKARTA PUSAT,MENTENG,KEBON SIRIH,12611,8583,4028,1576,5604,2021-07-18
3173011004,JAKARTA BARAT,CENGKARENG,KEDAUNG KALI ANGKE,33255,17965,15290,3305,18595,2021-07-18
3173051007,JAKARTA BARAT,KEBON JERUK,KEDOYA SELATAN,32647,19186,13461,4746,18207,2021-07-18
3173051006,JAKARTA BARAT,KEBON JERUK,KEDOYA UTARA,46407,26302,20105,7145,27250,2021-07-18
3173051004,JAKARTA BARAT,KEBON JERUK,KELAPA DUA,23936,14899,9037,3242,12279,2021-07-18
3175091003,JAKARTA TIMUR,CIRACAS,KELAPA DUA WETAN,47683,28503,19180,7523,26703,2021-07-18
3172061003,JAKARTA UTARA,KELAPA GADING,KELAPA GADING BARAT,36375,17841,18534,9122,27656,2021-07-18
3172061001,JAKARTA UTARA,KELAPA GADING,KELAPA GADING TIMUR,34089,15254,18835,9376,28211,2021-07-18
3173071005,JAKARTA BARAT,PALMERAH,KEMANGGISAN,32814,19479,13335,5366,18701,2021-07-18
3171031001,JAKARTA PUSAT,KEMAYORAN,KEMAYORAN,21186,12096,9090,2873,11963,2021-07-18
3173081006,JAKARTA BARAT,KEMBANGAN,KEMBANGAN SELATAN,27508,16003,11505,5153,16658,2021-07-18
3173081001,JAKARTA BARAT,KEMBANGAN,KEMBANGAN UTARA,55312,33046,22266,6820,29086,2021-07-18
3171041002,JAKARTA PUSAT,SENEN,KENARI,9820,5541,4279,1787,6066,2021-07-18
3173041005,JAKARTA BARAT,TAMBORA,KERENDANG,20382,12713,7669,2255,9924,2021-07-18
3175071003,JAKARTA TIMUR,DUREN SAWIT,KLENDER,71340,49311,22029,7681,29710,2021-07-18
3172031001,JAKARTA UTARA,KOJA,KOJA,28773,17238,11535,2922,14457,2021-07-18
3173071006,JAKARTA BARAT,PALMERAH,KOTA BAMBU SELATAN,21627,13497,8130,2341,10471,2021-07-18
3173071003,JAKARTA BARAT,PALMERAH,KOTA BAMBU UTARA,25510,16220,9290,2849,12139,2021-07-18
3171041004,JAKARTA PUSAT,SENEN,KRAMAT,29515,19640,9875,3073,12948,2021-07-18
3175041001,JAKARTA TIMUR,KRAMAT JATI,KRAMAT JATI,34814,22162,12652,5208,17860,2021-07-18
3174071003,JAKARTA SELATAN,KEBAYORAN BARU,KRAMAT PELA,14674,8145,6529,2426,8955,2021-07-18
3173031002,JAKARTA BARAT,TAMAN SARI,KRUKUT,19624,11690,7934,2340,10274,2021-07-18
3174031005,JAKARTA SELATAN,MAMPANG PRAPATAN,KUNINGAN BARAT,12986,7361,5625,1569,7194,2021-07-18
3174021008,JAKARTA SELATAN,SETIA BUDI,KUNINGAN TIMUR,6123,3637,2486,1086,3572,2021-07-18
3171041005,JAKARTA PUSAT,SENEN,KWITANG,15805,9580,6225,2134,8359,2021-07-18
3172031003,JAKARTA UTARA,KOJA,LAGOA,60201,38970,21231,5914,27145,2021-07-18
3174061002,JAKARTA SELATAN,CILANDAK,LEBAK BULUS,38208,22687,15521,6133,21654,2021-07-18
3174091004,JAKARTA SELATAN,JAGAKARSA,LENTENG AGUNG,54803,35554,19249,6355,25604,2021-07-18
3175101007,JAKARTA TIMUR,CIPAYUNG,LUBANG BUAYA,64480,39097,25383,8619,34002,2021-07-18
3175081001,JAKARTA TIMUR,MAKASAR,MAKASAR,35054,20960,14094,5091,19185,2021-07-18
3175071006,JAKARTA TIMUR,DUREN SAWIT,MALAKA JAYA,31629,18354,13275,5657,18932,2021-07-18
3175071005,JAKARTA TIMUR,DUREN SAWIT,MALAKA SARI,28114,16094,12020,5563,17583,2021-07-18
3174031001,JAKARTA SELATAN,MAMPANG PRAPATAN,MAMPANG PRAPATAN,18474,11232,7242,2105,9347,2021-07-18
3173031005,JAKARTA BARAT,TAMAN SARI,MANGGA BESAR,7834,3893,3941,1488,5429,2021-07-18
3171021005,JAKARTA PUSAT,SAWAH BESAR,MANGGA DUA SELATAN,28106,16668,11438,3918,15356,2021-07-18
3174011007,JAKARTA SELATAN,TEBET,MANGGARAI,28880,17858,11022,3639,14661,2021-07-18
3174011006,JAKARTA SELATAN,TEBET,MANGGARAI SELATAN,23514,13403,10111,3295,13406,2021-07-18
3173031003,JAKARTA BARAT,TAMAN SARI,MAPHAR,16790,9431,7359,2612,9971,2021-07-18
3172041003,JAKARTA UTARA,CILINCING,MARUNDA,29302,17171,12131,2651,14782,2021-07-18
3174071001,JAKARTA SELATAN,KEBAYORAN BARU,MELAWAI,2710,1294,1416,866,2282,2021-07-18
3171061001,JAKARTA PUSAT,MENTENG,MENTENG,26121,17713,8408,3632,12040,2021-07-18
3174021005,JAKARTA SELATAN,SETIA BUDI,MENTENG ATAS,28407,16265,12142,4138,16280,2021-07-18
3174011003,JAKARTA SELATAN,TEBET,MENTENG DALAM,36669,22527,14142,5354,19496,2021-07-18
3173081003,JAKARTA BARAT,KEMBANGAN,MERUYA SELATAN,32671,20020,12651,4447,17098,2021-07-18
3173081002,JAKARTA BARAT,KEMBANGAN,MERUYA UTARA,44535,26703,17832,7169,25001,2021-07-18
3175101004,JAKARTA TIMUR,CIPAYUNG,MUNJUL,24232,14836,9396,3701,13097,2021-07-18
3172051002,JAKARTA UTARA,PADEMANGAN,PADEMANGAN BARAT,75593,47397,28196,7969,36165,2021-07-18
3172051001,JAKARTA UTARA,PADEMANGAN,PADEMANGAN TIMUR,38344,19880,18464,7054,25518,2021-07-18
3175011004,JAKARTA TIMUR,MATRAMAN,PAL MERIAM,20183,12512,7671,2789,10460,2021-07-18
3173071001,JAKARTA BARAT,PALMERAH,PALMERAH,64057,39290,24767,8243,33010,2021-07-18
3174081001,JAKARTA SELATAN,PANCORAN,PANCORAN,19735,11542,8193,2716,10909,2021-07-18
3172021003,JAKARTA UTARA,TANJUNG PRIOK,PAPANGGO,39919,23609,16310,4879,21189,2021-07-18
3171021001,JAKARTA PUSAT,SAWAH BESAR,PASAR BARU,12302,6166,6136,2771,8907,2021-07-18
3174021006,JAKARTA SELATAN,SETIA BUDI,PASAR MANGGIS,27273,16095,11178,3642,14820,2021-07-18
3174041001,JAKARTA SELATAN,PASAR MINGGU,PASAR MINGGU,25321,15400,9921,4694,14615,2021-07-18
3171041003,JAKARTA PUSAT,SENEN,PASEBAN,24144,14688,9456,3389,12845,2021-07-18
3173061005,JAKARTA BARAT,KALI DERES,PEGADUNGAN,76816,47046,29770,9390,39160,2021-07-18
3171061002,JAKARTA PUSAT,MENTENG,PEGANGSAAN,23978,15782,8196,3043,11239,2021-07-18
3172061002,JAKARTA UTARA,KELAPA GADING,PEGANGSAAN DUA,50849,24341,26508,10773,37281,2021-07-18
3172011004,JAKARTA UTARA,PENJARINGAN,PEJAGALAN,75844,43042,32802,11147,43949,2021-07-18
3174041006,JAKARTA SELATAN,PASAR MINGGU,PEJATEN BARAT,37970,22358,15612,5828,21440,2021-07-18
3174041005,JAKARTA SELATAN,PASAR MINGGU,PEJATEN TIMUR,58725,38248,20477,6410,26887,2021-07-18
3175051005,JAKARTA TIMUR,PASAR REBO,PEKAYON,43973,26241,17732,6333,24065,2021-07-18
3173041009,JAKARTA BARAT,TAMBORA,PEKOJAN,23955,13665,10290,3485,13775,2021-07-18
3174031003,JAKARTA SELATAN,MAMPANG PRAPATAN,PELA MAMPANG,44274,25795,18479,5781,24260,2021-07-18
3174081005,JAKARTA SELATAN,PANCORAN,PENGADEGAN,21857,11430,10427,3456,13883,2021-07-18
3175061003,JAKARTA TIMUR,CAKUNG,PENGGILINGAN,101338,70953,30385,9733,40118,2021-07-18
3172011001,JAKARTA UTARA,PENJARINGAN,PENJARINGAN,90268,58906,31362,8021,39383,2021-07-18
3174101001,JAKARTA SELATAN,PESANGGRAHAN,PESANGGRAHAN,28134,15870,12264,5016,17280,2021-07-18
3171071004,JAKARTA PUSAT,TANAH ABANG,PETAMBURAN,34179,24687,9492,3019,12511,2021-07-18
3174071008,JAKARTA SELATAN,KEBAYORAN BARU,PETOGOGAN,11694,6694,5000,1954,6954,2021-07-18
3171011004,JAKARTA PUSAT,GAMBIR,PETOJO SELATAN,15153,8780,6373,3033,9406,2021-07-18
3171011003,JAKARTA PUSAT,GAMBIR,PETOJO UTARA,17858,10993,6865,2729,9594,2021-07-18
3174101004,JAKARTA SELATAN,PESANGGRAHAN,PETUKANGAN SELATAN,37906,21873,16033,5050,21083,2021-07-18
3174101003,JAKARTA SELATAN,PESANGGRAHAN,PETUKANGAN UTARA,54774,33709,21065,6931,27996,2021-07-18
3175081002,JAKARTA TIMUR,MAKASAR,PINANG RANTI,27705,16726,10979,3595,14574,2021-07-18
3173031008,JAKARTA BARAT,TAMAN SARI,PINANGSIA,10929,5692,5237,1664,6901,2021-07-18
3175011001,JAKARTA TIMUR,MATRAMAN,PISANGAN BARU,32340,21855,10485,3918,14403,2021-07-18
3175021002,JAKARTA TIMUR,PULO GADUNG,PISANGAN TIMUR,41806,25644,16162,5831,21993,2021-07-18
3172011005,JAKARTA UTARA,PENJARINGAN,PLUIT,48343,24715,23628,12564,36192,2021-07-18
3175071002,JAKARTA TIMUR,DUREN SAWIT,PONDOK BAMBU,62810,39443,23367,9270,32637,2021-07-18
3175071004,JAKARTA TIMUR,DUREN SAWIT,PONDOK KELAPA,73257,43590,29667,11406,41073,2021-07-18
3175071007,JAKARTA TIMUR,DUREN SAWIT,PONDOK KOPI,36156,24479,11677,4493,16170,2021-07-18
3174061003,JAKARTA SELATAN,CILANDAK,PONDOK LABU,47200,26672,20528,7116,27644,2021-07-18
3174051002,JAKARTA SELATAN,KEBAYORAN LAMA,PONDOK PINANG,57134,34603,22531,9952,32483,2021-07-18
3175101003,JAKARTA TIMUR,CIPAYUNG,PONDOK RANGGON,25905,16478,9427,3904,13331,2021-07-18
3101011003,KAB.ADM.KEP.SERIBU,KEP. SERIBU UTARA,PULAU HARAPAN,2094,751,1343,677,2020,2021-07-18
3101011002,KAB.ADM.KEP.SERIBU,KEP. SERIBU UTARA,PULAU KELAPA,5596,1999,3597,1089,4686,2021-07-18
3101011001,KAB.ADM.KEP.SERIBU,KEP. SERIBU UTARA,PULAU PANGGANG,5522,1837,3685,1162,4847,2021-07-18
3101021003,KAB.ADM.KEP.SERIBU,KEP. SERIBU SELATAN,PULAU PARI,2801,794,2007,616,2623,2021-07-18
3101021002,KAB.ADM.KEP.SERIBU,KEP. SERIBU SELATAN,PULAU TIDUNG,4634,1595,3039,1135,4174,2021-07-18
3101021001,KAB.ADM.KEP.SERIBU,KEP. SERIBU SELATAN,PULAU UNTUNG JAWA,1964,686,1278,562,1840,2021-07-18
3174071007,JAKARTA SELATAN,KEBAYORAN BARU,PULO,5915,2962,2953,1402,4355,2021-07-18
3175021001,JAKARTA TIMUR,PULO GADUNG,PULO GADUNG,35148,22281,12867,4828,17695,2021-07-18
3175061005,JAKARTA TIMUR,CAKUNG,PULO GEBANG,99227,65107,34120,11020,45140,2021-07-18
3174041004,JAKARTA SELATAN,PASAR MINGGU,RAGUNAN,40292,22837,17455,6015,23470,2021-07-18
3175091005,JAKARTA TIMUR,CIRACAS,RAMBUTAN,37488,25952,11536,4428,15964,2021-07-18
3172031006,JAKARTA UTARA,KOJA,RAWA BADAK SELATAN,43094,28403,14691,4017,18708,2021-07-18
3172031004,JAKARTA UTARA,KOJA,RAWA BADAK UTARA,35127,21508,13619,3956,17575,2021-07-18
3174071005,JAKARTA SELATAN,KEBAYORAN BARU,RAWA BARAT,5701,3031,2670,1364,4034,2021-07-18
3173011003,JAKARTA BARAT,CENGKARENG,RAWA BUAYA,64984,41331,23653,6158,29811,2021-07-18
3175031004,JAKARTA TIMUR,JATINEGARA,RAWA BUNGA,21819,14626,7193,2537,9730,2021-07-18
3174081003,JAKARTA SELATAN,PANCORAN,RAWA JATI,20969,11747,9222,3580,12802,2021-07-18
3175061002,JAKARTA TIMUR,CAKUNG,RAWA TERATE,25254,14796,10458,2185,12643,2021-07-18
3175021005,JAKARTA TIMUR,PULO GADUNG,RAWAMANGUN,38390,23461,14929,6048,20977,2021-07-18
3171051003,JAKARTA PUSAT,CEMPAKA PUTIH,RAWASARI,22583,13454,9129,3625,12754,2021-07-18
3173041010,JAKARTA BARAT,TAMBORA,ROA MALAKA,3527,1657,1870,901,2771,2021-07-18
3172041006,JAKARTA UTARA,CILINCING,ROROTAN,42339,24651,17688,4741,22429,2021-07-18
3174071004,JAKARTA SELATAN,KEBAYORAN BARU,SELONG,2885,1406,1479,900,2379,2021-07-18
3173061002,JAKARTA BARAT,KALI DERES,SEMANAN,72769,49892,22877,5149,28026,2021-07-18
3172041007,JAKARTA UTARA,CILINCING,SEMPER BARAT,70052,39546,30506,9256,39762,2021-07-18
3172041005,JAKARTA UTARA,CILINCING,SEMPER TIMUR,37024,22246,14778,4435,19213,2021-07-18
3174071006,JAKARTA SELATAN,KEBAYORAN BARU,SENAYAN,2848,1719,1129,596,1725,2021-07-18
3171041001,JAKARTA PUSAT,SENEN,SENEN,6994,4029,2965,1219,4184,2021-07-18
3171031004,JAKARTA PUSAT,KEMAYORAN,SERDANG,30405,18537,11868,4008,15876,2021-07-18
3174021001,JAKARTA SELATAN,SETIA BUDI,SETIA BUDI,3094,1764,1330,660,1990,2021-07-18
3175101005,JAKARTA TIMUR,CIPAYUNG,SETU,20870,14121,6749,2755,9504,2021-07-18
3173071002,JAKARTA BARAT,PALMERAH,SLIPI,16902,9628,7274,2790,10064,2021-07-18
3173081004,JAKARTA BARAT,KEMBANGAN,SRENGSENG,46238,29842,16396,6373,22769,2021-07-18
3174091002,JAKARTA SELATAN,JAGAKARSA,SRENGSENG SAWAH,59115,32004,27111,9140,36251,2021-07-18
3173051003,JAKARTA BARAT,KEBON JERUK,SUKABUMI SELATAN,37738,25300,12438,3587,16025,2021-07-18
3173051002,JAKARTA BARAT,KEBON JERUK,SUKABUMI UTARA,38909,26648,12261,4119,16380,2021-07-18
3172041002,JAKARTA UTARA,CILINCING,SUKAPURA,55672,34091,21581,5584,27165,2021-07-18
3171031007,JAKARTA PUSAT,KEMAYORAN,SUMUR BATU,23383,13909,9474,3491,12965,2021-07-18
3172021004,JAKARTA UTARA,TANJUNG PRIOK,SUNGAI BAMBU,30521,17981,12540,3657,16197,2021-07-18
3172021006,JAKARTA UTARA,TANJUNG PRIOK,SUNTER AGUNG,73070,38269,34801,13862,48663,2021-07-18
3172021002,JAKARTA UTARA,TANJUNG PRIOK,SUNTER JAYA,64160,36073,28087,10711,38798,2021-07-18
3175091004,JAKARTA TIMUR,CIRACAS,SUSUKAN,38962,24196,14766,4727,19493,2021-07-18
3173031001,JAKARTA BARAT,TAMAN SARI,TAMAN SARI,14592,8077,6515,2449,8964,2021-07-18
3173041001,JAKARTA BARAT,TAMBORA,TAMBORA,10418,6444,3974,1546,5520,2021-07-18
3173041004,JAKARTA BARAT,TAMBORA,TANAH SEREAL,26808,14486,12322,3985,16307,2021-07-18
3171081004,JAKARTA PUSAT,JOHAR BARU,TANAH TINGGI,38588,22103,16485,4331,20816,2021-07-18
3173031004,JAKARTA BARAT,TAMAN SARI,TANGKI,13569,7642,5927,1955,7882,2021-07-18
3174091005,JAKARTA SELATAN,JAGAKARSA,TANJUNG BARAT,40348,25447,14901,5878,20779,2021-07-18
3173021005,JAKARTA BARAT,GROGOL PETAMBURAN,TANJUNG DUREN SELATAN,25919,13715,12204,4647,16851,2021-07-18
3173021002,JAKARTA BARAT,GROGOL PETAMBURAN,TANJUNG DUREN UTARA,17282,8599,8683,3626,12309,2021-07-18
3172021001,JAKARTA UTARA,TANJUNG PRIOK,TANJUNG PRIOK,35493,20562,14931,3914,18845,2021-07-18
3174011002,JAKARTA SELATAN,TEBET,TEBET BARAT,21575,11678,9897,4331,14228,2021-07-18
3174011001,JAKARTA SELATAN,TEBET,TEBET TIMUR,18498,9625,8873,3915,12788,2021-07-18
3173061003,JAKARTA BARAT,KALI DERES,TEGAL ALUR,85206,55241,29965,7009,36974,2021-07-18
3174031004,JAKARTA SELATAN,MAMPANG PRAPATAN,TEGAL PARANG,32893,21484,11409,3424,14833,2021-07-18
3173021003,JAKARTA BARAT,GROGOL PETAMBURAN,TOMANG,30184,16773,13411,5098,18509,2021-07-18
3172031005,JAKARTA UTARA,KOJA,TUGU SELATAN,40013,26126,13887,3915,17802,2021-07-18
3172031002,JAKARTA UTARA,KOJA,TUGU UTARA,69068,44486,24582,6926,31508,2021-07-18
3175061006,JAKARTA TIMUR,CAKUNG,UJUNG MENTENG,30525,18328,12197,4092,16289,2021-07-18
3174101005,JAKARTA SELATAN,PESANGGRAHAN,ULUJAMI,41325,26858,14467,5068,19535,2021-07-18
3175011006,JAKARTA TIMUR,MATRAMAN,UTAN KAYU SELATAN,34205,20365,13840,5203,19043,2021-07-18
3175011002,JAKARTA TIMUR,MATRAMAN,UTAN KAYU UTARA,28777,17479,11298,3922,15220,2021-07-18
3171031008,JAKARTA PUSAT,KEMAYORAN,UTAN PANJANG,29932,19882,10050,2873,12923,2021-07-18
3172021007,JAKARTA UTARA,TANJUNG PRIOK,WARAKAS,45436,27139,18297,5352,23649,2021-07-18
3173021007,JAKARTA BARAT,GROGOL PETAMBURAN,WIJAYA KUSUMA,39811,24710,15101,4962,20063,2021-07-18
3172051003,JAKARTA UTARA,PADEMANGAN,ANCOL,24516,15345,9171,3399,12570,2021-07-20
3173041007,JAKARTA BARAT,TAMBORA,ANGKE,29988,17402,12586,3331,15917,2021-07-20
3175041005,JAKARTA TIMUR,KRAMAT JATI,BALE KAMBANG,29564,21057,8507,2787,11294,2021-07-20
3175031003,JAKARTA TIMUR,JATINEGARA,BALI MESTER,9926,6122,3804,1588,5392,2021-07-20
3175101006,JAKARTA TIMUR,CIPAYUNG,BAMBU APUS,26760,16772,9988,4149,14137,2021-07-20
3174031002,JAKARTA SELATAN,MAMPANG PRAPATAN,BANGKA,21936,13056,8880,2867,11747,2021-07-20
3175051002,JAKARTA TIMUR,PASAR REBO,BARU,24449,13091,11358,4982,16340,2021-07-20
3175041004,JAKARTA TIMUR,KRAMAT JATI,BATU AMPAR,48653,33779,14874,5545,20419,2021-07-20
3171071002,JAKARTA PUSAT,TANAH ABANG,BENDUNGAN HILIR,22127,12593,9534,3734,13268,2021-07-20
3175031002,JAKARTA TIMUR,JATINEGARA,BIDARA CINA,37414,25478,11936,4202,16138,2021-07-20
3174101002,JAKARTA SELATAN,PESANGGRAHAN,BINTARO,53940,32864,21076,7458,28534,2021-07-20
3174011005,JAKARTA SELATAN,TEBET,BUKIT DURI,34879,21973,12906,4150,17056,2021-07-20
3171041006,JAKARTA PUSAT,SENEN,BUNGUR,18681,11034,7647,2874,10521,2021-07-20
3175061007,JAKARTA TIMUR,CAKUNG,CAKUNG BARAT,59152,35517,23635,4224,27859,2021-07-20
3175061004,JAKARTA TIMUR,CAKUNG,CAKUNG TIMUR,59749,35877,23872,6678,30550,2021-07-20
3175041007,JAKARTA TIMUR,KRAMAT JATI,CAWANG,33478,21323,12155,4538,16693,2021-07-20
3175101008,JAKARTA TIMUR,CIPAYUNG,CEGER,19269,11956,7313,2678,9991,2021-07-20
3171031006,JAKARTA PUSAT,KEMAYORAN,CEMPAKA BARU,33463,21372,12091,4195,16286,2021-07-20
3171051002,JAKARTA PUSAT,CEMPAKA PUTIH,CEMPAKA PUTIH BARAT,36637,22653,13984,5195,19179,2021-07-20
3171051001,JAKARTA PUSAT,CEMPAKA PUTIH,CEMPAKA PUTIH TIMUR,24923,14544,10379,4682,15061,2021-07-20
3173011001,JAKARTA BARAT,CENGKARENG,CENGKARENG BARAT,67426,38291,29135,8501,37636,2021-07-20
3173011006,JAKARTA BARAT,CENGKARENG,CENGKARENG TIMUR,82441,49965,32476,9041,41517,2021-07-20
3175091002,JAKARTA TIMUR,CIRACAS,CIBUBUR,67471,38912,28559,9968,38527,2021-07-20
3171011002,JAKARTA PUSAT,GAMBIR,CIDENG,15791,8470,7321,3266,10587,2021-07-20
3174091003,JAKARTA SELATAN,JAGAKARSA,CIGANJUR,39104,23285,15819,5430,21249,2021-07-20
3175051003,JAKARTA TIMUR,PASAR REBO,CIJANTUNG,42211,24828,17383,6519,23902,2021-07-20
3171061003,JAKARTA PUSAT,MENTENG,CIKINI,8507,5363,3144,1415,4559,2021-07-20
3174081006,JAKARTA SELATAN,PANCORAN,CIKOKO,10777,5804,4973,1853,6826,2021-07-20
3174061001,JAKARTA SELATAN,CILANDAK,CILANDAK BARAT,52688,29043,23645,8413,32058,2021-07-20
3174041003,JAKARTA SELATAN,PASAR MINGGU,CILANDAK TIMUR,25805,14488,11317,5198,16515,2021-07-20
3175101002,JAKARTA TIMUR,CIPAYUNG,CILANGKAP,28082,17138,10944,3992,14936,2021-07-20
3175041006,JAKARTA TIMUR,KRAMAT JATI,CILILITAN,40978,27025,13953,5555,19508,2021-07-20
3172041001,JAKARTA UTARA,CILINCING,CILINCING,44480,28215,16265,4114,20379,2021-07-20
3175101001,JAKARTA TIMUR,CIPAYUNG,CIPAYUNG,26659,15199,11460,4423,15883,2021-07-20
3174091006,JAKARTA SELATAN,JAGAKARSA,CIPEDAK,38836,22250,16586,5069,21655,2021-07-20
3174061005,JAKARTA SELATAN,CILANDAK,CIPETE SELATAN,27193,15791,11402,4020,15422,2021-07-20
3174071010,JAKARTA SELATAN,KEBAYORAN BARU,CIPETE UTARA,34795,19893,14902,4284,19186,2021-07-20
3175021003,JAKARTA TIMUR,PULO GADUNG,CIPINANG,40086,24440,15646,6332,21978,2021-07-20
3175031007,JAKARTA TIMUR,JATINEGARA,CIPINANG BESAR SELATAN,35827,24722,11105,4071,15176,2021-07-20
3175031008,JAKARTA TIMUR,JATINEGARA,CIPINANG BESAR UTARA,46246,32108,14138,4357,18495,2021-07-20
3175031005,JAKARTA TIMUR,JATINEGARA,CIPINANG CEMPEDAK,33448,21492,11956,4879,16835,2021-07-20
3175081005,JAKARTA TIMUR,MAKASAR,CIPINANG MELAYU,43095,25940,17155,6626,23781,2021-07-20
3175031006,JAKARTA TIMUR,JATINEGARA,CIPINANG MUARA,56309,37668,18641,7644,26285,2021-07-20
3174051003,JAKARTA SELATAN,KEBAYORAN LAMA,CIPULIR,40688,25939,14749,4969,19718,2021-07-20
3175091001,JAKARTA TIMUR,CIRACAS,CIRACAS,65766,39059,26707,8813,35520,2021-07-20
3175041003,JAKARTA TIMUR,KRAMAT JATI,DUKUH,25034,15751,9283,3648,12931,2021-07-20
3175071001,JAKARTA TIMUR,DUREN SAWIT,DUREN SAWIT,62198,39405,22793,9686,32479,2021-07-20
3174081004,JAKARTA SELATAN,PANCORAN,DUREN TIGA,28806,16637,12169,4064,16233,2021-07-20
3173051005,JAKARTA BARAT,KEBON JERUK,DURI KEPA,61141,33672,27469,10410,37879,2021-07-20
3173011002,JAKARTA BARAT,CENGKARENG,DURI KOSAMBI,79279,48719,30560,8516,39076,2021-07-20
3171011006,JAKARTA PUSAT,GAMBIR,DURI PULO,20155,12511,7644,2418,10062,2021-07-20
3173041011,JAKARTA BARAT,TAMBORA,DURI SELATAN,14548,8228,6320,2417,8737,2021-07-20
3173041003,JAKARTA BARAT,TAMBORA,DURI UTARA,20213,11908,8305,2713,11018,2021-07-20
3171081003,JAKARTA PUSAT,JOHAR BARU,GALUR,18663,10395,8268,2030,10298,2021-07-20
3171011001,JAKARTA PUSAT,GAMBIR,GAMBIR,2284,1209,1075,561,1636,2021-07-20
3174061004,JAKARTA SELATAN,CILANDAK,GANDARIA SELATAN,22496,13333,9163,3061,12224,2021-07-20
3174071009,JAKARTA SELATAN,KEBAYORAN BARU,GANDARIA UTARA,40567,23658,16909,5584,22493,2021-07-20
3175051001,JAKARTA TIMUR,PASAR REBO,GEDONG,36445,22446,13999,5556,19555,2021-07-20
3171071001,JAKARTA PUSAT,TANAH ABANG,GELORA,3206,1890,1316,591,1907,2021-07-20
3173031007,JAKARTA BARAT,TAMAN SARI,GLODOK,7962,3631,4331,2034,6365,2021-07-20
3171061004,JAKARTA PUSAT,MENTENG,GONDANGDIA,4176,2086,2090,1335,3425,2021-07-20
3173021001,JAKARTA BARAT,GROGOL PETAMBURAN,GROGOL,17275,10032,7243,2712,9955,2021-07-20
3174051005,JAKARTA SELATAN,KEBAYORAN LAMA,GROGOL SELATAN,45028,28845,16183,5724,21907,2021-07-20
3174051004,JAKARTA SELATAN,KEBAYORAN LAMA,GROGOL UTARA,43272,27156,16116,6052,22168,2021-07-20
3174021007,JAKARTA SELATAN,SETIA BUDI,GUNTUR,4050,2034,2016,1018,3034,2021-07-20
3174071002,JAKARTA SELATAN,KEBAYORAN BARU,GUNUNG,9604,5182,4422,2126,6548,2021-07-20
3171031005,JAKARTA PUSAT,KEMAYORAN,GUNUNG SAHARI SELATAN,19670,11550,8120,2891,11011,2021-07-20
3171021004,JAKARTA PUSAT,SAWAH BESAR,GUNUNG SAHARI UTARA,17050,8749,8301,3443,11744,2021-07-20
3175081004,JAKARTA TIMUR,MAKASAR,HALIM PERDANA KUSUMAH,29162,13453,15709,9655,25364,2021-07-20
3171031003,JAKARTA PUSAT,KEMAYORAN,HARAPAN MULIA,23137,14619,8518,2766,11284,2021-07-20
3174091001,JAKARTA SELATAN,JAGAKARSA,JAGAKARSA,63301,35966,27335,9104,36439,2021-07-20
3175021007,JAKARTA TIMUR,PULO GADUNG,JATI,33382,20100,13282,5879,19161,2021-07-20
3174041002,JAKARTA SELATAN,PASAR MINGGU,JATI PADANG,38180,22473,15707,6209,21916,2021-07-20
3173071004,JAKARTA BARAT,PALMERAH,JATI PULO,29294,16515,12779,3776,16555,2021-07-20
3175061001,JAKARTA TIMUR,CAKUNG,JATINEGARA,86098,58253,27845,7151,34996,2021-07-20
3175021004,JAKARTA TIMUR,PULO GADUNG,JATINEGARA KAUM,25176,15811,9365,3046,12411,2021-07-20
3173021004,JAKARTA BARAT,GROGOL PETAMBURAN,JELAMBAR,30838,17093,13745,5644,19389,2021-07-20
3173021006,JAKARTA BARAT,GROGOL PETAMBURAN,JELAMBAR BARU,38942,21978,16964,6276,23240,2021-07-20
3173041006,JAKARTA BARAT,TAMBORA,JEMBATAN BESI,29948,21185,8763,2505,11268,2021-07-20
3173041008,JAKARTA BARAT,TAMBORA,JEMBATAN LIMA,21360,13843,7517,2353,9870,2021-07-20
3173081005,JAKARTA BARAT,KEMBANGAN,JOGLO,41569,25406,16163,6193,22356,2021-07-20
3171081001,JAKARTA PUSAT,JOHAR BARU,JOHAR BARU,38335,21480,16855,5547,22402,2021-07-20
3173041002,JAKARTA BARAT,TAMBORA,KALI ANYAR,24342,16357,7985,2307,10292,2021-07-20
3172041004,JAKARTA UTARA,CILINCING,KALIBARU,69169,46927,22242,4461,26703,2021-07-20
3174081002,JAKARTA SELATAN,PANCORAN,KALIBATA,42631,27406,15225,5285,20510,2021-07-20
3173061001,JAKARTA BARAT,KALI DERES,KALIDERES,73863,46055,27808,7847,35655,2021-07-20
3175051004,JAKARTA TIMUR,PASAR REBO,KALISARI,43984,26072,17912,7133,25045,2021-07-20
3173061004,JAKARTA BARAT,KALI DERES,KAMAL,54600,37773,16827,3752,20579,2021-07-20
3172011002,JAKARTA UTARA,PENJARINGAN,KAMAL MUARA,13142,6186,6956,2630,9586,2021-07-20
3171071007,JAKARTA PUSAT,TANAH ABANG,KAMPUNG BALI,11694,7657,4037,1507,5544,2021-07-20
3175031001,JAKARTA TIMUR,JATINEGARA,KAMPUNG MELAYU,26123,18073,8050,2379,10429,2021-07-20
3171081002,JAKARTA PUSAT,JOHAR BARU,KAMPUNG RAWA,21809,11282,10527,2598,13125,2021-07-20
3175041002,JAKARTA TIMUR,KRAMAT JATI,KAMPUNG TENGAH,44823,30703,14120,5468,19588,2021-07-20
3173011005,JAKARTA BARAT,CENGKARENG,KAPUK,137086,88892,48194,9819,58013,2021-07-20
3172011003,JAKARTA UTARA,PENJARINGAN,KAPUK MUARA,36293,19362,16931,6880,23811,2021-07-20
3171021002,JAKARTA PUSAT,SAWAH BESAR,KARANG ANYAR,26348,15606,10742,3458,14200,2021-07-20
3174021004,JAKARTA SELATAN,SETIA BUDI,KARET,9824,5644,4180,1510,5690,2021-07-20
3174021003,JAKARTA SELATAN,SETIA BUDI,KARET KUNINGAN,16356,8773,7583,2444,10027,2021-07-20
3174021002,JAKARTA SELATAN,SETIA BUDI,KARET SEMANGGI,2810,1364,1446,648,2094,2021-07-20
3171071003,JAKARTA PUSAT,TANAH ABANG,KARET TENGSIN,19698,12045,7653,2333,9986,2021-07-20
3171021003,JAKARTA PUSAT,SAWAH BESAR,KARTINI,22812,12809,10003,3542,13545,2021-07-20
3175011003,JAKARTA TIMUR,MATRAMAN,KAYU MANIS,25833,16639,9194,3121,12315,2021-07-20
3175021006,JAKARTA TIMUR,PULO GADUNG,KAYU PUTIH,41550,23290,18260,7398,25658,2021-07-20
3173031006,JAKARTA BARAT,TAMAN SARI,KEAGUNGAN,17729,10140,7589,2062,9651,2021-07-20
3174041007,JAKARTA SELATAN,PASAR MINGGU,KEBAGUSAN,45257,28324,16933,5667,22600,2021-07-20
3174051006,JAKARTA SELATAN,KEBAYORAN LAMA,KEBAYORAN LAMA SELATAN,41965,24179,17786,6058,23844,2021-07-20
3174051001,JAKARTA SELATAN,KEBAYORAN LAMA,KEBAYORAN LAMA UTARA,43328,27284,16044,5477,21521,2021-07-20
3174011004,JAKARTA SELATAN,TEBET,KEBON BARU,35871,21625,14246,5330,19576,2021-07-20
3172021005,JAKARTA UTARA,TANJUNG PRIOK,KEBON BAWANG,52097,30680,21417,7167,28584,2021-07-20
3173051001,JAKARTA BARAT,KEBON JERUK,KEBON JERUK,54764,35259,19505,7047,26552,2021-07-20
3171071006,JAKARTA PUSAT,TANAH ABANG,KEBON KACANG,22000,14876,7124,2710,9834,2021-07-20
3171011005,JAKARTA PUSAT,GAMBIR,KEBON KELAPA,10453,6142,4311,1700,6011,2021-07-20
3171031002,JAKARTA PUSAT,KEMAYORAN,KEBON KOSONG,30679,18727,11952,3605,15557,2021-07-20
3175011005,JAKARTA TIMUR,MATRAMAN,KEBON MANGGIS,16843,9696,7147,2886,10033,2021-07-20
3171071005,JAKARTA PUSAT,TANAH ABANG,KEBON MELATI,33178,23742,9436,2977,12413,2021-07-20
3175081003,JAKARTA TIMUR,MAKASAR,KEBON PALA,47563,29875,17688,6527,24215,2021-07-20
3171061005,JAKARTA PUSAT,MENTENG,KEBON SIRIH,12611,8530,4081,1604,5685,2021-07-20
3173011004,JAKARTA BARAT,CENGKARENG,KEDAUNG KALI ANGKE,33255,17729,15526,3331,18857,2021-07-20
3173051007,JAKARTA BARAT,KEBON JERUK,KEDOYA SELATAN,32647,18977,13670,4785,18455,2021-07-20
3173051006,JAKARTA BARAT,KEBON JERUK,KEDOYA UTARA,46407,26031,20376,7207,27583,2021-07-20
3173051004,JAKARTA BARAT,KEBON JERUK,KELAPA DUA,23936,14793,9143,3266,12409,2021-07-20
3175091003,JAKARTA TIMUR,CIRACAS,KELAPA DUA WETAN,47683,28055,19628,7563,27191,2021-07-20
3172061003,JAKARTA UTARA,KELAPA GADING,KELAPA GADING BARAT,36375,17669,18706,9166,27872,2021-07-20
3172061001,JAKARTA UTARA,KELAPA GADING,KELAPA GADING TIMUR,34089,15149,18940,9440,28380,2021-07-20
3173071005,JAKARTA BARAT,PALMERAH,KEMANGGISAN,32814,19273,13541,5399,18940,2021-07-20
3171031001,JAKARTA PUSAT,KEMAYORAN,KEMAYORAN,21186,12007,9179,2892,12071,2021-07-20
3173081006,JAKARTA BARAT,KEMBANGAN,KEMBANGAN SELATAN,27508,15848,11660,5182,16842,2021-07-20
3173081001,JAKARTA BARAT,KEMBANGAN,KEMBANGAN UTARA,55312,32656,22656,6880,29536,2021-07-20
3171041002,JAKARTA PUSAT,SENEN,KENARI,9820,5503,4317,1792,6109,2021-07-20
3173041005,JAKARTA BARAT,TAMBORA,KERENDANG,20382,12531,7851,2272,10123,2021-07-20
3175071003,JAKARTA TIMUR,DUREN SAWIT,KLENDER,71340,48866,22474,7746,30220,2021-07-20
3172031001,JAKARTA UTARA,KOJA,KOJA,28773,17046,11727,2947,14674,2021-07-20
3173071006,JAKARTA BARAT,PALMERAH,KOTA BAMBU SELATAN,21627,13307,8320,2362,10682,2021-07-20
3173071003,JAKARTA BARAT,PALMERAH,KOTA BAMBU UTARA,25510,16054,9456,2866,12322,2021-07-20
3171041004,JAKARTA PUSAT,SENEN,KRAMAT,29515,19487,10028,3088,13116,2021-07-20
3175041001,JAKARTA TIMUR,KRAMAT JATI,KRAMAT JATI,34814,21961,12853,5245,18098,2021-07-20
3174071003,JAKARTA SELATAN,KEBAYORAN BARU,KRAMAT PELA,14674,8082,6592,2454,9046,2021-07-20
3173031002,JAKARTA BARAT,TAMAN SARI,KRUKUT,19624,11544,8080,2359,10439,2021-07-20
3174031005,JAKARTA SELATAN,MAMPANG PRAPATAN,KUNINGAN BARAT,12986,7308,5678,1635,7313,2021-07-20
3174021008,JAKARTA SELATAN,SETIA BUDI,KUNINGAN TIMUR,6123,3580,2543,1093,3636,2021-07-20
3171041005,JAKARTA PUSAT,SENEN,KWITANG,15805,9532,6273,2148,8421,2021-07-20
3172031003,JAKARTA UTARA,KOJA,LAGOA,60201,38202,21999,5943,27942,2021-07-20
3174061002,JAKARTA SELATAN,CILANDAK,LEBAK BULUS,38208,22455,15753,6297,22050,2021-07-20
3174091004,JAKARTA SELATAN,JAGAKARSA,LENTENG AGUNG,54803,35313,19490,6500,25990,2021-07-20
3175101007,JAKARTA TIMUR,CIPAYUNG,LUBANG BUAYA,64480,38819,25661,8773,34434,2021-07-20
3175081001,JAKARTA TIMUR,MAKASAR,MAKASAR,35054,20757,14297,5108,19405,2021-07-20
3175071006,JAKARTA TIMUR,DUREN SAWIT,MALAKA JAYA,31629,18093,13536,5686,19222,2021-07-20
3175071005,JAKARTA TIMUR,DUREN SAWIT,MALAKA SARI,28114,15985,12129,5602,17731,2021-07-20
3174031001,JAKARTA SELATAN,MAMPANG PRAPATAN,MAMPANG PRAPATAN,18474,11070,7404,2168,9572,2021-07-20
3173031005,JAKARTA BARAT,TAMAN SARI,MANGGA BESAR,7834,3851,3983,1494,5477,2021-07-20
3171021005,JAKARTA PUSAT,SAWAH BESAR,MANGGA DUA SELATAN,28106,16477,11629,3942,15571,2021-07-20
3174011007,JAKARTA SELATAN,TEBET,MANGGARAI,28880,17675,11205,3673,14878,2021-07-20
3174011006,JAKARTA SELATAN,TEBET,MANGGARAI SELATAN,23514,13308,10206,3313,13519,2021-07-20
3173031003,JAKARTA BARAT,TAMAN SARI,MAPHAR,16790,9336,7454,2632,10086,2021-07-20
3172041003,JAKARTA UTARA,CILINCING,MARUNDA,29302,17039,12263,2667,14930,2021-07-20
3174071001,JAKARTA SELATAN,KEBAYORAN BARU,MELAWAI,2710,1291,1419,870,2289,2021-07-20
3171061001,JAKARTA PUSAT,MENTENG,MENTENG,26121,17442,8679,3673,12352,2021-07-20
3174021005,JAKARTA SELATAN,SETIA BUDI,MENTENG ATAS,28407,16142,12265,4182,16447,2021-07-20
3174011003,JAKARTA SELATAN,TEBET,MENTENG DALAM,36669,22392,14277,5418,19695,2021-07-20
3173081003,JAKARTA BARAT,KEMBANGAN,MERUYA SELATAN,32671,19866,12805,4481,17286,2021-07-20
3173081002,JAKARTA BARAT,KEMBANGAN,MERUYA UTARA,44535,26484,18051,7218,25269,2021-07-20
3175101004,JAKARTA TIMUR,CIPAYUNG,MUNJUL,24232,14675,9557,3716,13273,2021-07-20
3172051002,JAKARTA UTARA,PADEMANGAN,PADEMANGAN BARAT,75593,46501,29092,8022,37114,2021-07-20
3172051001,JAKARTA UTARA,PADEMANGAN,PADEMANGAN TIMUR,38344,19655,18689,7087,25776,2021-07-20
3175011004,JAKARTA TIMUR,MATRAMAN,PAL MERIAM,20183,12422,7761,2810,10571,2021-07-20
3173071001,JAKARTA BARAT,PALMERAH,PALMERAH,64057,38846,25211,8321,33532,2021-07-20
3174081001,JAKARTA SELATAN,PANCORAN,PANCORAN,19735,11423,8312,2824,11136,2021-07-20
3172021003,JAKARTA UTARA,TANJUNG PRIOK,PAPANGGO,39919,23415,16504,4905,21409,2021-07-20
3171021001,JAKARTA PUSAT,SAWAH BESAR,PASAR BARU,12302,6116,6186,2777,8963,2021-07-20
3174021006,JAKARTA SELATAN,SETIA BUDI,PASAR MANGGIS,27273,15966,11307,3668,14975,2021-07-20
3174041001,JAKARTA SELATAN,PASAR MINGGU,PASAR MINGGU,25321,15191,10130,4770,14900,2021-07-20
3171041003,JAKARTA PUSAT,SENEN,PASEBAN,24144,14505,9639,3410,13049,2021-07-20
3173061005,JAKARTA BARAT,KALI DERES,PEGADUNGAN,76816,46595,30221,9478,39699,2021-07-20
3171061002,JAKARTA PUSAT,MENTENG,PEGANGSAAN,23978,15662,8316,3066,11382,2021-07-20
3172061002,JAKARTA UTARA,KELAPA GADING,PEGANGSAAN DUA,50849,24114,26735,10851,37586,2021-07-20
3172011004,JAKARTA UTARA,PENJARINGAN,PEJAGALAN,75844,42405,33439,11242,44681,2021-07-20
3174041006,JAKARTA SELATAN,PASAR MINGGU,PEJATEN BARAT,37970,22233,15737,5918,21655,2021-07-20
3174041005,JAKARTA SELATAN,PASAR MINGGU,PEJATEN TIMUR,58725,38039,20686,6724,27410,2021-07-20
3175051005,JAKARTA TIMUR,PASAR REBO,PEKAYON,43973,25865,18108,6361,24469,2021-07-20
3173041009,JAKARTA BARAT,TAMBORA,PEKOJAN,23955,13504,10451,3533,13984,2021-07-20
3174031003,JAKARTA SELATAN,MAMPANG PRAPATAN,PELA MAMPANG,44274,25539,18735,5863,24598,2021-07-20
3174081005,JAKARTA SELATAN,PANCORAN,PENGADEGAN,21857,11386,10471,3588,14059,2021-07-20
3175061003,JAKARTA TIMUR,CAKUNG,PENGGILINGAN,101338,69744,31594,9828,41422,2021-07-20
3172011001,JAKARTA UTARA,PENJARINGAN,PENJARINGAN,90268,58301,31967,8070,40037,2021-07-20
3174101001,JAKARTA SELATAN,PESANGGRAHAN,PESANGGRAHAN,28134,15684,12450,5061,17511,2021-07-20
3171071004,JAKARTA PUSAT,TANAH ABANG,PETAMBURAN,34179,24415,9764,3052,12816,2021-07-20
3174071008,JAKARTA SELATAN,KEBAYORAN BARU,PETOGOGAN,11694,6655,5039,1978,7017,2021-07-20
3171011004,JAKARTA PUSAT,GAMBIR,PETOJO SELATAN,15153,8711,6442,3053,9495,2021-07-20
3171011003,JAKARTA PUSAT,GAMBIR,PETOJO UTARA,17858,10920,6938,2747,9685,2021-07-20
3174101004,JAKARTA SELATAN,PESANGGRAHAN,PETUKANGAN SELATAN,37906,21739,16167,5111,21278,2021-07-20
3174101003,JAKARTA SELATAN,PESANGGRAHAN,PETUKANGAN UTARA,54774,33579,21195,7099,28294,2021-07-20
3175081002,JAKARTA TIMUR,MAKASAR,PINANG RANTI,27705,16554,11151,3615,14766,2021-07-20
3173031008,JAKARTA BARAT,TAMAN SARI,PINANGSIA,10929,5645,5284,1687,6971,2021-07-20
3175011001,JAKARTA TIMUR,MATRAMAN,PISANGAN BARU,32340,21612,10728,3949,14677,2021-07-20
3175021002,JAKARTA TIMUR,PULO GADUNG,PISANGAN TIMUR,41806,25413,16393,5856,22249,2021-07-20
3172011005,JAKARTA UTARA,PENJARINGAN,PLUIT,48343,24550,23793,12629,36422,2021-07-20
3175071002,JAKARTA TIMUR,DUREN SAWIT,PONDOK BAMBU,62810,39167,23643,9342,32985,2021-07-20
3175071004,JAKARTA TIMUR,DUREN SAWIT,PONDOK KELAPA,73257,43223,30034,11503,41537,2021-07-20
3175071007,JAKARTA TIMUR,DUREN SAWIT,PONDOK KOPI,36156,24270,11886,4528,16414,2021-07-20
3174061003,JAKARTA SELATAN,CILANDAK,PONDOK LABU,47200,26356,20844,7353,28197,2021-07-20
3174051002,JAKARTA SELATAN,KEBAYORAN LAMA,PONDOK PINANG,57134,34382,22752,10037,32789,2021-07-20
3175101003,JAKARTA TIMUR,CIPAYUNG,PONDOK RANGGON,25905,16337,9568,3918,13486,2021-07-20
3101011003,KAB.ADM.KEP.SERIBU,KEP. SERIBU UTARA,PULAU HARAPAN,2094,750,1344,678,2022,2021-07-20
3101011002,KAB.ADM.KEP.SERIBU,KEP. SERIBU UTARA,PULAU KELAPA,5596,1991,3605,1089,4694,2021-07-20
3101011001,KAB.ADM.KEP.SERIBU,KEP. SERIBU UTARA,PULAU PANGGANG,5522,1829,3693,1162,4855,2021-07-20
3101021003,KAB.ADM.KEP.SERIBU,KEP. SERIBU SELATAN,PULAU PARI,2801,793,2008,616,2624,2021-07-20
3101021002,KAB.ADM.KEP.SERIBU,KEP. SERIBU SELATAN,PULAU TIDUNG,4634,1577,3057,1136,4193,2021-07-20
3101021001,KAB.ADM.KEP.SERIBU,KEP. SERIBU SELATAN,PULAU UNTUNG JAWA,1964,686,1278,562,1840,2021-07-20
3174071007,JAKARTA SELATAN,KEBAYORAN BARU,PULO,5915,2944,2971,1414,4385,2021-07-20
3175021001,JAKARTA TIMUR,PULO GADUNG,PULO GADUNG,35148,22038,13110,4872,17982,2021-07-20
3175061005,JAKARTA TIMUR,CAKUNG,PULO GEBANG,99227,63655,35572,11113,46685,2021-07-20
3174041004,JAKARTA SELATAN,PASAR MINGGU,RAGUNAN,40292,22642,17650,6187,23837,2021-07-20
3175091005,JAKARTA TIMUR,CIRACAS,RAMBUTAN,37488,25657,11831,4463,16294,2021-07-20
3172031006,JAKARTA UTARA,KOJA,RAWA BADAK SELATAN,43094,28180,14914,4039,18953,2021-07-20
3172031004,JAKARTA UTARA,KOJA,RAWA BADAK UTARA,35127,21383,13744,3973,17717,2021-07-20
3174071005,JAKARTA SELATAN,KEBAYORAN BARU,RAWA BARAT,5701,3006,2695,1373,4068,2021-07-20
3173011003,JAKARTA BARAT,CENGKARENG,RAWA BUAYA,64984,40728,24256,6344,30600,2021-07-20
3175031004,JAKARTA TIMUR,JATINEGARA,RAWA BUNGA,21819,14538,7281,2555,9836,2021-07-20
3174081003,JAKARTA SELATAN,PANCORAN,RAWA JATI,20969,11698,9271,3658,12929,2021-07-20
3175061002,JAKARTA TIMUR,CAKUNG,RAWA TERATE,25254,14647,10607,2198,12805,2021-07-20
3175021005,JAKARTA TIMUR,PULO GADUNG,RAWAMANGUN,38390,23250,15140,6089,21229,2021-07-20
3171051003,JAKARTA PUSAT,CEMPAKA PUTIH,RAWASARI,22583,13324,9259,3658,12917,2021-07-20
3173041010,JAKARTA BARAT,TAMBORA,ROA MALAKA,3527,1642,1885,913,2798,2021-07-20
3172041006,JAKARTA UTARA,CILINCING,ROROTAN,42339,24471,17868,4768,22636,2021-07-20
3174071004,JAKARTA SELATAN,KEBAYORAN BARU,SELONG,2885,1394,1491,906,2397,2021-07-20
3173061002,JAKARTA BARAT,KALI DERES,SEMANAN,72769,49234,23535,5202,28737,2021-07-20
3172041007,JAKARTA UTARA,CILINCING,SEMPER BARAT,70052,39192,30860,9281,40141,2021-07-20
3172041005,JAKARTA UTARA,CILINCING,SEMPER TIMUR,37024,22117,14907,4447,19354,2021-07-20
3174071006,JAKARTA SELATAN,KEBAYORAN BARU,SENAYAN,2848,1709,1139,601,1740,2021-07-20
3171041001,JAKARTA PUSAT,SENEN,SENEN,6994,4012,2982,1224,4206,2021-07-20
3171031004,JAKARTA PUSAT,KEMAYORAN,SERDANG,30405,18337,12068,4024,16092,2021-07-20
3174021001,JAKARTA SELATAN,SETIA BUDI,SETIA BUDI,3094,1738,1356,662,2018,2021-07-20
3175101005,JAKARTA TIMUR,CIPAYUNG,SETU,20870,14021,6849,2770,9619,2021-07-20
3173071002,JAKARTA BARAT,PALMERAH,SLIPI,16902,9520,7382,2813,10195,2021-07-20
3173081004,JAKARTA BARAT,KEMBANGAN,SRENGSENG,46238,29635,16603,6445,23048,2021-07-20
3174091002,JAKARTA SELATAN,JAGAKARSA,SRENGSENG SAWAH,59115,31757,27358,9351,36709,2021-07-20
3173051003,JAKARTA BARAT,KEBON JERUK,SUKABUMI SELATAN,37738,25123,12615,3623,16238,2021-07-20
3173051002,JAKARTA BARAT,KEBON JERUK,SUKABUMI UTARA,38909,26511,12398,4154,16552,2021-07-20
3172041002,JAKARTA UTARA,CILINCING,SUKAPURA,55672,33781,21891,5612,27503,2021-07-20
3171031007,JAKARTA PUSAT,KEMAYORAN,SUMUR BATU,23383,13768,9615,3509,13124,2021-07-20
3172021004,JAKARTA UTARA,TANJUNG PRIOK,SUNGAI BAMBU,30521,17801,12720,3670,16390,2021-07-20
3172021006,JAKARTA UTARA,TANJUNG PRIOK,SUNTER AGUNG,73070,37883,35187,13932,49119,2021-07-20
3172021002,JAKARTA UTARA,TANJUNG PRIOK,SUNTER JAYA,64160,35651,28509,10771,39280,2021-07-20
3175091004,JAKARTA TIMUR,CIRACAS,SUSUKAN,38962,23902,15060,4767,19827,2021-07-20
3173031001,JAKARTA BARAT,TAMAN SARI,TAMAN SARI,14592,8029,6563,2458,9021,2021-07-20
3173041001,JAKARTA BARAT,TAMBORA,TAMBORA,10418,6368,4050,1563,5613,2021-07-20
3173041004,JAKARTA BARAT,TAMBORA,TANAH SEREAL,26808,14336,12472,4003,16475,2021-07-20
3171081004,JAKARTA PUSAT,JOHAR BARU,TANAH TINGGI,38588,21884,16704,4358,21062,2021-07-20
3173031004,JAKARTA BARAT,TAMAN SARI,TANGKI,13569,7567,6002,1963,7965,2021-07-20
3174091005,JAKARTA SELATAN,JAGAKARSA,TANJUNG BARAT,40348,25283,15065,5943,21008,2021-07-20
3173021005,JAKARTA BARAT,GROGOL PETAMBURAN,TANJUNG DUREN SELATAN,25919,13631,12288,4674,16962,2021-07-20
3173021002,JAKARTA BARAT,GROGOL PETAMBURAN,TANJUNG DUREN UTARA,17282,8542,8740,3652,12392,2021-07-20
3172021001,JAKARTA UTARA,TANJUNG PRIOK,TANJUNG PRIOK,35493,20370,15123,3929,19052,2021-07-20
3174011002,JAKARTA SELATAN,TEBET,TEBET BARAT,21575,11604,9971,4392,14363,2021-07-20
3174011001,JAKARTA SELATAN,TEBET,TEBET TIMUR,18498,9584,8914,3952,12866,2021-07-20
3173061003,JAKARTA BARAT,KALI DERES,TEGAL ALUR,85206,54425,30781,7077,37858,2021-07-20
3174031004,JAKARTA SELATAN,MAMPANG PRAPATAN,TEGAL PARANG,32893,21313,11580,3510,15090,2021-07-20
3173021003,JAKARTA BARAT,GROGOL PETAMBURAN,TOMANG,30184,16507,13677,5124,18801,2021-07-20
3172031005,JAKARTA UTARA,KOJA,TUGU SELATAN,40013,25907,14106,3929,18035,2021-07-20
3172031002,JAKARTA UTARA,KOJA,TUGU UTARA,69068,44019,25049,6988,32037,2021-07-20
3175061006,JAKARTA TIMUR,CAKUNG,UJUNG MENTENG,30525,18067,12458,4119,16577,2021-07-20
3174101005,JAKARTA SELATAN,PESANGGRAHAN,ULUJAMI,41325,26705,14620,5117,19737,2021-07-20
3175011006,JAKARTA TIMUR,MATRAMAN,UTAN KAYU SELATAN,34205,20151,14054,5239,19293,2021-07-20
3175011002,JAKARTA TIMUR,MATRAMAN,UTAN KAYU UTARA,28777,17341,11436,3950,15386,2021-07-20
3171031008,JAKARTA PUSAT,KEMAYORAN,UTAN PANJANG,29932,19577,10355,2892,13247,2021-07-20
3172021007,JAKARTA UTARA,TANJUNG PRIOK,WARAKAS,45436,26827,18609,5371,23980,2021-07-20
3173021007,JAKARTA BARAT,GROGOL PETAMBURAN,WIJAYA KUSUMA,39811,24420,15391,4997,20388,2021-07-20
3172051003,JAKARTA UTARA,PADEMANGAN,ANCOL,24516,14505,10011,3400,13411,2021-07-21
3173041007,JAKARTA BARAT,TAMBORA,ANGKE,29988,16256,13732,3331,17063,2021-07-21
3175041005,JAKARTA TIMUR,KRAMAT JATI,BALE KAMBANG,29564,20689,8875,2787,11662,2021-07-21
3175031003,JAKARTA TIMUR,JATINEGARA,BALI MESTER,9926,5896,4030,1588,5618,2021-07-21
3175101006,JAKARTA TIMUR,CIPAYUNG,BAMBU APUS,26760,16318,10442,4150,14592,2021-07-21
3174031002,JAKARTA SELATAN,MAMPANG PRAPATAN,BANGKA,21936,12150,9786,2867,12653,2021-07-21
3175051002,JAKARTA TIMUR,PASAR REBO,BARU,24449,11846,12603,4984,17587,2021-07-21
3175041004,JAKARTA TIMUR,KRAMAT JATI,BATU AMPAR,48653,32945,15708,5546,21254,2021-07-21
3171071002,JAKARTA PUSAT,TANAH ABANG,BENDUNGAN HILIR,22127,11858,10269,3734,14003,2021-07-21
3175031002,JAKARTA TIMUR,JATINEGARA,BIDARA CINA,37414,24743,12671,4202,16873,2021-07-21
3174101002,JAKARTA SELATAN,PESANGGRAHAN,BINTARO,53940,30651,23289,7458,30747,2021-07-21
3174011005,JAKARTA SELATAN,TEBET,BUKIT DURI,34879,20862,14017,4150,18167,2021-07-21
3171041006,JAKARTA PUSAT,SENEN,BUNGUR,18681,10367,8314,2874,11188,2021-07-21
3175061007,JAKARTA TIMUR,CAKUNG,CAKUNG BARAT,59152,32766,26386,4224,30610,2021-07-21
3175061004,JAKARTA TIMUR,CAKUNG,CAKUNG TIMUR,59749,34093,25656,6679,32335,2021-07-21
3175041007,JAKARTA TIMUR,KRAMAT JATI,CAWANG,33478,20643,12835,4539,17374,2021-07-21
3175101008,JAKARTA TIMUR,CIPAYUNG,CEGER,19269,11645,7624,2678,10302,2021-07-21
3171031006,JAKARTA PUSAT,KEMAYORAN,CEMPAKA BARU,33463,20361,13102,4195,17297,2021-07-21
3171051002,JAKARTA PUSAT,CEMPAKA PUTIH,CEMPAKA PUTIH BARAT,36637,21183,15454,5195,20649,2021-07-21
3171051001,JAKARTA PUSAT,CEMPAKA PUTIH,CEMPAKA PUTIH TIMUR,24923,13685,11238,4682,15920,2021-07-21
3173011001,JAKARTA BARAT,CENGKARENG,CENGKARENG BARAT,67426,36607,30819,8501,39320,2021-07-21
3173011006,JAKARTA BARAT,CENGKARENG,CENGKARENG TIMUR,82441,48184,34257,9041,43298,2021-07-21
3175091002,JAKARTA TIMUR,CIRACAS,CIBUBUR,67471,36062,31409,9968,41377,2021-07-21
3171011002,JAKARTA PUSAT,GAMBIR,CIDENG,15791,8049,7742,3266,11008,2021-07-21
3174091003,JAKARTA SELATAN,JAGAKARSA,CIGANJUR,39104,21622,17482,5430,22912,2021-07-21
3175051003,JAKARTA TIMUR,PASAR REBO,CIJANTUNG,42211,23430,18781,6519,25300,2021-07-21
3171061003,JAKARTA PUSAT,MENTENG,CIKINI,8507,5167,3340,1415,4755,2021-07-21
3174081006,JAKARTA SELATAN,PANCORAN,CIKOKO,10777,5290,5487,1853,7340,2021-07-21
3174061001,JAKARTA SELATAN,CILANDAK,CILANDAK BARAT,52688,26503,26185,8413,34598,2021-07-21
3174041003,JAKARTA SELATAN,PASAR MINGGU,CILANDAK TIMUR,25805,13464,12341,5198,17539,2021-07-21
3175101002,JAKARTA TIMUR,CIPAYUNG,CILANGKAP,28082,16426,11656,3993,15649,2021-07-21
3175041006,JAKARTA TIMUR,KRAMAT JATI,CILILITAN,40978,26242,14736,5555,20291,2021-07-21
3172041001,JAKARTA UTARA,CILINCING,CILINCING,44480,26092,18388,4114,22502,2021-07-21
3175101001,JAKARTA TIMUR,CIPAYUNG,CIPAYUNG,26659,14571,12088,4424,16512,2021-07-21
3174091006,JAKARTA SELATAN,JAGAKARSA,CIPEDAK,38836,20124,18712,5069,23781,2021-07-21
3174061005,JAKARTA SELATAN,CILANDAK,CIPETE SELATAN,27193,14538,12655,4020,16675,2021-07-21
3174071010,JAKARTA SELATAN,KEBAYORAN BARU,CIPETE UTARA,34795,18365,16430,4284,20714,2021-07-21
3175021003,JAKARTA TIMUR,PULO GADUNG,CIPINANG,40086,23355,16731,6333,23064,2021-07-21
3175031007,JAKARTA TIMUR,JATINEGARA,CIPINANG BESAR SELATAN,35827,23884,11943,4071,16014,2021-07-21
3175031008,JAKARTA TIMUR,JATINEGARA,CIPINANG BESAR UTARA,46246,31660,14586,4358,18944,2021-07-21
3175031005,JAKARTA TIMUR,JATINEGARA,CIPINANG CEMPEDAK,33448,20704,12744,4879,17623,2021-07-21
3175081005,JAKARTA TIMUR,MAKASAR,CIPINANG MELAYU,43095,24862,18233,6626,24859,2021-07-21
3175031006,JAKARTA TIMUR,JATINEGARA,CIPINANG MUARA,56309,36603,19706,7646,27352,2021-07-21
3174051003,JAKARTA SELATAN,KEBAYORAN LAMA,CIPULIR,40688,24896,15792,4970,20762,2021-07-21
3175091001,JAKARTA TIMUR,CIRACAS,CIRACAS,65766,36571,29195,8816,38011,2021-07-21
3175041003,JAKARTA TIMUR,KRAMAT JATI,DUKUH,25034,15373,9661,3648,13309,2021-07-21
3175071001,JAKARTA TIMUR,DUREN SAWIT,DUREN SAWIT,62198,37810,24388,9687,34075,2021-07-21
3174081004,JAKARTA SELATAN,PANCORAN,DUREN TIGA,28806,15336,13470,4065,17535,2021-07-21
3173051005,JAKARTA BARAT,KEBON JERUK,DURI KEPA,61141,31362,29779,10410,40189,2021-07-21
3173011002,JAKARTA BARAT,CENGKARENG,DURI KOSAMBI,79279,46997,32282,8516,40798,2021-07-21
3171011006,JAKARTA PUSAT,GAMBIR,DURI PULO,20155,11886,8269,2418,10687,2021-07-21
3173041011,JAKARTA BARAT,TAMBORA,DURI SELATAN,14548,7735,6813,2417,9230,2021-07-21
3173041003,JAKARTA BARAT,TAMBORA,DURI UTARA,20213,11192,9021,2713,11734,2021-07-21
3171081003,JAKARTA PUSAT,JOHAR BARU,GALUR,18663,9559,9104,2030,11134,2021-07-21
3171011001,JAKARTA PUSAT,GAMBIR,GAMBIR,2284,1148,1136,561,1697,2021-07-21
3174061004,JAKARTA SELATAN,CILANDAK,GANDARIA SELATAN,22496,12531,9965,3061,13026,2021-07-21
3174071009,JAKARTA SELATAN,KEBAYORAN BARU,GANDARIA UTARA,40567,22261,18306,5584,23890,2021-07-21
3175051001,JAKARTA TIMUR,PASAR REBO,GEDONG,36445,21110,15335,5557,20892,2021-07-21
3171071001,JAKARTA PUSAT,TANAH ABANG,GELORA,3206,1804,1402,591,1993,2021-07-21
3173031007,JAKARTA BARAT,TAMAN SARI,GLODOK,7962,3369,4593,2034,6627,2021-07-21
3171061004,JAKARTA PUSAT,MENTENG,GONDANGDIA,4176,1972,2204,1335,3539,2021-07-21
3173021001,JAKARTA BARAT,GROGOL PETAMBURAN,GROGOL,17275,9360,7915,2712,10627,2021-07-21
3174051005,JAKARTA SELATAN,KEBAYORAN LAMA,GROGOL SELATAN,45028,27635,17393,5725,23118,2021-07-21
3174051004,JAKARTA SELATAN,KEBAYORAN LAMA,GROGOL UTARA,43272,26109,17163,6052,23215,2021-07-21
3174021007,JAKARTA SELATAN,SETIA BUDI,GUNTUR,4050,1909,2141,1018,3159,2021-07-21
3174071002,JAKARTA SELATAN,KEBAYORAN BARU,GUNUNG,9604,4841,4763,2126,6889,2021-07-21
3171031005,JAKARTA PUSAT,KEMAYORAN,GUNUNG SAHARI SELATAN,19670,10938,8732,2891,11623,2021-07-21
3171021004,JAKARTA PUSAT,SAWAH BESAR,GUNUNG SAHARI UTARA,17050,8147,8903,3443,12346,2021-07-21
3175081004,JAKARTA TIMUR,MAKASAR,HALIM PERDANA KUSUMAH,29162,11613,17549,9657,27206,2021-07-21
3171031003,JAKARTA PUSAT,KEMAYORAN,HARAPAN MULIA,23137,13827,9310,2766,12076,2021-07-21
3174091001,JAKARTA SELATAN,JAGAKARSA,JAGAKARSA,63301,33212,30089,9104,39193,2021-07-21
3175021007,JAKARTA TIMUR,PULO GADUNG,JATI,33382,19165,14217,5879,20096,2021-07-21
3174041002,JAKARTA SELATAN,PASAR MINGGU,JATI PADANG,38180,20981,17199,6210,23409,2021-07-21
3173071004,JAKARTA BARAT,PALMERAH,JATI PULO,29294,15432,13862,3776,17638,2021-07-21
3175061001,JAKARTA TIMUR,CAKUNG,JATINEGARA,86098,56599,29499,7152,36651,2021-07-21
3175021004,JAKARTA TIMUR,PULO GADUNG,JATINEGARA KAUM,25176,15225,9951,3046,12997,2021-07-21
3173021004,JAKARTA BARAT,GROGOL PETAMBURAN,JELAMBAR,30838,16169,14669,5644,20313,2021-07-21
3173021006,JAKARTA BARAT,GROGOL PETAMBURAN,JELAMBAR BARU,38942,20764,18178,6276,24454,2021-07-21
3173041006,JAKARTA BARAT,TAMBORA,JEMBATAN BESI,29948,20395,9553,2505,12058,2021-07-21
3173041008,JAKARTA BARAT,TAMBORA,JEMBATAN LIMA,21360,13235,8125,2353,10478,2021-07-21
3173081005,JAKARTA BARAT,KEMBANGAN,JOGLO,41569,24183,17386,6194,23580,2021-07-21
3171081001,JAKARTA PUSAT,JOHAR BARU,JOHAR BARU,38335,20268,18067,5547,23614,2021-07-21
3173041002,JAKARTA BARAT,TAMBORA,KALI ANYAR,24342,15677,8665,2307,10972,2021-07-21
3172041004,JAKARTA UTARA,CILINCING,KALIBARU,69169,43701,25468,4461,29929,2021-07-21
3174081002,JAKARTA SELATAN,PANCORAN,KALIBATA,42631,25962,16669,5285,21954,2021-07-21
3173061001,JAKARTA BARAT,KALI DERES,KALIDERES,73863,43942,29921,7847,37768,2021-07-21
3175051004,JAKARTA TIMUR,PASAR REBO,KALISARI,43984,24694,19290,7133,26423,2021-07-21
3173061004,JAKARTA BARAT,KALI DERES,KAMAL,54600,36631,17969,3753,21722,2021-07-21
3172011002,JAKARTA UTARA,PENJARINGAN,KAMAL MUARA,13142,5357,7785,2630,10415,2021-07-21
3171071007,JAKARTA PUSAT,TANAH ABANG,KAMPUNG BALI,11694,7390,4304,1507,5811,2021-07-21
3175031001,JAKARTA TIMUR,JATINEGARA,KAMPUNG MELAYU,26123,17144,8979,2379,11358,2021-07-21
3171081002,JAKARTA PUSAT,JOHAR BARU,KAMPUNG RAWA,21809,10347,11462,2598,14060,2021-07-21
3175041002,JAKARTA TIMUR,KRAMAT JATI,KAMPUNG TENGAH,44823,29799,15024,5468,20492,2021-07-21
3173011005,JAKARTA BARAT,CENGKARENG,KAPUK,137086,85650,51436,9819,61255,2021-07-21
3172011003,JAKARTA UTARA,PENJARINGAN,KAPUK MUARA,36293,17583,18710,6880,25590,2021-07-21
3171021002,JAKARTA PUSAT,SAWAH BESAR,KARANG ANYAR,26348,14886,11462,3458,14920,2021-07-21
3174021004,JAKARTA SELATAN,SETIA BUDI,KARET,9824,5277,4547,1510,6057,2021-07-21
3174021003,JAKARTA SELATAN,SETIA BUDI,KARET KUNINGAN,16356,8047,8309,2445,10754,2021-07-21
3174021002,JAKARTA SELATAN,SETIA BUDI,KARET SEMANGGI,2810,1284,1526,648,2174,2021-07-21
3171071003,JAKARTA PUSAT,TANAH ABANG,KARET TENGSIN,19698,11469,8229,2333,10562,2021-07-21
3171021003,JAKARTA PUSAT,SAWAH BESAR,KARTINI,22812,12072,10740,3542,14282,2021-07-21
3175011003,JAKARTA TIMUR,MATRAMAN,KAYU MANIS,25833,15919,9914,3121,13035,2021-07-21
3175021006,JAKARTA TIMUR,PULO GADUNG,KAYU PUTIH,41550,22020,19530,7398,26928,2021-07-21
3173031006,JAKARTA BARAT,TAMAN SARI,KEAGUNGAN,17729,9411,8318,2062,10380,2021-07-21
3174041007,JAKARTA SELATAN,PASAR MINGGU,KEBAGUSAN,45257,26772,18485,5668,24153,2021-07-21
3174051006,JAKARTA SELATAN,KEBAYORAN LAMA,KEBAYORAN LAMA SELATAN,41965,22502,19463,6058,25521,2021-07-21
3174051001,JAKARTA SELATAN,KEBAYORAN LAMA,KEBAYORAN LAMA UTARA,43328,26083,17245,5479,22724,2021-07-21
3174011004,JAKARTA SELATAN,TEBET,KEBON BARU,35871,20146,15725,5331,21056,2021-07-21
3172021005,JAKARTA UTARA,TANJUNG PRIOK,KEBON BAWANG,52097,28345,23752,7167,30919,2021-07-21
3173051001,JAKARTA BARAT,KEBON JERUK,KEBON JERUK,54764,33620,21144,7049,28193,2021-07-21
3171071006,JAKARTA PUSAT,TANAH ABANG,KEBON KACANG,22000,14392,7608,2710,10318,2021-07-21
3171011005,JAKARTA PUSAT,GAMBIR,KEBON KELAPA,10453,5837,4616,1700,6316,2021-07-21
3171031002,JAKARTA PUSAT,KEMAYORAN,KEBON KOSONG,30679,17395,13284,3606,16890,2021-07-21
3175011005,JAKARTA TIMUR,MATRAMAN,KEBON MANGGIS,16843,9119,7724,2886,10610,2021-07-21
3171071005,JAKARTA PUSAT,TANAH ABANG,KEBON MELATI,33178,22899,10279,2977,13256,2021-07-21
3175081003,JAKARTA TIMUR,MAKASAR,KEBON PALA,47563,28816,18747,6527,25274,2021-07-21
3171061005,JAKARTA PUSAT,MENTENG,KEBON SIRIH,12611,8215,4396,1604,6000,2021-07-21
3173011004,JAKARTA BARAT,CENGKARENG,KEDAUNG KALI ANGKE,33255,16465,16790,3331,20121,2021-07-21
3173051007,JAKARTA BARAT,KEBON JERUK,KEDOYA SELATAN,32647,17944,14703,4785,19488,2021-07-21
3173051006,JAKARTA BARAT,KEBON JERUK,KEDOYA UTARA,46407,24433,21974,7207,29181,2021-07-21
3173051004,JAKARTA BARAT,KEBON JERUK,KELAPA DUA,23936,13821,10115,3268,13383,2021-07-21
3175091003,JAKARTA TIMUR,CIRACAS,KELAPA DUA WETAN,47683,26310,21373,7563,28936,2021-07-21
3172061003,JAKARTA UTARA,KELAPA GADING,KELAPA GADING BARAT,36375,15824,20551,9168,29719,2021-07-21
3172061001,JAKARTA UTARA,KELAPA GADING,KELAPA GADING TIMUR,34089,13699,20390,9440,29830,2021-07-21
3173071005,JAKARTA BARAT,PALMERAH,KEMANGGISAN,32814,18286,14528,5399,19927,2021-07-21
3171031001,JAKARTA PUSAT,KEMAYORAN,KEMAYORAN,21186,11301,9885,2893,12778,2021-07-21
3173081006,JAKARTA BARAT,KEMBANGAN,KEMBANGAN SELATAN,27508,15045,12463,5182,17645,2021-07-21
3173081001,JAKARTA BARAT,KEMBANGAN,KEMBANGAN UTARA,55312,31034,24278,6880,31158,2021-07-21
3171041002,JAKARTA PUSAT,SENEN,KENARI,9820,5180,4640,1792,6432,2021-07-21
3173041005,JAKARTA BARAT,TAMBORA,KERENDANG,20382,11796,8586,2272,10858,2021-07-21
3175071003,JAKARTA TIMUR,DUREN SAWIT,KLENDER,71340,47698,23642,7746,31388,2021-07-21
3172031001,JAKARTA UTARA,KOJA,KOJA,28773,15507,13266,2947,16213,2021-07-21
3173071006,JAKARTA BARAT,PALMERAH,KOTA BAMBU SELATAN,21627,12560,9067,2362,11429,2021-07-21
3173071003,JAKARTA BARAT,PALMERAH,KOTA BAMBU UTARA,25510,15356,10154,2866,13020,2021-07-21
3171041004,JAKARTA PUSAT,SENEN,KRAMAT,29515,18646,10869,3088,13957,2021-07-21
3175041001,JAKARTA TIMUR,KRAMAT JATI,KRAMAT JATI,34814,21244,13570,5246,18816,2021-07-21
3174071003,JAKARTA SELATAN,KEBAYORAN BARU,KRAMAT PELA,14674,7521,7153,2454,9607,2021-07-21
3173031002,JAKARTA BARAT,TAMAN SARI,KRUKUT,19624,11058,8566,2359,10925,2021-07-21
3174031005,JAKARTA SELATAN,MAMPANG PRAPATAN,KUNINGAN BARAT,12986,6580,6406,1635,8041,2021-07-21
3174021008,JAKARTA SELATAN,SETIA BUDI,KUNINGAN TIMUR,6123,3356,2767,1093,3860,2021-07-21
3171041005,JAKARTA PUSAT,SENEN,KWITANG,15805,8931,6874,2148,9022,2021-07-21
3172031003,JAKARTA UTARA,KOJA,LAGOA,60201,35782,24419,5944,30363,2021-07-21
3174061002,JAKARTA SELATAN,CILANDAK,LEBAK BULUS,38208,20762,17446,6299,23745,2021-07-21
3174091004,JAKARTA SELATAN,JAGAKARSA,LENTENG AGUNG,54803,33002,21801,6500,28301,2021-07-21
3175101007,JAKARTA TIMUR,CIPAYUNG,LUBANG BUAYA,64480,37422,27058,8775,35833,2021-07-21
3175081001,JAKARTA TIMUR,MAKASAR,MAKASAR,35054,19917,15137,5108,20245,2021-07-21
3175071006,JAKARTA TIMUR,DUREN SAWIT,MALAKA JAYA,31629,16832,14797,5687,20484,2021-07-21
3175071005,JAKARTA TIMUR,DUREN SAWIT,MALAKA SARI,28114,15106,13008,5603,18611,2021-07-21
3174031001,JAKARTA SELATAN,MAMPANG PRAPATAN,MAMPANG PRAPATAN,18474,10209,8265,2168,10433,2021-07-21
3173031005,JAKARTA BARAT,TAMAN SARI,MANGGA BESAR,7834,3546,4288,1494,5782,2021-07-21
3171021005,JAKARTA PUSAT,SAWAH BESAR,MANGGA DUA SELATAN,28106,15640,12466,3942,16408,2021-07-21
3174011007,JAKARTA SELATAN,TEBET,MANGGARAI,28880,16619,12261,3675,15936,2021-07-21
3174011006,JAKARTA SELATAN,TEBET,MANGGARAI SELATAN,23514,12574,10940,3313,14253,2021-07-21
3173031003,JAKARTA BARAT,TAMAN SARI,MAPHAR,16790,8878,7912,2632,10544,2021-07-21
3172041003,JAKARTA UTARA,CILINCING,MARUNDA,29302,15366,13936,2668,16604,2021-07-21
3174071001,JAKARTA SELATAN,KEBAYORAN BARU,MELAWAI,2710,1183,1527,870,2397,2021-07-21
3171061001,JAKARTA PUSAT,MENTENG,MENTENG,26121,16695,9426,3673,13099,2021-07-21
3174021005,JAKARTA SELATAN,SETIA BUDI,MENTENG ATAS,28407,15000,13407,4182,17589,2021-07-21
3174011003,JAKARTA SELATAN,TEBET,MENTENG DALAM,36669,21220,15449,5419,20868,2021-07-21
3173081003,JAKARTA BARAT,KEMBANGAN,MERUYA SELATAN,32671,19175,13496,4481,17977,2021-07-21
3173081002,JAKARTA BARAT,KEMBANGAN,MERUYA UTARA,44535,25281,19254,7218,26472,2021-07-21
3175101004,JAKARTA TIMUR,CIPAYUNG,MUNJUL,24232,14194,10038,3716,13754,2021-07-21
3172051002,JAKARTA UTARA,PADEMANGAN,PADEMANGAN BARAT,75593,43540,32053,8022,40075,2021-07-21
3172051001,JAKARTA UTARA,PADEMANGAN,PADEMANGAN TIMUR,38344,17933,20411,7088,27499,2021-07-21
3175011004,JAKARTA TIMUR,MATRAMAN,PAL MERIAM,20183,11840,8343,2810,11153,2021-07-21
3173071001,JAKARTA BARAT,PALMERAH,PALMERAH,64057,37227,26830,8321,35151,2021-07-21
3174081001,JAKARTA SELATAN,PANCORAN,PANCORAN,19735,10484,9251,2824,12075,2021-07-21
3172021003,JAKARTA UTARA,TANJUNG PRIOK,PAPANGGO,39919,21201,18718,4905,23623,2021-07-21
3171021001,JAKARTA PUSAT,SAWAH BESAR,PASAR BARU,12302,5737,6565,2777,9342,2021-07-21
3174021006,JAKARTA SELATAN,SETIA BUDI,PASAR MANGGIS,27273,14938,12335,3669,16004,2021-07-21
3174041001,JAKARTA SELATAN,PASAR MINGGU,PASAR MINGGU,25321,14249,11072,4770,15842,2021-07-21
3171041003,JAKARTA PUSAT,SENEN,PASEBAN,24144,13680,10464,3410,13874,2021-07-21
3173061005,JAKARTA BARAT,KALI DERES,PEGADUNGAN,76816,43824,32992,9478,42470,2021-07-21
3171061002,JAKARTA PUSAT,MENTENG,PEGANGSAAN,23978,14999,8979,3066,12045,2021-07-21
3172061002,JAKARTA UTARA,KELAPA GADING,PEGANGSAAN DUA,50849,21388,29461,10853,40314,2021-07-21
3172011004,JAKARTA UTARA,PENJARINGAN,PEJAGALAN,75844,39727,36117,11242,47359,2021-07-21
3174041006,JAKARTA SELATAN,PASAR MINGGU,PEJATEN BARAT,37970,20761,17209,5920,23129,2021-07-21
3174041005,JAKARTA SELATAN,PASAR MINGGU,PEJATEN TIMUR,58725,36218,22507,6728,29235,2021-07-21
3175051005,JAKARTA TIMUR,PASAR REBO,PEKAYON,43973,24188,19785,6362,26147,2021-07-21
3173041009,JAKARTA BARAT,TAMBORA,PEKOJAN,23955,12597,11358,3533,14891,2021-07-21
3174031003,JAKARTA SELATAN,MAMPANG PRAPATAN,PELA MAMPANG,44274,23529,20745,5864,26609,2021-07-21
3174081005,JAKARTA SELATAN,PANCORAN,PENGADEGAN,21857,10220,11637,3589,15226,2021-07-21
3175061003,JAKARTA TIMUR,CAKUNG,PENGGILINGAN,101338,67451,33887,9828,43715,2021-07-21
3172011001,JAKARTA UTARA,PENJARINGAN,PENJARINGAN,90268,55241,35027,8070,43097,2021-07-21
3174101001,JAKARTA SELATAN,PESANGGRAHAN,PESANGGRAHAN,28134,14430,13704,5065,18769,2021-07-21
3171071004,JAKARTA PUSAT,TANAH ABANG,PETAMBURAN,34179,23697,10482,3052,13534,2021-07-21
3174071008,JAKARTA SELATAN,KEBAYORAN BARU,PETOGOGAN,11694,6123,5571,1978,7549,2021-07-21
3171011004,JAKARTA PUSAT,GAMBIR,PETOJO SELATAN,15153,8306,6847,3053,9900,2021-07-21
3171011003,JAKARTA PUSAT,GAMBIR,PETOJO UTARA,17858,10534,7324,2747,10071,2021-07-21
3174101004,JAKARTA SELATAN,PESANGGRAHAN,PETUKANGAN SELATAN,37906,20071,17835,5111,22946,2021-07-21
3174101003,JAKARTA SELATAN,PESANGGRAHAN,PETUKANGAN UTARA,54774,31908,22866,7100,29966,2021-07-21
3175081002,JAKARTA TIMUR,MAKASAR,PINANG RANTI,27705,15816,11889,3616,15505,2021-07-21
3173031008,JAKARTA BARAT,TAMAN SARI,PINANGSIA,10929,5144,5785,1687,7472,2021-07-21
3175011001,JAKARTA TIMUR,MATRAMAN,PISANGAN BARU,32340,20857,11483,3949,15432,2021-07-21
3175021002,JAKARTA TIMUR,PULO GADUNG,PISANGAN TIMUR,41806,24476,17330,5856,23186,2021-07-21
3172011005,JAKARTA UTARA,PENJARINGAN,PLUIT,48343,22865,25478,12630,38108,2021-07-21
3175071002,JAKARTA TIMUR,DUREN SAWIT,PONDOK BAMBU,62810,37651,25159,9343,34502,2021-07-21
3175071004,JAKARTA TIMUR,DUREN SAWIT,PONDOK KELAPA,73257,40333,32924,11504,44428,2021-07-21
3175071007,JAKARTA TIMUR,DUREN SAWIT,PONDOK KOPI,36156,23382,12774,4528,17302,2021-07-21
3174061003,JAKARTA SELATAN,CILANDAK,PONDOK LABU,47200,23836,23364,7355,30719,2021-07-21
3174051002,JAKARTA SELATAN,KEBAYORAN LAMA,PONDOK PINANG,57134,32278,24856,10039,34895,2021-07-21
3175101003,JAKARTA TIMUR,CIPAYUNG,PONDOK RANGGON,25905,15750,10155,3918,14073,2021-07-21
3101011003,KAB.ADM.KEP.SERIBU,KEP. SERIBU UTARA,PULAU HARAPAN,2094,577,1517,678,2195,2021-07-21
3101011002,KAB.ADM.KEP.SERIBU,KEP. SERIBU UTARA,PULAU KELAPA,5596,1476,4120,1089,5209,2021-07-21
3101011001,KAB.ADM.KEP.SERIBU,KEP. SERIBU UTARA,PULAU PANGGANG,5522,1313,4209,1162,5371,2021-07-21
3101021003,KAB.ADM.KEP.SERIBU,KEP. SERIBU SELATAN,PULAU PARI,2801,510,2291,616,2907,2021-07-21
3101021002,KAB.ADM.KEP.SERIBU,KEP. SERIBU SELATAN,PULAU TIDUNG,4634,1098,3536,1136,4672,2021-07-21
3101021001,KAB.ADM.KEP.SERIBU,KEP. SERIBU SELATAN,PULAU UNTUNG JAWA,1964,530,1434,562,1996,2021-07-21
3174071007,JAKARTA SELATAN,KEBAYORAN BARU,PULO,5915,2719,3196,1414,4610,2021-07-21
3175021001,JAKARTA TIMUR,PULO GADUNG,PULO GADUNG,35148,21054,14094,4874,18968,2021-07-21
3175061005,JAKARTA TIMUR,CAKUNG,PULO GEBANG,99227,60381,38846,11116,49962,2021-07-21
3174041004,JAKARTA SELATAN,PASAR MINGGU,RAGUNAN,40292,21028,19264,6187,25451,2021-07-21
3175091005,JAKARTA TIMUR,CIRACAS,RAMBUTAN,37488,24722,12766,4464,17230,2021-07-21
3172031006,JAKARTA UTARA,KOJA,RAWA BADAK SELATAN,43094,26325,16769,4039,20808,2021-07-21
3172031004,JAKARTA UTARA,KOJA,RAWA BADAK UTARA,35127,19481,15646,3973,19619,2021-07-21
3174071005,JAKARTA SELATAN,KEBAYORAN BARU,RAWA BARAT,5701,2812,2889,1374,4263,2021-07-21
3173011003,JAKARTA BARAT,CENGKARENG,RAWA BUAYA,64984,39370,25614,6346,31960,2021-07-21
3175031004,JAKARTA TIMUR,JATINEGARA,RAWA BUNGA,21819,13894,7925,2555,10480,2021-07-21
3174081003,JAKARTA SELATAN,PANCORAN,RAWA JATI,20969,10824,10145,3659,13804,2021-07-21
3175061002,JAKARTA TIMUR,CAKUNG,RAWA TERATE,25254,13519,11735,2198,13933,2021-07-21
3175021005,JAKARTA TIMUR,PULO GADUNG,RAWAMANGUN,38390,22213,16177,6090,22267,2021-07-21
3171051003,JAKARTA PUSAT,CEMPAKA PUTIH,RAWASARI,22583,12546,10037,3658,13695,2021-07-21
3173041010,JAKARTA BARAT,TAMBORA,ROA MALAKA,3527,1514,2013,913,2926,2021-07-21
3172041006,JAKARTA UTARA,CILINCING,ROROTAN,42339,22200,20139,4768,24907,2021-07-21
3174071004,JAKARTA SELATAN,KEBAYORAN BARU,SELONG,2885,1298,1587,906,2493,2021-07-21
3173061002,JAKARTA BARAT,KALI DERES,SEMANAN,72769,47701,25068,5202,30270,2021-07-21
3172041007,JAKARTA UTARA,CILINCING,SEMPER BARAT,70052,35034,35018,9282,44300,2021-07-21
3172041005,JAKARTA UTARA,CILINCING,SEMPER TIMUR,37024,20294,16730,4447,21177,2021-07-21
3174071006,JAKARTA SELATAN,KEBAYORAN BARU,SENAYAN,2848,1635,1213,601,1814,2021-07-21
3171041001,JAKARTA PUSAT,SENEN,SENEN,6994,3709,3285,1224,4509,2021-07-21
3171031004,JAKARTA PUSAT,KEMAYORAN,SERDANG,30405,17276,13129,4024,17153,2021-07-21
3174021001,JAKARTA SELATAN,SETIA BUDI,SETIA BUDI,3094,1646,1448,662,2110,2021-07-21
3175101005,JAKARTA TIMUR,CIPAYUNG,SETU,20870,13600,7270,2770,10040,2021-07-21
3173071002,JAKARTA BARAT,PALMERAH,SLIPI,16902,8842,8060,2813,10873,2021-07-21
3173081004,JAKARTA BARAT,KEMBANGAN,SRENGSENG,46238,28127,18111,6447,24558,2021-07-21
3174091002,JAKARTA SELATAN,JAGAKARSA,SRENGSENG SAWAH,59115,28745,30370,9352,39722,2021-07-21
3173051003,JAKARTA BARAT,KEBON JERUK,SUKABUMI SELATAN,37738,23938,13800,3623,17423,2021-07-21
3173051002,JAKARTA BARAT,KEBON JERUK,SUKABUMI UTARA,38909,25364,13545,4155,17700,2021-07-21
3172041002,JAKARTA UTARA,CILINCING,SUKAPURA,55672,30919,24753,5612,30365,2021-07-21
3171031007,JAKARTA PUSAT,KEMAYORAN,SUMUR BATU,23383,12992,10391,3509,13900,2021-07-21
3172021004,JAKARTA UTARA,TANJUNG PRIOK,SUNGAI BAMBU,30521,16177,14344,3670,18014,2021-07-21
3172021006,JAKARTA UTARA,TANJUNG PRIOK,SUNTER AGUNG,73070,34463,38607,13933,52540,2021-07-21
3172021002,JAKARTA UTARA,TANJUNG PRIOK,SUNTER JAYA,64160,32838,31322,10773,42095,2021-07-21
3175091004,JAKARTA TIMUR,CIRACAS,SUSUKAN,38962,22840,16122,4767,20889,2021-07-21
3173031001,JAKARTA BARAT,TAMAN SARI,TAMAN SARI,14592,7562,7030,2458,9488,2021-07-21
3173041001,JAKARTA BARAT,TAMBORA,TAMBORA,10418,6100,4318,1563,5881,2021-07-21
3173041004,JAKARTA BARAT,TAMBORA,TANAH SEREAL,26808,13394,13414,4003,17417,2021-07-21
3171081004,JAKARTA PUSAT,JOHAR BARU,TANAH TINGGI,38588,19756,18832,4358,23190,2021-07-21
3173031004,JAKARTA BARAT,TAMAN SARI,TANGKI,13569,7055,6514,1963,8477,2021-07-21
3174091005,JAKARTA SELATAN,JAGAKARSA,TANJUNG BARAT,40348,23828,16520,5945,22465,2021-07-21
3173021005,JAKARTA BARAT,GROGOL PETAMBURAN,TANJUNG DUREN SELATAN,25919,12678,13241,4674,17915,2021-07-21
3173021002,JAKARTA BARAT,GROGOL PETAMBURAN,TANJUNG DUREN UTARA,17282,7837,9445,3652,13097,2021-07-21
3172021001,JAKARTA UTARA,TANJUNG PRIOK,TANJUNG PRIOK,35493,18388,17105,3929,21034,2021-07-21
3174011002,JAKARTA SELATAN,TEBET,TEBET BARAT,21575,10725,10850,4392,15242,2021-07-21
3174011001,JAKARTA SELATAN,TEBET,TEBET TIMUR,18498,8698,9800,3954,13754,2021-07-21
3173061003,JAKARTA BARAT,KALI DERES,TEGAL ALUR,85206,52270,32936,7077,40013,2021-07-21
3174031004,JAKARTA SELATAN,MAMPANG PRAPATAN,TEGAL PARANG,32893,20042,12851,3511,16362,2021-07-21
3173021003,JAKARTA BARAT,GROGOL PETAMBURAN,TOMANG,30184,15353,14831,5124,19955,2021-07-21
3172031005,JAKARTA UTARA,KOJA,TUGU SELATAN,40013,24050,15963,3929,19892,2021-07-21
3172031002,JAKARTA UTARA,KOJA,TUGU UTARA,69068,41031,28037,6988,35025,2021-07-21
3175061006,JAKARTA TIMUR,CAKUNG,UJUNG MENTENG,30525,16942,13583,4120,17703,2021-07-21
3174101005,JAKARTA SELATAN,PESANGGRAHAN,ULUJAMI,41325,25581,15744,5118,20862,2021-07-21
3175011006,JAKARTA TIMUR,MATRAMAN,UTAN KAYU SELATAN,34205,18953,15252,5239,20491,2021-07-21
3175011002,JAKARTA TIMUR,MATRAMAN,UTAN KAYU UTARA,28777,16459,12318,3951,16269,2021-07-21
3171031008,JAKARTA PUSAT,KEMAYORAN,UTAN PANJANG,29932,18489,11443,2893,14336,2021-07-21
3172021007,JAKARTA UTARA,TANJUNG PRIOK,WARAKAS,45436,24458,20978,5371,26349,2021-07-21
3173021007,JAKARTA BARAT,GROGOL PETAMBURAN,WIJAYA KUSUMA,39811,23338,16473,4998,21471,2021-07-21
3172051003,JAKARTA UTARA,PADEMANGAN,ANCOL,24516,14348,10168,3415,13583,2021-07-22
3173041007,JAKARTA BARAT,TAMBORA,ANGKE,29988,16069,13919,3366,17285,2021-07-22
3175041005,JAKARTA TIMUR,KRAMAT JATI,BALE KAMBANG,29564,20574,8990,2814,11804,2021-07-22
3175031003,JAKARTA TIMUR,JATINEGARA,BALI MESTER,9926,5842,4084,1607,5691,2021-07-22
3175101006,JAKARTA TIMUR,CIPAYUNG,BAMBU APUS,26760,16102,10658,4175,14833,2021-07-22
3174031002,JAKARTA SELATAN,MAMPANG PRAPATAN,BANGKA,21936,12045,9891,2991,12882,2021-07-22
3175051002,JAKARTA TIMUR,PASAR REBO,BARU,24449,11722,12727,5053,17780,2021-07-22
3175041004,JAKARTA TIMUR,KRAMAT JATI,BATU AMPAR,48653,32776,15877,5632,21509,2021-07-22
3171071002,JAKARTA PUSAT,TANAH ABANG,BENDUNGAN HILIR,22127,11733,10394,3770,14164,2021-07-22
3175031002,JAKARTA TIMUR,JATINEGARA,BIDARA CINA,37414,24542,12872,4269,17141,2021-07-22
3174101002,JAKARTA SELATAN,PESANGGRAHAN,BINTARO,53940,30300,23640,7624,31264,2021-07-22
3174011005,JAKARTA SELATAN,TEBET,BUKIT DURI,34879,20631,14248,4406,18654,2021-07-22
3171041006,JAKARTA PUSAT,SENEN,BUNGUR,18681,10283,8398,2939,11337,2021-07-22
3175061007,JAKARTA TIMUR,CAKUNG,CAKUNG BARAT,59152,32399,26753,4435,31188,2021-07-22
3175061004,JAKARTA TIMUR,CAKUNG,CAKUNG TIMUR,59749,33303,26446,7089,33535,2021-07-22
3175041007,JAKARTA TIMUR,KRAMAT JATI,CAWANG,33478,20475,13003,4576,17579,2021-07-22
3175101008,JAKARTA TIMUR,CIPAYUNG,CEGER,19269,11539,7730,2706,10436,2021-07-22
3171031006,JAKARTA PUSAT,KEMAYORAN,CEMPAKA BARU,33463,20227,13236,4360,17596,2021-07-22
3171051002,JAKARTA PUSAT,CEMPAKA PUTIH,CEMPAKA PUTIH BARAT,36637,20966,15671,5258,20929,2021-07-22
3171051001,JAKARTA PUSAT,CEMPAKA PUTIH,CEMPAKA PUTIH TIMUR,24923,13533,11390,4726,16116,2021-07-22
3173011001,JAKARTA BARAT,CENGKARENG,CENGKARENG BARAT,67426,36040,31386,8963,40349,2021-07-22
3173011006,JAKARTA BARAT,CENGKARENG,CENGKARENG TIMUR,82441,47695,34746,9387,44133,2021-07-22
3175091002,JAKARTA TIMUR,CIRACAS,CIBUBUR,67471,35594,31877,10227,42104,2021-07-22
3171011002,JAKARTA PUSAT,GAMBIR,CIDENG,15791,7976,7815,3292,11107,2021-07-22
3174091003,JAKARTA SELATAN,JAGAKARSA,CIGANJUR,39104,21271,17833,5606,23439,2021-07-22
3175051003,JAKARTA TIMUR,PASAR REBO,CIJANTUNG,42211,23174,19037,6607,25644,2021-07-22
3171061003,JAKARTA PUSAT,MENTENG,CIKINI,8507,5042,3465,1437,4902,2021-07-22
3174081006,JAKARTA SELATAN,PANCORAN,CIKOKO,10777,5267,5510,1886,7396,2021-07-22
3174061001,JAKARTA SELATAN,CILANDAK,CILANDAK BARAT,52688,26277,26411,8650,35061,2021-07-22
3174041003,JAKARTA SELATAN,PASAR MINGGU,CILANDAK TIMUR,25805,13303,12502,5286,17788,2021-07-22
3175101002,JAKARTA TIMUR,CIPAYUNG,CILANGKAP,28082,16229,11853,4016,15869,2021-07-22
3175041006,JAKARTA TIMUR,KRAMAT JATI,CILILITAN,40978,26066,14912,5624,20536,2021-07-22
3172041001,JAKARTA UTARA,CILINCING,CILINCING,44480,25902,18578,4145,22723,2021-07-22
3175101001,JAKARTA TIMUR,CIPAYUNG,CIPAYUNG,26659,14447,12212,4456,16668,2021-07-22
3174091006,JAKARTA SELATAN,JAGAKARSA,CIPEDAK,38836,19771,19065,5287,24352,2021-07-22
3174061005,JAKARTA SELATAN,CILANDAK,CIPETE SELATAN,27193,14400,12793,4237,17030,2021-07-22
3174071010,JAKARTA SELATAN,KEBAYORAN BARU,CIPETE UTARA,34795,18119,16676,4400,21076,2021-07-22
3175021003,JAKARTA TIMUR,PULO GADUNG,CIPINANG,40086,23127,16959,6425,23384,2021-07-22
3175031007,JAKARTA TIMUR,JATINEGARA,CIPINANG BESAR SELATAN,35827,23619,12208,4113,16321,2021-07-22
3175031008,JAKARTA TIMUR,JATINEGARA,CIPINANG BESAR UTARA,46246,31288,14958,4414,19372,2021-07-22
3175031005,JAKARTA TIMUR,JATINEGARA,CIPINANG CEMPEDAK,33448,20518,12930,4929,17859,2021-07-22
3175081005,JAKARTA TIMUR,MAKASAR,CIPINANG MELAYU,43095,24508,18587,6701,25288,2021-07-22
3175031006,JAKARTA TIMUR,JATINEGARA,CIPINANG MUARA,56309,36311,19998,7727,27725,2021-07-22
3174051003,JAKARTA SELATAN,KEBAYORAN LAMA,CIPULIR,40688,24696,15992,5031,21023,2021-07-22
3175091001,JAKARTA TIMUR,CIRACAS,CIRACAS,65766,36173,29593,8996,38589,2021-07-22
3175041003,JAKARTA TIMUR,KRAMAT JATI,DUKUH,25034,15172,9862,3705,13567,2021-07-22
3175071001,JAKARTA TIMUR,DUREN SAWIT,DUREN SAWIT,62198,37504,24694,9793,34487,2021-07-22
3174081004,JAKARTA SELATAN,PANCORAN,DUREN TIGA,28806,15256,13550,4244,17794,2021-07-22
3173051005,JAKARTA BARAT,KEBON JERUK,DURI KEPA,61141,31055,30086,10551,40637,2021-07-22
3173011002,JAKARTA BARAT,CENGKARENG,DURI KOSAMBI,79279,46681,32598,8871,41469,2021-07-22
3171011006,JAKARTA PUSAT,GAMBIR,DURI PULO,20155,11695,8460,2461,10921,2021-07-22
3173041011,JAKARTA BARAT,TAMBORA,DURI SELATAN,14548,7538,7010,2439,9449,2021-07-22
3173041003,JAKARTA BARAT,TAMBORA,DURI UTARA,20213,10994,9219,2744,11963,2021-07-22
3171081003,JAKARTA PUSAT,JOHAR BARU,GALUR,18663,9376,9287,2046,11333,2021-07-22
3171011001,JAKARTA PUSAT,GAMBIR,GAMBIR,2284,1140,1144,567,1711,2021-07-22
3174061004,JAKARTA SELATAN,CILANDAK,GANDARIA SELATAN,22496,12460,10036,3203,13239,2021-07-22
3174071009,JAKARTA SELATAN,KEBAYORAN BARU,GANDARIA UTARA,40567,22093,18474,5701,24175,2021-07-22
3175051001,JAKARTA TIMUR,PASAR REBO,GEDONG,36445,20903,15542,5748,21290,2021-07-22
3171071001,JAKARTA PUSAT,TANAH ABANG,GELORA,3206,1794,1412,594,2006,2021-07-22
3173031007,JAKARTA BARAT,TAMAN SARI,GLODOK,7962,3337,4625,2050,6675,2021-07-22
3171061004,JAKARTA PUSAT,MENTENG,GONDANGDIA,4176,1955,2221,1341,3562,2021-07-22
3173021001,JAKARTA BARAT,GROGOL PETAMBURAN,GROGOL,17275,9239,8036,2761,10797,2021-07-22
3174051005,JAKARTA SELATAN,KEBAYORAN LAMA,GROGOL SELATAN,45028,27318,17710,5808,23518,2021-07-22
3174051004,JAKARTA SELATAN,KEBAYORAN LAMA,GROGOL UTARA,43272,25886,17386,6119,23505,2021-07-22
3174021007,JAKARTA SELATAN,SETIA BUDI,GUNTUR,4050,1893,2157,1029,3186,2021-07-22
3174071002,JAKARTA SELATAN,KEBAYORAN BARU,GUNUNG,9604,4799,4805,2171,6976,2021-07-22
3171031005,JAKARTA PUSAT,KEMAYORAN,GUNUNG SAHARI SELATAN,19670,10777,8893,3010,11903,2021-07-22
3171021004,JAKARTA PUSAT,SAWAH BESAR,GUNUNG SAHARI UTARA,17050,8059,8991,3473,12464,2021-07-22
3175081004,JAKARTA TIMUR,MAKASAR,HALIM PERDANA KUSUMAH,29162,11438,17724,9808,27532,2021-07-22
3171031003,JAKARTA PUSAT,KEMAYORAN,HARAPAN MULIA,23137,13715,9422,2834,12256,2021-07-22
3174091001,JAKARTA SELATAN,JAGAKARSA,JAGAKARSA,63301,32583,30718,9489,40207,2021-07-22
3175021007,JAKARTA TIMUR,PULO GADUNG,JATI,33382,19028,14354,5954,20308,2021-07-22
3174041002,JAKARTA SELATAN,PASAR MINGGU,JATI PADANG,38180,20749,17431,6429,23860,2021-07-22
3173071004,JAKARTA BARAT,PALMERAH,JATI PULO,29294,15232,14062,3817,17879,2021-07-22
3175061001,JAKARTA TIMUR,CAKUNG,JATINEGARA,86098,55853,30245,7256,37501,2021-07-22
3175021004,JAKARTA TIMUR,PULO GADUNG,JATINEGARA KAUM,25176,14998,10178,3082,13260,2021-07-22
3173021004,JAKARTA BARAT,GROGOL PETAMBURAN,JELAMBAR,30838,15939,14899,5765,20664,2021-07-22
3173021006,JAKARTA BARAT,GROGOL PETAMBURAN,JELAMBAR BARU,38942,20507,18435,6426,24861,2021-07-22
3173041006,JAKARTA BARAT,TAMBORA,JEMBATAN BESI,29948,20163,9785,2536,12321,2021-07-22
3173041008,JAKARTA BARAT,TAMBORA,JEMBATAN LIMA,21360,13109,8251,2384,10635,2021-07-22
3173081005,JAKARTA BARAT,KEMBANGAN,JOGLO,41569,23855,17714,6260,23974,2021-07-22
3171081001,JAKARTA PUSAT,JOHAR BARU,JOHAR BARU,38335,20081,18254,5598,23852,2021-07-22
3173041002,JAKARTA BARAT,TAMBORA,KALI ANYAR,24342,15406,8936,2327,11263,2021-07-22
3172041004,JAKARTA UTARA,CILINCING,KALIBARU,69169,43349,25820,4485,30305,2021-07-22
3174081002,JAKARTA SELATAN,PANCORAN,KALIBATA,42631,25641,16990,5484,22474,2021-07-22
3173061001,JAKARTA BARAT,KALI DERES,KALIDERES,73863,43352,30511,8073,38584,2021-07-22
3175051004,JAKARTA TIMUR,PASAR REBO,KALISARI,43984,24426,19558,7395,26953,2021-07-22
3173061004,JAKARTA BARAT,KALI DERES,KAMAL,54600,36167,18433,3826,22259,2021-07-22
3172011002,JAKARTA UTARA,PENJARINGAN,KAMAL MUARA,13142,5282,7860,2742,10602,2021-07-22
3171071007,JAKARTA PUSAT,TANAH ABANG,KAMPUNG BALI,11694,7345,4349,1519,5868,2021-07-22
3175031001,JAKARTA TIMUR,JATINEGARA,KAMPUNG MELAYU,26123,16986,9137,2413,11550,2021-07-22
3171081002,JAKARTA PUSAT,JOHAR BARU,KAMPUNG RAWA,21809,10059,11750,2620,14370,2021-07-22
3175041002,JAKARTA TIMUR,KRAMAT JATI,KAMPUNG TENGAH,44823,29658,15165,5553,20718,2021-07-22
3173011005,JAKARTA BARAT,CENGKARENG,KAPUK,137086,84515,52571,10096,62667,2021-07-22
3172011003,JAKARTA UTARA,PENJARINGAN,KAPUK MUARA,36293,17290,19003,7064,26067,2021-07-22
3171021002,JAKARTA PUSAT,SAWAH BESAR,KARANG ANYAR,26348,14673,11675,3496,15171,2021-07-22
3174021004,JAKARTA SELATAN,SETIA BUDI,KARET,9824,5236,4588,1551,6139,2021-07-22
3174021003,JAKARTA SELATAN,SETIA BUDI,KARET KUNINGAN,16356,7979,8377,2509,10886,2021-07-22
3174021002,JAKARTA SELATAN,SETIA BUDI,KARET SEMANGGI,2810,1275,1535,668,2203,2021-07-22
3171071003,JAKARTA PUSAT,TANAH ABANG,KARET TENGSIN,19698,11180,8518,2373,10891,2021-07-22
3171021003,JAKARTA PUSAT,SAWAH BESAR,KARTINI,22812,11903,10909,3581,14490,2021-07-22
3175011003,JAKARTA TIMUR,MATRAMAN,KAYU MANIS,25833,15787,10046,3184,13230,2021-07-22
3175021006,JAKARTA TIMUR,PULO GADUNG,KAYU PUTIH,41550,21817,19733,7643,27376,2021-07-22
3173031006,JAKARTA BARAT,TAMAN SARI,KEAGUNGAN,17729,9286,8443,2081,10524,2021-07-22
3174041007,JAKARTA SELATAN,PASAR MINGGU,KEBAGUSAN,45257,26445,18812,5950,24762,2021-07-22
3174051006,JAKARTA SELATAN,KEBAYORAN LAMA,KEBAYORAN LAMA SELATAN,41965,22306,19659,6143,25802,2021-07-22
3174051001,JAKARTA SELATAN,KEBAYORAN LAMA,KEBAYORAN LAMA UTARA,43328,25874,17454,5550,23004,2021-07-22
3174011004,JAKARTA SELATAN,TEBET,KEBON BARU,35871,19983,15888,5632,21520,2021-07-22
3172021005,JAKARTA UTARA,TANJUNG PRIOK,KEBON BAWANG,52097,28006,24091,7274,31365,2021-07-22
3173051001,JAKARTA BARAT,KEBON JERUK,KEBON JERUK,54764,33336,21428,7121,28549,2021-07-22
3171071006,JAKARTA PUSAT,TANAH ABANG,KEBON KACANG,22000,14312,7688,2740,10428,2021-07-22
3171011005,JAKARTA PUSAT,GAMBIR,KEBON KELAPA,10453,5807,4646,1712,6358,2021-07-22
3171031002,JAKARTA PUSAT,KEMAYORAN,KEBON KOSONG,30679,17256,13423,3747,17170,2021-07-22
3175011005,JAKARTA TIMUR,MATRAMAN,KEBON MANGGIS,16843,9074,7769,2953,10722,2021-07-22
3171071005,JAKARTA PUSAT,TANAH ABANG,KEBON MELATI,33178,22731,10447,3006,13453,2021-07-22
3175081003,JAKARTA TIMUR,MAKASAR,KEBON PALA,47563,28398,19165,6648,25813,2021-07-22
3171061005,JAKARTA PUSAT,MENTENG,KEBON SIRIH,12611,8177,4434,1632,6066,2021-07-22
3173011004,JAKARTA BARAT,CENGKARENG,KEDAUNG KALI ANGKE,33255,15673,17582,3463,21045,2021-07-22
3173051007,JAKARTA BARAT,KEBON JERUK,KEDOYA SELATAN,32647,17720,14927,4844,19771,2021-07-22
3173051006,JAKARTA BARAT,KEBON JERUK,KEDOYA UTARA,46407,24082,22325,7298,29623,2021-07-22
3173051004,JAKARTA BARAT,KEBON JERUK,KELAPA DUA,23936,13729,10207,3300,13507,2021-07-22
3175091003,JAKARTA TIMUR,CIRACAS,KELAPA DUA WETAN,47683,25907,21776,7684,29460,2021-07-22
3172061003,JAKARTA UTARA,KELAPA GADING,KELAPA GADING BARAT,36375,15614,20761,9249,30010,2021-07-22
3172061001,JAKARTA UTARA,KELAPA GADING,KELAPA GADING TIMUR,34089,13600,20489,9521,30010,2021-07-22
3173071005,JAKARTA BARAT,PALMERAH,KEMANGGISAN,32814,18102,14712,5446,20158,2021-07-22
3171031001,JAKARTA PUSAT,KEMAYORAN,KEMAYORAN,21186,11188,9998,2976,12974,2021-07-22
3173081006,JAKARTA BARAT,KEMBANGAN,KEMBANGAN SELATAN,27508,14877,12631,5253,17884,2021-07-22
3173081001,JAKARTA BARAT,KEMBANGAN,KEMBANGAN UTARA,55312,30484,24828,6957,31785,2021-07-22
3171041002,JAKARTA PUSAT,SENEN,KENARI,9820,5157,4663,1810,6473,2021-07-22
3173041005,JAKARTA BARAT,TAMBORA,KERENDANG,20382,11643,8739,2312,11051,2021-07-22
3175071003,JAKARTA TIMUR,DUREN SAWIT,KLENDER,71340,47207,24133,7872,32005,2021-07-22
3172031001,JAKARTA UTARA,KOJA,KOJA,28773,15373,13400,2965,16365,2021-07-22
3173071006,JAKARTA BARAT,PALMERAH,KOTA BAMBU SELATAN,21627,12454,9173,2388,11561,2021-07-22
3173071003,JAKARTA BARAT,PALMERAH,KOTA BAMBU UTARA,25510,15167,10343,2880,13223,2021-07-22
3171041004,JAKARTA PUSAT,SENEN,KRAMAT,29515,18452,11063,3122,14185,2021-07-22
3175041001,JAKARTA TIMUR,KRAMAT JATI,KRAMAT JATI,34814,21086,13728,5291,19019,2021-07-22
3174071003,JAKARTA SELATAN,KEBAYORAN BARU,KRAMAT PELA,14674,7423,7251,2507,9758,2021-07-22
3173031002,JAKARTA BARAT,TAMAN SARI,KRUKUT,19624,10931,8693,2383,11076,2021-07-22
3174031005,JAKARTA SELATAN,MAMPANG PRAPATAN,KUNINGAN BARAT,12986,6548,6438,1749,8187,2021-07-22
3174021008,JAKARTA SELATAN,SETIA BUDI,KUNINGAN TIMUR,6123,3317,2806,1112,3918,2021-07-22
3171041005,JAKARTA PUSAT,SENEN,KWITANG,15805,8807,6998,2201,9199,2021-07-22
3172031003,JAKARTA UTARA,KOJA,LAGOA,60201,35199,25002,5984,30986,2021-07-22
3174061002,JAKARTA SELATAN,CILANDAK,LEBAK BULUS,38208,20543,17665,6552,24217,2021-07-22
3174091004,JAKARTA SELATAN,JAGAKARSA,LENTENG AGUNG,54803,32772,22031,6723,28754,2021-07-22
3175101007,JAKARTA TIMUR,CIPAYUNG,LUBANG BUAYA,64480,36802,27678,8863,36541,2021-07-22
3175081001,JAKARTA TIMUR,MAKASAR,MAKASAR,35054,19589,15465,5238,20703,2021-07-22
3175071006,JAKARTA TIMUR,DUREN SAWIT,MALAKA JAYA,31629,16498,15131,5814,20945,2021-07-22
3175071005,JAKARTA TIMUR,DUREN SAWIT,MALAKA SARI,28114,14733,13381,5658,19039,2021-07-22
3174031001,JAKARTA SELATAN,MAMPANG PRAPATAN,MAMPANG PRAPATAN,18474,10164,8310,2277,10587,2021-07-22
3173031005,JAKARTA BARAT,TAMAN SARI,MANGGA BESAR,7834,3515,4319,1513,5832,2021-07-22
3171021005,JAKARTA PUSAT,SAWAH BESAR,MANGGA DUA SELATAN,28106,15510,12596,3987,16583,2021-07-22
3174011007,JAKARTA SELATAN,TEBET,MANGGARAI,28880,16374,12506,3737,16243,2021-07-22
3174011006,JAKARTA SELATAN,TEBET,MANGGARAI SELATAN,23514,12454,11060,3549,14609,2021-07-22
3173031003,JAKARTA BARAT,TAMAN SARI,MAPHAR,16790,8723,8067,2675,10742,2021-07-22
3172041003,JAKARTA UTARA,CILINCING,MARUNDA,29302,15285,14017,2688,16705,2021-07-22
3174071001,JAKARTA SELATAN,KEBAYORAN BARU,MELAWAI,2710,1176,1534,881,2415,2021-07-22
3171061001,JAKARTA PUSAT,MENTENG,MENTENG,26121,16584,9537,3726,13263,2021-07-22
3174021005,JAKARTA SELATAN,SETIA BUDI,MENTENG ATAS,28407,14841,13566,4261,17827,2021-07-22
3174011003,JAKARTA SELATAN,TEBET,MENTENG DALAM,36669,20992,15677,5594,21271,2021-07-22
3173081003,JAKARTA BARAT,KEMBANGAN,MERUYA SELATAN,32671,18979,13692,4519,18211,2021-07-22
3173081002,JAKARTA BARAT,KEMBANGAN,MERUYA UTARA,44535,25059,19476,7311,26787,2021-07-22
3175101004,JAKARTA TIMUR,CIPAYUNG,MUNJUL,24232,14014,10218,3735,13953,2021-07-22
3172051002,JAKARTA UTARA,PADEMANGAN,PADEMANGAN BARAT,75593,43160,32433,8101,40534,2021-07-22
3172051001,JAKARTA UTARA,PADEMANGAN,PADEMANGAN TIMUR,38344,17650,20694,7167,27861,2021-07-22
3175011004,JAKARTA TIMUR,MATRAMAN,PAL MERIAM,20183,11750,8433,2914,11347,2021-07-22
3173071001,JAKARTA BARAT,PALMERAH,PALMERAH,64057,36724,27333,8432,35765,2021-07-22
3174081001,JAKARTA SELATAN,PANCORAN,PANCORAN,19735,10438,9297,2965,12262,2021-07-22
3172021003,JAKARTA UTARA,TANJUNG PRIOK,PAPANGGO,39919,20948,18971,4941,23912,2021-07-22
3171021001,JAKARTA PUSAT,SAWAH BESAR,PASAR BARU,12302,5693,6609,2797,9406,2021-07-22
3174021006,JAKARTA SELATAN,SETIA BUDI,PASAR MANGGIS,27273,14828,12445,3715,16160,2021-07-22
3174041001,JAKARTA SELATAN,PASAR MINGGU,PASAR MINGGU,25321,14089,11232,4900,16132,2021-07-22
3171041003,JAKARTA PUSAT,SENEN,PASEBAN,24144,13583,10561,3438,13999,2021-07-22
3173061005,JAKARTA BARAT,KALI DERES,PEGADUNGAN,76816,43334,33482,9819,43301,2021-07-22
3171061002,JAKARTA PUSAT,MENTENG,PEGANGSAAN,23978,14881,9097,3109,12206,2021-07-22
3172061002,JAKARTA UTARA,KELAPA GADING,PEGANGSAAN DUA,50849,21119,29730,10967,40697,2021-07-22
3172011004,JAKARTA UTARA,PENJARINGAN,PEJAGALAN,75844,39378,36466,11617,48083,2021-07-22
3174041006,JAKARTA SELATAN,PASAR MINGGU,PEJATEN BARAT,37970,20561,17409,6159,23568,2021-07-22
3174041005,JAKARTA SELATAN,PASAR MINGGU,PEJATEN TIMUR,58725,35974,22751,7035,29786,2021-07-22
3175051005,JAKARTA TIMUR,PASAR REBO,PEKAYON,43973,23764,20209,6452,26661,2021-07-22
3173041009,JAKARTA BARAT,TAMBORA,PEKOJAN,23955,12404,11551,3588,15139,2021-07-22
3174031003,JAKARTA SELATAN,MAMPANG PRAPATAN,PELA MAMPANG,44274,23028,21246,6208,27454,2021-07-22
3174081005,JAKARTA SELATAN,PANCORAN,PENGADEGAN,21857,10157,11700,3798,15498,2021-07-22
3175061003,JAKARTA TIMUR,CAKUNG,PENGGILINGAN,101338,66050,35288,9947,45235,2021-07-22
3172011001,JAKARTA UTARA,PENJARINGAN,PENJARINGAN,90268,54782,35486,8350,43836,2021-07-22
3174101001,JAKARTA SELATAN,PESANGGRAHAN,PESANGGRAHAN,28134,14244,13890,5183,19073,2021-07-22
3171071004,JAKARTA PUSAT,TANAH ABANG,PETAMBURAN,34179,23363,10816,3094,13910,2021-07-22
3174071008,JAKARTA SELATAN,KEBAYORAN BARU,PETOGOGAN,11694,6088,5606,2049,7655,2021-07-22
3171011004,JAKARTA PUSAT,GAMBIR,PETOJO SELATAN,15153,8190,6963,3069,10032,2021-07-22
3171011003,JAKARTA PUSAT,GAMBIR,PETOJO UTARA,17858,10468,7390,2766,10156,2021-07-22
3174101004,JAKARTA SELATAN,PESANGGRAHAN,PETUKANGAN SELATAN,37906,19868,18038,5300,23338,2021-07-22
3174101003,JAKARTA SELATAN,PESANGGRAHAN,PETUKANGAN UTARA,54774,31488,23286,7349,30635,2021-07-22
3175081002,JAKARTA TIMUR,MAKASAR,PINANG RANTI,27705,15583,12122,3663,15785,2021-07-22
3173031008,JAKARTA BARAT,TAMAN SARI,PINANGSIA,10929,5114,5815,1713,7528,2021-07-22
3175011001,JAKARTA TIMUR,MATRAMAN,PISANGAN BARU,32340,20683,11657,4065,15722,2021-07-22
3175021002,JAKARTA TIMUR,PULO GADUNG,PISANGAN TIMUR,41806,24250,17556,5937,23493,2021-07-22
3172011005,JAKARTA UTARA,PENJARINGAN,PLUIT,48343,22717,25626,12808,38434,2021-07-22
3175071002,JAKARTA TIMUR,DUREN SAWIT,PONDOK BAMBU,62810,37193,25617,9528,35145,2021-07-22
3175071004,JAKARTA TIMUR,DUREN SAWIT,PONDOK KELAPA,73257,39941,33316,11648,44964,2021-07-22
3175071007,JAKARTA TIMUR,DUREN SAWIT,PONDOK KOPI,36156,23108,13048,4591,17639,2021-07-22
3174061003,JAKARTA SELATAN,CILANDAK,PONDOK LABU,47200,23618,23582,7644,31226,2021-07-22
3174051002,JAKARTA SELATAN,KEBAYORAN LAMA,PONDOK PINANG,57134,31993,25141,10162,35303,2021-07-22
3175101003,JAKARTA TIMUR,CIPAYUNG,PONDOK RANGGON,25905,15571,10334,3948,14282,2021-07-22
3101011003,KAB.ADM.KEP.SERIBU,KEP. SERIBU UTARA,PULAU HARAPAN,2094,575,1519,679,2198,2021-07-22
3101011002,KAB.ADM.KEP.SERIBU,KEP. SERIBU UTARA,PULAU KELAPA,5596,1467,4129,1105,5234,2021-07-22
3101011001,KAB.ADM.KEP.SERIBU,KEP. SERIBU UTARA,PULAU PANGGANG,5522,1304,4218,1170,5388,2021-07-22
3101021003,KAB.ADM.KEP.SERIBU,KEP. SERIBU SELATAN,PULAU PARI,2801,489,2312,620,2932,2021-07-22
3101021002,KAB.ADM.KEP.SERIBU,KEP. SERIBU SELATAN,PULAU TIDUNG,4634,1082,3552,1137,4689,2021-07-22
3101021001,KAB.ADM.KEP.SERIBU,KEP. SERIBU SELATAN,PULAU UNTUNG JAWA,1964,528,1436,568,2004,2021-07-22
3174071007,JAKARTA SELATAN,KEBAYORAN BARU,PULO,5915,2674,3241,1432,4673,2021-07-22
3175021001,JAKARTA TIMUR,PULO GADUNG,PULO GADUNG,35148,20870,14278,4966,19244,2021-07-22
3175061005,JAKARTA TIMUR,CAKUNG,PULO GEBANG,99227,59169,40058,11244,51302,2021-07-22
3174041004,JAKARTA SELATAN,PASAR MINGGU,RAGUNAN,40292,20719,19573,6383,25956,2021-07-22
3175091005,JAKARTA TIMUR,CIRACAS,RAMBUTAN,37488,24444,13044,4544,17588,2021-07-22
3172031006,JAKARTA UTARA,KOJA,RAWA BADAK SELATAN,43094,26031,17063,4061,21124,2021-07-22
3172031004,JAKARTA UTARA,KOJA,RAWA BADAK UTARA,35127,19348,15779,4002,19781,2021-07-22
3174071005,JAKARTA SELATAN,KEBAYORAN BARU,RAWA BARAT,5701,2790,2911,1398,4309,2021-07-22
3173011003,JAKARTA BARAT,CENGKARENG,RAWA BUAYA,64984,39031,25953,6594,32547,2021-07-22
3175031004,JAKARTA TIMUR,JATINEGARA,RAWA BUNGA,21819,13585,8234,2589,10823,2021-07-22
3174081003,JAKARTA SELATAN,PANCORAN,RAWA JATI,20969,10753,10216,3765,13981,2021-07-22
3175061002,JAKARTA TIMUR,CAKUNG,RAWA TERATE,25254,13376,11878,2219,14097,2021-07-22
3175021005,JAKARTA TIMUR,PULO GADUNG,RAWAMANGUN,38390,21993,16397,6179,22576,2021-07-22
3171051003,JAKARTA PUSAT,CEMPAKA PUTIH,RAWASARI,22583,12441,10142,3701,13843,2021-07-22
3173041010,JAKARTA BARAT,TAMBORA,ROA MALAKA,3527,1502,2025,924,2949,2021-07-22
3172041006,JAKARTA UTARA,CILINCING,ROROTAN,42339,22018,20321,4794,25115,2021-07-22
3174071004,JAKARTA SELATAN,KEBAYORAN BARU,SELONG,2885,1294,1591,920,2511,2021-07-22
3173061002,JAKARTA BARAT,KALI DERES,SEMANAN,72769,46526,26243,5318,31561,2021-07-22
3172041007,JAKARTA UTARA,CILINCING,SEMPER BARAT,70052,34645,35407,9332,44739,2021-07-22
3172041005,JAKARTA UTARA,CILINCING,SEMPER TIMUR,37024,19835,17189,4469,21658,2021-07-22
3174071006,JAKARTA SELATAN,KEBAYORAN BARU,SENAYAN,2848,1629,1219,608,1827,2021-07-22
3171041001,JAKARTA PUSAT,SENEN,SENEN,6994,3692,3302,1229,4531,2021-07-22
3171031004,JAKARTA PUSAT,KEMAYORAN,SERDANG,30405,17082,13323,4115,17438,2021-07-22
3174021001,JAKARTA SELATAN,SETIA BUDI,SETIA BUDI,3094,1625,1469,672,2141,2021-07-22
3175101005,JAKARTA TIMUR,CIPAYUNG,SETU,20870,13402,7468,2804,10272,2021-07-22
3173071002,JAKARTA BARAT,PALMERAH,SLIPI,16902,8739,8163,2832,10995,2021-07-22
3173081004,JAKARTA BARAT,KEMBANGAN,SRENGSENG,46238,27722,18516,6505,25021,2021-07-22
3174091002,JAKARTA SELATAN,JAGAKARSA,SRENGSENG SAWAH,59115,28452,30663,9694,40357,2021-07-22
3173051003,JAKARTA BARAT,KEBON JERUK,SUKABUMI SELATAN,37738,23728,14010,3665,17675,2021-07-22
3173051002,JAKARTA BARAT,KEBON JERUK,SUKABUMI UTARA,38909,25195,13714,4220,17934,2021-07-22
3172041002,JAKARTA UTARA,CILINCING,SUKAPURA,55672,30622,25050,5665,30715,2021-07-22
3171031007,JAKARTA PUSAT,KEMAYORAN,SUMUR BATU,23383,12851,10532,3659,14191,2021-07-22
3172021004,JAKARTA UTARA,TANJUNG PRIOK,SUNGAI BAMBU,30521,16014,14507,3855,18362,2021-07-22
3172021006,JAKARTA UTARA,TANJUNG PRIOK,SUNTER AGUNG,73070,33819,39251,14112,53363,2021-07-22
3172021002,JAKARTA UTARA,TANJUNG PRIOK,SUNTER JAYA,64160,32494,31666,11246,42912,2021-07-22
3175091004,JAKARTA TIMUR,CIRACAS,SUSUKAN,38962,22636,16326,4852,21178,2021-07-22
3173031001,JAKARTA BARAT,TAMAN SARI,TAMAN SARI,14592,7468,7124,2491,9615,2021-07-22
3173041001,JAKARTA BARAT,TAMBORA,TAMBORA,10418,6004,4414,1577,5991,2021-07-22
3173041004,JAKARTA BARAT,TAMBORA,TANAH SEREAL,26808,13173,13635,4052,17687,2021-07-22
3171081004,JAKARTA PUSAT,JOHAR BARU,TANAH TINGGI,38588,19582,19006,4400,23406,2021-07-22
3173031004,JAKARTA BARAT,TAMAN SARI,TANGKI,13569,6975,6594,1984,8578,2021-07-22
3174091005,JAKARTA SELATAN,JAGAKARSA,TANJUNG BARAT,40348,23654,16694,6138,22832,2021-07-22
3173021005,JAKARTA BARAT,GROGOL PETAMBURAN,TANJUNG DUREN SELATAN,25919,12543,13376,4797,18173,2021-07-22
3173021002,JAKARTA BARAT,GROGOL PETAMBURAN,TANJUNG DUREN UTARA,17282,7766,9516,3770,13286,2021-07-22
3172021001,JAKARTA UTARA,TANJUNG PRIOK,TANJUNG PRIOK,35493,18171,17322,3958,21280,2021-07-22
3174011002,JAKARTA SELATAN,TEBET,TEBET BARAT,21575,10593,10982,4480,15462,2021-07-22
3174011001,JAKARTA SELATAN,TEBET,TEBET TIMUR,18498,8612,9886,4005,13891,2021-07-22
3173061003,JAKARTA BARAT,KALI DERES,TEGAL ALUR,85206,51218,33988,7261,41249,2021-07-22
3174031004,JAKARTA SELATAN,MAMPANG PRAPATAN,TEGAL PARANG,32893,19857,13036,3665,16701,2021-07-22
3173021003,JAKARTA BARAT,GROGOL PETAMBURAN,TOMANG,30184,15191,14993,5243,20236,2021-07-22
3172031005,JAKARTA UTARA,KOJA,TUGU SELATAN,40013,23749,16264,3963,20227,2021-07-22
3172031002,JAKARTA UTARA,KOJA,TUGU UTARA,69068,40635,28433,7036,35469,2021-07-22
3175061006,JAKARTA TIMUR,CAKUNG,UJUNG MENTENG,30525,16627,13898,4196,18094,2021-07-22
3174101005,JAKARTA SELATAN,PESANGGRAHAN,ULUJAMI,41325,25164,16161,5264,21425,2021-07-22
3175011006,JAKARTA TIMUR,MATRAMAN,UTAN KAYU SELATAN,34205,18795,15410,5405,20815,2021-07-22
3175011002,JAKARTA TIMUR,MATRAMAN,UTAN KAYU UTARA,28777,16348,12429,4094,16523,2021-07-22
3171031008,JAKARTA PUSAT,KEMAYORAN,UTAN PANJANG,29932,18284,11648,2938,14586,2021-07-22
3172021007,JAKARTA UTARA,TANJUNG PRIOK,WARAKAS,45436,24210,21226,5441,26667,2021-07-22
3173021007,JAKARTA BARAT,GROGOL PETAMBURAN,WIJAYA KUSUMA,39811,23006,16805,5131,21936,2021-07-22
3172051003,JAKARTA UTARA,PADEMANGAN,ANCOL,24516,14168,10348,3439,13787,2021-07-23
3173041007,JAKARTA BARAT,TAMBORA,ANGKE,29988,15818,14170,3428,17598,2021-07-23
3175041005,JAKARTA TIMUR,KRAMAT JATI,BALE KAMBANG,29564,20422,9142,2856,11998,2021-07-23
3175031003,JAKARTA TIMUR,JATINEGARA,BALI MESTER,9926,5800,4126,1630,5756,2021-07-23
3175101006,JAKARTA TIMUR,CIPAYUNG,BAMBU APUS,26760,15907,10853,4222,15075,2021-07-23
3174031002,JAKARTA SELATAN,MAMPANG PRAPATAN,BANGKA,21936,11912,10024,3108,13132,2021-07-23
3175051002,JAKARTA TIMUR,PASAR REBO,BARU,24449,11565,12884,5197,18081,2021-07-23
3175041004,JAKARTA TIMUR,KRAMAT JATI,BATU AMPAR,48653,32496,16157,5821,21978,2021-07-23
3171071002,JAKARTA PUSAT,TANAH ABANG,BENDUNGAN HILIR,22127,11586,10541,3817,14358,2021-07-23
3175031002,JAKARTA TIMUR,JATINEGARA,BIDARA CINA,37414,24286,13128,4338,17466,2021-07-23
3174101002,JAKARTA SELATAN,PESANGGRAHAN,BINTARO,53940,29927,24013,7842,31855,2021-07-23
3174011005,JAKARTA SELATAN,TEBET,BUKIT DURI,34879,20351,14528,4545,19073,2021-07-23
3171041006,JAKARTA PUSAT,SENEN,BUNGUR,18681,10150,8531,3014,11545,2021-07-23
3175061007,JAKARTA TIMUR,CAKUNG,CAKUNG BARAT,59152,31665,27487,4947,32434,2021-07-23
3175061004,JAKARTA TIMUR,CAKUNG,CAKUNG TIMUR,59749,32832,26917,7384,34301,2021-07-23
3175041007,JAKARTA TIMUR,KRAMAT JATI,CAWANG,33478,20271,13207,4649,17856,2021-07-23
3175101008,JAKARTA TIMUR,CIPAYUNG,CEGER,19269,11419,7850,2742,10592,2021-07-23
3171031006,JAKARTA PUSAT,KEMAYORAN,CEMPAKA BARU,33463,20017,13446,4492,17938,2021-07-23
3171051002,JAKARTA PUSAT,CEMPAKA PUTIH,CEMPAKA PUTIH BARAT,36637,20787,15850,5321,21171,2021-07-23
3171051001,JAKARTA PUSAT,CEMPAKA PUTIH,CEMPAKA PUTIH TIMUR,24923,13372,11551,4784,16335,2021-07-23
3173011001,JAKARTA BARAT,CENGKARENG,CENGKARENG BARAT,67426,35487,31939,9557,41496,2021-07-23
3173011006,JAKARTA BARAT,CENGKARENG,CENGKARENG TIMUR,82441,46826,35615,9623,45238,2021-07-23
3175091002,JAKARTA TIMUR,CIRACAS,CIBUBUR,67471,35190,32281,10499,42780,2021-07-23
3171011002,JAKARTA PUSAT,GAMBIR,CIDENG,15791,7910,7881,3346,11227,2021-07-23
3174091003,JAKARTA SELATAN,JAGAKARSA,CIGANJUR,39104,20877,18227,5825,24052,2021-07-23
3175051003,JAKARTA TIMUR,PASAR REBO,CIJANTUNG,42211,22910,19301,6748,26049,2021-07-23
3171061003,JAKARTA PUSAT,MENTENG,CIKINI,8507,5005,3502,1461,4963,2021-07-23
3174081006,JAKARTA SELATAN,PANCORAN,CIKOKO,10777,5213,5564,1923,7487,2021-07-23
3174061001,JAKARTA SELATAN,CILANDAK,CILANDAK BARAT,52688,26059,26629,8990,35619,2021-07-23
3174041003,JAKARTA SELATAN,PASAR MINGGU,CILANDAK TIMUR,25805,13107,12698,5393,18091,2021-07-23
3175101002,JAKARTA TIMUR,CIPAYUNG,CILANGKAP,28082,16025,12057,4062,16119,2021-07-23
3175041006,JAKARTA TIMUR,KRAMAT JATI,CILILITAN,40978,25821,15157,5698,20855,2021-07-23
3172041001,JAKARTA UTARA,CILINCING,CILINCING,44480,25710,18770,4299,23069,2021-07-23
3175101001,JAKARTA TIMUR,CIPAYUNG,CIPAYUNG,26659,14262,12397,4509,16906,2021-07-23
3174091006,JAKARTA SELATAN,JAGAKARSA,CIPEDAK,38836,19410,19426,5599,25025,2021-07-23
3174061005,JAKARTA SELATAN,CILANDAK,CIPETE SELATAN,27193,14161,13032,4403,17435,2021-07-23
3174071010,JAKARTA SELATAN,KEBAYORAN BARU,CIPETE UTARA,34795,17931,16864,4624,21488,2021-07-23
3175021003,JAKARTA TIMUR,PULO GADUNG,CIPINANG,40086,22800,17286,6510,23796,2021-07-23
3175031007,JAKARTA TIMUR,JATINEGARA,CIPINANG BESAR SELATAN,35827,23354,12473,4150,16623,2021-07-23
3175031008,JAKARTA TIMUR,JATINEGARA,CIPINANG BESAR UTARA,46246,30952,15294,4474,19768,2021-07-23
3175031005,JAKARTA TIMUR,JATINEGARA,CIPINANG CEMPEDAK,33448,20342,13106,4987,18093,2021-07-23
3175081005,JAKARTA TIMUR,MAKASAR,CIPINANG MELAYU,43095,24168,18927,6834,25761,2021-07-23
3175031006,JAKARTA TIMUR,JATINEGARA,CIPINANG MUARA,56309,35991,20318,7828,28146,2021-07-23
3174051003,JAKARTA SELATAN,KEBAYORAN LAMA,CIPULIR,40688,24229,16459,5118,21577,2021-07-23
3175091001,JAKARTA TIMUR,CIRACAS,CIRACAS,65766,35723,30043,9191,39234,2021-07-23
3175041003,JAKARTA TIMUR,KRAMAT JATI,DUKUH,25034,15075,9959,3747,13706,2021-07-23
3175071001,JAKARTA TIMUR,DUREN SAWIT,DUREN SAWIT,62198,37221,24977,10078,35055,2021-07-23
3174081004,JAKARTA SELATAN,PANCORAN,DUREN TIGA,28806,14984,13822,4389,18211,2021-07-23
3173051005,JAKARTA BARAT,KEBON JERUK,DURI KEPA,61141,30706,30435,10727,41162,2021-07-23
3173011002,JAKARTA BARAT,CENGKARENG,DURI KOSAMBI,79279,46246,33033,9495,42528,2021-07-23
3171011006,JAKARTA PUSAT,GAMBIR,DURI PULO,20155,11380,8775,2520,11295,2021-07-23
3173041011,JAKARTA BARAT,TAMBORA,DURI SELATAN,14548,7409,7139,2458,9597,2021-07-23
3173041003,JAKARTA BARAT,TAMBORA,DURI UTARA,20213,10769,9444,2780,12224,2021-07-23
3171081003,JAKARTA PUSAT,JOHAR BARU,GALUR,18663,9191,9472,2074,11546,2021-07-23
3171011001,JAKARTA PUSAT,GAMBIR,GAMBIR,2284,1133,1151,573,1724,2021-07-23
3174061004,JAKARTA SELATAN,CILANDAK,GANDARIA SELATAN,22496,12298,10198,3349,13547,2021-07-23
3174071009,JAKARTA SELATAN,KEBAYORAN BARU,GANDARIA UTARA,40567,21678,18889,5896,24785,2021-07-23
3175051001,JAKARTA TIMUR,PASAR REBO,GEDONG,36445,20700,15745,5932,21677,2021-07-23
3171071001,JAKARTA PUSAT,TANAH ABANG,GELORA,3206,1769,1437,601,2038,2021-07-23
3173031007,JAKARTA BARAT,TAMAN SARI,GLODOK,7962,3298,4664,2086,6750,2021-07-23
3171061004,JAKARTA PUSAT,MENTENG,GONDANGDIA,4176,1944,2232,1373,3605,2021-07-23
3173021001,JAKARTA BARAT,GROGOL PETAMBURAN,GROGOL,17275,9136,8139,2864,11003,2021-07-23
3174051005,JAKARTA SELATAN,KEBAYORAN LAMA,GROGOL SELATAN,45028,26812,18216,5885,24101,2021-07-23
3174051004,JAKARTA SELATAN,KEBAYORAN LAMA,GROGOL UTARA,43272,25524,17748,6222,23970,2021-07-23
3174021007,JAKARTA SELATAN,SETIA BUDI,GUNTUR,4050,1875,2175,1049,3224,2021-07-23
3174071002,JAKARTA SELATAN,KEBAYORAN BARU,GUNUNG,9604,4728,4876,2211,7087,2021-07-23
3171031005,JAKARTA PUSAT,KEMAYORAN,GUNUNG SAHARI SELATAN,19670,10559,9111,3145,12256,2021-07-23
3171021004,JAKARTA PUSAT,SAWAH BESAR,GUNUNG SAHARI UTARA,17050,7981,9069,3511,12580,2021-07-23
3175081004,JAKARTA TIMUR,MAKASAR,HALIM PERDANA KUSUMAH,29162,11288,17874,9930,27804,2021-07-23
3171031003,JAKARTA PUSAT,KEMAYORAN,HARAPAN MULIA,23137,13564,9573,2927,12500,2021-07-23
3174091001,JAKARTA SELATAN,JAGAKARSA,JAGAKARSA,63301,31977,31324,9963,41287,2021-07-23
3175021007,JAKARTA TIMUR,PULO GADUNG,JATI,33382,18855,14527,6051,20578,2021-07-23
3174041002,JAKARTA SELATAN,PASAR MINGGU,JATI PADANG,38180,20377,17803,6652,24455,2021-07-23
3173071004,JAKARTA BARAT,PALMERAH,JATI PULO,29294,14915,14379,3855,18234,2021-07-23
3175061001,JAKARTA TIMUR,CAKUNG,JATINEGARA,86098,54595,31503,7427,38930,2021-07-23
3175021004,JAKARTA TIMUR,PULO GADUNG,JATINEGARA KAUM,25176,14804,10372,3168,13540,2021-07-23
3173021004,JAKARTA BARAT,GROGOL PETAMBURAN,JELAMBAR,30838,15681,15157,5926,21083,2021-07-23
3173021006,JAKARTA BARAT,GROGOL PETAMBURAN,JELAMBAR BARU,38942,20263,18679,6651,25330,2021-07-23
3173041006,JAKARTA BARAT,TAMBORA,JEMBATAN BESI,29948,19866,10082,2574,12656,2021-07-23
3173041008,JAKARTA BARAT,TAMBORA,JEMBATAN LIMA,21360,12960,8400,2423,10823,2021-07-23
3173081005,JAKARTA BARAT,KEMBANGAN,JOGLO,41569,23487,18082,6337,24419,2021-07-23
3171081001,JAKARTA PUSAT,JOHAR BARU,JOHAR BARU,38335,19766,18569,5760,24329,2021-07-23
3173041002,JAKARTA BARAT,TAMBORA,KALI ANYAR,24342,15162,9180,2363,11543,2021-07-23
3172041004,JAKARTA UTARA,CILINCING,KALIBARU,69169,42595,26574,4651,31225,2021-07-23
3174081002,JAKARTA SELATAN,PANCORAN,KALIBATA,42631,25235,17396,5637,23033,2021-07-23
3173061001,JAKARTA BARAT,KALI DERES,KALIDERES,73863,42690,31173,8473,39646,2021-07-23
3175051004,JAKARTA TIMUR,PASAR REBO,KALISARI,43984,24154,19830,7619,27449,2021-07-23
3173061004,JAKARTA BARAT,KALI DERES,KAMAL,54600,35640,18960,3914,22874,2021-07-23
3172011002,JAKARTA UTARA,PENJARINGAN,KAMAL MUARA,13142,5145,7997,2874,10871,2021-07-23
3171071007,JAKARTA PUSAT,TANAH ABANG,KAMPUNG BALI,11694,7289,4405,1542,5947,2021-07-23
3175031001,JAKARTA TIMUR,JATINEGARA,KAMPUNG MELAYU,26123,16833,9290,2442,11732,2021-07-23
3171081002,JAKARTA PUSAT,JOHAR BARU,KAMPUNG RAWA,21809,9756,12053,2642,14695,2021-07-23
3175041002,JAKARTA TIMUR,KRAMAT JATI,KAMPUNG TENGAH,44823,29243,15580,5631,21211,2021-07-23
3173011005,JAKARTA BARAT,CENGKARENG,KAPUK,137086,83230,53856,10430,64286,2021-07-23
3172011003,JAKARTA UTARA,PENJARINGAN,KAPUK MUARA,36293,16990,19303,7234,26537,2021-07-23
3171021002,JAKARTA PUSAT,SAWAH BESAR,KARANG ANYAR,26348,14435,11913,3554,15467,2021-07-23
3174021004,JAKARTA SELATAN,SETIA BUDI,KARET,9824,5183,4641,1614,6255,2021-07-23
3174021003,JAKARTA SELATAN,SETIA BUDI,KARET KUNINGAN,16356,7909,8447,2581,11028,2021-07-23
3174021002,JAKARTA SELATAN,SETIA BUDI,KARET SEMANGGI,2810,1257,1553,689,2242,2021-07-23
3171071003,JAKARTA PUSAT,TANAH ABANG,KARET TENGSIN,19698,11071,8627,2400,11027,2021-07-23
3171021003,JAKARTA PUSAT,SAWAH BESAR,KARTINI,22812,11713,11099,3645,14744,2021-07-23
3175011003,JAKARTA TIMUR,MATRAMAN,KAYU MANIS,25833,15657,10176,3265,13441,2021-07-23
3175021006,JAKARTA TIMUR,PULO GADUNG,KAYU PUTIH,41550,21541,20009,7903,27912,2021-07-23
3173031006,JAKARTA BARAT,TAMAN SARI,KEAGUNGAN,17729,9099,8630,2140,10770,2021-07-23
3174041007,JAKARTA SELATAN,PASAR MINGGU,KEBAGUSAN,45257,26027,19230,6208,25438,2021-07-23
3174051006,JAKARTA SELATAN,KEBAYORAN LAMA,KEBAYORAN LAMA SELATAN,41965,21930,20035,6232,26267,2021-07-23
3174051001,JAKARTA SELATAN,KEBAYORAN LAMA,KEBAYORAN LAMA UTARA,43328,25473,17855,5750,23605,2021-07-23
3174011004,JAKARTA SELATAN,TEBET,KEBON BARU,35871,19728,16143,5767,21910,2021-07-23
3172021005,JAKARTA UTARA,TANJUNG PRIOK,KEBON BAWANG,52097,27697,24400,7519,31919,2021-07-23
3173051001,JAKARTA BARAT,KEBON JERUK,KEBON JERUK,54764,32913,21851,7237,29088,2021-07-23
3171071006,JAKARTA PUSAT,TANAH ABANG,KEBON KACANG,22000,14233,7767,2782,10549,2021-07-23
3171011005,JAKARTA PUSAT,GAMBIR,KEBON KELAPA,10453,5766,4687,1745,6432,2021-07-23
3171031002,JAKARTA PUSAT,KEMAYORAN,KEBON KOSONG,30679,17090,13589,3839,17428,2021-07-23
3175011005,JAKARTA TIMUR,MATRAMAN,KEBON MANGGIS,16843,8982,7861,3060,10921,2021-07-23
3171071005,JAKARTA PUSAT,TANAH ABANG,KEBON MELATI,33178,22562,10616,3052,13668,2021-07-23
3175081003,JAKARTA TIMUR,MAKASAR,KEBON PALA,47563,27867,19696,6772,26468,2021-07-23
3171061005,JAKARTA PUSAT,MENTENG,KEBON SIRIH,12611,7945,4666,1685,6351,2021-07-23
3173011004,JAKARTA BARAT,CENGKARENG,KEDAUNG KALI ANGKE,33255,15558,17697,3651,21348,2021-07-23
3173051007,JAKARTA BARAT,KEBON JERUK,KEDOYA SELATAN,32647,17385,15262,4921,20183,2021-07-23
3173051006,JAKARTA BARAT,KEBON JERUK,KEDOYA UTARA,46407,23746,22661,7415,30076,2021-07-23
3173051004,JAKARTA BARAT,KEBON JERUK,KELAPA DUA,23936,13585,10351,3331,13682,2021-07-23
3175091003,JAKARTA TIMUR,CIRACAS,KELAPA DUA WETAN,47683,25545,22138,7807,29945,2021-07-23
3172061003,JAKARTA UTARA,KELAPA GADING,KELAPA GADING BARAT,36375,15427,20948,9347,30295,2021-07-23
3172061001,JAKARTA UTARA,KELAPA GADING,KELAPA GADING TIMUR,34089,13473,20616,9600,30216,2021-07-23
3173071005,JAKARTA BARAT,PALMERAH,KEMANGGISAN,32814,17877,14937,5507,20444,2021-07-23
3171031001,JAKARTA PUSAT,KEMAYORAN,KEMAYORAN,21186,11085,10101,3057,13158,2021-07-23
3173081006,JAKARTA BARAT,KEMBANGAN,KEMBANGAN SELATAN,27508,14709,12799,5311,18110,2021-07-23
3173081001,JAKARTA BARAT,KEMBANGAN,KEMBANGAN UTARA,55312,30000,25312,7074,32386,2021-07-23
3171041002,JAKARTA PUSAT,SENEN,KENARI,9820,5094,4726,1838,6564,2021-07-23
3173041005,JAKARTA BARAT,TAMBORA,KERENDANG,20382,11568,8814,2335,11149,2021-07-23
3175071003,JAKARTA TIMUR,DUREN SAWIT,KLENDER,71340,46662,24678,8067,32745,2021-07-23
3172031001,JAKARTA UTARA,KOJA,KOJA,28773,15259,13514,2979,16493,2021-07-23
3173071006,JAKARTA BARAT,PALMERAH,KOTA BAMBU SELATAN,21627,12301,9326,2421,11747,2021-07-23
3173071003,JAKARTA BARAT,PALMERAH,KOTA BAMBU UTARA,25510,14962,10548,2909,13457,2021-07-23
3171041004,JAKARTA PUSAT,SENEN,KRAMAT,29515,18121,11394,3187,14581,2021-07-23
3175041001,JAKARTA TIMUR,KRAMAT JATI,KRAMAT JATI,34814,20899,13915,5378,19293,2021-07-23
3174071003,JAKARTA SELATAN,KEBAYORAN BARU,KRAMAT PELA,14674,7340,7334,2571,9905,2021-07-23
3173031002,JAKARTA BARAT,TAMAN SARI,KRUKUT,19624,10790,8834,2424,11258,2021-07-23
3174031005,JAKARTA SELATAN,MAMPANG PRAPATAN,KUNINGAN BARAT,12986,6496,6490,1811,8301,2021-07-23
3174021008,JAKARTA SELATAN,SETIA BUDI,KUNINGAN TIMUR,6123,3281,2842,1137,3979,2021-07-23
3171041005,JAKARTA PUSAT,SENEN,KWITANG,15805,8686,7119,2280,9399,2021-07-23
3172031003,JAKARTA UTARA,KOJA,LAGOA,60201,34520,25681,6042,31723,2021-07-23
3174061002,JAKARTA SELATAN,CILANDAK,LEBAK BULUS,38208,20206,18002,6890,24892,2021-07-23
3174091004,JAKARTA SELATAN,JAGAKARSA,LENTENG AGUNG,54803,32414,22389,6968,29357,2021-07-23
3175101007,JAKARTA TIMUR,CIPAYUNG,LUBANG BUAYA,64480,35925,28555,9410,37965,2021-07-23
3175081001,JAKARTA TIMUR,MAKASAR,MAKASAR,35054,19267,15787,5459,21246,2021-07-23
3175071006,JAKARTA TIMUR,DUREN SAWIT,MALAKA JAYA,31629,16295,15334,5989,21323,2021-07-23
3175071005,JAKARTA TIMUR,DUREN SAWIT,MALAKA SARI,28114,14457,13657,5755,19412,2021-07-23
3174031001,JAKARTA SELATAN,MAMPANG PRAPATAN,MAMPANG PRAPATAN,18474,9877,8597,2375,10972,2021-07-23
3173031005,JAKARTA BARAT,TAMAN SARI,MANGGA BESAR,7834,3489,4345,1544,5889,2021-07-23
3171021005,JAKARTA PUSAT,SAWAH BESAR,MANGGA DUA SELATAN,28106,15331,12775,4100,16875,2021-07-23
3174011007,JAKARTA SELATAN,TEBET,MANGGARAI,28880,16083,12797,3858,16655,2021-07-23
3174011006,JAKARTA SELATAN,TEBET,MANGGARAI SELATAN,23514,12232,11282,3824,15106,2021-07-23
3173031003,JAKARTA BARAT,TAMAN SARI,MAPHAR,16790,8561,8229,2730,10959,2021-07-23
3172041003,JAKARTA UTARA,CILINCING,MARUNDA,29302,15136,14166,2721,16887,2021-07-23
3174071001,JAKARTA SELATAN,KEBAYORAN BARU,MELAWAI,2710,1162,1548,898,2446,2021-07-23
3171061001,JAKARTA PUSAT,MENTENG,MENTENG,26121,16354,9767,3822,13589,2021-07-23
3174021005,JAKARTA SELATAN,SETIA BUDI,MENTENG ATAS,28407,14710,13697,4394,18091,2021-07-23
3174011003,JAKARTA SELATAN,TEBET,MENTENG DALAM,36669,20745,15924,5742,21666,2021-07-23
3173081003,JAKARTA BARAT,KEMBANGAN,MERUYA SELATAN,32671,18673,13998,4566,18564,2021-07-23
3173081002,JAKARTA BARAT,KEMBANGAN,MERUYA UTARA,44535,24634,19901,7422,27323,2021-07-23
3175101004,JAKARTA TIMUR,CIPAYUNG,MUNJUL,24232,13725,10507,3762,14269,2021-07-23
3172051002,JAKARTA UTARA,PADEMANGAN,PADEMANGAN BARAT,75593,42669,32924,8220,41144,2021-07-23
3172051001,JAKARTA UTARA,PADEMANGAN,PADEMANGAN TIMUR,38344,17537,20807,7231,28038,2021-07-23
3175011004,JAKARTA TIMUR,MATRAMAN,PAL MERIAM,20183,11641,8542,3010,11552,2021-07-23
3173071001,JAKARTA BARAT,PALMERAH,PALMERAH,64057,36248,27809,8533,36342,2021-07-23
3174081001,JAKARTA SELATAN,PANCORAN,PANCORAN,19735,10346,9389,3049,12438,2021-07-23
3172021003,JAKARTA UTARA,TANJUNG PRIOK,PAPANGGO,39919,20751,19168,5127,24295,2021-07-23
3171021001,JAKARTA PUSAT,SAWAH BESAR,PASAR BARU,12302,5642,6660,2822,9482,2021-07-23
3174021006,JAKARTA SELATAN,SETIA BUDI,PASAR MANGGIS,27273,14684,12589,3877,16466,2021-07-23
3174041001,JAKARTA SELATAN,PASAR MINGGU,PASAR MINGGU,25321,13741,11580,5013,16593,2021-07-23
3171041003,JAKARTA PUSAT,SENEN,PASEBAN,24144,13436,10708,3514,14222,2021-07-23
3173061005,JAKARTA BARAT,KALI DERES,PEGADUNGAN,76816,42901,33915,10422,44337,2021-07-23
3171061002,JAKARTA PUSAT,MENTENG,PEGANGSAAN,23978,14796,9182,3153,12335,2021-07-23
3172061002,JAKARTA UTARA,KELAPA GADING,PEGANGSAAN DUA,50849,20778,30071,11062,41133,2021-07-23
3172011004,JAKARTA UTARA,PENJARINGAN,PEJAGALAN,75844,38913,36931,12056,48987,2021-07-23
3174041006,JAKARTA SELATAN,PASAR MINGGU,PEJATEN BARAT,37970,20326,17644,6392,24036,2021-07-23
3174041005,JAKARTA SELATAN,PASAR MINGGU,PEJATEN TIMUR,58725,35660,23065,7532,30597,2021-07-23
3175051005,JAKARTA TIMUR,PASAR REBO,PEKAYON,43973,23379,20594,6670,27264,2021-07-23
3173041009,JAKARTA BARAT,TAMBORA,PEKOJAN,23955,12169,11786,3654,15440,2021-07-23
3174031003,JAKARTA SELATAN,MAMPANG PRAPATAN,PELA MAMPANG,44274,22700,21574,6450,28024,2021-07-23
3174081005,JAKARTA SELATAN,PANCORAN,PENGADEGAN,21857,10016,11841,3898,15739,2021-07-23
3175061003,JAKARTA TIMUR,CAKUNG,PENGGILINGAN,101338,64453,36885,10080,46965,2021-07-23
3172011001,JAKARTA UTARA,PENJARINGAN,PENJARINGAN,90268,54246,36022,8744,44766,2021-07-23
3174101001,JAKARTA SELATAN,PESANGGRAHAN,PESANGGRAHAN,28134,14077,14057,5346,19403,2021-07-23
3171071004,JAKARTA PUSAT,TANAH ABANG,PETAMBURAN,34179,23018,11161,3136,14297,2021-07-23
3174071008,JAKARTA SELATAN,KEBAYORAN BARU,PETOGOGAN,11694,6020,5674,2105,7779,2021-07-23
3171011004,JAKARTA PUSAT,GAMBIR,PETOJO SELATAN,15153,8119,7034,3091,10125,2021-07-23
3171011003,JAKARTA PUSAT,GAMBIR,PETOJO UTARA,17858,10396,7462,2801,10263,2021-07-23
3174101004,JAKARTA SELATAN,PESANGGRAHAN,PETUKANGAN SELATAN,37906,19534,18372,5439,23811,2021-07-23
3174101003,JAKARTA SELATAN,PESANGGRAHAN,PETUKANGAN UTARA,54774,30914,23860,7703,31563,2021-07-23
3175081002,JAKARTA TIMUR,MAKASAR,PINANG RANTI,27705,15276,12429,3815,16244,2021-07-23
3173031008,JAKARTA BARAT,TAMAN SARI,PINANGSIA,10929,5074,5855,1751,7606,2021-07-23
3175011001,JAKARTA TIMUR,MATRAMAN,PISANGAN BARU,32340,20483,11857,4144,16001,2021-07-23
3175021002,JAKARTA TIMUR,PULO GADUNG,PISANGAN TIMUR,41806,23986,17820,6008,23828,2021-07-23
3172011005,JAKARTA UTARA,PENJARINGAN,PLUIT,48343,22531,25812,12995,38807,2021-07-23
3175071002,JAKARTA TIMUR,DUREN SAWIT,PONDOK BAMBU,62810,36730,26080,9814,35894,2021-07-23
3175071004,JAKARTA TIMUR,DUREN SAWIT,PONDOK KELAPA,73257,39400,33857,11858,45715,2021-07-23
3175071007,JAKARTA TIMUR,DUREN SAWIT,PONDOK KOPI,36156,22835,13321,4720,18041,2021-07-23
3174061003,JAKARTA SELATAN,CILANDAK,PONDOK LABU,47200,23362,23838,8034,31872,2021-07-23
3174051002,JAKARTA SELATAN,KEBAYORAN LAMA,PONDOK PINANG,57134,31612,25522,10361,35883,2021-07-23
3175101003,JAKARTA TIMUR,CIPAYUNG,PONDOK RANGGON,25905,15382,10523,3987,14510,2021-07-23
3101011003,KAB.ADM.KEP.SERIBU,KEP. SERIBU UTARA,PULAU HARAPAN,2094,564,1530,679,2209,2021-07-23
3101011002,KAB.ADM.KEP.SERIBU,KEP. SERIBU UTARA,PULAU KELAPA,5596,1453,4143,1136,5279,2021-07-23
3101011001,KAB.ADM.KEP.SERIBU,KEP. SERIBU UTARA,PULAU PANGGANG,5522,1287,4235,1176,5411,2021-07-23
3101021003,KAB.ADM.KEP.SERIBU,KEP. SERIBU SELATAN,PULAU PARI,2801,472,2329,653,2982,2021-07-23
3101021002,KAB.ADM.KEP.SERIBU,KEP. SERIBU SELATAN,PULAU TIDUNG,4634,1055,3579,1214,4793,2021-07-23
3101021001,KAB.ADM.KEP.SERIBU,KEP. SERIBU SELATAN,PULAU UNTUNG JAWA,1964,526,1438,576,2014,2021-07-23
3174071007,JAKARTA SELATAN,KEBAYORAN BARU,PULO,5915,2650,3265,1466,4731,2021-07-23
3175021001,JAKARTA TIMUR,PULO GADUNG,PULO GADUNG,35148,20665,14483,5070,19553,2021-07-23
3175061005,JAKARTA TIMUR,CAKUNG,PULO GEBANG,99227,58264,40963,11399,52362,2021-07-23
3174041004,JAKARTA SELATAN,PASAR MINGGU,RAGUNAN,40292,20436,19856,6647,26503,2021-07-23
3175091005,JAKARTA TIMUR,CIRACAS,RAMBUTAN,37488,24022,13466,4631,18097,2021-07-23
3172031006,JAKARTA UTARA,KOJA,RAWA BADAK SELATAN,43094,25742,17352,4092,21444,2021-07-23
3172031004,JAKARTA UTARA,KOJA,RAWA BADAK UTARA,35127,19202,15925,4048,19973,2021-07-23
3174071005,JAKARTA SELATAN,KEBAYORAN BARU,RAWA BARAT,5701,2766,2935,1433,4368,2021-07-23
3173011003,JAKARTA BARAT,CENGKARENG,RAWA BUAYA,64984,38655,26329,6796,33125,2021-07-23
3175031004,JAKARTA TIMUR,JATINEGARA,RAWA BUNGA,21819,13355,8464,2621,11085,2021-07-23
3174081003,JAKARTA SELATAN,PANCORAN,RAWA JATI,20969,10582,10387,3844,14231,2021-07-23
3175061002,JAKARTA TIMUR,CAKUNG,RAWA TERATE,25254,13130,12124,2250,14374,2021-07-23
3175021005,JAKARTA TIMUR,PULO GADUNG,RAWAMANGUN,38390,21784,16606,6280,22886,2021-07-23
3171051003,JAKARTA PUSAT,CEMPAKA PUTIH,RAWASARI,22583,12269,10314,3746,14060,2021-07-23
3173041010,JAKARTA BARAT,TAMBORA,ROA MALAKA,3527,1487,2040,931,2971,2021-07-23
3172041006,JAKARTA UTARA,CILINCING,ROROTAN,42339,21707,20632,4895,25527,2021-07-23
3174071004,JAKARTA SELATAN,KEBAYORAN BARU,SELONG,2885,1274,1611,939,2550,2021-07-23
3173061002,JAKARTA BARAT,KALI DERES,SEMANAN,72769,45197,27572,5444,33016,2021-07-23
3172041007,JAKARTA UTARA,CILINCING,SEMPER BARAT,70052,34295,35757,9602,45359,2021-07-23
3172041005,JAKARTA UTARA,CILINCING,SEMPER TIMUR,37024,19562,17462,4625,22087,2021-07-23
3174071006,JAKARTA SELATAN,KEBAYORAN BARU,SENAYAN,2848,1616,1232,625,1857,2021-07-23
3171041001,JAKARTA PUSAT,SENEN,SENEN,6994,3658,3336,1252,4588,2021-07-23
3171031004,JAKARTA PUSAT,KEMAYORAN,SERDANG,30405,16836,13569,4253,17822,2021-07-23
3174021001,JAKARTA SELATAN,SETIA BUDI,SETIA BUDI,3094,1603,1491,683,2174,2021-07-23
3175101005,JAKARTA TIMUR,CIPAYUNG,SETU,20870,13199,7671,2840,10511,2021-07-23
3173071002,JAKARTA BARAT,PALMERAH,SLIPI,16902,8645,8257,2852,11109,2021-07-23
3173081004,JAKARTA BARAT,KEMBANGAN,SRENGSENG,46238,27459,18779,6621,25400,2021-07-23
3174091002,JAKARTA SELATAN,JAGAKARSA,SRENGSENG SAWAH,59115,28095,31020,10128,41148,2021-07-23
3173051003,JAKARTA BARAT,KEBON JERUK,SUKABUMI SELATAN,37738,23444,14294,3722,18016,2021-07-23
3173051002,JAKARTA BARAT,KEBON JERUK,SUKABUMI UTARA,38909,24925,13984,4256,18240,2021-07-23
3172041002,JAKARTA UTARA,CILINCING,SUKAPURA,55672,30250,25422,5771,31193,2021-07-23
3171031007,JAKARTA PUSAT,KEMAYORAN,SUMUR BATU,23383,12714,10669,3833,14502,2021-07-23
3172021004,JAKARTA UTARA,TANJUNG PRIOK,SUNGAI BAMBU,30521,15855,14666,4092,18758,2021-07-23
3172021006,JAKARTA UTARA,TANJUNG PRIOK,SUNTER AGUNG,73070,33160,39910,14316,54226,2021-07-23
3172021002,JAKARTA UTARA,TANJUNG PRIOK,SUNTER JAYA,64160,32099,32061,11634,43695,2021-07-23
3175091004,JAKARTA TIMUR,CIRACAS,SUSUKAN,38962,22387,16575,4980,21555,2021-07-23
3173031001,JAKARTA BARAT,TAMAN SARI,TAMAN SARI,14592,7382,7210,2552,9762,2021-07-23
3173041001,JAKARTA BARAT,TAMBORA,TAMBORA,10418,5934,4484,1595,6079,2021-07-23
3173041004,JAKARTA BARAT,TAMBORA,TANAH SEREAL,26808,13023,13785,4114,17899,2021-07-23
3171081004,JAKARTA PUSAT,JOHAR BARU,TANAH TINGGI,38588,19326,19262,4537,23799,2021-07-23
3173031004,JAKARTA BARAT,TAMAN SARI,TANGKI,13569,6924,6645,2038,8683,2021-07-23
3174091005,JAKARTA SELATAN,JAGAKARSA,TANJUNG BARAT,40348,23423,16925,6320,23245,2021-07-23
3173021005,JAKARTA BARAT,GROGOL PETAMBURAN,TANJUNG DUREN SELATAN,25919,12394,13525,4906,18431,2021-07-23
3173021002,JAKARTA BARAT,GROGOL PETAMBURAN,TANJUNG DUREN UTARA,17282,7675,9607,3830,13437,2021-07-23
3172021001,JAKARTA UTARA,TANJUNG PRIOK,TANJUNG PRIOK,35493,18039,17454,4021,21475,2021-07-23
3174011002,JAKARTA SELATAN,TEBET,TEBET BARAT,21575,10480,11095,4644,15739,2021-07-23
3174011001,JAKARTA SELATAN,TEBET,TEBET TIMUR,18498,8500,9998,4060,14058,2021-07-23
3173061003,JAKARTA BARAT,KALI DERES,TEGAL ALUR,85206,50271,34935,7584,42519,2021-07-23
3174031004,JAKARTA SELATAN,MAMPANG PRAPATAN,TEGAL PARANG,32893,19614,13279,3811,17090,2021-07-23
3173021003,JAKARTA BARAT,GROGOL PETAMBURAN,TOMANG,30184,15056,15128,5369,20497,2021-07-23
3172031005,JAKARTA UTARA,KOJA,TUGU SELATAN,40013,23319,16694,4003,20697,2021-07-23
3172031002,JAKARTA UTARA,KOJA,TUGU UTARA,69068,40252,28816,7102,35918,2021-07-23
3175061006,JAKARTA TIMUR,CAKUNG,UJUNG MENTENG,30525,16423,14102,4304,18406,2021-07-23
3174101005,JAKARTA SELATAN,PESANGGRAHAN,ULUJAMI,41325,24746,16579,5468,22047,2021-07-23
3175011006,JAKARTA TIMUR,MATRAMAN,UTAN KAYU SELATAN,34205,18577,15628,5554,21182,2021-07-23
3175011002,JAKARTA TIMUR,MATRAMAN,UTAN KAYU UTARA,28777,16161,12616,4262,16878,2021-07-23
3171031008,JAKARTA PUSAT,KEMAYORAN,UTAN PANJANG,29932,18029,11903,3133,15036,2021-07-23
3172021007,JAKARTA UTARA,TANJUNG PRIOK,WARAKAS,45436,24002,21434,5707,27141,2021-07-23
3173021007,JAKARTA BARAT,GROGOL PETAMBURAN,WIJAYA KUSUMA,39811,22580,17231,5245,22476,2021-07-23
3172051003,JAKARTA UTARA,PADEMANGAN,ANCOL,24516,13988,10528,3475,14003,2021-07-24
3173041007,JAKARTA BARAT,TAMBORA,ANGKE,29988,15600,14388,3489,17877,2021-07-24
3175041005,JAKARTA TIMUR,KRAMAT JATI,BALE KAMBANG,29564,20289,9275,2907,12182,2021-07-24
3175031003,JAKARTA TIMUR,JATINEGARA,BALI MESTER,9926,5754,4172,1667,5839,2021-07-24
3175101006,JAKARTA TIMUR,CIPAYUNG,BAMBU APUS,26760,15709,11051,4335,15386,2021-07-24
3174031002,JAKARTA SELATAN,MAMPANG PRAPATAN,BANGKA,21936,11795,10141,3206,13347,2021-07-24
3175051002,JAKARTA TIMUR,PASAR REBO,BARU,24449,11435,13014,5293,18307,2021-07-24
3175041004,JAKARTA TIMUR,KRAMAT JATI,BATU AMPAR,48653,32183,16470,5953,22423,2021-07-24
3171071002,JAKARTA PUSAT,TANAH ABANG,BENDUNGAN HILIR,22127,11440,10687,3855,14542,2021-07-24
3175031002,JAKARTA TIMUR,JATINEGARA,BIDARA CINA,37414,24077,13337,4399,17736,2021-07-24
3174101002,JAKARTA SELATAN,PESANGGRAHAN,BINTARO,53940,29551,24389,8014,32403,2021-07-24
3174011005,JAKARTA SELATAN,TEBET,BUKIT DURI,34879,20109,14770,4653,19423,2021-07-24
3171041006,JAKARTA PUSAT,SENEN,BUNGUR,18681,10023,8658,3079,11737,2021-07-24
3175061007,JAKARTA TIMUR,CAKUNG,CAKUNG BARAT,59152,30757,28395,5336,33731,2021-07-24
3175061004,JAKARTA TIMUR,CAKUNG,CAKUNG TIMUR,59749,32228,27521,7624,35145,2021-07-24
3175041007,JAKARTA TIMUR,KRAMAT JATI,CAWANG,33478,20092,13386,4712,18098,2021-07-24
3175101008,JAKARTA TIMUR,CIPAYUNG,CEGER,19269,11253,8016,2794,10810,2021-07-24
3171031006,JAKARTA PUSAT,KEMAYORAN,CEMPAKA BARU,33463,19801,13662,4633,18295,2021-07-24
3171051002,JAKARTA PUSAT,CEMPAKA PUTIH,CEMPAKA PUTIH BARAT,36637,20565,16072,5432,21504,2021-07-24
3171051001,JAKARTA PUSAT,CEMPAKA PUTIH,CEMPAKA PUTIH TIMUR,24923,13241,11682,4843,16525,2021-07-24
3173011001,JAKARTA BARAT,CENGKARENG,CENGKARENG BARAT,67426,34759,32667,9734,42401,2021-07-24
3173011006,JAKARTA BARAT,CENGKARENG,CENGKARENG TIMUR,82441,46355,36086,9957,46043,2021-07-24
3175091002,JAKARTA TIMUR,CIRACAS,CIBUBUR,67471,34761,32710,10748,43458,2021-07-24
3171011002,JAKARTA PUSAT,GAMBIR,CIDENG,15791,7841,7950,3379,11329,2021-07-24
3174091003,JAKARTA SELATAN,JAGAKARSA,CIGANJUR,39104,20588,18516,6079,24595,2021-07-24
3175051003,JAKARTA TIMUR,PASAR REBO,CIJANTUNG,42211,22623,19588,6941,26529,2021-07-24
3171061003,JAKARTA PUSAT,MENTENG,CIKINI,8507,4952,3555,1494,5049,2021-07-24
3174081006,JAKARTA SELATAN,PANCORAN,CIKOKO,10777,5170,5607,1952,7559,2021-07-24
3174061001,JAKARTA SELATAN,CILANDAK,CILANDAK BARAT,52688,25846,26842,9307,36149,2021-07-24
3174041003,JAKARTA SELATAN,PASAR MINGGU,CILANDAK TIMUR,25805,12937,12868,5514,18382,2021-07-24
3175101002,JAKARTA TIMUR,CIPAYUNG,CILANGKAP,28082,15887,12195,4167,16362,2021-07-24
3175041006,JAKARTA TIMUR,KRAMAT JATI,CILILITAN,40978,25598,15380,5785,21165,2021-07-24
3172041001,JAKARTA UTARA,CILINCING,CILINCING,44480,25487,18993,4355,23348,2021-07-24
3175101001,JAKARTA TIMUR,CIPAYUNG,CIPAYUNG,26659,14119,12540,4576,17116,2021-07-24
3174091006,JAKARTA SELATAN,JAGAKARSA,CIPEDAK,38836,19129,19707,5923,25630,2021-07-24
3174061005,JAKARTA SELATAN,CILANDAK,CIPETE SELATAN,27193,14014,13179,4582,17761,2021-07-24
3174071010,JAKARTA SELATAN,KEBAYORAN BARU,CIPETE UTARA,34795,17781,17014,4824,21838,2021-07-24
3175021003,JAKARTA TIMUR,PULO GADUNG,CIPINANG,40086,22583,17503,6565,24068,2021-07-24
3175031007,JAKARTA TIMUR,JATINEGARA,CIPINANG BESAR SELATAN,35827,23115,12712,4197,16909,2021-07-24
3175031008,JAKARTA TIMUR,JATINEGARA,CIPINANG BESAR UTARA,46246,30638,15608,4532,20140,2021-07-24
3175031005,JAKARTA TIMUR,JATINEGARA,CIPINANG CEMPEDAK,33448,20106,13342,5047,18389,2021-07-24
3175081005,JAKARTA TIMUR,MAKASAR,CIPINANG MELAYU,43095,23861,19234,6953,26187,2021-07-24
3175031006,JAKARTA TIMUR,JATINEGARA,CIPINANG MUARA,56309,35698,20611,7916,28527,2021-07-24
3174051003,JAKARTA SELATAN,KEBAYORAN LAMA,CIPULIR,40688,23964,16724,5331,22055,2021-07-24
3175091001,JAKARTA TIMUR,CIRACAS,CIRACAS,65766,35295,30471,9349,39820,2021-07-24
3175041003,JAKARTA TIMUR,KRAMAT JATI,DUKUH,25034,14847,10187,3841,14028,2021-07-24
3175071001,JAKARTA TIMUR,DUREN SAWIT,DUREN SAWIT,62198,36858,25340,10289,35629,2021-07-24
3174081004,JAKARTA SELATAN,PANCORAN,DUREN TIGA,28806,14740,14066,4511,18577,2021-07-24
3173051005,JAKARTA BARAT,KEBON JERUK,DURI KEPA,61141,30217,30924,10881,41805,2021-07-24
3173011002,JAKARTA BARAT,CENGKARENG,DURI KOSAMBI,79279,45850,33429,9986,43415,2021-07-24
3171011006,JAKARTA PUSAT,GAMBIR,DURI PULO,20155,11174,8981,2554,11535,2021-07-24
3173041011,JAKARTA BARAT,TAMBORA,DURI SELATAN,14548,7217,7331,2479,9810,2021-07-24
3173041003,JAKARTA BARAT,TAMBORA,DURI UTARA,20213,10574,9639,2828,12467,2021-07-24
3171081003,JAKARTA PUSAT,JOHAR BARU,GALUR,18663,9119,9544,2113,11657,2021-07-24
3171011001,JAKARTA PUSAT,GAMBIR,GAMBIR,2284,1123,1161,575,1736,2021-07-24
3174061004,JAKARTA SELATAN,CILANDAK,GANDARIA SELATAN,22496,12198,10298,3492,13790,2021-07-24
3174071009,JAKARTA SELATAN,KEBAYORAN BARU,GANDARIA UTARA,40567,21438,19129,6093,25222,2021-07-24
3175051001,JAKARTA TIMUR,PASAR REBO,GEDONG,36445,20532,15913,6026,21939,2021-07-24
3171071001,JAKARTA PUSAT,TANAH ABANG,GELORA,3206,1750,1456,615,2071,2021-07-24
3173031007,JAKARTA BARAT,TAMAN SARI,GLODOK,7962,3266,4696,2131,6827,2021-07-24
3171061004,JAKARTA PUSAT,MENTENG,GONDANGDIA,4176,1934,2242,1392,3634,2021-07-24
3173021001,JAKARTA BARAT,GROGOL PETAMBURAN,GROGOL,17275,9038,8237,2907,11144,2021-07-24
3174051005,JAKARTA SELATAN,KEBAYORAN LAMA,GROGOL SELATAN,45028,26375,18653,5995,24648,2021-07-24
3174051004,JAKARTA SELATAN,KEBAYORAN LAMA,GROGOL UTARA,43272,25059,18213,6329,24542,2021-07-24
3174021007,JAKARTA SELATAN,SETIA BUDI,GUNTUR,4050,1859,2191,1072,3263,2021-07-24
3174071002,JAKARTA SELATAN,KEBAYORAN BARU,GUNUNG,9604,4657,4947,2263,7210,2021-07-24
3171031005,JAKARTA PUSAT,KEMAYORAN,GUNUNG SAHARI SELATAN,19670,10445,9225,3274,12499,2021-07-24
3171021004,JAKARTA PUSAT,SAWAH BESAR,GUNUNG SAHARI UTARA,17050,7900,9150,3584,12734,2021-07-24
3175081004,JAKARTA TIMUR,MAKASAR,HALIM PERDANA KUSUMAH,29162,11143,18019,10046,28065,2021-07-24
3171031003,JAKARTA PUSAT,KEMAYORAN,HARAPAN MULIA,23137,13409,9728,3077,12805,2021-07-24
3174091001,JAKARTA SELATAN,JAGAKARSA,JAGAKARSA,63301,31537,31764,10472,42236,2021-07-24
3175021007,JAKARTA TIMUR,PULO GADUNG,JATI,33382,18661,14721,6114,20835,2021-07-24
3174041002,JAKARTA SELATAN,PASAR MINGGU,JATI PADANG,38180,20107,18073,6880,24953,2021-07-24
3173071004,JAKARTA BARAT,PALMERAH,JATI PULO,29294,14490,14804,3882,18686,2021-07-24
3175061001,JAKARTA TIMUR,CAKUNG,JATINEGARA,86098,53742,32356,7640,39996,2021-07-24
3175021004,JAKARTA TIMUR,PULO GADUNG,JATINEGARA KAUM,25176,14604,10572,3216,13788,2021-07-24
3173021004,JAKARTA BARAT,GROGOL PETAMBURAN,JELAMBAR,30838,15451,15387,6047,21434,2021-07-24
3173021006,JAKARTA BARAT,GROGOL PETAMBURAN,JELAMBAR BARU,38942,20017,18925,6810,25735,2021-07-24
3173041006,JAKARTA BARAT,TAMBORA,JEMBATAN BESI,29948,19709,10239,2616,12855,2021-07-24
3173041008,JAKARTA BARAT,TAMBORA,JEMBATAN LIMA,21360,12811,8549,2460,11009,2021-07-24
3173081005,JAKARTA BARAT,KEMBANGAN,JOGLO,41569,23293,18276,6509,24785,2021-07-24
3171081001,JAKARTA PUSAT,JOHAR BARU,JOHAR BARU,38335,19483,18852,5912,24764,2021-07-24
3173041002,JAKARTA BARAT,TAMBORA,KALI ANYAR,24342,14800,9542,2388,11930,2021-07-24
3172041004,JAKARTA UTARA,CILINCING,KALIBARU,69169,42187,26982,4722,31704,2021-07-24
3174081002,JAKARTA SELATAN,PANCORAN,KALIBATA,42631,24797,17834,5774,23608,2021-07-24
3173061001,JAKARTA BARAT,KALI DERES,KALIDERES,73863,42104,31759,8716,40475,2021-07-24
3175051004,JAKARTA TIMUR,PASAR REBO,KALISARI,43984,23831,20153,7775,27928,2021-07-24
3173061004,JAKARTA BARAT,KALI DERES,KAMAL,54600,34761,19839,3973,23812,2021-07-24
3172011002,JAKARTA UTARA,PENJARINGAN,KAMAL MUARA,13142,5075,8067,2932,10999,2021-07-24
3171071007,JAKARTA PUSAT,TANAH ABANG,KAMPUNG BALI,11694,7210,4484,1559,6043,2021-07-24
3175031001,JAKARTA TIMUR,JATINEGARA,KAMPUNG MELAYU,26123,16690,9433,2476,11909,2021-07-24
3171081002,JAKARTA PUSAT,JOHAR BARU,KAMPUNG RAWA,21809,9599,12210,2786,14996,2021-07-24
3175041002,JAKARTA TIMUR,KRAMAT JATI,KAMPUNG TENGAH,44823,29046,15777,5701,21478,2021-07-24
3173011005,JAKARTA BARAT,CENGKARENG,KAPUK,137086,81923,55163,10771,65934,2021-07-24
3172011003,JAKARTA UTARA,PENJARINGAN,KAPUK MUARA,36293,16761,19532,7407,26939,2021-07-24
3171021002,JAKARTA PUSAT,SAWAH BESAR,KARANG ANYAR,26348,14155,12193,3647,15840,2021-07-24
3174021004,JAKARTA SELATAN,SETIA BUDI,KARET,9824,5138,4686,1676,6362,2021-07-24
3174021003,JAKARTA SELATAN,SETIA BUDI,KARET KUNINGAN,16356,7814,8542,2663,11205,2021-07-24
3174021002,JAKARTA SELATAN,SETIA BUDI,KARET SEMANGGI,2810,1241,1569,708,2277,2021-07-24
3171071003,JAKARTA PUSAT,TANAH ABANG,KARET TENGSIN,19698,10838,8860,2457,11317,2021-07-24
3171021003,JAKARTA PUSAT,SAWAH BESAR,KARTINI,22812,11517,11295,3755,15050,2021-07-24
3175011003,JAKARTA TIMUR,MATRAMAN,KAYU MANIS,25833,15511,10322,3357,13679,2021-07-24
3175021006,JAKARTA TIMUR,PULO GADUNG,KAYU PUTIH,41550,21342,20208,8101,28309,2021-07-24
3173031006,JAKARTA BARAT,TAMAN SARI,KEAGUNGAN,17729,8984,8745,2192,10937,2021-07-24
3174041007,JAKARTA SELATAN,PASAR MINGGU,KEBAGUSAN,45257,25655,19602,6431,26033,2021-07-24
3174051006,JAKARTA SELATAN,KEBAYORAN LAMA,KEBAYORAN LAMA SELATAN,41965,21629,20336,6325,26661,2021-07-24
3174051001,JAKARTA SELATAN,KEBAYORAN LAMA,KEBAYORAN LAMA UTARA,43328,25192,18136,5875,24011,2021-07-24
3174011004,JAKARTA SELATAN,TEBET,KEBON BARU,35871,19579,16292,5858,22150,2021-07-24
3172021005,JAKARTA UTARA,TANJUNG PRIOK,KEBON BAWANG,52097,27422,24675,7781,32456,2021-07-24
3173051001,JAKARTA BARAT,KEBON JERUK,KEBON JERUK,54764,32447,22317,7324,29641,2021-07-24
3171071006,JAKARTA PUSAT,TANAH ABANG,KEBON KACANG,22000,14118,7882,2818,10700,2021-07-24
3171011005,JAKARTA PUSAT,GAMBIR,KEBON KELAPA,10453,5729,4724,1769,6493,2021-07-24
3171031002,JAKARTA PUSAT,KEMAYORAN,KEBON KOSONG,30679,16781,13898,3969,17867,2021-07-24
3175011005,JAKARTA TIMUR,MATRAMAN,KEBON MANGGIS,16843,8889,7954,3182,11136,2021-07-24
3171071005,JAKARTA PUSAT,TANAH ABANG,KEBON MELATI,33178,22411,10767,3088,13855,2021-07-24
3175081003,JAKARTA TIMUR,MAKASAR,KEBON PALA,47563,27432,20131,6918,27049,2021-07-24
3171061005,JAKARTA PUSAT,MENTENG,KEBON SIRIH,12611,7886,4725,1742,6467,2021-07-24
3173011004,JAKARTA BARAT,CENGKARENG,KEDAUNG KALI ANGKE,33255,15348,17907,3793,21700,2021-07-24
3173051007,JAKARTA BARAT,KEBON JERUK,KEDOYA SELATAN,32647,17084,15563,4978,20541,2021-07-24
3173051006,JAKARTA BARAT,KEBON JERUK,KEDOYA UTARA,46407,23515,22892,7509,30401,2021-07-24
3173051004,JAKARTA BARAT,KEBON JERUK,KELAPA DUA,23936,13397,10539,3366,13905,2021-07-24
3175091003,JAKARTA TIMUR,CIRACAS,KELAPA DUA WETAN,47683,25251,22432,7934,30366,2021-07-24
3172061003,JAKARTA UTARA,KELAPA GADING,KELAPA GADING BARAT,36375,15322,21053,9429,30482,2021-07-24
3172061001,JAKARTA UTARA,KELAPA GADING,KELAPA GADING TIMUR,34089,13340,20749,9685,30434,2021-07-24
3173071005,JAKARTA BARAT,PALMERAH,KEMANGGISAN,32814,17700,15114,5564,20678,2021-07-24
3171031001,JAKARTA PUSAT,KEMAYORAN,KEMAYORAN,21186,10967,10219,3171,13390,2021-07-24
3173081006,JAKARTA BARAT,KEMBANGAN,KEMBANGAN SELATAN,27508,14542,12966,5396,18362,2021-07-24
3173081001,JAKARTA BARAT,KEMBANGAN,KEMBANGAN UTARA,55312,29626,25686,7210,32896,2021-07-24
3171041002,JAKARTA PUSAT,SENEN,KENARI,9820,5046,4774,1888,6662,2021-07-24
3173041005,JAKARTA BARAT,TAMBORA,KERENDANG,20382,11443,8939,2365,11304,2021-07-24
3175071003,JAKARTA TIMUR,DUREN SAWIT,KLENDER,71340,46142,25198,8235,33433,2021-07-24
3172031001,JAKARTA UTARA,KOJA,KOJA,28773,15159,13614,3101,16715,2021-07-24
3173071006,JAKARTA BARAT,PALMERAH,KOTA BAMBU SELATAN,21627,12130,9497,2447,11944,2021-07-24
3173071003,JAKARTA BARAT,PALMERAH,KOTA BAMBU UTARA,25510,14710,10800,2939,13739,2021-07-24
3171041004,JAKARTA PUSAT,SENEN,KRAMAT,29515,17819,11696,3323,15019,2021-07-24
3175041001,JAKARTA TIMUR,KRAMAT JATI,KRAMAT JATI,34814,20652,14162,5458,19620,2021-07-24
3174071003,JAKARTA SELATAN,KEBAYORAN BARU,KRAMAT PELA,14674,7257,7417,2652,10069,2021-07-24
3173031002,JAKARTA BARAT,TAMAN SARI,KRUKUT,19624,10645,8979,2479,11458,2021-07-24
3174031005,JAKARTA SELATAN,MAMPANG PRAPATAN,KUNINGAN BARAT,12986,6306,6680,1861,8541,2021-07-24
3174021008,JAKARTA SELATAN,SETIA BUDI,KUNINGAN TIMUR,6123,3229,2894,1194,4088,2021-07-24
3171041005,JAKARTA PUSAT,SENEN,KWITANG,15805,8565,7240,2378,9618,2021-07-24
3172031003,JAKARTA UTARA,KOJA,LAGOA,60201,33922,26279,6161,32440,2021-07-24
3174061002,JAKARTA SELATAN,CILANDAK,LEBAK BULUS,38208,20047,18161,7029,25190,2021-07-24
3174091004,JAKARTA SELATAN,JAGAKARSA,LENTENG AGUNG,54803,31727,23076,7223,30299,2021-07-24
3175101007,JAKARTA TIMUR,CIPAYUNG,LUBANG BUAYA,64480,35142,29338,9745,39083,2021-07-24
3175081001,JAKARTA TIMUR,MAKASAR,MAKASAR,35054,18912,16142,5644,21786,2021-07-24
3175071006,JAKARTA TIMUR,DUREN SAWIT,MALAKA JAYA,31629,15960,15669,6128,21797,2021-07-24
3175071005,JAKARTA TIMUR,DUREN SAWIT,MALAKA SARI,28114,14214,13900,5838,19738,2021-07-24
3174031001,JAKARTA SELATAN,MAMPANG PRAPATAN,MAMPANG PRAPATAN,18474,9779,8695,2481,11176,2021-07-24
3173031005,JAKARTA BARAT,TAMAN SARI,MANGGA BESAR,7834,3331,4503,1565,6068,2021-07-24
3171021005,JAKARTA PUSAT,SAWAH BESAR,MANGGA DUA SELATAN,28106,15061,13045,4232,17277,2021-07-24
3174011007,JAKARTA SELATAN,TEBET,MANGGARAI,28880,15919,12961,3946,16907,2021-07-24
3174011006,JAKARTA SELATAN,TEBET,MANGGARAI SELATAN,23514,12089,11425,4115,15540,2021-07-24
3173031003,JAKARTA BARAT,TAMAN SARI,MAPHAR,16790,8436,8354,2791,11145,2021-07-24
3172041003,JAKARTA UTARA,CILINCING,MARUNDA,29302,14975,14327,2774,17101,2021-07-24
3174071001,JAKARTA SELATAN,KEBAYORAN BARU,MELAWAI,2710,1157,1553,914,2467,2021-07-24
3171061001,JAKARTA PUSAT,MENTENG,MENTENG,26121,15919,10202,3924,14126,2021-07-24
3174021005,JAKARTA SELATAN,SETIA BUDI,MENTENG ATAS,28407,14560,13847,4547,18394,2021-07-24
3174011003,JAKARTA SELATAN,TEBET,MENTENG DALAM,36669,20537,16132,5937,22069,2021-07-24
3173081003,JAKARTA BARAT,KEMBANGAN,MERUYA SELATAN,32671,18532,14139,4665,18804,2021-07-24
3173081002,JAKARTA BARAT,KEMBANGAN,MERUYA UTARA,44535,24419,20116,7563,27679,2021-07-24
3175101004,JAKARTA TIMUR,CIPAYUNG,MUNJUL,24232,13560,10672,3842,14514,2021-07-24
3172051002,JAKARTA UTARA,PADEMANGAN,PADEMANGAN BARAT,75593,42392,33201,8341,41542,2021-07-24
3172051001,JAKARTA UTARA,PADEMANGAN,PADEMANGAN TIMUR,38344,17371,20973,7321,28294,2021-07-24
3175011004,JAKARTA TIMUR,MATRAMAN,PAL MERIAM,20183,11526,8657,3100,11757,2021-07-24
3173071001,JAKARTA BARAT,PALMERAH,PALMERAH,64057,35734,28323,8624,36947,2021-07-24
3174081001,JAKARTA SELATAN,PANCORAN,PANCORAN,19735,10251,9484,3155,12639,2021-07-24
3172021003,JAKARTA UTARA,TANJUNG PRIOK,PAPANGGO,39919,20501,19418,5194,24612,2021-07-24
3171021001,JAKARTA PUSAT,SAWAH BESAR,PASAR BARU,12302,5580,6722,2857,9579,2021-07-24
3174021006,JAKARTA SELATAN,SETIA BUDI,PASAR MANGGIS,27273,14585,12688,4122,16810,2021-07-24
3174041001,JAKARTA SELATAN,PASAR MINGGU,PASAR MINGGU,25321,13535,11786,5133,16919,2021-07-24
3171041003,JAKARTA PUSAT,SENEN,PASEBAN,24144,13315,10829,3607,14436,2021-07-24
3173061005,JAKARTA BARAT,KALI DERES,PEGADUNGAN,76816,42488,34328,10854,45182,2021-07-24
3171061002,JAKARTA PUSAT,MENTENG,PEGANGSAAN,23978,14675,9303,3210,12513,2021-07-24
3172061002,JAKARTA UTARA,KELAPA GADING,PEGANGSAAN DUA,50849,20613,30236,11172,41408,2021-07-24
3172011004,JAKARTA UTARA,PENJARINGAN,PEJAGALAN,75844,38543,37301,12372,49673,2021-07-24
3174041006,JAKARTA SELATAN,PASAR MINGGU,PEJATEN BARAT,37970,20083,17887,6636,24523,2021-07-24
3174041005,JAKARTA SELATAN,PASAR MINGGU,PEJATEN TIMUR,58725,35366,23359,8033,31392,2021-07-24
3175051005,JAKARTA TIMUR,PASAR REBO,PEKAYON,43973,22969,21004,6841,27845,2021-07-24
3173041009,JAKARTA BARAT,TAMBORA,PEKOJAN,23955,11965,11990,3723,15713,2021-07-24
3174031003,JAKARTA SELATAN,MAMPANG PRAPATAN,PELA MAMPANG,44274,22471,21803,6695,28498,2021-07-24
3174081005,JAKARTA SELATAN,PANCORAN,PENGADEGAN,21857,9852,12005,3957,15962,2021-07-24
3175061003,JAKARTA TIMUR,CAKUNG,PENGGILINGAN,101338,62956,38382,10274,48656,2021-07-24
3172011001,JAKARTA UTARA,PENJARINGAN,PENJARINGAN,90268,53922,36346,9012,45358,2021-07-24
3174101001,JAKARTA SELATAN,PESANGGRAHAN,PESANGGRAHAN,28134,13948,14186,5415,19601,2021-07-24
3171071004,JAKARTA PUSAT,TANAH ABANG,PETAMBURAN,34179,22565,11614,3178,14792,2021-07-24
3174071008,JAKARTA SELATAN,KEBAYORAN BARU,PETOGOGAN,11694,5962,5732,2165,7897,2021-07-24
3171011004,JAKARTA PUSAT,GAMBIR,PETOJO SELATAN,15153,8033,7120,3118,10238,2021-07-24
3171011003,JAKARTA PUSAT,GAMBIR,PETOJO UTARA,17858,10280,7578,2832,10410,2021-07-24
3174101004,JAKARTA SELATAN,PESANGGRAHAN,PETUKANGAN SELATAN,37906,19109,18797,5532,24329,2021-07-24
3174101003,JAKARTA SELATAN,PESANGGRAHAN,PETUKANGAN UTARA,54774,30525,24249,8197,32446,2021-07-24
3175081002,JAKARTA TIMUR,MAKASAR,PINANG RANTI,27705,14954,12751,3920,16671,2021-07-24
3173031008,JAKARTA BARAT,TAMAN SARI,PINANGSIA,10929,4949,5980,1786,7766,2021-07-24
3175011001,JAKARTA TIMUR,MATRAMAN,PISANGAN BARU,32340,20297,12043,4251,16294,2021-07-24
3175021002,JAKARTA TIMUR,PULO GADUNG,PISANGAN TIMUR,41806,23687,18119,6079,24198,2021-07-24
3172011005,JAKARTA UTARA,PENJARINGAN,PLUIT,48343,22411,25932,13200,39132,2021-07-24
3175071002,JAKARTA TIMUR,DUREN SAWIT,PONDOK BAMBU,62810,36438,26372,9959,36331,2021-07-24
3175071004,JAKARTA TIMUR,DUREN SAWIT,PONDOK KELAPA,73257,38980,34277,12030,46307,2021-07-24
3175071007,JAKARTA TIMUR,DUREN SAWIT,PONDOK KOPI,36156,22578,13578,4849,18427,2021-07-24
3174061003,JAKARTA SELATAN,CILANDAK,PONDOK LABU,47200,23080,24120,8464,32584,2021-07-24
3174051002,JAKARTA SELATAN,KEBAYORAN LAMA,PONDOK PINANG,57134,31187,25947,10652,36599,2021-07-24
3175101003,JAKARTA TIMUR,CIPAYUNG,PONDOK RANGGON,25905,15239,10666,4029,14695,2021-07-24
3101011003,KAB.ADM.KEP.SERIBU,KEP. SERIBU UTARA,PULAU HARAPAN,2094,562,1532,679,2211,2021-07-24
3101011002,KAB.ADM.KEP.SERIBU,KEP. SERIBU UTARA,PULAU KELAPA,5596,1439,4157,1162,5319,2021-07-24
3101011001,KAB.ADM.KEP.SERIBU,KEP. SERIBU UTARA,PULAU PANGGANG,5522,1249,4273,1194,5467,2021-07-24
3101021003,KAB.ADM.KEP.SERIBU,KEP. SERIBU SELATAN,PULAU PARI,2801,472,2329,653,2982,2021-07-24
3101021002,KAB.ADM.KEP.SERIBU,KEP. SERIBU SELATAN,PULAU TIDUNG,4634,1029,3605,1294,4899,2021-07-24
3101021001,KAB.ADM.KEP.SERIBU,KEP. SERIBU SELATAN,PULAU UNTUNG JAWA,1964,516,1448,584,2032,2021-07-24
3174071007,JAKARTA SELATAN,KEBAYORAN BARU,PULO,5915,2609,3306,1500,4806,2021-07-24
3175021001,JAKARTA TIMUR,PULO GADUNG,PULO GADUNG,35148,20473,14675,5155,19830,2021-07-24
3175061005,JAKARTA TIMUR,CAKUNG,PULO GEBANG,99227,57304,41923,11575,53498,2021-07-24
3174041004,JAKARTA SELATAN,PASAR MINGGU,RAGUNAN,40292,20134,20158,6886,27044,2021-07-24
3175091005,JAKARTA TIMUR,CIRACAS,RAMBUTAN,37488,23619,13869,4702,18571,2021-07-24
3172031006,JAKARTA UTARA,KOJA,RAWA BADAK SELATAN,43094,25561,17533,4192,21725,2021-07-24
3172031004,JAKARTA UTARA,KOJA,RAWA BADAK UTARA,35127,19043,16084,4219,20303,2021-07-24
3174071005,JAKARTA SELATAN,KEBAYORAN BARU,RAWA BARAT,5701,2702,2999,1472,4471,2021-07-24
3173011003,JAKARTA BARAT,CENGKARENG,RAWA BUAYA,64984,38301,26683,7016,33699,2021-07-24
3175031004,JAKARTA TIMUR,JATINEGARA,RAWA BUNGA,21819,13147,8672,2647,11319,2021-07-24
3174081003,JAKARTA SELATAN,PANCORAN,RAWA JATI,20969,10443,10526,3903,14429,2021-07-24
3175061002,JAKARTA TIMUR,CAKUNG,RAWA TERATE,25254,12915,12339,2309,14648,2021-07-24
3175021005,JAKARTA TIMUR,PULO GADUNG,RAWAMANGUN,38390,21522,16868,6354,23222,2021-07-24
3171051003,JAKARTA PUSAT,CEMPAKA PUTIH,RAWASARI,22583,12129,10454,3886,14340,2021-07-24
3173041010,JAKARTA BARAT,TAMBORA,ROA MALAKA,3527,1473,2054,943,2997,2021-07-24
3172041006,JAKARTA UTARA,CILINCING,ROROTAN,42339,21485,20854,5053,25907,2021-07-24
3174071004,JAKARTA SELATAN,KEBAYORAN BARU,SELONG,2885,1264,1621,954,2575,2021-07-24
3173061002,JAKARTA BARAT,KALI DERES,SEMANAN,72769,44199,28570,5565,34135,2021-07-24
3172041007,JAKARTA UTARA,CILINCING,SEMPER BARAT,70052,33999,36053,9764,45817,2021-07-24
3172041005,JAKARTA UTARA,CILINCING,SEMPER TIMUR,37024,19372,17652,4787,22439,2021-07-24
3174071006,JAKARTA SELATAN,KEBAYORAN BARU,SENAYAN,2848,1606,1242,638,1880,2021-07-24
3171041001,JAKARTA PUSAT,SENEN,SENEN,6994,3635,3359,1268,4627,2021-07-24
3171031004,JAKARTA PUSAT,KEMAYORAN,SERDANG,30405,16684,13721,4456,18177,2021-07-24
3174021001,JAKARTA SELATAN,SETIA BUDI,SETIA BUDI,3094,1589,1505,692,2197,2021-07-24
3175101005,JAKARTA TIMUR,CIPAYUNG,SETU,20870,13040,7830,2903,10733,2021-07-24
3173071002,JAKARTA BARAT,PALMERAH,SLIPI,16902,8518,8384,2878,11262,2021-07-24
3173081004,JAKARTA BARAT,KEMBANGAN,SRENGSENG,46238,27223,19015,6794,25809,2021-07-24
3174091002,JAKARTA SELATAN,JAGAKARSA,SRENGSENG SAWAH,59115,27834,31281,10608,41889,2021-07-24
3173051003,JAKARTA BARAT,KEBON JERUK,SUKABUMI SELATAN,37738,23092,14646,3764,18410,2021-07-24
3173051002,JAKARTA BARAT,KEBON JERUK,SUKABUMI UTARA,38909,24600,14309,4313,18622,2021-07-24
3172041002,JAKARTA UTARA,CILINCING,SUKAPURA,55672,29993,25679,5863,31542,2021-07-24
3171031007,JAKARTA PUSAT,KEMAYORAN,SUMUR BATU,23383,12622,10761,3999,14760,2021-07-24
3172021004,JAKARTA UTARA,TANJUNG PRIOK,SUNGAI BAMBU,30521,15688,14833,4240,19073,2021-07-24
3172021006,JAKARTA UTARA,TANJUNG PRIOK,SUNTER AGUNG,73070,32796,40274,14530,54804,2021-07-24
3172021002,JAKARTA UTARA,TANJUNG PRIOK,SUNTER JAYA,64160,31806,32354,11811,44165,2021-07-24
3175091004,JAKARTA TIMUR,CIRACAS,SUSUKAN,38962,22178,16784,5130,21914,2021-07-24
3173031001,JAKARTA BARAT,TAMAN SARI,TAMAN SARI,14592,7143,7449,2611,10060,2021-07-24
3173041001,JAKARTA BARAT,TAMBORA,TAMBORA,10418,5849,4569,1614,6183,2021-07-24
3173041004,JAKARTA BARAT,TAMBORA,TANAH SEREAL,26808,12699,14109,4168,18277,2021-07-24
3171081004,JAKARTA PUSAT,JOHAR BARU,TANAH TINGGI,38588,19138,19450,4729,24179,2021-07-24
3173031004,JAKARTA BARAT,TAMAN SARI,TANGKI,13569,6592,6977,2089,9066,2021-07-24
3174091005,JAKARTA SELATAN,JAGAKARSA,TANJUNG BARAT,40348,23194,17154,6491,23645,2021-07-24
3173021005,JAKARTA BARAT,GROGOL PETAMBURAN,TANJUNG DUREN SELATAN,25919,12272,13647,4970,18617,2021-07-24
3173021002,JAKARTA BARAT,GROGOL PETAMBURAN,TANJUNG DUREN UTARA,17282,7599,9683,3889,13572,2021-07-24
3172021001,JAKARTA UTARA,TANJUNG PRIOK,TANJUNG PRIOK,35493,17879,17614,4058,21672,2021-07-24
3174011002,JAKARTA SELATAN,TEBET,TEBET BARAT,21575,10352,11223,4733,15956,2021-07-24
3174011001,JAKARTA SELATAN,TEBET,TEBET TIMUR,18498,8421,10077,4195,14272,2021-07-24
3173061003,JAKARTA BARAT,KALI DERES,TEGAL ALUR,85206,49327,35879,7806,43685,2021-07-24
3174031004,JAKARTA SELATAN,MAMPANG PRAPATAN,TEGAL PARANG,32893,19387,13506,3955,17461,2021-07-24
3173021003,JAKARTA BARAT,GROGOL PETAMBURAN,TOMANG,30184,14783,15401,5512,20913,2021-07-24
3172031005,JAKARTA UTARA,KOJA,TUGU SELATAN,40013,22978,17035,4123,21158,2021-07-24
3172031002,JAKARTA UTARA,KOJA,TUGU UTARA,69068,39859,29209,7209,36418,2021-07-24
3175061006,JAKARTA TIMUR,CAKUNG,UJUNG MENTENG,30525,16088,14437,4413,18850,2021-07-24
3174101005,JAKARTA SELATAN,PESANGGRAHAN,ULUJAMI,41325,24389,16936,5697,22633,2021-07-24
3175011006,JAKARTA TIMUR,MATRAMAN,UTAN KAYU SELATAN,34205,18417,15788,5694,21482,2021-07-24
3175011002,JAKARTA TIMUR,MATRAMAN,UTAN KAYU UTARA,28777,15998,12779,4384,17163,2021-07-24
3171031008,JAKARTA PUSAT,KEMAYORAN,UTAN PANJANG,29932,17780,12152,3365,15517,2021-07-24
3172021007,JAKARTA UTARA,TANJUNG PRIOK,WARAKAS,45436,23760,21676,5777,27453,2021-07-24
3173021007,JAKARTA BARAT,GROGOL PETAMBURAN,WIJAYA KUSUMA,39811,22103,17708,5344,23052,2021-07-24
3172051003,JAKARTA UTARA,PADEMANGAN,ANCOL,23947,13381,10566,3503,14069,2021-07-25
3173041007,JAKARTA BARAT,TAMBORA,ANGKE,29381,14787,14594,3559,18153,2021-07-25
3175041005,JAKARTA TIMUR,KRAMAT JATI,BALE KAMBANG,29074,19749,9325,2942,12267,2021-07-25
3175031003,JAKARTA TIMUR,JATINEGARA,BALI MESTER,9752,5570,4182,1673,5855,2021-07-25
3175101006,JAKARTA TIMUR,CIPAYUNG,BAMBU APUS,26285,15178,11107,4364,15471,2021-07-25
3174031002,JAKARTA SELATAN,MAMPANG PRAPATAN,BANGKA,21566,11129,10437,3261,13698,2021-07-25
3175051002,JAKARTA TIMUR,PASAR REBO,BARU,23886,10907,12979,5334,18313,2021-07-25
3175041004,JAKARTA TIMUR,KRAMAT JATI,BATU AMPAR,47898,31289,16609,6033,22642,2021-07-25
3171071002,JAKARTA PUSAT,TANAH ABANG,BENDUNGAN HILIR,21494,10822,10672,3862,14534,2021-07-25
3175031002,JAKARTA TIMUR,JATINEGARA,BIDARA CINA,36689,23325,13364,4409,17773,2021-07-25
3174101002,JAKARTA SELATAN,PESANGGRAHAN,BINTARO,53098,28476,24622,8076,32698,2021-07-25
3174011005,JAKARTA SELATAN,TEBET,BUKIT DURI,34183,19444,14739,4705,19444,2021-07-25
3171041006,JAKARTA PUSAT,SENEN,BUNGUR,18144,9462,8682,3074,11756,2021-07-25
3175061007,JAKARTA TIMUR,CAKUNG,CAKUNG BARAT,57724,29222,28502,5613,34115,2021-07-25
3175061004,JAKARTA TIMUR,CAKUNG,CAKUNG TIMUR,58287,30701,27586,7715,35301,2021-07-25
3175041007,JAKARTA TIMUR,KRAMAT JATI,CAWANG,32762,19347,13415,4720,18135,2021-07-25
3175101008,JAKARTA TIMUR,CIPAYUNG,CEGER,18932,10868,8064,2813,10877,2021-07-25
3171031006,JAKARTA PUSAT,KEMAYORAN,CEMPAKA BARU,32581,18888,13693,4644,18337,2021-07-25
3171051002,JAKARTA PUSAT,CEMPAKA PUTIH,CEMPAKA PUTIH BARAT,35885,19642,16243,5466,21709,2021-07-25
3171051001,JAKARTA PUSAT,CEMPAKA PUTIH,CEMPAKA PUTIH TIMUR,24292,12570,11722,4922,16644,2021-07-25
3173011001,JAKARTA BARAT,CENGKARENG,CENGKARENG BARAT,66284,33565,32719,9842,42561,2021-07-25
3173011006,JAKARTA BARAT,CENGKARENG,CENGKARENG TIMUR,81027,44857,36170,10077,46247,2021-07-25
3175091002,JAKARTA TIMUR,CIRACAS,CIBUBUR,66364,33696,32668,10985,43653,2021-07-25
3171011002,JAKARTA PUSAT,GAMBIR,CIDENG,15390,7336,8054,3403,11457,2021-07-25
3174091003,JAKARTA SELATAN,JAGAKARSA,CIGANJUR,38497,19937,18560,6142,24702,2021-07-25
3175051003,JAKARTA TIMUR,PASAR REBO,CIJANTUNG,41419,21813,19606,7149,26755,2021-07-25
3171061003,JAKARTA PUSAT,MENTENG,CIKINI,8274,4723,3551,1502,5053,2021-07-25
3174081006,JAKARTA SELATAN,PANCORAN,CIKOKO,10547,4944,5603,1961,7564,2021-07-25
3174061001,JAKARTA SELATAN,CILANDAK,CILANDAK BARAT,51752,24872,26880,9363,36243,2021-07-25
3174041003,JAKARTA SELATAN,PASAR MINGGU,CILANDAK TIMUR,25145,12371,12774,5509,18283,2021-07-25
3175101002,JAKARTA TIMUR,CIPAYUNG,CILANGKAP,27635,15267,12368,4208,16576,2021-07-25
3175041006,JAKARTA TIMUR,KRAMAT JATI,CILILITAN,40181,24704,15477,5874,21351,2021-07-25
3172041001,JAKARTA UTARA,CILINCING,CILINCING,43609,24604,19005,4429,23434,2021-07-25
3175101001,JAKARTA TIMUR,CIPAYUNG,CIPAYUNG,26104,13508,12596,4598,17194,2021-07-25
3174091006,JAKARTA SELATAN,JAGAKARSA,CIPEDAK,38303,18438,19865,5969,25834,2021-07-25
3174061005,JAKARTA SELATAN,CILANDAK,CIPETE SELATAN,26704,13530,13174,4612,17786,2021-07-25
3174071010,JAKARTA SELATAN,KEBAYORAN BARU,CIPETE UTARA,34102,17127,16975,4868,21843,2021-07-25
3175021003,JAKARTA TIMUR,PULO GADUNG,CIPINANG,39306,21737,17569,6611,24180,2021-07-25
3175031007,JAKARTA TIMUR,JATINEGARA,CIPINANG BESAR SELATAN,35212,22463,12749,4207,16956,2021-07-25
3175031008,JAKARTA TIMUR,JATINEGARA,CIPINANG BESAR UTARA,45319,29689,15630,4543,20173,2021-07-25
3175031005,JAKARTA TIMUR,JATINEGARA,CIPINANG CEMPEDAK,32824,19319,13505,5073,18578,2021-07-25
3175081005,JAKARTA TIMUR,MAKASAR,CIPINANG MELAYU,42308,23077,19231,7050,26281,2021-07-25
3175031006,JAKARTA TIMUR,JATINEGARA,CIPINANG MUARA,55243,34562,20681,7975,28656,2021-07-25
3174051003,JAKARTA SELATAN,KEBAYORAN LAMA,CIPULIR,39937,23118,16819,5356,22175,2021-07-25
3175091001,JAKARTA TIMUR,CIRACAS,CIRACAS,64594,33898,30696,9477,40173,2021-07-25
3175041003,JAKARTA TIMUR,KRAMAT JATI,DUKUH,24609,14285,10324,3919,14243,2021-07-25
3175071001,JAKARTA TIMUR,DUREN SAWIT,DUREN SAWIT,61160,35858,25302,10431,35733,2021-07-25
3174081004,JAKARTA SELATAN,PANCORAN,DUREN TIGA,28319,14187,14132,4546,18678,2021-07-25
3173051005,JAKARTA BARAT,KEBON JERUK,DURI KEPA,60138,29124,31014,11037,42051,2021-07-25
3173011002,JAKARTA BARAT,CENGKARENG,DURI KOSAMBI,77923,44385,33538,10185,43723,2021-07-25
3171011006,JAKARTA PUSAT,GAMBIR,DURI PULO,19610,10607,9003,2580,11583,2021-07-25
3173041011,JAKARTA BARAT,TAMBORA,DURI SELATAN,14259,6902,7357,2504,9861,2021-07-25
3173041003,JAKARTA BARAT,TAMBORA,DURI UTARA,19844,10170,9674,2865,12539,2021-07-25
3171081003,JAKARTA PUSAT,JOHAR BARU,GALUR,18243,8630,9613,2129,11742,2021-07-25
3171011001,JAKARTA PUSAT,GAMBIR,GAMBIR,2191,1035,1156,574,1730,2021-07-25
3174061004,JAKARTA SELATAN,CILANDAK,GANDARIA SELATAN,22119,11730,10389,3569,13958,2021-07-25
3174071009,JAKARTA SELATAN,KEBAYORAN BARU,GANDARIA UTARA,39922,20758,19164,6269,25433,2021-07-25
3175051001,JAKARTA TIMUR,PASAR REBO,GEDONG,35755,19854,15901,6057,21958,2021-07-25
3171071001,JAKARTA PUSAT,TANAH ABANG,GELORA,3127,1667,1460,618,2078,2021-07-25
3173031007,JAKARTA BARAT,TAMAN SARI,GLODOK,7837,3120,4717,2154,6871,2021-07-25
3171061004,JAKARTA PUSAT,MENTENG,GONDANGDIA,4100,1851,2249,1404,3653,2021-07-25
3173021001,JAKARTA BARAT,GROGOL PETAMBURAN,GROGOL,16876,8640,8236,2933,11169,2021-07-25
3174051005,JAKARTA SELATAN,KEBAYORAN LAMA,GROGOL SELATAN,44251,25236,19015,6015,25030,2021-07-25
3174051004,JAKARTA SELATAN,KEBAYORAN LAMA,GROGOL UTARA,42494,24199,18295,6374,24669,2021-07-25
3174021007,JAKARTA SELATAN,SETIA BUDI,GUNTUR,3985,1802,2183,1078,3261,2021-07-25
3174071002,JAKARTA SELATAN,KEBAYORAN BARU,GUNUNG,9436,4480,4956,2302,7258,2021-07-25
3171031005,JAKARTA PUSAT,KEMAYORAN,GUNUNG SAHARI SELATAN,19199,9960,9239,3292,12531,2021-07-25
3171021004,JAKARTA PUSAT,SAWAH BESAR,GUNUNG SAHARI UTARA,16650,7497,9153,3607,12760,2021-07-25
3175081004,JAKARTA TIMUR,MAKASAR,HALIM PERDANA KUSUMAH,28363,10525,17838,9952,27790,2021-07-25
3171031003,JAKARTA PUSAT,KEMAYORAN,HARAPAN MULIA,22557,12846,9711,3077,12788,2021-07-25
3174091001,JAKARTA SELATAN,JAGAKARSA,JAGAKARSA,62389,30531,31858,10575,42433,2021-07-25
3175021007,JAKARTA TIMUR,PULO GADUNG,JATI,32757,18008,14749,6172,20921,2021-07-25
3174041002,JAKARTA SELATAN,PASAR MINGGU,JATI PADANG,37502,19441,18061,6927,24988,2021-07-25
3173071004,JAKARTA BARAT,PALMERAH,JATI PULO,28738,13922,14816,3890,18706,2021-07-25
3175061001,JAKARTA TIMUR,CAKUNG,JATINEGARA,84160,51738,32422,7733,40155,2021-07-25
3175021004,JAKARTA TIMUR,PULO GADUNG,JATINEGARA KAUM,24632,14018,10614,3241,13855,2021-07-25
3173021004,JAKARTA BARAT,GROGOL PETAMBURAN,JELAMBAR,30266,14822,15444,6195,21639,2021-07-25
3173021006,JAKARTA BARAT,GROGOL PETAMBURAN,JELAMBAR BARU,38246,19256,18990,6991,25981,2021-07-25
3173041006,JAKARTA BARAT,TAMBORA,JEMBATAN BESI,29314,18837,10477,2661,13138,2021-07-25
3173041008,JAKARTA BARAT,TAMBORA,JEMBATAN LIMA,21021,12414,8607,2517,11124,2021-07-25
3173081005,JAKARTA BARAT,KEMBANGAN,JOGLO,40839,22553,18286,6581,24867,2021-07-25
3171081001,JAKARTA PUSAT,JOHAR BARU,JOHAR BARU,37488,18455,19033,5956,24989,2021-07-25
3173041002,JAKARTA BARAT,TAMBORA,KALI ANYAR,23856,14015,9841,2408,12249,2021-07-25
3172041004,JAKARTA UTARA,CILINCING,KALIBARU,67684,40609,27075,4844,31919,2021-07-25
3174081002,JAKARTA SELATAN,PANCORAN,KALIBATA,41994,24111,17883,5830,23713,2021-07-25
3173061001,JAKARTA BARAT,KALI DERES,KALIDERES,72447,40277,32170,9037,41207,2021-07-25
3175051004,JAKARTA TIMUR,PASAR REBO,KALISARI,43212,23061,20151,7868,28019,2021-07-25
3173061004,JAKARTA BARAT,KALI DERES,KAMAL,53783,33836,19947,4018,23965,2021-07-25
3172011002,JAKARTA UTARA,PENJARINGAN,KAMAL MUARA,12930,4873,8057,2994,11051,2021-07-25
3171071007,JAKARTA PUSAT,TANAH ABANG,KAMPUNG BALI,11358,6885,4473,1566,6039,2021-07-25
3175031001,JAKARTA TIMUR,JATINEGARA,KAMPUNG MELAYU,25717,16270,9447,2482,11929,2021-07-25
3171081002,JAKARTA PUSAT,JOHAR BARU,KAMPUNG RAWA,21237,8936,12301,2808,15109,2021-07-25
3175041002,JAKARTA TIMUR,KRAMAT JATI,KAMPUNG TENGAH,43993,28091,15902,5767,21669,2021-07-25
3173011005,JAKARTA BARAT,CENGKARENG,KAPUK,134466,78944,55522,11145,66667,2021-07-25
3172011003,JAKARTA UTARA,PENJARINGAN,KAPUK MUARA,35781,16224,19557,7570,27127,2021-07-25
3171021002,JAKARTA PUSAT,SAWAH BESAR,KARANG ANYAR,25761,13498,12263,3667,15930,2021-07-25
3174021004,JAKARTA SELATAN,SETIA BUDI,KARET,9623,4955,4668,1671,6339,2021-07-25
3174021003,JAKARTA SELATAN,SETIA BUDI,KARET KUNINGAN,16055,7528,8527,2671,11198,2021-07-25
3174021002,JAKARTA SELATAN,SETIA BUDI,KARET SEMANGGI,2770,1198,1572,710,2282,2021-07-25
3171071003,JAKARTA PUSAT,TANAH ABANG,KARET TENGSIN,19271,10362,8909,2467,11376,2021-07-25
3171021003,JAKARTA PUSAT,SAWAH BESAR,KARTINI,22292,11002,11290,3775,15065,2021-07-25
3175011003,JAKARTA TIMUR,MATRAMAN,KAYU MANIS,25284,14955,10329,3381,13710,2021-07-25
3175021006,JAKARTA TIMUR,PULO GADUNG,KAYU PUTIH,40696,20470,20226,8184,28410,2021-07-25
3173031006,JAKARTA BARAT,TAMAN SARI,KEAGUNGAN,17387,8558,8829,2221,11050,2021-07-25
3174041007,JAKARTA SELATAN,PASAR MINGGU,KEBAGUSAN,44552,24939,19613,6662,26275,2021-07-25
3174051006,JAKARTA SELATAN,KEBAYORAN LAMA,KEBAYORAN LAMA SELATAN,41212,20813,20399,6347,26746,2021-07-25
3174051001,JAKARTA SELATAN,KEBAYORAN LAMA,KEBAYORAN LAMA UTARA,42422,24087,18335,5912,24247,2021-07-25
3174011004,JAKARTA SELATAN,TEBET,KEBON BARU,35165,18893,16272,5872,22144,2021-07-25
3172021005,JAKARTA UTARA,TANJUNG PRIOK,KEBON BAWANG,50952,26235,24717,7870,32587,2021-07-25
3173051001,JAKARTA BARAT,KEBON JERUK,KEBON JERUK,53887,31460,22427,7373,29800,2021-07-25
3171071006,JAKARTA PUSAT,TANAH ABANG,KEBON KACANG,21531,13651,7880,2841,10721,2021-07-25
3171011005,JAKARTA PUSAT,GAMBIR,KEBON KELAPA,10163,5447,4716,1767,6483,2021-07-25
3171031002,JAKARTA PUSAT,KEMAYORAN,KEBON KOSONG,30019,16116,13903,3999,17902,2021-07-25
3175011005,JAKARTA TIMUR,MATRAMAN,KEBON MANGGIS,16490,8549,7941,3183,11124,2021-07-25
3171071005,JAKARTA PUSAT,TANAH ABANG,KEBON MELATI,32206,21447,10759,3091,13850,2021-07-25
3175081003,JAKARTA TIMUR,MAKASAR,KEBON PALA,46614,26411,20203,6981,27184,2021-07-25
3171061005,JAKARTA PUSAT,MENTENG,KEBON SIRIH,12299,7566,4733,1755,6488,2021-07-25
3173011004,JAKARTA BARAT,CENGKARENG,KEDAUNG KALI ANGKE,32612,14601,18011,3837,21848,2021-07-25
3173051007,JAKARTA BARAT,KEBON JERUK,KEDOYA SELATAN,32165,16434,15731,5041,20772,2021-07-25
3173051006,JAKARTA BARAT,KEBON JERUK,KEDOYA UTARA,45740,22755,22985,7643,30628,2021-07-25
3173051004,JAKARTA BARAT,KEBON JERUK,KELAPA DUA,23565,13029,10536,3368,13904,2021-07-25
3175091003,JAKARTA TIMUR,CIRACAS,KELAPA DUA WETAN,46875,24390,22485,8042,30527,2021-07-25
3172061003,JAKARTA UTARA,KELAPA GADING,KELAPA GADING BARAT,35717,14689,21028,9474,30502,2021-07-25
3172061001,JAKARTA UTARA,KELAPA GADING,KELAPA GADING TIMUR,33592,12844,20748,9750,30498,2021-07-25
3173071005,JAKARTA BARAT,PALMERAH,KEMANGGISAN,32139,17065,15074,5610,20684,2021-07-25
3171031001,JAKARTA PUSAT,KEMAYORAN,KEMAYORAN,20708,10479,10229,3179,13408,2021-07-25
3173081006,JAKARTA BARAT,KEMBANGAN,KEMBANGAN SELATAN,27130,14078,13052,5449,18501,2021-07-25
3173081001,JAKARTA BARAT,KEMBANGAN,KEMBANGAN UTARA,54451,28606,25845,7303,33148,2021-07-25
3171041002,JAKARTA PUSAT,SENEN,KENARI,9579,4753,4826,1890,6716,2021-07-25
3173041005,JAKARTA BARAT,TAMBORA,KERENDANG,19973,10901,9072,2394,11466,2021-07-25
3175071003,JAKARTA TIMUR,DUREN SAWIT,KLENDER,69978,44610,25368,8338,33706,2021-07-25
3172031001,JAKARTA UTARA,KOJA,KOJA,28175,14531,13644,3210,16854,2021-07-25
3173071006,JAKARTA BARAT,PALMERAH,KOTA BAMBU SELATAN,21158,11684,9474,2456,11930,2021-07-25
3173071003,JAKARTA BARAT,PALMERAH,KOTA BAMBU UTARA,24995,14204,10791,2963,13754,2021-07-25
3171041004,JAKARTA PUSAT,SENEN,KRAMAT,28835,16936,11899,3338,15237,2021-07-25
3175041001,JAKARTA TIMUR,KRAMAT JATI,KRAMAT JATI,34144,19913,14231,5497,19728,2021-07-25
3174071003,JAKARTA SELATAN,KEBAYORAN BARU,KRAMAT PELA,14413,7003,7410,2662,10072,2021-07-25
3173031002,JAKARTA BARAT,TAMAN SARI,KRUKUT,19244,10165,9079,2531,11610,2021-07-25
3174031005,JAKARTA SELATAN,MAMPANG PRAPATAN,KUNINGAN BARAT,12785,6069,6716,1899,8615,2021-07-25
3174021008,JAKARTA SELATAN,SETIA BUDI,KUNINGAN TIMUR,6008,3119,2889,1202,4091,2021-07-25
3171041005,JAKARTA PUSAT,SENEN,KWITANG,15486,8225,7261,2393,9654,2021-07-25
3172031003,JAKARTA UTARA,KOJA,LAGOA,59065,32760,26305,6357,32662,2021-07-25
3174061002,JAKARTA SELATAN,CILANDAK,LEBAK BULUS,37626,19496,18130,7041,25171,2021-07-25
3174091004,JAKARTA SELATAN,JAGAKARSA,LENTENG AGUNG,53946,30794,23152,7275,30427,2021-07-25
3175101007,JAKARTA TIMUR,CIPAYUNG,LUBANG BUAYA,63547,34189,29358,10203,39561,2021-07-25
3175081001,JAKARTA TIMUR,MAKASAR,MAKASAR,34390,18222,16168,5746,21914,2021-07-25
3175071006,JAKARTA TIMUR,DUREN SAWIT,MALAKA JAYA,30927,15286,15641,6155,21796,2021-07-25
3175071005,JAKARTA TIMUR,DUREN SAWIT,MALAKA SARI,27530,13650,13880,5888,19768,2021-07-25
3174031001,JAKARTA SELATAN,MAMPANG PRAPATAN,MAMPANG PRAPATAN,18159,9425,8734,2600,11334,2021-07-25
3173031005,JAKARTA BARAT,TAMAN SARI,MANGGA BESAR,7707,3202,4505,1571,6076,2021-07-25
3171021005,JAKARTA PUSAT,SAWAH BESAR,MANGGA DUA SELATAN,27442,14421,13021,4264,17285,2021-07-25
3174011007,JAKARTA SELATAN,TEBET,MANGGARAI,28373,15348,13025,3952,16977,2021-07-25
3174011006,JAKARTA SELATAN,TEBET,MANGGARAI SELATAN,23075,11642,11433,4130,15563,2021-07-25
3173031003,JAKARTA BARAT,TAMAN SARI,MAPHAR,16461,8070,8391,2811,11202,2021-07-25
3172041003,JAKARTA UTARA,CILINCING,MARUNDA,28943,14598,14345,2831,17176,2021-07-25
3174071001,JAKARTA SELATAN,KEBAYORAN BARU,MELAWAI,2627,1086,1541,916,2457,2021-07-25
3171061001,JAKARTA PUSAT,MENTENG,MENTENG,25624,15418,10206,3945,14151,2021-07-25
3174021005,JAKARTA SELATAN,SETIA BUDI,MENTENG ATAS,27816,13990,13826,4557,18383,2021-07-25
3174011003,JAKARTA SELATAN,TEBET,MENTENG DALAM,36028,19869,16159,5996,22155,2021-07-25
3173081003,JAKARTA BARAT,KEMBANGAN,MERUYA SELATAN,32130,17912,14218,4692,18910,2021-07-25
3173081002,JAKARTA BARAT,KEMBANGAN,MERUYA UTARA,43752,23360,20392,7674,28066,2021-07-25
3175101004,JAKARTA TIMUR,CIPAYUNG,MUNJUL,23871,13192,10679,3863,14542,2021-07-25
3172051002,JAKARTA UTARA,PADEMANGAN,PADEMANGAN BARAT,74240,40592,33648,8388,42036,2021-07-25
3172051001,JAKARTA UTARA,PADEMANGAN,PADEMANGAN TIMUR,37736,16703,21033,7370,28403,2021-07-25
3175011004,JAKARTA TIMUR,MATRAMAN,PAL MERIAM,19769,11124,8645,3108,11753,2021-07-25
3173071001,JAKARTA BARAT,PALMERAH,PALMERAH,63011,34684,28327,8716,37043,2021-07-25
3174081001,JAKARTA SELATAN,PANCORAN,PANCORAN,19421,9919,9502,3188,12690,2021-07-25
3172021003,JAKARTA UTARA,TANJUNG PRIOK,PAPANGGO,39097,19653,19444,5216,24660,2021-07-25
3171021001,JAKARTA PUSAT,SAWAH BESAR,PASAR BARU,12035,5260,6775,2865,9640,2021-07-25
3174021006,JAKARTA SELATAN,SETIA BUDI,PASAR MANGGIS,26752,14060,12692,4125,16817,2021-07-25
3174041001,JAKARTA SELATAN,PASAR MINGGU,PASAR MINGGU,24821,12935,11886,5203,17089,2021-07-25
3171041003,JAKARTA PUSAT,SENEN,PASEBAN,23533,12636,10897,3613,14510,2021-07-25
3173061005,JAKARTA BARAT,KALI DERES,PEGADUNGAN,75587,41056,34531,11260,45791,2021-07-25
3171061002,JAKARTA PUSAT,MENTENG,PEGANGSAAN,23455,14126,9329,3214,12543,2021-07-25
3172061002,JAKARTA UTARA,KELAPA GADING,PEGANGSAAN DUA,49976,19783,30193,11261,41454,2021-07-25
3172011004,JAKARTA UTARA,PENJARINGAN,PEJAGALAN,74578,37168,37410,12729,50139,2021-07-25
3174041006,JAKARTA SELATAN,PASAR MINGGU,PEJATEN BARAT,37346,19482,17864,6669,24533,2021-07-25
3174041005,JAKARTA SELATAN,PASAR MINGGU,PEJATEN TIMUR,57656,34212,23444,8077,31521,2021-07-25
3175051005,JAKARTA TIMUR,PASAR REBO,PEKAYON,43250,22225,21025,6950,27975,2021-07-25
3173041009,JAKARTA BARAT,TAMBORA,PEKOJAN,23587,11503,12084,3787,15871,2021-07-25
3174031003,JAKARTA SELATAN,MAMPANG PRAPATAN,PELA MAMPANG,43522,21692,21830,6825,28655,2021-07-25
3174081005,JAKARTA SELATAN,PANCORAN,PENGADEGAN,21478,9490,11988,3963,15951,2021-07-25
3175061003,JAKARTA TIMUR,CAKUNG,PENGGILINGAN,99255,60788,38467,10384,48851,2021-07-25
3172011001,JAKARTA UTARA,PENJARINGAN,PENJARINGAN,88308,51918,36390,9259,45649,2021-07-25
3174101001,JAKARTA SELATAN,PESANGGRAHAN,PESANGGRAHAN,27545,13380,14165,5423,19588,2021-07-25
3171071004,JAKARTA PUSAT,TANAH ABANG,PETAMBURAN,33271,21681,11590,3184,14774,2021-07-25
3174071008,JAKARTA SELATAN,KEBAYORAN BARU,PETOGOGAN,11499,5763,5736,2186,7922,2021-07-25
3171011004,JAKARTA PUSAT,GAMBIR,PETOJO SELATAN,14692,7627,7065,3094,10159,2021-07-25
3171011003,JAKARTA PUSAT,GAMBIR,PETOJO UTARA,17458,9863,7595,2861,10456,2021-07-25
3174101004,JAKARTA SELATAN,PESANGGRAHAN,PETUKANGAN SELATAN,37187,18372,18815,5540,24355,2021-07-25
3174101003,JAKARTA SELATAN,PESANGGRAHAN,PETUKANGAN UTARA,53716,29323,24393,8292,32685,2021-07-25
3175081002,JAKARTA TIMUR,MAKASAR,PINANG RANTI,27198,14427,12771,4010,16781,2021-07-25
3173031008,JAKARTA BARAT,TAMAN SARI,PINANGSIA,10729,4737,5992,1806,7798,2021-07-25
3175011001,JAKARTA TIMUR,MATRAMAN,PISANGAN BARU,31776,19725,12051,4282,16333,2021-07-25
3175021002,JAKARTA TIMUR,PULO GADUNG,PISANGAN TIMUR,41011,22764,18247,6122,24369,2021-07-25
3172011005,JAKARTA UTARA,PENJARINGAN,PLUIT,47783,21847,25936,13421,39357,2021-07-25
3175071002,JAKARTA TIMUR,DUREN SAWIT,PONDOK BAMBU,61550,35195,26355,10022,36377,2021-07-25
3175071004,JAKARTA TIMUR,DUREN SAWIT,PONDOK KELAPA,72015,37833,34182,12121,46303,2021-07-25
3175071007,JAKARTA TIMUR,DUREN SAWIT,PONDOK KOPI,35367,21831,13536,4882,18418,2021-07-25
3174061003,JAKARTA SELATAN,CILANDAK,PONDOK LABU,46464,22248,24216,8514,32730,2021-07-25
3174051002,JAKARTA SELATAN,KEBAYORAN LAMA,PONDOK PINANG,56169,30174,25995,10670,36665,2021-07-25
3175101003,JAKARTA TIMUR,CIPAYUNG,PONDOK RANGGON,25574,14893,10681,4054,14735,2021-07-25
3101011003,KAB.ADM.KEP.SERIBU,KEP. SERIBU UTARA,PULAU HARAPAN,2060,508,1552,685,2237,2021-07-25
3101011002,KAB.ADM.KEP.SERIBU,KEP. SERIBU UTARA,PULAU KELAPA,5528,1272,4256,1320,5576,2021-07-25
3101011001,KAB.ADM.KEP.SERIBU,KEP. SERIBU UTARA,PULAU PANGGANG,5450,1185,4265,1237,5502,2021-07-25
3101021003,KAB.ADM.KEP.SERIBU,KEP. SERIBU SELATAN,PULAU PARI,2765,437,2328,654,2982,2021-07-25
3101021002,KAB.ADM.KEP.SERIBU,KEP. SERIBU SELATAN,PULAU TIDUNG,4553,951,3602,1337,4939,2021-07-25
3101021001,KAB.ADM.KEP.SERIBU,KEP. SERIBU SELATAN,PULAU UNTUNG JAWA,1941,488,1453,588,2041,2021-07-25
3174071007,JAKARTA SELATAN,KEBAYORAN BARU,PULO,5835,2511,3324,1520,4844,2021-07-25
3175021001,JAKARTA TIMUR,PULO GADUNG,PULO GADUNG,34422,19699,14723,5189,19912,2021-07-25
3175061005,JAKARTA TIMUR,CAKUNG,PULO GEBANG,97301,55219,42082,11684,53766,2021-07-25
3174041004,JAKARTA SELATAN,PASAR MINGGU,RAGUNAN,39616,19400,20216,6960,27176,2021-07-25
3175091005,JAKARTA TIMUR,CIRACAS,RAMBUTAN,36771,22722,14049,4767,18816,2021-07-25
3172031006,JAKARTA UTARA,KOJA,RAWA BADAK SELATAN,42179,24600,17579,4351,21930,2021-07-25
3172031004,JAKARTA UTARA,KOJA,RAWA BADAK UTARA,34408,18331,16077,4277,20354,2021-07-25
3174071005,JAKARTA SELATAN,KEBAYORAN BARU,RAWA BARAT,5625,2625,3000,1480,4480,2021-07-25
3173011003,JAKARTA BARAT,CENGKARENG,RAWA BUAYA,63799,36764,27035,7174,34209,2021-07-25
3175031004,JAKARTA TIMUR,JATINEGARA,RAWA BUNGA,21434,12758,8676,2666,11342,2021-07-25
3174081003,JAKARTA SELATAN,PANCORAN,RAWA JATI,20509,10011,10498,3913,14411,2021-07-25
3175061002,JAKARTA TIMUR,CAKUNG,RAWA TERATE,24637,12292,12345,2334,14679,2021-07-25
3175021005,JAKARTA TIMUR,PULO GADUNG,RAWAMANGUN,37612,20551,17061,6385,23446,2021-07-25
3171051003,JAKARTA PUSAT,CEMPAKA PUTIH,RAWASARI,21967,11515,10452,3908,14360,2021-07-25
3173041010,JAKARTA BARAT,TAMBORA,ROA MALAKA,3484,1428,2056,955,3011,2021-07-25
3172041006,JAKARTA UTARA,CILINCING,ROROTAN,41668,20783,20885,5174,26059,2021-07-25
3174071004,JAKARTA SELATAN,KEBAYORAN BARU,SELONG,2842,1220,1622,956,2578,2021-07-25
3173061002,JAKARTA BARAT,KALI DERES,SEMANAN,71354,42670,28684,5646,34330,2021-07-25
3172041007,JAKARTA UTARA,CILINCING,SEMPER BARAT,68587,32419,36168,9869,46037,2021-07-25
3172041005,JAKARTA UTARA,CILINCING,SEMPER TIMUR,36267,18630,17637,4909,22546,2021-07-25
3174071006,JAKARTA SELATAN,KEBAYORAN BARU,SENAYAN,2771,1528,1243,641,1884,2021-07-25
3171041001,JAKARTA PUSAT,SENEN,SENEN,6804,3452,3352,1269,4621,2021-07-25
3171031004,JAKARTA PUSAT,KEMAYORAN,SERDANG,29668,15931,13737,4457,18194,2021-07-25
3174021001,JAKARTA SELATAN,SETIA BUDI,SETIA BUDI,3023,1529,1494,693,2187,2021-07-25
3175101005,JAKARTA TIMUR,CIPAYUNG,SETU,20572,12644,7928,2918,10846,2021-07-25
3173071002,JAKARTA BARAT,PALMERAH,SLIPI,16591,8219,8372,2886,11258,2021-07-25
3173081004,JAKARTA BARAT,KEMBANGAN,SRENGSENG,45523,26448,19075,6840,25915,2021-07-25
3174091002,JAKARTA SELATAN,JAGAKARSA,SRENGSENG SAWAH,58196,26929,31267,10629,41896,2021-07-25
3173051003,JAKARTA BARAT,KEBON JERUK,SUKABUMI SELATAN,37033,22381,14652,3782,18434,2021-07-25
3173051002,JAKARTA BARAT,KEBON JERUK,SUKABUMI UTARA,38290,23960,14330,4328,18658,2021-07-25
3172041002,JAKARTA UTARA,CILINCING,SUKAPURA,53949,28131,25818,5917,31735,2021-07-25
3171031007,JAKARTA PUSAT,KEMAYORAN,SUMUR BATU,22717,11973,10744,4000,14744,2021-07-25
3172021004,JAKARTA UTARA,TANJUNG PRIOK,SUNGAI BAMBU,29876,15028,14848,4316,19164,2021-07-25
3172021006,JAKARTA UTARA,TANJUNG PRIOK,SUNTER AGUNG,71805,31480,40325,14635,54960,2021-07-25
3172021002,JAKARTA UTARA,TANJUNG PRIOK,SUNTER JAYA,63031,30654,32377,11865,44242,2021-07-25
3175091004,JAKARTA TIMUR,CIRACAS,SUSUKAN,38257,21313,16944,5297,22241,2021-07-25
3173031001,JAKARTA BARAT,TAMAN SARI,TAMAN SARI,14348,6881,7467,2631,10098,2021-07-25
3173041001,JAKARTA BARAT,TAMBORA,TAMBORA,10204,5634,4570,1626,6196,2021-07-25
3173041004,JAKARTA BARAT,TAMBORA,TANAH SEREAL,26387,12258,14129,4207,18336,2021-07-25
3171081004,JAKARTA PUSAT,JOHAR BARU,TANAH TINGGI,37693,18139,19554,4825,24379,2021-07-25
3173031004,JAKARTA BARAT,TAMAN SARI,TANGKI,13324,6246,7078,2126,9204,2021-07-25
3174091005,JAKARTA SELATAN,JAGAKARSA,TANJUNG BARAT,39770,22544,17226,6542,23768,2021-07-25
3173021005,JAKARTA BARAT,GROGOL PETAMBURAN,TANJUNG DUREN SELATAN,25337,11700,13637,5068,18705,2021-07-25
3173021002,JAKARTA BARAT,GROGOL PETAMBURAN,TANJUNG DUREN UTARA,17010,7340,9670,3968,13638,2021-07-25
3172021001,JAKARTA UTARA,TANJUNG PRIOK,TANJUNG PRIOK,34588,16940,17648,4063,21711,2021-07-25
3174011002,JAKARTA SELATAN,TEBET,TEBET BARAT,21194,9978,11216,4778,15994,2021-07-25
3174011001,JAKARTA SELATAN,TEBET,TEBET TIMUR,18199,8139,10060,4232,14292,2021-07-25
3173061003,JAKARTA BARAT,KALI DERES,TEGAL ALUR,83647,47533,36114,7987,44101,2021-07-25
3174031004,JAKARTA SELATAN,MAMPANG PRAPATAN,TEGAL PARANG,32401,18838,13563,4063,17626,2021-07-25
3173021003,JAKARTA BARAT,GROGOL PETAMBURAN,TOMANG,29605,14205,15400,5586,20986,2021-07-25
3172031005,JAKARTA UTARA,KOJA,TUGU SELATAN,39122,21975,17147,4242,21389,2021-07-25
3172031002,JAKARTA UTARA,KOJA,TUGU UTARA,67670,38371,29299,7288,36587,2021-07-25
3175061006,JAKARTA TIMUR,CAKUNG,UJUNG MENTENG,29934,15398,14536,4472,19008,2021-07-25
3174101005,JAKARTA SELATAN,PESANGGRAHAN,ULUJAMI,40544,23277,17267,5743,23010,2021-07-25
3175011006,JAKARTA TIMUR,MATRAMAN,UTAN KAYU SELATAN,33511,17706,15805,5713,21518,2021-07-25
3175011002,JAKARTA TIMUR,MATRAMAN,UTAN KAYU UTARA,28169,15385,12784,4401,17185,2021-07-25
3171031008,JAKARTA PUSAT,KEMAYORAN,UTAN PANJANG,29208,17032,12176,3378,15554,2021-07-25
3172021007,JAKARTA UTARA,TANJUNG PRIOK,WARAKAS,44401,22698,21703,5830,27533,2021-07-25
3173021007,JAKARTA BARAT,GROGOL PETAMBURAN,WIJAYA KUSUMA,38934,21154,17780,5459,23239,2021-07-25
3172051003,JAKARTA UTARA,PADEMANGAN,ANCOL,23947,13324,10623,3547,14170,2021-07-26
3173041007,JAKARTA BARAT,TAMBORA,ANGKE,29381,14671,14710,3602,18312,2021-07-26
3175041005,JAKARTA TIMUR,KRAMAT JATI,BALE KAMBANG,29074,19653,9421,2961,12382,2021-07-26
3175031003,JAKARTA TIMUR,JATINEGARA,BALI MESTER,9752,5553,4199,1679,5878,2021-07-26
3175101006,JAKARTA TIMUR,CIPAYUNG,BAMBU APUS,26285,15056,11229,4375,15604,2021-07-26
3174031002,JAKARTA SELATAN,MAMPANG PRAPATAN,BANGKA,21566,11098,10468,3279,13747,2021-07-26
3175051002,JAKARTA TIMUR,PASAR REBO,BARU,23886,10874,13012,5346,18358,2021-07-26
3175041004,JAKARTA TIMUR,KRAMAT JATI,BATU AMPAR,47898,31088,16810,6071,22881,2021-07-26
3171071002,JAKARTA PUSAT,TANAH ABANG,BENDUNGAN HILIR,21494,10804,10690,3869,14559,2021-07-26
3175031002,JAKARTA TIMUR,JATINEGARA,BIDARA CINA,36689,23280,13409,4430,17839,2021-07-26
3174101002,JAKARTA SELATAN,PESANGGRAHAN,BINTARO,53098,28179,24919,8116,33035,2021-07-26
3174011005,JAKARTA SELATAN,TEBET,BUKIT DURI,34183,19411,14772,4718,19490,2021-07-26
3171041006,JAKARTA PUSAT,SENEN,BUNGUR,18144,9440,8704,3084,11788,2021-07-26
3175061007,JAKARTA TIMUR,CAKUNG,CAKUNG BARAT,57724,29059,28665,5647,34312,2021-07-26
3175061004,JAKARTA TIMUR,CAKUNG,CAKUNG TIMUR,58287,30390,27897,7746,35643,2021-07-26
3175041007,JAKARTA TIMUR,KRAMAT JATI,CAWANG,32762,19249,13513,4766,18279,2021-07-26
3175101008,JAKARTA TIMUR,CIPAYUNG,CEGER,18932,10718,8214,2827,11041,2021-07-26
3171031006,JAKARTA PUSAT,KEMAYORAN,CEMPAKA BARU,32581,18760,13821,4653,18474,2021-07-26
3171051002,JAKARTA PUSAT,CEMPAKA PUTIH,CEMPAKA PUTIH BARAT,35885,19498,16387,5474,21861,2021-07-26
3171051001,JAKARTA PUSAT,CEMPAKA PUTIH,CEMPAKA PUTIH TIMUR,24292,12531,11761,4927,16688,2021-07-26
3173011001,JAKARTA BARAT,CENGKARENG,CENGKARENG BARAT,66284,33474,32810,9902,42712,2021-07-26
3173011006,JAKARTA BARAT,CENGKARENG,CENGKARENG TIMUR,81027,44766,36261,10303,46564,2021-07-26
3175091002,JAKARTA TIMUR,CIRACAS,CIBUBUR,66364,33596,32768,11047,43815,2021-07-26
3171011002,JAKARTA PUSAT,GAMBIR,CIDENG,15390,7320,8070,3417,11487,2021-07-26
3174091003,JAKARTA SELATAN,JAGAKARSA,CIGANJUR,38497,19819,18678,6172,24850,2021-07-26
3175051003,JAKARTA TIMUR,PASAR REBO,CIJANTUNG,41419,21680,19739,7337,27076,2021-07-26
3171061003,JAKARTA PUSAT,MENTENG,CIKINI,8274,4651,3623,1507,5130,2021-07-26
3174081006,JAKARTA SELATAN,PANCORAN,CIKOKO,10547,4937,5610,1970,7580,2021-07-26
3174061001,JAKARTA SELATAN,CILANDAK,CILANDAK BARAT,51752,24736,27016,9419,36435,2021-07-26
3174041003,JAKARTA SELATAN,PASAR MINGGU,CILANDAK TIMUR,25145,12245,12900,5527,18427,2021-07-26
3175101002,JAKARTA TIMUR,CIPAYUNG,CILANGKAP,27635,15204,12431,4233,16664,2021-07-26
3175041006,JAKARTA TIMUR,KRAMAT JATI,CILILITAN,40181,24599,15582,5942,21524,2021-07-26
3172041001,JAKARTA UTARA,CILINCING,CILINCING,43609,24563,19046,4446,23492,2021-07-26
3175101001,JAKARTA TIMUR,CIPAYUNG,CIPAYUNG,26104,13331,12773,4622,17395,2021-07-26
3174091006,JAKARTA SELATAN,JAGAKARSA,CIPEDAK,38303,18158,20145,6009,26154,2021-07-26
3174061005,JAKARTA SELATAN,CILANDAK,CIPETE SELATAN,26704,13489,13215,4630,17845,2021-07-26
3174071010,JAKARTA SELATAN,KEBAYORAN BARU,CIPETE UTARA,34102,16981,17121,4902,22023,2021-07-26
3175021003,JAKARTA TIMUR,PULO GADUNG,CIPINANG,39306,21649,17657,6628,24285,2021-07-26
3175031007,JAKARTA TIMUR,JATINEGARA,CIPINANG BESAR SELATAN,35212,22416,12796,4220,17016,2021-07-26
3175031008,JAKARTA TIMUR,JATINEGARA,CIPINANG BESAR UTARA,45319,29623,15696,4564,20260,2021-07-26
3175031005,JAKARTA TIMUR,JATINEGARA,CIPINANG CEMPEDAK,32824,19273,13551,5101,18652,2021-07-26
3175081005,JAKARTA TIMUR,MAKASAR,CIPINANG MELAYU,42308,23020,19288,7070,26358,2021-07-26
3175031006,JAKARTA TIMUR,JATINEGARA,CIPINANG MUARA,55243,34448,20795,8003,28798,2021-07-26
3174051003,JAKARTA SELATAN,KEBAYORAN LAMA,CIPULIR,39937,23041,16896,5395,22291,2021-07-26
3175091001,JAKARTA TIMUR,CIRACAS,CIRACAS,64594,33507,31087,9683,40770,2021-07-26
3175041003,JAKARTA TIMUR,KRAMAT JATI,DUKUH,24609,14168,10441,3929,14370,2021-07-26
3175071001,JAKARTA TIMUR,DUREN SAWIT,DUREN SAWIT,61160,35797,25363,10457,35820,2021-07-26
3174081004,JAKARTA SELATAN,PANCORAN,DUREN TIGA,28319,14153,14166,4574,18740,2021-07-26
3173051005,JAKARTA BARAT,KEBON JERUK,DURI KEPA,60138,29066,31072,11138,42210,2021-07-26
3173011002,JAKARTA BARAT,CENGKARENG,DURI KOSAMBI,77923,43885,34038,10226,44264,2021-07-26
3171011006,JAKARTA PUSAT,GAMBIR,DURI PULO,19610,10585,9025,2604,11629,2021-07-26
3173041011,JAKARTA BARAT,TAMBORA,DURI SELATAN,14259,6850,7409,2526,9935,2021-07-26
3173041003,JAKARTA BARAT,TAMBORA,DURI UTARA,19844,9957,9887,2903,12790,2021-07-26
3171081003,JAKARTA PUSAT,JOHAR BARU,GALUR,18243,8560,9683,2131,11814,2021-07-26
3171011001,JAKARTA PUSAT,GAMBIR,GAMBIR,2191,1033,1158,574,1732,2021-07-26
3174061004,JAKARTA SELATAN,CILANDAK,GANDARIA SELATAN,22119,11670,10449,3586,14035,2021-07-26
3174071009,JAKARTA SELATAN,KEBAYORAN BARU,GANDARIA UTARA,39922,20703,19219,6298,25517,2021-07-26
3175051001,JAKARTA TIMUR,PASAR REBO,GEDONG,35755,19759,15996,6104,22100,2021-07-26
3171071001,JAKARTA PUSAT,TANAH ABANG,GELORA,3127,1662,1465,620,2085,2021-07-26
3173031007,JAKARTA BARAT,TAMAN SARI,GLODOK,7837,3117,4720,2170,6890,2021-07-26
3171061004,JAKARTA PUSAT,MENTENG,GONDANGDIA,4100,1849,2251,1406,3657,2021-07-26
3173021001,JAKARTA BARAT,GROGOL PETAMBURAN,GROGOL,16876,8633,8243,2957,11200,2021-07-26
3174051005,JAKARTA SELATAN,KEBAYORAN LAMA,GROGOL SELATAN,44251,24902,19349,6045,25394,2021-07-26
3174051004,JAKARTA SELATAN,KEBAYORAN LAMA,GROGOL UTARA,42494,24147,18347,6397,24744,2021-07-26
3174021007,JAKARTA SELATAN,SETIA BUDI,GUNTUR,3985,1802,2183,1082,3265,2021-07-26
3174071002,JAKARTA SELATAN,KEBAYORAN BARU,GUNUNG,9436,4456,4980,2308,7288,2021-07-26
3171031005,JAKARTA PUSAT,KEMAYORAN,GUNUNG SAHARI SELATAN,19199,9920,9279,3314,12593,2021-07-26
3171021004,JAKARTA PUSAT,SAWAH BESAR,GUNUNG SAHARI UTARA,16650,7465,9185,3623,12808,2021-07-26
3175081004,JAKARTA TIMUR,MAKASAR,HALIM PERDANA KUSUMAH,28363,10494,17869,9967,27836,2021-07-26
3171031003,JAKARTA PUSAT,KEMAYORAN,HARAPAN MULIA,22557,12758,9799,3082,12881,2021-07-26
3174091001,JAKARTA SELATAN,JAGAKARSA,JAGAKARSA,62389,30362,32027,10612,42639,2021-07-26
3175021007,JAKARTA TIMUR,PULO GADUNG,JATI,32757,17904,14853,6196,21049,2021-07-26
3174041002,JAKARTA SELATAN,PASAR MINGGU,JATI PADANG,37502,19378,18124,6967,25091,2021-07-26
3173071004,JAKARTA BARAT,PALMERAH,JATI PULO,28738,13904,14834,3906,18740,2021-07-26
3175061001,JAKARTA TIMUR,CAKUNG,JATINEGARA,84160,51513,32647,7765,40412,2021-07-26
3175021004,JAKARTA TIMUR,PULO GADUNG,JATINEGARA KAUM,24632,13836,10796,3262,14058,2021-07-26
3173021004,JAKARTA BARAT,GROGOL PETAMBURAN,JELAMBAR,30266,14742,15524,6236,21760,2021-07-26
3173021006,JAKARTA BARAT,GROGOL PETAMBURAN,JELAMBAR BARU,38246,19158,19088,7064,26152,2021-07-26
3173041006,JAKARTA BARAT,TAMBORA,JEMBATAN BESI,29314,18636,10678,2680,13358,2021-07-26
3173041008,JAKARTA BARAT,TAMBORA,JEMBATAN LIMA,21021,12378,8643,2542,11185,2021-07-26
3173081005,JAKARTA BARAT,KEMBANGAN,JOGLO,40839,22426,18413,6625,25038,2021-07-26
3171081001,JAKARTA PUSAT,JOHAR BARU,JOHAR BARU,37488,18188,19300,5983,25283,2021-07-26
3173041002,JAKARTA BARAT,TAMBORA,KALI ANYAR,23856,13951,9905,2413,12318,2021-07-26
3172041004,JAKARTA UTARA,CILINCING,KALIBARU,67684,40369,27315,4871,32186,2021-07-26
3174081002,JAKARTA SELATAN,PANCORAN,KALIBATA,41994,24067,17927,5862,23789,2021-07-26
3173061001,JAKARTA BARAT,KALI DERES,KALIDERES,72447,39692,32755,9124,41879,2021-07-26
3175051004,JAKARTA TIMUR,PASAR REBO,KALISARI,43212,22969,20243,7928,28171,2021-07-26
3173061004,JAKARTA BARAT,KALI DERES,KAMAL,53783,33501,20282,4054,24336,2021-07-26
3172011002,JAKARTA UTARA,PENJARINGAN,KAMAL MUARA,12930,4871,8059,3025,11084,2021-07-26
3171071007,JAKARTA PUSAT,TANAH ABANG,KAMPUNG BALI,11358,6876,4482,1569,6051,2021-07-26
3175031001,JAKARTA TIMUR,JATINEGARA,KAMPUNG MELAYU,25717,16241,9476,2498,11974,2021-07-26
3171081002,JAKARTA PUSAT,JOHAR BARU,KAMPUNG RAWA,21237,8830,12407,2814,15221,2021-07-26
3175041002,JAKARTA TIMUR,KRAMAT JATI,KAMPUNG TENGAH,43993,27895,16098,5803,21901,2021-07-26
3173011005,JAKARTA BARAT,CENGKARENG,KAPUK,134466,78810,55656,11220,66876,2021-07-26
3172011003,JAKARTA UTARA,PENJARINGAN,KAPUK MUARA,35781,16208,19573,7642,27215,2021-07-26
3171021002,JAKARTA PUSAT,SAWAH BESAR,KARANG ANYAR,25761,13419,12342,3688,16030,2021-07-26
3174021004,JAKARTA SELATAN,SETIA BUDI,KARET,9623,4944,4679,1682,6361,2021-07-26
3174021003,JAKARTA SELATAN,SETIA BUDI,KARET KUNINGAN,16055,7506,8549,2682,11231,2021-07-26
3174021002,JAKARTA SELATAN,SETIA BUDI,KARET SEMANGGI,2770,1197,1573,710,2283,2021-07-26
3171071003,JAKARTA PUSAT,TANAH ABANG,KARET TENGSIN,19271,10283,8988,2484,11472,2021-07-26
3171021003,JAKARTA PUSAT,SAWAH BESAR,KARTINI,22292,10951,11341,3793,15134,2021-07-26
3175011003,JAKARTA TIMUR,MATRAMAN,KAYU MANIS,25284,14912,10372,3389,13761,2021-07-26
3175021006,JAKARTA TIMUR,PULO GADUNG,KAYU PUTIH,40696,20298,20398,8198,28596,2021-07-26
3173031006,JAKARTA BARAT,TAMAN SARI,KEAGUNGAN,17387,8543,8844,2239,11083,2021-07-26
3174041007,JAKARTA SELATAN,PASAR MINGGU,KEBAGUSAN,44552,24857,19695,6685,26380,2021-07-26
3174051006,JAKARTA SELATAN,KEBAYORAN LAMA,KEBAYORAN LAMA SELATAN,41212,20731,20481,6384,26865,2021-07-26
3174051001,JAKARTA SELATAN,KEBAYORAN LAMA,KEBAYORAN LAMA UTARA,42422,23976,18446,5939,24385,2021-07-26
3174011004,JAKARTA SELATAN,TEBET,KEBON BARU,35165,18868,16297,5878,22175,2021-07-26
3172021005,JAKARTA UTARA,TANJUNG PRIOK,KEBON BAWANG,50952,26025,24927,7887,32814,2021-07-26
3173051001,JAKARTA BARAT,KEBON JERUK,KEBON JERUK,53887,31358,22529,7408,29937,2021-07-26
3171071006,JAKARTA PUSAT,TANAH ABANG,KEBON KACANG,21531,13627,7904,2848,10752,2021-07-26
3171011005,JAKARTA PUSAT,GAMBIR,KEBON KELAPA,10163,5260,4903,1771,6674,2021-07-26
3171031002,JAKARTA PUSAT,KEMAYORAN,KEBON KOSONG,30019,16064,13955,4007,17962,2021-07-26
3175011005,JAKARTA TIMUR,MATRAMAN,KEBON MANGGIS,16490,8527,7963,3194,11157,2021-07-26
3171071005,JAKARTA PUSAT,TANAH ABANG,KEBON MELATI,32206,21414,10792,3109,13901,2021-07-26
3175081003,JAKARTA TIMUR,MAKASAR,KEBON PALA,46614,26264,20350,7027,27377,2021-07-26
3171061005,JAKARTA PUSAT,MENTENG,KEBON SIRIH,12299,7366,4933,1757,6690,2021-07-26
3173011004,JAKARTA BARAT,CENGKARENG,KEDAUNG KALI ANGKE,32612,14414,18198,3865,22063,2021-07-26
3173051007,JAKARTA BARAT,KEBON JERUK,KEDOYA SELATAN,32165,16387,15778,5069,20847,2021-07-26
3173051006,JAKARTA BARAT,KEBON JERUK,KEDOYA UTARA,45740,22643,23097,7693,30790,2021-07-26
3173051004,JAKARTA BARAT,KEBON JERUK,KELAPA DUA,23565,13005,10560,3379,13939,2021-07-26
3175091003,JAKARTA TIMUR,CIRACAS,KELAPA DUA WETAN,46875,24102,22773,8131,30904,2021-07-26
3172061003,JAKARTA UTARA,KELAPA GADING,KELAPA GADING BARAT,35717,14668,21049,9495,30544,2021-07-26
3172061001,JAKARTA UTARA,KELAPA GADING,KELAPA GADING TIMUR,33592,12827,20765,9771,30536,2021-07-26
3173071005,JAKARTA BARAT,PALMERAH,KEMANGGISAN,32139,17032,15107,5635,20742,2021-07-26
3171031001,JAKARTA PUSAT,KEMAYORAN,KEMAYORAN,20708,10431,10277,3196,13473,2021-07-26
3173081006,JAKARTA BARAT,KEMBANGAN,KEMBANGAN SELATAN,27130,13977,13153,5478,18631,2021-07-26
3173081001,JAKARTA BARAT,KEMBANGAN,KEMBANGAN UTARA,54451,28482,25969,7327,33296,2021-07-26
3171041002,JAKARTA PUSAT,SENEN,KENARI,9579,4739,4840,1894,6734,2021-07-26
3173041005,JAKARTA BARAT,TAMBORA,KERENDANG,19973,10839,9134,2424,11558,2021-07-26
3175071003,JAKARTA TIMUR,DUREN SAWIT,KLENDER,69978,44101,25877,8402,34279,2021-07-26
3172031001,JAKARTA UTARA,KOJA,KOJA,28175,14483,13692,3217,16909,2021-07-26
3173071006,JAKARTA BARAT,PALMERAH,KOTA BAMBU SELATAN,21158,11669,9489,2461,11950,2021-07-26
3173071003,JAKARTA BARAT,PALMERAH,KOTA BAMBU UTARA,24995,14191,10804,2970,13774,2021-07-26
3171041004,JAKARTA PUSAT,SENEN,KRAMAT,28835,16680,12155,3357,15512,2021-07-26
3175041001,JAKARTA TIMUR,KRAMAT JATI,KRAMAT JATI,34144,19818,14326,5519,19845,2021-07-26
3174071003,JAKARTA SELATAN,KEBAYORAN BARU,KRAMAT PELA,14413,6983,7430,2672,10102,2021-07-26
3173031002,JAKARTA BARAT,TAMAN SARI,KRUKUT,19244,10124,9120,2544,11664,2021-07-26
3174031005,JAKARTA SELATAN,MAMPANG PRAPATAN,KUNINGAN BARAT,12785,6056,6729,1903,8632,2021-07-26
3174021008,JAKARTA SELATAN,SETIA BUDI,KUNINGAN TIMUR,6008,3115,2893,1205,4098,2021-07-26
3171041005,JAKARTA PUSAT,SENEN,KWITANG,15486,8210,7276,2399,9675,2021-07-26
3172031003,JAKARTA UTARA,KOJA,LAGOA,59065,32476,26589,6381,32970,2021-07-26
3174061002,JAKARTA SELATAN,CILANDAK,LEBAK BULUS,37626,19428,18198,7080,25278,2021-07-26
3174091004,JAKARTA SELATAN,JAGAKARSA,LENTENG AGUNG,53946,30576,23370,7309,30679,2021-07-26
3175101007,JAKARTA TIMUR,CIPAYUNG,LUBANG BUAYA,63547,34068,29479,10249,39728,2021-07-26
3175081001,JAKARTA TIMUR,MAKASAR,MAKASAR,34390,18149,16241,5806,22047,2021-07-26
3175071006,JAKARTA TIMUR,DUREN SAWIT,MALAKA JAYA,30927,15253,15674,6183,21857,2021-07-26
3175071005,JAKARTA TIMUR,DUREN SAWIT,MALAKA SARI,27530,13610,13920,5900,19820,2021-07-26
3174031001,JAKARTA SELATAN,MAMPANG PRAPATAN,MAMPANG PRAPATAN,18159,9411,8748,2615,11363,2021-07-26
3173031005,JAKARTA BARAT,TAMAN SARI,MANGGA BESAR,7707,3198,4509,1585,6094,2021-07-26
3171021005,JAKARTA PUSAT,SAWAH BESAR,MANGGA DUA SELATAN,27442,14401,13041,4284,17325,2021-07-26
3174011007,JAKARTA SELATAN,TEBET,MANGGARAI,28373,15211,13162,3967,17129,2021-07-26
3174011006,JAKARTA SELATAN,TEBET,MANGGARAI SELATAN,23075,11614,11461,4140,15601,2021-07-26
3173031003,JAKARTA BARAT,TAMAN SARI,MAPHAR,16461,8015,8446,2830,11276,2021-07-26
3172041003,JAKARTA UTARA,CILINCING,MARUNDA,28943,14572,14371,2842,17213,2021-07-26
3174071001,JAKARTA SELATAN,KEBAYORAN BARU,MELAWAI,2627,1084,1543,916,2459,2021-07-26
3171061001,JAKARTA PUSAT,MENTENG,MENTENG,25624,15394,10230,3958,14188,2021-07-26
3174021005,JAKARTA SELATAN,SETIA BUDI,MENTENG ATAS,27816,13967,13849,4581,18430,2021-07-26
3174011003,JAKARTA SELATAN,TEBET,MENTENG DALAM,36028,19848,16180,6022,22202,2021-07-26
3173081003,JAKARTA BARAT,KEMBANGAN,MERUYA SELATAN,32130,17758,14372,4715,19087,2021-07-26
3173081002,JAKARTA BARAT,KEMBANGAN,MERUYA UTARA,43752,23274,20478,7701,28179,2021-07-26
3175101004,JAKARTA TIMUR,CIPAYUNG,MUNJUL,23871,13159,10712,3897,14609,2021-07-26
3172051002,JAKARTA UTARA,PADEMANGAN,PADEMANGAN BARAT,74240,40086,34154,8652,42806,2021-07-26
3172051001,JAKARTA UTARA,PADEMANGAN,PADEMANGAN TIMUR,37736,16611,21125,7442,28567,2021-07-26
3175011004,JAKARTA TIMUR,MATRAMAN,PAL MERIAM,19769,11089,8680,3124,11804,2021-07-26
3173071001,JAKARTA BARAT,PALMERAH,PALMERAH,63011,34578,28433,8750,37183,2021-07-26
3174081001,JAKARTA SELATAN,PANCORAN,PANCORAN,19421,9905,9516,3204,12720,2021-07-26
3172021003,JAKARTA UTARA,TANJUNG PRIOK,PAPANGGO,39097,19570,19527,5232,24759,2021-07-26
3171021001,JAKARTA PUSAT,SAWAH BESAR,PASAR BARU,12035,5201,6834,2875,9709,2021-07-26
3174021006,JAKARTA SELATAN,SETIA BUDI,PASAR MANGGIS,26752,14041,12711,4138,16849,2021-07-26
3174041001,JAKARTA SELATAN,PASAR MINGGU,PASAR MINGGU,24821,12881,11940,5224,17164,2021-07-26
3171041003,JAKARTA PUSAT,SENEN,PASEBAN,23533,12556,10977,3629,14606,2021-07-26
3173061005,JAKARTA BARAT,KALI DERES,PEGADUNGAN,75587,40770,34817,11486,46303,2021-07-26
3171061002,JAKARTA PUSAT,MENTENG,PEGANGSAAN,23455,14089,9366,3222,12588,2021-07-26
3172061002,JAKARTA UTARA,KELAPA GADING,PEGANGSAAN DUA,49976,19726,30250,11291,41541,2021-07-26
3172011004,JAKARTA UTARA,PENJARINGAN,PEJAGALAN,74578,36986,37592,12978,50570,2021-07-26
3174041006,JAKARTA SELATAN,PASAR MINGGU,PEJATEN BARAT,37346,19438,17908,6700,24608,2021-07-26
3174041005,JAKARTA SELATAN,PASAR MINGGU,PEJATEN TIMUR,57656,34141,23515,8108,31623,2021-07-26
3175051005,JAKARTA TIMUR,PASAR REBO,PEKAYON,43250,22156,21094,7032,28126,2021-07-26
3173041009,JAKARTA BARAT,TAMBORA,PEKOJAN,23587,11454,12133,3827,15960,2021-07-26
3174031003,JAKARTA SELATAN,MAMPANG PRAPATAN,PELA MAMPANG,43522,21645,21877,6858,28735,2021-07-26
3174081005,JAKARTA SELATAN,PANCORAN,PENGADEGAN,21478,9480,11998,3977,15975,2021-07-26
3175061003,JAKARTA TIMUR,CAKUNG,PENGGILINGAN,99255,60509,38746,10463,49209,2021-07-26
3172011001,JAKARTA UTARA,PENJARINGAN,PENJARINGAN,88308,51834,36474,9315,45789,2021-07-26
3174101001,JAKARTA SELATAN,PESANGGRAHAN,PESANGGRAHAN,27545,13351,14194,5450,19644,2021-07-26
3171071004,JAKARTA PUSAT,TANAH ABANG,PETAMBURAN,33271,21653,11618,3196,14814,2021-07-26
3174071008,JAKARTA SELATAN,KEBAYORAN BARU,PETOGOGAN,11499,5742,5757,2189,7946,2021-07-26
3171011004,JAKARTA PUSAT,GAMBIR,PETOJO SELATAN,14692,7617,7075,3110,10185,2021-07-26
3171011003,JAKARTA PUSAT,GAMBIR,PETOJO UTARA,17458,9838,7620,2880,10500,2021-07-26
3174101004,JAKARTA SELATAN,PESANGGRAHAN,PETUKANGAN SELATAN,37187,18321,18866,5567,24433,2021-07-26
3174101003,JAKARTA SELATAN,PESANGGRAHAN,PETUKANGAN UTARA,53716,29227,24489,8335,32824,2021-07-26
3175081002,JAKARTA TIMUR,MAKASAR,PINANG RANTI,27198,14363,12835,4043,16878,2021-07-26
3173031008,JAKARTA BARAT,TAMAN SARI,PINANGSIA,10729,4710,6019,1826,7845,2021-07-26
3175011001,JAKARTA TIMUR,MATRAMAN,PISANGAN BARU,31776,19681,12095,4293,16388,2021-07-26
3175021002,JAKARTA TIMUR,PULO GADUNG,PISANGAN TIMUR,41011,22519,18492,6150,24642,2021-07-26
3172011005,JAKARTA UTARA,PENJARINGAN,PLUIT,47783,21821,25962,13530,39492,2021-07-26
3175071002,JAKARTA TIMUR,DUREN SAWIT,PONDOK BAMBU,61550,35114,26436,10060,36496,2021-07-26
3175071004,JAKARTA TIMUR,DUREN SAWIT,PONDOK KELAPA,72015,37796,34219,12157,46376,2021-07-26
3175071007,JAKARTA TIMUR,DUREN SAWIT,PONDOK KOPI,35367,21796,13571,4889,18460,2021-07-26
3174061003,JAKARTA SELATAN,CILANDAK,PONDOK LABU,46464,22101,24363,8545,32908,2021-07-26
3174051002,JAKARTA SELATAN,KEBAYORAN LAMA,PONDOK PINANG,56169,30031,26138,10916,37054,2021-07-26
3175101003,JAKARTA TIMUR,CIPAYUNG,PONDOK RANGGON,25574,14859,10715,4076,14791,2021-07-26
3101011003,KAB.ADM.KEP.SERIBU,KEP. SERIBU UTARA,PULAU HARAPAN,2060,508,1552,685,2237,2021-07-26
3101011002,KAB.ADM.KEP.SERIBU,KEP. SERIBU UTARA,PULAU KELAPA,5528,1272,4256,1321,5577,2021-07-26
3101011001,KAB.ADM.KEP.SERIBU,KEP. SERIBU UTARA,PULAU PANGGANG,5450,1182,4268,1237,5505,2021-07-26
3101021003,KAB.ADM.KEP.SERIBU,KEP. SERIBU SELATAN,PULAU PARI,2765,437,2328,654,2982,2021-07-26
3101021002,KAB.ADM.KEP.SERIBU,KEP. SERIBU SELATAN,PULAU TIDUNG,4553,949,3604,1342,4946,2021-07-26
3101021001,KAB.ADM.KEP.SERIBU,KEP. SERIBU SELATAN,PULAU UNTUNG JAWA,1941,483,1458,590,2048,2021-07-26
3174071007,JAKARTA SELATAN,KEBAYORAN BARU,PULO,5835,2504,3331,1521,4852,2021-07-26
3175021001,JAKARTA TIMUR,PULO GADUNG,PULO GADUNG,34422,19545,14877,5224,20101,2021-07-26
3175061005,JAKARTA TIMUR,CAKUNG,PULO GEBANG,97301,54825,42476,11758,54234,2021-07-26
3174041004,JAKARTA SELATAN,PASAR MINGGU,RAGUNAN,39616,19237,20379,7005,27384,2021-07-26
3175091005,JAKARTA TIMUR,CIRACAS,RAMBUTAN,36771,22590,14181,4822,19003,2021-07-26
3172031006,JAKARTA UTARA,KOJA,RAWA BADAK SELATAN,42179,24515,17664,4357,22021,2021-07-26
3172031004,JAKARTA UTARA,KOJA,RAWA BADAK UTARA,34408,18282,16126,4284,20410,2021-07-26
3174071005,JAKARTA SELATAN,KEBAYORAN BARU,RAWA BARAT,5625,2622,3003,1486,4489,2021-07-26
3173011003,JAKARTA BARAT,CENGKARENG,RAWA BUAYA,63799,36672,27127,7212,34339,2021-07-26
3175031004,JAKARTA TIMUR,JATINEGARA,RAWA BUNGA,21434,12745,8689,2684,11373,2021-07-26
3174081003,JAKARTA SELATAN,PANCORAN,RAWA JATI,20509,9989,10520,3933,14453,2021-07-26
3175061002,JAKARTA TIMUR,CAKUNG,RAWA TERATE,24637,12192,12445,2347,14792,2021-07-26
3175021005,JAKARTA TIMUR,PULO GADUNG,RAWAMANGUN,37612,20361,17251,6410,23661,2021-07-26
3171051003,JAKARTA PUSAT,CEMPAKA PUTIH,RAWASARI,21967,11456,10511,3917,14428,2021-07-26
3173041010,JAKARTA BARAT,TAMBORA,ROA MALAKA,3484,1428,2056,959,3015,2021-07-26
3172041006,JAKARTA UTARA,CILINCING,ROROTAN,41668,20753,20915,5188,26103,2021-07-26
3174071004,JAKARTA SELATAN,KEBAYORAN BARU,SELONG,2842,1215,1627,960,2587,2021-07-26
3173061002,JAKARTA BARAT,KALI DERES,SEMANAN,71354,42572,28782,5674,34456,2021-07-26
3172041007,JAKARTA UTARA,CILINCING,SEMPER BARAT,68587,32305,36282,9890,46172,2021-07-26
3172041005,JAKARTA UTARA,CILINCING,SEMPER TIMUR,36267,18600,17667,4916,22583,2021-07-26
3174071006,JAKARTA SELATAN,KEBAYORAN BARU,SENAYAN,2771,1526,1245,641,1886,2021-07-26
3171041001,JAKARTA PUSAT,SENEN,SENEN,6804,3443,3361,1270,4631,2021-07-26
3171031004,JAKARTA PUSAT,KEMAYORAN,SERDANG,29668,15870,13798,4469,18267,2021-07-26
3174021001,JAKARTA SELATAN,SETIA BUDI,SETIA BUDI,3023,1528,1495,695,2190,2021-07-26
3175101005,JAKARTA TIMUR,CIPAYUNG,SETU,20572,12538,8034,2933,10967,2021-07-26
3173071002,JAKARTA BARAT,PALMERAH,SLIPI,16591,8211,8380,2899,11279,2021-07-26
3173081004,JAKARTA BARAT,KEMBANGAN,SRENGSENG,45523,26371,19152,6869,26021,2021-07-26
3174091002,JAKARTA SELATAN,JAGAKARSA,SRENGSENG SAWAH,58196,26782,31414,10662,42076,2021-07-26
3173051003,JAKARTA BARAT,KEBON JERUK,SUKABUMI SELATAN,37033,22345,14688,3801,18489,2021-07-26
3173051002,JAKARTA BARAT,KEBON JERUK,SUKABUMI UTARA,38290,23927,14363,4348,18711,2021-07-26
3172041002,JAKARTA UTARA,CILINCING,SUKAPURA,53949,28048,25901,5946,31847,2021-07-26
3171031007,JAKARTA PUSAT,KEMAYORAN,SUMUR BATU,22717,11919,10798,4008,14806,2021-07-26
3172021004,JAKARTA UTARA,TANJUNG PRIOK,SUNGAI BAMBU,29876,14971,14905,4321,19226,2021-07-26
3172021006,JAKARTA UTARA,TANJUNG PRIOK,SUNTER AGUNG,71805,31277,40528,14711,55239,2021-07-26
3172021002,JAKARTA UTARA,TANJUNG PRIOK,SUNTER JAYA,63031,30456,32575,11905,44480,2021-07-26
3175091004,JAKARTA TIMUR,CIRACAS,SUSUKAN,38257,21113,17144,5502,22646,2021-07-26
3173031001,JAKARTA BARAT,TAMAN SARI,TAMAN SARI,14348,6825,7523,2657,10180,2021-07-26
3173041001,JAKARTA BARAT,TAMBORA,TAMBORA,10204,5627,4577,1641,6218,2021-07-26
3173041004,JAKARTA BARAT,TAMBORA,TANAH SEREAL,26387,12187,14200,4263,18463,2021-07-26
3171081004,JAKARTA PUSAT,JOHAR BARU,TANAH TINGGI,37693,17950,19743,4840,24583,2021-07-26
3173031004,JAKARTA BARAT,TAMAN SARI,TANGKI,13324,6234,7090,2139,9229,2021-07-26
3174091005,JAKARTA SELATAN,JAGAKARSA,TANJUNG BARAT,39770,22479,17291,6576,23867,2021-07-26
3173021005,JAKARTA BARAT,GROGOL PETAMBURAN,TANJUNG DUREN SELATAN,25337,11667,13670,5110,18780,2021-07-26
3173021002,JAKARTA BARAT,GROGOL PETAMBURAN,TANJUNG DUREN UTARA,17010,7327,9683,4001,13684,2021-07-26
3172021001,JAKARTA UTARA,TANJUNG PRIOK,TANJUNG PRIOK,34588,16874,17714,4072,21786,2021-07-26
3174011002,JAKARTA SELATAN,TEBET,TEBET BARAT,21194,9967,11227,4790,16017,2021-07-26
3174011001,JAKARTA SELATAN,TEBET,TEBET TIMUR,18199,8116,10083,4242,14325,2021-07-26
3173061003,JAKARTA BARAT,KALI DERES,TEGAL ALUR,83647,47201,36446,8078,44524,2021-07-26
3174031004,JAKARTA SELATAN,MAMPANG PRAPATAN,TEGAL PARANG,32401,18816,13585,4083,17668,2021-07-26
3173021003,JAKARTA BARAT,GROGOL PETAMBURAN,TOMANG,29605,14186,15419,5610,21029,2021-07-26
3172031005,JAKARTA UTARA,KOJA,TUGU SELATAN,39122,21741,17381,4255,21636,2021-07-26
3172031002,JAKARTA UTARA,KOJA,TUGU UTARA,67670,38098,29572,7318,36890,2021-07-26
3175061006,JAKARTA TIMUR,CAKUNG,UJUNG MENTENG,29934,15226,14708,4499,19207,2021-07-26
3174101005,JAKARTA SELATAN,PESANGGRAHAN,ULUJAMI,40544,23224,17320,5764,23084,2021-07-26
3175011006,JAKARTA TIMUR,MATRAMAN,UTAN KAYU SELATAN,33511,17644,15867,5732,21599,2021-07-26
3175011002,JAKARTA TIMUR,MATRAMAN,UTAN KAYU UTARA,28169,15344,12825,4424,17249,2021-07-26
3171031008,JAKARTA PUSAT,KEMAYORAN,UTAN PANJANG,29208,16961,12247,3389,15636,2021-07-26
3172021007,JAKARTA UTARA,TANJUNG PRIOK,WARAKAS,44401,22635,21766,5850,27616,2021-07-26
3173021007,JAKARTA BARAT,GROGOL PETAMBURAN,WIJAYA KUSUMA,38934,21090,17844,5487,23331,2021-07-26
3172051003,JAKARTA UTARA,PADEMANGAN,ANCOL,23947,13074,10873,3601,14474,2021-07-27
3173041007,JAKARTA BARAT,TAMBORA,ANGKE,29381,14482,14899,3800,18699,2021-07-27
3175041005,JAKARTA TIMUR,KRAMAT JATI,BALE KAMBANG,29074,19430,9644,3020,12664,2021-07-27
3175031003,JAKARTA TIMUR,JATINEGARA,BALI MESTER,9752,5485,4267,1745,6012,2021-07-27
3175101006,JAKARTA TIMUR,CIPAYUNG,BAMBU APUS,26285,14793,11492,4531,16023,2021-07-27
3174031002,JAKARTA SELATAN,MAMPANG PRAPATAN,BANGKA,21566,10962,10604,3446,14050,2021-07-27
3175051002,JAKARTA TIMUR,PASAR REBO,BARU,23886,10607,13279,5494,18773,2021-07-27
3175041004,JAKARTA TIMUR,KRAMAT JATI,BATU AMPAR,47898,30649,17249,6218,23467,2021-07-27
3171071002,JAKARTA PUSAT,TANAH ABANG,BENDUNGAN HILIR,21494,10574,10920,3952,14872,2021-07-27
3175031002,JAKARTA TIMUR,JATINEGARA,BIDARA CINA,36689,23009,13680,4580,18260,2021-07-27
3174101002,JAKARTA SELATAN,PESANGGRAHAN,BINTARO,53098,27706,25392,8384,33776,2021-07-27
3174011005,JAKARTA SELATAN,TEBET,BUKIT DURI,34183,19180,15003,5002,20005,2021-07-27
3171041006,JAKARTA PUSAT,SENEN,BUNGUR,18144,9243,8901,3187,12088,2021-07-27
3175061007,JAKARTA TIMUR,CAKUNG,CAKUNG BARAT,57724,28172,29552,5925,35477,2021-07-27
3175061004,JAKARTA TIMUR,CAKUNG,CAKUNG TIMUR,58287,29619,28668,8273,36941,2021-07-27
3175041007,JAKARTA TIMUR,KRAMAT JATI,CAWANG,32762,18987,13775,4997,18772,2021-07-27
3175101008,JAKARTA TIMUR,CIPAYUNG,CEGER,18932,10582,8350,2942,11292,2021-07-27
3171031006,JAKARTA PUSAT,KEMAYORAN,CEMPAKA BARU,32581,18560,14021,4754,18775,2021-07-27
3171051002,JAKARTA PUSAT,CEMPAKA PUTIH,CEMPAKA PUTIH BARAT,35885,19200,16685,5647,22332,2021-07-27
3171051001,JAKARTA PUSAT,CEMPAKA PUTIH,CEMPAKA PUTIH TIMUR,24292,12383,11909,5060,16969,2021-07-27
3173011001,JAKARTA BARAT,CENGKARENG,CENGKARENG BARAT,66284,33060,33224,10654,43878,2021-07-27
3173011006,JAKARTA BARAT,CENGKARENG,CENGKARENG TIMUR,81027,43962,37065,11048,48113,2021-07-27
3175091002,JAKARTA TIMUR,CIRACAS,CIBUBUR,66364,33029,33335,11559,44894,2021-07-27
3171011002,JAKARTA PUSAT,GAMBIR,CIDENG,15390,7148,8242,3479,11721,2021-07-27
3174091003,JAKARTA SELATAN,JAGAKARSA,CIGANJUR,38497,19569,18928,6471,25399,2021-07-27
3175051003,JAKARTA TIMUR,PASAR REBO,CIJANTUNG,41419,21182,20237,7641,27878,2021-07-27
3171061003,JAKARTA PUSAT,MENTENG,CIKINI,8274,4598,3676,1544,5220,2021-07-27
3174081006,JAKARTA SELATAN,PANCORAN,CIKOKO,10547,4866,5681,2003,7684,2021-07-27
3174061001,JAKARTA SELATAN,CILANDAK,CILANDAK BARAT,51752,24517,27235,9886,37121,2021-07-27
3174041003,JAKARTA SELATAN,PASAR MINGGU,CILANDAK TIMUR,25145,12117,13028,5663,18691,2021-07-27
3175101002,JAKARTA TIMUR,CIPAYUNG,CILANGKAP,27635,14987,12648,4375,17023,2021-07-27
3175041006,JAKARTA TIMUR,KRAMAT JATI,CILILITAN,40181,24306,15875,6145,22020,2021-07-27
3172041001,JAKARTA UTARA,CILINCING,CILINCING,43609,24153,19456,4679,24135,2021-07-27
3175101001,JAKARTA TIMUR,CIPAYUNG,CIPAYUNG,26104,13133,12971,4809,17780,2021-07-27
3174091006,JAKARTA SELATAN,JAGAKARSA,CIPEDAK,38303,17955,20348,6342,26690,2021-07-27
3174061005,JAKARTA SELATAN,CILANDAK,CIPETE SELATAN,26704,13342,13362,4842,18204,2021-07-27
3174071010,JAKARTA SELATAN,KEBAYORAN BARU,CIPETE UTARA,34102,16805,17297,5082,22379,2021-07-27
3175021003,JAKARTA TIMUR,PULO GADUNG,CIPINANG,39306,21370,17936,6780,24716,2021-07-27
3175031007,JAKARTA TIMUR,JATINEGARA,CIPINANG BESAR SELATAN,35212,22007,13205,4330,17535,2021-07-27
3175031008,JAKARTA TIMUR,JATINEGARA,CIPINANG BESAR UTARA,45319,29185,16134,4724,20858,2021-07-27
3175031005,JAKARTA TIMUR,JATINEGARA,CIPINANG CEMPEDAK,32824,19088,13736,5247,18983,2021-07-27
3175081005,JAKARTA TIMUR,MAKASAR,CIPINANG MELAYU,42308,22692,19616,7347,26963,2021-07-27
3175031006,JAKARTA TIMUR,JATINEGARA,CIPINANG MUARA,55243,33931,21312,8243,29555,2021-07-27
3174051003,JAKARTA SELATAN,KEBAYORAN LAMA,CIPULIR,39937,22738,17199,5702,22901,2021-07-27
3175091001,JAKARTA TIMUR,CIRACAS,CIRACAS,64594,32874,31720,10022,41742,2021-07-27
3175041003,JAKARTA TIMUR,KRAMAT JATI,DUKUH,24609,13844,10765,4069,14834,2021-07-27
3175071001,JAKARTA TIMUR,DUREN SAWIT,DUREN SAWIT,61160,35186,25974,10853,36827,2021-07-27
3174081004,JAKARTA SELATAN,PANCORAN,DUREN TIGA,28319,13957,14362,4708,19070,2021-07-27
3173051005,JAKARTA BARAT,KEBON JERUK,DURI KEPA,60138,28709,31429,11357,42786,2021-07-27
3173011002,JAKARTA BARAT,CENGKARENG,DURI KOSAMBI,77923,43312,34611,10672,45283,2021-07-27
3171011006,JAKARTA PUSAT,GAMBIR,DURI PULO,19610,10442,9168,2675,11843,2021-07-27
3173041011,JAKARTA BARAT,TAMBORA,DURI SELATAN,14259,6668,7591,2582,10173,2021-07-27
3173041003,JAKARTA BARAT,TAMBORA,DURI UTARA,19844,9724,10120,2984,13104,2021-07-27
3171081003,JAKARTA PUSAT,JOHAR BARU,GALUR,18243,8395,9848,2285,12133,2021-07-27
3171011001,JAKARTA PUSAT,GAMBIR,GAMBIR,2191,1011,1180,577,1757,2021-07-27
3174061004,JAKARTA SELATAN,CILANDAK,GANDARIA SELATAN,22119,11469,10650,3754,14404,2021-07-27
3174071009,JAKARTA SELATAN,KEBAYORAN BARU,GANDARIA UTARA,39922,20495,19427,6513,25940,2021-07-27
3175051001,JAKARTA TIMUR,PASAR REBO,GEDONG,35755,19439,16316,6252,22568,2021-07-27
3171071001,JAKARTA PUSAT,TANAH ABANG,GELORA,3127,1638,1489,634,2123,2021-07-27
3173031007,JAKARTA BARAT,TAMAN SARI,GLODOK,7837,3096,4741,2226,6967,2021-07-27
3171061004,JAKARTA PUSAT,MENTENG,GONDANGDIA,4100,1836,2264,1421,3685,2021-07-27
3173021001,JAKARTA BARAT,GROGOL PETAMBURAN,GROGOL,16876,8554,8322,3053,11375,2021-07-27
3174051005,JAKARTA SELATAN,KEBAYORAN LAMA,GROGOL SELATAN,44251,24565,19686,6219,25905,2021-07-27
3174051004,JAKARTA SELATAN,KEBAYORAN LAMA,GROGOL UTARA,42494,23849,18645,6605,25250,2021-07-27
3174021007,JAKARTA SELATAN,SETIA BUDI,GUNTUR,3985,1781,2204,1109,3313,2021-07-27
3174071002,JAKARTA SELATAN,KEBAYORAN BARU,GUNUNG,9436,4424,5012,2362,7374,2021-07-27
3171031005,JAKARTA PUSAT,KEMAYORAN,GUNUNG SAHARI SELATAN,19199,9788,9411,3424,12835,2021-07-27
3171021004,JAKARTA PUSAT,SAWAH BESAR,GUNUNG SAHARI UTARA,16650,7347,9303,3719,13022,2021-07-27
3175081004,JAKARTA TIMUR,MAKASAR,HALIM PERDANA KUSUMAH,28363,10356,18007,10179,28186,2021-07-27
3171031003,JAKARTA PUSAT,KEMAYORAN,HARAPAN MULIA,22557,12390,10167,3197,13364,2021-07-27
3174091001,JAKARTA SELATAN,JAGAKARSA,JAGAKARSA,62389,29961,32428,11316,43744,2021-07-27
3175021007,JAKARTA TIMUR,PULO GADUNG,JATI,32757,17685,15072,6309,21381,2021-07-27
3174041002,JAKARTA SELATAN,PASAR MINGGU,JATI PADANG,37502,19133,18369,7243,25612,2021-07-27
3173071004,JAKARTA BARAT,PALMERAH,JATI PULO,28738,13559,15179,3944,19123,2021-07-27
3175061001,JAKARTA TIMUR,CAKUNG,JATINEGARA,84160,50349,33811,8214,42025,2021-07-27
3175021004,JAKARTA TIMUR,PULO GADUNG,JATINEGARA KAUM,24632,13557,11075,3346,14421,2021-07-27
3173021004,JAKARTA BARAT,GROGOL PETAMBURAN,JELAMBAR,30266,14539,15727,6446,22173,2021-07-27
3173021006,JAKARTA BARAT,GROGOL PETAMBURAN,JELAMBAR BARU,38246,18835,19411,7371,26782,2021-07-27
3173041006,JAKARTA BARAT,TAMBORA,JEMBATAN BESI,29314,18406,10908,2797,13705,2021-07-27
3173041008,JAKARTA BARAT,TAMBORA,JEMBATAN LIMA,21021,12248,8773,2668,11441,2021-07-27
3173081005,JAKARTA BARAT,KEMBANGAN,JOGLO,40839,22241,18598,6780,25378,2021-07-27
3171081001,JAKARTA PUSAT,JOHAR BARU,JOHAR BARU,37488,17912,19576,6207,25783,2021-07-27
3173041002,JAKARTA BARAT,TAMBORA,KALI ANYAR,23856,13755,10101,2517,12618,2021-07-27
3172041004,JAKARTA UTARA,CILINCING,KALIBARU,67684,39825,27859,5039,32898,2021-07-27
3174081002,JAKARTA SELATAN,PANCORAN,KALIBATA,41994,23736,18258,6047,24305,2021-07-27
3173061001,JAKARTA BARAT,KALI DERES,KALIDERES,72447,38665,33782,9574,43356,2021-07-27
3175051004,JAKARTA TIMUR,PASAR REBO,KALISARI,43212,22495,20717,8164,28881,2021-07-27
3173061004,JAKARTA BARAT,KALI DERES,KAMAL,53783,32841,20942,4322,25264,2021-07-27
3172011002,JAKARTA UTARA,PENJARINGAN,KAMAL MUARA,12930,4808,8122,3225,11347,2021-07-27
3171071007,JAKARTA PUSAT,TANAH ABANG,KAMPUNG BALI,11358,6791,4567,1595,6162,2021-07-27
3175031001,JAKARTA TIMUR,JATINEGARA,KAMPUNG MELAYU,25717,16044,9673,2578,12251,2021-07-27
3171081002,JAKARTA PUSAT,JOHAR BARU,KAMPUNG RAWA,21237,8670,12567,3010,15577,2021-07-27
3175041002,JAKARTA TIMUR,KRAMAT JATI,KAMPUNG TENGAH,43993,27581,16412,5904,22316,2021-07-27
3173011005,JAKARTA BARAT,CENGKARENG,KAPUK,134466,78276,56190,12138,68328,2021-07-27
3172011003,JAKARTA UTARA,PENJARINGAN,KAPUK MUARA,35781,15993,19788,7851,27639,2021-07-27
3171021002,JAKARTA PUSAT,SAWAH BESAR,KARANG ANYAR,25761,13153,12608,3817,16425,2021-07-27
3174021004,JAKARTA SELATAN,SETIA BUDI,KARET,9623,4884,4739,1740,6479,2021-07-27
3174021003,JAKARTA SELATAN,SETIA BUDI,KARET KUNINGAN,16055,7450,8605,2806,11411,2021-07-27
3174021002,JAKARTA SELATAN,SETIA BUDI,KARET SEMANGGI,2770,1187,1583,741,2324,2021-07-27
3171071003,JAKARTA PUSAT,TANAH ABANG,KARET TENGSIN,19271,10042,9229,2532,11761,2021-07-27
3171021003,JAKARTA PUSAT,SAWAH BESAR,KARTINI,22292,10793,11499,3918,15417,2021-07-27
3175011003,JAKARTA TIMUR,MATRAMAN,KAYU MANIS,25284,14713,10571,3486,14057,2021-07-27
3175021006,JAKARTA TIMUR,PULO GADUNG,KAYU PUTIH,40696,20048,20648,8515,29163,2021-07-27
3173031006,JAKARTA BARAT,TAMAN SARI,KEAGUNGAN,17387,8481,8906,2317,11223,2021-07-27
3174041007,JAKARTA SELATAN,PASAR MINGGU,KEBAGUSAN,44552,24529,20023,6990,27013,2021-07-27
3174051006,JAKARTA SELATAN,KEBAYORAN LAMA,KEBAYORAN LAMA SELATAN,41212,20494,20718,6546,27264,2021-07-27
3174051001,JAKARTA SELATAN,KEBAYORAN LAMA,KEBAYORAN LAMA UTARA,42422,23675,18747,6288,25035,2021-07-27
3174011004,JAKARTA SELATAN,TEBET,KEBON BARU,35165,18512,16653,6109,22762,2021-07-27
3172021005,JAKARTA UTARA,TANJUNG PRIOK,KEBON BAWANG,50952,25731,25221,8223,33444,2021-07-27
3173051001,JAKARTA BARAT,KEBON JERUK,KEBON JERUK,53887,30762,23125,7707,30832,2021-07-27
3171071006,JAKARTA PUSAT,TANAH ABANG,KEBON KACANG,21531,13355,8176,2903,11079,2021-07-27
3171011005,JAKARTA PUSAT,GAMBIR,KEBON KELAPA,10163,5223,4940,1813,6753,2021-07-27
3171031002,JAKARTA PUSAT,KEMAYORAN,KEBON KOSONG,30019,15826,14193,4189,18382,2021-07-27
3175011005,JAKARTA TIMUR,MATRAMAN,KEBON MANGGIS,16490,8452,8038,3278,11316,2021-07-27
3171071005,JAKARTA PUSAT,TANAH ABANG,KEBON MELATI,32206,21168,11038,3177,14215,2021-07-27
3175081003,JAKARTA TIMUR,MAKASAR,KEBON PALA,46614,25571,21043,7271,28314,2021-07-27
3171061005,JAKARTA PUSAT,MENTENG,KEBON SIRIH,12299,7255,5044,1798,6842,2021-07-27
3173011004,JAKARTA BARAT,CENGKARENG,KEDAUNG KALI ANGKE,32612,14325,18287,4022,22309,2021-07-27
3173051007,JAKARTA BARAT,KEBON JERUK,KEDOYA SELATAN,32165,16200,15965,5155,21120,2021-07-27
3173051006,JAKARTA BARAT,KEBON JERUK,KEDOYA UTARA,45740,22217,23523,7843,31366,2021-07-27
3173051004,JAKARTA BARAT,KEBON JERUK,KELAPA DUA,23565,12754,10811,3521,14332,2021-07-27
3175091003,JAKARTA TIMUR,CIRACAS,KELAPA DUA WETAN,46875,23828,23047,8339,31386,2021-07-27
3172061003,JAKARTA UTARA,KELAPA GADING,KELAPA GADING BARAT,35717,14572,21145,9707,30852,2021-07-27
3172061001,JAKARTA UTARA,KELAPA GADING,KELAPA GADING TIMUR,33592,12730,20862,10055,30917,2021-07-27
3173071005,JAKARTA BARAT,PALMERAH,KEMANGGISAN,32139,16805,15334,5738,21072,2021-07-27
3171031001,JAKARTA PUSAT,KEMAYORAN,KEMAYORAN,20708,10260,10448,3312,13760,2021-07-27
3173081006,JAKARTA BARAT,KEMBANGAN,KEMBANGAN SELATAN,27130,13755,13375,5560,18935,2021-07-27
3173081001,JAKARTA BARAT,KEMBANGAN,KEMBANGAN UTARA,54451,27864,26587,7475,34062,2021-07-27
3171041002,JAKARTA PUSAT,SENEN,KENARI,9579,4665,4914,1949,6863,2021-07-27
3173041005,JAKARTA BARAT,TAMBORA,KERENDANG,19973,10583,9390,2520,11910,2021-07-27
3175071003,JAKARTA TIMUR,DUREN SAWIT,KLENDER,69978,43356,26622,8724,35346,2021-07-27
3172031001,JAKARTA UTARA,KOJA,KOJA,28175,14358,13817,3387,17204,2021-07-27
3173071006,JAKARTA BARAT,PALMERAH,KOTA BAMBU SELATAN,21158,11382,9776,2526,12302,2021-07-27
3173071003,JAKARTA BARAT,PALMERAH,KOTA BAMBU UTARA,24995,13767,11228,3011,14239,2021-07-27
3171041004,JAKARTA PUSAT,SENEN,KRAMAT,28835,16337,12498,3560,16058,2021-07-27
3175041001,JAKARTA TIMUR,KRAMAT JATI,KRAMAT JATI,34144,19537,14607,5621,20228,2021-07-27
3174071003,JAKARTA SELATAN,KEBAYORAN BARU,KRAMAT PELA,14413,6924,7489,2743,10232,2021-07-27
3173031002,JAKARTA BARAT,TAMAN SARI,KRUKUT,19244,9860,9384,2683,12067,2021-07-27
3174031005,JAKARTA SELATAN,MAMPANG PRAPATAN,KUNINGAN BARAT,12785,6030,6755,2002,8757,2021-07-27
3174021008,JAKARTA SELATAN,SETIA BUDI,KUNINGAN TIMUR,6008,3080,2928,1246,4174,2021-07-27
3171041005,JAKARTA PUSAT,SENEN,KWITANG,15486,8068,7418,2512,9930,2021-07-27
3172031003,JAKARTA UTARA,KOJA,LAGOA,59065,32263,26802,6639,33441,2021-07-27
3174061002,JAKARTA SELATAN,CILANDAK,LEBAK BULUS,37626,19246,18380,7297,25677,2021-07-27
3174091004,JAKARTA SELATAN,JAGAKARSA,LENTENG AGUNG,53946,30339,23607,7592,31199,2021-07-27
3175101007,JAKARTA TIMUR,CIPAYUNG,LUBANG BUAYA,63547,33533,30014,10983,40997,2021-07-27
3175081001,JAKARTA TIMUR,MAKASAR,MAKASAR,34390,17863,16527,5965,22492,2021-07-27
3175071006,JAKARTA TIMUR,DUREN SAWIT,MALAKA JAYA,30927,15134,15793,6332,22125,2021-07-27
3175071005,JAKARTA TIMUR,DUREN SAWIT,MALAKA SARI,27530,13442,14088,6077,20165,2021-07-27
3174031001,JAKARTA SELATAN,MAMPANG PRAPATAN,MAMPANG PRAPATAN,18159,9207,8952,2799,11751,2021-07-27
3173031005,JAKARTA BARAT,TAMAN SARI,MANGGA BESAR,7707,3163,4544,1645,6189,2021-07-27
3171021005,JAKARTA PUSAT,SAWAH BESAR,MANGGA DUA SELATAN,27442,14181,13261,4475,17736,2021-07-27
3174011007,JAKARTA SELATAN,TEBET,MANGGARAI,28373,15083,13290,4124,17414,2021-07-27
3174011006,JAKARTA SELATAN,TEBET,MANGGARAI SELATAN,23075,11482,11593,4295,15888,2021-07-27
3173031003,JAKARTA BARAT,TAMAN SARI,MAPHAR,16461,7903,8558,2903,11461,2021-07-27
3172041003,JAKARTA UTARA,CILINCING,MARUNDA,28943,14404,14539,3018,17557,2021-07-27
3174071001,JAKARTA SELATAN,KEBAYORAN BARU,MELAWAI,2627,1070,1557,925,2482,2021-07-27
3171061001,JAKARTA PUSAT,MENTENG,MENTENG,25624,15105,10519,4056,14575,2021-07-27
3174021005,JAKARTA SELATAN,SETIA BUDI,MENTENG ATAS,27816,13792,14024,4770,18794,2021-07-27
3174011003,JAKARTA SELATAN,TEBET,MENTENG DALAM,36028,19590,16438,6296,22734,2021-07-27
3173081003,JAKARTA BARAT,KEMBANGAN,MERUYA SELATAN,32130,17589,14541,4978,19519,2021-07-27
3173081002,JAKARTA BARAT,KEMBANGAN,MERUYA UTARA,43752,22871,20881,7935,28816,2021-07-27
3175101004,JAKARTA TIMUR,CIPAYUNG,MUNJUL,23871,12949,10922,4134,15056,2021-07-27
3172051002,JAKARTA UTARA,PADEMANGAN,PADEMANGAN BARAT,74240,39656,34584,8840,43424,2021-07-27
3172051001,JAKARTA UTARA,PADEMANGAN,PADEMANGAN TIMUR,37736,16345,21391,7571,28962,2021-07-27
3175011004,JAKARTA TIMUR,MATRAMAN,PAL MERIAM,19769,10957,8812,3206,12018,2021-07-27
3173071001,JAKARTA BARAT,PALMERAH,PALMERAH,63011,34112,28899,8956,37855,2021-07-27
3174081001,JAKARTA SELATAN,PANCORAN,PANCORAN,19421,9752,9669,3325,12994,2021-07-27
3172021003,JAKARTA UTARA,TANJUNG PRIOK,PAPANGGO,39097,19326,19771,5461,25232,2021-07-27
3171021001,JAKARTA PUSAT,SAWAH BESAR,PASAR BARU,12035,5143,6892,2930,9822,2021-07-27
3174021006,JAKARTA SELATAN,SETIA BUDI,PASAR MANGGIS,26752,13880,12872,4348,17220,2021-07-27
3174041001,JAKARTA SELATAN,PASAR MINGGU,PASAR MINGGU,24821,12695,12126,5366,17492,2021-07-27
3171041003,JAKARTA PUSAT,SENEN,PASEBAN,23533,12362,11171,3758,14929,2021-07-27
3173061005,JAKARTA BARAT,KALI DERES,PEGADUNGAN,75587,39570,36017,12180,48197,2021-07-27
3171061002,JAKARTA PUSAT,MENTENG,PEGANGSAAN,23455,13804,9651,3319,12970,2021-07-27
3172061002,JAKARTA UTARA,KELAPA GADING,PEGANGSAAN DUA,49976,19563,30413,11614,42027,2021-07-27
3172011004,JAKARTA UTARA,PENJARINGAN,PEJAGALAN,74578,36600,37978,13596,51574,2021-07-27
3174041006,JAKARTA SELATAN,PASAR MINGGU,PEJATEN BARAT,37346,19187,18159,6973,25132,2021-07-27
3174041005,JAKARTA SELATAN,PASAR MINGGU,PEJATEN TIMUR,57656,33751,23905,8547,32452,2021-07-27
3175051005,JAKARTA TIMUR,PASAR REBO,PEKAYON,43250,21529,21721,7285,29006,2021-07-27
3173041009,JAKARTA BARAT,TAMBORA,PEKOJAN,23587,11258,12329,3950,16279,2021-07-27
3174031003,JAKARTA SELATAN,MAMPANG PRAPATAN,PELA MAMPANG,43522,21361,22161,7079,29240,2021-07-27
3174081005,JAKARTA SELATAN,PANCORAN,PENGADEGAN,21478,9369,12109,4054,16163,2021-07-27
3175061003,JAKARTA TIMUR,CAKUNG,PENGGILINGAN,99255,59527,39728,10753,50481,2021-07-27
3172011001,JAKARTA UTARA,PENJARINGAN,PENJARINGAN,88308,51192,37116,9936,47052,2021-07-27
3174101001,JAKARTA SELATAN,PESANGGRAHAN,PESANGGRAHAN,27545,12976,14569,5720,20289,2021-07-27
3171071004,JAKARTA PUSAT,TANAH ABANG,PETAMBURAN,33271,21380,11891,3253,15144,2021-07-27
3174071008,JAKARTA SELATAN,KEBAYORAN BARU,PETOGOGAN,11499,5690,5809,2234,8043,2021-07-27
3171011004,JAKARTA PUSAT,GAMBIR,PETOJO SELATAN,14692,7516,7176,3138,10314,2021-07-27
3171011003,JAKARTA PUSAT,GAMBIR,PETOJO UTARA,17458,9699,7759,2935,10694,2021-07-27
3174101004,JAKARTA SELATAN,PESANGGRAHAN,PETUKANGAN SELATAN,37187,18077,19110,5677,24787,2021-07-27
3174101003,JAKARTA SELATAN,PESANGGRAHAN,PETUKANGAN UTARA,53716,28725,24991,8641,33632,2021-07-27
3175081002,JAKARTA TIMUR,MAKASAR,PINANG RANTI,27198,14071,13127,4322,17449,2021-07-27
3173031008,JAKARTA BARAT,TAMAN SARI,PINANGSIA,10729,4659,6070,1885,7955,2021-07-27
3175011001,JAKARTA TIMUR,MATRAMAN,PISANGAN BARU,31776,19317,12459,4443,16902,2021-07-27
3175021002,JAKARTA TIMUR,PULO GADUNG,PISANGAN TIMUR,41011,22170,18841,6269,25110,2021-07-27
3172011005,JAKARTA UTARA,PENJARINGAN,PLUIT,47783,21675,26108,13984,40092,2021-07-27
3175071002,JAKARTA TIMUR,DUREN SAWIT,PONDOK BAMBU,61550,34632,26918,10382,37300,2021-07-27
3175071004,JAKARTA TIMUR,DUREN SAWIT,PONDOK KELAPA,72015,37410,34605,12529,47134,2021-07-27
3175071007,JAKARTA TIMUR,DUREN SAWIT,PONDOK KOPI,35367,21505,13862,5066,18928,2021-07-27
3174061003,JAKARTA SELATAN,CILANDAK,PONDOK LABU,46464,21801,24663,8860,33523,2021-07-27
3174051002,JAKARTA SELATAN,KEBAYORAN LAMA,PONDOK PINANG,56169,29695,26474,11225,37699,2021-07-27
3175101003,JAKARTA TIMUR,CIPAYUNG,PONDOK RANGGON,25574,14728,10846,4237,15083,2021-07-27
3101011003,KAB.ADM.KEP.SERIBU,KEP. SERIBU UTARA,PULAU HARAPAN,2060,504,1556,685,2241,2021-07-27
3101011002,KAB.ADM.KEP.SERIBU,KEP. SERIBU UTARA,PULAU KELAPA,5528,1256,4272,1335,5607,2021-07-27
3101011001,KAB.ADM.KEP.SERIBU,KEP. SERIBU UTARA,PULAU PANGGANG,5450,1170,4280,1242,5522,2021-07-27
3101021003,KAB.ADM.KEP.SERIBU,KEP. SERIBU SELATAN,PULAU PARI,2765,429,2336,654,2990,2021-07-27
3101021002,KAB.ADM.KEP.SERIBU,KEP. SERIBU SELATAN,PULAU TIDUNG,4553,936,3617,1394,5011,2021-07-27
3101021001,KAB.ADM.KEP.SERIBU,KEP. SERIBU SELATAN,PULAU UNTUNG JAWA,1941,481,1460,607,2067,2021-07-27
3174071007,JAKARTA SELATAN,KEBAYORAN BARU,PULO,5835,2487,3348,1567,4915,2021-07-27
3175021001,JAKARTA TIMUR,PULO GADUNG,PULO GADUNG,34422,19259,15163,5340,20503,2021-07-27
3175061005,JAKARTA TIMUR,CAKUNG,PULO GEBANG,97301,54029,43272,12106,55378,2021-07-27
3174041004,JAKARTA SELATAN,PASAR MINGGU,RAGUNAN,39616,18960,20656,7217,27873,2021-07-27
3175091005,JAKARTA TIMUR,CIRACAS,RAMBUTAN,36771,22143,14628,4943,19571,2021-07-27
3172031006,JAKARTA UTARA,KOJA,RAWA BADAK SELATAN,42179,24072,18107,4458,22565,2021-07-27
3172031004,JAKARTA UTARA,KOJA,RAWA BADAK UTARA,34408,18112,16296,4538,20834,2021-07-27
3174071005,JAKARTA SELATAN,KEBAYORAN BARU,RAWA BARAT,5625,2604,3021,1518,4539,2021-07-27
3173011003,JAKARTA BARAT,CENGKARENG,RAWA BUAYA,63799,35845,27954,7576,35530,2021-07-27
3175031004,JAKARTA TIMUR,JATINEGARA,RAWA BUNGA,21434,12541,8893,2776,11669,2021-07-27
3174081003,JAKARTA SELATAN,PANCORAN,RAWA JATI,20509,9809,10700,4014,14714,2021-07-27
3175061002,JAKARTA TIMUR,CAKUNG,RAWA TERATE,24637,11946,12691,2411,15102,2021-07-27
3175021005,JAKARTA TIMUR,PULO GADUNG,RAWAMANGUN,37612,20029,17583,6561,24144,2021-07-27
3171051003,JAKARTA PUSAT,CEMPAKA PUTIH,RAWASARI,21967,11259,10708,4045,14753,2021-07-27
3173041010,JAKARTA BARAT,TAMBORA,ROA MALAKA,3484,1405,2079,982,3061,2021-07-27
3172041006,JAKARTA UTARA,CILINCING,ROROTAN,41668,20363,21305,5406,26711,2021-07-27
3174071004,JAKARTA SELATAN,KEBAYORAN BARU,SELONG,2842,1198,1644,974,2618,2021-07-27
3173061002,JAKARTA BARAT,KALI DERES,SEMANAN,71354,41454,29900,5917,35817,2021-07-27
3172041007,JAKARTA UTARA,CILINCING,SEMPER BARAT,68587,32002,36585,10243,46828,2021-07-27
3172041005,JAKARTA UTARA,CILINCING,SEMPER TIMUR,36267,18252,18015,5186,23201,2021-07-27
3174071006,JAKARTA SELATAN,KEBAYORAN BARU,SENAYAN,2771,1511,1260,664,1924,2021-07-27
3171041001,JAKARTA PUSAT,SENEN,SENEN,6804,3376,3428,1300,4728,2021-07-27
3171031004,JAKARTA PUSAT,KEMAYORAN,SERDANG,29668,15683,13985,4682,18667,2021-07-27
3174021001,JAKARTA SELATAN,SETIA BUDI,SETIA BUDI,3023,1508,1515,717,2232,2021-07-27
3175101005,JAKARTA TIMUR,CIPAYUNG,SETU,20572,12345,8227,2991,11218,2021-07-27
3173071002,JAKARTA BARAT,PALMERAH,SLIPI,16591,8081,8510,2942,11452,2021-07-27
3173081004,JAKARTA BARAT,KEMBANGAN,SRENGSENG,45523,25888,19635,7074,26709,2021-07-27
3174091002,JAKARTA SELATAN,JAGAKARSA,SRENGSENG SAWAH,58196,26481,31715,11116,42831,2021-07-27
3173051003,JAKARTA BARAT,KEBON JERUK,SUKABUMI SELATAN,37033,22053,14980,3890,18870,2021-07-27
3173051002,JAKARTA BARAT,KEBON JERUK,SUKABUMI UTARA,38290,23611,14679,4496,19175,2021-07-27
3172041002,JAKARTA UTARA,CILINCING,SUKAPURA,53949,27621,26328,6204,32532,2021-07-27
3171031007,JAKARTA PUSAT,KEMAYORAN,SUMUR BATU,22717,11812,10905,4160,15065,2021-07-27
3172021004,JAKARTA UTARA,TANJUNG PRIOK,SUNGAI BAMBU,29876,14798,15078,4530,19608,2021-07-27
3172021006,JAKARTA UTARA,TANJUNG PRIOK,SUNTER AGUNG,71805,30684,41121,15108,56229,2021-07-27
3172021002,JAKARTA UTARA,TANJUNG PRIOK,SUNTER JAYA,63031,29944,33087,12317,45404,2021-07-27
3175091004,JAKARTA TIMUR,CIRACAS,SUSUKAN,38257,20843,17414,5699,23113,2021-07-27
3173031001,JAKARTA BARAT,TAMAN SARI,TAMAN SARI,14348,6748,7600,2729,10329,2021-07-27
3173041001,JAKARTA BARAT,TAMBORA,TAMBORA,10204,5552,4652,1765,6417,2021-07-27
3173041004,JAKARTA BARAT,TAMBORA,TANAH SEREAL,26387,11961,14426,4387,18813,2021-07-27
3171081004,JAKARTA PUSAT,JOHAR BARU,TANAH TINGGI,37693,17620,20073,5104,25177,2021-07-27
3173031004,JAKARTA BARAT,TAMAN SARI,TANGKI,13324,6189,7135,2225,9360,2021-07-27
3174091005,JAKARTA SELATAN,JAGAKARSA,TANJUNG BARAT,39770,22243,17527,6772,24299,2021-07-27
3173021005,JAKARTA BARAT,GROGOL PETAMBURAN,TANJUNG DUREN SELATAN,25337,11519,13818,5213,19031,2021-07-27
3173021002,JAKARTA BARAT,GROGOL PETAMBURAN,TANJUNG DUREN UTARA,17010,7256,9754,4087,13841,2021-07-27
3172021001,JAKARTA UTARA,TANJUNG PRIOK,TANJUNG PRIOK,34588,16660,17928,4193,22121,2021-07-27
3174011002,JAKARTA SELATAN,TEBET,TEBET BARAT,21194,9826,11368,4927,16295,2021-07-27
3174011001,JAKARTA SELATAN,TEBET,TEBET TIMUR,18199,8005,10194,4312,14506,2021-07-27
3173061003,JAKARTA BARAT,KALI DERES,TEGAL ALUR,83647,46152,37495,8503,45998,2021-07-27
3174031004,JAKARTA SELATAN,MAMPANG PRAPATAN,TEGAL PARANG,32401,18534,13867,4225,18092,2021-07-27
3173021003,JAKARTA BARAT,GROGOL PETAMBURAN,TOMANG,29605,14035,15570,5783,21353,2021-07-27
3172031005,JAKARTA UTARA,KOJA,TUGU SELATAN,39122,21536,17586,4448,22034,2021-07-27
3172031002,JAKARTA UTARA,KOJA,TUGU UTARA,67670,37675,29995,7664,37659,2021-07-27
3175061006,JAKARTA TIMUR,CAKUNG,UJUNG MENTENG,29934,14871,15063,4667,19730,2021-07-27
3174101005,JAKARTA SELATAN,PESANGGRAHAN,ULUJAMI,40544,22837,17707,5909,23616,2021-07-27
3175011006,JAKARTA TIMUR,MATRAMAN,UTAN KAYU SELATAN,33511,17407,16104,5944,22048,2021-07-27
3175011002,JAKARTA TIMUR,MATRAMAN,UTAN KAYU UTARA,28169,15120,13049,4572,17621,2021-07-27
3171031008,JAKARTA PUSAT,KEMAYORAN,UTAN PANJANG,29208,16701,12507,3544,16051,2021-07-27
3172021007,JAKARTA UTARA,TANJUNG PRIOK,WARAKAS,44401,22412,21989,6250,28239,2021-07-27
3173021007,JAKARTA BARAT,GROGOL PETAMBURAN,WIJAYA KUSUMA,38934,20617,18317,5675,23992,2021-07-27
3172051003,JAKARTA UTARA,PADEMANGAN,ANCOL,23947,12880,11067,3681,14748,2021-07-28
3173041007,JAKARTA BARAT,TAMBORA,ANGKE,29381,14334,15047,3988,19035,2021-07-28
3175041005,JAKARTA TIMUR,KRAMAT JATI,BALE KAMBANG,29074,19176,9898,3155,13053,2021-07-28
3175031003,JAKARTA TIMUR,JATINEGARA,BALI MESTER,9752,5433,4319,1813,6132,2021-07-28
3175101006,JAKARTA TIMUR,CIPAYUNG,BAMBU APUS,26285,14541,11744,4656,16400,2021-07-28
3174031002,JAKARTA SELATAN,MAMPANG PRAPATAN,BANGKA,21566,10815,10751,3583,14334,2021-07-28
3175051002,JAKARTA TIMUR,PASAR REBO,BARU,23886,10496,13390,5653,19043,2021-07-28
3175041004,JAKARTA TIMUR,KRAMAT JATI,BATU AMPAR,47898,30097,17801,6425,24226,2021-07-28
3171071002,JAKARTA PUSAT,TANAH ABANG,BENDUNGAN HILIR,21494,10395,11099,4047,15146,2021-07-28
3175031002,JAKARTA TIMUR,JATINEGARA,BIDARA CINA,36689,22655,14034,4750,18784,2021-07-28
3174101002,JAKARTA SELATAN,PESANGGRAHAN,BINTARO,53098,27282,25816,8673,34489,2021-07-28
3174011005,JAKARTA SELATAN,TEBET,BUKIT DURI,34183,18950,15233,5276,20509,2021-07-28
3171041006,JAKARTA PUSAT,SENEN,BUNGUR,18144,9079,9065,3294,12359,2021-07-28
3175061007,JAKARTA TIMUR,CAKUNG,CAKUNG BARAT,57724,27893,29831,6153,35984,2021-07-28
3175061004,JAKARTA TIMUR,CAKUNG,CAKUNG TIMUR,58287,29014,29273,8842,38115,2021-07-28
3175041007,JAKARTA TIMUR,KRAMAT JATI,CAWANG,32762,18719,14043,5178,19221,2021-07-28
3175101008,JAKARTA TIMUR,CIPAYUNG,CEGER,18932,10393,8539,3026,11565,2021-07-28
3171031006,JAKARTA PUSAT,KEMAYORAN,CEMPAKA BARU,32581,18328,14253,4932,19185,2021-07-28
3171051002,JAKARTA PUSAT,CEMPAKA PUTIH,CEMPAKA PUTIH BARAT,35885,18920,16965,5830,22795,2021-07-28
3171051001,JAKARTA PUSAT,CEMPAKA PUTIH,CEMPAKA PUTIH TIMUR,24292,12234,12058,5210,17268,2021-07-28
3173011001,JAKARTA BARAT,CENGKARENG,CENGKARENG BARAT,66284,32767,33517,11064,44581,2021-07-28
3173011006,JAKARTA BARAT,CENGKARENG,CENGKARENG TIMUR,81027,43633,37394,11578,48972,2021-07-28
3175091002,JAKARTA TIMUR,CIRACAS,CIBUBUR,66364,32547,33817,11872,45689,2021-07-28
3171011002,JAKARTA PUSAT,GAMBIR,CIDENG,15390,7089,8301,3559,11860,2021-07-28
3174091003,JAKARTA SELATAN,JAGAKARSA,CIGANJUR,38497,19319,19178,6754,25932,2021-07-28
3175051003,JAKARTA TIMUR,PASAR REBO,CIJANTUNG,41419,20828,20591,7863,28454,2021-07-28
3171061003,JAKARTA PUSAT,MENTENG,CIKINI,8274,4558,3716,1580,5296,2021-07-28
3174081006,JAKARTA SELATAN,PANCORAN,CIKOKO,10547,4672,5875,2051,7926,2021-07-28
3174061001,JAKARTA SELATAN,CILANDAK,CILANDAK BARAT,51752,24306,27446,10284,37730,2021-07-28
3174041003,JAKARTA SELATAN,PASAR MINGGU,CILANDAK TIMUR,25145,12007,13138,5791,18929,2021-07-28
3175101002,JAKARTA TIMUR,CIPAYUNG,CILANGKAP,27635,14680,12955,4529,17484,2021-07-28
3175041006,JAKARTA TIMUR,KRAMAT JATI,CILILITAN,40181,24000,16181,6374,22555,2021-07-28
3172041001,JAKARTA UTARA,CILINCING,CILINCING,43609,23811,19798,4890,24688,2021-07-28
3175101001,JAKARTA TIMUR,CIPAYUNG,CIPAYUNG,26104,12797,13307,4963,18270,2021-07-28
3174091006,JAKARTA SELATAN,JAGAKARSA,CIPEDAK,38303,17738,20565,6658,27223,2021-07-28
3174061005,JAKARTA SELATAN,CILANDAK,CIPETE SELATAN,26704,13211,13493,5072,18565,2021-07-28
3174071010,JAKARTA SELATAN,KEBAYORAN BARU,CIPETE UTARA,34102,16604,17498,5269,22767,2021-07-28
3175021003,JAKARTA TIMUR,PULO GADUNG,CIPINANG,39306,21111,18195,6958,25153,2021-07-28
3175031007,JAKARTA TIMUR,JATINEGARA,CIPINANG BESAR SELATAN,35212,21661,13551,4462,18013,2021-07-28
3175031008,JAKARTA TIMUR,JATINEGARA,CIPINANG BESAR UTARA,45319,28686,16633,4904,21537,2021-07-28
3175031005,JAKARTA TIMUR,JATINEGARA,CIPINANG CEMPEDAK,32824,18865,13959,5420,19379,2021-07-28
3175081005,JAKARTA TIMUR,MAKASAR,CIPINANG MELAYU,42308,22073,20235,7750,27985,2021-07-28
3175031006,JAKARTA TIMUR,JATINEGARA,CIPINANG MUARA,55243,33375,21868,8509,30377,2021-07-28
3174051003,JAKARTA SELATAN,KEBAYORAN LAMA,CIPULIR,39937,22397,17540,6030,23570,2021-07-28
3175091001,JAKARTA TIMUR,CIRACAS,CIRACAS,64594,32097,32497,10398,42895,2021-07-28
3175041003,JAKARTA TIMUR,KRAMAT JATI,DUKUH,24609,13546,11063,4235,15298,2021-07-28
3175071001,JAKARTA TIMUR,DUREN SAWIT,DUREN SAWIT,61160,34727,26433,11208,37641,2021-07-28
3174081004,JAKARTA SELATAN,PANCORAN,DUREN TIGA,28319,13824,14495,4797,19292,2021-07-28
3173051005,JAKARTA BARAT,KEBON JERUK,DURI KEPA,60138,28221,31917,11687,43604,2021-07-28
3173011002,JAKARTA BARAT,CENGKARENG,DURI KOSAMBI,77923,42824,35099,10942,46041,2021-07-28
3171011006,JAKARTA PUSAT,GAMBIR,DURI PULO,19610,10315,9295,2796,12091,2021-07-28
3173041011,JAKARTA BARAT,TAMBORA,DURI SELATAN,14259,6516,7743,2622,10365,2021-07-28
3173041003,JAKARTA BARAT,TAMBORA,DURI UTARA,19844,9580,10264,3056,13320,2021-07-28
3171081003,JAKARTA PUSAT,JOHAR BARU,GALUR,18243,8271,9972,2435,12407,2021-07-28
3171011001,JAKARTA PUSAT,GAMBIR,GAMBIR,2191,988,1203,588,1791,2021-07-28
3174061004,JAKARTA SELATAN,CILANDAK,GANDARIA SELATAN,22119,11341,10778,3916,14694,2021-07-28
3174071009,JAKARTA SELATAN,KEBAYORAN BARU,GANDARIA UTARA,39922,20296,19626,6712,26338,2021-07-28
3175051001,JAKARTA TIMUR,PASAR REBO,GEDONG,35755,18938,16817,6493,23310,2021-07-28
3171071001,JAKARTA PUSAT,TANAH ABANG,GELORA,3127,1619,1508,645,2153,2021-07-28
3173031007,JAKARTA BARAT,TAMAN SARI,GLODOK,7837,3081,4756,2277,7033,2021-07-28
3171061004,JAKARTA PUSAT,MENTENG,GONDANGDIA,4100,1822,2278,1436,3714,2021-07-28
3173021001,JAKARTA BARAT,GROGOL PETAMBURAN,GROGOL,16876,8368,8508,3161,11669,2021-07-28
3174051005,JAKARTA SELATAN,KEBAYORAN LAMA,GROGOL SELATAN,44251,24274,19977,6411,26388,2021-07-28
3174051004,JAKARTA SELATAN,KEBAYORAN LAMA,GROGOL UTARA,42494,23584,18910,6955,25865,2021-07-28
3174021007,JAKARTA SELATAN,SETIA BUDI,GUNTUR,3985,1766,2219,1131,3350,2021-07-28
3174071002,JAKARTA SELATAN,KEBAYORAN BARU,GUNUNG,9436,4368,5068,2425,7493,2021-07-28
3171031005,JAKARTA PUSAT,KEMAYORAN,GUNUNG SAHARI SELATAN,19199,9629,9570,3545,13115,2021-07-28
3171021004,JAKARTA PUSAT,SAWAH BESAR,GUNUNG SAHARI UTARA,16650,7252,9398,3851,13249,2021-07-28
3175081004,JAKARTA TIMUR,MAKASAR,HALIM PERDANA KUSUMAH,28363,10207,18156,10365,28521,2021-07-28
3171031003,JAKARTA PUSAT,KEMAYORAN,HARAPAN MULIA,22557,12112,10445,3317,13762,2021-07-28
3174091001,JAKARTA SELATAN,JAGAKARSA,JAGAKARSA,62389,29542,32847,11934,44781,2021-07-28
3175021007,JAKARTA TIMUR,PULO GADUNG,JATI,32757,17499,15258,6438,21696,2021-07-28
3174041002,JAKARTA SELATAN,PASAR MINGGU,JATI PADANG,37502,18869,18633,7486,26119,2021-07-28
3173071004,JAKARTA BARAT,PALMERAH,JATI PULO,28738,13328,15410,4090,19500,2021-07-28
3175061001,JAKARTA TIMUR,CAKUNG,JATINEGARA,84160,49069,35091,8569,43660,2021-07-28
3175021004,JAKARTA TIMUR,PULO GADUNG,JATINEGARA KAUM,24632,13393,11239,3475,14714,2021-07-28
3173021004,JAKARTA BARAT,GROGOL PETAMBURAN,JELAMBAR,30266,14352,15914,6698,22612,2021-07-28
3173021006,JAKARTA BARAT,GROGOL PETAMBURAN,JELAMBAR BARU,38246,18606,19640,7685,27325,2021-07-28
3173041006,JAKARTA BARAT,TAMBORA,JEMBATAN BESI,29314,18241,11073,2919,13992,2021-07-28
3173041008,JAKARTA BARAT,TAMBORA,JEMBATAN LIMA,21021,12133,8888,2770,11658,2021-07-28
3173081005,JAKARTA BARAT,KEMBANGAN,JOGLO,40839,21922,18917,7085,26002,2021-07-28
3171081001,JAKARTA PUSAT,JOHAR BARU,JOHAR BARU,37488,17656,19832,6452,26284,2021-07-28
3173041002,JAKARTA BARAT,TAMBORA,KALI ANYAR,23856,13540,10316,2618,12934,2021-07-28
3172041004,JAKARTA UTARA,CILINCING,KALIBARU,67684,39401,28283,5272,33555,2021-07-28
3174081002,JAKARTA SELATAN,PANCORAN,KALIBATA,41994,23473,18521,6215,24736,2021-07-28
3173061001,JAKARTA BARAT,KALI DERES,KALIDERES,72447,37885,34562,10157,44719,2021-07-28
3175051004,JAKARTA TIMUR,PASAR REBO,KALISARI,43212,22098,21114,8422,29536,2021-07-28
3173061004,JAKARTA BARAT,KALI DERES,KAMAL,53783,32345,21438,4560,25998,2021-07-28
3172011002,JAKARTA UTARA,PENJARINGAN,KAMAL MUARA,12930,4751,8179,3367,11546,2021-07-28
3171071007,JAKARTA PUSAT,TANAH ABANG,KAMPUNG BALI,11358,6700,4658,1659,6317,2021-07-28
3175031001,JAKARTA TIMUR,JATINEGARA,KAMPUNG MELAYU,25717,15784,9933,2673,12606,2021-07-28
3171081002,JAKARTA PUSAT,JOHAR BARU,KAMPUNG RAWA,21237,8530,12707,3201,15908,2021-07-28
3175041002,JAKARTA TIMUR,KRAMAT JATI,KAMPUNG TENGAH,43993,27261,16732,6102,22834,2021-07-28
3173011005,JAKARTA BARAT,CENGKARENG,KAPUK,134466,77183,57283,12931,70214,2021-07-28
3172011003,JAKARTA UTARA,PENJARINGAN,KAPUK MUARA,35781,15733,20048,8182,28230,2021-07-28
3171021002,JAKARTA PUSAT,SAWAH BESAR,KARANG ANYAR,25761,12943,12818,3969,16787,2021-07-28
3174021004,JAKARTA SELATAN,SETIA BUDI,KARET,9623,4830,4793,1830,6623,2021-07-28
3174021003,JAKARTA SELATAN,SETIA BUDI,KARET KUNINGAN,16055,7344,8711,2946,11657,2021-07-28
3174021002,JAKARTA SELATAN,SETIA BUDI,KARET SEMANGGI,2770,1179,1591,767,2358,2021-07-28
3171071003,JAKARTA PUSAT,TANAH ABANG,KARET TENGSIN,19271,9795,9476,2626,12102,2021-07-28
3171021003,JAKARTA PUSAT,SAWAH BESAR,KARTINI,22292,10672,11620,4061,15681,2021-07-28
3175011003,JAKARTA TIMUR,MATRAMAN,KAYU MANIS,25284,14520,10764,3603,14367,2021-07-28
3175021006,JAKARTA TIMUR,PULO GADUNG,KAYU PUTIH,40696,19803,20893,8767,29660,2021-07-28
3173031006,JAKARTA BARAT,TAMAN SARI,KEAGUNGAN,17387,8280,9107,2406,11513,2021-07-28
3174041007,JAKARTA SELATAN,PASAR MINGGU,KEBAGUSAN,44552,24177,20375,7292,27667,2021-07-28
3174051006,JAKARTA SELATAN,KEBAYORAN LAMA,KEBAYORAN LAMA SELATAN,41212,20312,20900,6813,27713,2021-07-28
3174051001,JAKARTA SELATAN,KEBAYORAN LAMA,KEBAYORAN LAMA UTARA,42422,23321,19101,6486,25587,2021-07-28
3174011004,JAKARTA SELATAN,TEBET,KEBON BARU,35165,18194,16971,6366,23337,2021-07-28
3172021005,JAKARTA UTARA,TANJUNG PRIOK,KEBON BAWANG,50952,25343,25609,8589,34198,2021-07-28
3173051001,JAKARTA BARAT,KEBON JERUK,KEBON JERUK,53887,30230,23657,8010,31667,2021-07-28
3171071006,JAKARTA PUSAT,TANAH ABANG,KEBON KACANG,21531,13129,8402,2989,11391,2021-07-28
3171011005,JAKARTA PUSAT,GAMBIR,KEBON KELAPA,10163,5181,4982,1875,6857,2021-07-28
3171031002,JAKARTA PUSAT,KEMAYORAN,KEBON KOSONG,30019,15505,14514,4427,18941,2021-07-28
3175011005,JAKARTA TIMUR,MATRAMAN,KEBON MANGGIS,16490,8388,8102,3393,11495,2021-07-28
3171071005,JAKARTA PUSAT,TANAH ABANG,KEBON MELATI,32206,20881,11325,3251,14576,2021-07-28
3175081003,JAKARTA TIMUR,MAKASAR,KEBON PALA,46614,25203,21411,7503,28914,2021-07-28
3171061005,JAKARTA PUSAT,MENTENG,KEBON SIRIH,12299,7207,5092,1852,6944,2021-07-28
3173011004,JAKARTA BARAT,CENGKARENG,KEDAUNG KALI ANGKE,32612,14183,18429,4188,22617,2021-07-28
3173051007,JAKARTA BARAT,KEBON JERUK,KEDOYA SELATAN,32165,15895,16270,5362,21632,2021-07-28
3173051006,JAKARTA BARAT,KEBON JERUK,KEDOYA UTARA,45740,21756,23984,7992,31976,2021-07-28
3173051004,JAKARTA BARAT,KEBON JERUK,KELAPA DUA,23565,12507,11058,3730,14788,2021-07-28
3175091003,JAKARTA TIMUR,CIRACAS,KELAPA DUA WETAN,46875,23400,23475,8556,32031,2021-07-28
3172061003,JAKARTA UTARA,KELAPA GADING,KELAPA GADING BARAT,35717,14471,21246,9945,31191,2021-07-28
3172061001,JAKARTA UTARA,KELAPA GADING,KELAPA GADING TIMUR,33592,12613,20979,10448,31427,2021-07-28
3173071005,JAKARTA BARAT,PALMERAH,KEMANGGISAN,32139,16606,15533,5845,21378,2021-07-28
3171031001,JAKARTA PUSAT,KEMAYORAN,KEMAYORAN,20708,10051,10657,3452,14109,2021-07-28
3173081006,JAKARTA BARAT,KEMBANGAN,KEMBANGAN SELATAN,27130,13530,13600,5714,19314,2021-07-28
3173081001,JAKARTA BARAT,KEMBANGAN,KEMBANGAN UTARA,54451,27267,27184,7657,34841,2021-07-28
3171041002,JAKARTA PUSAT,SENEN,KENARI,9579,4565,5014,2005,7019,2021-07-28
3173041005,JAKARTA BARAT,TAMBORA,KERENDANG,19973,10419,9554,2594,12148,2021-07-28
3175071003,JAKARTA TIMUR,DUREN SAWIT,KLENDER,69978,42702,27276,9022,36298,2021-07-28
3172031001,JAKARTA UTARA,KOJA,KOJA,28175,14160,14015,3646,17661,2021-07-28
3173071006,JAKARTA BARAT,PALMERAH,KOTA BAMBU SELATAN,21158,11183,9975,2618,12593,2021-07-28
3173071003,JAKARTA BARAT,PALMERAH,KOTA BAMBU UTARA,24995,13435,11560,3114,14674,2021-07-28
3171041004,JAKARTA PUSAT,SENEN,KRAMAT,28835,16121,12714,3727,16441,2021-07-28
3175041001,JAKARTA TIMUR,KRAMAT JATI,KRAMAT JATI,34144,19267,14877,5756,20633,2021-07-28
3174071003,JAKARTA SELATAN,KEBAYORAN BARU,KRAMAT PELA,14413,6850,7563,2819,10382,2021-07-28
3173031002,JAKARTA BARAT,TAMAN SARI,KRUKUT,19244,9629,9615,2796,12411,2021-07-28
3174031005,JAKARTA SELATAN,MAMPANG PRAPATAN,KUNINGAN BARAT,12785,5982,6803,2056,8859,2021-07-28
3174021008,JAKARTA SELATAN,SETIA BUDI,KUNINGAN TIMUR,6008,3055,2953,1281,4234,2021-07-28
3171041005,JAKARTA PUSAT,SENEN,KWITANG,15486,7965,7521,2604,10125,2021-07-28
3172031003,JAKARTA UTARA,KOJA,LAGOA,59065,31926,27139,6955,34094,2021-07-28
3174061002,JAKARTA SELATAN,CILANDAK,LEBAK BULUS,37626,19027,18599,7610,26209,2021-07-28
3174091004,JAKARTA SELATAN,JAGAKARSA,LENTENG AGUNG,53946,30072,23874,7977,31851,2021-07-28
3175101007,JAKARTA TIMUR,CIPAYUNG,LUBANG BUAYA,63547,33031,30516,11626,42142,2021-07-28
3175081001,JAKARTA TIMUR,MAKASAR,MAKASAR,34390,17621,16769,6225,22994,2021-07-28
3175071006,JAKARTA TIMUR,DUREN SAWIT,MALAKA JAYA,30927,14956,15971,6472,22443,2021-07-28
3175071005,JAKARTA TIMUR,DUREN SAWIT,MALAKA SARI,27530,13253,14277,6248,20525,2021-07-28
3174031001,JAKARTA SELATAN,MAMPANG PRAPATAN,MAMPANG PRAPATAN,18159,9108,9051,2954,12005,2021-07-28
3173031005,JAKARTA BARAT,TAMAN SARI,MANGGA BESAR,7707,3145,4562,1693,6255,2021-07-28
3171021005,JAKARTA PUSAT,SAWAH BESAR,MANGGA DUA SELATAN,27442,14046,13396,4660,18056,2021-07-28
3174011007,JAKARTA SELATAN,TEBET,MANGGARAI,28373,14834,13539,4322,17861,2021-07-28
3174011006,JAKARTA SELATAN,TEBET,MANGGARAI SELATAN,23075,11375,11700,4528,16228,2021-07-28
3173031003,JAKARTA BARAT,TAMAN SARI,MAPHAR,16461,7852,8609,2988,11597,2021-07-28
3172041003,JAKARTA UTARA,CILINCING,MARUNDA,28943,14181,14762,3151,17913,2021-07-28
3174071001,JAKARTA SELATAN,KEBAYORAN BARU,MELAWAI,2627,1056,1571,935,2506,2021-07-28
3171061001,JAKARTA PUSAT,MENTENG,MENTENG,25624,14833,10791,4155,14946,2021-07-28
3174021005,JAKARTA SELATAN,SETIA BUDI,MENTENG ATAS,27816,13570,14246,4960,19206,2021-07-28
3174011003,JAKARTA SELATAN,TEBET,MENTENG DALAM,36028,19113,16915,6639,23554,2021-07-28
3173081003,JAKARTA BARAT,KEMBANGAN,MERUYA SELATAN,32130,17368,14762,5207,19969,2021-07-28
3173081002,JAKARTA BARAT,KEMBANGAN,MERUYA UTARA,43752,22430,21322,8183,29505,2021-07-28
3175101004,JAKARTA TIMUR,CIPAYUNG,MUNJUL,23871,12604,11267,4278,15545,2021-07-28
3172051002,JAKARTA UTARA,PADEMANGAN,PADEMANGAN BARAT,74240,38919,35321,9114,44435,2021-07-28
3172051001,JAKARTA UTARA,PADEMANGAN,PADEMANGAN TIMUR,37736,16039,21697,7814,29511,2021-07-28
3175011004,JAKARTA TIMUR,MATRAMAN,PAL MERIAM,19769,10847,8922,3339,12261,2021-07-28
3173071001,JAKARTA BARAT,PALMERAH,PALMERAH,63011,33592,29419,9254,38673,2021-07-28
3174081001,JAKARTA SELATAN,PANCORAN,PANCORAN,19421,9614,9807,3422,13229,2021-07-28
3172021003,JAKARTA UTARA,TANJUNG PRIOK,PAPANGGO,39097,19091,20006,5764,25770,2021-07-28
3171021001,JAKARTA PUSAT,SAWAH BESAR,PASAR BARU,12035,5078,6957,3008,9965,2021-07-28
3174021006,JAKARTA SELATAN,SETIA BUDI,PASAR MANGGIS,26752,13724,13028,4565,17593,2021-07-28
3174041001,JAKARTA SELATAN,PASAR MINGGU,PASAR MINGGU,24821,12551,12270,5499,17769,2021-07-28
3171041003,JAKARTA PUSAT,SENEN,PASEBAN,23533,12080,11453,3879,15332,2021-07-28
3173061005,JAKARTA BARAT,KALI DERES,PEGADUNGAN,75587,38701,36886,12977,49863,2021-07-28
3171061002,JAKARTA PUSAT,MENTENG,PEGANGSAAN,23455,13475,9980,3430,13410,2021-07-28
3172061002,JAKARTA UTARA,KELAPA GADING,PEGANGSAAN DUA,49976,19397,30579,12049,42628,2021-07-28
3172011004,JAKARTA UTARA,PENJARINGAN,PEJAGALAN,74578,36283,38295,14231,52526,2021-07-28
3174041006,JAKARTA SELATAN,PASAR MINGGU,PEJATEN BARAT,37346,18918,18428,7271,25699,2021-07-28
3174041005,JAKARTA SELATAN,PASAR MINGGU,PEJATEN TIMUR,57656,33367,24289,8912,33201,2021-07-28
3175051005,JAKARTA TIMUR,PASAR REBO,PEKAYON,43250,21186,22064,7520,29584,2021-07-28
3173041009,JAKARTA BARAT,TAMBORA,PEKOJAN,23587,11129,12458,4122,16580,2021-07-28
3174031003,JAKARTA SELATAN,MAMPANG PRAPATAN,PELA MAMPANG,43522,20926,22596,7352,29948,2021-07-28
3174081005,JAKARTA SELATAN,PANCORAN,PENGADEGAN,21478,9279,12199,4136,16335,2021-07-28
3175061003,JAKARTA TIMUR,CAKUNG,PENGGILINGAN,99255,58625,40630,11138,51768,2021-07-28
3172011001,JAKARTA UTARA,PENJARINGAN,PENJARINGAN,88308,50394,37914,10324,48238,2021-07-28
3174101001,JAKARTA SELATAN,PESANGGRAHAN,PESANGGRAHAN,27545,12828,14717,5847,20564,2021-07-28
3171071004,JAKARTA PUSAT,TANAH ABANG,PETAMBURAN,33271,21133,12138,3344,15482,2021-07-28
3174071008,JAKARTA SELATAN,KEBAYORAN BARU,PETOGOGAN,11499,5622,5877,2354,8231,2021-07-28
3171011004,JAKARTA PUSAT,GAMBIR,PETOJO SELATAN,14692,7412,7280,3226,10506,2021-07-28
3171011003,JAKARTA PUSAT,GAMBIR,PETOJO UTARA,17458,9634,7824,2996,10820,2021-07-28
3174101004,JAKARTA SELATAN,PESANGGRAHAN,PETUKANGAN SELATAN,37187,17825,19362,5798,25160,2021-07-28
3174101003,JAKARTA SELATAN,PESANGGRAHAN,PETUKANGAN UTARA,53716,28363,25353,8888,34241,2021-07-28
3175081002,JAKARTA TIMUR,MAKASAR,PINANG RANTI,27198,13825,13373,4587,17960,2021-07-28
3173031008,JAKARTA BARAT,TAMAN SARI,PINANGSIA,10729,4610,6119,1957,8076,2021-07-28
3175011001,JAKARTA TIMUR,MATRAMAN,PISANGAN BARU,31776,18934,12842,4560,17402,2021-07-28
3175021002,JAKARTA TIMUR,PULO GADUNG,PISANGAN TIMUR,41011,21867,19144,6443,25587,2021-07-28
3172011005,JAKARTA UTARA,PENJARINGAN,PLUIT,47783,21427,26356,14353,40709,2021-07-28
3175071002,JAKARTA TIMUR,DUREN SAWIT,PONDOK BAMBU,61550,34177,27373,10690,38063,2021-07-28
3175071004,JAKARTA TIMUR,DUREN SAWIT,PONDOK KELAPA,72015,36825,35190,12801,47991,2021-07-28
3175071007,JAKARTA TIMUR,DUREN SAWIT,PONDOK KOPI,35367,21116,14251,5220,19471,2021-07-28
3174061003,JAKARTA SELATAN,CILANDAK,PONDOK LABU,46464,21543,24921,9170,34091,2021-07-28
3174051002,JAKARTA SELATAN,KEBAYORAN LAMA,PONDOK PINANG,56169,29370,26799,11571,38370,2021-07-28
3175101003,JAKARTA TIMUR,CIPAYUNG,PONDOK RANGGON,25574,14421,11153,4374,15527,2021-07-28
3101011003,KAB.ADM.KEP.SERIBU,KEP. SERIBU UTARA,PULAU HARAPAN,2060,496,1564,688,2252,2021-07-28
3101011002,KAB.ADM.KEP.SERIBU,KEP. SERIBU UTARA,PULAU KELAPA,5528,1252,4276,1345,5621,2021-07-28
3101011001,KAB.ADM.KEP.SERIBU,KEP. SERIBU UTARA,PULAU PANGGANG,5450,1159,4291,1248,5539,2021-07-28
3101021003,KAB.ADM.KEP.SERIBU,KEP. SERIBU SELATAN,PULAU PARI,2765,428,2337,672,3009,2021-07-28
3101021002,KAB.ADM.KEP.SERIBU,KEP. SERIBU SELATAN,PULAU TIDUNG,4553,927,3626,1414,5040,2021-07-28
3101021001,KAB.ADM.KEP.SERIBU,KEP. SERIBU SELATAN,PULAU UNTUNG JAWA,1941,468,1473,610,2083,2021-07-28
3174071007,JAKARTA SELATAN,KEBAYORAN BARU,PULO,5835,2474,3361,1612,4973,2021-07-28
3175021001,JAKARTA TIMUR,PULO GADUNG,PULO GADUNG,34422,19042,15380,5530,20910,2021-07-28
3175061005,JAKARTA TIMUR,CAKUNG,PULO GEBANG,97301,53069,44232,12435,56667,2021-07-28
3174041004,JAKARTA SELATAN,PASAR MINGGU,RAGUNAN,39616,18714,20902,7434,28336,2021-07-28
3175091005,JAKARTA TIMUR,CIRACAS,RAMBUTAN,36771,21722,15049,5094,20143,2021-07-28
3172031006,JAKARTA UTARA,KOJA,RAWA BADAK SELATAN,42179,23703,18476,4719,23195,2021-07-28
3172031004,JAKARTA UTARA,KOJA,RAWA BADAK UTARA,34408,17922,16486,4785,21271,2021-07-28
3174071005,JAKARTA SELATAN,KEBAYORAN BARU,RAWA BARAT,5625,2573,3052,1543,4595,2021-07-28
3173011003,JAKARTA BARAT,CENGKARENG,RAWA BUAYA,63799,34990,28809,7849,36658,2021-07-28
3175031004,JAKARTA TIMUR,JATINEGARA,RAWA BUNGA,21434,12344,9090,2861,11951,2021-07-28
3174081003,JAKARTA SELATAN,PANCORAN,RAWA JATI,20509,9635,10874,4091,14965,2021-07-28
3175061002,JAKARTA TIMUR,CAKUNG,RAWA TERATE,24637,11754,12883,2485,15368,2021-07-28
3175021005,JAKARTA TIMUR,PULO GADUNG,RAWAMANGUN,37612,19720,17892,6730,24622,2021-07-28
3171051003,JAKARTA PUSAT,CEMPAKA PUTIH,RAWASARI,21967,11088,10879,4175,15054,2021-07-28
3173041010,JAKARTA BARAT,TAMBORA,ROA MALAKA,3484,1389,2095,1006,3101,2021-07-28
3172041006,JAKARTA UTARA,CILINCING,ROROTAN,41668,20115,21553,5572,27125,2021-07-28
3174071004,JAKARTA SELATAN,KEBAYORAN BARU,SELONG,2842,1193,1649,986,2635,2021-07-28
3173061002,JAKARTA BARAT,KALI DERES,SEMANAN,71354,40538,30816,6306,37122,2021-07-28
3172041007,JAKARTA UTARA,CILINCING,SEMPER BARAT,68587,31382,37205,10645,47850,2021-07-28
3172041005,JAKARTA UTARA,CILINCING,SEMPER TIMUR,36267,18102,18165,5469,23634,2021-07-28
3174071006,JAKARTA SELATAN,KEBAYORAN BARU,SENAYAN,2771,1497,1274,668,1942,2021-07-28
3171041001,JAKARTA PUSAT,SENEN,SENEN,6804,3293,3511,1331,4842,2021-07-28
3171031004,JAKARTA PUSAT,KEMAYORAN,SERDANG,29668,15488,14180,4872,19052,2021-07-28
3174021001,JAKARTA SELATAN,SETIA BUDI,SETIA BUDI,3023,1497,1526,742,2268,2021-07-28
3175101005,JAKARTA TIMUR,CIPAYUNG,SETU,20572,12117,8455,3076,11531,2021-07-28
3173071002,JAKARTA BARAT,PALMERAH,SLIPI,16591,7988,8603,3040,11643,2021-07-28
3173081004,JAKARTA BARAT,KEMBANGAN,SRENGSENG,45523,25320,20203,7303,27506,2021-07-28
3174091002,JAKARTA SELATAN,JAGAKARSA,SRENGSENG SAWAH,58196,26192,32004,11588,43592,2021-07-28
3173051003,JAKARTA BARAT,KEBON JERUK,SUKABUMI SELATAN,37033,21803,15230,4124,19354,2021-07-28
3173051002,JAKARTA BARAT,KEBON JERUK,SUKABUMI UTARA,38290,23322,14968,4712,19680,2021-07-28
3172041002,JAKARTA UTARA,CILINCING,SUKAPURA,53949,27300,26649,6476,33125,2021-07-28
3171031007,JAKARTA PUSAT,KEMAYORAN,SUMUR BATU,22717,11609,11108,4339,15447,2021-07-28
3172021004,JAKARTA UTARA,TANJUNG PRIOK,SUNGAI BAMBU,29876,14606,15270,4819,20089,2021-07-28
3172021006,JAKARTA UTARA,TANJUNG PRIOK,SUNTER AGUNG,71805,30140,41665,15666,57331,2021-07-28
3172021002,JAKARTA UTARA,TANJUNG PRIOK,SUNTER JAYA,63031,29416,33615,12830,46445,2021-07-28
3175091004,JAKARTA TIMUR,CIRACAS,SUSUKAN,38257,20151,18106,5966,24072,2021-07-28
3173031001,JAKARTA BARAT,TAMAN SARI,TAMAN SARI,14348,6684,7664,2817,10481,2021-07-28
3173041001,JAKARTA BARAT,TAMBORA,TAMBORA,10204,5503,4701,1844,6545,2021-07-28
3173041004,JAKARTA BARAT,TAMBORA,TANAH SEREAL,26387,11808,14579,4510,19089,2021-07-28
3171081004,JAKARTA PUSAT,JOHAR BARU,TANAH TINGGI,37693,17371,20322,5290,25612,2021-07-28
3173031004,JAKARTA BARAT,TAMAN SARI,TANGKI,13324,6123,7201,2314,9515,2021-07-28
3174091005,JAKARTA SELATAN,JAGAKARSA,TANJUNG BARAT,39770,21935,17835,7031,24866,2021-07-28
3173021005,JAKARTA BARAT,GROGOL PETAMBURAN,TANJUNG DUREN SELATAN,25337,11386,13951,5326,19277,2021-07-28
3173021002,JAKARTA BARAT,GROGOL PETAMBURAN,TANJUNG DUREN UTARA,17010,7167,9843,4179,14022,2021-07-28
3172021001,JAKARTA UTARA,TANJUNG PRIOK,TANJUNG PRIOK,34588,16281,18307,4363,22670,2021-07-28
3174011002,JAKARTA SELATAN,TEBET,TEBET BARAT,21194,9621,11573,5013,16586,2021-07-28
3174011001,JAKARTA SELATAN,TEBET,TEBET TIMUR,18199,7897,10302,4489,14791,2021-07-28
3173061003,JAKARTA BARAT,KALI DERES,TEGAL ALUR,83647,45158,38489,8968,47457,2021-07-28
3174031004,JAKARTA SELATAN,MAMPANG PRAPATAN,TEGAL PARANG,32401,18164,14237,4419,18656,2021-07-28
3173021003,JAKARTA BARAT,GROGOL PETAMBURAN,TOMANG,29605,13918,15687,5933,21620,2021-07-28
3172031005,JAKARTA UTARA,KOJA,TUGU SELATAN,39122,21055,18067,4651,22718,2021-07-28
3172031002,JAKARTA UTARA,KOJA,TUGU UTARA,67670,37111,30559,8112,38671,2021-07-28
3175061006,JAKARTA TIMUR,CAKUNG,UJUNG MENTENG,29934,14549,15385,4851,20236,2021-07-28
3174101005,JAKARTA SELATAN,PESANGGRAHAN,ULUJAMI,40544,22469,18075,6301,24376,2021-07-28
3175011006,JAKARTA TIMUR,MATRAMAN,UTAN KAYU SELATAN,33511,17183,16328,6140,22468,2021-07-28
3175011002,JAKARTA TIMUR,MATRAMAN,UTAN KAYU UTARA,28169,14921,13248,4742,17990,2021-07-28
3171031008,JAKARTA PUSAT,KEMAYORAN,UTAN PANJANG,29208,16455,12753,3669,16422,2021-07-28
3172021007,JAKARTA UTARA,TANJUNG PRIOK,WARAKAS,44401,22128,22273,6664,28937,2021-07-28
3173021007,JAKARTA BARAT,GROGOL PETAMBURAN,WIJAYA KUSUMA,38934,20241,18693,5863,24556,2021-07-28
3172051003,JAKARTA UTARA,PADEMANGAN,ANCOL,23947,12671,11276,3832,15108,2021-07-29
3173041007,JAKARTA BARAT,TAMBORA,ANGKE,29381,14214,15167,4232,19399,2021-07-29
3175041005,JAKARTA TIMUR,KRAMAT JATI,BALE KAMBANG,29074,18859,10215,3318,13533,2021-07-29
3175031003,JAKARTA TIMUR,JATINEGARA,BALI MESTER,9752,5341,4411,1870,6281,2021-07-29
3175101006,JAKARTA TIMUR,CIPAYUNG,BAMBU APUS,26285,14390,11895,4848,16743,2021-07-29
3174031002,JAKARTA SELATAN,MAMPANG PRAPATAN,BANGKA,21566,10698,10868,3738,14606,2021-07-29
3175051002,JAKARTA TIMUR,PASAR REBO,BARU,23886,10355,13531,5843,19374,2021-07-29
3175041004,JAKARTA TIMUR,KRAMAT JATI,BATU AMPAR,47898,29586,18312,6645,24957,2021-07-29
3171071002,JAKARTA PUSAT,TANAH ABANG,BENDUNGAN HILIR,21494,10255,11239,4213,15452,2021-07-29
3175031002,JAKARTA TIMUR,JATINEGARA,BIDARA CINA,36689,22393,14296,4975,19271,2021-07-29
3174101002,JAKARTA SELATAN,PESANGGRAHAN,BINTARO,53098,26938,26160,9002,35162,2021-07-29
3174011005,JAKARTA SELATAN,TEBET,BUKIT DURI,34183,18509,15674,5641,21315,2021-07-29
3171041006,JAKARTA PUSAT,SENEN,BUNGUR,18144,8965,9179,3427,12606,2021-07-29
3175061007,JAKARTA TIMUR,CAKUNG,CAKUNG BARAT,57724,26942,30782,6573,37355,2021-07-29
3175061004,JAKARTA TIMUR,CAKUNG,CAKUNG TIMUR,58287,28418,29869,9450,39319,2021-07-29
3175041007,JAKARTA TIMUR,KRAMAT JATI,CAWANG,32762,18399,14363,5419,19782,2021-07-29
3175101008,JAKARTA TIMUR,CIPAYUNG,CEGER,18932,10204,8728,3151,11879,2021-07-29
3171031006,JAKARTA PUSAT,KEMAYORAN,CEMPAKA BARU,32581,18015,14566,5120,19686,2021-07-29
3171051002,JAKARTA PUSAT,CEMPAKA PUTIH,CEMPAKA PUTIH BARAT,35885,18607,17278,6067,23345,2021-07-29
3171051001,JAKARTA PUSAT,CEMPAKA PUTIH,CEMPAKA PUTIH TIMUR,24292,12074,12218,5369,17587,2021-07-29
3173011001,JAKARTA BARAT,CENGKARENG,CENGKARENG BARAT,66284,32502,33782,11660,45442,2021-07-29
3173011006,JAKARTA BARAT,CENGKARENG,CENGKARENG TIMUR,81027,43023,38004,12410,50414,2021-07-29
3175091002,JAKARTA TIMUR,CIRACAS,CIBUBUR,66364,31810,34554,12450,47004,2021-07-29
3171011002,JAKARTA PUSAT,GAMBIR,CIDENG,15390,7020,8370,3650,12020,2021-07-29
3174091003,JAKARTA SELATAN,JAGAKARSA,CIGANJUR,38497,19095,19402,7093,26495,2021-07-29
3175051003,JAKARTA TIMUR,PASAR REBO,CIJANTUNG,41419,20551,20868,8153,29021,2021-07-29
3171061003,JAKARTA PUSAT,MENTENG,CIKINI,8274,4486,3788,1698,5486,2021-07-29
3174081006,JAKARTA SELATAN,PANCORAN,CIKOKO,10547,4566,5981,2106,8087,2021-07-29
3174061001,JAKARTA SELATAN,CILANDAK,CILANDAK BARAT,51752,24023,27729,10736,38465,2021-07-29
3174041003,JAKARTA SELATAN,PASAR MINGGU,CILANDAK TIMUR,25145,11884,13261,6059,19320,2021-07-29
3175101002,JAKARTA TIMUR,CIPAYUNG,CILANGKAP,27635,14505,13130,4749,17879,2021-07-29
3175041006,JAKARTA TIMUR,KRAMAT JATI,CILILITAN,40181,23732,16449,6563,23012,2021-07-29
3172041001,JAKARTA UTARA,CILINCING,CILINCING,43609,23468,20141,5219,25360,2021-07-29
3175101001,JAKARTA TIMUR,CIPAYUNG,CIPAYUNG,26104,12674,13430,5120,18550,2021-07-29
3174091006,JAKARTA SELATAN,JAGAKARSA,CIPEDAK,38303,17527,20776,7046,27822,2021-07-29
3174061005,JAKARTA SELATAN,CILANDAK,CIPETE SELATAN,26704,13030,13674,5310,18984,2021-07-29
3174071010,JAKARTA SELATAN,KEBAYORAN BARU,CIPETE UTARA,34102,16446,17656,5577,23233,2021-07-29
3175021003,JAKARTA TIMUR,PULO GADUNG,CIPINANG,39306,20811,18495,7300,25795,2021-07-29
3175031007,JAKARTA TIMUR,JATINEGARA,CIPINANG BESAR SELATAN,35212,21242,13970,4726,18696,2021-07-29
3175031008,JAKARTA TIMUR,JATINEGARA,CIPINANG BESAR UTARA,45319,27978,17341,5121,22462,2021-07-29
3175031005,JAKARTA TIMUR,JATINEGARA,CIPINANG CEMPEDAK,32824,18678,14146,5603,19749,2021-07-29
3175081005,JAKARTA TIMUR,MAKASAR,CIPINANG MELAYU,42308,21724,20584,8148,28732,2021-07-29
3175031006,JAKARTA TIMUR,JATINEGARA,CIPINANG MUARA,55243,32868,22375,8811,31186,2021-07-29
3174051003,JAKARTA SELATAN,KEBAYORAN LAMA,CIPULIR,39937,22141,17796,6423,24219,2021-07-29
3175091001,JAKARTA TIMUR,CIRACAS,CIRACAS,64594,31775,32819,10878,43697,2021-07-29
3175041003,JAKARTA TIMUR,KRAMAT JATI,DUKUH,24609,13388,11221,4393,15614,2021-07-29
3175071001,JAKARTA TIMUR,DUREN SAWIT,DUREN SAWIT,61160,34343,26817,11623,38440,2021-07-29
3174081004,JAKARTA SELATAN,PANCORAN,DUREN TIGA,28319,13549,14770,4956,19726,2021-07-29
3173051005,JAKARTA BARAT,KEBON JERUK,DURI KEPA,60138,27696,32442,12171,44613,2021-07-29
3173011002,JAKARTA BARAT,CENGKARENG,DURI KOSAMBI,77923,42285,35638,11574,47212,2021-07-29
3171011006,JAKARTA PUSAT,GAMBIR,DURI PULO,19610,10199,9411,2910,12321,2021-07-29
3173041011,JAKARTA BARAT,TAMBORA,DURI SELATAN,14259,6403,7856,2739,10595,2021-07-29
3173041003,JAKARTA BARAT,TAMBORA,DURI UTARA,19844,9471,10373,3173,13546,2021-07-29
3171081003,JAKARTA PUSAT,JOHAR BARU,GALUR,18243,8102,10141,2615,12756,2021-07-29
3171011001,JAKARTA PUSAT,GAMBIR,GAMBIR,2191,976,1215,591,1806,2021-07-29
3174061004,JAKARTA SELATAN,CILANDAK,GANDARIA SELATAN,22119,11138,10981,4093,15074,2021-07-29
3174071009,JAKARTA SELATAN,KEBAYORAN BARU,GANDARIA UTARA,39922,20015,19907,6945,26852,2021-07-29
3175051001,JAKARTA TIMUR,PASAR REBO,GEDONG,35755,18626,17129,6712,23841,2021-07-29
3171071001,JAKARTA PUSAT,TANAH ABANG,GELORA,3127,1586,1541,654,2195,2021-07-29
3173031007,JAKARTA BARAT,TAMAN SARI,GLODOK,7837,3057,4780,2337,7117,2021-07-29
3171061004,JAKARTA PUSAT,MENTENG,GONDANGDIA,4100,1802,2298,1463,3761,2021-07-29
3173021001,JAKARTA BARAT,GROGOL PETAMBURAN,GROGOL,16876,8254,8622,3290,11912,2021-07-29
3174051005,JAKARTA SELATAN,KEBAYORAN LAMA,GROGOL SELATAN,44251,23992,20259,6944,27203,2021-07-29
3174051004,JAKARTA SELATAN,KEBAYORAN LAMA,GROGOL UTARA,42494,23032,19462,7239,26701,2021-07-29
3174021007,JAKARTA SELATAN,SETIA BUDI,GUNTUR,3985,1750,2235,1145,3380,2021-07-29
3174071002,JAKARTA SELATAN,KEBAYORAN BARU,GUNUNG,9436,4339,5097,2485,7582,2021-07-29
3171031005,JAKARTA PUSAT,KEMAYORAN,GUNUNG SAHARI SELATAN,19199,9511,9688,3712,13400,2021-07-29
3171021004,JAKARTA PUSAT,SAWAH BESAR,GUNUNG SAHARI UTARA,16650,7117,9533,3997,13530,2021-07-29
3175081004,JAKARTA TIMUR,MAKASAR,HALIM PERDANA KUSUMAH,28363,10133,18230,10585,28815,2021-07-29
3171031003,JAKARTA PUSAT,KEMAYORAN,HARAPAN MULIA,22557,11844,10713,3511,14224,2021-07-29
3174091001,JAKARTA SELATAN,JAGAKARSA,JAGAKARSA,62389,29183,33206,12536,45742,2021-07-29
3175021007,JAKARTA TIMUR,PULO GADUNG,JATI,32757,17293,15464,6700,22164,2021-07-29
3174041002,JAKARTA SELATAN,PASAR MINGGU,JATI PADANG,37502,18621,18881,7722,26603,2021-07-29
3173071004,JAKARTA BARAT,PALMERAH,JATI PULO,28738,13119,15619,4202,19821,2021-07-29
3175061001,JAKARTA TIMUR,CAKUNG,JATINEGARA,84160,47640,36520,9577,46097,2021-07-29
3175021004,JAKARTA TIMUR,PULO GADUNG,JATINEGARA KAUM,24632,13140,11492,3643,15135,2021-07-29
3173021004,JAKARTA BARAT,GROGOL PETAMBURAN,JELAMBAR,30266,14180,16086,6988,23074,2021-07-29
3173021006,JAKARTA BARAT,GROGOL PETAMBURAN,JELAMBAR BARU,38246,18380,19866,8021,27887,2021-07-29
3173041006,JAKARTA BARAT,TAMBORA,JEMBATAN BESI,29314,17936,11378,3109,14487,2021-07-29
3173041008,JAKARTA BARAT,TAMBORA,JEMBATAN LIMA,21021,12000,9021,2912,11933,2021-07-29
3173081005,JAKARTA BARAT,KEMBANGAN,JOGLO,40839,21571,19268,7407,26675,2021-07-29
3171081001,JAKARTA PUSAT,JOHAR BARU,JOHAR BARU,37488,17342,20146,6696,26842,2021-07-29
3173041002,JAKARTA BARAT,TAMBORA,KALI ANYAR,23856,13183,10673,2757,13430,2021-07-29
3172041004,JAKARTA UTARA,CILINCING,KALIBARU,67684,39046,28638,5731,34369,2021-07-29
3174081002,JAKARTA SELATAN,PANCORAN,KALIBATA,41994,23179,18815,6465,25280,2021-07-29
3173061001,JAKARTA BARAT,KALI DERES,KALIDERES,72447,37356,35091,10709,45800,2021-07-29
3175051004,JAKARTA TIMUR,PASAR REBO,KALISARI,43212,21625,21587,8711,30298,2021-07-29
3173061004,JAKARTA BARAT,KALI DERES,KAMAL,53783,31863,21920,4853,26773,2021-07-29
3172011002,JAKARTA UTARA,PENJARINGAN,KAMAL MUARA,12930,4634,8296,3508,11804,2021-07-29
3171071007,JAKARTA PUSAT,TANAH ABANG,KAMPUNG BALI,11358,6594,4764,1723,6487,2021-07-29
3175031001,JAKARTA TIMUR,JATINEGARA,KAMPUNG MELAYU,25717,15458,10259,2796,13055,2021-07-29
3171081002,JAKARTA PUSAT,JOHAR BARU,KAMPUNG RAWA,21237,8403,12834,3349,16183,2021-07-29
3175041002,JAKARTA TIMUR,KRAMAT JATI,KAMPUNG TENGAH,43993,27001,16992,6344,23336,2021-07-29
3173011005,JAKARTA BARAT,CENGKARENG,KAPUK,134466,76469,57997,13979,71976,2021-07-29
3172011003,JAKARTA UTARA,PENJARINGAN,KAPUK MUARA,35781,15436,20345,8481,28826,2021-07-29
3171021002,JAKARTA PUSAT,SAWAH BESAR,KARANG ANYAR,25761,12734,13027,4169,17196,2021-07-29
3174021004,JAKARTA SELATAN,SETIA BUDI,KARET,9623,4778,4845,1904,6749,2021-07-29
3174021003,JAKARTA SELATAN,SETIA BUDI,KARET KUNINGAN,16055,7243,8812,3069,11881,2021-07-29
3174021002,JAKARTA SELATAN,SETIA BUDI,KARET SEMANGGI,2770,1169,1601,792,2393,2021-07-29
3171071003,JAKARTA PUSAT,TANAH ABANG,KARET TENGSIN,19271,9504,9767,2785,12552,2021-07-29
3171021003,JAKARTA PUSAT,SAWAH BESAR,KARTINI,22292,10544,11748,4296,16044,2021-07-29
3175011003,JAKARTA TIMUR,MATRAMAN,KAYU MANIS,25284,14342,10942,3778,14720,2021-07-29
3175021006,JAKARTA TIMUR,PULO GADUNG,KAYU PUTIH,40696,19549,21147,9100,30247,2021-07-29
3173031006,JAKARTA BARAT,TAMAN SARI,KEAGUNGAN,17387,8229,9158,2520,11678,2021-07-29
3174041007,JAKARTA SELATAN,PASAR MINGGU,KEBAGUSAN,44552,23763,20789,7658,28447,2021-07-29
3174051006,JAKARTA SELATAN,KEBAYORAN LAMA,KEBAYORAN LAMA SELATAN,41212,20078,21134,7070,28204,2021-07-29
3174051001,JAKARTA SELATAN,KEBAYORAN LAMA,KEBAYORAN LAMA UTARA,42422,23059,19363,6750,26113,2021-07-29
3174011004,JAKARTA SELATAN,TEBET,KEBON BARU,35165,17859,17306,6643,23949,2021-07-29
3172021005,JAKARTA UTARA,TANJUNG PRIOK,KEBON BAWANG,50952,24957,25995,8882,34877,2021-07-29
3173051001,JAKARTA BARAT,KEBON JERUK,KEBON JERUK,53887,29808,24079,8364,32443,2021-07-29
3171071006,JAKARTA PUSAT,TANAH ABANG,KEBON KACANG,21531,12762,8769,3077,11846,2021-07-29
3171011005,JAKARTA PUSAT,GAMBIR,KEBON KELAPA,10163,5039,5124,1953,7077,2021-07-29
3171031002,JAKARTA PUSAT,KEMAYORAN,KEBON KOSONG,30019,15269,14750,4602,19352,2021-07-29
3175011005,JAKARTA TIMUR,MATRAMAN,KEBON MANGGIS,16490,8288,8202,3504,11706,2021-07-29
3171071005,JAKARTA PUSAT,TANAH ABANG,KEBON MELATI,32206,20346,11860,3389,15249,2021-07-29
3175081003,JAKARTA TIMUR,MAKASAR,KEBON PALA,46614,24888,21726,7793,29519,2021-07-29
3171061005,JAKARTA PUSAT,MENTENG,KEBON SIRIH,12299,6952,5347,1927,7274,2021-07-29
3173011004,JAKARTA BARAT,CENGKARENG,KEDAUNG KALI ANGKE,32612,13954,18658,4423,23081,2021-07-29
3173051007,JAKARTA BARAT,KEBON JERUK,KEDOYA SELATAN,32165,15472,16693,5612,22305,2021-07-29
3173051006,JAKARTA BARAT,KEBON JERUK,KEDOYA UTARA,45740,21149,24591,8339,32930,2021-07-29
3173051004,JAKARTA BARAT,KEBON JERUK,KELAPA DUA,23565,12269,11296,3953,15249,2021-07-29
3175091003,JAKARTA TIMUR,CIRACAS,KELAPA DUA WETAN,46875,22774,24101,8840,32941,2021-07-29
3172061003,JAKARTA UTARA,KELAPA GADING,KELAPA GADING BARAT,35717,14380,21337,10252,31589,2021-07-29
3172061001,JAKARTA UTARA,KELAPA GADING,KELAPA GADING TIMUR,33592,12374,21218,10777,31995,2021-07-29
3173071005,JAKARTA BARAT,PALMERAH,KEMANGGISAN,32139,16405,15734,6020,21754,2021-07-29
3171031001,JAKARTA PUSAT,KEMAYORAN,KEMAYORAN,20708,9886,10822,3668,14490,2021-07-29
3173081006,JAKARTA BARAT,KEMBANGAN,KEMBANGAN SELATAN,27130,13318,13812,5841,19653,2021-07-29
3173081001,JAKARTA BARAT,KEMBANGAN,KEMBANGAN UTARA,54451,26954,27497,7861,35358,2021-07-29
3171041002,JAKARTA PUSAT,SENEN,KENARI,9579,4409,5170,2051,7221,2021-07-29
3173041005,JAKARTA BARAT,TAMBORA,KERENDANG,19973,10271,9702,2730,12432,2021-07-29
3175071003,JAKARTA TIMUR,DUREN SAWIT,KLENDER,69978,41934,28044,9481,37525,2021-07-29
3172031001,JAKARTA UTARA,KOJA,KOJA,28175,14010,14165,3832,17997,2021-07-29
3173071006,JAKARTA BARAT,PALMERAH,KOTA BAMBU SELATAN,21158,10938,10220,2762,12982,2021-07-29
3173071003,JAKARTA BARAT,PALMERAH,KOTA BAMBU UTARA,24995,13170,11825,3194,15019,2021-07-29
3171041004,JAKARTA PUSAT,SENEN,KRAMAT,28835,15890,12945,3926,16871,2021-07-29
3175041001,JAKARTA TIMUR,KRAMAT JATI,KRAMAT JATI,34144,19035,15109,5905,21014,2021-07-29
3174071003,JAKARTA SELATAN,KEBAYORAN BARU,KRAMAT PELA,14413,6769,7644,2913,10557,2021-07-29
3173031002,JAKARTA BARAT,TAMAN SARI,KRUKUT,19244,9535,9709,2911,12620,2021-07-29
3174031005,JAKARTA SELATAN,MAMPANG PRAPATAN,KUNINGAN BARAT,12785,5950,6835,2102,8937,2021-07-29
3174021008,JAKARTA SELATAN,SETIA BUDI,KUNINGAN TIMUR,6008,3023,2985,1328,4313,2021-07-29
3171041005,JAKARTA PUSAT,SENEN,KWITANG,15486,7851,7635,2713,10348,2021-07-29
3172031003,JAKARTA UTARA,KOJA,LAGOA,59065,31664,27401,7382,34783,2021-07-29
3174061002,JAKARTA SELATAN,CILANDAK,LEBAK BULUS,37626,18764,18862,7856,26718,2021-07-29
3174091004,JAKARTA SELATAN,JAGAKARSA,LENTENG AGUNG,53946,29580,24366,8474,32840,2021-07-29
3175101007,JAKARTA TIMUR,CIPAYUNG,LUBANG BUAYA,63547,32587,30960,12215,43175,2021-07-29
3175081001,JAKARTA TIMUR,MAKASAR,MAKASAR,34390,17396,16994,6549,23543,2021-07-29
3175071006,JAKARTA TIMUR,DUREN SAWIT,MALAKA JAYA,30927,14815,16112,6692,22804,2021-07-29
3175071005,JAKARTA TIMUR,DUREN SAWIT,MALAKA SARI,27530,13047,14483,6437,20920,2021-07-29
3174031001,JAKARTA SELATAN,MAMPANG PRAPATAN,MAMPANG PRAPATAN,18159,9015,9144,3102,12246,2021-07-29
3173031005,JAKARTA BARAT,TAMAN SARI,MANGGA BESAR,7707,3111,4596,1790,6386,2021-07-29
3171021005,JAKARTA PUSAT,SAWAH BESAR,MANGGA DUA SELATAN,27442,13690,13752,4939,18691,2021-07-29
3174011007,JAKARTA SELATAN,TEBET,MANGGARAI,28373,14574,13799,4534,18333,2021-07-29
3174011006,JAKARTA SELATAN,TEBET,MANGGARAI SELATAN,23075,11204,11871,4697,16568,2021-07-29
3173031003,JAKARTA BARAT,TAMAN SARI,MAPHAR,16461,7722,8739,3146,11885,2021-07-29
3172041003,JAKARTA UTARA,CILINCING,MARUNDA,28943,14009,14934,3371,18305,2021-07-29
3174071001,JAKARTA SELATAN,KEBAYORAN BARU,MELAWAI,2627,1045,1582,959,2541,2021-07-29
3171061001,JAKARTA PUSAT,MENTENG,MENTENG,25624,14685,10939,4302,15241,2021-07-29
3174021005,JAKARTA SELATAN,SETIA BUDI,MENTENG ATAS,27816,13377,14439,5142,19581,2021-07-29
3174011003,JAKARTA SELATAN,TEBET,MENTENG DALAM,36028,18672,17356,6941,24297,2021-07-29
3173081003,JAKARTA BARAT,KEMBANGAN,MERUYA SELATAN,32130,17176,14954,5539,20493,2021-07-29
3173081002,JAKARTA BARAT,KEMBANGAN,MERUYA UTARA,43752,22108,21644,8449,30093,2021-07-29
3175101004,JAKARTA TIMUR,CIPAYUNG,MUNJUL,23871,12304,11567,4421,15988,2021-07-29
3172051002,JAKARTA UTARA,PADEMANGAN,PADEMANGAN BARAT,74240,38223,36017,9580,45597,2021-07-29
3172051001,JAKARTA UTARA,PADEMANGAN,PADEMANGAN TIMUR,37736,15755,21981,8133,30114,2021-07-29
3175011004,JAKARTA TIMUR,MATRAMAN,PAL MERIAM,19769,10736,9033,3508,12541,2021-07-29
3173071001,JAKARTA BARAT,PALMERAH,PALMERAH,63011,33181,29830,9707,39537,2021-07-29
3174081001,JAKARTA SELATAN,PANCORAN,PANCORAN,19421,9514,9907,3557,13464,2021-07-29
3172021003,JAKARTA UTARA,TANJUNG PRIOK,PAPANGGO,39097,18527,20570,6118,26688,2021-07-29
3171021001,JAKARTA PUSAT,SAWAH BESAR,PASAR BARU,12035,5004,7031,3124,10155,2021-07-29
3174021006,JAKARTA SELATAN,SETIA BUDI,PASAR MANGGIS,26752,13549,13203,4778,17981,2021-07-29
3174041001,JAKARTA SELATAN,PASAR MINGGU,PASAR MINGGU,24821,12341,12480,5711,18191,2021-07-29
3171041003,JAKARTA PUSAT,SENEN,PASEBAN,23533,11898,11635,4024,15659,2021-07-29
3173061005,JAKARTA BARAT,KALI DERES,PEGADUNGAN,75587,38004,37583,13787,51370,2021-07-29
3171061002,JAKARTA PUSAT,MENTENG,PEGANGSAAN,23455,13266,10189,3548,13737,2021-07-29
3172061002,JAKARTA UTARA,KELAPA GADING,PEGANGSAAN DUA,49976,19177,30799,12527,43326,2021-07-29
3172011004,JAKARTA UTARA,PENJARINGAN,PEJAGALAN,74578,35906,38672,15007,53679,2021-07-29
3174041006,JAKARTA SELATAN,PASAR MINGGU,PEJATEN BARAT,37346,18640,18706,7561,26267,2021-07-29
3174041005,JAKARTA SELATAN,PASAR MINGGU,PEJATEN TIMUR,57656,32840,24816,9392,34208,2021-07-29
3175051005,JAKARTA TIMUR,PASAR REBO,PEKAYON,43250,20781,22469,7787,30256,2021-07-29
3173041009,JAKARTA BARAT,TAMBORA,PEKOJAN,23587,10975,12612,4364,16976,2021-07-29
3174031003,JAKARTA SELATAN,MAMPANG PRAPATAN,PELA MAMPANG,43522,20615,22907,7672,30579,2021-07-29
3174081005,JAKARTA SELATAN,PANCORAN,PENGADEGAN,21478,9166,12312,4229,16541,2021-07-29
3175061003,JAKARTA TIMUR,CAKUNG,PENGGILINGAN,99255,57667,41588,11704,53292,2021-07-29
3172011001,JAKARTA UTARA,PENJARINGAN,PENJARINGAN,88308,49665,38643,11112,49755,2021-07-29
3174101001,JAKARTA SELATAN,PESANGGRAHAN,PESANGGRAHAN,27545,12694,14851,6117,20968,2021-07-29
3171071004,JAKARTA PUSAT,TANAH ABANG,PETAMBURAN,33271,20868,12403,3484,15887,2021-07-29
3174071008,JAKARTA SELATAN,KEBAYORAN BARU,PETOGOGAN,11499,5569,5930,2477,8407,2021-07-29
3171011004,JAKARTA PUSAT,GAMBIR,PETOJO SELATAN,14692,7307,7385,3314,10699,2021-07-29
3171011003,JAKARTA PUSAT,GAMBIR,PETOJO UTARA,17458,9550,7908,3090,10998,2021-07-29
3174101004,JAKARTA SELATAN,PESANGGRAHAN,PETUKANGAN SELATAN,37187,17528,19659,6004,25663,2021-07-29
3174101003,JAKARTA SELATAN,PESANGGRAHAN,PETUKANGAN UTARA,53716,28138,25578,9267,34845,2021-07-29
3175081002,JAKARTA TIMUR,MAKASAR,PINANG RANTI,27198,13623,13575,4912,18487,2021-07-29
3173031008,JAKARTA BARAT,TAMAN SARI,PINANGSIA,10729,4535,6194,2030,8224,2021-07-29
3175011001,JAKARTA TIMUR,MATRAMAN,PISANGAN BARU,31776,18466,13310,4739,18049,2021-07-29
3175021002,JAKARTA TIMUR,PULO GADUNG,PISANGAN TIMUR,41011,21256,19755,6725,26480,2021-07-29
3172011005,JAKARTA UTARA,PENJARINGAN,PLUIT,47783,21207,26576,14801,41377,2021-07-29
3175071002,JAKARTA TIMUR,DUREN SAWIT,PONDOK BAMBU,61550,33657,27893,11103,38996,2021-07-29
3175071004,JAKARTA TIMUR,DUREN SAWIT,PONDOK KELAPA,72015,36175,35840,13170,49010,2021-07-29
3175071007,JAKARTA TIMUR,DUREN SAWIT,PONDOK KOPI,35367,20869,14498,5411,19909,2021-07-29
3174061003,JAKARTA SELATAN,CILANDAK,PONDOK LABU,46464,21347,25117,9563,34680,2021-07-29
3174051002,JAKARTA SELATAN,KEBAYORAN LAMA,PONDOK PINANG,56169,29044,27125,11974,39099,2021-07-29
3175101003,JAKARTA TIMUR,CIPAYUNG,PONDOK RANGGON,25574,14214,11360,4505,15865,2021-07-29
3101011003,KAB.ADM.KEP.SERIBU,KEP. SERIBU UTARA,PULAU HARAPAN,2060,492,1568,692,2260,2021-07-29
3101011002,KAB.ADM.KEP.SERIBU,KEP. SERIBU UTARA,PULAU KELAPA,5528,1244,4284,1354,5638,2021-07-29
3101011001,KAB.ADM.KEP.SERIBU,KEP. SERIBU UTARA,PULAU PANGGANG,5450,1121,4329,1262,5591,2021-07-29
3101021003,KAB.ADM.KEP.SERIBU,KEP. SERIBU SELATAN,PULAU PARI,2765,419,2346,682,3028,2021-07-29
3101021002,KAB.ADM.KEP.SERIBU,KEP. SERIBU SELATAN,PULAU TIDUNG,4553,918,3635,1458,5093,2021-07-29
3101021001,KAB.ADM.KEP.SERIBU,KEP. SERIBU SELATAN,PULAU UNTUNG JAWA,1941,463,1478,613,2091,2021-07-29
3174071007,JAKARTA SELATAN,KEBAYORAN BARU,PULO,5835,2446,3389,1665,5054,2021-07-29
3175021001,JAKARTA TIMUR,PULO GADUNG,PULO GADUNG,34422,18798,15624,5864,21488,2021-07-29
3175061005,JAKARTA TIMUR,CAKUNG,PULO GEBANG,97301,52208,45093,12854,57947,2021-07-29
3174041004,JAKARTA SELATAN,PASAR MINGGU,RAGUNAN,39616,18486,21130,7880,29010,2021-07-29
3175091005,JAKARTA TIMUR,CIRACAS,RAMBUTAN,36771,21362,15409,5274,20683,2021-07-29
3172031006,JAKARTA UTARA,KOJA,RAWA BADAK SELATAN,42179,23207,18972,5019,23991,2021-07-29
3172031004,JAKARTA UTARA,KOJA,RAWA BADAK UTARA,34408,17771,16637,5064,21701,2021-07-29
3174071005,JAKARTA SELATAN,KEBAYORAN BARU,RAWA BARAT,5625,2560,3065,1586,4651,2021-07-29
3173011003,JAKARTA BARAT,CENGKARENG,RAWA BUAYA,63799,34303,29496,8236,37732,2021-07-29
3175031004,JAKARTA TIMUR,JATINEGARA,RAWA BUNGA,21434,12169,9265,2959,12224,2021-07-29
3174081003,JAKARTA SELATAN,PANCORAN,RAWA JATI,20509,9483,11026,4203,15229,2021-07-29
3175061002,JAKARTA TIMUR,CAKUNG,RAWA TERATE,24637,11522,13115,2640,15755,2021-07-29
3175021005,JAKARTA TIMUR,PULO GADUNG,RAWAMANGUN,37612,19421,18191,6987,25178,2021-07-29
3171051003,JAKARTA PUSAT,CEMPAKA PUTIH,RAWASARI,21967,10940,11027,4343,15370,2021-07-29
3173041010,JAKARTA BARAT,TAMBORA,ROA MALAKA,3484,1383,2101,1035,3136,2021-07-29
3172041006,JAKARTA UTARA,CILINCING,ROROTAN,41668,19766,21902,5989,27891,2021-07-29
3174071004,JAKARTA SELATAN,KEBAYORAN BARU,SELONG,2842,1187,1655,996,2651,2021-07-29
3173061002,JAKARTA BARAT,KALI DERES,SEMANAN,71354,39350,32004,6709,38713,2021-07-29
3172041007,JAKARTA UTARA,CILINCING,SEMPER BARAT,68587,30961,37626,11316,48942,2021-07-29
3172041005,JAKARTA UTARA,CILINCING,SEMPER TIMUR,36267,17832,18435,5855,24290,2021-07-29
3174071006,JAKARTA SELATAN,KEBAYORAN BARU,SENAYAN,2771,1493,1278,677,1955,2021-07-29
3171041001,JAKARTA PUSAT,SENEN,SENEN,6804,3211,3593,1385,4978,2021-07-29
3171031004,JAKARTA PUSAT,KEMAYORAN,SERDANG,29668,15191,14477,5058,19535,2021-07-29
3174021001,JAKARTA SELATAN,SETIA BUDI,SETIA BUDI,3023,1480,1543,750,2293,2021-07-29
3175101005,JAKARTA TIMUR,CIPAYUNG,SETU,20572,11955,8617,3197,11814,2021-07-29
3173071002,JAKARTA BARAT,PALMERAH,SLIPI,16591,7851,8740,3159,11899,2021-07-29
3173081004,JAKARTA BARAT,KEMBANGAN,SRENGSENG,45523,24798,20725,7536,28261,2021-07-29
3174091002,JAKARTA SELATAN,JAGAKARSA,SRENGSENG SAWAH,58196,25986,32210,12254,44464,2021-07-29
3173051003,JAKARTA BARAT,KEBON JERUK,SUKABUMI SELATAN,37033,21516,15517,4545,20062,2021-07-29
3173051002,JAKARTA BARAT,KEBON JERUK,SUKABUMI UTARA,38290,23075,15215,4960,20175,2021-07-29
3172041002,JAKARTA UTARA,CILINCING,SUKAPURA,53949,26979,26970,6777,33747,2021-07-29
3171031007,JAKARTA PUSAT,KEMAYORAN,SUMUR BATU,22717,11477,11240,4539,15779,2021-07-29
3172021004,JAKARTA UTARA,TANJUNG PRIOK,SUNGAI BAMBU,29876,14412,15464,5086,20550,2021-07-29
3172021006,JAKARTA UTARA,TANJUNG PRIOK,SUNTER AGUNG,71805,29805,42000,16303,58303,2021-07-29
3172021002,JAKARTA UTARA,TANJUNG PRIOK,SUNTER JAYA,63031,28675,34356,13387,47743,2021-07-29
3175091004,JAKARTA TIMUR,CIRACAS,SUSUKAN,38257,19898,18359,6276,24635,2021-07-29
3173031001,JAKARTA BARAT,TAMAN SARI,TAMAN SARI,14348,6599,7749,2999,10748,2021-07-29
3173041001,JAKARTA BARAT,TAMBORA,TAMBORA,10204,5453,4751,1958,6709,2021-07-29
3173041004,JAKARTA BARAT,TAMBORA,TANAH SEREAL,26387,11710,14677,4739,19416,2021-07-29
3171081004,JAKARTA PUSAT,JOHAR BARU,TANAH TINGGI,37693,17101,20592,5605,26197,2021-07-29
3173031004,JAKARTA BARAT,TAMAN SARI,TANGKI,13324,6066,7258,2448,9706,2021-07-29
3174091005,JAKARTA SELATAN,JAGAKARSA,TANJUNG BARAT,39770,20879,18891,7267,26158,2021-07-29
3173021005,JAKARTA BARAT,GROGOL PETAMBURAN,TANJUNG DUREN SELATAN,25337,11245,14092,5478,19570,2021-07-29
3173021002,JAKARTA BARAT,GROGOL PETAMBURAN,TANJUNG DUREN UTARA,17010,7084,9926,4283,14209,2021-07-29
3172021001,JAKARTA UTARA,TANJUNG PRIOK,TANJUNG PRIOK,34588,15784,18804,4626,23430,2021-07-29
3174011002,JAKARTA SELATAN,TEBET,TEBET BARAT,21194,9484,11710,5200,16910,2021-07-29
3174011001,JAKARTA SELATAN,TEBET,TEBET TIMUR,18199,7776,10423,4626,15049,2021-07-29
3173061003,JAKARTA BARAT,KALI DERES,TEGAL ALUR,83647,44667,38980,9695,48675,2021-07-29
3174031004,JAKARTA SELATAN,MAMPANG PRAPATAN,TEGAL PARANG,32401,17590,14811,4606,19417,2021-07-29
3173021003,JAKARTA BARAT,GROGOL PETAMBURAN,TOMANG,29605,13793,15812,6180,21992,2021-07-29
3172031005,JAKARTA UTARA,KOJA,TUGU SELATAN,39122,20865,18257,4888,23145,2021-07-29
3172031002,JAKARTA UTARA,KOJA,TUGU UTARA,67670,36621,31049,8473,39522,2021-07-29
3175061006,JAKARTA TIMUR,CAKUNG,UJUNG MENTENG,29934,14234,15700,5025,20725,2021-07-29
3174101005,JAKARTA SELATAN,PESANGGRAHAN,ULUJAMI,40544,22167,18377,6467,24844,2021-07-29
3175011006,JAKARTA TIMUR,MATRAMAN,UTAN KAYU SELATAN,33511,16987,16524,6357,22881,2021-07-29
3175011002,JAKARTA TIMUR,MATRAMAN,UTAN KAYU UTARA,28169,14732,13437,4977,18414,2021-07-29
3171031008,JAKARTA PUSAT,KEMAYORAN,UTAN PANJANG,29208,16141,13067,3786,16853,2021-07-29
3172021007,JAKARTA UTARA,TANJUNG PRIOK,WARAKAS,44401,21727,22674,7086,29760,2021-07-29
3173021007,JAKARTA BARAT,GROGOL PETAMBURAN,WIJAYA KUSUMA,38934,20031,18903,6196,25099,2021-07-29
3172051003,JAKARTA UTARA,PADEMANGAN,ANCOL,23947,12466,11481,4005,15486,2021-07-30
3173041007,JAKARTA BARAT,TAMBORA,ANGKE,29381,14076,15305,4494,19799,2021-07-30
3175041005,JAKARTA TIMUR,KRAMAT JATI,BALE KAMBANG,29074,18484,10590,3469,14059,2021-07-30
3175031003,JAKARTA TIMUR,JATINEGARA,BALI MESTER,9752,5269,4483,1935,6418,2021-07-30
3175101006,JAKARTA TIMUR,CIPAYUNG,BAMBU APUS,26285,14121,12164,5030,17194,2021-07-30
3174031002,JAKARTA SELATAN,MAMPANG PRAPATAN,BANGKA,21566,10546,11020,3893,14913,2021-07-30
3175051002,JAKARTA TIMUR,PASAR REBO,BARU,23886,10209,13677,5956,19633,2021-07-30
3175041004,JAKARTA TIMUR,KRAMAT JATI,BATU AMPAR,47898,29145,18753,6973,25726,2021-07-30
3171071002,JAKARTA PUSAT,TANAH ABANG,BENDUNGAN HILIR,21494,10099,11395,4440,15835,2021-07-30
3175031002,JAKARTA TIMUR,JATINEGARA,BIDARA CINA,36689,22116,14573,5214,19787,2021-07-30
3174101002,JAKARTA SELATAN,PESANGGRAHAN,BINTARO,53098,26552,26546,9504,36050,2021-07-30
3174011005,JAKARTA SELATAN,TEBET,BUKIT DURI,34183,18375,15808,5916,21724,2021-07-30
3171041006,JAKARTA PUSAT,SENEN,BUNGUR,18144,8762,9382,3614,12996,2021-07-30
3175061007,JAKARTA TIMUR,CAKUNG,CAKUNG BARAT,57724,26572,31152,6893,38045,2021-07-30
3175061004,JAKARTA TIMUR,CAKUNG,CAKUNG TIMUR,58287,27952,30335,9749,40084,2021-07-30
3175041007,JAKARTA TIMUR,KRAMAT JATI,CAWANG,32762,18195,14567,5625,20192,2021-07-30
3175101008,JAKARTA TIMUR,CIPAYUNG,CEGER,18932,9826,9106,3309,12415,2021-07-30
3171031006,JAKARTA PUSAT,KEMAYORAN,CEMPAKA BARU,32581,17708,14873,5319,20192,2021-07-30
3171051002,JAKARTA PUSAT,CEMPAKA PUTIH,CEMPAKA PUTIH BARAT,35885,18266,17619,6328,23947,2021-07-30
3171051001,JAKARTA PUSAT,CEMPAKA PUTIH,CEMPAKA PUTIH TIMUR,24292,11890,12402,5549,17951,2021-07-30
3173011001,JAKARTA BARAT,CENGKARENG,CENGKARENG BARAT,66284,31785,34499,12223,46722,2021-07-30
3173011006,JAKARTA BARAT,CENGKARENG,CENGKARENG TIMUR,81027,42591,38436,13252,51688,2021-07-30
3175091002,JAKARTA TIMUR,CIRACAS,CIBUBUR,66364,31283,35081,13153,48234,2021-07-30
3171011002,JAKARTA PUSAT,GAMBIR,CIDENG,15390,6954,8436,3764,12200,2021-07-30
3174091003,JAKARTA SELATAN,JAGAKARSA,CIGANJUR,38497,18809,19688,7372,27060,2021-07-30
3175051003,JAKARTA TIMUR,PASAR REBO,CIJANTUNG,41419,20256,21163,8496,29659,2021-07-30
3171061003,JAKARTA PUSAT,MENTENG,CIKINI,8274,4436,3838,1776,5614,2021-07-30
3174081006,JAKARTA SELATAN,PANCORAN,CIKOKO,10547,4478,6069,2176,8245,2021-07-30
3174061001,JAKARTA SELATAN,CILANDAK,CILANDAK BARAT,51752,23696,28056,11240,39296,2021-07-30
3174041003,JAKARTA SELATAN,PASAR MINGGU,CILANDAK TIMUR,25145,11731,13414,6296,19710,2021-07-30
3175101002,JAKARTA TIMUR,CIPAYUNG,CILANGKAP,27635,14288,13347,4949,18296,2021-07-30
3175041006,JAKARTA TIMUR,KRAMAT JATI,CILILITAN,40181,23024,17157,6897,24054,2021-07-30
3172041001,JAKARTA UTARA,CILINCING,CILINCING,43609,23249,20360,5581,25941,2021-07-30
3175101001,JAKARTA TIMUR,CIPAYUNG,CIPAYUNG,26104,12502,13602,5320,18922,2021-07-30
3174091006,JAKARTA SELATAN,JAGAKARSA,CIPEDAK,38303,17272,21031,7425,28456,2021-07-30
3174061005,JAKARTA SELATAN,CILANDAK,CIPETE SELATAN,26704,12855,13849,5542,19391,2021-07-30
3174071010,JAKARTA SELATAN,KEBAYORAN BARU,CIPETE UTARA,34102,16297,17805,5922,23727,2021-07-30
3175021003,JAKARTA TIMUR,PULO GADUNG,CIPINANG,39306,20475,18831,7677,26508,2021-07-30
3175031007,JAKARTA TIMUR,JATINEGARA,CIPINANG BESAR SELATAN,35212,20876,14336,4984,19320,2021-07-30
3175031008,JAKARTA TIMUR,JATINEGARA,CIPINANG BESAR UTARA,45319,27310,18009,5353,23362,2021-07-30
3175031005,JAKARTA TIMUR,JATINEGARA,CIPINANG CEMPEDAK,32824,18490,14334,5829,20163,2021-07-30
3175081005,JAKARTA TIMUR,MAKASAR,CIPINANG MELAYU,42308,21336,20972,8526,29498,2021-07-30
3175031006,JAKARTA TIMUR,JATINEGARA,CIPINANG MUARA,55243,32155,23088,9150,32238,2021-07-30
3174051003,JAKARTA SELATAN,KEBAYORAN LAMA,CIPULIR,39937,21726,18211,6695,24906,2021-07-30
3175091001,JAKARTA TIMUR,CIRACAS,CIRACAS,64594,31067,33527,11477,45004,2021-07-30
3175041003,JAKARTA TIMUR,KRAMAT JATI,DUKUH,24609,13283,11326,4454,15780,2021-07-30
3175071001,JAKARTA TIMUR,DUREN SAWIT,DUREN SAWIT,61160,33924,27236,12036,39272,2021-07-30
3174081004,JAKARTA SELATAN,PANCORAN,DUREN TIGA,28319,13318,15001,5105,20106,2021-07-30
3173051005,JAKARTA BARAT,KEBON JERUK,DURI KEPA,60138,27133,33005,12755,45760,2021-07-30
3173011002,JAKARTA BARAT,CENGKARENG,DURI KOSAMBI,77923,41810,36113,12061,48174,2021-07-30
3171011006,JAKARTA PUSAT,GAMBIR,DURI PULO,19610,10070,9540,3019,12559,2021-07-30
3173041011,JAKARTA BARAT,TAMBORA,DURI SELATAN,14259,6307,7952,2840,10792,2021-07-30
3173041003,JAKARTA BARAT,TAMBORA,DURI UTARA,19844,9378,10466,3317,13783,2021-07-30
3171081003,JAKARTA PUSAT,JOHAR BARU,GALUR,18243,7919,10324,2802,13126,2021-07-30
3171011001,JAKARTA PUSAT,GAMBIR,GAMBIR,2191,974,1217,599,1816,2021-07-30
3174061004,JAKARTA SELATAN,CILANDAK,GANDARIA SELATAN,22119,10994,11125,4356,15481,2021-07-30
3174071009,JAKARTA SELATAN,KEBAYORAN BARU,GANDARIA UTARA,39922,19772,20150,7321,27471,2021-07-30
3175051001,JAKARTA TIMUR,PASAR REBO,GEDONG,35755,18222,17533,6941,24474,2021-07-30
3171071001,JAKARTA PUSAT,TANAH ABANG,GELORA,3127,1509,1618,676,2294,2021-07-30
3173031007,JAKARTA BARAT,TAMAN SARI,GLODOK,7837,3020,4817,2496,7313,2021-07-30
3171061004,JAKARTA PUSAT,MENTENG,GONDANGDIA,4100,1781,2319,1478,3797,2021-07-30
3173021001,JAKARTA BARAT,GROGOL PETAMBURAN,GROGOL,16876,8216,8660,3416,12076,2021-07-30
3174051005,JAKARTA SELATAN,KEBAYORAN LAMA,GROGOL SELATAN,44251,23580,20671,7382,28053,2021-07-30
3174051004,JAKARTA SELATAN,KEBAYORAN LAMA,GROGOL UTARA,42494,22341,20153,7510,27663,2021-07-30
3174021007,JAKARTA SELATAN,SETIA BUDI,GUNTUR,3985,1737,2248,1162,3410,2021-07-30
3174071002,JAKARTA SELATAN,KEBAYORAN BARU,GUNUNG,9436,4277,5159,2579,7738,2021-07-30
3171031005,JAKARTA PUSAT,KEMAYORAN,GUNUNG SAHARI SELATAN,19199,9377,9822,3939,13761,2021-07-30
3171021004,JAKARTA PUSAT,SAWAH BESAR,GUNUNG SAHARI UTARA,16650,6969,9681,4191,13872,2021-07-30
3175081004,JAKARTA TIMUR,MAKASAR,HALIM PERDANA KUSUMAH,28363,10049,18314,10781,29095,2021-07-30
3171031003,JAKARTA PUSAT,KEMAYORAN,HARAPAN MULIA,22557,11598,10959,3751,14710,2021-07-30
3174091001,JAKARTA SELATAN,JAGAKARSA,JAGAKARSA,62389,28767,33622,13120,46742,2021-07-30
3175021007,JAKARTA TIMUR,PULO GADUNG,JATI,32757,17093,15664,6963,22627,2021-07-30
3174041002,JAKARTA SELATAN,PASAR MINGGU,JATI PADANG,37502,18422,19080,8013,27093,2021-07-30
3173071004,JAKARTA BARAT,PALMERAH,JATI PULO,28738,12910,15828,4480,20308,2021-07-30
3175061001,JAKARTA TIMUR,CAKUNG,JATINEGARA,84160,46646,37514,10038,47552,2021-07-30
3175021004,JAKARTA TIMUR,PULO GADUNG,JATINEGARA KAUM,24632,12902,11730,3805,15535,2021-07-30
3173021004,JAKARTA BARAT,GROGOL PETAMBURAN,JELAMBAR,30266,14056,16210,7251,23461,2021-07-30
3173021006,JAKARTA BARAT,GROGOL PETAMBURAN,JELAMBAR BARU,38246,18226,20020,8319,28339,2021-07-30
3173041006,JAKARTA BARAT,TAMBORA,JEMBATAN BESI,29314,17746,11568,3265,14833,2021-07-30
3173041008,JAKARTA BARAT,TAMBORA,JEMBATAN LIMA,21021,11897,9124,3126,12250,2021-07-30
3173081005,JAKARTA BARAT,KEMBANGAN,JOGLO,40839,21035,19804,7759,27563,2021-07-30
3171081001,JAKARTA PUSAT,JOHAR BARU,JOHAR BARU,37488,16869,20619,7078,27697,2021-07-30
3173041002,JAKARTA BARAT,TAMBORA,KALI ANYAR,23856,12987,10869,2855,13724,2021-07-30
3172041004,JAKARTA UTARA,CILINCING,KALIBARU,67684,38603,29081,6336,35417,2021-07-30
3174081002,JAKARTA SELATAN,PANCORAN,KALIBATA,41994,22979,19015,6774,25789,2021-07-30
3173061001,JAKARTA BARAT,KALI DERES,KALIDERES,72447,36809,35638,11200,46838,2021-07-30
3175051004,JAKARTA TIMUR,PASAR REBO,KALISARI,43212,21276,21936,9040,30976,2021-07-30
3173061004,JAKARTA BARAT,KALI DERES,KAMAL,53783,30968,22815,5099,27914,2021-07-30
3172011002,JAKARTA UTARA,PENJARINGAN,KAMAL MUARA,12930,4557,8373,3640,12013,2021-07-30
3171071007,JAKARTA PUSAT,TANAH ABANG,KAMPUNG BALI,11358,6472,4886,1802,6688,2021-07-30
3175031001,JAKARTA TIMUR,JATINEGARA,KAMPUNG MELAYU,25717,15251,10466,2987,13453,2021-07-30
3171081002,JAKARTA PUSAT,JOHAR BARU,KAMPUNG RAWA,21237,8274,12963,3516,16479,2021-07-30
3175041002,JAKARTA TIMUR,KRAMAT JATI,KAMPUNG TENGAH,43993,26645,17348,6578,23926,2021-07-30
3173011005,JAKARTA BARAT,CENGKARENG,KAPUK,134466,75359,59107,15146,74253,2021-07-30
3172011003,JAKARTA UTARA,PENJARINGAN,KAPUK MUARA,35781,15148,20633,8940,29573,2021-07-30
3171021002,JAKARTA PUSAT,SAWAH BESAR,KARANG ANYAR,25761,12483,13278,4413,17691,2021-07-30
3174021004,JAKARTA SELATAN,SETIA BUDI,KARET,9623,4728,4895,1982,6877,2021-07-30
3174021003,JAKARTA SELATAN,SETIA BUDI,KARET KUNINGAN,16055,7161,8894,3236,12130,2021-07-30
3174021002,JAKARTA SELATAN,SETIA BUDI,KARET SEMANGGI,2770,1156,1614,812,2426,2021-07-30
3171071003,JAKARTA PUSAT,TANAH ABANG,KARET TENGSIN,19271,9246,10025,2962,12987,2021-07-30
3171021003,JAKARTA PUSAT,SAWAH BESAR,KARTINI,22292,10419,11873,4558,16431,2021-07-30
3175011003,JAKARTA TIMUR,MATRAMAN,KAYU MANIS,25284,14184,11100,3944,15044,2021-07-30
3175021006,JAKARTA TIMUR,PULO GADUNG,KAYU PUTIH,40696,19153,21543,9440,30983,2021-07-30
3173031006,JAKARTA BARAT,TAMAN SARI,KEAGUNGAN,17387,8163,9224,2973,12197,2021-07-30
3174041007,JAKARTA SELATAN,PASAR MINGGU,KEBAGUSAN,44552,23383,21169,8006,29175,2021-07-30
3174051006,JAKARTA SELATAN,KEBAYORAN LAMA,KEBAYORAN LAMA SELATAN,41212,19869,21343,7613,28956,2021-07-30
3174051001,JAKARTA SELATAN,KEBAYORAN LAMA,KEBAYORAN LAMA UTARA,42422,22758,19664,7033,26697,2021-07-30
3174011004,JAKARTA SELATAN,TEBET,KEBON BARU,35165,17448,17717,6932,24649,2021-07-30
3172021005,JAKARTA UTARA,TANJUNG PRIOK,KEBON BAWANG,50952,24701,26251,9259,35510,2021-07-30
3173051001,JAKARTA BARAT,KEBON JERUK,KEBON JERUK,53887,29328,24559,8740,33299,2021-07-30
3171071006,JAKARTA PUSAT,TANAH ABANG,KEBON KACANG,21531,12581,8950,3207,12157,2021-07-30
3171011005,JAKARTA PUSAT,GAMBIR,KEBON KELAPA,10163,4896,5267,2026,7293,2021-07-30
3171031002,JAKARTA PUSAT,KEMAYORAN,KEBON KOSONG,30019,15008,15011,4853,19864,2021-07-30
3175011005,JAKARTA TIMUR,MATRAMAN,KEBON MANGGIS,16490,8223,8267,3587,11854,2021-07-30
3171071005,JAKARTA PUSAT,TANAH ABANG,KEBON MELATI,32206,20018,12188,3553,15741,2021-07-30
3175081003,JAKARTA TIMUR,MAKASAR,KEBON PALA,46614,24575,22039,8065,30104,2021-07-30
3171061005,JAKARTA PUSAT,MENTENG,KEBON SIRIH,12299,6752,5547,2002,7549,2021-07-30
3173011004,JAKARTA BARAT,CENGKARENG,KEDAUNG KALI ANGKE,32612,13857,18755,4599,23354,2021-07-30
3173051007,JAKARTA BARAT,KEBON JERUK,KEDOYA SELATAN,32165,15079,17086,5839,22925,2021-07-30
3173051006,JAKARTA BARAT,KEBON JERUK,KEDOYA UTARA,45740,20649,25091,8719,33810,2021-07-30
3173051004,JAKARTA BARAT,KEBON JERUK,KELAPA DUA,23565,12027,11538,4121,15659,2021-07-30
3175091003,JAKARTA TIMUR,CIRACAS,KELAPA DUA WETAN,46875,22457,24418,9186,33604,2021-07-30
3172061003,JAKARTA UTARA,KELAPA GADING,KELAPA GADING BARAT,35717,14269,21448,10521,31969,2021-07-30
3172061001,JAKARTA UTARA,KELAPA GADING,KELAPA GADING TIMUR,33592,12274,21318,11150,32468,2021-07-30
3173071005,JAKARTA BARAT,PALMERAH,KEMANGGISAN,32139,16198,15941,6202,22143,2021-07-30
3171031001,JAKARTA PUSAT,KEMAYORAN,KEMAYORAN,20708,9704,11004,3851,14855,2021-07-30
3173081006,JAKARTA BARAT,KEMBANGAN,KEMBANGAN SELATAN,27130,13170,13960,6012,19972,2021-07-30
3173081001,JAKARTA BARAT,KEMBANGAN,KEMBANGAN UTARA,54451,26683,27768,8102,35870,2021-07-30
3171041002,JAKARTA PUSAT,SENEN,KENARI,9579,4294,5285,2095,7380,2021-07-30
3173041005,JAKARTA BARAT,TAMBORA,KERENDANG,19973,10124,9849,2893,12742,2021-07-30
3175071003,JAKARTA TIMUR,DUREN SAWIT,KLENDER,69978,41490,28488,10047,38535,2021-07-30
3172031001,JAKARTA UTARA,KOJA,KOJA,28175,13864,14311,4079,18390,2021-07-30
3173071006,JAKARTA BARAT,PALMERAH,KOTA BAMBU SELATAN,21158,10784,10374,2935,13309,2021-07-30
3173071003,JAKARTA BARAT,PALMERAH,KOTA BAMBU UTARA,24995,12897,12098,3356,15454,2021-07-30
3171041004,JAKARTA PUSAT,SENEN,KRAMAT,28835,15583,13252,4170,17422,2021-07-30
3175041001,JAKARTA TIMUR,KRAMAT JATI,KRAMAT JATI,34144,18780,15364,6110,21474,2021-07-30
3174071003,JAKARTA SELATAN,KEBAYORAN BARU,KRAMAT PELA,14413,6708,7705,3046,10751,2021-07-30
3173031002,JAKARTA BARAT,TAMAN SARI,KRUKUT,19244,9362,9882,3031,12913,2021-07-30
3174031005,JAKARTA SELATAN,MAMPANG PRAPATAN,KUNINGAN BARAT,12785,5919,6866,2254,9120,2021-07-30
3174021008,JAKARTA SELATAN,SETIA BUDI,KUNINGAN TIMUR,6008,2991,3017,1351,4368,2021-07-30
3171041005,JAKARTA PUSAT,SENEN,KWITANG,15486,7752,7734,2812,10546,2021-07-30
3172031003,JAKARTA UTARA,KOJA,LAGOA,59065,31250,27815,7941,35756,2021-07-30
3174061002,JAKARTA SELATAN,CILANDAK,LEBAK BULUS,37626,18574,19052,8179,27231,2021-07-30
3174091004,JAKARTA SELATAN,JAGAKARSA,LENTENG AGUNG,53946,29032,24914,8822,33736,2021-07-30
3175101007,JAKARTA TIMUR,CIPAYUNG,LUBANG BUAYA,63547,32041,31506,12907,44413,2021-07-30
3175081001,JAKARTA TIMUR,MAKASAR,MAKASAR,34390,17136,17254,6944,24198,2021-07-30
3175071006,JAKARTA TIMUR,DUREN SAWIT,MALAKA JAYA,30927,14679,16248,6949,23197,2021-07-30
3175071005,JAKARTA TIMUR,DUREN SAWIT,MALAKA SARI,27530,12843,14687,6663,21350,2021-07-30
3174031001,JAKARTA SELATAN,MAMPANG PRAPATAN,MAMPANG PRAPATAN,18159,8946,9213,3271,12484,2021-07-30
3173031005,JAKARTA BARAT,TAMAN SARI,MANGGA BESAR,7707,3081,4626,1960,6586,2021-07-30
3171021005,JAKARTA PUSAT,SAWAH BESAR,MANGGA DUA SELATAN,27442,13487,13955,5203,19158,2021-07-30
3174011007,JAKARTA SELATAN,TEBET,MANGGARAI,28373,14255,14118,4728,18846,2021-07-30
3174011006,JAKARTA SELATAN,TEBET,MANGGARAI SELATAN,23075,11040,12035,4955,16990,2021-07-30
3173031003,JAKARTA BARAT,TAMAN SARI,MAPHAR,16461,7605,8856,3391,12247,2021-07-30
3172041003,JAKARTA UTARA,CILINCING,MARUNDA,28943,13868,15075,3577,18652,2021-07-30
3174071001,JAKARTA SELATAN,KEBAYORAN BARU,MELAWAI,2627,1042,1585,975,2560,2021-07-30
3171061001,JAKARTA PUSAT,MENTENG,MENTENG,25624,14441,11183,4451,15634,2021-07-30
3174021005,JAKARTA SELATAN,SETIA BUDI,MENTENG ATAS,27816,13166,14650,5344,19994,2021-07-30
3174011003,JAKARTA SELATAN,TEBET,MENTENG DALAM,36028,18408,17620,7249,24869,2021-07-30
3173081003,JAKARTA BARAT,KEMBANGAN,MERUYA SELATAN,32130,17006,15124,5815,20939,2021-07-30
3173081002,JAKARTA BARAT,KEMBANGAN,MERUYA UTARA,43752,21919,21833,8751,30584,2021-07-30
3175101004,JAKARTA TIMUR,CIPAYUNG,MUNJUL,23871,12034,11837,4574,16411,2021-07-30
3172051002,JAKARTA UTARA,PADEMANGAN,PADEMANGAN BARAT,74240,37439,36801,10293,47094,2021-07-30
3172051001,JAKARTA UTARA,PADEMANGAN,PADEMANGAN TIMUR,37736,15559,22177,8464,30641,2021-07-30
3175011004,JAKARTA TIMUR,MATRAMAN,PAL MERIAM,19769,10624,9145,3643,12788,2021-07-30
3173071001,JAKARTA BARAT,PALMERAH,PALMERAH,63011,32657,30354,10195,40549,2021-07-30
3174081001,JAKARTA SELATAN,PANCORAN,PANCORAN,19421,9358,10063,3676,13739,2021-07-30
3172021003,JAKARTA UTARA,TANJUNG PRIOK,PAPANGGO,39097,18186,20911,6527,27438,2021-07-30
3171021001,JAKARTA PUSAT,SAWAH BESAR,PASAR BARU,12035,4933,7102,3257,10359,2021-07-30
3174021006,JAKARTA SELATAN,SETIA BUDI,PASAR MANGGIS,26752,13404,13348,5059,18407,2021-07-30
3174041001,JAKARTA SELATAN,PASAR MINGGU,PASAR MINGGU,24821,12165,12656,5907,18563,2021-07-30
3171041003,JAKARTA PUSAT,SENEN,PASEBAN,23533,11735,11798,4173,15971,2021-07-30
3173061005,JAKARTA BARAT,KALI DERES,PEGADUNGAN,75587,37224,38363,14566,52929,2021-07-30
3171061002,JAKARTA PUSAT,MENTENG,PEGANGSAAN,23455,13126,10329,3696,14025,2021-07-30
3172061002,JAKARTA UTARA,KELAPA GADING,PEGANGSAAN DUA,49976,18918,31058,13028,44086,2021-07-30
3172011004,JAKARTA UTARA,PENJARINGAN,PEJAGALAN,74578,35560,39018,15729,54747,2021-07-30
3174041006,JAKARTA SELATAN,PASAR MINGGU,PEJATEN BARAT,37346,18438,18908,7941,26849,2021-07-30
3174041005,JAKARTA SELATAN,PASAR MINGGU,PEJATEN TIMUR,57656,32293,25363,9828,35191,2021-07-30
3175051005,JAKARTA TIMUR,PASAR REBO,PEKAYON,43250,20410,22840,8115,30955,2021-07-30
3173041009,JAKARTA BARAT,TAMBORA,PEKOJAN,23587,10874,12713,4629,17342,2021-07-30
3174031003,JAKARTA SELATAN,MAMPANG PRAPATAN,PELA MAMPANG,43522,20300,23222,8054,31276,2021-07-30
3174081005,JAKARTA SELATAN,PANCORAN,PENGADEGAN,21478,9065,12413,4398,16811,2021-07-30
3175061003,JAKARTA TIMUR,CAKUNG,PENGGILINGAN,99255,57072,42183,12149,54332,2021-07-30
3172011001,JAKARTA UTARA,PENJARINGAN,PENJARINGAN,88308,48994,39314,12164,51478,2021-07-30
3174101001,JAKARTA SELATAN,PESANGGRAHAN,PESANGGRAHAN,27545,12506,15039,6395,21434,2021-07-30
3171071004,JAKARTA PUSAT,TANAH ABANG,PETAMBURAN,33271,20646,12625,3657,16282,2021-07-30
3174071008,JAKARTA SELATAN,KEBAYORAN BARU,PETOGOGAN,11499,5534,5965,2598,8563,2021-07-30
3171011004,JAKARTA PUSAT,GAMBIR,PETOJO SELATAN,14692,7221,7471,3386,10857,2021-07-30
3171011003,JAKARTA PUSAT,GAMBIR,PETOJO UTARA,17458,9415,8043,3163,11206,2021-07-30
3174101004,JAKARTA SELATAN,PESANGGRAHAN,PETUKANGAN SELATAN,37187,17383,19804,6230,26034,2021-07-30
3174101003,JAKARTA SELATAN,PESANGGRAHAN,PETUKANGAN UTARA,53716,27801,25915,9863,35778,2021-07-30
3175081002,JAKARTA TIMUR,MAKASAR,PINANG RANTI,27198,13386,13812,5158,18970,2021-07-30
3173031008,JAKARTA BARAT,TAMAN SARI,PINANGSIA,10729,4486,6243,2108,8351,2021-07-30
3175011001,JAKARTA TIMUR,MATRAMAN,PISANGAN BARU,31776,18050,13726,4957,18683,2021-07-30
3175021002,JAKARTA TIMUR,PULO GADUNG,PISANGAN TIMUR,41011,20803,20208,7031,27239,2021-07-30
3172011005,JAKARTA UTARA,PENJARINGAN,PLUIT,47783,21106,26677,15154,41831,2021-07-30
3175071002,JAKARTA TIMUR,DUREN SAWIT,PONDOK BAMBU,61550,33127,28423,11556,39979,2021-07-30
3175071004,JAKARTA TIMUR,DUREN SAWIT,PONDOK KELAPA,72015,35637,36378,13728,50106,2021-07-30
3175071007,JAKARTA TIMUR,DUREN SAWIT,PONDOK KOPI,35367,20550,14817,5592,20409,2021-07-30
3174061003,JAKARTA SELATAN,CILANDAK,PONDOK LABU,46464,21136,25328,10080,35408,2021-07-30
3174051002,JAKARTA SELATAN,KEBAYORAN LAMA,PONDOK PINANG,56169,28703,27466,12232,39698,2021-07-30
3175101003,JAKARTA TIMUR,CIPAYUNG,PONDOK RANGGON,25574,14028,11546,4673,16219,2021-07-30
3101011003,KAB.ADM.KEP.SERIBU,KEP. SERIBU UTARA,PULAU HARAPAN,2060,488,1572,696,2268,2021-07-30
3101011002,KAB.ADM.KEP.SERIBU,KEP. SERIBU UTARA,PULAU KELAPA,5528,1236,4292,1364,5656,2021-07-30
3101011001,KAB.ADM.KEP.SERIBU,KEP. SERIBU UTARA,PULAU PANGGANG,5450,1104,4346,1273,5619,2021-07-30
3101021003,KAB.ADM.KEP.SERIBU,KEP. SERIBU SELATAN,PULAU PARI,2765,419,2346,692,3038,2021-07-30
3101021002,KAB.ADM.KEP.SERIBU,KEP. SERIBU SELATAN,PULAU TIDUNG,4553,908,3645,1495,5140,2021-07-30
3101021001,KAB.ADM.KEP.SERIBU,KEP. SERIBU SELATAN,PULAU UNTUNG JAWA,1941,453,1488,631,2119,2021-07-30
3174071007,JAKARTA SELATAN,KEBAYORAN BARU,PULO,5835,2427,3408,1727,5135,2021-07-30
3175021001,JAKARTA TIMUR,PULO GADUNG,PULO GADUNG,34422,18494,15928,6183,22111,2021-07-30
3175061005,JAKARTA TIMUR,CAKUNG,PULO GEBANG,97301,51327,45974,13386,59360,2021-07-30
3174041004,JAKARTA SELATAN,PASAR MINGGU,RAGUNAN,39616,18220,21396,8280,29676,2021-07-30
3175091005,JAKARTA TIMUR,CIRACAS,RAMBUTAN,36771,20883,15888,5546,21434,2021-07-30
3172031006,JAKARTA UTARA,KOJA,RAWA BADAK SELATAN,42179,22812,19367,5269,24636,2021-07-30
3172031004,JAKARTA UTARA,KOJA,RAWA BADAK UTARA,34408,17572,16836,5261,22097,2021-07-30
3174071005,JAKARTA SELATAN,KEBAYORAN BARU,RAWA BARAT,5625,2544,3081,1635,4716,2021-07-30
3173011003,JAKARTA BARAT,CENGKARENG,RAWA BUAYA,63799,33934,29865,8633,38498,2021-07-30
3175031004,JAKARTA TIMUR,JATINEGARA,RAWA BUNGA,21434,11984,9450,3058,12508,2021-07-30
3174081003,JAKARTA SELATAN,PANCORAN,RAWA JATI,20509,9364,11145,4398,15543,2021-07-30
3175061002,JAKARTA TIMUR,CAKUNG,RAWA TERATE,24637,11414,13223,2844,16067,2021-07-30
3175021005,JAKARTA TIMUR,PULO GADUNG,RAWAMANGUN,37612,19130,18482,7255,25737,2021-07-30
3171051003,JAKARTA PUSAT,CEMPAKA PUTIH,RAWASARI,21967,10761,11206,4525,15731,2021-07-30
3173041010,JAKARTA BARAT,TAMBORA,ROA MALAKA,3484,1373,2111,1059,3170,2021-07-30
3172041006,JAKARTA UTARA,CILINCING,ROROTAN,41668,19481,22187,6242,28429,2021-07-30
3174071004,JAKARTA SELATAN,KEBAYORAN BARU,SELONG,2842,1181,1661,1018,2679,2021-07-30
3173061002,JAKARTA BARAT,KALI DERES,SEMANAN,71354,38186,33168,7116,40284,2021-07-30
3172041007,JAKARTA UTARA,CILINCING,SEMPER BARAT,68587,30258,38329,12118,50447,2021-07-30
3172041005,JAKARTA UTARA,CILINCING,SEMPER TIMUR,36267,17668,18599,6008,24607,2021-07-30
3174071006,JAKARTA SELATAN,KEBAYORAN BARU,SENAYAN,2771,1488,1283,698,1981,2021-07-30
3171041001,JAKARTA PUSAT,SENEN,SENEN,6804,3159,3645,1411,5056,2021-07-30
3171031004,JAKARTA PUSAT,KEMAYORAN,SERDANG,29668,14899,14769,5278,20047,2021-07-30
3174021001,JAKARTA SELATAN,SETIA BUDI,SETIA BUDI,3023,1465,1558,770,2328,2021-07-30
3175101005,JAKARTA TIMUR,CIPAYUNG,SETU,20572,11776,8796,3327,12123,2021-07-30
3173071002,JAKARTA BARAT,PALMERAH,SLIPI,16591,7738,8853,3306,12159,2021-07-30
3173081004,JAKARTA BARAT,KEMBANGAN,SRENGSENG,45523,24371,21152,7793,28945,2021-07-30
3174091002,JAKARTA SELATAN,JAGAKARSA,SRENGSENG SAWAH,58196,25689,32507,12944,45451,2021-07-30
3173051003,JAKARTA BARAT,KEBON JERUK,SUKABUMI SELATAN,37033,21221,15812,4774,20586,2021-07-30
3173051002,JAKARTA BARAT,KEBON JERUK,SUKABUMI UTARA,38290,22779,15511,5244,20755,2021-07-30
3172041002,JAKARTA UTARA,CILINCING,SUKAPURA,53949,26538,27411,7218,34629,2021-07-30
3171031007,JAKARTA PUSAT,KEMAYORAN,SUMUR BATU,22717,11316,11401,4748,16149,2021-07-30
3172021004,JAKARTA UTARA,TANJUNG PRIOK,SUNGAI BAMBU,29876,14264,15612,5293,20905,2021-07-30
3172021006,JAKARTA UTARA,TANJUNG PRIOK,SUNTER AGUNG,71805,29446,42359,17034,59393,2021-07-30
3172021002,JAKARTA UTARA,TANJUNG PRIOK,SUNTER JAYA,63031,28154,34877,13914,48791,2021-07-30
3175091004,JAKARTA TIMUR,CIRACAS,SUSUKAN,38257,19263,18994,6677,25671,2021-07-30
3173031001,JAKARTA BARAT,TAMAN SARI,TAMAN SARI,14348,6535,7813,3179,10992,2021-07-30
3173041001,JAKARTA BARAT,TAMBORA,TAMBORA,10204,5379,4825,2016,6841,2021-07-30
3173041004,JAKARTA BARAT,TAMBORA,TANAH SEREAL,26387,11631,14756,4989,19745,2021-07-30
3171081004,JAKARTA PUSAT,JOHAR BARU,TANAH TINGGI,37693,16602,21091,5910,27001,2021-07-30
3173031004,JAKARTA BARAT,TAMAN SARI,TANGKI,13324,6013,7311,2636,9947,2021-07-30
3174091005,JAKARTA SELATAN,JAGAKARSA,TANJUNG BARAT,39770,19747,20023,7728,27751,2021-07-30
3173021005,JAKARTA BARAT,GROGOL PETAMBURAN,TANJUNG DUREN SELATAN,25337,11138,14199,5624,19823,2021-07-30
3173021002,JAKARTA BARAT,GROGOL PETAMBURAN,TANJUNG DUREN UTARA,17010,7022,9988,4372,14360,2021-07-30
3172021001,JAKARTA UTARA,TANJUNG PRIOK,TANJUNG PRIOK,34588,15438,19150,4928,24078,2021-07-30
3174011002,JAKARTA SELATAN,TEBET,TEBET BARAT,21194,9310,11884,5405,17289,2021-07-30
3174011001,JAKARTA SELATAN,TEBET,TEBET TIMUR,18199,7686,10513,4767,15280,2021-07-30
3173061003,JAKARTA BARAT,KALI DERES,TEGAL ALUR,83647,43797,39850,10219,50069,2021-07-30
3174031004,JAKARTA SELATAN,MAMPANG PRAPATAN,TEGAL PARANG,32401,17191,15210,4845,20055,2021-07-30
3173021003,JAKARTA BARAT,GROGOL PETAMBURAN,TOMANG,29605,13667,15938,6436,22374,2021-07-30
3172031005,JAKARTA UTARA,KOJA,TUGU SELATAN,39122,20615,18507,5130,23637,2021-07-30
3172031002,JAKARTA UTARA,KOJA,TUGU UTARA,67670,36178,31492,8910,40402,2021-07-30
3175061006,JAKARTA TIMUR,CAKUNG,UJUNG MENTENG,29934,13906,16028,5197,21225,2021-07-30
3174101005,JAKARTA SELATAN,PESANGGRAHAN,ULUJAMI,40544,21561,18983,6680,25663,2021-07-30
3175011006,JAKARTA TIMUR,MATRAMAN,UTAN KAYU SELATAN,33511,16746,16765,6633,23398,2021-07-30
3175011002,JAKARTA TIMUR,MATRAMAN,UTAN KAYU UTARA,28169,14569,13600,5168,18768,2021-07-30
3171031008,JAKARTA PUSAT,KEMAYORAN,UTAN PANJANG,29208,15683,13525,3909,17434,2021-07-30
3172021007,JAKARTA UTARA,TANJUNG PRIOK,WARAKAS,44401,21245,23156,7410,30566,2021-07-30
3173021007,JAKARTA BARAT,GROGOL PETAMBURAN,WIJAYA KUSUMA,38934,19634,19300,6566,25866,2021-07-30
3172051003,JAKARTA UTARA,PADEMANGAN,ANCOL,23947,12333,11614,4181,15795,2021-07-31
3173041007,JAKARTA BARAT,TAMBORA,ANGKE,29381,13875,15506,4798,20304,2021-07-31
3175041005,JAKARTA TIMUR,KRAMAT JATI,BALE KAMBANG,29074,18314,10760,3658,14418,2021-07-31
3175031003,JAKARTA TIMUR,JATINEGARA,BALI MESTER,9752,5173,4579,2007,6586,2021-07-31
3175101006,JAKARTA TIMUR,CIPAYUNG,BAMBU APUS,26285,13775,12510,5206,17716,2021-07-31
3174031002,JAKARTA SELATAN,MAMPANG PRAPATAN,BANGKA,21566,10443,11123,4010,15133,2021-07-31
3175051002,JAKARTA TIMUR,PASAR REBO,BARU,23886,10063,13823,6118,19941,2021-07-31
3175041004,JAKARTA TIMUR,KRAMAT JATI,BATU AMPAR,47898,28848,19050,7261,26311,2021-07-31
3171071002,JAKARTA PUSAT,TANAH ABANG,BENDUNGAN HILIR,21494,9978,11516,4602,16118,2021-07-31
3175031002,JAKARTA TIMUR,JATINEGARA,BIDARA CINA,36689,21784,14905,5490,20395,2021-07-31
3174101002,JAKARTA SELATAN,PESANGGRAHAN,BINTARO,53098,26231,26867,9864,36731,2021-07-31
3174011005,JAKARTA SELATAN,TEBET,BUKIT DURI,34183,18142,16041,6155,22196,2021-07-31
3171041006,JAKARTA PUSAT,SENEN,BUNGUR,18144,8558,9586,3745,13331,2021-07-31
3175061007,JAKARTA TIMUR,CAKUNG,CAKUNG BARAT,57724,25962,31762,7209,38971,2021-07-31
3175061004,JAKARTA TIMUR,CAKUNG,CAKUNG TIMUR,58287,27347,30940,10164,41104,2021-07-31
3175041007,JAKARTA TIMUR,KRAMAT JATI,CAWANG,32762,17977,14785,5832,20617,2021-07-31
3175101008,JAKARTA TIMUR,CIPAYUNG,CEGER,18932,9535,9397,3458,12855,2021-07-31
3171031006,JAKARTA PUSAT,KEMAYORAN,CEMPAKA BARU,32581,17361,15220,5541,20761,2021-07-31
3171051002,JAKARTA PUSAT,CEMPAKA PUTIH,CEMPAKA PUTIH BARAT,35885,17924,17961,6572,24533,2021-07-31
3171051001,JAKARTA PUSAT,CEMPAKA PUTIH,CEMPAKA PUTIH TIMUR,24292,11726,12566,5759,18325,2021-07-31
3173011001,JAKARTA BARAT,CENGKARENG,CENGKARENG BARAT,66284,31510,34774,13083,47857,2021-07-31
3173011006,JAKARTA BARAT,CENGKARENG,CENGKARENG TIMUR,81027,42298,38729,14007,52736,2021-07-31
3175091002,JAKARTA TIMUR,CIRACAS,CIBUBUR,66364,31034,35330,13775,49105,2021-07-31
3171011002,JAKARTA PUSAT,GAMBIR,CIDENG,15390,6888,8502,3875,12377,2021-07-31
3174091003,JAKARTA SELATAN,JAGAKARSA,CIGANJUR,38497,18545,19952,7652,27604,2021-07-31
3175051003,JAKARTA TIMUR,PASAR REBO,CIJANTUNG,41419,20017,21402,8806,30208,2021-07-31
3171061003,JAKARTA PUSAT,MENTENG,CIKINI,8274,4399,3875,1825,5700,2021-07-31
3174081006,JAKARTA SELATAN,PANCORAN,CIKOKO,10547,4377,6170,2234,8404,2021-07-31
3174061001,JAKARTA SELATAN,CILANDAK,CILANDAK BARAT,51752,23413,28339,11794,40133,2021-07-31
3174041003,JAKARTA SELATAN,PASAR MINGGU,CILANDAK TIMUR,25145,11593,13552,6558,20110,2021-07-31
3175101002,JAKARTA TIMUR,CIPAYUNG,CILANGKAP,27635,14017,13618,5203,18821,2021-07-31
3175041006,JAKARTA TIMUR,KRAMAT JATI,CILILITAN,40181,22375,17806,7171,24977,2021-07-31
3172041001,JAKARTA UTARA,CILINCING,CILINCING,43609,22959,20650,5974,26624,2021-07-31
3175101001,JAKARTA TIMUR,CIPAYUNG,CIPAYUNG,26104,12295,13809,5581,19390,2021-07-31
3174091006,JAKARTA SELATAN,JAGAKARSA,CIPEDAK,38303,16996,21307,7749,29056,2021-07-31
3174061005,JAKARTA SELATAN,CILANDAK,CIPETE SELATAN,26704,12600,14104,5786,19890,2021-07-31
3174071010,JAKARTA SELATAN,KEBAYORAN BARU,CIPETE UTARA,34102,16141,17961,6203,24164,2021-07-31
3175021003,JAKARTA TIMUR,PULO GADUNG,CIPINANG,39306,20199,19107,8044,27151,2021-07-31
3175031007,JAKARTA TIMUR,JATINEGARA,CIPINANG BESAR SELATAN,35212,20568,14644,5239,19883,2021-07-31
3175031008,JAKARTA TIMUR,JATINEGARA,CIPINANG BESAR UTARA,45319,26683,18636,5660,24296,2021-07-31
3175031005,JAKARTA TIMUR,JATINEGARA,CIPINANG CEMPEDAK,32824,18281,14543,6059,20602,2021-07-31
3175081005,JAKARTA TIMUR,MAKASAR,CIPINANG MELAYU,42308,20945,21363,8864,30227,2021-07-31
3175031006,JAKARTA TIMUR,JATINEGARA,CIPINANG MUARA,55243,31406,23837,9497,33334,2021-07-31
3174051003,JAKARTA SELATAN,KEBAYORAN LAMA,CIPULIR,39937,21370,18567,7043,25610,2021-07-31
3175091001,JAKARTA TIMUR,CIRACAS,CIRACAS,64594,30462,34132,12080,46212,2021-07-31
3175041003,JAKARTA TIMUR,KRAMAT JATI,DUKUH,24609,13164,11445,4681,16126,2021-07-31
3175071001,JAKARTA TIMUR,DUREN SAWIT,DUREN SAWIT,61160,33494,27666,12493,40159,2021-07-31
3174081004,JAKARTA SELATAN,PANCORAN,DUREN TIGA,28319,13120,15199,5220,20419,2021-07-31
3173051005,JAKARTA BARAT,KEBON JERUK,DURI KEPA,60138,26650,33488,13320,46808,2021-07-31
3173011002,JAKARTA BARAT,CENGKARENG,DURI KOSAMBI,77923,41456,36467,12633,49100,2021-07-31
3171011006,JAKARTA PUSAT,GAMBIR,DURI PULO,19610,9949,9661,3131,12792,2021-07-31
3173041011,JAKARTA BARAT,TAMBORA,DURI SELATAN,14259,6221,8038,2979,11017,2021-07-31
3173041003,JAKARTA BARAT,TAMBORA,DURI UTARA,19844,9289,10555,3468,14023,2021-07-31
3171081003,JAKARTA PUSAT,JOHAR BARU,GALUR,18243,7805,10438,2909,13347,2021-07-31
3171011001,JAKARTA PUSAT,GAMBIR,GAMBIR,2191,962,1229,616,1845,2021-07-31
3174061004,JAKARTA SELATAN,CILANDAK,GANDARIA SELATAN,22119,10908,11211,4504,15715,2021-07-31
3174071009,JAKARTA SELATAN,KEBAYORAN BARU,GANDARIA UTARA,39922,19586,20336,7700,28036,2021-07-31
3175051001,JAKARTA TIMUR,PASAR REBO,GEDONG,35755,17901,17854,7210,25064,2021-07-31
3171071001,JAKARTA PUSAT,TANAH ABANG,GELORA,3127,1481,1646,693,2339,2021-07-31
3173031007,JAKARTA BARAT,TAMAN SARI,GLODOK,7837,3006,4831,2602,7433,2021-07-31
3171061004,JAKARTA PUSAT,MENTENG,GONDANGDIA,4100,1772,2328,1501,3829,2021-07-31
3173021001,JAKARTA BARAT,GROGOL PETAMBURAN,GROGOL,16876,8138,8738,3537,12275,2021-07-31
3174051005,JAKARTA SELATAN,KEBAYORAN LAMA,GROGOL SELATAN,44251,23213,21038,7807,28845,2021-07-31
3174051004,JAKARTA SELATAN,KEBAYORAN LAMA,GROGOL UTARA,42494,21870,20624,7719,28343,2021-07-31
3174021007,JAKARTA SELATAN,SETIA BUDI,GUNTUR,3985,1717,2268,1203,3471,2021-07-31
3174071002,JAKARTA SELATAN,KEBAYORAN BARU,GUNUNG,9436,4252,5184,2636,7820,2021-07-31
3171031005,JAKARTA PUSAT,KEMAYORAN,GUNUNG SAHARI SELATAN,19199,9194,10005,4177,14182,2021-07-31
3171021004,JAKARTA PUSAT,SAWAH BESAR,GUNUNG SAHARI UTARA,16650,6821,9829,4378,14207,2021-07-31
3175081004,JAKARTA TIMUR,MAKASAR,HALIM PERDANA KUSUMAH,28363,9955,18408,10930,29338,2021-07-31
3171031003,JAKARTA PUSAT,KEMAYORAN,HARAPAN MULIA,22557,11339,11218,3930,15148,2021-07-31
3174091001,JAKARTA SELATAN,JAGAKARSA,JAGAKARSA,62389,28210,34179,13704,47883,2021-07-31
3175021007,JAKARTA TIMUR,PULO GADUNG,JATI,32757,16883,15874,7233,23107,2021-07-31
3174041002,JAKARTA SELATAN,PASAR MINGGU,JATI PADANG,37502,18177,19325,8278,27603,2021-07-31
3173071004,JAKARTA BARAT,PALMERAH,JATI PULO,28738,12696,16042,4673,20715,2021-07-31
3175061001,JAKARTA TIMUR,CAKUNG,JATINEGARA,84160,45616,38544,10594,49138,2021-07-31
3175021004,JAKARTA TIMUR,PULO GADUNG,JATINEGARA KAUM,24632,12643,11989,3981,15970,2021-07-31
3173021004,JAKARTA BARAT,GROGOL PETAMBURAN,JELAMBAR,30266,13944,16322,7517,23839,2021-07-31
3173021006,JAKARTA BARAT,GROGOL PETAMBURAN,JELAMBAR BARU,38246,18066,20180,8711,28891,2021-07-31
3173041006,JAKARTA BARAT,TAMBORA,JEMBATAN BESI,29314,17458,11856,3423,15279,2021-07-31
3173041008,JAKARTA BARAT,TAMBORA,JEMBATAN LIMA,21021,11794,9227,3307,12534,2021-07-31
3173081005,JAKARTA BARAT,KEMBANGAN,JOGLO,40839,20706,20133,7983,28116,2021-07-31
3171081001,JAKARTA PUSAT,JOHAR BARU,JOHAR BARU,37488,16568,20920,7378,28298,2021-07-31
3173041002,JAKARTA BARAT,TAMBORA,KALI ANYAR,23856,12726,11130,2953,14083,2021-07-31
3172041004,JAKARTA UTARA,CILINCING,KALIBARU,67684,38127,29557,6864,36421,2021-07-31
3174081002,JAKARTA SELATAN,PANCORAN,KALIBATA,41994,22796,19198,7012,26210,2021-07-31
3173061001,JAKARTA BARAT,KALI DERES,KALIDERES,72447,36294,36153,11757,47910,2021-07-31
3175051004,JAKARTA TIMUR,PASAR REBO,KALISARI,43212,20991,22221,9351,31572,2021-07-31
3173061004,JAKARTA BARAT,KALI DERES,KAMAL,53783,30123,23660,5425,29085,2021-07-31
3172011002,JAKARTA UTARA,PENJARINGAN,KAMAL MUARA,12930,4499,8431,3810,12241,2021-07-31
3171071007,JAKARTA PUSAT,TANAH ABANG,KAMPUNG BALI,11358,6398,4960,1888,6848,2021-07-31
3175031001,JAKARTA TIMUR,JATINEGARA,KAMPUNG MELAYU,25717,14936,10781,3257,14038,2021-07-31
3171081002,JAKARTA PUSAT,JOHAR BARU,KAMPUNG RAWA,21237,8083,13154,3731,16885,2021-07-31
3175041002,JAKARTA TIMUR,KRAMAT JATI,KAMPUNG TENGAH,43993,26456,17537,6974,24511,2021-07-31
3173011005,JAKARTA BARAT,CENGKARENG,KAPUK,134466,74228,60238,15861,76099,2021-07-31
3172011003,JAKARTA UTARA,PENJARINGAN,KAPUK MUARA,35781,14958,20823,9421,30244,2021-07-31
3171021002,JAKARTA PUSAT,SAWAH BESAR,KARANG ANYAR,25761,12303,13458,4699,18157,2021-07-31
3174021004,JAKARTA SELATAN,SETIA BUDI,KARET,9623,4701,4922,2078,7000,2021-07-31
3174021003,JAKARTA SELATAN,SETIA BUDI,KARET KUNINGAN,16055,7126,8929,3394,12323,2021-07-31
3174021002,JAKARTA SELATAN,SETIA BUDI,KARET SEMANGGI,2770,1152,1618,821,2439,2021-07-31
3171071003,JAKARTA PUSAT,TANAH ABANG,KARET TENGSIN,19271,9152,10119,3161,13280,2021-07-31
3171021003,JAKARTA PUSAT,SAWAH BESAR,KARTINI,22292,10266,12026,4819,16845,2021-07-31
3175011003,JAKARTA TIMUR,MATRAMAN,KAYU MANIS,25284,14020,11264,4160,15424,2021-07-31
3175021006,JAKARTA TIMUR,PULO GADUNG,KAYU PUTIH,40696,18820,21876,9736,31612,2021-07-31
3173031006,JAKARTA BARAT,TAMAN SARI,KEAGUNGAN,17387,8126,9261,3231,12492,2021-07-31
3174041007,JAKARTA SELATAN,PASAR MINGGU,KEBAGUSAN,44552,23092,21460,8287,29747,2021-07-31
3174051006,JAKARTA SELATAN,KEBAYORAN LAMA,KEBAYORAN LAMA SELATAN,41212,19631,21581,8140,29721,2021-07-31
3174051001,JAKARTA SELATAN,KEBAYORAN LAMA,KEBAYORAN LAMA UTARA,42422,22513,19909,7263,27172,2021-07-31
3174011004,JAKARTA SELATAN,TEBET,KEBON BARU,35165,17111,18054,7117,25171,2021-07-31
3172021005,JAKARTA UTARA,TANJUNG PRIOK,KEBON BAWANG,50952,24426,26526,9638,36164,2021-07-31
3173051001,JAKARTA BARAT,KEBON JERUK,KEBON JERUK,53887,28728,25159,9124,34283,2021-07-31
3171071006,JAKARTA PUSAT,TANAH ABANG,KEBON KACANG,21531,12424,9107,3302,12409,2021-07-31
3171011005,JAKARTA PUSAT,GAMBIR,KEBON KELAPA,10163,4863,5300,2129,7429,2021-07-31
3171031002,JAKARTA PUSAT,KEMAYORAN,KEBON KOSONG,30019,14796,15223,5134,20357,2021-07-31
3175011005,JAKARTA TIMUR,MATRAMAN,KEBON MANGGIS,16490,8118,8372,3664,12036,2021-07-31
3171071005,JAKARTA PUSAT,TANAH ABANG,KEBON MELATI,32206,19643,12563,3678,16241,2021-07-31
3175081003,JAKARTA TIMUR,MAKASAR,KEBON PALA,46614,24279,22335,8352,30687,2021-07-31
3171061005,JAKARTA PUSAT,MENTENG,KEBON SIRIH,12299,6600,5699,2073,7772,2021-07-31
3173011004,JAKARTA BARAT,CENGKARENG,KEDAUNG KALI ANGKE,32612,13738,18874,4855,23729,2021-07-31
3173051007,JAKARTA BARAT,KEBON JERUK,KEDOYA SELATAN,32165,14789,17376,6142,23518,2021-07-31
3173051006,JAKARTA BARAT,KEBON JERUK,KEDOYA UTARA,45740,20104,25636,9152,34788,2021-07-31
3173051004,JAKARTA BARAT,KEBON JERUK,KELAPA DUA,23565,11812,11753,4299,16052,2021-07-31
3175091003,JAKARTA TIMUR,CIRACAS,KELAPA DUA WETAN,46875,22153,24722,9564,34286,2021-07-31
3172061003,JAKARTA UTARA,KELAPA GADING,KELAPA GADING BARAT,35717,14072,21645,10864,32509,2021-07-31
3172061001,JAKARTA UTARA,KELAPA GADING,KELAPA GADING TIMUR,33592,12188,21404,11489,32893,2021-07-31
3173071005,JAKARTA BARAT,PALMERAH,KEMANGGISAN,32139,15975,16164,6386,22550,2021-07-31
3171031001,JAKARTA PUSAT,KEMAYORAN,KEMAYORAN,20708,9453,11255,4070,15325,2021-07-31
3173081006,JAKARTA BARAT,KEMBANGAN,KEMBANGAN SELATAN,27130,13025,14105,6243,20348,2021-07-31
3173081001,JAKARTA BARAT,KEMBANGAN,KEMBANGAN UTARA,54451,26353,28098,8490,36588,2021-07-31
3171041002,JAKARTA PUSAT,SENEN,KENARI,9579,4227,5352,2154,7506,2021-07-31
3173041005,JAKARTA BARAT,TAMBORA,KERENDANG,19973,9987,9986,3051,13037,2021-07-31
3175071003,JAKARTA TIMUR,DUREN SAWIT,KLENDER,69978,41096,28882,10715,39597,2021-07-31
3172031001,JAKARTA UTARA,KOJA,KOJA,28175,13707,14468,4323,18791,2021-07-31
3173071006,JAKARTA BARAT,PALMERAH,KOTA BAMBU SELATAN,21158,10625,10533,3121,13654,2021-07-31
3173071003,JAKARTA BARAT,PALMERAH,KOTA BAMBU UTARA,24995,12681,12314,3548,15862,2021-07-31
3171041004,JAKARTA PUSAT,SENEN,KRAMAT,28835,15298,13537,4337,17874,2021-07-31
3175041001,JAKARTA TIMUR,KRAMAT JATI,KRAMAT JATI,34144,18579,15565,6335,21900,2021-07-31
3174071003,JAKARTA SELATAN,KEBAYORAN BARU,KRAMAT PELA,14413,6623,7790,3193,10983,2021-07-31
3173031002,JAKARTA BARAT,TAMAN SARI,KRUKUT,19244,9258,9986,3154,13140,2021-07-31
3174031005,JAKARTA SELATAN,MAMPANG PRAPATAN,KUNINGAN BARAT,12785,5886,6899,2407,9306,2021-07-31
3174021008,JAKARTA SELATAN,SETIA BUDI,KUNINGAN TIMUR,6008,2966,3042,1414,4456,2021-07-31
3171041005,JAKARTA PUSAT,SENEN,KWITANG,15486,7660,7826,2919,10745,2021-07-31
3172031003,JAKARTA UTARA,KOJA,LAGOA,59065,30954,28111,8435,36546,2021-07-31
3174061002,JAKARTA SELATAN,CILANDAK,LEBAK BULUS,37626,18428,19198,8378,27576,2021-07-31
3174091004,JAKARTA SELATAN,JAGAKARSA,LENTENG AGUNG,53946,28216,25730,9177,34907,2021-07-31
3175101007,JAKARTA TIMUR,CIPAYUNG,LUBANG BUAYA,63547,31530,32017,13621,45638,2021-07-31
3175081001,JAKARTA TIMUR,MAKASAR,MAKASAR,34390,16893,17497,7228,24725,2021-07-31
3175071006,JAKARTA TIMUR,DUREN SAWIT,MALAKA JAYA,30927,14506,16421,7207,23628,2021-07-31
3175071005,JAKARTA TIMUR,DUREN SAWIT,MALAKA SARI,27530,12697,14833,6827,21660,2021-07-31
3174031001,JAKARTA SELATAN,MAMPANG PRAPATAN,MAMPANG PRAPATAN,18159,8877,9282,3416,12698,2021-07-31
3173031005,JAKARTA BARAT,TAMAN SARI,MANGGA BESAR,7707,3060,4647,2081,6728,2021-07-31
3171021005,JAKARTA PUSAT,SAWAH BESAR,MANGGA DUA SELATAN,27442,13270,14172,5478,19650,2021-07-31
3174011007,JAKARTA SELATAN,TEBET,MANGGARAI,28373,14056,14317,4912,19229,2021-07-31
3174011006,JAKARTA SELATAN,TEBET,MANGGARAI SELATAN,23075,10912,12163,5247,17410,2021-07-31
3173031003,JAKARTA BARAT,TAMAN SARI,MAPHAR,16461,7550,8911,3560,12471,2021-07-31
3172041003,JAKARTA UTARA,CILINCING,MARUNDA,28943,13707,15236,3821,19057,2021-07-31
3174071001,JAKARTA SELATAN,KEBAYORAN BARU,MELAWAI,2627,1040,1587,995,2582,2021-07-31
3171061001,JAKARTA PUSAT,MENTENG,MENTENG,25624,14307,11317,4621,15938,2021-07-31
3174021005,JAKARTA SELATAN,SETIA BUDI,MENTENG ATAS,27816,12922,14894,5519,20413,2021-07-31
3174011003,JAKARTA SELATAN,TEBET,MENTENG DALAM,36028,18166,17862,7457,25319,2021-07-31
3173081003,JAKARTA BARAT,KEMBANGAN,MERUYA SELATAN,32130,16846,15284,6117,21401,2021-07-31
3173081002,JAKARTA BARAT,KEMBANGAN,MERUYA UTARA,43752,21716,22036,9086,31122,2021-07-31
3175101004,JAKARTA TIMUR,CIPAYUNG,MUNJUL,23871,11849,12022,4748,16770,2021-07-31
3172051002,JAKARTA UTARA,PADEMANGAN,PADEMANGAN BARAT,74240,36771,37469,11011,48480,2021-07-31
3172051001,JAKARTA UTARA,PADEMANGAN,PADEMANGAN TIMUR,37736,15330,22406,8874,31280,2021-07-31
3175011004,JAKARTA TIMUR,MATRAMAN,PAL MERIAM,19769,10493,9276,3811,13087,2021-07-31
3173071001,JAKARTA BARAT,PALMERAH,PALMERAH,63011,32039,30972,10726,41698,2021-07-31
3174081001,JAKARTA SELATAN,PANCORAN,PANCORAN,19421,9281,10140,3782,13922,2021-07-31
3172021003,JAKARTA UTARA,TANJUNG PRIOK,PAPANGGO,39097,17912,21185,6944,28129,2021-07-31
3171021001,JAKARTA PUSAT,SAWAH BESAR,PASAR BARU,12035,4899,7136,3397,10533,2021-07-31
3174021006,JAKARTA SELATAN,SETIA BUDI,PASAR MANGGIS,26752,13252,13500,5287,18787,2021-07-31
3174041001,JAKARTA SELATAN,PASAR MINGGU,PASAR MINGGU,24821,12074,12747,6037,18784,2021-07-31
3171041003,JAKARTA PUSAT,SENEN,PASEBAN,23533,11552,11981,4343,16324,2021-07-31
3173061005,JAKARTA BARAT,KALI DERES,PEGADUNGAN,75587,36479,39108,15181,54289,2021-07-31
3171061002,JAKARTA PUSAT,MENTENG,PEGANGSAAN,23455,12919,10536,3847,14383,2021-07-31
3172061002,JAKARTA UTARA,KELAPA GADING,PEGANGSAAN DUA,49976,18728,31248,13706,44954,2021-07-31
3172011004,JAKARTA UTARA,PENJARINGAN,PEJAGALAN,74578,35080,39498,16725,56223,2021-07-31
3174041006,JAKARTA SELATAN,PASAR MINGGU,PEJATEN BARAT,37346,18241,19105,8215,27320,2021-07-31
3174041005,JAKARTA SELATAN,PASAR MINGGU,PEJATEN TIMUR,57656,31975,25681,10253,35934,2021-07-31
3175051005,JAKARTA TIMUR,PASAR REBO,PEKAYON,43250,20205,23045,8434,31479,2021-07-31
3173041009,JAKARTA BARAT,TAMBORA,PEKOJAN,23587,10773,12814,4887,17701,2021-07-31
3174031003,JAKARTA SELATAN,MAMPANG PRAPATAN,PELA MAMPANG,43522,20115,23407,8477,31884,2021-07-31
3174081005,JAKARTA SELATAN,PANCORAN,PENGADEGAN,21478,8964,12514,4535,17049,2021-07-31
3175061003,JAKARTA TIMUR,CAKUNG,PENGGILINGAN,99255,56439,42816,12613,55429,2021-07-31
3172011001,JAKARTA UTARA,PENJARINGAN,PENJARINGAN,88308,48415,39893,13266,53159,2021-07-31
3174101001,JAKARTA SELATAN,PESANGGRAHAN,PESANGGRAHAN,27545,12325,15220,6589,21809,2021-07-31
3171071004,JAKARTA PUSAT,TANAH ABANG,PETAMBURAN,33271,20496,12775,3817,16592,2021-07-31
3174071008,JAKARTA SELATAN,KEBAYORAN BARU,PETOGOGAN,11499,5490,6009,2735,8744,2021-07-31
3171011004,JAKARTA PUSAT,GAMBIR,PETOJO SELATAN,14692,7135,7557,3500,11057,2021-07-31
3171011003,JAKARTA PUSAT,GAMBIR,PETOJO UTARA,17458,9216,8242,3271,11513,2021-07-31
3174101004,JAKARTA SELATAN,PESANGGRAHAN,PETUKANGAN SELATAN,37187,17074,20113,6705,26818,2021-07-31
3174101003,JAKARTA SELATAN,PESANGGRAHAN,PETUKANGAN UTARA,53716,27547,26169,10340,36509,2021-07-31
3175081002,JAKARTA TIMUR,MAKASAR,PINANG RANTI,27198,13189,14009,5392,19401,2021-07-31
3173031008,JAKARTA BARAT,TAMAN SARI,PINANGSIA,10729,4443,6286,2226,8512,2021-07-31
3175011001,JAKARTA TIMUR,MATRAMAN,PISANGAN BARU,31776,17641,14135,5176,19311,2021-07-31
3175021002,JAKARTA TIMUR,PULO GADUNG,PISANGAN TIMUR,41011,20502,20509,7374,27883,2021-07-31
3172011005,JAKARTA UTARA,PENJARINGAN,PLUIT,47783,20962,26821,15795,42616,2021-07-31
3175071002,JAKARTA TIMUR,DUREN SAWIT,PONDOK BAMBU,61550,32693,28857,11871,40728,2021-07-31
3175071004,JAKARTA TIMUR,DUREN SAWIT,PONDOK KELAPA,72015,35110,36905,14419,51324,2021-07-31
3175071007,JAKARTA TIMUR,DUREN SAWIT,PONDOK KOPI,35367,20300,15067,5841,20908,2021-07-31
3174061003,JAKARTA SELATAN,CILANDAK,PONDOK LABU,46464,20947,25517,10517,36034,2021-07-31
3174051002,JAKARTA SELATAN,KEBAYORAN LAMA,PONDOK PINANG,56169,28512,27657,12564,40221,2021-07-31
3175101003,JAKARTA TIMUR,CIPAYUNG,PONDOK RANGGON,25574,13869,11705,4867,16572,2021-07-31
3101011003,KAB.ADM.KEP.SERIBU,KEP. SERIBU UTARA,PULAU HARAPAN,2060,469,1591,707,2298,2021-07-31
3101011002,KAB.ADM.KEP.SERIBU,KEP. SERIBU UTARA,PULAU KELAPA,5528,1221,4307,1377,5684,2021-07-31
3101011001,KAB.ADM.KEP.SERIBU,KEP. SERIBU UTARA,PULAU PANGGANG,5450,1070,4380,1281,5661,2021-07-31
3101021003,KAB.ADM.KEP.SERIBU,KEP. SERIBU SELATAN,PULAU PARI,2765,414,2351,695,3046,2021-07-31
3101021002,KAB.ADM.KEP.SERIBU,KEP. SERIBU SELATAN,PULAU TIDUNG,4553,898,3655,1511,5166,2021-07-31
3101021001,KAB.ADM.KEP.SERIBU,KEP. SERIBU SELATAN,PULAU UNTUNG JAWA,1941,450,1491,655,2146,2021-07-31
3174071007,JAKARTA SELATAN,KEBAYORAN BARU,PULO,5835,2404,3431,1774,5205,2021-07-31
3175021001,JAKARTA TIMUR,PULO GADUNG,PULO GADUNG,34422,18331,16091,6406,22497,2021-07-31
3175061005,JAKARTA TIMUR,CAKUNG,PULO GEBANG,97301,50249,47052,13877,60929,2021-07-31
3174041004,JAKARTA SELATAN,PASAR MINGGU,RAGUNAN,39616,17973,21643,8652,30295,2021-07-31
3175091005,JAKARTA TIMUR,CIRACAS,RAMBUTAN,36771,20627,16144,5815,21959,2021-07-31
3172031006,JAKARTA UTARA,KOJA,RAWA BADAK SELATAN,42179,22534,19645,5639,25284,2021-07-31
3172031004,JAKARTA UTARA,KOJA,RAWA BADAK UTARA,34408,17435,16973,5498,22471,2021-07-31
3174071005,JAKARTA SELATAN,KEBAYORAN BARU,RAWA BARAT,5625,2530,3095,1671,4766,2021-07-31
3173011003,JAKARTA BARAT,CENGKARENG,RAWA BUAYA,63799,33579,30220,9013,39233,2021-07-31
3175031004,JAKARTA TIMUR,JATINEGARA,RAWA BUNGA,21434,11800,9634,3170,12804,2021-07-31
3174081003,JAKARTA SELATAN,PANCORAN,RAWA JATI,20509,9242,11267,4560,15827,2021-07-31
3175061002,JAKARTA TIMUR,CAKUNG,RAWA TERATE,24637,11264,13373,3066,16439,2021-07-31
3175021005,JAKARTA TIMUR,PULO GADUNG,RAWAMANGUN,37612,18880,18732,7626,26358,2021-07-31
3171051003,JAKARTA PUSAT,CEMPAKA PUTIH,RAWASARI,21967,10589,11378,4682,16060,2021-07-31
3173041010,JAKARTA BARAT,TAMBORA,ROA MALAKA,3484,1362,2122,1103,3225,2021-07-31
3172041006,JAKARTA UTARA,CILINCING,ROROTAN,41668,18987,22681,6507,29188,2021-07-31
3174071004,JAKARTA SELATAN,KEBAYORAN BARU,SELONG,2842,1176,1666,1037,2703,2021-07-31
3173061002,JAKARTA BARAT,KALI DERES,SEMANAN,71354,37213,34141,7582,41723,2021-07-31
3172041007,JAKARTA UTARA,CILINCING,SEMPER BARAT,68587,29737,38850,12679,51529,2021-07-31
3172041005,JAKARTA UTARA,CILINCING,SEMPER TIMUR,36267,17395,18872,6384,25256,2021-07-31
3174071006,JAKARTA SELATAN,KEBAYORAN BARU,SENAYAN,2771,1479,1292,715,2007,2021-07-31
3171041001,JAKARTA PUSAT,SENEN,SENEN,6804,3101,3703,1450,5153,2021-07-31
3171031004,JAKARTA PUSAT,KEMAYORAN,SERDANG,29668,14536,15132,5482,20614,2021-07-31
3174021001,JAKARTA SELATAN,SETIA BUDI,SETIA BUDI,3023,1453,1570,790,2360,2021-07-31
3175101005,JAKARTA TIMUR,CIPAYUNG,SETU,20572,11634,8938,3455,12393,2021-07-31
3173071002,JAKARTA BARAT,PALMERAH,SLIPI,16591,7627,8964,3491,12455,2021-07-31
3173081004,JAKARTA BARAT,KEMBANGAN,SRENGSENG,45523,23985,21538,8080,29618,2021-07-31
3174091002,JAKARTA SELATAN,JAGAKARSA,SRENGSENG SAWAH,58196,25217,32979,13547,46526,2021-07-31
3173051003,JAKARTA BARAT,KEBON JERUK,SUKABUMI SELATAN,37033,20832,16201,5058,21259,2021-07-31
3173051002,JAKARTA BARAT,KEBON JERUK,SUKABUMI UTARA,38290,22559,15731,5525,21256,2021-07-31
3172041002,JAKARTA UTARA,CILINCING,SUKAPURA,53949,26232,27717,7621,35338,2021-07-31
3171031007,JAKARTA PUSAT,KEMAYORAN,SUMUR BATU,22717,11121,11596,4965,16561,2021-07-31
3172021004,JAKARTA UTARA,TANJUNG PRIOK,SUNGAI BAMBU,29876,14102,15774,5741,21515,2021-07-31
3172021006,JAKARTA UTARA,TANJUNG PRIOK,SUNTER AGUNG,71805,29067,42738,17952,60690,2021-07-31
3172021002,JAKARTA UTARA,TANJUNG PRIOK,SUNTER JAYA,63031,27635,35396,14447,49843,2021-07-31
3175091004,JAKARTA TIMUR,CIRACAS,SUSUKAN,38257,19020,19237,7019,26256,2021-07-31
3173031001,JAKARTA BARAT,TAMAN SARI,TAMAN SARI,14348,6450,7898,3345,11243,2021-07-31
3173041001,JAKARTA BARAT,TAMBORA,TAMBORA,10204,5317,4887,2075,6962,2021-07-31
3173041004,JAKARTA BARAT,TAMBORA,TANAH SEREAL,26387,11567,14820,5213,20033,2021-07-31
3171081004,JAKARTA PUSAT,JOHAR BARU,TANAH TINGGI,37693,16294,21399,6160,27559,2021-07-31
3173031004,JAKARTA BARAT,TAMAN SARI,TANGKI,13324,5945,7379,2787,10166,2021-07-31
3174091005,JAKARTA SELATAN,JAGAKARSA,TANJUNG BARAT,39770,19500,20270,8115,28385,2021-07-31
3173021005,JAKARTA BARAT,GROGOL PETAMBURAN,TANJUNG DUREN SELATAN,25337,11025,14312,5898,20210,2021-07-31
3173021002,JAKARTA BARAT,GROGOL PETAMBURAN,TANJUNG DUREN UTARA,17010,6966,10044,4474,14518,2021-07-31
3172021001,JAKARTA UTARA,TANJUNG PRIOK,TANJUNG PRIOK,34588,15186,19402,5298,24700,2021-07-31
3174011002,JAKARTA SELATAN,TEBET,TEBET BARAT,21194,9161,12033,5592,17625,2021-07-31
3174011001,JAKARTA SELATAN,TEBET,TEBET TIMUR,18199,7604,10595,4936,15531,2021-07-31
3173061003,JAKARTA BARAT,KALI DERES,TEGAL ALUR,83647,43198,40449,10984,51433,2021-07-31
3174031004,JAKARTA SELATAN,MAMPANG PRAPATAN,TEGAL PARANG,32401,17009,15392,5051,20443,2021-07-31
3173021003,JAKARTA BARAT,GROGOL PETAMBURAN,TOMANG,29605,13544,16061,6751,22812,2021-07-31
3172031005,JAKARTA UTARA,KOJA,TUGU SELATAN,39122,20210,18912,5458,24370,2021-07-31
3172031002,JAKARTA UTARA,KOJA,TUGU UTARA,67670,35636,32034,9439,41473,2021-07-31
3175061006,JAKARTA TIMUR,CAKUNG,UJUNG MENTENG,29934,13530,16404,5383,21787,2021-07-31
3174101005,JAKARTA SELATAN,PESANGGRAHAN,ULUJAMI,40544,21285,19259,6830,26089,2021-07-31
3175011006,JAKARTA TIMUR,MATRAMAN,UTAN KAYU SELATAN,33511,16508,17003,6917,23920,2021-07-31
3175011002,JAKARTA TIMUR,MATRAMAN,UTAN KAYU UTARA,28169,14397,13772,5389,19161,2021-07-31
3171031008,JAKARTA PUSAT,KEMAYORAN,UTAN PANJANG,29208,15142,14066,4073,18139,2021-07-31
3172021007,JAKARTA UTARA,TANJUNG PRIOK,WARAKAS,44401,20921,23480,7802,31282,2021-07-31
3173021007,JAKARTA BARAT,GROGOL PETAMBURAN,WIJAYA KUSUMA,38934,19284,19650,6982,26632,2021-07-31
3172051003,JAKARTA UTARA,PADEMANGAN,ANCOL,23947,12155,11792,4268,16060,2021-08-01
3173041007,JAKARTA BARAT,TAMBORA,ANGKE,29381,13727,15654,4905,20559,2021-08-01
3175041005,JAKARTA TIMUR,KRAMAT JATI,BALE KAMBANG,29074,18226,10848,3712,14560,2021-08-01
3175031003,JAKARTA TIMUR,JATINEGARA,BALI MESTER,9752,4987,4765,2036,6801,2021-08-01
3175101006,JAKARTA TIMUR,CIPAYUNG,BAMBU APUS,26285,13716,12569,5242,17811,2021-08-01
3174031002,JAKARTA SELATAN,MAMPANG PRAPATAN,BANGKA,21566,10232,11334,4089,15423,2021-08-01
3175051002,JAKARTA TIMUR,PASAR REBO,BARU,23886,9999,13887,6150,20037,2021-08-01
3175041004,JAKARTA TIMUR,KRAMAT JATI,BATU AMPAR,47898,28381,19517,7375,26892,2021-08-01
3171071002,JAKARTA PUSAT,TANAH ABANG,BENDUNGAN HILIR,21494,9895,11599,4662,16261,2021-08-01
3175031002,JAKARTA TIMUR,JATINEGARA,BIDARA CINA,36689,21668,15021,5556,20577,2021-08-01
3174101002,JAKARTA SELATAN,PESANGGRAHAN,BINTARO,53098,25851,27247,9951,37198,2021-08-01
3174011005,JAKARTA SELATAN,TEBET,BUKIT DURI,34183,17980,16203,6235,22438,2021-08-01
3171041006,JAKARTA PUSAT,SENEN,BUNGUR,18144,8318,9826,3815,13641,2021-08-01
3175061007,JAKARTA TIMUR,CAKUNG,CAKUNG BARAT,57724,25769,31955,7383,39338,2021-08-01
3175061004,JAKARTA TIMUR,CAKUNG,CAKUNG TIMUR,58287,27205,31082,10319,41401,2021-08-01
3175041007,JAKARTA TIMUR,KRAMAT JATI,CAWANG,32762,17888,14874,5940,20814,2021-08-01
3175101008,JAKARTA TIMUR,CIPAYUNG,CEGER,18932,9316,9616,3489,13105,2021-08-01
3171031006,JAKARTA PUSAT,KEMAYORAN,CEMPAKA BARU,32581,17199,15382,5622,21004,2021-08-01
3171051002,JAKARTA PUSAT,CEMPAKA PUTIH,CEMPAKA PUTIH BARAT,35885,17527,18358,6669,25027,2021-08-01
3171051001,JAKARTA PUSAT,CEMPAKA PUTIH,CEMPAKA PUTIH TIMUR,24292,11618,12674,5866,18540,2021-08-01
3173011001,JAKARTA BARAT,CENGKARENG,CENGKARENG BARAT,66284,31390,34894,13222,48116,2021-08-01
3173011006,JAKARTA BARAT,CENGKARENG,CENGKARENG TIMUR,81027,42130,38897,14190,53087,2021-08-01
3175091002,JAKARTA TIMUR,CIRACAS,CIBUBUR,66364,30875,35489,13922,49411,2021-08-01
3171011002,JAKARTA PUSAT,GAMBIR,CIDENG,15390,6867,8523,3958,12481,2021-08-01
3174091003,JAKARTA SELATAN,JAGAKARSA,CIGANJUR,38497,18410,20087,7733,27820,2021-08-01
3175051003,JAKARTA TIMUR,PASAR REBO,CIJANTUNG,41419,19851,21568,8908,30476,2021-08-01
3171061003,JAKARTA PUSAT,MENTENG,CIKINI,8274,4366,3908,1843,5751,2021-08-01
3174081006,JAKARTA SELATAN,PANCORAN,CIKOKO,10547,4361,6186,2254,8440,2021-08-01
3174061001,JAKARTA SELATAN,CILANDAK,CILANDAK BARAT,51752,23098,28654,11907,40561,2021-08-01
3174041003,JAKARTA SELATAN,PASAR MINGGU,CILANDAK TIMUR,25145,11463,13682,6607,20289,2021-08-01
3175101002,JAKARTA TIMUR,CIPAYUNG,CILANGKAP,27635,13939,13696,5249,18945,2021-08-01
3175041006,JAKARTA TIMUR,KRAMAT JATI,CILILITAN,40181,22259,17922,7296,25218,2021-08-01
3172041001,JAKARTA UTARA,CILINCING,CILINCING,43609,22741,20868,6124,26992,2021-08-01
3175101001,JAKARTA TIMUR,CIPAYUNG,CIPAYUNG,26104,12229,13875,5630,19505,2021-08-01
3174091006,JAKARTA SELATAN,JAGAKARSA,CIPEDAK,38303,16929,21374,7786,29160,2021-08-01
3174061005,JAKARTA SELATAN,CILANDAK,CIPETE SELATAN,26704,12424,14280,5848,20128,2021-08-01
3174071010,JAKARTA SELATAN,KEBAYORAN BARU,CIPETE UTARA,34102,16027,18075,6271,24346,2021-08-01
3175021003,JAKARTA TIMUR,PULO GADUNG,CIPINANG,39306,19942,19364,8139,27503,2021-08-01
3175031007,JAKARTA TIMUR,JATINEGARA,CIPINANG BESAR SELATAN,35212,20479,14733,5308,20041,2021-08-01
3175031008,JAKARTA TIMUR,JATINEGARA,CIPINANG BESAR UTARA,45319,26184,19135,5799,24934,2021-08-01
3175031005,JAKARTA TIMUR,JATINEGARA,CIPINANG CEMPEDAK,32824,18208,14616,6124,20740,2021-08-01
3175081005,JAKARTA TIMUR,MAKASAR,CIPINANG MELAYU,42308,20878,21430,8970,30400,2021-08-01
3175031006,JAKARTA TIMUR,JATINEGARA,CIPINANG MUARA,55243,31246,23997,9633,33630,2021-08-01
3174051003,JAKARTA SELATAN,KEBAYORAN LAMA,CIPULIR,39937,21134,18803,7123,25926,2021-08-01
3175091001,JAKARTA TIMUR,CIRACAS,CIRACAS,64594,30229,34365,12233,46598,2021-08-01
3175041003,JAKARTA TIMUR,KRAMAT JATI,DUKUH,24609,13099,11510,4726,16236,2021-08-01
3175071001,JAKARTA TIMUR,DUREN SAWIT,DUREN SAWIT,61160,33332,27828,12636,40464,2021-08-01
3174081004,JAKARTA SELATAN,PANCORAN,DUREN TIGA,28319,13050,15269,5301,20570,2021-08-01
3173051005,JAKARTA BARAT,KEBON JERUK,DURI KEPA,60138,26379,33759,13514,47273,2021-08-01
3173011002,JAKARTA BARAT,CENGKARENG,DURI KOSAMBI,77923,41170,36753,12856,49609,2021-08-01
3171011006,JAKARTA PUSAT,GAMBIR,DURI PULO,19610,9901,9709,3191,12900,2021-08-01
3173041011,JAKARTA BARAT,TAMBORA,DURI SELATAN,14259,6165,8094,3017,11111,2021-08-01
3173041003,JAKARTA BARAT,TAMBORA,DURI UTARA,19844,9180,10664,3518,14182,2021-08-01
3171081003,JAKARTA PUSAT,JOHAR BARU,GALUR,18243,7699,10544,2950,13494,2021-08-01
3171011001,JAKARTA PUSAT,GAMBIR,GAMBIR,2191,958,1233,626,1859,2021-08-01
3174061004,JAKARTA SELATAN,CILANDAK,GANDARIA SELATAN,22119,10460,11659,4541,16200,2021-08-01
3174071009,JAKARTA SELATAN,KEBAYORAN BARU,GANDARIA UTARA,39922,19290,20632,7809,28441,2021-08-01
3175051001,JAKARTA TIMUR,PASAR REBO,GEDONG,35755,17819,17936,7280,25216,2021-08-01
3171071001,JAKARTA PUSAT,TANAH ABANG,GELORA,3127,1465,1662,712,2374,2021-08-01
3173031007,JAKARTA BARAT,TAMAN SARI,GLODOK,7837,2931,4906,2636,7542,2021-08-01
3171061004,JAKARTA PUSAT,MENTENG,GONDANGDIA,4100,1764,2336,1510,3846,2021-08-01
3173021001,JAKARTA BARAT,GROGOL PETAMBURAN,GROGOL,16876,8005,8871,3581,12452,2021-08-01
3174051005,JAKARTA SELATAN,KEBAYORAN LAMA,GROGOL SELATAN,44251,22913,21338,7883,29221,2021-08-01
3174051004,JAKARTA SELATAN,KEBAYORAN LAMA,GROGOL UTARA,42494,21439,21055,7844,28899,2021-08-01
3174021007,JAKARTA SELATAN,SETIA BUDI,GUNTUR,3985,1710,2275,1214,3489,2021-08-01
3174071002,JAKARTA SELATAN,KEBAYORAN BARU,GUNUNG,9436,4230,5206,2678,7884,2021-08-01
3171031005,JAKARTA PUSAT,KEMAYORAN,GUNUNG SAHARI SELATAN,19199,9143,10056,4233,14289,2021-08-01
3171021004,JAKARTA PUSAT,SAWAH BESAR,GUNUNG SAHARI UTARA,16650,6714,9936,4438,14374,2021-08-01
3175081004,JAKARTA TIMUR,MAKASAR,HALIM PERDANA KUSUMAH,28363,9874,18489,10983,29472,2021-08-01
3171031003,JAKARTA PUSAT,KEMAYORAN,HARAPAN MULIA,22557,11256,11301,3984,15285,2021-08-01
3174091001,JAKARTA SELATAN,JAGAKARSA,JAGAKARSA,62389,27865,34524,13882,48406,2021-08-01
3175021007,JAKARTA TIMUR,PULO GADUNG,JATI,32757,16645,16112,7322,23434,2021-08-01
3174041002,JAKARTA SELATAN,PASAR MINGGU,JATI PADANG,37502,18083,19419,8347,27766,2021-08-01
3173071004,JAKARTA BARAT,PALMERAH,JATI PULO,28738,12648,16090,4718,20808,2021-08-01
3175061001,JAKARTA TIMUR,CAKUNG,JATINEGARA,84160,45049,39111,10748,49859,2021-08-01
3175021004,JAKARTA TIMUR,PULO GADUNG,JATINEGARA KAUM,24632,12463,12169,4038,16207,2021-08-01
3173021004,JAKARTA BARAT,GROGOL PETAMBURAN,JELAMBAR,30266,13871,16395,7623,24018,2021-08-01
3173021006,JAKARTA BARAT,GROGOL PETAMBURAN,JELAMBAR BARU,38246,17968,20278,8830,29108,2021-08-01
3173041006,JAKARTA BARAT,TAMBORA,JEMBATAN BESI,29314,17289,12025,3470,15495,2021-08-01
3173041008,JAKARTA BARAT,TAMBORA,JEMBATAN LIMA,21021,11728,9293,3401,12694,2021-08-01
3173081005,JAKARTA BARAT,KEMBANGAN,JOGLO,40839,20603,20236,8099,28335,2021-08-01
3171081001,JAKARTA PUSAT,JOHAR BARU,JOHAR BARU,37488,16376,21112,7475,28587,2021-08-01
3173041002,JAKARTA BARAT,TAMBORA,KALI ANYAR,23856,12504,11352,3000,14352,2021-08-01
3172041004,JAKARTA UTARA,CILINCING,KALIBARU,67684,37556,30128,7145,37273,2021-08-01
3174081002,JAKARTA SELATAN,PANCORAN,KALIBATA,41994,22570,19424,7084,26508,2021-08-01
3173061001,JAKARTA BARAT,KALI DERES,KALIDERES,72447,35818,36629,11922,48551,2021-08-01
3175051004,JAKARTA TIMUR,PASAR REBO,KALISARI,43212,20881,22331,9422,31753,2021-08-01
3173061004,JAKARTA BARAT,KALI DERES,KAMAL,53783,29331,24452,5497,29949,2021-08-01
3172011002,JAKARTA UTARA,PENJARINGAN,KAMAL MUARA,12930,4469,8461,3843,12304,2021-08-01
3171071007,JAKARTA PUSAT,TANAH ABANG,KAMPUNG BALI,11358,6377,4981,1911,6892,2021-08-01
3175031001,JAKARTA TIMUR,JATINEGARA,KAMPUNG MELAYU,25717,14831,10886,3408,14294,2021-08-01
3171081002,JAKARTA PUSAT,JOHAR BARU,KAMPUNG RAWA,21237,7985,13252,3776,17028,2021-08-01
3175041002,JAKARTA TIMUR,KRAMAT JATI,KAMPUNG TENGAH,43993,26326,17667,7051,24718,2021-08-01
3173011005,JAKARTA BARAT,CENGKARENG,KAPUK,134466,73501,60965,16090,77055,2021-08-01
3172011003,JAKARTA UTARA,PENJARINGAN,KAPUK MUARA,35781,14915,20866,9494,30360,2021-08-01
3171021002,JAKARTA PUSAT,SAWAH BESAR,KARANG ANYAR,25761,12191,13570,4781,18351,2021-08-01
3174021004,JAKARTA SELATAN,SETIA BUDI,KARET,9623,4683,4940,2096,7036,2021-08-01
3174021003,JAKARTA SELATAN,SETIA BUDI,KARET KUNINGAN,16055,7098,8957,3438,12395,2021-08-01
3174021002,JAKARTA SELATAN,SETIA BUDI,KARET SEMANGGI,2770,1144,1626,837,2463,2021-08-01
3171071003,JAKARTA PUSAT,TANAH ABANG,KARET TENGSIN,19271,9112,10159,3195,13354,2021-08-01
3171021003,JAKARTA PUSAT,SAWAH BESAR,KARTINI,22292,10201,12091,4879,16970,2021-08-01
3175011003,JAKARTA TIMUR,MATRAMAN,KAYU MANIS,25284,13908,11376,4215,15591,2021-08-01
3175021006,JAKARTA TIMUR,PULO GADUNG,KAYU PUTIH,40696,18550,22146,9835,31981,2021-08-01
3173031006,JAKARTA BARAT,TAMAN SARI,KEAGUNGAN,17387,8034,9353,3296,12649,2021-08-01
3174041007,JAKARTA SELATAN,PASAR MINGGU,KEBAGUSAN,44552,22984,21568,8359,29927,2021-08-01
3174051006,JAKARTA SELATAN,KEBAYORAN LAMA,KEBAYORAN LAMA SELATAN,41212,19440,21772,8315,30087,2021-08-01
3174051001,JAKARTA SELATAN,KEBAYORAN LAMA,KEBAYORAN LAMA UTARA,42422,22350,20072,7356,27428,2021-08-01
3174011004,JAKARTA SELATAN,TEBET,KEBON BARU,35165,17021,18144,7197,25341,2021-08-01
3172021005,JAKARTA UTARA,TANJUNG PRIOK,KEBON BAWANG,50952,24225,26727,9778,36505,2021-08-01
3173051001,JAKARTA BARAT,KEBON JERUK,KEBON JERUK,53887,28582,25305,9258,34563,2021-08-01
3171071006,JAKARTA PUSAT,TANAH ABANG,KEBON KACANG,21531,12384,9147,3371,12518,2021-08-01
3171011005,JAKARTA PUSAT,GAMBIR,KEBON KELAPA,10163,4804,5359,2162,7521,2021-08-01
3171031002,JAKARTA PUSAT,KEMAYORAN,KEBON KOSONG,30019,14710,15309,5206,20515,2021-08-01
3175011005,JAKARTA TIMUR,MATRAMAN,KEBON MANGGIS,16490,7978,8512,3770,12282,2021-08-01
3171071005,JAKARTA PUSAT,TANAH ABANG,KEBON MELATI,32206,19577,12629,3734,16363,2021-08-01
3175081003,JAKARTA TIMUR,MAKASAR,KEBON PALA,46614,24099,22515,8427,30942,2021-08-01
3171061005,JAKARTA PUSAT,MENTENG,KEBON SIRIH,12299,6565,5734,2095,7829,2021-08-01
3173011004,JAKARTA BARAT,CENGKARENG,KEDAUNG KALI ANGKE,32612,13372,19240,4930,24170,2021-08-01
3173051007,JAKARTA BARAT,KEBON JERUK,KEDOYA SELATAN,32165,14666,17499,6226,23725,2021-08-01
3173051006,JAKARTA BARAT,KEBON JERUK,KEDOYA UTARA,45740,19750,25990,9296,35286,2021-08-01
3173051004,JAKARTA BARAT,KEBON JERUK,KELAPA DUA,23565,11768,11797,4346,16143,2021-08-01
3175091003,JAKARTA TIMUR,CIRACAS,KELAPA DUA WETAN,46875,21977,24898,9662,34560,2021-08-01
3172061003,JAKARTA UTARA,KELAPA GADING,KELAPA GADING BARAT,35717,14000,21717,10974,32691,2021-08-01
3172061001,JAKARTA UTARA,KELAPA GADING,KELAPA GADING TIMUR,33592,12087,21505,11629,33134,2021-08-01
3173071005,JAKARTA BARAT,PALMERAH,KEMANGGISAN,32139,15851,16288,6460,22748,2021-08-01
3171031001,JAKARTA PUSAT,KEMAYORAN,KEMAYORAN,20708,9396,11312,4128,15440,2021-08-01
3173081006,JAKARTA BARAT,KEMBANGAN,KEMBANGAN SELATAN,27130,12853,14277,6352,20629,2021-08-01
3173081001,JAKARTA BARAT,KEMBANGAN,KEMBANGAN UTARA,54451,25990,28461,8662,37123,2021-08-01
3171041002,JAKARTA PUSAT,SENEN,KENARI,9579,4135,5444,2198,7642,2021-08-01
3173041005,JAKARTA BARAT,TAMBORA,KERENDANG,19973,9834,10139,3122,13261,2021-08-01
3175071003,JAKARTA TIMUR,DUREN SAWIT,KLENDER,69978,40905,29073,10869,39942,2021-08-01
3172031001,JAKARTA UTARA,KOJA,KOJA,28175,13569,14606,4560,19166,2021-08-01
3173071006,JAKARTA BARAT,PALMERAH,KOTA BAMBU SELATAN,21158,10569,10589,3161,13750,2021-08-01
3173071003,JAKARTA BARAT,PALMERAH,KOTA BAMBU UTARA,24995,12565,12430,3592,16022,2021-08-01
3171041004,JAKARTA PUSAT,SENEN,KRAMAT,28835,15071,13764,4401,18165,2021-08-01
3175041001,JAKARTA TIMUR,KRAMAT JATI,KRAMAT JATI,34144,18418,15726,6411,22137,2021-08-01
3174071003,JAKARTA SELATAN,KEBAYORAN BARU,KRAMAT PELA,14413,6570,7843,3255,11098,2021-08-01
3173031002,JAKARTA BARAT,TAMAN SARI,KRUKUT,19244,9118,10126,3193,13319,2021-08-01
3174031005,JAKARTA SELATAN,MAMPANG PRAPATAN,KUNINGAN BARAT,12785,5843,6942,2482,9424,2021-08-01
3174021008,JAKARTA SELATAN,SETIA BUDI,KUNINGAN TIMUR,6008,2956,3052,1425,4477,2021-08-01
3171041005,JAKARTA PUSAT,SENEN,KWITANG,15486,7611,7875,2955,10830,2021-08-01
3172031003,JAKARTA UTARA,KOJA,LAGOA,59065,30673,28392,8642,37034,2021-08-01
3174061002,JAKARTA SELATAN,CILANDAK,LEBAK BULUS,37626,18205,19421,8455,27876,2021-08-01
3174091004,JAKARTA SELATAN,JAGAKARSA,LENTENG AGUNG,53946,27747,26199,9287,35486,2021-08-01
3175101007,JAKARTA TIMUR,CIPAYUNG,LUBANG BUAYA,63547,31420,32127,13707,45834,2021-08-01
3175081001,JAKARTA TIMUR,MAKASAR,MAKASAR,34390,16747,17643,7296,24939,2021-08-01
3175071006,JAKARTA TIMUR,DUREN SAWIT,MALAKA JAYA,30927,14455,16472,7248,23720,2021-08-01
3175071005,JAKARTA TIMUR,DUREN SAWIT,MALAKA SARI,27530,12665,14865,6898,21763,2021-08-01
3174031001,JAKARTA SELATAN,MAMPANG PRAPATAN,MAMPANG PRAPATAN,18159,8807,9352,3506,12858,2021-08-01
3173031005,JAKARTA BARAT,TAMAN SARI,MANGGA BESAR,7707,3032,4675,2107,6782,2021-08-01
3171021005,JAKARTA PUSAT,SAWAH BESAR,MANGGA DUA SELATAN,27442,13161,14281,5581,19862,2021-08-01
3174011007,JAKARTA SELATAN,TEBET,MANGGARAI,28373,13989,14384,4981,19365,2021-08-01
3174011006,JAKARTA SELATAN,TEBET,MANGGARAI SELATAN,23075,10755,12320,5312,17632,2021-08-01
3173031003,JAKARTA BARAT,TAMAN SARI,MAPHAR,16461,7428,9033,3616,12649,2021-08-01
3172041003,JAKARTA UTARA,CILINCING,MARUNDA,28943,13665,15278,3860,19138,2021-08-01
3174071001,JAKARTA SELATAN,KEBAYORAN BARU,MELAWAI,2627,1036,1591,1000,2591,2021-08-01
3171061001,JAKARTA PUSAT,MENTENG,MENTENG,25624,14132,11492,4684,16176,2021-08-01
3174021005,JAKARTA SELATAN,SETIA BUDI,MENTENG ATAS,27816,12856,14960,5584,20544,2021-08-01
3174011003,JAKARTA SELATAN,TEBET,MENTENG DALAM,36028,18083,17945,7527,25472,2021-08-01
3173081003,JAKARTA BARAT,KEMBANGAN,MERUYA SELATAN,32130,16667,15463,6217,21680,2021-08-01
3173081002,JAKARTA BARAT,KEMBANGAN,MERUYA UTARA,43752,21579,22173,9245,31418,2021-08-01
3175101004,JAKARTA TIMUR,CIPAYUNG,MUNJUL,23871,11761,12110,4774,16884,2021-08-01
3172051002,JAKARTA UTARA,PADEMANGAN,PADEMANGAN BARAT,74240,36400,37840,11335,49175,2021-08-01
3172051001,JAKARTA UTARA,PADEMANGAN,PADEMANGAN TIMUR,37736,15209,22527,9065,31592,2021-08-01
3175011004,JAKARTA TIMUR,MATRAMAN,PAL MERIAM,19769,10412,9357,3859,13216,2021-08-01
3173071001,JAKARTA BARAT,PALMERAH,PALMERAH,63011,31812,31199,10887,42086,2021-08-01
3174081001,JAKARTA SELATAN,PANCORAN,PANCORAN,19421,9222,10199,3860,14059,2021-08-01
3172021003,JAKARTA UTARA,TANJUNG PRIOK,PAPANGGO,39097,17749,21348,7049,28397,2021-08-01
3171021001,JAKARTA PUSAT,SAWAH BESAR,PASAR BARU,12035,4870,7165,3450,10615,2021-08-01
3174021006,JAKARTA SELATAN,SETIA BUDI,PASAR MANGGIS,26752,13117,13635,5331,18966,2021-08-01
3174041001,JAKARTA SELATAN,PASAR MINGGU,PASAR MINGGU,24821,11946,12875,6107,18982,2021-08-01
3171041003,JAKARTA PUSAT,SENEN,PASEBAN,23533,11355,12178,4395,16573,2021-08-01
3173061005,JAKARTA BARAT,KALI DERES,PEGADUNGAN,75587,35949,39638,15357,54995,2021-08-01
3171061002,JAKARTA PUSAT,MENTENG,PEGANGSAAN,23455,12864,10591,3915,14506,2021-08-01
3172061002,JAKARTA UTARA,KELAPA GADING,PEGANGSAAN DUA,49976,18369,31607,13865,45472,2021-08-01
3172011004,JAKARTA UTARA,PENJARINGAN,PEJAGALAN,74578,34724,39854,16975,56829,2021-08-01
3174041006,JAKARTA SELATAN,PASAR MINGGU,PEJATEN BARAT,37346,18161,19185,8277,27462,2021-08-01
3174041005,JAKARTA SELATAN,PASAR MINGGU,PEJATEN TIMUR,57656,31667,25989,10356,36345,2021-08-01
3175051005,JAKARTA TIMUR,PASAR REBO,PEKAYON,43250,20001,23249,8511,31760,2021-08-01
3173041009,JAKARTA BARAT,TAMBORA,PEKOJAN,23587,10612,12975,4961,17936,2021-08-01
3174031003,JAKARTA SELATAN,MAMPANG PRAPATAN,PELA MAMPANG,43522,19912,23610,8610,32220,2021-08-01
3174081005,JAKARTA SELATAN,PANCORAN,PENGADEGAN,21478,8937,12541,4572,17113,2021-08-01
3175061003,JAKARTA TIMUR,CAKUNG,PENGGILINGAN,99255,56227,43028,12753,55781,2021-08-01
3172011001,JAKARTA UTARA,PENJARINGAN,PENJARINGAN,88308,48117,40191,13434,53625,2021-08-01
3174101001,JAKARTA SELATAN,PESANGGRAHAN,PESANGGRAHAN,27545,12124,15421,6623,22044,2021-08-01
3171071004,JAKARTA PUSAT,TANAH ABANG,PETAMBURAN,33271,20197,13074,3894,16968,2021-08-01
3174071008,JAKARTA SELATAN,KEBAYORAN BARU,PETOGOGAN,11499,5465,6034,2766,8800,2021-08-01
3171011004,JAKARTA PUSAT,GAMBIR,PETOJO SELATAN,14692,7119,7573,3546,11119,2021-08-01
3171011003,JAKARTA PUSAT,GAMBIR,PETOJO UTARA,17458,9072,8386,3321,11707,2021-08-01
3174101004,JAKARTA SELATAN,PESANGGRAHAN,PETUKANGAN SELATAN,37187,16876,20311,6890,27201,2021-08-01
3174101003,JAKARTA SELATAN,PESANGGRAHAN,PETUKANGAN UTARA,53716,27134,26582,10528,37110,2021-08-01
3175081002,JAKARTA TIMUR,MAKASAR,PINANG RANTI,27198,13078,14120,5446,19566,2021-08-01
3173031008,JAKARTA BARAT,TAMAN SARI,PINANGSIA,10729,4396,6333,2261,8594,2021-08-01
3175011001,JAKARTA TIMUR,MATRAMAN,PISANGAN BARU,31776,17538,14238,5238,19476,2021-08-01
3175021002,JAKARTA TIMUR,PULO GADUNG,PISANGAN TIMUR,41011,20040,20971,7478,28449,2021-08-01
3172011005,JAKARTA UTARA,PENJARINGAN,PLUIT,47783,20886,26897,15932,42829,2021-08-01
3175071002,JAKARTA TIMUR,DUREN SAWIT,PONDOK BAMBU,61550,32570,28980,11994,40974,2021-08-01
3175071004,JAKARTA TIMUR,DUREN SAWIT,PONDOK KELAPA,72015,34991,37024,14542,51566,2021-08-01
3175071007,JAKARTA TIMUR,DUREN SAWIT,PONDOK KOPI,35367,20229,15138,5888,21026,2021-08-01
3174061003,JAKARTA SELATAN,CILANDAK,PONDOK LABU,46464,20591,25873,10630,36503,2021-08-01
3174051002,JAKARTA SELATAN,KEBAYORAN LAMA,PONDOK PINANG,56169,28141,28028,12794,40822,2021-08-01
3175101003,JAKARTA TIMUR,CIPAYUNG,PONDOK RANGGON,25574,13791,11783,4925,16708,2021-08-01
3101011003,KAB.ADM.KEP.SERIBU,KEP. SERIBU UTARA,PULAU HARAPAN,2060,468,1592,708,2300,2021-08-01
3101011002,KAB.ADM.KEP.SERIBU,KEP. SERIBU UTARA,PULAU KELAPA,5528,1220,4308,1379,5687,2021-08-01
3101011001,KAB.ADM.KEP.SERIBU,KEP. SERIBU UTARA,PULAU PANGGANG,5450,1063,4387,1282,5669,2021-08-01
3101021003,KAB.ADM.KEP.SERIBU,KEP. SERIBU SELATAN,PULAU PARI,2765,413,2352,697,3049,2021-08-01
3101021002,KAB.ADM.KEP.SERIBU,KEP. SERIBU SELATAN,PULAU TIDUNG,4553,891,3662,1519,5181,2021-08-01
3101021001,KAB.ADM.KEP.SERIBU,KEP. SERIBU SELATAN,PULAU UNTUNG JAWA,1941,445,1496,660,2156,2021-08-01
3174071007,JAKARTA SELATAN,KEBAYORAN BARU,PULO,5835,2381,3454,1887,5341,2021-08-01
3175021001,JAKARTA TIMUR,PULO GADUNG,PULO GADUNG,34422,18145,16277,6498,22775,2021-08-01
3175061005,JAKARTA TIMUR,CAKUNG,PULO GEBANG,97301,49906,47395,14071,61466,2021-08-01
3174041004,JAKARTA SELATAN,PASAR MINGGU,RAGUNAN,39616,17815,21801,8745,30546,2021-08-01
3175091005,JAKARTA TIMUR,CIRACAS,RAMBUTAN,36771,20545,16226,5880,22106,2021-08-01
3172031006,JAKARTA UTARA,KOJA,RAWA BADAK SELATAN,42179,22302,19877,5722,25599,2021-08-01
3172031004,JAKARTA UTARA,KOJA,RAWA BADAK UTARA,34408,17318,17090,5757,22847,2021-08-01
3174071005,JAKARTA SELATAN,KEBAYORAN BARU,RAWA BARAT,5625,2517,3108,1687,4795,2021-08-01
3173011003,JAKARTA BARAT,CENGKARENG,RAWA BUAYA,63799,33137,30662,9160,39822,2021-08-01
3175031004,JAKARTA TIMUR,JATINEGARA,RAWA BUNGA,21434,11756,9678,3211,12889,2021-08-01
3174081003,JAKARTA SELATAN,PANCORAN,RAWA JATI,20509,9213,11296,4607,15903,2021-08-01
3175061002,JAKARTA TIMUR,CAKUNG,RAWA TERATE,24637,11129,13508,3097,16605,2021-08-01
3175021005,JAKARTA TIMUR,PULO GADUNG,RAWAMANGUN,37612,18460,19152,7725,26877,2021-08-01
3171051003,JAKARTA PUSAT,CEMPAKA PUTIH,RAWASARI,21967,10528,11439,4724,16163,2021-08-01
3173041010,JAKARTA BARAT,TAMBORA,ROA MALAKA,3484,1355,2129,1123,3252,2021-08-01
3172041006,JAKARTA UTARA,CILINCING,ROROTAN,41668,18851,22817,6662,29479,2021-08-01
3174071004,JAKARTA SELATAN,KEBAYORAN BARU,SELONG,2842,1169,1673,1043,2716,2021-08-01
3173061002,JAKARTA BARAT,KALI DERES,SEMANAN,71354,36920,34434,7699,42133,2021-08-01
3172041007,JAKARTA UTARA,CILINCING,SEMPER BARAT,68587,29281,39306,12922,52228,2021-08-01
3172041005,JAKARTA UTARA,CILINCING,SEMPER TIMUR,36267,17330,18937,6483,25420,2021-08-01
3174071006,JAKARTA SELATAN,KEBAYORAN BARU,SENAYAN,2771,1471,1300,721,2021,2021-08-01
3171041001,JAKARTA PUSAT,SENEN,SENEN,6804,3080,3724,1476,5200,2021-08-01
3171031004,JAKARTA PUSAT,KEMAYORAN,SERDANG,29668,14375,15293,5536,20829,2021-08-01
3174021001,JAKARTA SELATAN,SETIA BUDI,SETIA BUDI,3023,1445,1578,799,2377,2021-08-01
3175101005,JAKARTA TIMUR,CIPAYUNG,SETU,20572,11594,8978,3498,12476,2021-08-01
3173071002,JAKARTA BARAT,PALMERAH,SLIPI,16591,7601,8990,3521,12511,2021-08-01
3173081004,JAKARTA BARAT,KEMBANGAN,SRENGSENG,45523,23839,21684,8197,29881,2021-08-01
3174091002,JAKARTA SELATAN,JAGAKARSA,SRENGSENG SAWAH,58196,25011,33185,13650,46835,2021-08-01
3173051003,JAKARTA BARAT,KEBON JERUK,SUKABUMI SELATAN,37033,20743,16290,5119,21409,2021-08-01
3173051002,JAKARTA BARAT,KEBON JERUK,SUKABUMI UTARA,38290,22453,15837,5596,21433,2021-08-01
3172041002,JAKARTA UTARA,CILINCING,SUKAPURA,53949,25995,27954,8061,36015,2021-08-01
3171031007,JAKARTA PUSAT,KEMAYORAN,SUMUR BATU,22717,10956,11761,5011,16772,2021-08-01
3172021004,JAKARTA UTARA,TANJUNG PRIOK,SUNGAI BAMBU,29876,13992,15884,6033,21917,2021-08-01
3172021006,JAKARTA UTARA,TANJUNG PRIOK,SUNTER AGUNG,71805,28858,42947,18309,61256,2021-08-01
3172021002,JAKARTA UTARA,TANJUNG PRIOK,SUNTER JAYA,63031,27274,35757,14583,50340,2021-08-01
3175091004,JAKARTA TIMUR,CIRACAS,SUSUKAN,38257,18887,19370,7116,26486,2021-08-01
3173031001,JAKARTA BARAT,TAMAN SARI,TAMAN SARI,14348,6291,8057,3412,11469,2021-08-01
3173041001,JAKARTA BARAT,TAMBORA,TAMBORA,10204,5283,4921,2095,7016,2021-08-01
3173041004,JAKARTA BARAT,TAMBORA,TANAH SEREAL,26387,10811,15576,5278,20854,2021-08-01
3171081004,JAKARTA PUSAT,JOHAR BARU,TANAH TINGGI,37693,16097,21596,6257,27853,2021-08-01
3173031004,JAKARTA BARAT,TAMAN SARI,TANGKI,13324,5881,7443,2853,10296,2021-08-01
3174091005,JAKARTA SELATAN,JAGAKARSA,TANJUNG BARAT,39770,19005,20765,8206,28971,2021-08-01
3173021005,JAKARTA BARAT,GROGOL PETAMBURAN,TANJUNG DUREN SELATAN,25337,10967,14370,5986,20356,2021-08-01
3173021002,JAKARTA BARAT,GROGOL PETAMBURAN,TANJUNG DUREN UTARA,17010,6926,10084,4540,14624,2021-08-01
3172021001,JAKARTA UTARA,TANJUNG PRIOK,TANJUNG PRIOK,34588,15030,19558,5374,24932,2021-08-01
3174011002,JAKARTA SELATAN,TEBET,TEBET BARAT,21194,9097,12097,5633,17730,2021-08-01
3174011001,JAKARTA SELATAN,TEBET,TEBET TIMUR,18199,7525,10674,4987,15661,2021-08-01
3173061003,JAKARTA BARAT,KALI DERES,TEGAL ALUR,83647,42727,40920,11112,52032,2021-08-01
3174031004,JAKARTA SELATAN,MAMPANG PRAPATAN,TEGAL PARANG,32401,16913,15488,5155,20643,2021-08-01
3173021003,JAKARTA BARAT,GROGOL PETAMBURAN,TOMANG,29605,13487,16118,6837,22955,2021-08-01
3172031005,JAKARTA UTARA,KOJA,TUGU SELATAN,39122,20058,19064,5541,24605,2021-08-01
3172031002,JAKARTA UTARA,KOJA,TUGU UTARA,67670,35250,32420,9786,42206,2021-08-01
3175061006,JAKARTA TIMUR,CAKUNG,UJUNG MENTENG,29934,13486,16448,5449,21897,2021-08-01
3174101005,JAKARTA SELATAN,PESANGGRAHAN,ULUJAMI,40544,21044,19500,6889,26389,2021-08-01
3175011006,JAKARTA TIMUR,MATRAMAN,UTAN KAYU SELATAN,33511,16402,17109,6971,24080,2021-08-01
3175011002,JAKARTA TIMUR,MATRAMAN,UTAN KAYU UTARA,28169,14292,13877,5441,19318,2021-08-01
3171031008,JAKARTA PUSAT,KEMAYORAN,UTAN PANJANG,29208,14785,14423,4112,18535,2021-08-01
3172021007,JAKARTA UTARA,TANJUNG PRIOK,WARAKAS,44401,20662,23739,7995,31734,2021-08-01
3173021007,JAKARTA BARAT,GROGOL PETAMBURAN,WIJAYA KUSUMA,38934,19184,19750,7083,26833,2021-08-01
3172051003,JAKARTA UTARA,PADEMANGAN,ANCOL,23947,12052,11895,4298,16193,2021-08-02
3173041007,JAKARTA BARAT,TAMBORA,ANGKE,29381,13534,15847,4953,20800,2021-08-02
3175041005,JAKARTA TIMUR,KRAMAT JATI,BALE KAMBANG,29074,18057,11017,3744,14761,2021-08-02
3175031003,JAKARTA TIMUR,JATINEGARA,BALI MESTER,9752,4961,4791,2045,6836,2021-08-02
3175101006,JAKARTA TIMUR,CIPAYUNG,BAMBU APUS,26285,13527,12758,5261,18019,2021-08-02
3174031002,JAKARTA SELATAN,MAMPANG PRAPATAN,BANGKA,21566,10206,11360,4113,15473,2021-08-02
3175051002,JAKARTA TIMUR,PASAR REBO,BARU,23886,9938,13948,6172,20120,2021-08-02
3175041004,JAKARTA TIMUR,KRAMAT JATI,BATU AMPAR,47898,28015,19883,7435,27318,2021-08-02
3171071002,JAKARTA PUSAT,TANAH ABANG,BENDUNGAN HILIR,21494,9831,11663,4690,16353,2021-08-02
3175031002,JAKARTA TIMUR,JATINEGARA,BIDARA CINA,36689,21574,15115,5600,20715,2021-08-02
3174101002,JAKARTA SELATAN,PESANGGRAHAN,BINTARO,53098,24918,28180,10018,38198,2021-08-02
3174011005,JAKARTA SELATAN,TEBET,BUKIT DURI,34183,17677,16506,6312,22818,2021-08-02
3171041006,JAKARTA PUSAT,SENEN,BUNGUR,18144,8289,9855,3835,13690,2021-08-02
3175061007,JAKARTA TIMUR,CAKUNG,CAKUNG BARAT,57724,25671,32053,7427,39480,2021-08-02
3175061004,JAKARTA TIMUR,CAKUNG,CAKUNG TIMUR,58287,27081,31206,10383,41589,2021-08-02
3175041007,JAKARTA TIMUR,KRAMAT JATI,CAWANG,32762,17645,15117,6017,21134,2021-08-02
3175101008,JAKARTA TIMUR,CIPAYUNG,CEGER,18932,9019,9913,3511,13424,2021-08-02
3171031006,JAKARTA PUSAT,KEMAYORAN,CEMPAKA BARU,32581,17115,15466,5652,21118,2021-08-02
3171051002,JAKARTA PUSAT,CEMPAKA PUTIH,CEMPAKA PUTIH BARAT,35885,17268,18617,6715,25332,2021-08-02
3171051001,JAKARTA PUSAT,CEMPAKA PUTIH,CEMPAKA PUTIH TIMUR,24292,11578,12714,5895,18609,2021-08-02
3173011001,JAKARTA BARAT,CENGKARENG,CENGKARENG BARAT,66284,31157,35127,13300,48427,2021-08-02
3173011006,JAKARTA BARAT,CENGKARENG,CENGKARENG TIMUR,81027,41346,39681,14612,54293,2021-08-02
3175091002,JAKARTA TIMUR,CIRACAS,CIBUBUR,66364,30650,35714,13979,49693,2021-08-02
3171011002,JAKARTA PUSAT,GAMBIR,CIDENG,15390,6833,8557,3985,12542,2021-08-02
3174091003,JAKARTA SELATAN,JAGAKARSA,CIGANJUR,38497,18242,20255,7756,28011,2021-08-02
3175051003,JAKARTA TIMUR,PASAR REBO,CIJANTUNG,41419,19634,21785,8987,30772,2021-08-02
3171061003,JAKARTA PUSAT,MENTENG,CIKINI,8274,4332,3942,1849,5791,2021-08-02
3174081006,JAKARTA SELATAN,PANCORAN,CIKOKO,10547,4355,6192,2269,8461,2021-08-02
3174061001,JAKARTA SELATAN,CILANDAK,CILANDAK BARAT,51752,22872,28880,11968,40848,2021-08-02
3174041003,JAKARTA SELATAN,PASAR MINGGU,CILANDAK TIMUR,25145,11264,13881,6620,20501,2021-08-02
3175101002,JAKARTA TIMUR,CIPAYUNG,CILANGKAP,27635,13710,13925,5279,19204,2021-08-02
3175041006,JAKARTA TIMUR,KRAMAT JATI,CILILITAN,40181,22114,18067,7327,25394,2021-08-02
3172041001,JAKARTA UTARA,CILINCING,CILINCING,43609,22585,21024,6152,27176,2021-08-02
3175101001,JAKARTA TIMUR,CIPAYUNG,CIPAYUNG,26104,12172,13932,5660,19592,2021-08-02
3174091006,JAKARTA SELATAN,JAGAKARSA,CIPEDAK,38303,16620,21683,7823,29506,2021-08-02
3174061005,JAKARTA SELATAN,CILANDAK,CIPETE SELATAN,26704,12369,14335,5875,20210,2021-08-02
3174071010,JAKARTA SELATAN,KEBAYORAN BARU,CIPETE UTARA,34102,15899,18203,6296,24499,2021-08-02
3175021003,JAKARTA TIMUR,PULO GADUNG,CIPINANG,39306,19647,19659,8189,27848,2021-08-02
3175031007,JAKARTA TIMUR,JATINEGARA,CIPINANG BESAR SELATAN,35212,20231,14981,5347,20328,2021-08-02
3175031008,JAKARTA TIMUR,JATINEGARA,CIPINANG BESAR UTARA,45319,25718,19601,5821,25422,2021-08-02
3175031005,JAKARTA TIMUR,JATINEGARA,CIPINANG CEMPEDAK,32824,18041,14783,6167,20950,2021-08-02
3175081005,JAKARTA TIMUR,MAKASAR,CIPINANG MELAYU,42308,20763,21545,9019,30564,2021-08-02
3175031006,JAKARTA TIMUR,JATINEGARA,CIPINANG MUARA,55243,30649,24594,9707,34301,2021-08-02
3174051003,JAKARTA SELATAN,KEBAYORAN LAMA,CIPULIR,39937,20827,19110,7153,26263,2021-08-02
3175091001,JAKARTA TIMUR,CIRACAS,CIRACAS,64594,29883,34711,12342,47053,2021-08-02
3175041003,JAKARTA TIMUR,KRAMAT JATI,DUKUH,24609,12888,11721,4757,16478,2021-08-02
3175071001,JAKARTA TIMUR,DUREN SAWIT,DUREN SAWIT,61160,33093,28067,12697,40764,2021-08-02
3174081004,JAKARTA SELATAN,PANCORAN,DUREN TIGA,28319,12982,15337,5332,20669,2021-08-02
3173051005,JAKARTA BARAT,KEBON JERUK,DURI KEPA,60138,26294,33844,13640,47484,2021-08-02
3173011002,JAKARTA BARAT,CENGKARENG,DURI KOSAMBI,77923,40844,37079,12918,49997,2021-08-02
3171011006,JAKARTA PUSAT,GAMBIR,DURI PULO,19610,9839,9771,3225,12996,2021-08-02
3173041011,JAKARTA BARAT,TAMBORA,DURI SELATAN,14259,6127,8132,3038,11170,2021-08-02
3173041003,JAKARTA BARAT,TAMBORA,DURI UTARA,19844,9049,10795,3585,14380,2021-08-02
3171081003,JAKARTA PUSAT,JOHAR BARU,GALUR,18243,7658,10585,2965,13550,2021-08-02
3171011001,JAKARTA PUSAT,GAMBIR,GAMBIR,2191,938,1253,626,1879,2021-08-02
3174061004,JAKARTA SELATAN,CILANDAK,GANDARIA SELATAN,22119,10313,11806,4574,16380,2021-08-02
3174071009,JAKARTA SELATAN,KEBAYORAN BARU,GANDARIA UTARA,39922,19103,20819,7853,28672,2021-08-02
3175051001,JAKARTA TIMUR,PASAR REBO,GEDONG,35755,17645,18110,7327,25437,2021-08-02
3171071001,JAKARTA PUSAT,TANAH ABANG,GELORA,3127,1462,1665,717,2382,2021-08-02
3173031007,JAKARTA BARAT,TAMAN SARI,GLODOK,7837,2906,4931,2682,7613,2021-08-02
3171061004,JAKARTA PUSAT,MENTENG,GONDANGDIA,4100,1758,2342,1518,3860,2021-08-02
3173021001,JAKARTA BARAT,GROGOL PETAMBURAN,GROGOL,16876,7854,9022,3613,12635,2021-08-02
3174051005,JAKARTA SELATAN,KEBAYORAN LAMA,GROGOL SELATAN,44251,22700,21551,7915,29466,2021-08-02
3174051004,JAKARTA SELATAN,KEBAYORAN LAMA,GROGOL UTARA,42494,21286,21208,7896,29104,2021-08-02
3174021007,JAKARTA SELATAN,SETIA BUDI,GUNTUR,3985,1706,2279,1221,3500,2021-08-02
3174071002,JAKARTA SELATAN,KEBAYORAN BARU,GUNUNG,9436,4176,5260,2694,7954,2021-08-02
3171031005,JAKARTA PUSAT,KEMAYORAN,GUNUNG SAHARI SELATAN,19199,9085,10114,4274,14388,2021-08-02
3171021004,JAKARTA PUSAT,SAWAH BESAR,GUNUNG SAHARI UTARA,16650,6692,9958,4494,14452,2021-08-02
3175081004,JAKARTA TIMUR,MAKASAR,HALIM PERDANA KUSUMAH,28363,9851,18512,11037,29549,2021-08-02
3171031003,JAKARTA PUSAT,KEMAYORAN,HARAPAN MULIA,22557,11211,11346,4009,15355,2021-08-02
3174091001,JAKARTA SELATAN,JAGAKARSA,JAGAKARSA,62389,27767,34622,13921,48543,2021-08-02
3175021007,JAKARTA TIMUR,PULO GADUNG,JATI,32757,16411,16346,7368,23714,2021-08-02
3174041002,JAKARTA SELATAN,PASAR MINGGU,JATI PADANG,37502,18035,19467,8391,27858,2021-08-02
3173071004,JAKARTA BARAT,PALMERAH,JATI PULO,28738,12610,16128,4743,20871,2021-08-02
3175061001,JAKARTA TIMUR,CAKUNG,JATINEGARA,84160,44404,39756,10835,50591,2021-08-02
3175021004,JAKARTA TIMUR,PULO GADUNG,JATINEGARA KAUM,24632,12121,12511,4075,16586,2021-08-02
3173021004,JAKARTA BARAT,GROGOL PETAMBURAN,JELAMBAR,30266,13700,16566,7691,24257,2021-08-02
3173021006,JAKARTA BARAT,GROGOL PETAMBURAN,JELAMBAR BARU,38246,17852,20394,8953,29347,2021-08-02
3173041006,JAKARTA BARAT,TAMBORA,JEMBATAN BESI,29314,17080,12234,3500,15734,2021-08-02
3173041008,JAKARTA BARAT,TAMBORA,JEMBATAN LIMA,21021,11588,9433,3437,12870,2021-08-02
3173081005,JAKARTA BARAT,KEMBANGAN,JOGLO,40839,20373,20466,8151,28617,2021-08-02
3171081001,JAKARTA PUSAT,JOHAR BARU,JOHAR BARU,37488,16329,21159,7507,28666,2021-08-02
3173041002,JAKARTA BARAT,TAMBORA,KALI ANYAR,23856,12129,11727,3027,14754,2021-08-02
3172041004,JAKARTA UTARA,CILINCING,KALIBARU,67684,37039,30645,7229,37874,2021-08-02
3174081002,JAKARTA SELATAN,PANCORAN,KALIBATA,41994,22250,19744,7120,26864,2021-08-02
3173061001,JAKARTA BARAT,KALI DERES,KALIDERES,72447,35371,37076,11992,49068,2021-08-02
3175051004,JAKARTA TIMUR,PASAR REBO,KALISARI,43212,20466,22746,9489,32235,2021-08-02
3173061004,JAKARTA BARAT,KALI DERES,KAMAL,53783,28756,25027,5528,30555,2021-08-02
3172011002,JAKARTA UTARA,PENJARINGAN,KAMAL MUARA,12930,4464,8466,3861,12327,2021-08-02
3171071007,JAKARTA PUSAT,TANAH ABANG,KAMPUNG BALI,11358,6349,5009,1921,6930,2021-08-02
3175031001,JAKARTA TIMUR,JATINEGARA,KAMPUNG MELAYU,25717,14711,11006,3434,14440,2021-08-02
3171081002,JAKARTA PUSAT,JOHAR BARU,KAMPUNG RAWA,21237,7943,13294,3788,17082,2021-08-02
3175041002,JAKARTA TIMUR,KRAMAT JATI,KAMPUNG TENGAH,43993,25980,18013,7101,25114,2021-08-02
3173011005,JAKARTA BARAT,CENGKARENG,KAPUK,134466,72895,61571,16201,77772,2021-08-02
3172011003,JAKARTA UTARA,PENJARINGAN,KAPUK MUARA,35781,14794,20987,9541,30528,2021-08-02
3171021002,JAKARTA PUSAT,SAWAH BESAR,KARANG ANYAR,25761,12046,13715,4826,18541,2021-08-02
3174021004,JAKARTA SELATAN,SETIA BUDI,KARET,9623,4673,4950,2104,7054,2021-08-02
3174021003,JAKARTA SELATAN,SETIA BUDI,KARET KUNINGAN,16055,7073,8982,3465,12447,2021-08-02
3174021002,JAKARTA SELATAN,SETIA BUDI,KARET SEMANGGI,2770,1134,1636,845,2481,2021-08-02
3171071003,JAKARTA PUSAT,TANAH ABANG,KARET TENGSIN,19271,9022,10249,3211,13460,2021-08-02
3171021003,JAKARTA PUSAT,SAWAH BESAR,KARTINI,22292,10152,12140,4923,17063,2021-08-02
3175011003,JAKARTA TIMUR,MATRAMAN,KAYU MANIS,25284,13740,11544,4238,15782,2021-08-02
3175021006,JAKARTA TIMUR,PULO GADUNG,KAYU PUTIH,40696,18277,22419,9883,32302,2021-08-02
3173031006,JAKARTA BARAT,TAMAN SARI,KEAGUNGAN,17387,7908,9479,3326,12805,2021-08-02
3174041007,JAKARTA SELATAN,PASAR MINGGU,KEBAGUSAN,44552,22791,21761,8387,30148,2021-08-02
3174051006,JAKARTA SELATAN,KEBAYORAN LAMA,KEBAYORAN LAMA SELATAN,41212,19264,21948,8366,30314,2021-08-02
3174051001,JAKARTA SELATAN,KEBAYORAN LAMA,KEBAYORAN LAMA UTARA,42422,21898,20524,7399,27923,2021-08-02
3174011004,JAKARTA SELATAN,TEBET,KEBON BARU,35165,16931,18234,7229,25463,2021-08-02
3172021005,JAKARTA UTARA,TANJUNG PRIOK,KEBON BAWANG,50952,23987,26965,9821,36786,2021-08-02
3173051001,JAKARTA BARAT,KEBON JERUK,KEBON JERUK,53887,28373,25514,9325,34839,2021-08-02
3171071006,JAKARTA PUSAT,TANAH ABANG,KEBON KACANG,21531,12312,9219,3399,12618,2021-08-02
3171011005,JAKARTA PUSAT,GAMBIR,KEBON KELAPA,10163,4748,5415,2189,7604,2021-08-02
3171031002,JAKARTA PUSAT,KEMAYORAN,KEBON KOSONG,30019,14635,15384,5258,20642,2021-08-02
3175011005,JAKARTA TIMUR,MATRAMAN,KEBON MANGGIS,16490,7715,8775,3810,12585,2021-08-02
3171071005,JAKARTA PUSAT,TANAH ABANG,KEBON MELATI,32206,19283,12923,3767,16690,2021-08-02
3175081003,JAKARTA TIMUR,MAKASAR,KEBON PALA,46614,23765,22849,8492,31341,2021-08-02
3171061005,JAKARTA PUSAT,MENTENG,KEBON SIRIH,12299,6394,5905,2117,8022,2021-08-02
3173011004,JAKARTA BARAT,CENGKARENG,KEDAUNG KALI ANGKE,32612,13344,19268,4973,24241,2021-08-02
3173051007,JAKARTA BARAT,KEBON JERUK,KEDOYA SELATAN,32165,14551,17614,6278,23892,2021-08-02
3173051006,JAKARTA BARAT,KEBON JERUK,KEDOYA UTARA,45740,19492,26248,9376,35624,2021-08-02
3173051004,JAKARTA BARAT,KEBON JERUK,KELAPA DUA,23565,11695,11870,4364,16234,2021-08-02
3175091003,JAKARTA TIMUR,CIRACAS,KELAPA DUA WETAN,46875,21714,25161,9711,34872,2021-08-02
3172061003,JAKARTA UTARA,KELAPA GADING,KELAPA GADING BARAT,35717,13924,21793,11029,32822,2021-08-02
3172061001,JAKARTA UTARA,KELAPA GADING,KELAPA GADING TIMUR,33592,11999,21593,11699,33292,2021-08-02
3173071005,JAKARTA BARAT,PALMERAH,KEMANGGISAN,32139,15810,16329,6502,22831,2021-08-02
3171031001,JAKARTA PUSAT,KEMAYORAN,KEMAYORAN,20708,9355,11353,4169,15522,2021-08-02
3173081006,JAKARTA BARAT,KEMBANGAN,KEMBANGAN SELATAN,27130,12718,14412,6425,20837,2021-08-02
3173081001,JAKARTA BARAT,KEMBANGAN,KEMBANGAN UTARA,54451,25778,28673,8766,37439,2021-08-02
3171041002,JAKARTA PUSAT,SENEN,KENARI,9579,4108,5471,2210,7681,2021-08-02
3173041005,JAKARTA BARAT,TAMBORA,KERENDANG,19973,9720,10253,3160,13413,2021-08-02
3175071003,JAKARTA TIMUR,DUREN SAWIT,KLENDER,69978,40722,29256,10940,40196,2021-08-02
3172031001,JAKARTA UTARA,KOJA,KOJA,28175,13534,14641,4579,19220,2021-08-02
3173071006,JAKARTA BARAT,PALMERAH,KOTA BAMBU SELATAN,21158,10436,10722,3175,13897,2021-08-02
3173071003,JAKARTA BARAT,PALMERAH,KOTA BAMBU UTARA,24995,12504,12491,3613,16104,2021-08-02
3171041004,JAKARTA PUSAT,SENEN,KRAMAT,28835,14995,13840,4431,18271,2021-08-02
3175041001,JAKARTA TIMUR,KRAMAT JATI,KRAMAT JATI,34144,18096,16048,6448,22496,2021-08-02
3174071003,JAKARTA SELATAN,KEBAYORAN BARU,KRAMAT PELA,14413,6542,7871,3290,11161,2021-08-02
3173031002,JAKARTA BARAT,TAMAN SARI,KRUKUT,19244,8975,10269,3216,13485,2021-08-02
3174031005,JAKARTA SELATAN,MAMPANG PRAPATAN,KUNINGAN BARAT,12785,5826,6959,2489,9448,2021-08-02
3174021008,JAKARTA SELATAN,SETIA BUDI,KUNINGAN TIMUR,6008,2864,3144,1434,4578,2021-08-02
3171041005,JAKARTA PUSAT,SENEN,KWITANG,15486,7344,8142,2972,11114,2021-08-02
3172031003,JAKARTA UTARA,KOJA,LAGOA,59065,30550,28515,8678,37193,2021-08-02
3174061002,JAKARTA SELATAN,CILANDAK,LEBAK BULUS,37626,18107,19519,8484,28003,2021-08-02
3174091004,JAKARTA SELATAN,JAGAKARSA,LENTENG AGUNG,53946,27448,26498,9352,35850,2021-08-02
3175101007,JAKARTA TIMUR,CIPAYUNG,LUBANG BUAYA,63547,31269,32278,13749,46027,2021-08-02
3175081001,JAKARTA TIMUR,MAKASAR,MAKASAR,34390,16663,17727,7331,25058,2021-08-02
3175071006,JAKARTA TIMUR,DUREN SAWIT,MALAKA JAYA,30927,14341,16586,7274,23860,2021-08-02
3175071005,JAKARTA TIMUR,DUREN SAWIT,MALAKA SARI,27530,12629,14901,6923,21824,2021-08-02
3174031001,JAKARTA SELATAN,MAMPANG PRAPATAN,MAMPANG PRAPATAN,18159,8710,9449,3514,12963,2021-08-02
3173031005,JAKARTA BARAT,TAMAN SARI,MANGGA BESAR,7707,3021,4686,2126,6812,2021-08-02
3171021005,JAKARTA PUSAT,SAWAH BESAR,MANGGA DUA SELATAN,27442,13080,14362,5642,20004,2021-08-02
3174011007,JAKARTA SELATAN,TEBET,MANGGARAI,28373,13733,14640,5019,19659,2021-08-02
3174011006,JAKARTA SELATAN,TEBET,MANGGARAI SELATAN,23075,10599,12476,5344,17820,2021-08-02
3173031003,JAKARTA BARAT,TAMAN SARI,MAPHAR,16461,7400,9061,3648,12709,2021-08-02
3172041003,JAKARTA UTARA,CILINCING,MARUNDA,28943,13571,15372,3868,19240,2021-08-02
3174071001,JAKARTA SELATAN,KEBAYORAN BARU,MELAWAI,2627,1033,1594,1003,2597,2021-08-02
3171061001,JAKARTA PUSAT,MENTENG,MENTENG,25624,14078,11546,4709,16255,2021-08-02
3174021005,JAKARTA SELATAN,SETIA BUDI,MENTENG ATAS,27816,12772,15044,5617,20661,2021-08-02
3174011003,JAKARTA SELATAN,TEBET,MENTENG DALAM,36028,17736,18292,7562,25854,2021-08-02
3173081003,JAKARTA BARAT,KEMBANGAN,MERUYA SELATAN,32130,16290,15840,6269,22109,2021-08-02
3173081002,JAKARTA BARAT,KEMBANGAN,MERUYA UTARA,43752,21367,22385,9356,31741,2021-08-02
3175101004,JAKARTA TIMUR,CIPAYUNG,MUNJUL,23871,11648,12223,4795,17018,2021-08-02
3172051002,JAKARTA UTARA,PADEMANGAN,PADEMANGAN BARAT,74240,36184,38056,11791,49847,2021-08-02
3172051001,JAKARTA UTARA,PADEMANGAN,PADEMANGAN TIMUR,37736,15172,22564,9218,31782,2021-08-02
3175011004,JAKARTA TIMUR,MATRAMAN,PAL MERIAM,19769,10284,9485,3893,13378,2021-08-02
3173071001,JAKARTA BARAT,PALMERAH,PALMERAH,63011,31459,31552,10973,42525,2021-08-02
3174081001,JAKARTA SELATAN,PANCORAN,PANCORAN,19421,9020,10401,3889,14290,2021-08-02
3172021003,JAKARTA UTARA,TANJUNG PRIOK,PAPANGGO,39097,17637,21460,7091,28551,2021-08-02
3171021001,JAKARTA PUSAT,SAWAH BESAR,PASAR BARU,12035,4853,7182,3470,10652,2021-08-02
3174021006,JAKARTA SELATAN,SETIA BUDI,PASAR MANGGIS,26752,13083,13669,5347,19016,2021-08-02
3174041001,JAKARTA SELATAN,PASAR MINGGU,PASAR MINGGU,24821,11754,13067,6117,19184,2021-08-02
3171041003,JAKARTA PUSAT,SENEN,PASEBAN,23533,11226,12307,4424,16731,2021-08-02
3173061005,JAKARTA BARAT,KALI DERES,PEGADUNGAN,75587,35512,40075,15426,55501,2021-08-02
3171061002,JAKARTA PUSAT,MENTENG,PEGANGSAAN,23455,12793,10662,3931,14593,2021-08-02
3172061002,JAKARTA UTARA,KELAPA GADING,PEGANGSAAN DUA,49976,18232,31744,13926,45670,2021-08-02
3172011004,JAKARTA UTARA,PENJARINGAN,PEJAGALAN,74578,34550,40028,17138,57166,2021-08-02
3174041006,JAKARTA SELATAN,PASAR MINGGU,PEJATEN BARAT,37346,18088,19258,8309,27567,2021-08-02
3174041005,JAKARTA SELATAN,PASAR MINGGU,PEJATEN TIMUR,57656,31239,26417,10399,36816,2021-08-02
3175051005,JAKARTA TIMUR,PASAR REBO,PEKAYON,43250,19779,23471,8583,32054,2021-08-02
3173041009,JAKARTA BARAT,TAMBORA,PEKOJAN,23587,10476,13111,5003,18114,2021-08-02
3174031003,JAKARTA SELATAN,MAMPANG PRAPATAN,PELA MAMPANG,43522,19817,23705,8632,32337,2021-08-02
3174081005,JAKARTA SELATAN,PANCORAN,PENGADEGAN,21478,8927,12551,4587,17138,2021-08-02
3175061003,JAKARTA TIMUR,CAKUNG,PENGGILINGAN,99255,55892,43363,12895,56258,2021-08-02
3172011001,JAKARTA UTARA,PENJARINGAN,PENJARINGAN,88308,47757,40551,13500,54051,2021-08-02
3174101001,JAKARTA SELATAN,PESANGGRAHAN,PESANGGRAHAN,27545,11963,15582,6651,22233,2021-08-02
3171071004,JAKARTA PUSAT,TANAH ABANG,PETAMBURAN,33271,19886,13385,3947,17332,2021-08-02
3174071008,JAKARTA SELATAN,KEBAYORAN BARU,PETOGOGAN,11499,5403,6096,2776,8872,2021-08-02
3171011004,JAKARTA PUSAT,GAMBIR,PETOJO SELATAN,14692,7063,7629,3558,11187,2021-08-02
3171011003,JAKARTA PUSAT,GAMBIR,PETOJO UTARA,17458,9007,8451,3349,11800,2021-08-02
3174101004,JAKARTA SELATAN,PESANGGRAHAN,PETUKANGAN SELATAN,37187,16771,20416,6920,27336,2021-08-02
3174101003,JAKARTA SELATAN,PESANGGRAHAN,PETUKANGAN UTARA,53716,26847,26869,10572,37441,2021-08-02
3175081002,JAKARTA TIMUR,MAKASAR,PINANG RANTI,27198,13049,14149,5471,19620,2021-08-02
3173031008,JAKARTA BARAT,TAMAN SARI,PINANGSIA,10729,4379,6350,2294,8644,2021-08-02
3175011001,JAKARTA TIMUR,MATRAMAN,PISANGAN BARU,31776,17387,14389,5274,19663,2021-08-02
3175021002,JAKARTA TIMUR,PULO GADUNG,PISANGAN TIMUR,41011,19719,21292,7536,28828,2021-08-02
3172011005,JAKARTA UTARA,PENJARINGAN,PLUIT,47783,20719,27064,16038,43102,2021-08-02
3175071002,JAKARTA TIMUR,DUREN SAWIT,PONDOK BAMBU,61550,32423,29127,12045,41172,2021-08-02
3175071004,JAKARTA TIMUR,DUREN SAWIT,PONDOK KELAPA,72015,34739,37276,14633,51909,2021-08-02
3175071007,JAKARTA TIMUR,DUREN SAWIT,PONDOK KOPI,35367,19850,15517,5920,21437,2021-08-02
3174061003,JAKARTA SELATAN,CILANDAK,PONDOK LABU,46464,20474,25990,10657,36647,2021-08-02
3174051002,JAKARTA SELATAN,KEBAYORAN LAMA,PONDOK PINANG,56169,27711,28458,13081,41539,2021-08-02
3175101003,JAKARTA TIMUR,CIPAYUNG,PONDOK RANGGON,25574,13708,11866,4951,16817,2021-08-02
3101011003,KAB.ADM.KEP.SERIBU,KEP. SERIBU UTARA,PULAU HARAPAN,2060,467,1593,708,2301,2021-08-02
3101011002,KAB.ADM.KEP.SERIBU,KEP. SERIBU UTARA,PULAU KELAPA,5528,1219,4309,1380,5689,2021-08-02
3101011001,KAB.ADM.KEP.SERIBU,KEP. SERIBU UTARA,PULAU PANGGANG,5450,1060,4390,1283,5673,2021-08-02
3101021003,KAB.ADM.KEP.SERIBU,KEP. SERIBU SELATAN,PULAU PARI,2765,413,2352,697,3049,2021-08-02
3101021002,KAB.ADM.KEP.SERIBU,KEP. SERIBU SELATAN,PULAU TIDUNG,4553,887,3666,1521,5187,2021-08-02
3101021001,KAB.ADM.KEP.SERIBU,KEP. SERIBU SELATAN,PULAU UNTUNG JAWA,1941,438,1503,671,2174,2021-08-02
3174071007,JAKARTA SELATAN,KEBAYORAN BARU,PULO,5835,2373,3462,1887,5349,2021-08-02
3175021001,JAKARTA TIMUR,PULO GADUNG,PULO GADUNG,34422,17855,16567,6543,23110,2021-08-02
3175061005,JAKARTA TIMUR,CAKUNG,PULO GEBANG,97301,49692,47609,14173,61782,2021-08-02
3174041004,JAKARTA SELATAN,PASAR MINGGU,RAGUNAN,39616,17712,21904,8780,30684,2021-08-02
3175091005,JAKARTA TIMUR,CIRACAS,RAMBUTAN,36771,20332,16439,5925,22364,2021-08-02
3172031006,JAKARTA UTARA,KOJA,RAWA BADAK SELATAN,42179,22209,19970,5741,25711,2021-08-02
3172031004,JAKARTA UTARA,KOJA,RAWA BADAK UTARA,34408,17278,17130,5785,22915,2021-08-02
3174071005,JAKARTA SELATAN,KEBAYORAN BARU,RAWA BARAT,5625,2483,3142,1692,4834,2021-08-02
3173011003,JAKARTA BARAT,CENGKARENG,RAWA BUAYA,63799,32820,30979,9239,40218,2021-08-02
3175031004,JAKARTA TIMUR,JATINEGARA,RAWA BUNGA,21434,11648,9786,3231,13017,2021-08-02
3174081003,JAKARTA SELATAN,PANCORAN,RAWA JATI,20509,9179,11330,4614,15944,2021-08-02
3175061002,JAKARTA TIMUR,CAKUNG,RAWA TERATE,24637,10952,13685,3116,16801,2021-08-02
3175021005,JAKARTA TIMUR,PULO GADUNG,RAWAMANGUN,37612,18213,19399,7782,27181,2021-08-02
3171051003,JAKARTA PUSAT,CEMPAKA PUTIH,RAWASARI,21967,10377,11590,4760,16350,2021-08-02
3173041010,JAKARTA BARAT,TAMBORA,ROA MALAKA,3484,1353,2131,1130,3261,2021-08-02
3172041006,JAKARTA UTARA,CILINCING,ROROTAN,41668,18820,22848,6688,29536,2021-08-02
3174071004,JAKARTA SELATAN,KEBAYORAN BARU,SELONG,2842,1167,1675,1046,2721,2021-08-02
3173061002,JAKARTA BARAT,KALI DERES,SEMANAN,71354,36864,34490,7755,42245,2021-08-02
3172041007,JAKARTA UTARA,CILINCING,SEMPER BARAT,68587,29196,39391,12968,52359,2021-08-02
3172041005,JAKARTA UTARA,CILINCING,SEMPER TIMUR,36267,17227,19040,6504,25544,2021-08-02
3174071006,JAKARTA SELATAN,KEBAYORAN BARU,SENAYAN,2771,1457,1314,725,2039,2021-08-02
3171041001,JAKARTA PUSAT,SENEN,SENEN,6804,3074,3730,1482,5212,2021-08-02
3171031004,JAKARTA PUSAT,KEMAYORAN,SERDANG,29668,14347,15321,5567,20888,2021-08-02
3174021001,JAKARTA SELATAN,SETIA BUDI,SETIA BUDI,3023,1441,1582,805,2387,2021-08-02
3175101005,JAKARTA TIMUR,CIPAYUNG,SETU,20572,11431,9141,3513,12654,2021-08-02
3173071002,JAKARTA BARAT,PALMERAH,SLIPI,16591,7589,9002,3530,12532,2021-08-02
3173081004,JAKARTA BARAT,KEMBANGAN,SRENGSENG,45523,23549,21974,8270,30244,2021-08-02
3174091002,JAKARTA SELATAN,JAGAKARSA,SRENGSENG SAWAH,58196,24946,33250,13696,46946,2021-08-02
3173051003,JAKARTA BARAT,KEBON JERUK,SUKABUMI SELATAN,37033,20370,16663,5141,21804,2021-08-02
3173051002,JAKARTA BARAT,KEBON JERUK,SUKABUMI UTARA,38290,22188,16102,5619,21721,2021-08-02
3172041002,JAKARTA UTARA,CILINCING,SUKAPURA,53949,25905,28044,8114,36158,2021-08-02
3171031007,JAKARTA PUSAT,KEMAYORAN,SUMUR BATU,22717,10923,11794,5037,16831,2021-08-02
3172021004,JAKARTA UTARA,TANJUNG PRIOK,SUNGAI BAMBU,29876,13925,15951,6063,22014,2021-08-02
3172021006,JAKARTA UTARA,TANJUNG PRIOK,SUNTER AGUNG,71805,28767,43038,18489,61527,2021-08-02
3172021002,JAKARTA UTARA,TANJUNG PRIOK,SUNTER JAYA,63031,27157,35874,14688,50562,2021-08-02
3175091004,JAKARTA TIMUR,CIRACAS,SUSUKAN,38257,18719,19538,7183,26721,2021-08-02
3173031001,JAKARTA BARAT,TAMAN SARI,TAMAN SARI,14348,6267,8081,3449,11530,2021-08-02
3173041001,JAKARTA BARAT,TAMBORA,TAMBORA,10204,5222,4982,2121,7103,2021-08-02
3173041004,JAKARTA BARAT,TAMBORA,TANAH SEREAL,26387,10246,16141,5330,21471,2021-08-02
3171081004,JAKARTA PUSAT,JOHAR BARU,TANAH TINGGI,37693,15972,21721,6289,28010,2021-08-02
3173031004,JAKARTA BARAT,TAMAN SARI,TANGKI,13324,5830,7494,2883,10377,2021-08-02
3174091005,JAKARTA SELATAN,JAGAKARSA,TANJUNG BARAT,39770,18733,21037,8248,29285,2021-08-02
3173021005,JAKARTA BARAT,GROGOL PETAMBURAN,TANJUNG DUREN SELATAN,25337,10944,14393,6048,20441,2021-08-02
3173021002,JAKARTA BARAT,GROGOL PETAMBURAN,TANJUNG DUREN UTARA,17010,6908,10102,4578,14680,2021-08-02
3172021001,JAKARTA UTARA,TANJUNG PRIOK,TANJUNG PRIOK,34588,14854,19734,5395,25129,2021-08-02
3174011002,JAKARTA SELATAN,TEBET,TEBET BARAT,21194,8992,12202,5666,17868,2021-08-02
3174011001,JAKARTA SELATAN,TEBET,TEBET TIMUR,18199,7465,10734,5008,15742,2021-08-02
3173061003,JAKARTA BARAT,KALI DERES,TEGAL ALUR,83647,42013,41634,11184,52818,2021-08-02
3174031004,JAKARTA SELATAN,MAMPANG PRAPATAN,TEGAL PARANG,32401,16599,15802,5174,20976,2021-08-02
3173021003,JAKARTA BARAT,GROGOL PETAMBURAN,TOMANG,29605,13448,16157,6875,23032,2021-08-02
3172031005,JAKARTA UTARA,KOJA,TUGU SELATAN,39122,19940,19182,5576,24758,2021-08-02
3172031002,JAKARTA UTARA,KOJA,TUGU UTARA,67670,35153,32517,9836,42353,2021-08-02
3175061006,JAKARTA TIMUR,CAKUNG,UJUNG MENTENG,29934,13430,16504,5490,21994,2021-08-02
3174101005,JAKARTA SELATAN,PESANGGRAHAN,ULUJAMI,40544,20798,19746,6918,26664,2021-08-02
3175011006,JAKARTA TIMUR,MATRAMAN,UTAN KAYU SELATAN,33511,16259,17252,7014,24266,2021-08-02
3175011002,JAKARTA TIMUR,MATRAMAN,UTAN KAYU UTARA,28169,14208,13961,5478,19439,2021-08-02
3171031008,JAKARTA PUSAT,KEMAYORAN,UTAN PANJANG,29208,14719,14489,4150,18639,2021-08-02
3172021007,JAKARTA UTARA,TANJUNG PRIOK,WARAKAS,44401,20328,24073,8067,32140,2021-08-02
3173021007,JAKARTA BARAT,GROGOL PETAMBURAN,WIJAYA KUSUMA,38934,18918,20016,7138,27154,2021-08-02
3172051003,JAKARTA UTARA,PADEMANGAN,ANCOL,23947,11810,12137,4464,16601,2021-08-03
3173041007,JAKARTA BARAT,TAMBORA,ANGKE,29381,13255,16126,5180,21306,2021-08-03
3175041005,JAKARTA TIMUR,KRAMAT JATI,BALE KAMBANG,29074,17816,11258,3867,15125,2021-08-03
3175031003,JAKARTA TIMUR,JATINEGARA,BALI MESTER,9752,4832,4920,2088,7008,2021-08-03
3175101006,JAKARTA TIMUR,CIPAYUNG,BAMBU APUS,26285,13094,13191,5438,18629,2021-08-03
3174031002,JAKARTA SELATAN,MAMPANG PRAPATAN,BANGKA,21566,10100,11466,4246,15712,2021-08-03
3175051002,JAKARTA TIMUR,PASAR REBO,BARU,23886,9796,14090,6301,20391,2021-08-03
3175041004,JAKARTA TIMUR,KRAMAT JATI,BATU AMPAR,47898,27579,20319,7705,28024,2021-08-03
3171071002,JAKARTA PUSAT,TANAH ABANG,BENDUNGAN HILIR,21494,9720,11774,4865,16639,2021-08-03
3175031002,JAKARTA TIMUR,JATINEGARA,BIDARA CINA,36689,21129,15560,5837,21397,2021-08-03
3174101002,JAKARTA SELATAN,PESANGGRAHAN,BINTARO,53098,24557,28541,10539,39080,2021-08-03
3174011005,JAKARTA SELATAN,TEBET,BUKIT DURI,34183,17312,16871,6489,23360,2021-08-03
3171041006,JAKARTA PUSAT,SENEN,BUNGUR,18144,8172,9972,4010,13982,2021-08-03
3175061007,JAKARTA TIMUR,CAKUNG,CAKUNG BARAT,57724,25216,32508,7885,40393,2021-08-03
3175061004,JAKARTA TIMUR,CAKUNG,CAKUNG TIMUR,58287,26516,31771,11026,42797,2021-08-03
3175041007,JAKARTA TIMUR,KRAMAT JATI,CAWANG,32762,17389,15373,6238,21611,2021-08-03
3175101008,JAKARTA TIMUR,CIPAYUNG,CEGER,18932,8739,10193,3666,13859,2021-08-03
3171031006,JAKARTA PUSAT,KEMAYORAN,CEMPAKA BARU,32581,16821,15760,5826,21586,2021-08-03
3171051002,JAKARTA PUSAT,CEMPAKA PUTIH,CEMPAKA PUTIH BARAT,35885,17068,18817,7085,25902,2021-08-03
3171051001,JAKARTA PUSAT,CEMPAKA PUTIH,CEMPAKA PUTIH TIMUR,24292,11342,12950,6105,19055,2021-08-03
3173011001,JAKARTA BARAT,CENGKARENG,CENGKARENG BARAT,66284,30971,35313,13579,48892,2021-08-03
3173011006,JAKARTA BARAT,CENGKARENG,CENGKARENG TIMUR,81027,40957,40070,14917,54987,2021-08-03
3175091002,JAKARTA TIMUR,CIRACAS,CIBUBUR,66364,30426,35938,14318,50256,2021-08-03
3171011002,JAKARTA PUSAT,GAMBIR,CIDENG,15390,6683,8707,4129,12836,2021-08-03
3174091003,JAKARTA SELATAN,JAGAKARSA,CIGANJUR,38497,17862,20635,8065,28700,2021-08-03
3175051003,JAKARTA TIMUR,PASAR REBO,CIJANTUNG,41419,19305,22114,9365,31479,2021-08-03
3171061003,JAKARTA PUSAT,MENTENG,CIKINI,8274,4290,3984,1891,5875,2021-08-03
3174081006,JAKARTA SELATAN,PANCORAN,CIKOKO,10547,4325,6222,2321,8543,2021-08-03
3174061001,JAKARTA SELATAN,CILANDAK,CILANDAK BARAT,51752,22532,29220,12567,41787,2021-08-03
3174041003,JAKARTA SELATAN,PASAR MINGGU,CILANDAK TIMUR,25145,11149,13996,6774,20770,2021-08-03
3175101002,JAKARTA TIMUR,CIPAYUNG,CILANGKAP,27635,13418,14217,5442,19659,2021-08-03
3175041006,JAKARTA TIMUR,KRAMAT JATI,CILILITAN,40181,21835,18346,7570,25916,2021-08-03
3172041001,JAKARTA UTARA,CILINCING,CILINCING,43609,22247,21362,6558,27920,2021-08-03
3175101001,JAKARTA TIMUR,CIPAYUNG,CIPAYUNG,26104,11853,14251,5848,20099,2021-08-03
3174091006,JAKARTA SELATAN,JAGAKARSA,CIPEDAK,38303,16368,21935,8255,30190,2021-08-03
3174061005,JAKARTA SELATAN,CILANDAK,CIPETE SELATAN,26704,12263,14441,6261,20702,2021-08-03
3174071010,JAKARTA SELATAN,KEBAYORAN BARU,CIPETE UTARA,34102,15691,18411,6608,25019,2021-08-03
3175021003,JAKARTA TIMUR,PULO GADUNG,CIPINANG,39306,19408,19898,8515,28413,2021-08-03
3175031007,JAKARTA TIMUR,JATINEGARA,CIPINANG BESAR SELATAN,35212,19886,15326,5523,20849,2021-08-03
3175031008,JAKARTA TIMUR,JATINEGARA,CIPINANG BESAR UTARA,45319,25330,19989,6074,26063,2021-08-03
3175031005,JAKARTA TIMUR,JATINEGARA,CIPINANG CEMPEDAK,32824,17709,15115,6418,21533,2021-08-03
3175081005,JAKARTA TIMUR,MAKASAR,CIPINANG MELAYU,42308,20475,21833,9303,31136,2021-08-03
3175031006,JAKARTA TIMUR,JATINEGARA,CIPINANG MUARA,55243,29888,25355,10007,35362,2021-08-03
3174051003,JAKARTA SELATAN,KEBAYORAN LAMA,CIPULIR,39937,20433,19504,7332,26836,2021-08-03
3175091001,JAKARTA TIMUR,CIRACAS,CIRACAS,64594,29305,35289,12776,48065,2021-08-03
3175041003,JAKARTA TIMUR,KRAMAT JATI,DUKUH,24609,12403,12206,4965,17171,2021-08-03
3175071001,JAKARTA TIMUR,DUREN SAWIT,DUREN SAWIT,61160,32786,28374,13167,41541,2021-08-03
3174081004,JAKARTA SELATAN,PANCORAN,DUREN TIGA,28319,12758,15561,5488,21049,2021-08-03
3173051005,JAKARTA BARAT,KEBON JERUK,DURI KEPA,60138,26203,33935,13915,47850,2021-08-03
3173011002,JAKARTA BARAT,CENGKARENG,DURI KOSAMBI,77923,40620,37303,13501,50804,2021-08-03
3171011006,JAKARTA PUSAT,GAMBIR,DURI PULO,19610,9757,9853,3311,13164,2021-08-03
3173041011,JAKARTA BARAT,TAMBORA,DURI SELATAN,14259,6080,8179,3093,11272,2021-08-03
3173041003,JAKARTA BARAT,TAMBORA,DURI UTARA,19844,8744,11100,3723,14823,2021-08-03
3171081003,JAKARTA PUSAT,JOHAR BARU,GALUR,18243,7538,10705,3138,13843,2021-08-03
3171011001,JAKARTA PUSAT,GAMBIR,GAMBIR,2191,920,1271,639,1910,2021-08-03
3174061004,JAKARTA SELATAN,CILANDAK,GANDARIA SELATAN,22119,10147,11972,4774,16746,2021-08-03
3174071009,JAKARTA SELATAN,KEBAYORAN BARU,GANDARIA UTARA,39922,18877,21045,8205,29250,2021-08-03
3175051001,JAKARTA TIMUR,PASAR REBO,GEDONG,35755,17302,18453,7528,25981,2021-08-03
3171071001,JAKARTA PUSAT,TANAH ABANG,GELORA,3127,1454,1673,739,2412,2021-08-03
3173031007,JAKARTA BARAT,TAMAN SARI,GLODOK,7837,2893,4944,2722,7666,2021-08-03
3171061004,JAKARTA PUSAT,MENTENG,GONDANGDIA,4100,1749,2351,1529,3880,2021-08-03
3173021001,JAKARTA BARAT,GROGOL PETAMBURAN,GROGOL,16876,7792,9084,3745,12829,2021-08-03
3174051005,JAKARTA SELATAN,KEBAYORAN LAMA,GROGOL SELATAN,44251,22231,22020,8295,30315,2021-08-03
3174051004,JAKARTA SELATAN,KEBAYORAN LAMA,GROGOL UTARA,42494,20870,21624,8215,29839,2021-08-03
3174021007,JAKARTA SELATAN,SETIA BUDI,GUNTUR,3985,1694,2291,1259,3550,2021-08-03
3174071002,JAKARTA SELATAN,KEBAYORAN BARU,GUNUNG,9436,4100,5336,2773,8109,2021-08-03
3171031005,JAKARTA PUSAT,KEMAYORAN,GUNUNG SAHARI SELATAN,19199,8900,10299,4409,14708,2021-08-03
3171021004,JAKARTA PUSAT,SAWAH BESAR,GUNUNG SAHARI UTARA,16650,6585,10065,4655,14720,2021-08-03
3175081004,JAKARTA TIMUR,MAKASAR,HALIM PERDANA KUSUMAH,28363,9745,18618,11228,29846,2021-08-03
3171031003,JAKARTA PUSAT,KEMAYORAN,HARAPAN MULIA,22557,10914,11643,4215,15858,2021-08-03
3174091001,JAKARTA SELATAN,JAGAKARSA,JAGAKARSA,62389,27158,35231,14484,49715,2021-08-03
3175021007,JAKARTA TIMUR,PULO GADUNG,JATI,32757,16188,16569,7629,24198,2021-08-03
3174041002,JAKARTA SELATAN,PASAR MINGGU,JATI PADANG,37502,17620,19882,8696,28578,2021-08-03
3173071004,JAKARTA BARAT,PALMERAH,JATI PULO,28738,12538,16200,4852,21052,2021-08-03
3175061001,JAKARTA TIMUR,CAKUNG,JATINEGARA,84160,43142,41018,11386,52404,2021-08-03
3175021004,JAKARTA TIMUR,PULO GADUNG,JATINEGARA KAUM,24632,11943,12689,4226,16915,2021-08-03
3173021004,JAKARTA BARAT,GROGOL PETAMBURAN,JELAMBAR,30266,13604,16662,7945,24607,2021-08-03
3173021006,JAKARTA BARAT,GROGOL PETAMBURAN,JELAMBAR BARU,38246,17728,20518,9223,29741,2021-08-03
3173041006,JAKARTA BARAT,TAMBORA,JEMBATAN BESI,29314,16786,12528,3621,16149,2021-08-03
3173041008,JAKARTA BARAT,TAMBORA,JEMBATAN LIMA,21021,11505,9516,3543,13059,2021-08-03
3173081005,JAKARTA BARAT,KEMBANGAN,JOGLO,40839,19893,20946,8395,29341,2021-08-03
3171081001,JAKARTA PUSAT,JOHAR BARU,JOHAR BARU,37488,16005,21483,7874,29357,2021-08-03
3173041002,JAKARTA BARAT,TAMBORA,KALI ANYAR,23856,12072,11784,3088,14872,2021-08-03
3172041004,JAKARTA UTARA,CILINCING,KALIBARU,67684,36566,31118,7563,38681,2021-08-03
3174081002,JAKARTA SELATAN,PANCORAN,KALIBATA,41994,21859,20135,7369,27504,2021-08-03
3173061001,JAKARTA BARAT,KALI DERES,KALIDERES,72447,34963,37484,12389,49873,2021-08-03
3175051004,JAKARTA TIMUR,PASAR REBO,KALISARI,43212,20002,23210,9816,33026,2021-08-03
3173061004,JAKARTA BARAT,KALI DERES,KAMAL,53783,28537,25246,5855,31101,2021-08-03
3172011002,JAKARTA UTARA,PENJARINGAN,KAMAL MUARA,12930,4363,8567,4010,12577,2021-08-03
3171071007,JAKARTA PUSAT,TANAH ABANG,KAMPUNG BALI,11358,6241,5117,2009,7126,2021-08-03
3175031001,JAKARTA TIMUR,JATINEGARA,KAMPUNG MELAYU,25717,14334,11383,3563,14946,2021-08-03
3171081002,JAKARTA PUSAT,JOHAR BARU,KAMPUNG RAWA,21237,7818,13419,3991,17410,2021-08-03
3175041002,JAKARTA TIMUR,KRAMAT JATI,KAMPUNG TENGAH,43993,25714,18279,7337,25616,2021-08-03
3173011005,JAKARTA BARAT,CENGKARENG,KAPUK,134466,72102,62364,16740,79104,2021-08-03
3172011003,JAKARTA UTARA,PENJARINGAN,KAPUK MUARA,35781,14542,21239,9905,31144,2021-08-03
3171021002,JAKARTA PUSAT,SAWAH BESAR,KARANG ANYAR,25761,11847,13914,5071,18985,2021-08-03
3174021004,JAKARTA SELATAN,SETIA BUDI,KARET,9623,4631,4992,2208,7200,2021-08-03
3174021003,JAKARTA SELATAN,SETIA BUDI,KARET KUNINGAN,16055,6994,9061,3640,12701,2021-08-03
3174021002,JAKARTA SELATAN,SETIA BUDI,KARET SEMANGGI,2770,1118,1652,884,2536,2021-08-03
3171071003,JAKARTA PUSAT,TANAH ABANG,KARET TENGSIN,19271,8908,10363,3372,13735,2021-08-03
3171021003,JAKARTA PUSAT,SAWAH BESAR,KARTINI,22292,9955,12337,5160,17497,2021-08-03
3175011003,JAKARTA TIMUR,MATRAMAN,KAYU MANIS,25284,13613,11671,4425,16096,2021-08-03
3175021006,JAKARTA TIMUR,PULO GADUNG,KAYU PUTIH,40696,18110,22586,10244,32830,2021-08-03
3173031006,JAKARTA BARAT,TAMAN SARI,KEAGUNGAN,17387,7882,9505,3367,12872,2021-08-03
3174041007,JAKARTA SELATAN,PASAR MINGGU,KEBAGUSAN,44552,22322,22230,8646,30876,2021-08-03
3174051006,JAKARTA SELATAN,KEBAYORAN LAMA,KEBAYORAN LAMA SELATAN,41212,18907,22305,8682,30987,2021-08-03
3174051001,JAKARTA SELATAN,KEBAYORAN LAMA,KEBAYORAN LAMA UTARA,42422,21411,21011,7705,28716,2021-08-03
3174011004,JAKARTA SELATAN,TEBET,KEBON BARU,35165,16514,18651,7500,26151,2021-08-03
3172021005,JAKARTA UTARA,TANJUNG PRIOK,KEBON BAWANG,50952,23725,27227,10343,37570,2021-08-03
3173051001,JAKARTA BARAT,KEBON JERUK,KEBON JERUK,53887,28142,25745,9582,35327,2021-08-03
3171071006,JAKARTA PUSAT,TANAH ABANG,KEBON KACANG,21531,12200,9331,3526,12857,2021-08-03
3171011005,JAKARTA PUSAT,GAMBIR,KEBON KELAPA,10163,4689,5474,2247,7721,2021-08-03
3171031002,JAKARTA PUSAT,KEMAYORAN,KEBON KOSONG,30019,14434,15585,5594,21179,2021-08-03
3175011005,JAKARTA TIMUR,MATRAMAN,KEBON MANGGIS,16490,7590,8900,3890,12790,2021-08-03
3171071005,JAKARTA PUSAT,TANAH ABANG,KEBON MELATI,32206,19123,13083,3904,16987,2021-08-03
3175081003,JAKARTA TIMUR,MAKASAR,KEBON PALA,46614,23424,23190,8754,31944,2021-08-03
3171061005,JAKARTA PUSAT,MENTENG,KEBON SIRIH,12299,6331,5968,2178,8146,2021-08-03
3173011004,JAKARTA BARAT,CENGKARENG,KEDAUNG KALI ANGKE,32612,13294,19318,5134,24452,2021-08-03
3173051007,JAKARTA BARAT,KEBON JERUK,KEDOYA SELATAN,32165,14482,17683,6378,24061,2021-08-03
3173051006,JAKARTA BARAT,KEBON JERUK,KEDOYA UTARA,45740,19389,26351,9599,35950,2021-08-03
3173051004,JAKARTA BARAT,KEBON JERUK,KELAPA DUA,23565,11585,11980,4453,16433,2021-08-03
3175091003,JAKARTA TIMUR,CIRACAS,KELAPA DUA WETAN,46875,21316,25559,10007,35566,2021-08-03
3172061003,JAKARTA UTARA,KELAPA GADING,KELAPA GADING BARAT,35717,13825,21892,11341,33233,2021-08-03
3172061001,JAKARTA UTARA,KELAPA GADING,KELAPA GADING TIMUR,33592,11888,21704,12007,33711,2021-08-03
3173071005,JAKARTA BARAT,PALMERAH,KEMANGGISAN,32139,15702,16437,6605,23042,2021-08-03
3171031001,JAKARTA PUSAT,KEMAYORAN,KEMAYORAN,20708,9185,11523,4366,15889,2021-08-03
3173081006,JAKARTA BARAT,KEMBANGAN,KEMBANGAN SELATAN,27130,12467,14663,6517,21180,2021-08-03
3173081001,JAKARTA BARAT,KEMBANGAN,KEMBANGAN UTARA,54451,25402,29049,9026,38075,2021-08-03
3171041002,JAKARTA PUSAT,SENEN,KENARI,9579,4057,5522,2268,7790,2021-08-03
3173041005,JAKARTA BARAT,TAMBORA,KERENDANG,19973,9551,10422,3224,13646,2021-08-03
3175071003,JAKARTA TIMUR,DUREN SAWIT,KLENDER,69978,40217,29761,11460,41221,2021-08-03
3172031001,JAKARTA UTARA,KOJA,KOJA,28175,13396,14779,4828,19607,2021-08-03
3173071006,JAKARTA BARAT,PALMERAH,KOTA BAMBU SELATAN,21158,10356,10802,3232,14034,2021-08-03
3173071003,JAKARTA BARAT,PALMERAH,KOTA BAMBU UTARA,24995,12387,12608,3776,16384,2021-08-03
3171041004,JAKARTA PUSAT,SENEN,KRAMAT,28835,14768,14067,4582,18649,2021-08-03
3175041001,JAKARTA TIMUR,KRAMAT JATI,KRAMAT JATI,34144,17699,16445,6689,23134,2021-08-03
3174071003,JAKARTA SELATAN,KEBAYORAN BARU,KRAMAT PELA,14413,6446,7967,3423,11390,2021-08-03
3173031002,JAKARTA BARAT,TAMAN SARI,KRUKUT,19244,8919,10325,3302,13627,2021-08-03
3174031005,JAKARTA SELATAN,MAMPANG PRAPATAN,KUNINGAN BARAT,12785,5801,6984,2683,9667,2021-08-03
3174021008,JAKARTA SELATAN,SETIA BUDI,KUNINGAN TIMUR,6008,2815,3193,1477,4670,2021-08-03
3171041005,JAKARTA PUSAT,SENEN,KWITANG,15486,7222,8264,3053,11317,2021-08-03
3172031003,JAKARTA UTARA,KOJA,LAGOA,59065,30142,28923,9147,38070,2021-08-03
3174061002,JAKARTA SELATAN,CILANDAK,LEBAK BULUS,37626,17831,19795,8885,28680,2021-08-03
3174091004,JAKARTA SELATAN,JAGAKARSA,LENTENG AGUNG,53946,26898,27048,9706,36754,2021-08-03
3175101007,JAKARTA TIMUR,CIPAYUNG,LUBANG BUAYA,63547,30601,32946,14411,47357,2021-08-03
3175081001,JAKARTA TIMUR,MAKASAR,MAKASAR,34390,16371,18019,7670,25689,2021-08-03
3175071006,JAKARTA TIMUR,DUREN SAWIT,MALAKA JAYA,30927,14192,16735,7518,24253,2021-08-03
3175071005,JAKARTA TIMUR,DUREN SAWIT,MALAKA SARI,27530,12504,15026,7126,22152,2021-08-03
3174031001,JAKARTA SELATAN,MAMPANG PRAPATAN,MAMPANG PRAPATAN,18159,8548,9611,3715,13326,2021-08-03
3173031005,JAKARTA BARAT,TAMAN SARI,MANGGA BESAR,7707,3004,4703,2170,6873,2021-08-03
3171021005,JAKARTA PUSAT,SAWAH BESAR,MANGGA DUA SELATAN,27442,12873,14569,5880,20449,2021-08-03
3174011007,JAKARTA SELATAN,TEBET,MANGGARAI,28373,13355,15018,5133,20151,2021-08-03
3174011006,JAKARTA SELATAN,TEBET,MANGGARAI SELATAN,23075,10308,12767,5442,18209,2021-08-03
3173031003,JAKARTA BARAT,TAMAN SARI,MAPHAR,16461,7355,9106,3781,12887,2021-08-03
3172041003,JAKARTA UTARA,CILINCING,MARUNDA,28943,13321,15622,4066,19688,2021-08-03
3174071001,JAKARTA SELATAN,KEBAYORAN BARU,MELAWAI,2627,1022,1605,1037,2642,2021-08-03
3171061001,JAKARTA PUSAT,MENTENG,MENTENG,25624,13858,11766,4843,16609,2021-08-03
3174021005,JAKARTA SELATAN,SETIA BUDI,MENTENG ATAS,27816,12559,15257,5897,21154,2021-08-03
3174011003,JAKARTA SELATAN,TEBET,MENTENG DALAM,36028,17336,18692,7771,26463,2021-08-03
3173081003,JAKARTA BARAT,KEMBANGAN,MERUYA SELATAN,32130,15882,16248,6461,22709,2021-08-03
3173081002,JAKARTA BARAT,KEMBANGAN,MERUYA UTARA,43752,21027,22725,9611,32336,2021-08-03
3175101004,JAKARTA TIMUR,CIPAYUNG,MUNJUL,23871,11358,12513,4967,17480,2021-08-03
3172051002,JAKARTA UTARA,PADEMANGAN,PADEMANGAN BARAT,74240,35799,38441,12475,50916,2021-08-03
3172051001,JAKARTA UTARA,PADEMANGAN,PADEMANGAN TIMUR,37736,14931,22805,9615,32420,2021-08-03
3175011004,JAKARTA TIMUR,MATRAMAN,PAL MERIAM,19769,10106,9663,4025,13688,2021-08-03
3173071001,JAKARTA BARAT,PALMERAH,PALMERAH,63011,31251,31760,11239,42999,2021-08-03
3174081001,JAKARTA SELATAN,PANCORAN,PANCORAN,19421,8938,10483,4019,14502,2021-08-03
3172021003,JAKARTA UTARA,TANJUNG PRIOK,PAPANGGO,39097,17244,21853,7724,29577,2021-08-03
3171021001,JAKARTA PUSAT,SAWAH BESAR,PASAR BARU,12035,4778,7257,3538,10795,2021-08-03
3174021006,JAKARTA SELATAN,SETIA BUDI,PASAR MANGGIS,26752,12875,13877,5592,19469,2021-08-03
3174041001,JAKARTA SELATAN,PASAR MINGGU,PASAR MINGGU,24821,11464,13357,6314,19671,2021-08-03
3171041003,JAKARTA PUSAT,SENEN,PASEBAN,23533,11055,12478,4583,17061,2021-08-03
3173061005,JAKARTA BARAT,KALI DERES,PEGADUNGAN,75587,35129,40458,15894,56352,2021-08-03
3171061002,JAKARTA PUSAT,MENTENG,PEGANGSAAN,23455,12650,10805,4110,14915,2021-08-03
3172061002,JAKARTA UTARA,KELAPA GADING,PEGANGSAAN DUA,49976,17880,32096,14487,46583,2021-08-03
3172011004,JAKARTA UTARA,PENJARINGAN,PEJAGALAN,74578,33942,40636,17777,58413,2021-08-03
3174041006,JAKARTA SELATAN,PASAR MINGGU,PEJATEN BARAT,37346,17761,19585,8593,28178,2021-08-03
3174041005,JAKARTA SELATAN,PASAR MINGGU,PEJATEN TIMUR,57656,30690,26966,10757,37723,2021-08-03
3175051005,JAKARTA TIMUR,PASAR REBO,PEKAYON,43250,19264,23986,8931,32917,2021-08-03
3173041009,JAKARTA BARAT,TAMBORA,PEKOJAN,23587,10347,13240,5204,18444,2021-08-03
3174031003,JAKARTA SELATAN,MAMPANG PRAPATAN,PELA MAMPANG,43522,19600,23922,9030,32952,2021-08-03
3174081005,JAKARTA SELATAN,PANCORAN,PENGADEGAN,21478,8814,12664,4757,17421,2021-08-03
3175061003,JAKARTA TIMUR,CAKUNG,PENGGILINGAN,99255,55219,44036,13403,57439,2021-08-03
3172011001,JAKARTA UTARA,PENJARINGAN,PENJARINGAN,88308,46885,41423,14365,55788,2021-08-03
3174101001,JAKARTA SELATAN,PESANGGRAHAN,PESANGGRAHAN,27545,11798,15747,7138,22885,2021-08-03
3171071004,JAKARTA PUSAT,TANAH ABANG,PETAMBURAN,33271,19619,13652,4104,17756,2021-08-03
3174071008,JAKARTA SELATAN,KEBAYORAN BARU,PETOGOGAN,11499,5327,6172,2881,9053,2021-08-03
3171011004,JAKARTA PUSAT,GAMBIR,PETOJO SELATAN,14692,6950,7742,3692,11434,2021-08-03
3171011003,JAKARTA PUSAT,GAMBIR,PETOJO UTARA,17458,8763,8695,3490,12185,2021-08-03
3174101004,JAKARTA SELATAN,PESANGGRAHAN,PETUKANGAN SELATAN,37187,16562,20625,7117,27742,2021-08-03
3174101003,JAKARTA SELATAN,PESANGGRAHAN,PETUKANGAN UTARA,53716,26400,27316,10981,38297,2021-08-03
3175081002,JAKARTA TIMUR,MAKASAR,PINANG RANTI,27198,12868,14330,5581,19911,2021-08-03
3173031008,JAKARTA BARAT,TAMAN SARI,PINANGSIA,10729,4355,6374,2419,8793,2021-08-03
3175011001,JAKARTA TIMUR,MATRAMAN,PISANGAN BARU,31776,17070,14706,5460,20166,2021-08-03
3175021002,JAKARTA TIMUR,PULO GADUNG,PISANGAN TIMUR,41011,19411,21600,7847,29447,2021-08-03
3172011005,JAKARTA UTARA,PENJARINGAN,PLUIT,47783,20427,27356,16326,43682,2021-08-03
3175071002,JAKARTA TIMUR,DUREN SAWIT,PONDOK BAMBU,61550,31921,29629,12597,42226,2021-08-03
3175071004,JAKARTA TIMUR,DUREN SAWIT,PONDOK KELAPA,72015,34182,37833,15203,53036,2021-08-03
3175071007,JAKARTA TIMUR,DUREN SAWIT,PONDOK KOPI,35367,19514,15853,6165,22018,2021-08-03
3174061003,JAKARTA SELATAN,CILANDAK,PONDOK LABU,46464,20223,26241,11148,37389,2021-08-03
3174051002,JAKARTA SELATAN,KEBAYORAN LAMA,PONDOK PINANG,56169,26852,29317,13448,42765,2021-08-03
3175101003,JAKARTA TIMUR,CIPAYUNG,PONDOK RANGGON,25574,13367,12207,5034,17241,2021-08-03
3101011003,KAB.ADM.KEP.SERIBU,KEP. SERIBU UTARA,PULAU HARAPAN,2060,462,1598,720,2318,2021-08-03
3101011002,KAB.ADM.KEP.SERIBU,KEP. SERIBU UTARA,PULAU KELAPA,5528,1186,4342,1466,5808,2021-08-03
3101011001,KAB.ADM.KEP.SERIBU,KEP. SERIBU UTARA,PULAU PANGGANG,5450,1045,4405,1299,5704,2021-08-03
3101021003,KAB.ADM.KEP.SERIBU,KEP. SERIBU SELATAN,PULAU PARI,2765,399,2366,739,3105,2021-08-03
3101021002,KAB.ADM.KEP.SERIBU,KEP. SERIBU SELATAN,PULAU TIDUNG,4553,884,3669,1556,5225,2021-08-03
3101021001,KAB.ADM.KEP.SERIBU,KEP. SERIBU SELATAN,PULAU UNTUNG JAWA,1941,429,1512,687,2199,2021-08-03
3174071007,JAKARTA SELATAN,KEBAYORAN BARU,PULO,5835,2360,3475,1932,5407,2021-08-03
3175021001,JAKARTA TIMUR,PULO GADUNG,PULO GADUNG,34422,17684,16738,6789,23527,2021-08-03
3175061005,JAKARTA TIMUR,CAKUNG,PULO GEBANG,97301,49047,48254,14684,62938,2021-08-03
3174041004,JAKARTA SELATAN,PASAR MINGGU,RAGUNAN,39616,17483,22133,9051,31184,2021-08-03
3175091005,JAKARTA TIMUR,CIRACAS,RAMBUTAN,36771,20063,16708,6199,22907,2021-08-03
3172031006,JAKARTA UTARA,KOJA,RAWA BADAK SELATAN,42179,21819,20360,5866,26226,2021-08-03
3172031004,JAKARTA UTARA,KOJA,RAWA BADAK UTARA,34408,17090,17318,6231,23549,2021-08-03
3174071005,JAKARTA SELATAN,KEBAYORAN BARU,RAWA BARAT,5625,2471,3154,1741,4895,2021-08-03
3173011003,JAKARTA BARAT,CENGKARENG,RAWA BUAYA,63799,32548,31251,9585,40836,2021-08-03
3175031004,JAKARTA TIMUR,JATINEGARA,RAWA BUNGA,21434,11393,10041,3413,13454,2021-08-03
3174081003,JAKARTA SELATAN,PANCORAN,RAWA JATI,20509,9021,11488,4751,16239,2021-08-03
3175061002,JAKARTA TIMUR,CAKUNG,RAWA TERATE,24637,10864,13773,3223,16996,2021-08-03
3175021005,JAKARTA TIMUR,PULO GADUNG,RAWAMANGUN,37612,17981,19631,8102,27733,2021-08-03
3171051003,JAKARTA PUSAT,CEMPAKA PUTIH,RAWASARI,21967,10251,11716,4963,16679,2021-08-03
3173041010,JAKARTA BARAT,TAMBORA,ROA MALAKA,3484,1329,2155,1148,3303,2021-08-03
3172041006,JAKARTA UTARA,CILINCING,ROROTAN,41668,18442,23226,6911,30137,2021-08-03
3174071004,JAKARTA SELATAN,KEBAYORAN BARU,SELONG,2842,1157,1685,1084,2769,2021-08-03
3173061002,JAKARTA BARAT,KALI DERES,SEMANAN,71354,36170,35184,7948,43132,2021-08-03
3172041007,JAKARTA UTARA,CILINCING,SEMPER BARAT,68587,28822,39765,13492,53257,2021-08-03
3172041005,JAKARTA UTARA,CILINCING,SEMPER TIMUR,36267,17006,19261,6831,26092,2021-08-03
3174071006,JAKARTA SELATAN,KEBAYORAN BARU,SENAYAN,2771,1452,1319,751,2070,2021-08-03
3171041001,JAKARTA PUSAT,SENEN,SENEN,6804,3046,3758,1509,5267,2021-08-03
3171031004,JAKARTA PUSAT,KEMAYORAN,SERDANG,29668,14073,15595,5740,21335,2021-08-03
3174021001,JAKARTA SELATAN,SETIA BUDI,SETIA BUDI,3023,1427,1596,830,2426,2021-08-03
3175101005,JAKARTA TIMUR,CIPAYUNG,SETU,20572,11194,9378,3631,13009,2021-08-03
3173071002,JAKARTA BARAT,PALMERAH,SLIPI,16591,7481,9110,3659,12769,2021-08-03
3173081004,JAKARTA BARAT,KEMBANGAN,SRENGSENG,45523,23041,22482,8552,31034,2021-08-03
3174091002,JAKARTA SELATAN,JAGAKARSA,SRENGSENG SAWAH,58196,24179,34017,14236,48253,2021-08-03
3173051003,JAKARTA BARAT,KEBON JERUK,SUKABUMI SELATAN,37033,20218,16815,5266,22081,2021-08-03
3173051002,JAKARTA BARAT,KEBON JERUK,SUKABUMI UTARA,38290,22065,16225,5721,21946,2021-08-03
3172041002,JAKARTA UTARA,CILINCING,SUKAPURA,53949,25425,28524,8837,37361,2021-08-03
3171031007,JAKARTA PUSAT,KEMAYORAN,SUMUR BATU,22717,10686,12031,5230,17261,2021-08-03
3172021004,JAKARTA UTARA,TANJUNG PRIOK,SUNGAI BAMBU,29876,13618,16258,6425,22683,2021-08-03
3172021006,JAKARTA UTARA,TANJUNG PRIOK,SUNTER AGUNG,71805,28393,43412,19387,62799,2021-08-03
3172021002,JAKARTA UTARA,TANJUNG PRIOK,SUNTER JAYA,63031,26867,36164,15547,51711,2021-08-03
3175091004,JAKARTA TIMUR,CIRACAS,SUSUKAN,38257,18314,19943,7544,27487,2021-08-03
3173031001,JAKARTA BARAT,TAMAN SARI,TAMAN SARI,14348,6243,8105,3529,11634,2021-08-03
3173041001,JAKARTA BARAT,TAMBORA,TAMBORA,10204,5166,5038,2169,7207,2021-08-03
3173041004,JAKARTA BARAT,TAMBORA,TANAH SEREAL,26387,10182,16205,5471,21676,2021-08-03
3171081004,JAKARTA PUSAT,JOHAR BARU,TANAH TINGGI,37693,15559,22134,6662,28796,2021-08-03
3173031004,JAKARTA BARAT,TAMAN SARI,TANGKI,13324,5804,7520,2957,10477,2021-08-03
3174091005,JAKARTA SELATAN,JAGAKARSA,TANJUNG BARAT,39770,18358,21412,8501,29913,2021-08-03
3173021005,JAKARTA BARAT,GROGOL PETAMBURAN,TANJUNG DUREN SELATAN,25337,10846,14491,6222,20713,2021-08-03
3173021002,JAKARTA BARAT,GROGOL PETAMBURAN,TANJUNG DUREN UTARA,17010,6840,10170,4690,14860,2021-08-03
3172021001,JAKARTA UTARA,TANJUNG PRIOK,TANJUNG PRIOK,34588,14582,20006,5893,25899,2021-08-03
3174011002,JAKARTA SELATAN,TEBET,TEBET BARAT,21194,8812,12382,5795,18177,2021-08-03
3174011001,JAKARTA SELATAN,TEBET,TEBET TIMUR,18199,7378,10821,5124,15945,2021-08-03
3173061003,JAKARTA BARAT,KALI DERES,TEGAL ALUR,83647,40895,42752,11813,54565,2021-08-03
3174031004,JAKARTA SELATAN,MAMPANG PRAPATAN,TEGAL PARANG,32401,16263,16138,5393,21531,2021-08-03
3173021003,JAKARTA BARAT,GROGOL PETAMBURAN,TOMANG,29605,13284,16321,7077,23398,2021-08-03
3172031005,JAKARTA UTARA,KOJA,TUGU SELATAN,39122,19588,19534,5929,25463,2021-08-03
3172031002,JAKARTA UTARA,KOJA,TUGU UTARA,67670,34611,33059,10434,43493,2021-08-03
3175061006,JAKARTA TIMUR,CAKUNG,UJUNG MENTENG,29934,13089,16845,5669,22514,2021-08-03
3174101005,JAKARTA SELATAN,PESANGGRAHAN,ULUJAMI,40544,20411,20133,7086,27219,2021-08-03
3175011006,JAKARTA TIMUR,MATRAMAN,UTAN KAYU SELATAN,33511,16006,17505,7252,24757,2021-08-03
3175011002,JAKARTA TIMUR,MATRAMAN,UTAN KAYU UTARA,28169,14051,14118,5668,19786,2021-08-03
3171031008,JAKARTA PUSAT,KEMAYORAN,UTAN PANJANG,29208,14353,14855,4284,19139,2021-08-03
3172021007,JAKARTA UTARA,TANJUNG PRIOK,WARAKAS,44401,20075,24326,8411,32737,2021-08-03
3173021007,JAKARTA BARAT,GROGOL PETAMBURAN,WIJAYA KUSUMA,38934,18838,20096,7488,27584,2021-08-03
3172051003,JAKARTA UTARA,PADEMANGAN,ANCOL,23947,11641,12306,4538,16844,2021-08-04
3173041007,JAKARTA BARAT,TAMBORA,ANGKE,29381,13051,16330,5353,21683,2021-08-04
3175041005,JAKARTA TIMUR,KRAMAT JATI,BALE KAMBANG,29074,17438,11636,3991,15627,2021-08-04
3175031003,JAKARTA TIMUR,JATINEGARA,BALI MESTER,9752,4695,5057,2172,7229,2021-08-04
3175101006,JAKARTA TIMUR,CIPAYUNG,BAMBU APUS,26285,12817,13468,5543,19011,2021-08-04
3174031002,JAKARTA SELATAN,MAMPANG PRAPATAN,BANGKA,21566,10009,11557,4413,15970,2021-08-04
3175051002,JAKARTA TIMUR,PASAR REBO,BARU,23886,9695,14191,6419,20610,2021-08-04
3175041004,JAKARTA TIMUR,KRAMAT JATI,BATU AMPAR,47898,27143,20755,7943,28698,2021-08-04
3171071002,JAKARTA PUSAT,TANAH ABANG,BENDUNGAN HILIR,21494,9610,11884,4999,16883,2021-08-04
3175031002,JAKARTA TIMUR,JATINEGARA,BIDARA CINA,36689,20607,16082,6085,22167,2021-08-04
3174101002,JAKARTA SELATAN,PESANGGRAHAN,BINTARO,53098,24177,28921,10983,39904,2021-08-04
3174011005,JAKARTA SELATAN,TEBET,BUKIT DURI,34183,16839,17344,6765,24109,2021-08-04
3171041006,JAKARTA PUSAT,SENEN,BUNGUR,18144,8062,10082,4185,14267,2021-08-04
3175061007,JAKARTA TIMUR,CAKUNG,CAKUNG BARAT,57724,24843,32881,8421,41302,2021-08-04
3175061004,JAKARTA TIMUR,CAKUNG,CAKUNG TIMUR,58287,26327,31960,11512,43472,2021-08-04
3175041007,JAKARTA TIMUR,KRAMAT JATI,CAWANG,32762,17093,15669,6428,22097,2021-08-04
3175101008,JAKARTA TIMUR,CIPAYUNG,CEGER,18932,8691,10241,3719,13960,2021-08-04
3171031006,JAKARTA PUSAT,KEMAYORAN,CEMPAKA BARU,32581,16577,16004,6009,22013,2021-08-04
3171051002,JAKARTA PUSAT,CEMPAKA PUTIH,CEMPAKA PUTIH BARAT,35885,16914,18971,7363,26334,2021-08-04
3171051001,JAKARTA PUSAT,CEMPAKA PUTIH,CEMPAKA PUTIH TIMUR,24292,11223,13069,6287,19356,2021-08-04
3173011001,JAKARTA BARAT,CENGKARENG,CENGKARENG BARAT,66284,30645,35639,14370,50009,2021-08-04
3173011006,JAKARTA BARAT,CENGKARENG,CENGKARENG TIMUR,81027,39751,41276,15299,56575,2021-08-04
3175091002,JAKARTA TIMUR,CIRACAS,CIBUBUR,66364,29615,36749,14802,51551,2021-08-04
3171011002,JAKARTA PUSAT,GAMBIR,CIDENG,15390,6594,8796,4177,12973,2021-08-04
3174091003,JAKARTA SELATAN,JAGAKARSA,CIGANJUR,38497,17523,20974,8348,29322,2021-08-04
3175051003,JAKARTA TIMUR,PASAR REBO,CIJANTUNG,41419,18904,22515,9657,32172,2021-08-04
3171061003,JAKARTA PUSAT,MENTENG,CIKINI,8274,4243,4031,1925,5956,2021-08-04
3174081006,JAKARTA SELATAN,PANCORAN,CIKOKO,10547,4296,6251,2382,8633,2021-08-04
3174061001,JAKARTA SELATAN,CILANDAK,CILANDAK BARAT,51752,22288,29464,13085,42549,2021-08-04
3174041003,JAKARTA SELATAN,PASAR MINGGU,CILANDAK TIMUR,25145,11001,14144,6926,21070,2021-08-04
3175101002,JAKARTA TIMUR,CIPAYUNG,CILANGKAP,27635,13190,14445,5609,20054,2021-08-04
3175041006,JAKARTA TIMUR,KRAMAT JATI,CILILITAN,40181,21549,18632,7780,26412,2021-08-04
3172041001,JAKARTA UTARA,CILINCING,CILINCING,43609,22042,21567,6663,28230,2021-08-04
3175101001,JAKARTA TIMUR,CIPAYUNG,CIPAYUNG,26104,11590,14514,6028,20542,2021-08-04
3174091006,JAKARTA SELATAN,JAGAKARSA,CIPEDAK,38303,16157,22146,8701,30847,2021-08-04
3174061005,JAKARTA SELATAN,CILANDAK,CIPETE SELATAN,26704,12203,14501,6554,21055,2021-08-04
3174071010,JAKARTA SELATAN,KEBAYORAN BARU,CIPETE UTARA,34102,15542,18560,6915,25475,2021-08-04
3175021003,JAKARTA TIMUR,PULO GADUNG,CIPINANG,39306,19159,20147,8706,28853,2021-08-04
3175031007,JAKARTA TIMUR,JATINEGARA,CIPINANG BESAR SELATAN,35212,19474,15738,5657,21395,2021-08-04
3175031008,JAKARTA TIMUR,JATINEGARA,CIPINANG BESAR UTARA,45319,24893,20426,6295,26721,2021-08-04
3175031005,JAKARTA TIMUR,JATINEGARA,CIPINANG CEMPEDAK,32824,17342,15482,6711,22193,2021-08-04
3175081005,JAKARTA TIMUR,MAKASAR,CIPINANG MELAYU,42308,20214,22094,9575,31669,2021-08-04
3175031006,JAKARTA TIMUR,JATINEGARA,CIPINANG MUARA,55243,29179,26064,10249,36313,2021-08-04
3174051003,JAKARTA SELATAN,KEBAYORAN LAMA,CIPULIR,39937,19848,20089,7640,27729,2021-08-04
3175091001,JAKARTA TIMUR,CIRACAS,CIRACAS,64594,29018,35576,13078,48654,2021-08-04
3175041003,JAKARTA TIMUR,KRAMAT JATI,DUKUH,24609,12248,12361,5017,17378,2021-08-04
3175071001,JAKARTA TIMUR,DUREN SAWIT,DUREN SAWIT,61160,32366,28794,13601,42395,2021-08-04
3174081004,JAKARTA SELATAN,PANCORAN,DUREN TIGA,28319,12603,15716,5681,21397,2021-08-04
3173051005,JAKARTA BARAT,KEBON JERUK,DURI KEPA,60138,25940,34198,14274,48472,2021-08-04
3173011002,JAKARTA BARAT,CENGKARENG,DURI KOSAMBI,77923,39933,37990,14001,51991,2021-08-04
3171011006,JAKARTA PUSAT,GAMBIR,DURI PULO,19610,9569,10041,3381,13422,2021-08-04
3173041011,JAKARTA BARAT,TAMBORA,DURI SELATAN,14259,5968,8291,3151,11442,2021-08-04
3173041003,JAKARTA BARAT,TAMBORA,DURI UTARA,19844,8618,11226,3808,15034,2021-08-04
3171081003,JAKARTA PUSAT,JOHAR BARU,GALUR,18243,7423,10820,3250,14070,2021-08-04
3171011001,JAKARTA PUSAT,GAMBIR,GAMBIR,2191,906,1285,644,1929,2021-08-04
3174061004,JAKARTA SELATAN,CILANDAK,GANDARIA SELATAN,22119,10017,12102,4901,17003,2021-08-04
3174071009,JAKARTA SELATAN,KEBAYORAN BARU,GANDARIA UTARA,39922,18692,21230,8474,29704,2021-08-04
3175051001,JAKARTA TIMUR,PASAR REBO,GEDONG,35755,16947,18808,7708,26516,2021-08-04
3171071001,JAKARTA PUSAT,TANAH ABANG,GELORA,3127,1444,1683,749,2432,2021-08-04
3173031007,JAKARTA BARAT,TAMAN SARI,GLODOK,7837,2880,4957,2758,7715,2021-08-04
3171061004,JAKARTA PUSAT,MENTENG,GONDANGDIA,4100,1742,2358,1544,3902,2021-08-04
3173021001,JAKARTA BARAT,GROGOL PETAMBURAN,GROGOL,16876,7662,9214,3878,13092,2021-08-04
3174051005,JAKARTA SELATAN,KEBAYORAN LAMA,GROGOL SELATAN,44251,21665,22586,8527,31113,2021-08-04
3174051004,JAKARTA SELATAN,KEBAYORAN LAMA,GROGOL UTARA,42494,20441,22053,8433,30486,2021-08-04
3174021007,JAKARTA SELATAN,SETIA BUDI,GUNTUR,3985,1677,2308,1290,3598,2021-08-04
3174071002,JAKARTA SELATAN,KEBAYORAN BARU,GUNUNG,9436,4059,5377,2857,8234,2021-08-04
3171031005,JAKARTA PUSAT,KEMAYORAN,GUNUNG SAHARI SELATAN,19199,8781,10418,4516,14934,2021-08-04
3171021004,JAKARTA PUSAT,SAWAH BESAR,GUNUNG SAHARI UTARA,16650,6550,10100,4738,14838,2021-08-04
3175081004,JAKARTA TIMUR,MAKASAR,HALIM PERDANA KUSUMAH,28363,9649,18714,11495,30209,2021-08-04
3171031003,JAKARTA PUSAT,KEMAYORAN,HARAPAN MULIA,22557,10840,11717,4377,16094,2021-08-04
3174091001,JAKARTA SELATAN,JAGAKARSA,JAGAKARSA,62389,26729,35660,15075,50735,2021-08-04
3175021007,JAKARTA TIMUR,PULO GADUNG,JATI,32757,16010,16747,7809,24556,2021-08-04
3174041002,JAKARTA SELATAN,PASAR MINGGU,JATI PADANG,37502,17293,20209,9033,29242,2021-08-04
3173071004,JAKARTA BARAT,PALMERAH,JATI PULO,28738,12398,16340,5034,21374,2021-08-04
3175061001,JAKARTA TIMUR,CAKUNG,JATINEGARA,84160,42204,41956,11669,53625,2021-08-04
3175021004,JAKARTA TIMUR,PULO GADUNG,JATINEGARA KAUM,24632,11750,12882,4351,17233,2021-08-04
3173021004,JAKARTA BARAT,GROGOL PETAMBURAN,JELAMBAR,30266,13385,16881,8072,24953,2021-08-04
3173021006,JAKARTA BARAT,GROGOL PETAMBURAN,JELAMBAR BARU,38246,17427,20819,9470,30289,2021-08-04
3173041006,JAKARTA BARAT,TAMBORA,JEMBATAN BESI,29314,16497,12817,3765,16582,2021-08-04
3173041008,JAKARTA BARAT,TAMBORA,JEMBATAN LIMA,21021,11231,9790,3633,13423,2021-08-04
3173081005,JAKARTA BARAT,KEMBANGAN,JOGLO,40839,19562,21277,8543,29820,2021-08-04
3171081001,JAKARTA PUSAT,JOHAR BARU,JOHAR BARU,37488,15735,21753,8198,29951,2021-08-04
3173041002,JAKARTA BARAT,TAMBORA,KALI ANYAR,23856,11713,12143,3253,15396,2021-08-04
3172041004,JAKARTA UTARA,CILINCING,KALIBARU,67684,36121,31563,7788,39351,2021-08-04
3174081002,JAKARTA SELATAN,PANCORAN,KALIBATA,41994,21532,20462,7587,28049,2021-08-04
3173061001,JAKARTA BARAT,KALI DERES,KALIDERES,72447,33909,38538,13126,51664,2021-08-04
3175051004,JAKARTA TIMUR,PASAR REBO,KALISARI,43212,19631,23581,10194,33775,2021-08-04
3173061004,JAKARTA BARAT,KALI DERES,KAMAL,53783,27421,26362,6108,32470,2021-08-04
3172011002,JAKARTA UTARA,PENJARINGAN,KAMAL MUARA,12930,4347,8583,4032,12615,2021-08-04
3171071007,JAKARTA PUSAT,TANAH ABANG,KAMPUNG BALI,11358,6123,5235,2074,7309,2021-08-04
3175031001,JAKARTA TIMUR,JATINEGARA,KAMPUNG MELAYU,25717,13832,11885,3746,15631,2021-08-04
3171081002,JAKARTA PUSAT,JOHAR BARU,KAMPUNG RAWA,21237,7703,13534,4164,17698,2021-08-04
3175041002,JAKARTA TIMUR,KRAMAT JATI,KAMPUNG TENGAH,43993,25086,18907,7502,26409,2021-08-04
3173011005,JAKARTA BARAT,CENGKARENG,KAPUK,134466,70792,63674,17809,81483,2021-08-04
3172011003,JAKARTA UTARA,PENJARINGAN,KAPUK MUARA,35781,14459,21322,10026,31348,2021-08-04
3171021002,JAKARTA PUSAT,SAWAH BESAR,KARANG ANYAR,25761,11528,14233,5273,19506,2021-08-04
3174021004,JAKARTA SELATAN,SETIA BUDI,KARET,9623,4591,5032,2321,7353,2021-08-04
3174021003,JAKARTA SELATAN,SETIA BUDI,KARET KUNINGAN,16055,6942,9113,3779,12892,2021-08-04
3174021002,JAKARTA SELATAN,SETIA BUDI,KARET SEMANGGI,2770,1108,1662,916,2578,2021-08-04
3171071003,JAKARTA PUSAT,TANAH ABANG,KARET TENGSIN,19271,8822,10449,3477,13926,2021-08-04
3171021003,JAKARTA PUSAT,SAWAH BESAR,KARTINI,22292,9764,12528,5363,17891,2021-08-04
3175011003,JAKARTA TIMUR,MATRAMAN,KAYU MANIS,25284,13372,11912,4546,16458,2021-08-04
3175021006,JAKARTA TIMUR,PULO GADUNG,KAYU PUTIH,40696,17971,22725,10432,33157,2021-08-04
3173031006,JAKARTA BARAT,TAMAN SARI,KEAGUNGAN,17387,7750,9637,3506,13143,2021-08-04
3174041007,JAKARTA SELATAN,PASAR MINGGU,KEBAGUSAN,44552,21641,22911,8916,31827,2021-08-04
3174051006,JAKARTA SELATAN,KEBAYORAN LAMA,KEBAYORAN LAMA SELATAN,41212,18683,22529,9045,31574,2021-08-04
3174051001,JAKARTA SELATAN,KEBAYORAN LAMA,KEBAYORAN LAMA UTARA,42422,21035,21387,8073,29460,2021-08-04
3174011004,JAKARTA SELATAN,TEBET,KEBON BARU,35165,16202,18963,7752,26715,2021-08-04
3172021005,JAKARTA UTARA,TANJUNG PRIOK,KEBON BAWANG,50952,23597,27355,10495,37850,2021-08-04
3173051001,JAKARTA BARAT,KEBON JERUK,KEBON JERUK,53887,27485,26402,9842,36244,2021-08-04
3171071006,JAKARTA PUSAT,TANAH ABANG,KEBON KACANG,21531,12120,9411,3589,13000,2021-08-04
3171011005,JAKARTA PUSAT,GAMBIR,KEBON KELAPA,10163,4626,5537,2287,7824,2021-08-04
3171031002,JAKARTA PUSAT,KEMAYORAN,KEBON KOSONG,30019,14259,15760,5870,21630,2021-08-04
3175011005,JAKARTA TIMUR,MATRAMAN,KEBON MANGGIS,16490,7507,8983,3963,12946,2021-08-04
3171071005,JAKARTA PUSAT,TANAH ABANG,KEBON MELATI,32206,18941,13265,3995,17260,2021-08-04
3175081003,JAKARTA TIMUR,MAKASAR,KEBON PALA,46614,23103,23511,8987,32498,2021-08-04
3171061005,JAKARTA PUSAT,MENTENG,KEBON SIRIH,12299,6283,6016,2211,8227,2021-08-04
3173011004,JAKARTA BARAT,CENGKARENG,KEDAUNG KALI ANGKE,32612,13062,19550,5469,25019,2021-08-04
3173051007,JAKARTA BARAT,KEBON JERUK,KEDOYA SELATAN,32165,14227,17938,6518,24456,2021-08-04
3173051006,JAKARTA BARAT,KEBON JERUK,KEDOYA UTARA,45740,18877,26863,9923,36786,2021-08-04
3173051004,JAKARTA BARAT,KEBON JERUK,KELAPA DUA,23565,11344,12221,4544,16765,2021-08-04
3175091003,JAKARTA TIMUR,CIRACAS,KELAPA DUA WETAN,46875,21050,25825,10245,36070,2021-08-04
3172061003,JAKARTA UTARA,KELAPA GADING,KELAPA GADING BARAT,35717,13742,21975,11479,33454,2021-08-04
3172061001,JAKARTA UTARA,KELAPA GADING,KELAPA GADING TIMUR,33592,11806,21786,12186,33972,2021-08-04
3173071005,JAKARTA BARAT,PALMERAH,KEMANGGISAN,32139,15508,16631,6810,23441,2021-08-04
3171031001,JAKARTA PUSAT,KEMAYORAN,KEMAYORAN,20708,9069,11639,4509,16148,2021-08-04
3173081006,JAKARTA BARAT,KEMBANGAN,KEMBANGAN SELATAN,27130,12230,14900,6670,21570,2021-08-04
3173081001,JAKARTA BARAT,KEMBANGAN,KEMBANGAN UTARA,54451,24777,29674,9365,39039,2021-08-04
3171041002,JAKARTA PUSAT,SENEN,KENARI,9579,4028,5551,2330,7881,2021-08-04
3173041005,JAKARTA BARAT,TAMBORA,KERENDANG,19973,9364,10609,3341,13950,2021-08-04
3175071003,JAKARTA TIMUR,DUREN SAWIT,KLENDER,69978,39680,30298,11815,42113,2021-08-04
3172031001,JAKARTA UTARA,KOJA,KOJA,28175,13321,14854,4855,19709,2021-08-04
3173071006,JAKARTA BARAT,PALMERAH,KOTA BAMBU SELATAN,21158,10062,11096,3393,14489,2021-08-04
3173071003,JAKARTA BARAT,PALMERAH,KOTA BAMBU UTARA,24995,12176,12819,3984,16803,2021-08-04
3171041004,JAKARTA PUSAT,SENEN,KRAMAT,28835,14625,14210,4724,18934,2021-08-04
3175041001,JAKARTA TIMUR,KRAMAT JATI,KRAMAT JATI,34144,17295,16849,6860,23709,2021-08-04
3174071003,JAKARTA SELATAN,KEBAYORAN BARU,KRAMAT PELA,14413,6397,8016,3515,11531,2021-08-04
3173031002,JAKARTA BARAT,TAMAN SARI,KRUKUT,19244,8772,10472,3519,13991,2021-08-04
3174031005,JAKARTA SELATAN,MAMPANG PRAPATAN,KUNINGAN BARAT,12785,5768,7017,2893,9910,2021-08-04
3174021008,JAKARTA SELATAN,SETIA BUDI,KUNINGAN TIMUR,6008,2760,3248,1534,4782,2021-08-04
3171041005,JAKARTA PUSAT,SENEN,KWITANG,15486,7084,8402,3123,11525,2021-08-04
3172031003,JAKARTA UTARA,KOJA,LAGOA,59065,30027,29038,9245,38283,2021-08-04
3174061002,JAKARTA SELATAN,CILANDAK,LEBAK BULUS,37626,17572,20054,9037,29091,2021-08-04
3174091004,JAKARTA SELATAN,JAGAKARSA,LENTENG AGUNG,53946,26273,27673,10099,37772,2021-08-04
3175101007,JAKARTA TIMUR,CIPAYUNG,LUBANG BUAYA,63547,30344,33203,14614,47817,2021-08-04
3175081001,JAKARTA TIMUR,MAKASAR,MAKASAR,34390,16077,18313,7891,26204,2021-08-04
3175071006,JAKARTA TIMUR,DUREN SAWIT,MALAKA JAYA,30927,14017,16910,7769,24679,2021-08-04
3175071005,JAKARTA TIMUR,DUREN SAWIT,MALAKA SARI,27530,12331,15199,7306,22505,2021-08-04
3174031001,JAKARTA SELATAN,MAMPANG PRAPATAN,MAMPANG PRAPATAN,18159,8469,9690,3855,13545,2021-08-04
3173031005,JAKARTA BARAT,TAMAN SARI,MANGGA BESAR,7707,2975,4732,2241,6973,2021-08-04
3171021005,JAKARTA PUSAT,SAWAH BESAR,MANGGA DUA SELATAN,27442,12617,14825,6137,20962,2021-08-04
3174011007,JAKARTA SELATAN,TEBET,MANGGARAI,28373,12977,15396,5352,20748,2021-08-04
3174011006,JAKARTA SELATAN,TEBET,MANGGARAI SELATAN,23075,10186,12889,5638,18527,2021-08-04
3173031003,JAKARTA BARAT,TAMAN SARI,MAPHAR,16461,7311,9150,3870,13020,2021-08-04
3172041003,JAKARTA UTARA,CILINCING,MARUNDA,28943,13255,15688,4093,19781,2021-08-04
3174071001,JAKARTA SELATAN,KEBAYORAN BARU,MELAWAI,2627,1017,1610,1061,2671,2021-08-04
3171061001,JAKARTA PUSAT,MENTENG,MENTENG,25624,13639,11985,4968,16953,2021-08-04
3174021005,JAKARTA SELATAN,SETIA BUDI,MENTENG ATAS,27816,12364,15452,6053,21505,2021-08-04
3174011003,JAKARTA SELATAN,TEBET,MENTENG DALAM,36028,16881,19147,8127,27274,2021-08-04
3173081003,JAKARTA BARAT,KEMBANGAN,MERUYA SELATAN,32130,15557,16573,6538,23111,2021-08-04
3173081002,JAKARTA BARAT,KEMBANGAN,MERUYA UTARA,43752,20567,23185,9861,33046,2021-08-04
3175101004,JAKARTA TIMUR,CIPAYUNG,MUNJUL,23871,11253,12618,5101,17719,2021-08-04
3172051002,JAKARTA UTARA,PADEMANGAN,PADEMANGAN BARAT,74240,35537,38703,12722,51425,2021-08-04
3172051001,JAKARTA UTARA,PADEMANGAN,PADEMANGAN TIMUR,37736,14846,22890,9740,32630,2021-08-04
3175011004,JAKARTA TIMUR,MATRAMAN,PAL MERIAM,19769,9836,9933,4103,14036,2021-08-04
3173071001,JAKARTA BARAT,PALMERAH,PALMERAH,63011,30660,32351,11603,43954,2021-08-04
3174081001,JAKARTA SELATAN,PANCORAN,PANCORAN,19421,8873,10548,4116,14664,2021-08-04
3172021003,JAKARTA UTARA,TANJUNG PRIOK,PAPANGGO,39097,17106,21991,7791,29782,2021-08-04
3171021001,JAKARTA PUSAT,SAWAH BESAR,PASAR BARU,12035,4704,7331,3607,10938,2021-08-04
3174021006,JAKARTA SELATAN,SETIA BUDI,PASAR MANGGIS,26752,12705,14047,5812,19859,2021-08-04
3174041001,JAKARTA SELATAN,PASAR MINGGU,PASAR MINGGU,24821,11293,13528,6453,19981,2021-08-04
3171041003,JAKARTA PUSAT,SENEN,PASEBAN,23533,10966,12567,4726,17293,2021-08-04
3173061005,JAKARTA BARAT,KALI DERES,PEGADUNGAN,75587,33911,41676,16339,58015,2021-08-04
3171061002,JAKARTA PUSAT,MENTENG,PEGANGSAAN,23455,12471,10984,4262,15246,2021-08-04
3172061002,JAKARTA UTARA,KELAPA GADING,PEGANGSAAN DUA,49976,17785,32191,14650,46841,2021-08-04
3172011004,JAKARTA UTARA,PENJARINGAN,PEJAGALAN,74578,33758,40820,18006,58826,2021-08-04
3174041006,JAKARTA SELATAN,PASAR MINGGU,PEJATEN BARAT,37346,17508,19838,8846,28684,2021-08-04
3174041005,JAKARTA SELATAN,PASAR MINGGU,PEJATEN TIMUR,57656,30069,27587,11217,38804,2021-08-04
3175051005,JAKARTA TIMUR,PASAR REBO,PEKAYON,43250,18925,24325,9220,33545,2021-08-04
3173041009,JAKARTA BARAT,TAMBORA,PEKOJAN,23587,10167,13420,5371,18791,2021-08-04
3174031003,JAKARTA SELATAN,MAMPANG PRAPATAN,PELA MAMPANG,43522,19278,24244,9526,33770,2021-08-04
3174081005,JAKARTA SELATAN,PANCORAN,PENGADEGAN,21478,8733,12745,4854,17599,2021-08-04
3175061003,JAKARTA TIMUR,CAKUNG,PENGGILINGAN,99255,54550,44705,13814,58519,2021-08-04
3172011001,JAKARTA UTARA,PENJARINGAN,PENJARINGAN,88308,46365,41943,14690,56633,2021-08-04
3174101001,JAKARTA SELATAN,PESANGGRAHAN,PESANGGRAHAN,27545,11682,15863,7272,23135,2021-08-04
3171071004,JAKARTA PUSAT,TANAH ABANG,PETAMBURAN,33271,19458,13813,4219,18032,2021-08-04
3174071008,JAKARTA SELATAN,KEBAYORAN BARU,PETOGOGAN,11499,5272,6227,2967,9194,2021-08-04
3171011004,JAKARTA PUSAT,GAMBIR,PETOJO SELATAN,14692,6830,7862,3796,11658,2021-08-04
3171011003,JAKARTA PUSAT,GAMBIR,PETOJO UTARA,17458,8497,8961,3569,12530,2021-08-04
3174101004,JAKARTA SELATAN,PESANGGRAHAN,PETUKANGAN SELATAN,37187,16451,20736,7255,27991,2021-08-04
3174101003,JAKARTA SELATAN,PESANGGRAHAN,PETUKANGAN UTARA,53716,25979,27737,11269,39006,2021-08-04
3175081002,JAKARTA TIMUR,MAKASAR,PINANG RANTI,27198,12677,14521,5720,20241,2021-08-04
3173031008,JAKARTA BARAT,TAMAN SARI,PINANGSIA,10729,4331,6398,2556,8954,2021-08-04
3175011001,JAKARTA TIMUR,MATRAMAN,PISANGAN BARU,31776,16711,15065,5589,20654,2021-08-04
3175021002,JAKARTA TIMUR,PULO GADUNG,PISANGAN TIMUR,41011,19081,21930,8031,29961,2021-08-04
3172011005,JAKARTA UTARA,PENJARINGAN,PLUIT,47783,20256,27527,16439,43966,2021-08-04
3175071002,JAKARTA TIMUR,DUREN SAWIT,PONDOK BAMBU,61550,31575,29975,12896,42871,2021-08-04
3175071004,JAKARTA TIMUR,DUREN SAWIT,PONDOK KELAPA,72015,33724,38291,15723,54014,2021-08-04
3175071007,JAKARTA TIMUR,DUREN SAWIT,PONDOK KOPI,35367,18997,16370,6385,22755,2021-08-04
3174061003,JAKARTA SELATAN,CILANDAK,PONDOK LABU,46464,19988,26476,11555,38031,2021-08-04
3174051002,JAKARTA SELATAN,KEBAYORAN LAMA,PONDOK PINANG,56169,26250,29919,13782,43701,2021-08-04
3175101003,JAKARTA TIMUR,CIPAYUNG,PONDOK RANGGON,25574,13182,12392,5207,17599,2021-08-04
3101011003,KAB.ADM.KEP.SERIBU,KEP. SERIBU UTARA,PULAU HARAPAN,2060,433,1627,749,2376,2021-08-04
3101011002,KAB.ADM.KEP.SERIBU,KEP. SERIBU UTARA,PULAU KELAPA,5528,1170,4358,1524,5882,2021-08-04
3101011001,KAB.ADM.KEP.SERIBU,KEP. SERIBU UTARA,PULAU PANGGANG,5450,1044,4406,1332,5738,2021-08-04
3101021003,KAB.ADM.KEP.SERIBU,KEP. SERIBU SELATAN,PULAU PARI,2765,391,2374,940,3314,2021-08-04
3101021002,KAB.ADM.KEP.SERIBU,KEP. SERIBU SELATAN,PULAU TIDUNG,4553,874,3679,1571,5250,2021-08-04
3101021001,KAB.ADM.KEP.SERIBU,KEP. SERIBU SELATAN,PULAU UNTUNG JAWA,1941,429,1512,687,2199,2021-08-04
3174071007,JAKARTA SELATAN,KEBAYORAN BARU,PULO,5835,2346,3489,1964,5453,2021-08-04
3175021001,JAKARTA TIMUR,PULO GADUNG,PULO GADUNG,34422,17459,16963,6946,23909,2021-08-04
3175061005,JAKARTA TIMUR,CAKUNG,PULO GEBANG,97301,48786,48515,15177,63692,2021-08-04
3174041004,JAKARTA SELATAN,PASAR MINGGU,RAGUNAN,39616,17309,22307,9382,31689,2021-08-04
3175091005,JAKARTA TIMUR,CIRACAS,RAMBUTAN,36771,19746,17025,6349,23374,2021-08-04
3172031006,JAKARTA UTARA,KOJA,RAWA BADAK SELATAN,42179,21537,20642,6081,26723,2021-08-04
3172031004,JAKARTA UTARA,KOJA,RAWA BADAK UTARA,34408,16994,17414,6298,23712,2021-08-04
3174071005,JAKARTA SELATAN,KEBAYORAN BARU,RAWA BARAT,5625,2402,3223,1777,5000,2021-08-04
3173011003,JAKARTA BARAT,CENGKARENG,RAWA BUAYA,63799,31853,31946,9955,41901,2021-08-04
3175031004,JAKARTA TIMUR,JATINEGARA,RAWA BUNGA,21434,11120,10314,3540,13854,2021-08-04
3174081003,JAKARTA SELATAN,PANCORAN,RAWA JATI,20509,8913,11596,4880,16476,2021-08-04
3175061002,JAKARTA TIMUR,CAKUNG,RAWA TERATE,24637,10725,13912,3310,17222,2021-08-04
3175021005,JAKARTA TIMUR,PULO GADUNG,RAWAMANGUN,37612,17769,19843,8287,28130,2021-08-04
3171051003,JAKARTA PUSAT,CEMPAKA PUTIH,RAWASARI,21967,10137,11830,5166,16996,2021-08-04
3173041010,JAKARTA BARAT,TAMBORA,ROA MALAKA,3484,1323,2161,1159,3320,2021-08-04
3172041006,JAKARTA UTARA,CILINCING,ROROTAN,41668,18375,23293,6985,30278,2021-08-04
3174071004,JAKARTA SELATAN,KEBAYORAN BARU,SELONG,2842,1150,1692,1102,2794,2021-08-04
3173061002,JAKARTA BARAT,KALI DERES,SEMANAN,71354,35520,35834,8169,44003,2021-08-04
3172041007,JAKARTA UTARA,CILINCING,SEMPER BARAT,68587,28680,39907,13593,53500,2021-08-04
3172041005,JAKARTA UTARA,CILINCING,SEMPER TIMUR,36267,16797,19470,6899,26369,2021-08-04
3174071006,JAKARTA SELATAN,KEBAYORAN BARU,SENAYAN,2771,1436,1335,762,2097,2021-08-04
3171041001,JAKARTA PUSAT,SENEN,SENEN,6804,3005,3799,1548,5347,2021-08-04
3171031004,JAKARTA PUSAT,KEMAYORAN,SERDANG,29668,13827,15841,5916,21757,2021-08-04
3174021001,JAKARTA SELATAN,SETIA BUDI,SETIA BUDI,3023,1416,1607,854,2461,2021-08-04
3175101005,JAKARTA TIMUR,CIPAYUNG,SETU,20572,10983,9589,3703,13292,2021-08-04
3173071002,JAKARTA BARAT,PALMERAH,SLIPI,16591,7396,9195,3828,13023,2021-08-04
3173081004,JAKARTA BARAT,KEMBANGAN,SRENGSENG,45523,22898,22625,8722,31347,2021-08-04
3174091002,JAKARTA SELATAN,JAGAKARSA,SRENGSENG SAWAH,58196,23681,34515,14842,49357,2021-08-04
3173051003,JAKARTA BARAT,KEBON JERUK,SUKABUMI SELATAN,37033,19687,17346,5604,22950,2021-08-04
3173051002,JAKARTA BARAT,KEBON JERUK,SUKABUMI UTARA,38290,21525,16765,5845,22610,2021-08-04
3172041002,JAKARTA UTARA,CILINCING,SUKAPURA,53949,25262,28687,8946,37633,2021-08-04
3171031007,JAKARTA PUSAT,KEMAYORAN,SUMUR BATU,22717,10571,12146,5353,17499,2021-08-04
3172021004,JAKARTA UTARA,TANJUNG PRIOK,SUNGAI BAMBU,29876,13551,16325,6498,22823,2021-08-04
3172021006,JAKARTA UTARA,TANJUNG PRIOK,SUNTER AGUNG,71805,28281,43524,19607,63131,2021-08-04
3172021002,JAKARTA UTARA,TANJUNG PRIOK,SUNTER JAYA,63031,26680,36351,15864,52215,2021-08-04
3175091004,JAKARTA TIMUR,CIRACAS,SUSUKAN,38257,18086,20171,7774,27945,2021-08-04
3173031001,JAKARTA BARAT,TAMAN SARI,TAMAN SARI,14348,6206,8142,3597,11739,2021-08-04
3173041001,JAKARTA BARAT,TAMBORA,TAMBORA,10204,5110,5094,2198,7292,2021-08-04
3173041004,JAKARTA BARAT,TAMBORA,TANAH SEREAL,26387,10070,16317,5617,21934,2021-08-04
3171081004,JAKARTA PUSAT,JOHAR BARU,TANAH TINGGI,37693,15248,22445,6951,29396,2021-08-04
3173031004,JAKARTA BARAT,TAMAN SARI,TANGKI,13324,5759,7565,3032,10597,2021-08-04
3174091005,JAKARTA SELATAN,JAGAKARSA,TANJUNG BARAT,39770,18073,21697,8649,30346,2021-08-04
3173021005,JAKARTA BARAT,GROGOL PETAMBURAN,TANJUNG DUREN SELATAN,25337,10782,14555,6371,20926,2021-08-04
3173021002,JAKARTA BARAT,GROGOL PETAMBURAN,TANJUNG DUREN UTARA,17010,6773,10237,4780,15017,2021-08-04
3172021001,JAKARTA UTARA,TANJUNG PRIOK,TANJUNG PRIOK,34588,14520,20068,5965,26033,2021-08-04
3174011002,JAKARTA SELATAN,TEBET,TEBET BARAT,21194,8682,12512,5911,18423,2021-08-04
3174011001,JAKARTA SELATAN,TEBET,TEBET TIMUR,18199,7320,10879,5266,16145,2021-08-04
3173061003,JAKARTA BARAT,KALI DERES,TEGAL ALUR,83647,39601,44046,12242,56288,2021-08-04
3174031004,JAKARTA SELATAN,MAMPANG PRAPATAN,TEGAL PARANG,32401,16032,16369,5654,22023,2021-08-04
3173021003,JAKARTA BARAT,GROGOL PETAMBURAN,TOMANG,29605,13217,16388,7231,23619,2021-08-04
3172031005,JAKARTA UTARA,KOJA,TUGU SELATAN,39122,19506,19616,6016,25632,2021-08-04
3172031002,JAKARTA UTARA,KOJA,TUGU UTARA,67670,34338,33332,10900,44232,2021-08-04
3175061006,JAKARTA TIMUR,CAKUNG,UJUNG MENTENG,29934,12849,17085,5806,22891,2021-08-04
3174101005,JAKARTA SELATAN,PESANGGRAHAN,ULUJAMI,40544,19878,20666,7471,28137,2021-08-04
3175011006,JAKARTA TIMUR,MATRAMAN,UTAN KAYU SELATAN,33511,15810,17701,7434,25135,2021-08-04
3175011002,JAKARTA TIMUR,MATRAMAN,UTAN KAYU UTARA,28169,13962,14207,5812,20019,2021-08-04
3171031008,JAKARTA PUSAT,KEMAYORAN,UTAN PANJANG,29208,14247,14961,4553,19514,2021-08-04
3172021007,JAKARTA UTARA,TANJUNG PRIOK,WARAKAS,44401,20017,24384,8507,32891,2021-08-04
3173021007,JAKARTA BARAT,GROGOL PETAMBURAN,WIJAYA KUSUMA,38934,18530,20404,7834,28238,2021-08-04
3172051003,JAKARTA UTARA,PADEMANGAN,ANCOL,23947,11422,12525,4831,17356,2021-08-05
3173041007,JAKARTA BARAT,TAMBORA,ANGKE,29381,12912,16469,5570,22039,2021-08-05
3175041005,JAKARTA TIMUR,KRAMAT JATI,BALE KAMBANG,29074,17230,11844,4091,15935,2021-08-05
3175031003,JAKARTA TIMUR,JATINEGARA,BALI MESTER,9752,4635,5117,2278,7395,2021-08-05
3175101006,JAKARTA TIMUR,CIPAYUNG,BAMBU APUS,26285,12354,13931,5743,19674,2021-08-05
3174031002,JAKARTA SELATAN,MAMPANG PRAPATAN,BANGKA,21566,9934,11632,4610,16242,2021-08-05
3175051002,JAKARTA TIMUR,PASAR REBO,BARU,23886,9594,14292,6559,20851,2021-08-05
3175041004,JAKARTA TIMUR,KRAMAT JATI,BATU AMPAR,47898,26455,21443,8211,29654,2021-08-05
3171071002,JAKARTA PUSAT,TANAH ABANG,BENDUNGAN HILIR,21494,9500,11994,5224,17218,2021-08-05
3175031002,JAKARTA TIMUR,JATINEGARA,BIDARA CINA,36689,20156,16533,6334,22867,2021-08-05
3174101002,JAKARTA SELATAN,PESANGGRAHAN,BINTARO,53098,23938,29160,11520,40680,2021-08-05
3174011005,JAKARTA SELATAN,TEBET,BUKIT DURI,34183,16591,17592,7046,24638,2021-08-05
3171041006,JAKARTA PUSAT,SENEN,BUNGUR,18144,7942,10202,4304,14506,2021-08-05
3175061007,JAKARTA TIMUR,CAKUNG,CAKUNG BARAT,57724,24371,33353,8854,42207,2021-08-05
3175061004,JAKARTA TIMUR,CAKUNG,CAKUNG TIMUR,58287,25323,32964,11800,44764,2021-08-05
3175041007,JAKARTA TIMUR,KRAMAT JATI,CAWANG,32762,16638,16124,6695,22819,2021-08-05
3175101008,JAKARTA TIMUR,CIPAYUNG,CEGER,18932,8382,10550,3842,14392,2021-08-05
3171031006,JAKARTA PUSAT,KEMAYORAN,CEMPAKA BARU,32581,16316,16265,6238,22503,2021-08-05
3171051002,JAKARTA PUSAT,CEMPAKA PUTIH,CEMPAKA PUTIH BARAT,35885,16699,19186,7652,26838,2021-08-05
3171051001,JAKARTA PUSAT,CEMPAKA PUTIH,CEMPAKA PUTIH TIMUR,24292,11112,13180,6499,19679,2021-08-05
3173011001,JAKARTA BARAT,CENGKARENG,CENGKARENG BARAT,66284,30147,36137,14673,50810,2021-08-05
3173011006,JAKARTA BARAT,CENGKARENG,CENGKARENG TIMUR,81027,37767,43260,15887,59147,2021-08-05
3175091002,JAKARTA TIMUR,CIRACAS,CIBUBUR,66364,28856,37508,15499,53007,2021-08-05
3171011002,JAKARTA PUSAT,GAMBIR,CIDENG,15390,6394,8996,4383,13379,2021-08-05
3174091003,JAKARTA SELATAN,JAGAKARSA,CIGANJUR,38497,17253,21244,8604,29848,2021-08-05
3175051003,JAKARTA TIMUR,PASAR REBO,CIJANTUNG,41419,18574,22845,9943,32788,2021-08-05
3171061003,JAKARTA PUSAT,MENTENG,CIKINI,8274,4151,4123,1974,6097,2021-08-05
3174081006,JAKARTA SELATAN,PANCORAN,CIKOKO,10547,4270,6277,2453,8730,2021-08-05
3174061001,JAKARTA SELATAN,CILANDAK,CILANDAK BARAT,51752,22111,29641,13449,43090,2021-08-05
3174041003,JAKARTA SELATAN,PASAR MINGGU,CILANDAK TIMUR,25145,10830,14315,7142,21457,2021-08-05
3175101002,JAKARTA TIMUR,CIPAYUNG,CILANGKAP,27635,12725,14910,5841,20751,2021-08-05
3175041006,JAKARTA TIMUR,KRAMAT JATI,CILILITAN,40181,21129,19052,8031,27083,2021-08-05
3172041001,JAKARTA UTARA,CILINCING,CILINCING,43609,21646,21963,7211,29174,2021-08-05
3175101001,JAKARTA TIMUR,CIPAYUNG,CIPAYUNG,26104,11282,14822,6241,21063,2021-08-05
3174091006,JAKARTA SELATAN,JAGAKARSA,CIPEDAK,38303,15996,22307,9032,31339,2021-08-05
3174061005,JAKARTA SELATAN,CILANDAK,CIPETE SELATAN,26704,12070,14634,6768,21402,2021-08-05
3174071010,JAKARTA SELATAN,KEBAYORAN BARU,CIPETE UTARA,34102,15392,18710,7205,25915,2021-08-05
3175021003,JAKARTA TIMUR,PULO GADUNG,CIPINANG,39306,18673,20633,9039,29672,2021-08-05
3175031007,JAKARTA TIMUR,JATINEGARA,CIPINANG BESAR SELATAN,35212,19169,16043,5858,21901,2021-08-05
3175031008,JAKARTA TIMUR,JATINEGARA,CIPINANG BESAR UTARA,45319,24395,20924,6622,27546,2021-08-05
3175031005,JAKARTA TIMUR,JATINEGARA,CIPINANG CEMPEDAK,32824,17002,15822,7017,22839,2021-08-05
3175081005,JAKARTA TIMUR,MAKASAR,CIPINANG MELAYU,42308,19865,22443,9820,32263,2021-08-05
3175031006,JAKARTA TIMUR,JATINEGARA,CIPINANG MUARA,55243,28712,26531,10691,37222,2021-08-05
3174051003,JAKARTA SELATAN,KEBAYORAN LAMA,CIPULIR,39937,19643,20294,7819,28113,2021-08-05
3175091001,JAKARTA TIMUR,CIRACAS,CIRACAS,64594,28476,36118,13551,49669,2021-08-05
3175041003,JAKARTA TIMUR,KRAMAT JATI,DUKUH,24609,11657,12952,5247,18199,2021-08-05
3175071001,JAKARTA TIMUR,DUREN SAWIT,DUREN SAWIT,61160,31683,29477,14011,43488,2021-08-05
3174081004,JAKARTA SELATAN,PANCORAN,DUREN TIGA,28319,12508,15811,5860,21671,2021-08-05
3173051005,JAKARTA BARAT,KEBON JERUK,DURI KEPA,60138,25520,34618,14864,49482,2021-08-05
3173011002,JAKARTA BARAT,CENGKARENG,DURI KOSAMBI,77923,39122,38801,14506,53307,2021-08-05
3171011006,JAKARTA PUSAT,GAMBIR,DURI PULO,19610,9288,10322,3547,13869,2021-08-05
3173041011,JAKARTA BARAT,TAMBORA,DURI SELATAN,14259,5843,8416,3348,11764,2021-08-05
3173041003,JAKARTA BARAT,TAMBORA,DURI UTARA,19844,8508,11336,3938,15274,2021-08-05
3171081003,JAKARTA PUSAT,JOHAR BARU,GALUR,18243,7343,10900,3334,14234,2021-08-05
3171011001,JAKARTA PUSAT,GAMBIR,GAMBIR,2191,875,1316,669,1985,2021-08-05
3174061004,JAKARTA SELATAN,CILANDAK,GANDARIA SELATAN,22119,9886,12233,5045,17278,2021-08-05
3174071009,JAKARTA SELATAN,KEBAYORAN BARU,GANDARIA UTARA,39922,18528,21394,8770,30164,2021-08-05
3175051001,JAKARTA TIMUR,PASAR REBO,GEDONG,35755,16511,19244,7978,27222,2021-08-05
3171071001,JAKARTA PUSAT,TANAH ABANG,GELORA,3127,1437,1690,769,2459,2021-08-05
3173031007,JAKARTA BARAT,TAMAN SARI,GLODOK,7837,2846,4991,2824,7815,2021-08-05
3171061004,JAKARTA PUSAT,MENTENG,GONDANGDIA,4100,1730,2370,1574,3944,2021-08-05
3173021001,JAKARTA BARAT,GROGOL PETAMBURAN,GROGOL,16876,7488,9388,4061,13449,2021-08-05
3174051005,JAKARTA SELATAN,KEBAYORAN LAMA,GROGOL SELATAN,44251,21339,22912,8747,31659,2021-08-05
3174051004,JAKARTA SELATAN,KEBAYORAN LAMA,GROGOL UTARA,42494,20102,22392,8659,31051,2021-08-05
3174021007,JAKARTA SELATAN,SETIA BUDI,GUNTUR,3985,1666,2319,1310,3629,2021-08-05
3174071002,JAKARTA SELATAN,KEBAYORAN BARU,GUNUNG,9436,4016,5420,2937,8357,2021-08-05
3171031005,JAKARTA PUSAT,KEMAYORAN,GUNUNG SAHARI SELATAN,19199,8627,10572,4664,15236,2021-08-05
3171021004,JAKARTA PUSAT,SAWAH BESAR,GUNUNG SAHARI UTARA,16650,6412,10238,4949,15187,2021-08-05
3175081004,JAKARTA TIMUR,MAKASAR,HALIM PERDANA KUSUMAH,28363,9566,18797,11720,30517,2021-08-05
3171031003,JAKARTA PUSAT,KEMAYORAN,HARAPAN MULIA,22557,10477,12080,4542,16622,2021-08-05
3174091001,JAKARTA SELATAN,JAGAKARSA,JAGAKARSA,62389,26389,36000,15512,51512,2021-08-05
3175021007,JAKARTA TIMUR,PULO GADUNG,JATI,32757,15599,17158,8144,25302,2021-08-05
3174041002,JAKARTA SELATAN,PASAR MINGGU,JATI PADANG,37502,17079,20423,9374,29797,2021-08-05
3173071004,JAKARTA BARAT,PALMERAH,JATI PULO,28738,12203,16535,5271,21806,2021-08-05
3175061001,JAKARTA TIMUR,CAKUNG,JATINEGARA,84160,40977,43183,12404,55587,2021-08-05
3175021004,JAKARTA TIMUR,PULO GADUNG,JATINEGARA KAUM,24632,11204,13428,4567,17995,2021-08-05
3173021004,JAKARTA BARAT,GROGOL PETAMBURAN,JELAMBAR,30266,13116,17150,8255,25405,2021-08-05
3173021006,JAKARTA BARAT,GROGOL PETAMBURAN,JELAMBAR BARU,38246,17034,21212,9772,30984,2021-08-05
3173041006,JAKARTA BARAT,TAMBORA,JEMBATAN BESI,29314,16265,13049,3936,16985,2021-08-05
3173041008,JAKARTA BARAT,TAMBORA,JEMBATAN LIMA,21021,10894,10127,3789,13916,2021-08-05
3173081005,JAKARTA BARAT,KEMBANGAN,JOGLO,40839,19169,21670,8798,30468,2021-08-05
3171081001,JAKARTA PUSAT,JOHAR BARU,JOHAR BARU,37488,15591,21897,8519,30416,2021-08-05
3173041002,JAKARTA BARAT,TAMBORA,KALI ANYAR,23856,11323,12533,3468,16001,2021-08-05
3172041004,JAKARTA UTARA,CILINCING,KALIBARU,67684,35664,32020,8323,40343,2021-08-05
3174081002,JAKARTA SELATAN,PANCORAN,KALIBATA,41994,21322,20672,7821,28493,2021-08-05
3173061001,JAKARTA BARAT,KALI DERES,KALIDERES,72447,32743,39704,13932,53636,2021-08-05
3175051004,JAKARTA TIMUR,PASAR REBO,KALISARI,43212,19385,23827,10463,34290,2021-08-05
3173061004,JAKARTA BARAT,KALI DERES,KAMAL,53783,26924,26859,6378,33237,2021-08-05
3172011002,JAKARTA UTARA,PENJARINGAN,KAMAL MUARA,12930,4266,8664,4205,12869,2021-08-05
3171071007,JAKARTA PUSAT,TANAH ABANG,KAMPUNG BALI,11358,5998,5360,2139,7499,2021-08-05
3175031001,JAKARTA TIMUR,JATINEGARA,KAMPUNG MELAYU,25717,13609,12108,4029,16137,2021-08-05
3171081002,JAKARTA PUSAT,JOHAR BARU,KAMPUNG RAWA,21237,7636,13601,4317,17918,2021-08-05
3175041002,JAKARTA TIMUR,KRAMAT JATI,KAMPUNG TENGAH,43993,24320,19673,7722,27395,2021-08-05
3173011005,JAKARTA BARAT,CENGKARENG,KAPUK,134466,68651,65815,18925,84740,2021-08-05
3172011003,JAKARTA UTARA,PENJARINGAN,KAPUK MUARA,35781,14189,21592,10636,32228,2021-08-05
3171021002,JAKARTA PUSAT,SAWAH BESAR,KARANG ANYAR,25761,11181,14580,5499,20079,2021-08-05
3174021004,JAKARTA SELATAN,SETIA BUDI,KARET,9623,4546,5077,2403,7480,2021-08-05
3174021003,JAKARTA SELATAN,SETIA BUDI,KARET KUNINGAN,16055,6864,9191,3900,13091,2021-08-05
3174021002,JAKARTA SELATAN,SETIA BUDI,KARET SEMANGGI,2770,1099,1671,934,2605,2021-08-05
3171071003,JAKARTA PUSAT,TANAH ABANG,KARET TENGSIN,19271,8698,10573,3662,14235,2021-08-05
3171021003,JAKARTA PUSAT,SAWAH BESAR,KARTINI,22292,9643,12649,5528,18177,2021-08-05
3175011003,JAKARTA TIMUR,MATRAMAN,KAYU MANIS,25284,12934,12350,4724,17074,2021-08-05
3175021006,JAKARTA TIMUR,PULO GADUNG,KAYU PUTIH,40696,17606,23090,10886,33976,2021-08-05
3173031006,JAKARTA BARAT,TAMAN SARI,KEAGUNGAN,17387,7520,9867,3749,13616,2021-08-05
3174041007,JAKARTA SELATAN,PASAR MINGGU,KEBAGUSAN,44552,21261,23291,9210,32501,2021-08-05
3174051006,JAKARTA SELATAN,KEBAYORAN LAMA,KEBAYORAN LAMA SELATAN,41212,18516,22696,9245,31941,2021-08-05
3174051001,JAKARTA SELATAN,KEBAYORAN LAMA,KEBAYORAN LAMA UTARA,42422,20867,21555,8300,29855,2021-08-05
3174011004,JAKARTA SELATAN,TEBET,KEBON BARU,35165,15982,19183,8031,27214,2021-08-05
3172021005,JAKARTA UTARA,TANJUNG PRIOK,KEBON BAWANG,50952,23276,27676,11222,38898,2021-08-05
3173051001,JAKARTA BARAT,KEBON JERUK,KEBON JERUK,53887,26671,27216,10290,37506,2021-08-05
3171071006,JAKARTA PUSAT,TANAH ABANG,KEBON KACANG,21531,11908,9623,3745,13368,2021-08-05
3171011005,JAKARTA PUSAT,GAMBIR,KEBON KELAPA,10163,4563,5600,2358,7958,2021-08-05
3171031002,JAKARTA PUSAT,KEMAYORAN,KEBON KOSONG,30019,14071,15948,6115,22063,2021-08-05
3175011005,JAKARTA TIMUR,MATRAMAN,KEBON MANGGIS,16490,7373,9117,4054,13171,2021-08-05
3171071005,JAKARTA PUSAT,TANAH ABANG,KEBON MELATI,32206,18772,13434,4199,17633,2021-08-05
3175081003,JAKARTA TIMUR,MAKASAR,KEBON PALA,46614,22458,24156,9282,33438,2021-08-05
3171061005,JAKARTA PUSAT,MENTENG,KEBON SIRIH,12299,6134,6165,2305,8470,2021-08-05
3173011004,JAKARTA BARAT,CENGKARENG,KEDAUNG KALI ANGKE,32612,12849,19763,5790,25553,2021-08-05
3173051007,JAKARTA BARAT,KEBON JERUK,KEDOYA SELATAN,32165,13880,18285,6721,25006,2021-08-05
3173051006,JAKARTA BARAT,KEBON JERUK,KEDOYA UTARA,45740,18371,27369,10409,37778,2021-08-05
3173051004,JAKARTA BARAT,KEBON JERUK,KELAPA DUA,23565,11039,12526,4729,17255,2021-08-05
3175091003,JAKARTA TIMUR,CIRACAS,KELAPA DUA WETAN,46875,20388,26487,10562,37049,2021-08-05
3172061003,JAKARTA UTARA,KELAPA GADING,KELAPA GADING BARAT,35717,13614,22103,11919,34022,2021-08-05
3172061001,JAKARTA UTARA,KELAPA GADING,KELAPA GADING TIMUR,33592,11737,21855,12600,34455,2021-08-05
3173071005,JAKARTA BARAT,PALMERAH,KEMANGGISAN,32139,15151,16988,7135,24123,2021-08-05
3171031001,JAKARTA PUSAT,KEMAYORAN,KEMAYORAN,20708,8951,11757,4677,16434,2021-08-05
3173081006,JAKARTA BARAT,KEMBANGAN,KEMBANGAN SELATAN,27130,12067,15063,6919,21982,2021-08-05
3173081001,JAKARTA BARAT,KEMBANGAN,KEMBANGAN UTARA,54451,24306,30145,9897,40042,2021-08-05
3171041002,JAKARTA PUSAT,SENEN,KENARI,9579,3980,5599,2396,7995,2021-08-05
3173041005,JAKARTA BARAT,TAMBORA,KERENDANG,19973,9223,10750,3518,14268,2021-08-05
3175071003,JAKARTA TIMUR,DUREN SAWIT,KLENDER,69978,38472,31506,12172,43678,2021-08-05
3172031001,JAKARTA UTARA,KOJA,KOJA,28175,13189,14986,5365,20351,2021-08-05
3173071006,JAKARTA BARAT,PALMERAH,KOTA BAMBU SELATAN,21158,9830,11328,3746,15074,2021-08-05
3173071003,JAKARTA BARAT,PALMERAH,KOTA BAMBU UTARA,24995,11963,13032,4240,17272,2021-08-05
3171041004,JAKARTA PUSAT,SENEN,KRAMAT,28835,14511,14324,4908,19232,2021-08-05
3175041001,JAKARTA TIMUR,KRAMAT JATI,KRAMAT JATI,34144,16802,17342,7046,24388,2021-08-05
3174071003,JAKARTA SELATAN,KEBAYORAN BARU,KRAMAT PELA,14413,6329,8084,3607,11691,2021-08-05
3173031002,JAKARTA BARAT,TAMAN SARI,KRUKUT,19244,8594,10650,3829,14479,2021-08-05
3174031005,JAKARTA SELATAN,MAMPANG PRAPATAN,KUNINGAN BARAT,12785,5714,7071,3027,10098,2021-08-05
3174021008,JAKARTA SELATAN,SETIA BUDI,KUNINGAN TIMUR,6008,2725,3283,1584,4867,2021-08-05
3171041005,JAKARTA PUSAT,SENEN,KWITANG,15486,6966,8520,3242,11762,2021-08-05
3172031003,JAKARTA UTARA,KOJA,LAGOA,59065,29774,29291,9870,39161,2021-08-05
3174061002,JAKARTA SELATAN,CILANDAK,LEBAK BULUS,37626,17374,20252,9279,29531,2021-08-05
3174091004,JAKARTA SELATAN,JAGAKARSA,LENTENG AGUNG,53946,25798,28148,10441,38589,2021-08-05
3175101007,JAKARTA TIMUR,CIPAYUNG,LUBANG BUAYA,63547,29349,34198,15214,49412,2021-08-05
3175081001,JAKARTA TIMUR,MAKASAR,MAKASAR,34390,15644,18746,8077,26823,2021-08-05
3175071006,JAKARTA TIMUR,DUREN SAWIT,MALAKA JAYA,30927,13853,17074,7997,25071,2021-08-05
3175071005,JAKARTA TIMUR,DUREN SAWIT,MALAKA SARI,27530,12189,15341,7520,22861,2021-08-05
3174031001,JAKARTA SELATAN,MAMPANG PRAPATAN,MAMPANG PRAPATAN,18159,8270,9889,4030,13919,2021-08-05
3173031005,JAKARTA BARAT,TAMAN SARI,MANGGA BESAR,7707,2935,4772,2308,7080,2021-08-05
3171021005,JAKARTA PUSAT,SAWAH BESAR,MANGGA DUA SELATAN,27442,12409,15033,6443,21476,2021-08-05
3174011007,JAKARTA SELATAN,TEBET,MANGGARAI,28373,12658,15715,5572,21287,2021-08-05
3174011006,JAKARTA SELATAN,TEBET,MANGGARAI SELATAN,23075,9964,13111,5813,18924,2021-08-05
3173031003,JAKARTA BARAT,TAMAN SARI,MAPHAR,16461,7220,9241,4026,13267,2021-08-05
3172041003,JAKARTA UTARA,CILINCING,MARUNDA,28943,12958,15985,4554,20539,2021-08-05
3174071001,JAKARTA SELATAN,KEBAYORAN BARU,MELAWAI,2627,1007,1620,1086,2706,2021-08-05
3171061001,JAKARTA PUSAT,MENTENG,MENTENG,25624,13287,12337,5176,17513,2021-08-05
3174021005,JAKARTA SELATAN,SETIA BUDI,MENTENG ATAS,27816,12197,15619,6259,21878,2021-08-05
3174011003,JAKARTA SELATAN,TEBET,MENTENG DALAM,36028,16525,19503,8410,27913,2021-08-05
3173081003,JAKARTA BARAT,KEMBANGAN,MERUYA SELATAN,32130,15201,16929,6736,23665,2021-08-05
3173081002,JAKARTA BARAT,KEMBANGAN,MERUYA UTARA,43752,20172,23580,10192,33772,2021-08-05
3175101004,JAKARTA TIMUR,CIPAYUNG,MUNJUL,23871,10758,13113,5261,18374,2021-08-05
3172051002,JAKARTA UTARA,PADEMANGAN,PADEMANGAN BARAT,74240,34924,39316,13336,52652,2021-08-05
3172051001,JAKARTA UTARA,PADEMANGAN,PADEMANGAN TIMUR,37736,14665,23071,10191,33262,2021-08-05
3175011004,JAKARTA TIMUR,MATRAMAN,PAL MERIAM,19769,9577,10192,4262,14454,2021-08-05
3173071001,JAKARTA BARAT,PALMERAH,PALMERAH,63011,29851,33160,12169,45329,2021-08-05
3174081001,JAKARTA SELATAN,PANCORAN,PANCORAN,19421,8803,10618,4301,14919,2021-08-05
3172021003,JAKARTA UTARA,TANJUNG PRIOK,PAPANGGO,39097,16727,22370,8506,30876,2021-08-05
3171021001,JAKARTA PUSAT,SAWAH BESAR,PASAR BARU,12035,4643,7392,3776,11168,2021-08-05
3174021006,JAKARTA SELATAN,SETIA BUDI,PASAR MANGGIS,26752,12519,14233,6106,20339,2021-08-05
3174041001,JAKARTA SELATAN,PASAR MINGGU,PASAR MINGGU,24821,11103,13718,6654,20372,2021-08-05
3171041003,JAKARTA PUSAT,SENEN,PASEBAN,23533,10881,12652,4891,17543,2021-08-05
3173061005,JAKARTA BARAT,KALI DERES,PEGADUNGAN,75587,33123,42464,16825,59289,2021-08-05
3171061002,JAKARTA PUSAT,MENTENG,PEGANGSAAN,23455,12155,11300,4431,15731,2021-08-05
3172061002,JAKARTA UTARA,KELAPA GADING,PEGANGSAAN DUA,49976,17534,32442,15489,47931,2021-08-05
3172011004,JAKARTA UTARA,PENJARINGAN,PEJAGALAN,74578,33187,41391,18842,60233,2021-08-05
3174041006,JAKARTA SELATAN,PASAR MINGGU,PEJATEN BARAT,37346,17341,20005,9121,29126,2021-08-05
3174041005,JAKARTA SELATAN,PASAR MINGGU,PEJATEN TIMUR,57656,29600,28056,11606,39662,2021-08-05
3175051005,JAKARTA TIMUR,PASAR REBO,PEKAYON,43250,18568,24682,9505,34187,2021-08-05
3173041009,JAKARTA BARAT,TAMBORA,PEKOJAN,23587,10046,13541,5562,19103,2021-08-05
3174031003,JAKARTA SELATAN,MAMPANG PRAPATAN,PELA MAMPANG,43522,19056,24466,9996,34462,2021-08-05
3174081005,JAKARTA SELATAN,PANCORAN,PENGADEGAN,21478,8671,12807,4982,17789,2021-08-05
3175061003,JAKARTA TIMUR,CAKUNG,PENGGILINGAN,99255,53317,45938,14461,60399,2021-08-05
3172011001,JAKARTA UTARA,PENJARINGAN,PENJARINGAN,88308,45648,42660,15662,58322,2021-08-05
3174101001,JAKARTA SELATAN,PESANGGRAHAN,PESANGGRAHAN,27545,11544,16001,7400,23401,2021-08-05
3171071004,JAKARTA PUSAT,TANAH ABANG,PETAMBURAN,33271,18943,14328,4497,18825,2021-08-05
3174071008,JAKARTA SELATAN,KEBAYORAN BARU,PETOGOGAN,11499,5230,6269,3020,9289,2021-08-05
3171011004,JAKARTA PUSAT,GAMBIR,PETOJO SELATAN,14692,6736,7956,3893,11849,2021-08-05
3171011003,JAKARTA PUSAT,GAMBIR,PETOJO UTARA,17458,8317,9141,3750,12891,2021-08-05
3174101004,JAKARTA SELATAN,PESANGGRAHAN,PETUKANGAN SELATAN,37187,16330,20857,7405,28262,2021-08-05
3174101003,JAKARTA SELATAN,PESANGGRAHAN,PETUKANGAN UTARA,53716,25677,28039,11524,39563,2021-08-05
3175081002,JAKARTA TIMUR,MAKASAR,PINANG RANTI,27198,12526,14672,5854,20526,2021-08-05
3173031008,JAKARTA BARAT,TAMAN SARI,PINANGSIA,10729,4285,6444,2726,9170,2021-08-05
3175011001,JAKARTA TIMUR,MATRAMAN,PISANGAN BARU,31776,16238,15538,5783,21321,2021-08-05
3175021002,JAKARTA TIMUR,PULO GADUNG,PISANGAN TIMUR,41011,18464,22547,8540,31087,2021-08-05
3172011005,JAKARTA UTARA,PENJARINGAN,PLUIT,47783,20075,27708,16855,44563,2021-08-05
3175071002,JAKARTA TIMUR,DUREN SAWIT,PONDOK BAMBU,61550,31049,30501,13295,43796,2021-08-05
3175071004,JAKARTA TIMUR,DUREN SAWIT,PONDOK KELAPA,72015,32940,39075,16162,55237,2021-08-05
3175071007,JAKARTA TIMUR,DUREN SAWIT,PONDOK KOPI,35367,18626,16741,6613,23354,2021-08-05
3174061003,JAKARTA SELATAN,CILANDAK,PONDOK LABU,46464,19810,26654,12004,38658,2021-08-05
3174051002,JAKARTA SELATAN,KEBAYORAN LAMA,PONDOK PINANG,56169,25898,30271,14183,44454,2021-08-05
3175101003,JAKARTA TIMUR,CIPAYUNG,PONDOK RANGGON,25574,12648,12926,5532,18458,2021-08-05
3101011003,KAB.ADM.KEP.SERIBU,KEP. SERIBU UTARA,PULAU HARAPAN,2060,427,1633,756,2389,2021-08-05
3101011002,KAB.ADM.KEP.SERIBU,KEP. SERIBU UTARA,PULAU KELAPA,5528,1147,4381,1554,5935,2021-08-05
3101011001,KAB.ADM.KEP.SERIBU,KEP. SERIBU UTARA,PULAU PANGGANG,5450,1023,4427,1447,5874,2021-08-05
3101021003,KAB.ADM.KEP.SERIBU,KEP. SERIBU SELATAN,PULAU PARI,2765,386,2379,1040,3419,2021-08-05
3101021002,KAB.ADM.KEP.SERIBU,KEP. SERIBU SELATAN,PULAU TIDUNG,4553,863,3690,1584,5274,2021-08-05
3101021001,KAB.ADM.KEP.SERIBU,KEP. SERIBU SELATAN,PULAU UNTUNG JAWA,1941,421,1520,745,2265,2021-08-05
3174071007,JAKARTA SELATAN,KEBAYORAN BARU,PULO,5835,2328,3507,2033,5540,2021-08-05
3175021001,JAKARTA TIMUR,PULO GADUNG,PULO GADUNG,34422,16993,17429,7324,24753,2021-08-05
3175061005,JAKARTA TIMUR,CAKUNG,PULO GEBANG,97301,47673,49628,15989,65617,2021-08-05
3174041004,JAKARTA SELATAN,PASAR MINGGU,RAGUNAN,39616,17121,22495,9669,32164,2021-08-05
3175091005,JAKARTA TIMUR,CIRACAS,RAMBUTAN,36771,19338,17433,6620,24053,2021-08-05
3172031006,JAKARTA UTARA,KOJA,RAWA BADAK SELATAN,42179,21392,20787,6417,27204,2021-08-05
3172031004,JAKARTA UTARA,KOJA,RAWA BADAK UTARA,34408,16871,17537,6704,24241,2021-08-05
3174071005,JAKARTA SELATAN,KEBAYORAN BARU,RAWA BARAT,5625,2367,3258,1843,5101,2021-08-05
3173011003,JAKARTA BARAT,CENGKARENG,RAWA BUAYA,63799,30884,32915,10325,43240,2021-08-05
3175031004,JAKARTA TIMUR,JATINEGARA,RAWA BUNGA,21434,10938,10496,3783,14279,2021-08-05
3174081003,JAKARTA SELATAN,PANCORAN,RAWA JATI,20509,8823,11686,5016,16702,2021-08-05
3175061002,JAKARTA TIMUR,CAKUNG,RAWA TERATE,24637,10220,14417,3474,17891,2021-08-05
3175021005,JAKARTA TIMUR,PULO GADUNG,RAWAMANGUN,37612,17434,20178,8623,28801,2021-08-05
3171051003,JAKARTA PUSAT,CEMPAKA PUTIH,RAWASARI,21967,10035,11932,5345,17277,2021-08-05
3173041010,JAKARTA BARAT,TAMBORA,ROA MALAKA,3484,1319,2165,1192,3357,2021-08-05
3172041006,JAKARTA UTARA,CILINCING,ROROTAN,41668,18019,23649,7538,31187,2021-08-05
3174071004,JAKARTA SELATAN,KEBAYORAN BARU,SELONG,2842,1147,1695,1122,2817,2021-08-05
3173061002,JAKARTA BARAT,KALI DERES,SEMANAN,71354,35019,36335,8519,44854,2021-08-05
3172041007,JAKARTA UTARA,CILINCING,SEMPER BARAT,68587,28304,40283,14709,54992,2021-08-05
3172041005,JAKARTA UTARA,CILINCING,SEMPER TIMUR,36267,16484,19783,7510,27293,2021-08-05
3174071006,JAKARTA SELATAN,KEBAYORAN BARU,SENAYAN,2771,1424,1347,779,2126,2021-08-05
3171041001,JAKARTA PUSAT,SENEN,SENEN,6804,2958,3846,1600,5446,2021-08-05
3171031004,JAKARTA PUSAT,KEMAYORAN,SERDANG,29668,13686,15982,6133,22115,2021-08-05
3174021001,JAKARTA SELATAN,SETIA BUDI,SETIA BUDI,3023,1405,1618,882,2500,2021-08-05
3175101005,JAKARTA TIMUR,CIPAYUNG,SETU,20572,10606,9966,3830,13796,2021-08-05
3173071002,JAKARTA BARAT,PALMERAH,SLIPI,16591,7277,9314,3974,13288,2021-08-05
3173081004,JAKARTA BARAT,KEMBANGAN,SRENGSENG,45523,22232,23291,9171,32462,2021-08-05
3174091002,JAKARTA SELATAN,JAGAKARSA,SRENGSENG SAWAH,58196,23416,34780,15204,49984,2021-08-05
3173051003,JAKARTA BARAT,KEBON JERUK,SUKABUMI SELATAN,37033,18983,18050,6132,24182,2021-08-05
3173051002,JAKARTA BARAT,KEBON JERUK,SUKABUMI UTARA,38290,20738,17552,6202,23754,2021-08-05
3172041002,JAKARTA UTARA,CILINCING,SUKAPURA,53949,24887,29062,9648,38710,2021-08-05
3171031007,JAKARTA PUSAT,KEMAYORAN,SUMUR BATU,22717,10443,12274,5546,17820,2021-08-05
3172021004,JAKARTA UTARA,TANJUNG PRIOK,SUNGAI BAMBU,29876,13250,16626,6890,23516,2021-08-05
3172021006,JAKARTA UTARA,TANJUNG PRIOK,SUNTER AGUNG,71805,27782,44023,20561,64584,2021-08-05
3172021002,JAKARTA UTARA,TANJUNG PRIOK,SUNTER JAYA,63031,26257,36774,16846,53620,2021-08-05
3175091004,JAKARTA TIMUR,CIRACAS,SUSUKAN,38257,17482,20775,8133,28908,2021-08-05
3173031001,JAKARTA BARAT,TAMAN SARI,TAMAN SARI,14348,6122,8226,3720,11946,2021-08-05
3173041001,JAKARTA BARAT,TAMBORA,TAMBORA,10204,4976,5228,2239,7467,2021-08-05
3173041004,JAKARTA BARAT,TAMBORA,TANAH SEREAL,26387,9942,16445,5815,22260,2021-08-05
3171081004,JAKARTA PUSAT,JOHAR BARU,TANAH TINGGI,37693,15042,22651,7267,29918,2021-08-05
3173031004,JAKARTA BARAT,TAMAN SARI,TANGKI,13324,5663,7661,3151,10812,2021-08-05
3174091005,JAKARTA SELATAN,JAGAKARSA,TANJUNG BARAT,39770,17678,22092,9052,31144,2021-08-05
3173021005,JAKARTA BARAT,GROGOL PETAMBURAN,TANJUNG DUREN SELATAN,25337,10624,14713,6527,21240,2021-08-05
3173021002,JAKARTA BARAT,GROGOL PETAMBURAN,TANJUNG DUREN UTARA,17010,6716,10294,4926,15220,2021-08-05
3172021001,JAKARTA UTARA,TANJUNG PRIOK,TANJUNG PRIOK,34588,14211,20377,6573,26950,2021-08-05
3174011002,JAKARTA SELATAN,TEBET,TEBET BARAT,21194,8588,12606,6100,18706,2021-08-05
3174011001,JAKARTA SELATAN,TEBET,TEBET TIMUR,18199,7243,10956,5386,16342,2021-08-05
3173061003,JAKARTA BARAT,KALI DERES,TEGAL ALUR,83647,38546,45101,12739,57840,2021-08-05
3174031004,JAKARTA SELATAN,MAMPANG PRAPATAN,TEGAL PARANG,32401,15863,16538,5861,22399,2021-08-05
3173021003,JAKARTA BARAT,GROGOL PETAMBURAN,TOMANG,29605,13042,16563,7526,24089,2021-08-05
3172031005,JAKARTA UTARA,KOJA,TUGU SELATAN,39122,19099,20023,6700,26723,2021-08-05
3172031002,JAKARTA UTARA,KOJA,TUGU UTARA,67670,34036,33634,11556,45190,2021-08-05
3175061006,JAKARTA TIMUR,CAKUNG,UJUNG MENTENG,29934,12607,17327,5994,23321,2021-08-05
3174101005,JAKARTA SELATAN,PESANGGRAHAN,ULUJAMI,40544,19580,20964,7648,28612,2021-08-05
3175011006,JAKARTA TIMUR,MATRAMAN,UTAN KAYU SELATAN,33511,15388,18123,7676,25799,2021-08-05
3175011002,JAKARTA TIMUR,MATRAMAN,UTAN KAYU UTARA,28169,13588,14581,6011,20592,2021-08-05
3171031008,JAKARTA PUSAT,KEMAYORAN,UTAN PANJANG,29208,14043,15165,4789,19954,2021-08-05
3172021007,JAKARTA UTARA,TANJUNG PRIOK,WARAKAS,44401,19519,24882,9117,33999,2021-08-05
3173021007,JAKARTA BARAT,GROGOL PETAMBURAN,WIJAYA KUSUMA,38934,18079,20855,8130,28985,2021-08-05
3172051003,JAKARTA UTARA,PADEMANGAN,ANCOL,23947,11329,12618,4887,17505,2021-08-06
3173041007,JAKARTA BARAT,TAMBORA,ANGKE,29381,12823,16558,5663,22221,2021-08-06
3175041005,JAKARTA TIMUR,KRAMAT JATI,BALE KAMBANG,29074,17017,12057,4152,16209,2021-08-06
3175031003,JAKARTA TIMUR,JATINEGARA,BALI MESTER,9752,4604,5148,2306,7454,2021-08-06
3175101006,JAKARTA TIMUR,CIPAYUNG,BAMBU APUS,26285,12215,14070,5808,19878,2021-08-06
3174031002,JAKARTA SELATAN,MAMPANG PRAPATAN,BANGKA,21566,9900,11666,4663,16329,2021-08-06
3175051002,JAKARTA TIMUR,PASAR REBO,BARU,23886,9565,14321,6614,20935,2021-08-06
3175041004,JAKARTA TIMUR,KRAMAT JATI,BATU AMPAR,47898,26188,21710,8342,30052,2021-08-06
3171071002,JAKARTA PUSAT,TANAH ABANG,BENDUNGAN HILIR,21494,9454,12040,5300,17340,2021-08-06
3175031002,JAKARTA TIMUR,JATINEGARA,BIDARA CINA,36689,19952,16737,6414,23151,2021-08-06
3174101002,JAKARTA SELATAN,PESANGGRAHAN,BINTARO,53098,23794,29304,11887,41191,2021-08-06
3174011005,JAKARTA SELATAN,TEBET,BUKIT DURI,34183,16522,17661,7115,24776,2021-08-06
3171041006,JAKARTA PUSAT,SENEN,BUNGUR,18144,7908,10236,4345,14581,2021-08-06
3175061007,JAKARTA TIMUR,CAKUNG,CAKUNG BARAT,57724,24196,33528,8954,42482,2021-08-06
3175061004,JAKARTA TIMUR,CAKUNG,CAKUNG TIMUR,58287,25073,33214,11887,45101,2021-08-06
3175041007,JAKARTA TIMUR,KRAMAT JATI,CAWANG,32762,16474,16288,6816,23104,2021-08-06
3175101008,JAKARTA TIMUR,CIPAYUNG,CEGER,18932,8354,10578,3876,14454,2021-08-06
3171031006,JAKARTA PUSAT,KEMAYORAN,CEMPAKA BARU,32581,16191,16390,6334,22724,2021-08-06
3171051002,JAKARTA PUSAT,CEMPAKA PUTIH,CEMPAKA PUTIH BARAT,35885,16584,19301,7793,27094,2021-08-06
3171051001,JAKARTA PUSAT,CEMPAKA PUTIH,CEMPAKA PUTIH TIMUR,24292,11058,13234,6572,19806,2021-08-06
3173011001,JAKARTA BARAT,CENGKARENG,CENGKARENG BARAT,66284,29900,36384,14770,51154,2021-08-06
3173011006,JAKARTA BARAT,CENGKARENG,CENGKARENG TIMUR,81027,37302,43725,16036,59761,2021-08-06
3175091002,JAKARTA TIMUR,CIRACAS,CIBUBUR,66364,28497,37867,15739,53606,2021-08-06
3171011002,JAKARTA PUSAT,GAMBIR,CIDENG,15390,6366,9024,4427,13451,2021-08-06
3174091003,JAKARTA SELATAN,JAGAKARSA,CIGANJUR,38497,17115,21382,8746,30128,2021-08-06
3175051003,JAKARTA TIMUR,PASAR REBO,CIJANTUNG,41419,18409,23010,10093,33103,2021-08-06
3171061003,JAKARTA PUSAT,MENTENG,CIKINI,8274,4132,4142,1985,6127,2021-08-06
3174081006,JAKARTA SELATAN,PANCORAN,CIKOKO,10547,4253,6294,2482,8776,2021-08-06
3174061001,JAKARTA SELATAN,CILANDAK,CILANDAK BARAT,51752,22025,29727,13670,43397,2021-08-06
3174041003,JAKARTA SELATAN,PASAR MINGGU,CILANDAK TIMUR,25145,10731,14414,7271,21685,2021-08-06
3175101002,JAKARTA TIMUR,CIPAYUNG,CILANGKAP,27635,12551,15084,5928,21012,2021-08-06
3175041006,JAKARTA TIMUR,KRAMAT JATI,CILILITAN,40181,20940,19241,8122,27363,2021-08-06
3172041001,JAKARTA UTARA,CILINCING,CILINCING,43609,21478,22131,7351,29482,2021-08-06
3175101001,JAKARTA TIMUR,CIPAYUNG,CIPAYUNG,26104,11059,15045,6359,21404,2021-08-06
3174091006,JAKARTA SELATAN,JAGAKARSA,CIPEDAK,38303,15911,22392,9216,31608,2021-08-06
3174061005,JAKARTA SELATAN,CILANDAK,CIPETE SELATAN,26704,12000,14704,6866,21570,2021-08-06
3174071010,JAKARTA SELATAN,KEBAYORAN BARU,CIPETE UTARA,34102,15304,18798,7351,26149,2021-08-06
3175021003,JAKARTA TIMUR,PULO GADUNG,CIPINANG,39306,18531,20775,9151,29926,2021-08-06
3175031007,JAKARTA TIMUR,JATINEGARA,CIPINANG BESAR SELATAN,35212,19078,16134,5924,22058,2021-08-06
3175031008,JAKARTA TIMUR,JATINEGARA,CIPINANG BESAR UTARA,45319,24112,21207,6798,28005,2021-08-06
3175031005,JAKARTA TIMUR,JATINEGARA,CIPINANG CEMPEDAK,32824,16869,15955,7096,23051,2021-08-06
3175081005,JAKARTA TIMUR,MAKASAR,CIPINANG MELAYU,42308,19693,22615,9995,32610,2021-08-06
3175031006,JAKARTA TIMUR,JATINEGARA,CIPINANG MUARA,55243,28378,26865,10866,37731,2021-08-06
3174051003,JAKARTA SELATAN,KEBAYORAN LAMA,CIPULIR,39937,19533,20404,7895,28299,2021-08-06
3175091001,JAKARTA TIMUR,CIRACAS,CIRACAS,64594,28192,36402,13738,50140,2021-08-06
3175041003,JAKARTA TIMUR,KRAMAT JATI,DUKUH,24609,11429,13180,5288,18468,2021-08-06
3175071001,JAKARTA TIMUR,DUREN SAWIT,DUREN SAWIT,61160,31395,29765,14277,44042,2021-08-06
3174081004,JAKARTA SELATAN,PANCORAN,DUREN TIGA,28319,12437,15882,5951,21833,2021-08-06
3173051005,JAKARTA BARAT,KEBON JERUK,DURI KEPA,60138,25370,34768,15055,49823,2021-08-06
3173011002,JAKARTA BARAT,CENGKARENG,DURI KOSAMBI,77923,38855,39068,14688,53756,2021-08-06
3171011006,JAKARTA PUSAT,GAMBIR,DURI PULO,19610,9200,10410,3607,14017,2021-08-06
3173041011,JAKARTA BARAT,TAMBORA,DURI SELATAN,14259,5797,8462,3395,11857,2021-08-06
3173041003,JAKARTA BARAT,TAMBORA,DURI UTARA,19844,8470,11374,3984,15358,2021-08-06
3171081003,JAKARTA PUSAT,JOHAR BARU,GALUR,18243,7303,10940,3358,14298,2021-08-06
3171011001,JAKARTA PUSAT,GAMBIR,GAMBIR,2191,868,1323,677,2000,2021-08-06
3174061004,JAKARTA SELATAN,CILANDAK,GANDARIA SELATAN,22119,9806,12313,5105,17418,2021-08-06
3174071009,JAKARTA SELATAN,KEBAYORAN BARU,GANDARIA UTARA,39922,18441,21481,8885,30366,2021-08-06
3175051001,JAKARTA TIMUR,PASAR REBO,GEDONG,35755,16222,19533,8070,27603,2021-08-06
3171071001,JAKARTA PUSAT,TANAH ABANG,GELORA,3127,1424,1703,770,2473,2021-08-06
3173031007,JAKARTA BARAT,TAMAN SARI,GLODOK,7837,2838,4999,2849,7848,2021-08-06
3171061004,JAKARTA PUSAT,MENTENG,GONDANGDIA,4100,1723,2377,1579,3956,2021-08-06
3173021001,JAKARTA BARAT,GROGOL PETAMBURAN,GROGOL,16876,7450,9426,4095,13521,2021-08-06
3174051005,JAKARTA SELATAN,KEBAYORAN LAMA,GROGOL SELATAN,44251,21184,23067,8833,31900,2021-08-06
3174051004,JAKARTA SELATAN,KEBAYORAN LAMA,GROGOL UTARA,42494,19982,22512,8728,31240,2021-08-06
3174021007,JAKARTA SELATAN,SETIA BUDI,GUNTUR,3985,1663,2322,1317,3639,2021-08-06
3174071002,JAKARTA SELATAN,KEBAYORAN BARU,GUNUNG,9436,3994,5442,2984,8426,2021-08-06
3171031005,JAKARTA PUSAT,KEMAYORAN,GUNUNG SAHARI SELATAN,19199,8591,10608,4750,15358,2021-08-06
3171021004,JAKARTA PUSAT,SAWAH BESAR,GUNUNG SAHARI UTARA,16650,6398,10252,4980,15232,2021-08-06
3175081004,JAKARTA TIMUR,MAKASAR,HALIM PERDANA KUSUMAH,28363,9517,18846,11850,30696,2021-08-06
3171031003,JAKARTA PUSAT,KEMAYORAN,HARAPAN MULIA,22557,10428,12129,4609,16738,2021-08-06
3174091001,JAKARTA SELATAN,JAGAKARSA,JAGAKARSA,62389,26275,36114,15678,51792,2021-08-06
3175021007,JAKARTA TIMUR,PULO GADUNG,JATI,32757,15495,17262,8219,25481,2021-08-06
3174041002,JAKARTA SELATAN,PASAR MINGGU,JATI PADANG,37502,16999,20503,9486,29989,2021-08-06
3173071004,JAKARTA BARAT,PALMERAH,JATI PULO,28738,12171,16567,5324,21891,2021-08-06
3175061001,JAKARTA TIMUR,CAKUNG,JATINEGARA,84160,40486,43674,12632,56306,2021-08-06
3175021004,JAKARTA TIMUR,PULO GADUNG,JATINEGARA KAUM,24632,11032,13600,4623,18223,2021-08-06
3173021004,JAKARTA BARAT,GROGOL PETAMBURAN,JELAMBAR,30266,13036,17230,8334,25564,2021-08-06
3173021006,JAKARTA BARAT,GROGOL PETAMBURAN,JELAMBAR BARU,38246,16916,21330,9903,31233,2021-08-06
3173041006,JAKARTA BARAT,TAMBORA,JEMBATAN BESI,29314,16068,13246,4009,17255,2021-08-06
3173041008,JAKARTA BARAT,TAMBORA,JEMBATAN LIMA,21021,10810,10211,3847,14058,2021-08-06
3173081005,JAKARTA BARAT,KEMBANGAN,JOGLO,40839,19084,21755,8905,30660,2021-08-06
3171081001,JAKARTA PUSAT,JOHAR BARU,JOHAR BARU,37488,15512,21976,8578,30554,2021-08-06
3173041002,JAKARTA BARAT,TAMBORA,KALI ANYAR,23856,11214,12642,3530,16172,2021-08-06
3172041004,JAKARTA UTARA,CILINCING,KALIBARU,67684,35462,32222,8539,40761,2021-08-06
3174081002,JAKARTA SELATAN,PANCORAN,KALIBATA,41994,21201,20793,7938,28731,2021-08-06
3173061001,JAKARTA BARAT,KALI DERES,KALIDERES,72447,32397,40050,14168,54218,2021-08-06
3175051004,JAKARTA TIMUR,PASAR REBO,KALISARI,43212,19280,23932,10564,34496,2021-08-06
3173061004,JAKARTA BARAT,KALI DERES,KAMAL,53783,26624,27159,6493,33652,2021-08-06
3172011002,JAKARTA UTARA,PENJARINGAN,KAMAL MUARA,12930,4242,8688,4256,12944,2021-08-06
3171071007,JAKARTA PUSAT,TANAH ABANG,KAMPUNG BALI,11358,5915,5443,2180,7623,2021-08-06
3175031001,JAKARTA TIMUR,JATINEGARA,KAMPUNG MELAYU,25717,13491,12226,4170,16396,2021-08-06
3171081002,JAKARTA PUSAT,JOHAR BARU,KAMPUNG RAWA,21237,7598,13639,4337,17976,2021-08-06
3175041002,JAKARTA TIMUR,KRAMAT JATI,KAMPUNG TENGAH,43993,24007,19986,7896,27882,2021-08-06
3173011005,JAKARTA BARAT,CENGKARENG,KAPUK,134466,67878,66588,19160,85748,2021-08-06
3172011003,JAKARTA UTARA,PENJARINGAN,KAPUK MUARA,35781,14136,21645,10732,32377,2021-08-06
3171021002,JAKARTA PUSAT,SAWAH BESAR,KARANG ANYAR,25761,11111,14650,5587,20237,2021-08-06
3174021004,JAKARTA SELATAN,SETIA BUDI,KARET,9623,4540,5083,2423,7506,2021-08-06
3174021003,JAKARTA SELATAN,SETIA BUDI,KARET KUNINGAN,16055,6819,9236,3940,13176,2021-08-06
3174021002,JAKARTA SELATAN,SETIA BUDI,KARET SEMANGGI,2770,1095,1675,939,2614,2021-08-06
3171071003,JAKARTA PUSAT,TANAH ABANG,KARET TENGSIN,19271,8642,10629,3742,14371,2021-08-06
3171021003,JAKARTA PUSAT,SAWAH BESAR,KARTINI,22292,9579,12713,5641,18354,2021-08-06
3175011003,JAKARTA TIMUR,MATRAMAN,KAYU MANIS,25284,12797,12487,4800,17287,2021-08-06
3175021006,JAKARTA TIMUR,PULO GADUNG,KAYU PUTIH,40696,17446,23250,11017,34267,2021-08-06
3173031006,JAKARTA BARAT,TAMAN SARI,KEAGUNGAN,17387,7477,9910,3788,13698,2021-08-06
3174041007,JAKARTA SELATAN,PASAR MINGGU,KEBAGUSAN,44552,21104,23448,9360,32808,2021-08-06
3174051006,JAKARTA SELATAN,KEBAYORAN LAMA,KEBAYORAN LAMA SELATAN,41212,18448,22764,9314,32078,2021-08-06
3174051001,JAKARTA SELATAN,KEBAYORAN LAMA,KEBAYORAN LAMA UTARA,42422,20781,21641,8425,30066,2021-08-06
3174011004,JAKARTA SELATAN,TEBET,KEBON BARU,35165,15938,19227,8120,27347,2021-08-06
3172021005,JAKARTA UTARA,TANJUNG PRIOK,KEBON BAWANG,50952,23181,27771,11437,39208,2021-08-06
3173051001,JAKARTA BARAT,KEBON JERUK,KEBON JERUK,53887,26470,27417,10465,37882,2021-08-06
3171071006,JAKARTA PUSAT,TANAH ABANG,KEBON KACANG,21531,11846,9685,3810,13495,2021-08-06
3171011005,JAKARTA PUSAT,GAMBIR,KEBON KELAPA,10163,4545,5618,2396,8014,2021-08-06
3171031002,JAKARTA PUSAT,KEMAYORAN,KEBON KOSONG,30019,14005,16014,6210,22224,2021-08-06
3175011005,JAKARTA TIMUR,MATRAMAN,KEBON MANGGIS,16490,7279,9211,4107,13318,2021-08-06
3171071005,JAKARTA PUSAT,TANAH ABANG,KEBON MELATI,32206,18650,13556,4272,17828,2021-08-06
3175081003,JAKARTA TIMUR,MAKASAR,KEBON PALA,46614,22231,24383,9431,33814,2021-08-06
3171061005,JAKARTA PUSAT,MENTENG,KEBON SIRIH,12299,6113,6186,2340,8526,2021-08-06
3173011004,JAKARTA BARAT,CENGKARENG,KEDAUNG KALI ANGKE,32612,12770,19842,5860,25702,2021-08-06
3173051007,JAKARTA BARAT,KEBON JERUK,KEDOYA SELATAN,32165,13805,18360,6827,25187,2021-08-06
3173051006,JAKARTA BARAT,KEBON JERUK,KEDOYA UTARA,45740,18270,27470,10525,37995,2021-08-06
3173051004,JAKARTA BARAT,KEBON JERUK,KELAPA DUA,23565,10948,12617,4781,17398,2021-08-06
3175091003,JAKARTA TIMUR,CIRACAS,KELAPA DUA WETAN,46875,20135,26740,10685,37425,2021-08-06
3172061003,JAKARTA UTARA,KELAPA GADING,KELAPA GADING BARAT,35717,13548,22169,12044,34213,2021-08-06
3172061001,JAKARTA UTARA,KELAPA GADING,KELAPA GADING TIMUR,33592,11716,21876,12742,34618,2021-08-06
3173071005,JAKARTA BARAT,PALMERAH,KEMANGGISAN,32139,15054,17085,7242,24327,2021-08-06
3171031001,JAKARTA PUSAT,KEMAYORAN,KEMAYORAN,20708,8921,11787,4717,16504,2021-08-06
3173081006,JAKARTA BARAT,KEMBANGAN,KEMBANGAN SELATAN,27130,11979,15151,6994,22145,2021-08-06
3173081001,JAKARTA BARAT,KEMBANGAN,KEMBANGAN UTARA,54451,24109,30342,10095,40437,2021-08-06
3171041002,JAKARTA PUSAT,SENEN,KENARI,9579,3961,5618,2420,8038,2021-08-06
3173041005,JAKARTA BARAT,TAMBORA,KERENDANG,19973,9144,10829,3610,14439,2021-08-06
3175071003,JAKARTA TIMUR,DUREN SAWIT,KLENDER,69978,38050,31928,12325,44253,2021-08-06
3172031001,JAKARTA UTARA,KOJA,KOJA,28175,13114,15061,5538,20599,2021-08-06
3173071006,JAKARTA BARAT,PALMERAH,KOTA BAMBU SELATAN,21158,9779,11379,3822,15201,2021-08-06
3173071003,JAKARTA BARAT,PALMERAH,KOTA BAMBU UTARA,24995,11915,13080,4308,17388,2021-08-06
3171041004,JAKARTA PUSAT,SENEN,KRAMAT,28835,14450,14385,4981,19366,2021-08-06
3175041001,JAKARTA TIMUR,KRAMAT JATI,KRAMAT JATI,34144,16559,17585,7112,24697,2021-08-06
3174071003,JAKARTA SELATAN,KEBAYORAN BARU,KRAMAT PELA,14413,6305,8108,3649,11757,2021-08-06
3173031002,JAKARTA BARAT,TAMAN SARI,KRUKUT,19244,8529,10715,3861,14576,2021-08-06
3174031005,JAKARTA SELATAN,MAMPANG PRAPATAN,KUNINGAN BARAT,12785,5674,7111,3071,10182,2021-08-06
3174021008,JAKARTA SELATAN,SETIA BUDI,KUNINGAN TIMUR,6008,2700,3308,1608,4916,2021-08-06
3171041005,JAKARTA PUSAT,SENEN,KWITANG,15486,6898,8588,3294,11882,2021-08-06
3172031003,JAKARTA UTARA,KOJA,LAGOA,59065,29639,29426,10047,39473,2021-08-06
3174061002,JAKARTA SELATAN,CILANDAK,LEBAK BULUS,37626,17214,20412,9416,29828,2021-08-06
3174091004,JAKARTA SELATAN,JAGAKARSA,LENTENG AGUNG,53946,25654,28292,10572,38864,2021-08-06
3175101007,JAKARTA TIMUR,CIPAYUNG,LUBANG BUAYA,63547,29053,34494,15440,49934,2021-08-06
3175081001,JAKARTA TIMUR,MAKASAR,MAKASAR,34390,15465,18925,8181,27106,2021-08-06
3175071006,JAKARTA TIMUR,DUREN SAWIT,MALAKA JAYA,30927,13783,17144,8130,25274,2021-08-06
3175071005,JAKARTA TIMUR,DUREN SAWIT,MALAKA SARI,27530,12114,15416,7627,23043,2021-08-06
3174031001,JAKARTA SELATAN,MAMPANG PRAPATAN,MAMPANG PRAPATAN,18159,8181,9978,4095,14073,2021-08-06
3173031005,JAKARTA BARAT,TAMAN SARI,MANGGA BESAR,7707,2925,4782,2331,7113,2021-08-06
3171021005,JAKARTA PUSAT,SAWAH BESAR,MANGGA DUA SELATAN,27442,12334,15108,6529,21637,2021-08-06
3174011007,JAKARTA SELATAN,TEBET,MANGGARAI,28373,12568,15805,5637,21442,2021-08-06
3174011006,JAKARTA SELATAN,TEBET,MANGGARAI SELATAN,23075,9918,13157,5863,19020,2021-08-06
3173031003,JAKARTA BARAT,TAMAN SARI,MAPHAR,16461,7179,9282,4095,13377,2021-08-06
3172041003,JAKARTA UTARA,CILINCING,MARUNDA,28943,12891,16052,4615,20667,2021-08-06
3174071001,JAKARTA SELATAN,KEBAYORAN BARU,MELAWAI,2627,1005,1622,1101,2723,2021-08-06
3171061001,JAKARTA PUSAT,MENTENG,MENTENG,25624,13116,12508,5256,17764,2021-08-06
3174021005,JAKARTA SELATAN,SETIA BUDI,MENTENG ATAS,27816,12115,15701,6349,22050,2021-08-06
3174011003,JAKARTA SELATAN,TEBET,MENTENG DALAM,36028,16399,19629,8499,28128,2021-08-06
3173081003,JAKARTA BARAT,KEMBANGAN,MERUYA SELATAN,32130,15065,17065,6806,23871,2021-08-06
3173081002,JAKARTA BARAT,KEMBANGAN,MERUYA UTARA,43752,19966,23786,10335,34121,2021-08-06
3175101004,JAKARTA TIMUR,CIPAYUNG,MUNJUL,23871,10607,13264,5327,18591,2021-08-06
3172051002,JAKARTA UTARA,PADEMANGAN,PADEMANGAN BARAT,74240,34681,39559,13589,53148,2021-08-06
3172051001,JAKARTA UTARA,PADEMANGAN,PADEMANGAN TIMUR,37736,14609,23127,10302,33429,2021-08-06
3175011004,JAKARTA TIMUR,MATRAMAN,PAL MERIAM,19769,9514,10255,4314,14569,2021-08-06
3173071001,JAKARTA BARAT,PALMERAH,PALMERAH,63011,29635,33376,12352,45728,2021-08-06
3174081001,JAKARTA SELATAN,PANCORAN,PANCORAN,19421,8763,10658,4383,15041,2021-08-06
3172021003,JAKARTA UTARA,TANJUNG PRIOK,PAPANGGO,39097,16620,22477,8701,31178,2021-08-06
3171021001,JAKARTA PUSAT,SAWAH BESAR,PASAR BARU,12035,4622,7413,3792,11205,2021-08-06
3174021006,JAKARTA SELATAN,SETIA BUDI,PASAR MANGGIS,26752,12449,14303,6204,20507,2021-08-06
3174041001,JAKARTA SELATAN,PASAR MINGGU,PASAR MINGGU,24821,10967,13854,6740,20594,2021-08-06
3171041003,JAKARTA PUSAT,SENEN,PASEBAN,23533,10846,12687,4948,17635,2021-08-06
3173061005,JAKARTA BARAT,KALI DERES,PEGADUNGAN,75587,32699,42888,17073,59961,2021-08-06
3171061002,JAKARTA PUSAT,MENTENG,PEGANGSAAN,23455,12000,11455,4511,15966,2021-08-06
3172061002,JAKARTA UTARA,KELAPA GADING,PEGANGSAAN DUA,49976,17497,32479,15670,48149,2021-08-06
3172011004,JAKARTA UTARA,PENJARINGAN,PEJAGALAN,74578,33036,41542,19060,60602,2021-08-06
3174041006,JAKARTA SELATAN,PASAR MINGGU,PEJATEN BARAT,37346,17252,20094,9259,29353,2021-08-06
3174041005,JAKARTA SELATAN,PASAR MINGGU,PEJATEN TIMUR,57656,29366,28290,11771,40061,2021-08-06
3175051005,JAKARTA TIMUR,PASAR REBO,PEKAYON,43250,18449,24801,9607,34408,2021-08-06
3173041009,JAKARTA BARAT,TAMBORA,PEKOJAN,23587,9942,13645,5676,19321,2021-08-06
3174031003,JAKARTA SELATAN,MAMPANG PRAPATAN,PELA MAMPANG,43522,18990,24532,10114,34646,2021-08-06
3174081005,JAKARTA SELATAN,PANCORAN,PENGADEGAN,21478,8646,12832,5037,17869,2021-08-06
3175061003,JAKARTA TIMUR,CAKUNG,PENGGILINGAN,99255,52859,46396,14626,61022,2021-08-06
3172011001,JAKARTA UTARA,PENJARINGAN,PENJARINGAN,88308,45385,42923,15966,58889,2021-08-06
3174101001,JAKARTA SELATAN,PESANGGRAHAN,PESANGGRAHAN,27545,11378,16167,7508,23675,2021-08-06
3171071004,JAKARTA PUSAT,TANAH ABANG,PETAMBURAN,33271,18734,14537,4581,19118,2021-08-06
3174071008,JAKARTA SELATAN,KEBAYORAN BARU,PETOGOGAN,11499,5213,6286,3039,9325,2021-08-06
3171011004,JAKARTA PUSAT,GAMBIR,PETOJO SELATAN,14692,6684,8008,3938,11946,2021-08-06
3171011003,JAKARTA PUSAT,GAMBIR,PETOJO UTARA,17458,8245,9213,3820,13033,2021-08-06
3174101004,JAKARTA SELATAN,PESANGGRAHAN,PETUKANGAN SELATAN,37187,16267,20920,7494,28414,2021-08-06
3174101003,JAKARTA SELATAN,PESANGGRAHAN,PETUKANGAN UTARA,53716,25576,28140,11774,39914,2021-08-06
3175081002,JAKARTA TIMUR,MAKASAR,PINANG RANTI,27198,12431,14767,5943,20710,2021-08-06
3173031008,JAKARTA BARAT,TAMAN SARI,PINANGSIA,10729,4273,6456,2771,9227,2021-08-06
3175011001,JAKARTA TIMUR,MATRAMAN,PISANGAN BARU,31776,16059,15717,5855,21572,2021-08-06
3175021002,JAKARTA TIMUR,PULO GADUNG,PISANGAN TIMUR,41011,18275,22736,8692,31428,2021-08-06
3172011005,JAKARTA UTARA,PENJARINGAN,PLUIT,47783,20013,27770,16959,44729,2021-08-06
3175071002,JAKARTA TIMUR,DUREN SAWIT,PONDOK BAMBU,61550,30791,30759,13497,44256,2021-08-06
3175071004,JAKARTA TIMUR,DUREN SAWIT,PONDOK KELAPA,72015,32598,39417,16466,55883,2021-08-06
3175071007,JAKARTA TIMUR,DUREN SAWIT,PONDOK KOPI,35367,18470,16897,6711,23608,2021-08-06
3174061003,JAKARTA SELATAN,CILANDAK,PONDOK LABU,46464,19732,26732,12168,38900,2021-08-06
3174051002,JAKARTA SELATAN,KEBAYORAN LAMA,PONDOK PINANG,56169,25731,30438,14317,44755,2021-08-06
3175101003,JAKARTA TIMUR,CIPAYUNG,PONDOK RANGGON,25574,12487,13087,5631,18718,2021-08-06
3101011003,KAB.ADM.KEP.SERIBU,KEP. SERIBU UTARA,PULAU HARAPAN,2060,409,1651,805,2456,2021-08-06
3101011002,KAB.ADM.KEP.SERIBU,KEP. SERIBU UTARA,PULAU KELAPA,5528,1139,4389,1578,5967,2021-08-06
3101011001,KAB.ADM.KEP.SERIBU,KEP. SERIBU UTARA,PULAU PANGGANG,5450,1020,4430,1533,5963,2021-08-06
3101021003,KAB.ADM.KEP.SERIBU,KEP. SERIBU SELATAN,PULAU PARI,2765,383,2382,1064,3446,2021-08-06
3101021002,KAB.ADM.KEP.SERIBU,KEP. SERIBU SELATAN,PULAU TIDUNG,4553,859,3694,1591,5285,2021-08-06
3101021001,KAB.ADM.KEP.SERIBU,KEP. SERIBU SELATAN,PULAU UNTUNG JAWA,1941,420,1521,749,2270,2021-08-06
3174071007,JAKARTA SELATAN,KEBAYORAN BARU,PULO,5835,2320,3515,2063,5578,2021-08-06
3175021001,JAKARTA TIMUR,PULO GADUNG,PULO GADUNG,34422,16828,17594,7416,25010,2021-08-06
3175061005,JAKARTA TIMUR,CAKUNG,PULO GEBANG,97301,47396,49905,16245,66150,2021-08-06
3174041004,JAKARTA SELATAN,PASAR MINGGU,RAGUNAN,39616,17001,22615,9840,32455,2021-08-06
3175091005,JAKARTA TIMUR,CIRACAS,RAMBUTAN,36771,19185,17586,6738,24324,2021-08-06
3172031006,JAKARTA UTARA,KOJA,RAWA BADAK SELATAN,42179,21289,20890,6497,27387,2021-08-06
3172031004,JAKARTA UTARA,KOJA,RAWA BADAK UTARA,34408,16822,17586,6841,24427,2021-08-06
3174071005,JAKARTA SELATAN,KEBAYORAN BARU,RAWA BARAT,5625,2326,3299,1865,5164,2021-08-06
3173011003,JAKARTA BARAT,CENGKARENG,RAWA BUAYA,63799,30708,33091,10409,43500,2021-08-06
3175031004,JAKARTA TIMUR,JATINEGARA,RAWA BUNGA,21434,10829,10605,3831,14436,2021-08-06
3174081003,JAKARTA SELATAN,PANCORAN,RAWA JATI,20509,8774,11735,5083,16818,2021-08-06
3175061002,JAKARTA TIMUR,CAKUNG,RAWA TERATE,24637,10077,14560,3514,18074,2021-08-06
3175021005,JAKARTA TIMUR,PULO GADUNG,RAWAMANGUN,37612,17340,20272,8730,29002,2021-08-06
3171051003,JAKARTA PUSAT,CEMPAKA PUTIH,RAWASARI,21967,10000,11967,5436,17403,2021-08-06
3173041010,JAKARTA BARAT,TAMBORA,ROA MALAKA,3484,1313,2171,1201,3372,2021-08-06
3172041006,JAKARTA UTARA,CILINCING,ROROTAN,41668,17921,23747,7631,31378,2021-08-06
3174071004,JAKARTA SELATAN,KEBAYORAN BARU,SELONG,2842,1145,1697,1130,2827,2021-08-06
3173061002,JAKARTA BARAT,KALI DERES,SEMANAN,71354,34733,36621,8656,45277,2021-08-06
3172041007,JAKARTA UTARA,CILINCING,SEMPER BARAT,68587,28180,40407,15126,55533,2021-08-06
3172041005,JAKARTA UTARA,CILINCING,SEMPER TIMUR,36267,16301,19966,7733,27699,2021-08-06
3174071006,JAKARTA SELATAN,KEBAYORAN BARU,SENAYAN,2771,1415,1356,786,2142,2021-08-06
3171041001,JAKARTA PUSAT,SENEN,SENEN,6804,2948,3856,1613,5469,2021-08-06
3171031004,JAKARTA PUSAT,KEMAYORAN,SERDANG,29668,13582,16086,6193,22279,2021-08-06
3174021001,JAKARTA SELATAN,SETIA BUDI,SETIA BUDI,3023,1401,1622,893,2515,2021-08-06
3175101005,JAKARTA TIMUR,CIPAYUNG,SETU,20572,10432,10140,3889,14029,2021-08-06
3173071002,JAKARTA BARAT,PALMERAH,SLIPI,16591,7240,9351,4036,13387,2021-08-06
3173081004,JAKARTA BARAT,KEMBANGAN,SRENGSENG,45523,22075,23448,9300,32748,2021-08-06
3174091002,JAKARTA SELATAN,JAGAKARSA,SRENGSENG SAWAH,58196,23193,35003,15397,50400,2021-08-06
3173051003,JAKARTA BARAT,KEBON JERUK,SUKABUMI SELATAN,37033,18846,18187,6230,24417,2021-08-06
3173051002,JAKARTA BARAT,KEBON JERUK,SUKABUMI UTARA,38290,20620,17670,6289,23959,2021-08-06
3172041002,JAKARTA UTARA,CILINCING,SUKAPURA,53949,24712,29237,10005,39242,2021-08-06
3171031007,JAKARTA PUSAT,KEMAYORAN,SUMUR BATU,22717,10368,12349,5654,18003,2021-08-06
3172021004,JAKARTA UTARA,TANJUNG PRIOK,SUNGAI BAMBU,29876,13202,16674,6957,23631,2021-08-06
3172021006,JAKARTA UTARA,TANJUNG PRIOK,SUNTER AGUNG,71805,27600,44205,20965,65170,2021-08-06
3172021002,JAKARTA UTARA,TANJUNG PRIOK,SUNTER JAYA,63031,26164,36867,16973,53840,2021-08-06
3175091004,JAKARTA TIMUR,CIRACAS,SUSUKAN,38257,17217,21040,8302,29342,2021-08-06
3173031001,JAKARTA BARAT,TAMAN SARI,TAMAN SARI,14348,6101,8247,3779,12026,2021-08-06
3173041001,JAKARTA BARAT,TAMBORA,TAMBORA,10204,4936,5268,2259,7527,2021-08-06
3173041004,JAKARTA BARAT,TAMBORA,TANAH SEREAL,26387,9888,16499,5895,22394,2021-08-06
3171081004,JAKARTA PUSAT,JOHAR BARU,TANAH TINGGI,37693,14956,22737,7422,30159,2021-08-06
3173031004,JAKARTA BARAT,TAMAN SARI,TANGKI,13324,5636,7688,3205,10893,2021-08-06
3174091005,JAKARTA SELATAN,JAGAKARSA,TANJUNG BARAT,39770,17532,22238,9174,31412,2021-08-06
3173021005,JAKARTA BARAT,GROGOL PETAMBURAN,TANJUNG DUREN SELATAN,25337,10585,14752,6609,21361,2021-08-06
3173021002,JAKARTA BARAT,GROGOL PETAMBURAN,TANJUNG DUREN UTARA,17010,6678,10332,4978,15310,2021-08-06
3172021001,JAKARTA UTARA,TANJUNG PRIOK,TANJUNG PRIOK,34588,14141,20447,6709,27156,2021-08-06
3174011002,JAKARTA SELATAN,TEBET,TEBET BARAT,21194,8534,12660,6197,18857,2021-08-06
3174011001,JAKARTA SELATAN,TEBET,TEBET TIMUR,18199,7209,10990,5445,16435,2021-08-06
3173061003,JAKARTA BARAT,KALI DERES,TEGAL ALUR,83647,38073,45574,12918,58492,2021-08-06
3174031004,JAKARTA SELATAN,MAMPANG PRAPATAN,TEGAL PARANG,32401,15748,16653,5938,22591,2021-08-06
3173021003,JAKARTA BARAT,GROGOL PETAMBURAN,TOMANG,29605,12996,16609,7613,24222,2021-08-06
3172031005,JAKARTA UTARA,KOJA,TUGU SELATAN,39122,19002,20120,6900,27020,2021-08-06
3172031002,JAKARTA UTARA,KOJA,TUGU UTARA,67670,33895,33775,11736,45511,2021-08-06
3175061006,JAKARTA TIMUR,CAKUNG,UJUNG MENTENG,29934,12509,17425,6070,23495,2021-08-06
3174101005,JAKARTA SELATAN,PESANGGRAHAN,ULUJAMI,40544,19463,21081,7785,28866,2021-08-06
3175011006,JAKARTA TIMUR,MATRAMAN,UTAN KAYU SELATAN,33511,15279,18232,7757,25989,2021-08-06
3175011002,JAKARTA TIMUR,MATRAMAN,UTAN KAYU UTARA,28169,13488,14681,6064,20745,2021-08-06
3171031008,JAKARTA PUSAT,KEMAYORAN,UTAN PANJANG,29208,13979,15229,4907,20136,2021-08-06
3172021007,JAKARTA UTARA,TANJUNG PRIOK,WARAKAS,44401,19388,25013,9256,34269,2021-08-06
3173021007,JAKARTA BARAT,GROGOL PETAMBURAN,WIJAYA KUSUMA,38934,18013,20921,8215,29136,2021-08-06
3172051003,JAKARTA UTARA,PADEMANGAN,ANCOL,23947,11195,12752,4987,17739,2021-08-07
3173041007,JAKARTA BARAT,TAMBORA,ANGKE,29381,12748,16633,5802,22435,2021-08-07
3175041005,JAKARTA TIMUR,KRAMAT JATI,BALE KAMBANG,29074,16816,12258,4277,16535,2021-08-07
3175031003,JAKARTA TIMUR,JATINEGARA,BALI MESTER,9752,4558,5194,2345,7539,2021-08-07
3175101006,JAKARTA TIMUR,CIPAYUNG,BAMBU APUS,26285,12086,14199,5903,20102,2021-08-07
3174031002,JAKARTA SELATAN,MAMPANG PRAPATAN,BANGKA,21566,9820,11746,4777,16523,2021-08-07
3175051002,JAKARTA TIMUR,PASAR REBO,BARU,23886,9477,14409,7081,21490,2021-08-07
3175041004,JAKARTA TIMUR,KRAMAT JATI,BATU AMPAR,47898,25891,22007,8510,30517,2021-08-07
3171071002,JAKARTA PUSAT,TANAH ABANG,BENDUNGAN HILIR,21494,9394,12100,5397,17497,2021-08-07
3175031002,JAKARTA TIMUR,JATINEGARA,BIDARA CINA,36689,19686,17003,6588,23591,2021-08-07
3174101002,JAKARTA SELATAN,PESANGGRAHAN,BINTARO,53098,23567,29531,12181,41712,2021-08-07
3174011005,JAKARTA SELATAN,TEBET,BUKIT DURI,34183,16362,17821,7279,25100,2021-08-07
3171041006,JAKARTA PUSAT,SENEN,BUNGUR,18144,7835,10309,4426,14735,2021-08-07
3175061007,JAKARTA TIMUR,CAKUNG,CAKUNG BARAT,57724,23957,33767,9225,42992,2021-08-07
3175061004,JAKARTA TIMUR,CAKUNG,CAKUNG TIMUR,58287,24918,33369,12064,45433,2021-08-07
3175041007,JAKARTA TIMUR,KRAMAT JATI,CAWANG,32762,16319,16443,6920,23363,2021-08-07
3175101008,JAKARTA TIMUR,CIPAYUNG,CEGER,18932,8310,10622,3960,14582,2021-08-07
3171031006,JAKARTA PUSAT,KEMAYORAN,CEMPAKA BARU,32581,16073,16508,6448,22956,2021-08-07
3171051002,JAKARTA PUSAT,CEMPAKA PUTIH,CEMPAKA PUTIH BARAT,35885,16410,19475,8056,27531,2021-08-07
3171051001,JAKARTA PUSAT,CEMPAKA PUTIH,CEMPAKA PUTIH TIMUR,24292,10955,13337,6682,20019,2021-08-07
3173011001,JAKARTA BARAT,CENGKARENG,CENGKARENG BARAT,66284,29633,36651,15142,51793,2021-08-07
3173011006,JAKARTA BARAT,CENGKARENG,CENGKARENG TIMUR,81027,36792,44235,16298,60533,2021-08-07
3175091002,JAKARTA TIMUR,CIRACAS,CIBUBUR,66364,28346,38018,15953,53971,2021-08-07
3171011002,JAKARTA PUSAT,GAMBIR,CIDENG,15390,6296,9094,4476,13570,2021-08-07
3174091003,JAKARTA SELATAN,JAGAKARSA,CIGANJUR,38497,16928,21569,8966,30535,2021-08-07
3175051003,JAKARTA TIMUR,PASAR REBO,CIJANTUNG,41419,18172,23247,10379,33626,2021-08-07
3171061003,JAKARTA PUSAT,MENTENG,CIKINI,8274,4111,4163,2004,6167,2021-08-07
3174081006,JAKARTA SELATAN,PANCORAN,CIKOKO,10547,4239,6308,2530,8838,2021-08-07
3174061001,JAKARTA SELATAN,CILANDAK,CILANDAK BARAT,51752,21851,29901,13969,43870,2021-08-07
3174041003,JAKARTA SELATAN,PASAR MINGGU,CILANDAK TIMUR,25145,10568,14577,7428,22005,2021-08-07
3175101002,JAKARTA TIMUR,CIPAYUNG,CILANGKAP,27635,12397,15238,6031,21269,2021-08-07
3175041006,JAKARTA TIMUR,KRAMAT JATI,CILILITAN,40181,20629,19552,8234,27786,2021-08-07
3172041001,JAKARTA UTARA,CILINCING,CILINCING,43609,21237,22372,7636,30008,2021-08-07
3175101001,JAKARTA TIMUR,CIPAYUNG,CIPAYUNG,26104,10912,15192,6491,21683,2021-08-07
3174091006,JAKARTA SELATAN,JAGAKARSA,CIPEDAK,38303,15741,22562,9506,32068,2021-08-07
3174061005,JAKARTA SELATAN,CILANDAK,CIPETE SELATAN,26704,11842,14862,6999,21861,2021-08-07
3174071010,JAKARTA SELATAN,KEBAYORAN BARU,CIPETE UTARA,34102,15193,18909,7612,26521,2021-08-07
3175021003,JAKARTA TIMUR,PULO GADUNG,CIPINANG,39306,18354,20952,9343,30295,2021-08-07
3175031007,JAKARTA TIMUR,JATINEGARA,CIPINANG BESAR SELATAN,35212,18908,16304,6101,22405,2021-08-07
3175031008,JAKARTA TIMUR,JATINEGARA,CIPINANG BESAR UTARA,45319,23819,21500,7011,28511,2021-08-07
3175031005,JAKARTA TIMUR,JATINEGARA,CIPINANG CEMPEDAK,32824,16634,16190,7235,23425,2021-08-07
3175081005,JAKARTA TIMUR,MAKASAR,CIPINANG MELAYU,42308,19520,22788,10162,32950,2021-08-07
3175031006,JAKARTA TIMUR,JATINEGARA,CIPINANG MUARA,55243,27949,27294,11053,38347,2021-08-07
3174051003,JAKARTA SELATAN,KEBAYORAN LAMA,CIPULIR,39937,19343,20594,8044,28638,2021-08-07
3175091001,JAKARTA TIMUR,CIRACAS,CIRACAS,64594,27893,36701,13998,50699,2021-08-07
3175041003,JAKARTA TIMUR,KRAMAT JATI,DUKUH,24609,11327,13282,5342,18624,2021-08-07
3175071001,JAKARTA TIMUR,DUREN SAWIT,DUREN SAWIT,61160,31119,30041,14521,44562,2021-08-07
3174081004,JAKARTA SELATAN,PANCORAN,DUREN TIGA,28319,12378,15941,6093,22034,2021-08-07
3173051005,JAKARTA BARAT,KEBON JERUK,DURI KEPA,60138,25212,34926,15338,50264,2021-08-07
3173011002,JAKARTA BARAT,CENGKARENG,DURI KOSAMBI,77923,38554,39369,15097,54466,2021-08-07
3171011006,JAKARTA PUSAT,GAMBIR,DURI PULO,19610,9064,10546,3685,14231,2021-08-07
3173041011,JAKARTA BARAT,TAMBORA,DURI SELATAN,14259,5728,8531,3428,11959,2021-08-07
3173041003,JAKARTA BARAT,TAMBORA,DURI UTARA,19844,8399,11445,4066,15511,2021-08-07
3171081003,JAKARTA PUSAT,JOHAR BARU,GALUR,18243,7261,10982,3462,14444,2021-08-07
3171011001,JAKARTA PUSAT,GAMBIR,GAMBIR,2191,860,1331,687,2018,2021-08-07
3174061004,JAKARTA SELATAN,CILANDAK,GANDARIA SELATAN,22119,9643,12476,5190,17666,2021-08-07
3174071009,JAKARTA SELATAN,KEBAYORAN BARU,GANDARIA UTARA,39922,18281,21641,9159,30800,2021-08-07
3175051001,JAKARTA TIMUR,PASAR REBO,GEDONG,35755,15970,19785,8272,28057,2021-08-07
3171071001,JAKARTA PUSAT,TANAH ABANG,GELORA,3127,1416,1711,778,2489,2021-08-07
3173031007,JAKARTA BARAT,TAMAN SARI,GLODOK,7837,2828,5009,2872,7881,2021-08-07
3171061004,JAKARTA PUSAT,MENTENG,GONDANGDIA,4100,1716,2384,1594,3978,2021-08-07
3173021001,JAKARTA BARAT,GROGOL PETAMBURAN,GROGOL,16876,7392,9484,4168,13652,2021-08-07
3174051005,JAKARTA SELATAN,KEBAYORAN LAMA,GROGOL SELATAN,44251,20958,23293,9043,32336,2021-08-07
3174051004,JAKARTA SELATAN,KEBAYORAN LAMA,GROGOL UTARA,42494,19772,22722,8886,31608,2021-08-07
3174021007,JAKARTA SELATAN,SETIA BUDI,GUNTUR,3985,1645,2340,1331,3671,2021-08-07
3174071002,JAKARTA SELATAN,KEBAYORAN BARU,GUNUNG,9436,3934,5502,3032,8534,2021-08-07
3171031005,JAKARTA PUSAT,KEMAYORAN,GUNUNG SAHARI SELATAN,19199,8519,10680,4827,15507,2021-08-07
3171021004,JAKARTA PUSAT,SAWAH BESAR,GUNUNG SAHARI UTARA,16650,6317,10333,5076,15409,2021-08-07
3175081004,JAKARTA TIMUR,MAKASAR,HALIM PERDANA KUSUMAH,28363,9443,18920,12024,30944,2021-08-07
3171031003,JAKARTA PUSAT,KEMAYORAN,HARAPAN MULIA,22557,10343,12214,4719,16933,2021-08-07
3174091001,JAKARTA SELATAN,JAGAKARSA,JAGAKARSA,62389,26013,36376,16022,52398,2021-08-07
3175021007,JAKARTA TIMUR,PULO GADUNG,JATI,32757,15354,17403,8357,25760,2021-08-07
3174041002,JAKARTA SELATAN,PASAR MINGGU,JATI PADANG,37502,16864,20638,9721,30359,2021-08-07
3173071004,JAKARTA BARAT,PALMERAH,JATI PULO,28738,12060,16678,5510,22188,2021-08-07
3175061001,JAKARTA TIMUR,CAKUNG,JATINEGARA,84160,40018,44142,13016,57158,2021-08-07
3175021004,JAKARTA TIMUR,PULO GADUNG,JATINEGARA KAUM,24632,10886,13746,4722,18468,2021-08-07
3173021004,JAKARTA BARAT,GROGOL PETAMBURAN,JELAMBAR,30266,12959,17307,8475,25782,2021-08-07
3173021006,JAKARTA BARAT,GROGOL PETAMBURAN,JELAMBAR BARU,38246,16810,21436,10078,31514,2021-08-07
3173041006,JAKARTA BARAT,TAMBORA,JEMBATAN BESI,29314,15936,13378,4109,17487,2021-08-07
3173041008,JAKARTA BARAT,TAMBORA,JEMBATAN LIMA,21021,10729,10292,3954,14246,2021-08-07
3173081005,JAKARTA BARAT,KEMBANGAN,JOGLO,40839,18894,21945,9081,31026,2021-08-07
3171081001,JAKARTA PUSAT,JOHAR BARU,JOHAR BARU,37488,15368,22120,8771,30891,2021-08-07
3173041002,JAKARTA BARAT,TAMBORA,KALI ANYAR,23856,11131,12725,3624,16349,2021-08-07
3172041004,JAKARTA UTARA,CILINCING,KALIBARU,67684,35150,32534,8907,41441,2021-08-07
3174081002,JAKARTA SELATAN,PANCORAN,KALIBATA,41994,21052,20942,8083,29025,2021-08-07
3173061001,JAKARTA BARAT,KALI DERES,KALIDERES,72447,32057,40390,14470,54860,2021-08-07
3175051004,JAKARTA TIMUR,PASAR REBO,KALISARI,43212,19115,24097,10771,34868,2021-08-07
3173061004,JAKARTA BARAT,KALI DERES,KAMAL,53783,26396,27387,6661,34048,2021-08-07
3172011002,JAKARTA UTARA,PENJARINGAN,KAMAL MUARA,12930,4216,8714,4329,13043,2021-08-07
3171071007,JAKARTA PUSAT,TANAH ABANG,KAMPUNG BALI,11358,5869,5489,2209,7698,2021-08-07
3175031001,JAKARTA TIMUR,JATINEGARA,KAMPUNG MELAYU,25717,13323,12394,4422,16816,2021-08-07
3171081002,JAKARTA PUSAT,JOHAR BARU,KAMPUNG RAWA,21237,7511,13726,4437,18163,2021-08-07
3175041002,JAKARTA TIMUR,KRAMAT JATI,KAMPUNG TENGAH,43993,23735,20258,8120,28378,2021-08-07
3173011005,JAKARTA BARAT,CENGKARENG,KAPUK,134466,67079,67387,19698,87085,2021-08-07
3172011003,JAKARTA UTARA,PENJARINGAN,KAPUK MUARA,35781,14034,21747,10956,32703,2021-08-07
3171021002,JAKARTA PUSAT,SAWAH BESAR,KARANG ANYAR,25761,10972,14789,5692,20481,2021-08-07
3174021004,JAKARTA SELATAN,SETIA BUDI,KARET,9623,4498,5125,2503,7628,2021-08-07
3174021003,JAKARTA SELATAN,SETIA BUDI,KARET KUNINGAN,16055,6761,9294,4034,13328,2021-08-07
3174021002,JAKARTA SELATAN,SETIA BUDI,KARET SEMANGGI,2770,1094,1676,955,2631,2021-08-07
3171071003,JAKARTA PUSAT,TANAH ABANG,KARET TENGSIN,19271,8581,10690,3839,14529,2021-08-07
3171021003,JAKARTA PUSAT,SAWAH BESAR,KARTINI,22292,9478,12814,5752,18566,2021-08-07
3175011003,JAKARTA TIMUR,MATRAMAN,KAYU MANIS,25284,12667,12617,4901,17518,2021-08-07
3175021006,JAKARTA TIMUR,PULO GADUNG,KAYU PUTIH,40696,17163,23533,11384,34917,2021-08-07
3173031006,JAKARTA BARAT,TAMAN SARI,KEAGUNGAN,17387,7429,9958,3855,13813,2021-08-07
3174041007,JAKARTA SELATAN,PASAR MINGGU,KEBAGUSAN,44552,20821,23731,9558,33289,2021-08-07
3174051006,JAKARTA SELATAN,KEBAYORAN LAMA,KEBAYORAN LAMA SELATAN,41212,18279,22933,9538,32471,2021-08-07
3174051001,JAKARTA SELATAN,KEBAYORAN LAMA,KEBAYORAN LAMA UTARA,42422,20616,21806,8631,30437,2021-08-07
3174011004,JAKARTA SELATAN,TEBET,KEBON BARU,35165,15769,19396,8336,27732,2021-08-07
3172021005,JAKARTA UTARA,TANJUNG PRIOK,KEBON BAWANG,50952,23060,27892,11663,39555,2021-08-07
3173051001,JAKARTA BARAT,KEBON JERUK,KEBON JERUK,53887,26174,27713,10764,38477,2021-08-07
3171071006,JAKARTA PUSAT,TANAH ABANG,KEBON KACANG,21531,11690,9841,3879,13720,2021-08-07
3171011005,JAKARTA PUSAT,GAMBIR,KEBON KELAPA,10163,4508,5655,2457,8112,2021-08-07
3171031002,JAKARTA PUSAT,KEMAYORAN,KEBON KOSONG,30019,13905,16114,6348,22462,2021-08-07
3175011005,JAKARTA TIMUR,MATRAMAN,KEBON MANGGIS,16490,7234,9256,4195,13451,2021-08-07
3171071005,JAKARTA PUSAT,TANAH ABANG,KEBON MELATI,32206,18433,13773,4354,18127,2021-08-07
3175081003,JAKARTA TIMUR,MAKASAR,KEBON PALA,46614,21885,24729,9607,34336,2021-08-07
3171061005,JAKARTA PUSAT,MENTENG,KEBON SIRIH,12299,6042,6257,2390,8647,2021-08-07
3173011004,JAKARTA BARAT,CENGKARENG,KEDAUNG KALI ANGKE,32612,12707,19905,6059,25964,2021-08-07
3173051007,JAKARTA BARAT,KEBON JERUK,KEDOYA SELATAN,32165,13690,18475,6932,25407,2021-08-07
3173051006,JAKARTA BARAT,KEBON JERUK,KEDOYA UTARA,45740,18092,27648,10778,38426,2021-08-07
3173051004,JAKARTA BARAT,KEBON JERUK,KELAPA DUA,23565,10851,12714,4898,17612,2021-08-07
3175091003,JAKARTA TIMUR,CIRACAS,KELAPA DUA WETAN,46875,19921,26954,10909,37863,2021-08-07
3172061003,JAKARTA UTARA,KELAPA GADING,KELAPA GADING BARAT,35717,13479,22238,12274,34512,2021-08-07
3172061001,JAKARTA UTARA,KELAPA GADING,KELAPA GADING TIMUR,33592,11687,21905,12919,34824,2021-08-07
3173071005,JAKARTA BARAT,PALMERAH,KEMANGGISAN,32139,14895,17244,7386,24630,2021-08-07
3171031001,JAKARTA PUSAT,KEMAYORAN,KEMAYORAN,20708,8861,11847,4821,16668,2021-08-07
3173081006,JAKARTA BARAT,KEMBANGAN,KEMBANGAN SELATAN,27130,11904,15226,7121,22347,2021-08-07
3173081001,JAKARTA BARAT,KEMBANGAN,KEMBANGAN UTARA,54451,23913,30538,10357,40895,2021-08-07
3171041002,JAKARTA PUSAT,SENEN,KENARI,9579,3918,5661,2468,8129,2021-08-07
3173041005,JAKARTA BARAT,TAMBORA,KERENDANG,19973,9058,10915,3723,14638,2021-08-07
3175071003,JAKARTA TIMUR,DUREN SAWIT,KLENDER,69978,37399,32579,12579,45158,2021-08-07
3172031001,JAKARTA UTARA,KOJA,KOJA,28175,13046,15129,5768,20897,2021-08-07
3173071006,JAKARTA BARAT,PALMERAH,KOTA BAMBU SELATAN,21158,9714,11444,3944,15388,2021-08-07
3173071003,JAKARTA BARAT,PALMERAH,KOTA BAMBU UTARA,24995,11842,13153,4428,17581,2021-08-07
3171041004,JAKARTA PUSAT,SENEN,KRAMAT,28835,14351,14484,5104,19588,2021-08-07
3175041001,JAKARTA TIMUR,KRAMAT JATI,KRAMAT JATI,34144,16344,17800,7212,25012,2021-08-07
3174071003,JAKARTA SELATAN,KEBAYORAN BARU,KRAMAT PELA,14413,6248,8165,3779,11944,2021-08-07
3173031002,JAKARTA BARAT,TAMAN SARI,KRUKUT,19244,8485,10759,3904,14663,2021-08-07
3174031005,JAKARTA SELATAN,MAMPANG PRAPATAN,KUNINGAN BARAT,12785,5620,7165,3141,10306,2021-08-07
3174021008,JAKARTA SELATAN,SETIA BUDI,KUNINGAN TIMUR,6008,2678,3330,1647,4977,2021-08-07
3171041005,JAKARTA PUSAT,SENEN,KWITANG,15486,6821,8665,3352,12017,2021-08-07
3172031003,JAKARTA UTARA,KOJA,LAGOA,59065,29482,29583,10400,39983,2021-08-07
3174061002,JAKARTA SELATAN,CILANDAK,LEBAK BULUS,37626,17075,20551,9699,30250,2021-08-07
3174091004,JAKARTA SELATAN,JAGAKARSA,LENTENG AGUNG,53946,25329,28617,10802,39419,2021-08-07
3175101007,JAKARTA TIMUR,CIPAYUNG,LUBANG BUAYA,63547,28793,34754,15720,50474,2021-08-07
3175081001,JAKARTA TIMUR,MAKASAR,MAKASAR,34390,15233,19157,8296,27453,2021-08-07
3175071006,JAKARTA TIMUR,DUREN SAWIT,MALAKA JAYA,30927,13662,17265,8302,25567,2021-08-07
3175071005,JAKARTA TIMUR,DUREN SAWIT,MALAKA SARI,27530,12050,15480,7724,23204,2021-08-07
3174031001,JAKARTA SELATAN,MAMPANG PRAPATAN,MAMPANG PRAPATAN,18159,8102,10057,4216,14273,2021-08-07
3173031005,JAKARTA BARAT,TAMAN SARI,MANGGA BESAR,7707,2913,4794,2355,7149,2021-08-07
3171021005,JAKARTA PUSAT,SAWAH BESAR,MANGGA DUA SELATAN,27442,12206,15236,6656,21892,2021-08-07
3174011007,JAKARTA SELATAN,TEBET,MANGGARAI,28373,12360,16013,5835,21848,2021-08-07
3174011006,JAKARTA SELATAN,TEBET,MANGGARAI SELATAN,23075,9783,13292,5959,19251,2021-08-07
3173031003,JAKARTA BARAT,TAMAN SARI,MAPHAR,16461,7150,9311,4176,13487,2021-08-07
3172041003,JAKARTA UTARA,CILINCING,MARUNDA,28943,12761,16182,4795,20977,2021-08-07
3174071001,JAKARTA SELATAN,KEBAYORAN BARU,MELAWAI,2627,1004,1623,1108,2731,2021-08-07
3171061001,JAKARTA PUSAT,MENTENG,MENTENG,25624,12911,12713,5393,18106,2021-08-07
3174021005,JAKARTA SELATAN,SETIA BUDI,MENTENG ATAS,27816,11949,15867,6522,22389,2021-08-07
3174011003,JAKARTA SELATAN,TEBET,MENTENG DALAM,36028,16198,19830,8650,28480,2021-08-07
3173081003,JAKARTA BARAT,KEMBANGAN,MERUYA SELATAN,32130,14867,17263,6921,24184,2021-08-07
3173081002,JAKARTA BARAT,KEMBANGAN,MERUYA UTARA,43752,19670,24082,10521,34603,2021-08-07
3175101004,JAKARTA TIMUR,CIPAYUNG,MUNJUL,23871,10494,13377,5415,18792,2021-08-07
3172051002,JAKARTA UTARA,PADEMANGAN,PADEMANGAN BARAT,74240,34374,39866,13857,53723,2021-08-07
3172051001,JAKARTA UTARA,PADEMANGAN,PADEMANGAN TIMUR,37736,14514,23222,10474,33696,2021-08-07
3175011004,JAKARTA TIMUR,MATRAMAN,PAL MERIAM,19769,9431,10338,4421,14759,2021-08-07
3173071001,JAKARTA BARAT,PALMERAH,PALMERAH,63011,29346,33665,12588,46253,2021-08-07
3174081001,JAKARTA SELATAN,PANCORAN,PANCORAN,19421,8697,10724,4504,15228,2021-08-07
3172021003,JAKARTA UTARA,TANJUNG PRIOK,PAPANGGO,39097,16439,22658,8974,31632,2021-08-07
3171021001,JAKARTA PUSAT,SAWAH BESAR,PASAR BARU,12035,4557,7478,3837,11315,2021-08-07
3174021006,JAKARTA SELATAN,SETIA BUDI,PASAR MANGGIS,26752,12297,14455,6350,20805,2021-08-07
3174041001,JAKARTA SELATAN,PASAR MINGGU,PASAR MINGGU,24821,10853,13968,6872,20840,2021-08-07
3171041003,JAKARTA PUSAT,SENEN,PASEBAN,23533,10787,12746,5034,17780,2021-08-07
3173061005,JAKARTA BARAT,KALI DERES,PEGADUNGAN,75587,32226,43361,17345,60706,2021-08-07
3171061002,JAKARTA PUSAT,MENTENG,PEGANGSAAN,23455,11758,11697,4624,16321,2021-08-07
3172061002,JAKARTA UTARA,KELAPA GADING,PEGANGSAAN DUA,49976,17400,32576,16053,48629,2021-08-07
3172011004,JAKARTA UTARA,PENJARINGAN,PEJAGALAN,74578,32834,41744,19399,61143,2021-08-07
3174041006,JAKARTA SELATAN,PASAR MINGGU,PEJATEN BARAT,37346,17154,20192,9398,29590,2021-08-07
3174041005,JAKARTA SELATAN,PASAR MINGGU,PEJATEN TIMUR,57656,28954,28702,12053,40755,2021-08-07
3175051005,JAKARTA TIMUR,PASAR REBO,PEKAYON,43250,18260,24990,9825,34815,2021-08-07
3173041009,JAKARTA BARAT,TAMBORA,PEKOJAN,23587,9867,13720,5800,19520,2021-08-07
3174031003,JAKARTA SELATAN,MAMPANG PRAPATAN,PELA MAMPANG,43522,18859,24663,10375,35038,2021-08-07
3174081005,JAKARTA SELATAN,PANCORAN,PENGADEGAN,21478,8614,12864,5113,17977,2021-08-07
3175061003,JAKARTA TIMUR,CAKUNG,PENGGILINGAN,99255,52129,47126,15017,62143,2021-08-07
3172011001,JAKARTA UTARA,PENJARINGAN,PENJARINGAN,88308,44947,43361,16333,59694,2021-08-07
3174101001,JAKARTA SELATAN,PESANGGRAHAN,PESANGGRAHAN,27545,11313,16232,7594,23826,2021-08-07
3171071004,JAKARTA PUSAT,TANAH ABANG,PETAMBURAN,33271,18554,14717,4667,19384,2021-08-07
3174071008,JAKARTA SELATAN,KEBAYORAN BARU,PETOGOGAN,11499,5184,6315,3100,9415,2021-08-07
3171011004,JAKARTA PUSAT,GAMBIR,PETOJO SELATAN,14692,6608,8084,3989,12073,2021-08-07
3171011003,JAKARTA PUSAT,GAMBIR,PETOJO UTARA,17458,8123,9335,3896,13231,2021-08-07
3174101004,JAKARTA SELATAN,PESANGGRAHAN,PETUKANGAN SELATAN,37187,16188,20999,7711,28710,2021-08-07
3174101003,JAKARTA SELATAN,PESANGGRAHAN,PETUKANGAN UTARA,53716,25434,28282,12128,40410,2021-08-07
3175081002,JAKARTA TIMUR,MAKASAR,PINANG RANTI,27198,12345,14853,6143,20996,2021-08-07
3173031008,JAKARTA BARAT,TAMAN SARI,PINANGSIA,10729,4242,6487,2824,9311,2021-08-07
3175011001,JAKARTA TIMUR,MATRAMAN,PISANGAN BARU,31776,15779,15997,6010,22007,2021-08-07
3175021002,JAKARTA TIMUR,PULO GADUNG,PISANGAN TIMUR,41011,18023,22988,8947,31935,2021-08-07
3172011005,JAKARTA UTARA,PENJARINGAN,PLUIT,47783,19863,27920,17153,45073,2021-08-07
3175071002,JAKARTA TIMUR,DUREN SAWIT,PONDOK BAMBU,61550,30438,31112,13765,44877,2021-08-07
3175071004,JAKARTA TIMUR,DUREN SAWIT,PONDOK KELAPA,72015,32171,39844,16933,56777,2021-08-07
3175071007,JAKARTA TIMUR,DUREN SAWIT,PONDOK KOPI,35367,18329,17038,6860,23898,2021-08-07
3174061003,JAKARTA SELATAN,CILANDAK,PONDOK LABU,46464,19570,26894,12428,39322,2021-08-07
3174051002,JAKARTA SELATAN,KEBAYORAN LAMA,PONDOK PINANG,56169,25441,30728,14626,45354,2021-08-07
3175101003,JAKARTA TIMUR,CIPAYUNG,PONDOK RANGGON,25574,12270,13304,5711,19015,2021-08-07
3101011003,KAB.ADM.KEP.SERIBU,KEP. SERIBU UTARA,PULAU HARAPAN,2060,407,1653,806,2459,2021-08-07
3101011002,KAB.ADM.KEP.SERIBU,KEP. SERIBU UTARA,PULAU KELAPA,5528,1137,4391,1609,6000,2021-08-07
3101011001,KAB.ADM.KEP.SERIBU,KEP. SERIBU UTARA,PULAU PANGGANG,5450,1016,4434,1569,6003,2021-08-07
3101021003,KAB.ADM.KEP.SERIBU,KEP. SERIBU SELATAN,PULAU PARI,2765,377,2388,1120,3508,2021-08-07
3101021002,KAB.ADM.KEP.SERIBU,KEP. SERIBU SELATAN,PULAU TIDUNG,4553,848,3705,1604,5309,2021-08-07
3101021001,KAB.ADM.KEP.SERIBU,KEP. SERIBU SELATAN,PULAU UNTUNG JAWA,1941,419,1522,749,2271,2021-08-07
3174071007,JAKARTA SELATAN,KEBAYORAN BARU,PULO,5835,2307,3528,2100,5628,2021-08-07
3175021001,JAKARTA TIMUR,PULO GADUNG,PULO GADUNG,34422,16591,17831,7612,25443,2021-08-07
3175061005,JAKARTA TIMUR,CAKUNG,PULO GEBANG,97301,46964,50337,16669,67006,2021-08-07
3174041004,JAKARTA SELATAN,PASAR MINGGU,RAGUNAN,39616,16869,22747,10045,32792,2021-08-07
3175091005,JAKARTA TIMUR,CIRACAS,RAMBUTAN,36771,19030,17741,6862,24603,2021-08-07
3172031006,JAKARTA UTARA,KOJA,RAWA BADAK SELATAN,42179,21139,21040,6713,27753,2021-08-07
3172031004,JAKARTA UTARA,KOJA,RAWA BADAK UTARA,34408,16717,17691,7065,24756,2021-08-07
3174071005,JAKARTA SELATAN,KEBAYORAN BARU,RAWA BARAT,5625,2298,3327,1880,5207,2021-08-07
3173011003,JAKARTA BARAT,CENGKARENG,RAWA BUAYA,63799,30408,33391,10629,44020,2021-08-07
3175031004,JAKARTA TIMUR,JATINEGARA,RAWA BUNGA,21434,10715,10719,3938,14657,2021-08-07
3174081003,JAKARTA SELATAN,PANCORAN,RAWA JATI,20509,8730,11779,5169,16948,2021-08-07
3175061002,JAKARTA TIMUR,CAKUNG,RAWA TERATE,24637,9993,14644,3587,18231,2021-08-07
3175021005,JAKARTA TIMUR,PULO GADUNG,RAWAMANGUN,37612,17215,20397,8892,29289,2021-08-07
3171051003,JAKARTA PUSAT,CEMPAKA PUTIH,RAWASARI,21967,9918,12049,5555,17604,2021-08-07
3173041010,JAKARTA BARAT,TAMBORA,ROA MALAKA,3484,1304,2180,1215,3395,2021-08-07
3172041006,JAKARTA UTARA,CILINCING,ROROTAN,41668,17806,23862,7785,31647,2021-08-07
3174071004,JAKARTA SELATAN,KEBAYORAN BARU,SELONG,2842,1139,1703,1144,2847,2021-08-07
3173061002,JAKARTA BARAT,KALI DERES,SEMANAN,71354,34354,37000,8971,45971,2021-08-07
3172041007,JAKARTA UTARA,CILINCING,SEMPER BARAT,68587,28026,40561,15629,56190,2021-08-07
3172041005,JAKARTA UTARA,CILINCING,SEMPER TIMUR,36267,16111,20156,8008,28164,2021-08-07
3174071006,JAKARTA SELATAN,KEBAYORAN BARU,SENAYAN,2771,1400,1371,806,2177,2021-08-07
3171041001,JAKARTA PUSAT,SENEN,SENEN,6804,2938,3866,1626,5492,2021-08-07
3171031004,JAKARTA PUSAT,KEMAYORAN,SERDANG,29668,13403,16265,6314,22579,2021-08-07
3174021001,JAKARTA SELATAN,SETIA BUDI,SETIA BUDI,3023,1376,1647,906,2553,2021-08-07
3175101005,JAKARTA TIMUR,CIPAYUNG,SETU,20572,10308,10264,3945,14209,2021-08-07
3173071002,JAKARTA BARAT,PALMERAH,SLIPI,16591,7186,9405,4106,13511,2021-08-07
3173081004,JAKARTA BARAT,KEMBANGAN,SRENGSENG,45523,21893,23630,9565,33195,2021-08-07
3174091002,JAKARTA SELATAN,JAGAKARSA,SRENGSENG SAWAH,58196,22868,35328,15688,51016,2021-08-07
3173051003,JAKARTA BARAT,KEBON JERUK,SUKABUMI SELATAN,37033,18640,18393,6452,24845,2021-08-07
3173051002,JAKARTA BARAT,KEBON JERUK,SUKABUMI UTARA,38290,20401,17889,6472,24361,2021-08-07
3172041002,JAKARTA UTARA,CILINCING,SUKAPURA,53949,24535,29414,10369,39783,2021-08-07
3171031007,JAKARTA PUSAT,KEMAYORAN,SUMUR BATU,22717,10292,12425,5756,18181,2021-08-07
3172021004,JAKARTA UTARA,TANJUNG PRIOK,SUNGAI BAMBU,29876,13103,16773,7141,23914,2021-08-07
3172021006,JAKARTA UTARA,TANJUNG PRIOK,SUNTER AGUNG,71805,27374,44431,21461,65892,2021-08-07
3172021002,JAKARTA UTARA,TANJUNG PRIOK,SUNTER JAYA,63031,25890,37141,17348,54489,2021-08-07
3175091004,JAKARTA TIMUR,CIRACAS,SUSUKAN,38257,16954,21303,8538,29841,2021-08-07
3173031001,JAKARTA BARAT,TAMAN SARI,TAMAN SARI,14348,6072,8276,3863,12139,2021-08-07
3173041001,JAKARTA BARAT,TAMBORA,TAMBORA,10204,4893,5311,2290,7601,2021-08-07
3173041004,JAKARTA BARAT,TAMBORA,TANAH SEREAL,26387,9854,16533,6032,22565,2021-08-07
3171081004,JAKARTA PUSAT,JOHAR BARU,TANAH TINGGI,37693,14745,22948,7817,30765,2021-08-07
3173031004,JAKARTA BARAT,TAMAN SARI,TANGKI,13324,5615,7709,3257,10966,2021-08-07
3174091005,JAKARTA SELATAN,JAGAKARSA,TANJUNG BARAT,39770,17327,22443,9411,31854,2021-08-07
3173021005,JAKARTA BARAT,GROGOL PETAMBURAN,TANJUNG DUREN SELATAN,25337,10523,14814,6710,21524,2021-08-07
3173021002,JAKARTA BARAT,GROGOL PETAMBURAN,TANJUNG DUREN UTARA,17010,6655,10355,5037,15392,2021-08-07
3172021001,JAKARTA UTARA,TANJUNG PRIOK,TANJUNG PRIOK,34588,14031,20557,6921,27478,2021-08-07
3174011002,JAKARTA SELATAN,TEBET,TEBET BARAT,21194,8476,12718,6302,19020,2021-08-07
3174011001,JAKARTA SELATAN,TEBET,TEBET TIMUR,18199,7153,11046,5567,16613,2021-08-07
3173061003,JAKARTA BARAT,KALI DERES,TEGAL ALUR,83647,37637,46010,13229,59239,2021-08-07
3174031004,JAKARTA SELATAN,MAMPANG PRAPATAN,TEGAL PARANG,32401,15598,16803,6155,22958,2021-08-07
3173021003,JAKARTA BARAT,GROGOL PETAMBURAN,TOMANG,29605,12908,16697,7801,24498,2021-08-07
3172031005,JAKARTA UTARA,KOJA,TUGU SELATAN,39122,18859,20263,7222,27485,2021-08-07
3172031002,JAKARTA UTARA,KOJA,TUGU UTARA,67670,33625,34045,12172,46217,2021-08-07
3175061006,JAKARTA TIMUR,CAKUNG,UJUNG MENTENG,29934,12354,17580,6235,23815,2021-08-07
3174101005,JAKARTA SELATAN,PESANGGRAHAN,ULUJAMI,40544,19291,21253,7922,29175,2021-08-07
3175011006,JAKARTA TIMUR,MATRAMAN,UTAN KAYU SELATAN,33511,15119,18392,7873,26265,2021-08-07
3175011002,JAKARTA TIMUR,MATRAMAN,UTAN KAYU UTARA,28169,13339,14830,6193,21023,2021-08-07
3171031008,JAKARTA PUSAT,KEMAYORAN,UTAN PANJANG,29208,13881,15327,5104,20431,2021-08-07
3172021007,JAKARTA UTARA,TANJUNG PRIOK,WARAKAS,44401,19232,25169,9596,34765,2021-08-07
3173021007,JAKARTA BARAT,GROGOL PETAMBURAN,WIJAYA KUSUMA,38934,17907,21027,8341,29368,2021-08-07
3172051003,JAKARTA UTARA,PADEMANGAN,ANCOL,23947,10917,13030,5096,18126,2021-08-08
3173041007,JAKARTA BARAT,TAMBORA,ANGKE,29381,12695,16686,5901,22587,2021-08-08
3175041005,JAKARTA TIMUR,KRAMAT JATI,BALE KAMBANG,29074,16303,12771,4503,17274,2021-08-08
3175031003,JAKARTA TIMUR,JATINEGARA,BALI MESTER,9752,4378,5374,2408,7782,2021-08-08
3175101006,JAKARTA TIMUR,CIPAYUNG,BAMBU APUS,26285,11797,14488,6157,20645,2021-08-08
3174031002,JAKARTA SELATAN,MAMPANG PRAPATAN,BANGKA,21566,9599,11967,5010,16977,2021-08-08
3175051002,JAKARTA TIMUR,PASAR REBO,BARU,23886,9244,14642,7556,22198,2021-08-08
3175041004,JAKARTA TIMUR,KRAMAT JATI,BATU AMPAR,47898,25159,22739,9036,31775,2021-08-08
3171071002,JAKARTA PUSAT,TANAH ABANG,BENDUNGAN HILIR,21494,9293,12201,5559,17760,2021-08-08
3175031002,JAKARTA TIMUR,JATINEGARA,BIDARA CINA,36689,18871,17818,6918,24736,2021-08-08
3174101002,JAKARTA SELATAN,PESANGGRAHAN,BINTARO,53098,22793,30305,13142,43447,2021-08-08
3174011005,JAKARTA SELATAN,TEBET,BUKIT DURI,34183,15784,18399,7767,26166,2021-08-08
3171041006,JAKARTA PUSAT,SENEN,BUNGUR,18144,7669,10475,4583,15058,2021-08-08
3175061007,JAKARTA TIMUR,CAKUNG,CAKUNG BARAT,57724,23582,34142,9949,44091,2021-08-08
3175061004,JAKARTA TIMUR,CAKUNG,CAKUNG TIMUR,58287,24139,34148,12579,46727,2021-08-08
3175041007,JAKARTA TIMUR,KRAMAT JATI,CAWANG,32762,15992,16770,7211,23981,2021-08-08
3175101008,JAKARTA TIMUR,CIPAYUNG,CEGER,18932,8225,10707,4131,14838,2021-08-08
3171031006,JAKARTA PUSAT,KEMAYORAN,CEMPAKA BARU,32581,15450,17131,6934,24065,2021-08-08
3171051002,JAKARTA PUSAT,CEMPAKA PUTIH,CEMPAKA PUTIH BARAT,35885,15938,19947,8620,28567,2021-08-08
3171051001,JAKARTA PUSAT,CEMPAKA PUTIH,CEMPAKA PUTIH TIMUR,24292,10678,13614,6988,20602,2021-08-08
3173011001,JAKARTA BARAT,CENGKARENG,CENGKARENG BARAT,66284,29346,36938,15513,52451,2021-08-08
3173011006,JAKARTA BARAT,CENGKARENG,CENGKARENG TIMUR,81027,36150,44877,16510,61387,2021-08-08
3175091002,JAKARTA TIMUR,CIRACAS,CIBUBUR,66364,28083,38281,16516,54797,2021-08-08
3171011002,JAKARTA PUSAT,GAMBIR,CIDENG,15390,6185,9205,4556,13761,2021-08-08
3174091003,JAKARTA SELATAN,JAGAKARSA,CIGANJUR,38497,16522,21975,9514,31489,2021-08-08
3175051003,JAKARTA TIMUR,PASAR REBO,CIJANTUNG,41419,17640,23779,11028,34807,2021-08-08
3171061003,JAKARTA PUSAT,MENTENG,CIKINI,8274,4061,4213,2051,6264,2021-08-08
3174081006,JAKARTA SELATAN,PANCORAN,CIKOKO,10547,4162,6385,2667,9052,2021-08-08
3174061001,JAKARTA SELATAN,CILANDAK,CILANDAK BARAT,51752,21352,30400,14853,45253,2021-08-08
3174041003,JAKARTA SELATAN,PASAR MINGGU,CILANDAK TIMUR,25145,10274,14871,7740,22611,2021-08-08
3175101002,JAKARTA TIMUR,CIPAYUNG,CILANGKAP,27635,12104,15531,6387,21918,2021-08-08
3175041006,JAKARTA TIMUR,KRAMAT JATI,CILILITAN,40181,20298,19883,8557,28440,2021-08-08
3172041001,JAKARTA UTARA,CILINCING,CILINCING,43609,20565,23044,7906,30950,2021-08-08
3175101001,JAKARTA TIMUR,CIPAYUNG,CIPAYUNG,26104,10217,15887,6873,22760,2021-08-08
3174091006,JAKARTA SELATAN,JAGAKARSA,CIPEDAK,38303,15196,23107,10266,33373,2021-08-08
3174061005,JAKARTA SELATAN,CILANDAK,CIPETE SELATAN,26704,11481,15223,7328,22551,2021-08-08
3174071010,JAKARTA SELATAN,KEBAYORAN BARU,CIPETE UTARA,34102,14699,19403,8146,27549,2021-08-08
3175021003,JAKARTA TIMUR,PULO GADUNG,CIPINANG,39306,17947,21359,9762,31121,2021-08-08
3175031007,JAKARTA TIMUR,JATINEGARA,CIPINANG BESAR SELATAN,35212,18238,16974,6383,23357,2021-08-08
3175031008,JAKARTA TIMUR,JATINEGARA,CIPINANG BESAR UTARA,45319,22673,22646,7676,30322,2021-08-08
3175031005,JAKARTA TIMUR,JATINEGARA,CIPINANG CEMPEDAK,32824,15812,17012,7565,24577,2021-08-08
3175081005,JAKARTA TIMUR,MAKASAR,CIPINANG MELAYU,42308,19182,23126,10677,33803,2021-08-08
3175031006,JAKARTA TIMUR,JATINEGARA,CIPINANG MUARA,55243,26635,28608,11511,40119,2021-08-08
3174051003,JAKARTA SELATAN,KEBAYORAN LAMA,CIPULIR,39937,18596,21341,8539,29880,2021-08-08
3175091001,JAKARTA TIMUR,CIRACAS,CIRACAS,64594,27351,37243,14959,52202,2021-08-08
3175041003,JAKARTA TIMUR,KRAMAT JATI,DUKUH,24609,11189,13420,5713,19133,2021-08-08
3175071001,JAKARTA TIMUR,DUREN SAWIT,DUREN SAWIT,61160,30163,30997,15219,46216,2021-08-08
3174081004,JAKARTA SELATAN,PANCORAN,DUREN TIGA,28319,12062,16257,6444,22701,2021-08-08
3173051005,JAKARTA BARAT,KEBON JERUK,DURI KEPA,60138,25105,35033,15632,50665,2021-08-08
3173011002,JAKARTA BARAT,CENGKARENG,DURI KOSAMBI,77923,38393,39530,15315,54845,2021-08-08
3171011006,JAKARTA PUSAT,GAMBIR,DURI PULO,19610,8649,10961,3817,14778,2021-08-08
3173041011,JAKARTA BARAT,TAMBORA,DURI SELATAN,14259,5695,8564,3482,12046,2021-08-08
3173041003,JAKARTA BARAT,TAMBORA,DURI UTARA,19844,8359,11485,4144,15629,2021-08-08
3171081003,JAKARTA PUSAT,JOHAR BARU,GALUR,18243,6922,11321,3599,14920,2021-08-08
3171011001,JAKARTA PUSAT,GAMBIR,GAMBIR,2191,836,1355,709,2064,2021-08-08
3174061004,JAKARTA SELATAN,CILANDAK,GANDARIA SELATAN,22119,9469,12650,5467,18117,2021-08-08
3174071009,JAKARTA SELATAN,KEBAYORAN BARU,GANDARIA UTARA,39922,17639,22283,9553,31836,2021-08-08
3175051001,JAKARTA TIMUR,PASAR REBO,GEDONG,35755,15559,20196,8760,28956,2021-08-08
3171071001,JAKARTA PUSAT,TANAH ABANG,GELORA,3127,1402,1725,788,2513,2021-08-08
3173031007,JAKARTA BARAT,TAMAN SARI,GLODOK,7837,2818,5019,2899,7918,2021-08-08
3171061004,JAKARTA PUSAT,MENTENG,GONDANGDIA,4100,1699,2401,1615,4016,2021-08-08
3173021001,JAKARTA BARAT,GROGOL PETAMBURAN,GROGOL,16876,7366,9510,4239,13749,2021-08-08
3174051005,JAKARTA SELATAN,KEBAYORAN LAMA,GROGOL SELATAN,44251,20331,23920,9496,33416,2021-08-08
3174051004,JAKARTA SELATAN,KEBAYORAN LAMA,GROGOL UTARA,42494,19072,23422,9558,32980,2021-08-08
3174021007,JAKARTA SELATAN,SETIA BUDI,GUNTUR,3985,1612,2373,1404,3777,2021-08-08
3174071002,JAKARTA SELATAN,KEBAYORAN BARU,GUNUNG,9436,3832,5604,3150,8754,2021-08-08
3171031005,JAKARTA PUSAT,KEMAYORAN,GUNUNG SAHARI SELATAN,19199,8365,10834,5058,15892,2021-08-08
3171021004,JAKARTA PUSAT,SAWAH BESAR,GUNUNG SAHARI UTARA,16650,6285,10365,5169,15534,2021-08-08
3175081004,JAKARTA TIMUR,MAKASAR,HALIM PERDANA KUSUMAH,28363,9308,19055,12895,31950,2021-08-08
3171031003,JAKARTA PUSAT,KEMAYORAN,HARAPAN MULIA,22557,10001,12556,5060,17616,2021-08-08
3174091001,JAKARTA SELATAN,JAGAKARSA,JAGAKARSA,62389,25133,37256,16890,54146,2021-08-08
3175021007,JAKARTA TIMUR,PULO GADUNG,JATI,32757,15148,17609,8712,26321,2021-08-08
3174041002,JAKARTA SELATAN,PASAR MINGGU,JATI PADANG,37502,16413,21089,10228,31317,2021-08-08
3173071004,JAKARTA BARAT,PALMERAH,JATI PULO,28738,11990,16748,5603,22351,2021-08-08
3175061001,JAKARTA TIMUR,CAKUNG,JATINEGARA,84160,38951,45209,13719,58928,2021-08-08
3175021004,JAKARTA TIMUR,PULO GADUNG,JATINEGARA KAUM,24632,10719,13913,4918,18831,2021-08-08
3173021004,JAKARTA BARAT,GROGOL PETAMBURAN,JELAMBAR,30266,12876,17390,8694,26084,2021-08-08
3173021006,JAKARTA BARAT,GROGOL PETAMBURAN,JELAMBAR BARU,38246,16729,21517,10317,31834,2021-08-08
3173041006,JAKARTA BARAT,TAMBORA,JEMBATAN BESI,29314,15891,13423,4205,17628,2021-08-08
3173041008,JAKARTA BARAT,TAMBORA,JEMBATAN LIMA,21021,10688,10333,4014,14347,2021-08-08
3173081005,JAKARTA BARAT,KEMBANGAN,JOGLO,40839,18789,22050,9251,31301,2021-08-08
3171081001,JAKARTA PUSAT,JOHAR BARU,JOHAR BARU,37488,14951,22537,9266,31803,2021-08-08
3173041002,JAKARTA BARAT,TAMBORA,KALI ANYAR,23856,11088,12768,3708,16476,2021-08-08
3172041004,JAKARTA UTARA,CILINCING,KALIBARU,67684,34170,33514,9971,43485,2021-08-08
3174081002,JAKARTA SELATAN,PANCORAN,KALIBATA,41994,20233,21761,8495,30256,2021-08-08
3173061001,JAKARTA BARAT,KALI DERES,KALIDERES,72447,31392,41055,15280,56335,2021-08-08
3175051004,JAKARTA TIMUR,PASAR REBO,KALISARI,43212,18483,24729,11376,36105,2021-08-08
3173061004,JAKARTA BARAT,KALI DERES,KAMAL,53783,25173,28610,7276,35886,2021-08-08
3172011002,JAKARTA UTARA,PENJARINGAN,KAMAL MUARA,12930,4189,8741,4386,13127,2021-08-08
3171071007,JAKARTA PUSAT,TANAH ABANG,KAMPUNG BALI,11358,5702,5656,2365,8021,2021-08-08
3175031001,JAKARTA TIMUR,JATINEGARA,KAMPUNG MELAYU,25717,12708,13009,4763,17772,2021-08-08
3171081002,JAKARTA PUSAT,JOHAR BARU,KAMPUNG RAWA,21237,7205,14032,4648,18680,2021-08-08
3175041002,JAKARTA TIMUR,KRAMAT JATI,KAMPUNG TENGAH,43993,23361,20632,8454,29086,2021-08-08
3173011005,JAKARTA BARAT,CENGKARENG,KAPUK,134466,66293,68173,20165,88338,2021-08-08
3172011003,JAKARTA UTARA,PENJARINGAN,KAPUK MUARA,35781,13790,21991,11235,33226,2021-08-08
3171021002,JAKARTA PUSAT,SAWAH BESAR,KARANG ANYAR,25761,10739,15022,5983,21005,2021-08-08
3174021004,JAKARTA SELATAN,SETIA BUDI,KARET,9623,4441,5182,2620,7802,2021-08-08
3174021003,JAKARTA SELATAN,SETIA BUDI,KARET KUNINGAN,16055,6603,9452,4261,13713,2021-08-08
3174021002,JAKARTA SELATAN,SETIA BUDI,KARET SEMANGGI,2770,1058,1712,1028,2740,2021-08-08
3171071003,JAKARTA PUSAT,TANAH ABANG,KARET TENGSIN,19271,8426,10845,3960,14805,2021-08-08
3171021003,JAKARTA PUSAT,SAWAH BESAR,KARTINI,22292,9279,13013,5956,18969,2021-08-08
3175011003,JAKARTA TIMUR,MATRAMAN,KAYU MANIS,25284,12537,12747,5072,17819,2021-08-08
3175021006,JAKARTA TIMUR,PULO GADUNG,KAYU PUTIH,40696,16696,24000,11757,35757,2021-08-08
3173031006,JAKARTA BARAT,TAMAN SARI,KEAGUNGAN,17387,7383,10004,3906,13910,2021-08-08
3174041007,JAKARTA SELATAN,PASAR MINGGU,KEBAGUSAN,44552,20026,24526,10106,34632,2021-08-08
3174051006,JAKARTA SELATAN,KEBAYORAN LAMA,KEBAYORAN LAMA SELATAN,41212,17788,23424,9854,33278,2021-08-08
3174051001,JAKARTA SELATAN,KEBAYORAN LAMA,KEBAYORAN LAMA UTARA,42422,19745,22677,9040,31717,2021-08-08
3174011004,JAKARTA SELATAN,TEBET,KEBON BARU,35165,15297,19868,8728,28596,2021-08-08
3172021005,JAKARTA UTARA,TANJUNG PRIOK,KEBON BAWANG,50952,22782,28170,11983,40153,2021-08-08
3173051001,JAKARTA BARAT,KEBON JERUK,KEBON JERUK,53887,26066,27821,10927,38748,2021-08-08
3171071006,JAKARTA PUSAT,TANAH ABANG,KEBON KACANG,21531,11461,10070,4033,14103,2021-08-08
3171011005,JAKARTA PUSAT,GAMBIR,KEBON KELAPA,10163,4328,5835,2616,8451,2021-08-08
3171031002,JAKARTA PUSAT,KEMAYORAN,KEBON KOSONG,30019,13439,16580,6840,23420,2021-08-08
3175011005,JAKARTA TIMUR,MATRAMAN,KEBON MANGGIS,16490,7125,9365,4349,13714,2021-08-08
3171071005,JAKARTA PUSAT,TANAH ABANG,KEBON MELATI,32206,18039,14167,4497,18664,2021-08-08
3175081003,JAKARTA TIMUR,MAKASAR,KEBON PALA,46614,21555,25059,10052,35111,2021-08-08
3171061005,JAKARTA PUSAT,MENTENG,KEBON SIRIH,12299,5982,6317,2464,8781,2021-08-08
3173011004,JAKARTA BARAT,CENGKARENG,KEDAUNG KALI ANGKE,32612,12624,19988,6167,26155,2021-08-08
3173051007,JAKARTA BARAT,KEBON JERUK,KEDOYA SELATAN,32165,13635,18530,7034,25564,2021-08-08
3173051006,JAKARTA BARAT,KEBON JERUK,KEDOYA UTARA,45740,18037,27703,10915,38618,2021-08-08
3173051004,JAKARTA BARAT,KEBON JERUK,KELAPA DUA,23565,10789,12776,4976,17752,2021-08-08
3175091003,JAKARTA TIMUR,CIRACAS,KELAPA DUA WETAN,46875,19480,27395,11543,38938,2021-08-08
3172061003,JAKARTA UTARA,KELAPA GADING,KELAPA GADING BARAT,35717,13295,22422,12683,35105,2021-08-08
3172061001,JAKARTA UTARA,KELAPA GADING,KELAPA GADING TIMUR,33592,11545,22047,13279,35326,2021-08-08
3173071005,JAKARTA BARAT,PALMERAH,KEMANGGISAN,32139,14807,17332,7530,24862,2021-08-08
3171031001,JAKARTA PUSAT,KEMAYORAN,KEMAYORAN,20708,8660,12048,5182,17230,2021-08-08
3173081006,JAKARTA BARAT,KEMBANGAN,KEMBANGAN SELATAN,27130,11876,15254,7209,22463,2021-08-08
3173081001,JAKARTA BARAT,KEMBANGAN,KEMBANGAN UTARA,54451,23831,30620,10513,41133,2021-08-08
3171041002,JAKARTA PUSAT,SENEN,KENARI,9579,3844,5735,2591,8326,2021-08-08
3173041005,JAKARTA BARAT,TAMBORA,KERENDANG,19973,9017,10956,3768,14724,2021-08-08
3175071003,JAKARTA TIMUR,DUREN SAWIT,KLENDER,69978,36680,33298,13030,46328,2021-08-08
3172031001,JAKARTA UTARA,KOJA,KOJA,28175,12806,15369,5913,21282,2021-08-08
3173071006,JAKARTA BARAT,PALMERAH,KOTA BAMBU SELATAN,21158,9662,11496,4010,15506,2021-08-08
3173071003,JAKARTA BARAT,PALMERAH,KOTA BAMBU UTARA,24995,11802,13193,4493,17686,2021-08-08
3171041004,JAKARTA PUSAT,SENEN,KRAMAT,28835,14006,14829,5523,20352,2021-08-08
3175041001,JAKARTA TIMUR,KRAMAT JATI,KRAMAT JATI,34144,16050,18094,7521,25615,2021-08-08
3174071003,JAKARTA SELATAN,KEBAYORAN BARU,KRAMAT PELA,14413,6118,8295,3883,12178,2021-08-08
3173031002,JAKARTA BARAT,TAMAN SARI,KRUKUT,19244,8449,10795,3946,14741,2021-08-08
3174031005,JAKARTA SELATAN,MAMPANG PRAPATAN,KUNINGAN BARAT,12785,5365,7420,3542,10962,2021-08-08
3174021008,JAKARTA SELATAN,SETIA BUDI,KUNINGAN TIMUR,6008,2604,3404,1753,5157,2021-08-08
3171041005,JAKARTA PUSAT,SENEN,KWITANG,15486,6577,8909,3558,12467,2021-08-08
3172031003,JAKARTA UTARA,KOJA,LAGOA,59065,28781,30284,10934,41218,2021-08-08
3174061002,JAKARTA SELATAN,CILANDAK,LEBAK BULUS,37626,16738,20888,9996,30884,2021-08-08
3174091004,JAKARTA SELATAN,JAGAKARSA,LENTENG AGUNG,53946,24276,29670,11418,41088,2021-08-08
3175101007,JAKARTA TIMUR,CIPAYUNG,LUBANG BUAYA,63547,28340,35207,16161,51368,2021-08-08
3175081001,JAKARTA TIMUR,MAKASAR,MAKASAR,34390,14809,19581,8642,28223,2021-08-08
3175071006,JAKARTA TIMUR,DUREN SAWIT,MALAKA JAYA,30927,13426,17501,8817,26318,2021-08-08
3175071005,JAKARTA TIMUR,DUREN SAWIT,MALAKA SARI,27530,11763,15767,8053,23820,2021-08-08
3174031001,JAKARTA SELATAN,MAMPANG PRAPATAN,MAMPANG PRAPATAN,18159,7845,10314,4605,14919,2021-08-08
3173031005,JAKARTA BARAT,TAMAN SARI,MANGGA BESAR,7707,2897,4810,2384,7194,2021-08-08
3171021005,JAKARTA PUSAT,SAWAH BESAR,MANGGA DUA SELATAN,27442,11925,15517,6954,22471,2021-08-08
3174011007,JAKARTA SELATAN,TEBET,MANGGARAI,28373,11802,16571,6109,22680,2021-08-08
3174011006,JAKARTA SELATAN,TEBET,MANGGARAI SELATAN,23075,9476,13599,6268,19867,2021-08-08
3173031003,JAKARTA BARAT,TAMAN SARI,MAPHAR,16461,7109,9352,4246,13598,2021-08-08
3172041003,JAKARTA UTARA,CILINCING,MARUNDA,28943,12534,16409,4957,21366,2021-08-08
3174071001,JAKARTA SELATAN,KEBAYORAN BARU,MELAWAI,2627,995,1632,1132,2764,2021-08-08
3171061001,JAKARTA PUSAT,MENTENG,MENTENG,25624,12623,13001,5603,18604,2021-08-08
3174021005,JAKARTA SELATAN,SETIA BUDI,MENTENG ATAS,27816,11565,16251,6912,23163,2021-08-08
3174011003,JAKARTA SELATAN,TEBET,MENTENG DALAM,36028,15606,20422,8993,29415,2021-08-08
3173081003,JAKARTA BARAT,KEMBANGAN,MERUYA SELATAN,32130,14783,17347,7049,24396,2021-08-08
3173081002,JAKARTA BARAT,KEMBANGAN,MERUYA UTARA,43752,19594,24158,10729,34887,2021-08-08
3175101004,JAKARTA TIMUR,CIPAYUNG,MUNJUL,23871,10225,13646,5698,19344,2021-08-08
3172051002,JAKARTA UTARA,PADEMANGAN,PADEMANGAN BARAT,74240,33831,40409,14338,54747,2021-08-08
3172051001,JAKARTA UTARA,PADEMANGAN,PADEMANGAN TIMUR,37736,14397,23339,10678,34017,2021-08-08
3175011004,JAKARTA TIMUR,MATRAMAN,PAL MERIAM,19769,9302,10467,4557,15024,2021-08-08
3173071001,JAKARTA BARAT,PALMERAH,PALMERAH,63011,29192,33819,12827,46646,2021-08-08
3174081001,JAKARTA SELATAN,PANCORAN,PANCORAN,19421,8347,11074,4793,15867,2021-08-08
3172021003,JAKARTA UTARA,TANJUNG PRIOK,PAPANGGO,39097,16132,22965,9235,32200,2021-08-08
3171021001,JAKARTA PUSAT,SAWAH BESAR,PASAR BARU,12035,4460,7575,3916,11491,2021-08-08
3174021006,JAKARTA SELATAN,SETIA BUDI,PASAR MANGGIS,26752,11974,14778,6843,21621,2021-08-08
3174041001,JAKARTA SELATAN,PASAR MINGGU,PASAR MINGGU,24821,10520,14301,7216,21517,2021-08-08
3171041003,JAKARTA PUSAT,SENEN,PASEBAN,23533,10465,13068,5342,18410,2021-08-08
3173061005,JAKARTA BARAT,KALI DERES,PEGADUNGAN,75587,31339,44248,18376,62624,2021-08-08
3171061002,JAKARTA PUSAT,MENTENG,PEGANGSAAN,23455,11484,11971,4832,16803,2021-08-08
3172061002,JAKARTA UTARA,KELAPA GADING,PEGANGSAAN DUA,49976,16987,32989,16874,49863,2021-08-08
3172011004,JAKARTA UTARA,PENJARINGAN,PEJAGALAN,74578,32464,42114,19734,61848,2021-08-08
3174041006,JAKARTA SELATAN,PASAR MINGGU,PEJATEN BARAT,37346,16795,20551,9811,30362,2021-08-08
3174041005,JAKARTA SELATAN,PASAR MINGGU,PEJATEN TIMUR,57656,27749,29907,12669,42576,2021-08-08
3175051005,JAKARTA TIMUR,PASAR REBO,PEKAYON,43250,17960,25290,10279,35569,2021-08-08
3173041009,JAKARTA BARAT,TAMBORA,PEKOJAN,23587,9813,13774,5876,19650,2021-08-08
3174031003,JAKARTA SELATAN,MAMPANG PRAPATAN,PELA MAMPANG,43522,18470,25052,11158,36210,2021-08-08
3174081005,JAKARTA SELATAN,PANCORAN,PENGADEGAN,21478,8445,13033,5545,18578,2021-08-08
3175061003,JAKARTA TIMUR,CAKUNG,PENGGILINGAN,99255,50355,48900,15921,64821,2021-08-08
3172011001,JAKARTA UTARA,PENJARINGAN,PENJARINGAN,88308,43650,44658,16825,61483,2021-08-08
3174101001,JAKARTA SELATAN,PESANGGRAHAN,PESANGGRAHAN,27545,10849,16696,7938,24634,2021-08-08
3171071004,JAKARTA PUSAT,TANAH ABANG,PETAMBURAN,33271,18256,15015,4835,19850,2021-08-08
3174071008,JAKARTA SELATAN,KEBAYORAN BARU,PETOGOGAN,11499,5034,6465,3336,9801,2021-08-08
3171011004,JAKARTA PUSAT,GAMBIR,PETOJO SELATAN,14692,6428,8264,4097,12361,2021-08-08
3171011003,JAKARTA PUSAT,GAMBIR,PETOJO UTARA,17458,7756,9702,4062,13764,2021-08-08
3174101004,JAKARTA SELATAN,PESANGGRAHAN,PETUKANGAN SELATAN,37187,15671,21516,8626,30142,2021-08-08
3174101003,JAKARTA SELATAN,PESANGGRAHAN,PETUKANGAN UTARA,53716,24536,29180,12624,41804,2021-08-08
3175081002,JAKARTA TIMUR,MAKASAR,PINANG RANTI,27198,12128,15070,6397,21467,2021-08-08
3173031008,JAKARTA BARAT,TAMAN SARI,PINANGSIA,10729,4211,6518,2877,9395,2021-08-08
3175011001,JAKARTA TIMUR,MATRAMAN,PISANGAN BARU,31776,15504,16272,6230,22502,2021-08-08
3175021002,JAKARTA TIMUR,PULO GADUNG,PISANGAN TIMUR,41011,17527,23484,9414,32898,2021-08-08
3172011005,JAKARTA UTARA,PENJARINGAN,PLUIT,47783,19474,28309,17374,45683,2021-08-08
3175071002,JAKARTA TIMUR,DUREN SAWIT,PONDOK BAMBU,61550,29899,31651,14235,45886,2021-08-08
3175071004,JAKARTA TIMUR,DUREN SAWIT,PONDOK KELAPA,72015,31376,40639,17836,58475,2021-08-08
3175071007,JAKARTA TIMUR,DUREN SAWIT,PONDOK KOPI,35367,18067,17300,7150,24450,2021-08-08
3174061003,JAKARTA SELATAN,CILANDAK,PONDOK LABU,46464,18885,27579,13070,40649,2021-08-08
3174051002,JAKARTA SELATAN,KEBAYORAN LAMA,PONDOK PINANG,56169,24479,31690,15012,46702,2021-08-08
3175101003,JAKARTA TIMUR,CIPAYUNG,PONDOK RANGGON,25574,12102,13472,5856,19328,2021-08-08
3101011003,KAB.ADM.KEP.SERIBU,KEP. SERIBU UTARA,PULAU HARAPAN,2060,398,1662,825,2487,2021-08-08
3101011002,KAB.ADM.KEP.SERIBU,KEP. SERIBU UTARA,PULAU KELAPA,5528,1119,4409,1749,6158,2021-08-08
3101011001,KAB.ADM.KEP.SERIBU,KEP. SERIBU UTARA,PULAU PANGGANG,5450,1002,4448,1722,6170,2021-08-08
3101021003,KAB.ADM.KEP.SERIBU,KEP. SERIBU SELATAN,PULAU PARI,2765,374,2391,1149,3540,2021-08-08
3101021002,KAB.ADM.KEP.SERIBU,KEP. SERIBU SELATAN,PULAU TIDUNG,4553,778,3775,2196,5971,2021-08-08
3101021001,KAB.ADM.KEP.SERIBU,KEP. SERIBU SELATAN,PULAU UNTUNG JAWA,1941,417,1524,749,2273,2021-08-08
3174071007,JAKARTA SELATAN,KEBAYORAN BARU,PULO,5835,2255,3580,2169,5749,2021-08-08
3175021001,JAKARTA TIMUR,PULO GADUNG,PULO GADUNG,34422,16385,18037,7824,25861,2021-08-08
3175061005,JAKARTA TIMUR,CAKUNG,PULO GEBANG,97301,45611,51690,17789,69479,2021-08-08
3174041004,JAKARTA SELATAN,PASAR MINGGU,RAGUNAN,39616,16442,23174,10533,33707,2021-08-08
3175091005,JAKARTA TIMUR,CIRACAS,RAMBUTAN,36771,18801,17970,7147,25117,2021-08-08
3172031006,JAKARTA UTARA,KOJA,RAWA BADAK SELATAN,42179,20545,21634,7498,29132,2021-08-08
3172031004,JAKARTA UTARA,KOJA,RAWA BADAK UTARA,34408,16470,17938,7403,25341,2021-08-08
3174071005,JAKARTA SELATAN,KEBAYORAN BARU,RAWA BARAT,5625,2208,3417,1934,5351,2021-08-08
3173011003,JAKARTA BARAT,CENGKARENG,RAWA BUAYA,63799,30283,33516,10782,44298,2021-08-08
3175031004,JAKARTA TIMUR,JATINEGARA,RAWA BUNGA,21434,10284,11150,4172,15322,2021-08-08
3174081003,JAKARTA SELATAN,PANCORAN,RAWA JATI,20509,8526,11983,5466,17449,2021-08-08
3175061002,JAKARTA TIMUR,CAKUNG,RAWA TERATE,24637,9747,14890,3810,18700,2021-08-08
3175021005,JAKARTA TIMUR,PULO GADUNG,RAWAMANGUN,37612,16880,20732,9266,29998,2021-08-08
3171051003,JAKARTA PUSAT,CEMPAKA PUTIH,RAWASARI,21967,9672,12295,5888,18183,2021-08-08
3173041010,JAKARTA BARAT,TAMBORA,ROA MALAKA,3484,1289,2195,1223,3418,2021-08-08
3172041006,JAKARTA UTARA,CILINCING,ROROTAN,41668,17593,24075,7976,32051,2021-08-08
3174071004,JAKARTA SELATAN,KEBAYORAN BARU,SELONG,2842,1087,1755,1172,2927,2021-08-08
3173061002,JAKARTA BARAT,KALI DERES,SEMANAN,71354,33098,38256,10018,48274,2021-08-08
3172041007,JAKARTA UTARA,CILINCING,SEMPER BARAT,68587,27683,40904,15913,56817,2021-08-08
3172041005,JAKARTA UTARA,CILINCING,SEMPER TIMUR,36267,15706,20561,8184,28745,2021-08-08
3174071006,JAKARTA SELATAN,KEBAYORAN BARU,SENAYAN,2771,1343,1428,831,2259,2021-08-08
3171041001,JAKARTA PUSAT,SENEN,SENEN,6804,2884,3920,1723,5643,2021-08-08
3171031004,JAKARTA PUSAT,KEMAYORAN,SERDANG,29668,12827,16841,6739,23580,2021-08-08
3174021001,JAKARTA SELATAN,SETIA BUDI,SETIA BUDI,3023,1344,1679,935,2614,2021-08-08
3175101005,JAKARTA TIMUR,CIPAYUNG,SETU,20572,10096,10476,4137,14613,2021-08-08
3173071002,JAKARTA BARAT,PALMERAH,SLIPI,16591,7128,9463,4171,13634,2021-08-08
3173081004,JAKARTA BARAT,KEMBANGAN,SRENGSENG,45523,21787,23736,9783,33519,2021-08-08
3174091002,JAKARTA SELATAN,JAGAKARSA,SRENGSENG SAWAH,58196,21706,36490,16480,52970,2021-08-08
3173051003,JAKARTA BARAT,KEBON JERUK,SUKABUMI SELATAN,37033,18515,18518,6560,25078,2021-08-08
3173051002,JAKARTA BARAT,KEBON JERUK,SUKABUMI UTARA,38290,20323,17967,6577,24544,2021-08-08
3172041002,JAKARTA UTARA,CILINCING,SUKAPURA,53949,24105,29844,10942,40786,2021-08-08
3171031007,JAKARTA PUSAT,KEMAYORAN,SUMUR BATU,22717,10029,12688,5951,18639,2021-08-08
3172021004,JAKARTA UTARA,TANJUNG PRIOK,SUNGAI BAMBU,29876,12919,16957,7284,24241,2021-08-08
3172021006,JAKARTA UTARA,TANJUNG PRIOK,SUNTER AGUNG,71805,27173,44632,21816,66448,2021-08-08
3172021002,JAKARTA UTARA,TANJUNG PRIOK,SUNTER JAYA,63031,25404,37627,17630,55257,2021-08-08
3175091004,JAKARTA TIMUR,CIRACAS,SUSUKAN,38257,16489,21768,9290,31058,2021-08-08
3173031001,JAKARTA BARAT,TAMAN SARI,TAMAN SARI,14348,6043,8305,3937,12242,2021-08-08
3173041001,JAKARTA BARAT,TAMBORA,TAMBORA,10204,4868,5336,2315,7651,2021-08-08
3173041004,JAKARTA BARAT,TAMBORA,TANAH SEREAL,26387,9808,16579,6143,22722,2021-08-08
3171081004,JAKARTA PUSAT,JOHAR BARU,TANAH TINGGI,37693,14033,23660,8786,32446,2021-08-08
3173031004,JAKARTA BARAT,TAMAN SARI,TANGKI,13324,5576,7748,3336,11084,2021-08-08
3174091005,JAKARTA SELATAN,JAGAKARSA,TANJUNG BARAT,39770,16807,22963,9795,32758,2021-08-08
3173021005,JAKARTA BARAT,GROGOL PETAMBURAN,TANJUNG DUREN SELATAN,25337,10455,14882,6957,21839,2021-08-08
3173021002,JAKARTA BARAT,GROGOL PETAMBURAN,TANJUNG DUREN UTARA,17010,6624,10386,5132,15518,2021-08-08
3172021001,JAKARTA UTARA,TANJUNG PRIOK,TANJUNG PRIOK,34588,13855,20733,7094,27827,2021-08-08
3174011002,JAKARTA SELATAN,TEBET,TEBET BARAT,21194,8262,12932,6740,19672,2021-08-08
3174011001,JAKARTA SELATAN,TEBET,TEBET TIMUR,18199,6990,11209,5921,17130,2021-08-08
3173061003,JAKARTA BARAT,KALI DERES,TEGAL ALUR,83647,36495,47152,14177,61329,2021-08-08
3174031004,JAKARTA SELATAN,MAMPANG PRAPATAN,TEGAL PARANG,32401,15053,17348,6674,24022,2021-08-08
3173021003,JAKARTA BARAT,GROGOL PETAMBURAN,TOMANG,29605,12834,16771,7943,24714,2021-08-08
3172031005,JAKARTA UTARA,KOJA,TUGU SELATAN,39122,18468,20654,7528,28182,2021-08-08
3172031002,JAKARTA UTARA,KOJA,TUGU UTARA,67670,32765,34905,13304,48209,2021-08-08
3175061006,JAKARTA TIMUR,CAKUNG,UJUNG MENTENG,29934,12105,17829,6582,24411,2021-08-08
3174101005,JAKARTA SELATAN,PESANGGRAHAN,ULUJAMI,40544,18569,21975,8378,30353,2021-08-08
3175011006,JAKARTA TIMUR,MATRAMAN,UTAN KAYU SELATAN,33511,14960,18551,8225,26776,2021-08-08
3175011002,JAKARTA TIMUR,MATRAMAN,UTAN KAYU UTARA,28169,13125,15044,6468,21512,2021-08-08
3171031008,JAKARTA PUSAT,KEMAYORAN,UTAN PANJANG,29208,13190,16018,5473,21491,2021-08-08
3172021007,JAKARTA UTARA,TANJUNG PRIOK,WARAKAS,44401,19024,25377,9903,35280,2021-08-08
3173021007,JAKARTA BARAT,GROGOL PETAMBURAN,WIJAYA KUSUMA,38934,17796,21138,8576,29714,2021-08-08
3172051003,JAKARTA UTARA,PADEMANGAN,ANCOL,23947,10678,13269,5407,18676,2021-08-09
3173041007,JAKARTA BARAT,TAMBORA,ANGKE,29381,11999,17382,6468,23850,2021-08-09
3175041005,JAKARTA TIMUR,KRAMAT JATI,BALE KAMBANG,29074,15340,13734,4795,18529,2021-08-09
3175031003,JAKARTA TIMUR,JATINEGARA,BALI MESTER,9752,4315,5437,2505,7942,2021-08-09
3175101006,JAKARTA TIMUR,CIPAYUNG,BAMBU APUS,26285,11328,14957,6351,21308,2021-08-09
3174031002,JAKARTA SELATAN,MAMPANG PRAPATAN,BANGKA,21566,9463,12103,5171,17274,2021-08-09
3175051002,JAKARTA TIMUR,PASAR REBO,BARU,23886,9104,14782,7716,22498,2021-08-09
3175041004,JAKARTA TIMUR,KRAMAT JATI,BATU AMPAR,47898,24017,23881,9393,33274,2021-08-09
3171071002,JAKARTA PUSAT,TANAH ABANG,BENDUNGAN HILIR,21494,9122,12372,5778,18150,2021-08-09
3175031002,JAKARTA TIMUR,JATINEGARA,BIDARA CINA,36689,18572,18117,7154,25271,2021-08-09
3174101002,JAKARTA SELATAN,PESANGGRAHAN,BINTARO,53098,22366,30732,13624,44356,2021-08-09
3174011005,JAKARTA SELATAN,TEBET,BUKIT DURI,34183,15512,18671,7959,26630,2021-08-09
3171041006,JAKARTA PUSAT,SENEN,BUNGUR,18144,7532,10612,4697,15309,2021-08-09
3175061007,JAKARTA TIMUR,CAKUNG,CAKUNG BARAT,57724,22625,35099,10652,45751,2021-08-09
3175061004,JAKARTA TIMUR,CAKUNG,CAKUNG TIMUR,58287,23446,34841,12969,47810,2021-08-09
3175041007,JAKARTA TIMUR,KRAMAT JATI,CAWANG,32762,15420,17342,7495,24837,2021-08-09
3175101008,JAKARTA TIMUR,CIPAYUNG,CEGER,18932,7921,11011,4307,15318,2021-08-09
3171031006,JAKARTA PUSAT,KEMAYORAN,CEMPAKA BARU,32581,15268,17313,7169,24482,2021-08-09
3171051002,JAKARTA PUSAT,CEMPAKA PUTIH,CEMPAKA PUTIH BARAT,35885,15728,20157,8937,29094,2021-08-09
3171051001,JAKARTA PUSAT,CEMPAKA PUTIH,CEMPAKA PUTIH TIMUR,24292,10559,13733,7138,20871,2021-08-09
3173011001,JAKARTA BARAT,CENGKARENG,CENGKARENG BARAT,66284,28426,37858,16307,54165,2021-08-09
3173011006,JAKARTA BARAT,CENGKARENG,CENGKARENG TIMUR,81027,34591,46436,17435,63871,2021-08-09
3175091002,JAKARTA TIMUR,CIRACAS,CIBUBUR,66364,26861,39503,17784,57287,2021-08-09
3171011002,JAKARTA PUSAT,GAMBIR,CIDENG,15390,5946,9444,4873,14317,2021-08-09
3174091003,JAKARTA SELATAN,JAGAKARSA,CIGANJUR,38497,16235,22262,9715,31977,2021-08-09
3175051003,JAKARTA TIMUR,PASAR REBO,CIJANTUNG,41419,17005,24414,11473,35887,2021-08-09
3171061003,JAKARTA PUSAT,MENTENG,CIKINI,8274,4010,4264,2102,6366,2021-08-09
3174081006,JAKARTA SELATAN,PANCORAN,CIKOKO,10547,4107,6440,2825,9265,2021-08-09
3174061001,JAKARTA SELATAN,CILANDAK,CILANDAK BARAT,51752,21072,30680,15107,45787,2021-08-09
3174041003,JAKARTA SELATAN,PASAR MINGGU,CILANDAK TIMUR,25145,10058,15087,8044,23131,2021-08-09
3175101002,JAKARTA TIMUR,CIPAYUNG,CILANGKAP,27635,11422,16213,6703,22916,2021-08-09
3175041006,JAKARTA TIMUR,KRAMAT JATI,CILILITAN,40181,19472,20709,8873,29582,2021-08-09
3172041001,JAKARTA UTARA,CILINCING,CILINCING,43609,20096,23513,8889,32402,2021-08-09
3175101001,JAKARTA TIMUR,CIPAYUNG,CIPAYUNG,26104,10000,16104,7395,23499,2021-08-09
3174091006,JAKARTA SELATAN,JAGAKARSA,CIPEDAK,38303,14936,23367,10538,33905,2021-08-09
3174061005,JAKARTA SELATAN,CILANDAK,CIPETE SELATAN,26704,11395,15309,7476,22785,2021-08-09
3174071010,JAKARTA SELATAN,KEBAYORAN BARU,CIPETE UTARA,34102,14520,19582,8346,27928,2021-08-09
3175021003,JAKARTA TIMUR,PULO GADUNG,CIPINANG,39306,17174,22132,10090,32222,2021-08-09
3175031007,JAKARTA TIMUR,JATINEGARA,CIPINANG BESAR SELATAN,35212,17913,17299,6569,23868,2021-08-09
3175031008,JAKARTA TIMUR,JATINEGARA,CIPINANG BESAR UTARA,45319,22245,23074,7907,30981,2021-08-09
3175031005,JAKARTA TIMUR,JATINEGARA,CIPINANG CEMPEDAK,32824,15531,17293,7852,25145,2021-08-09
3175081005,JAKARTA TIMUR,MAKASAR,CIPINANG MELAYU,42308,18736,23572,10951,34523,2021-08-09
3175031006,JAKARTA TIMUR,JATINEGARA,CIPINANG MUARA,55243,26185,29058,11913,40971,2021-08-09
3174051003,JAKARTA SELATAN,KEBAYORAN LAMA,CIPULIR,39937,18290,21647,8740,30387,2021-08-09
3175091001,JAKARTA TIMUR,CIRACAS,CIRACAS,64594,26436,38158,15627,53785,2021-08-09
3175041003,JAKARTA TIMUR,KRAMAT JATI,DUKUH,24609,10490,14119,5847,19966,2021-08-09
3175071001,JAKARTA TIMUR,DUREN SAWIT,DUREN SAWIT,61160,28982,32178,15557,47735,2021-08-09
3174081004,JAKARTA SELATAN,PANCORAN,DUREN TIGA,28319,11903,16416,6641,23057,2021-08-09
3173051005,JAKARTA BARAT,KEBON JERUK,DURI KEPA,60138,24291,35847,16972,52819,2021-08-09
3173011002,JAKARTA BARAT,CENGKARENG,DURI KOSAMBI,77923,36643,41280,16299,57579,2021-08-09
3171011006,JAKARTA PUSAT,GAMBIR,DURI PULO,19610,8336,11274,4076,15350,2021-08-09
3173041011,JAKARTA BARAT,TAMBORA,DURI SELATAN,14259,5349,8910,3683,12593,2021-08-09
3173041003,JAKARTA BARAT,TAMBORA,DURI UTARA,19844,7873,11971,4571,16542,2021-08-09
3171081003,JAKARTA PUSAT,JOHAR BARU,GALUR,18243,6860,11383,3664,15047,2021-08-09
3171011001,JAKARTA PUSAT,GAMBIR,GAMBIR,2191,820,1371,735,2106,2021-08-09
3174061004,JAKARTA SELATAN,CILANDAK,GANDARIA SELATAN,22119,9395,12724,5586,18310,2021-08-09
3174071009,JAKARTA SELATAN,KEBAYORAN BARU,GANDARIA UTARA,39922,17413,22509,9853,32362,2021-08-09
3175051001,JAKARTA TIMUR,PASAR REBO,GEDONG,35755,14910,20845,9218,30063,2021-08-09
3171071001,JAKARTA PUSAT,TANAH ABANG,GELORA,3127,1379,1748,814,2562,2021-08-09
3173031007,JAKARTA BARAT,TAMAN SARI,GLODOK,7837,2750,5087,3021,8108,2021-08-09
3171061004,JAKARTA PUSAT,MENTENG,GONDANGDIA,4100,1673,2427,1649,4076,2021-08-09
3173021001,JAKARTA BARAT,GROGOL PETAMBURAN,GROGOL,16876,7059,9817,4586,14403,2021-08-09
3174051005,JAKARTA SELATAN,KEBAYORAN LAMA,GROGOL SELATAN,44251,19933,24318,9733,34051,2021-08-09
3174051004,JAKARTA SELATAN,KEBAYORAN LAMA,GROGOL UTARA,42494,18709,23785,9887,33672,2021-08-09
3174021007,JAKARTA SELATAN,SETIA BUDI,GUNTUR,3985,1592,2393,1445,3838,2021-08-09
3174071002,JAKARTA SELATAN,KEBAYORAN BARU,GUNUNG,9436,3758,5678,3241,8919,2021-08-09
3171031005,JAKARTA PUSAT,KEMAYORAN,GUNUNG SAHARI SELATAN,19199,8237,10962,5201,16163,2021-08-09
3171021004,JAKARTA PUSAT,SAWAH BESAR,GUNUNG SAHARI UTARA,16650,6113,10537,5419,15956,2021-08-09
3175081004,JAKARTA TIMUR,MAKASAR,HALIM PERDANA KUSUMAH,28363,9151,19212,13008,32220,2021-08-09
3171031003,JAKARTA PUSAT,KEMAYORAN,HARAPAN MULIA,22557,9853,12704,5205,17909,2021-08-09
3174091001,JAKARTA SELATAN,JAGAKARSA,JAGAKARSA,62389,24884,37505,17210,54715,2021-08-09
3175021007,JAKARTA TIMUR,PULO GADUNG,JATI,32757,14186,18571,9064,27635,2021-08-09
3174041002,JAKARTA SELATAN,PASAR MINGGU,JATI PADANG,37502,15998,21504,10507,32011,2021-08-09
3173071004,JAKARTA BARAT,PALMERAH,JATI PULO,28738,11660,17078,5953,23031,2021-08-09
3175061001,JAKARTA TIMUR,CAKUNG,JATINEGARA,84160,37716,46444,14727,61171,2021-08-09
3175021004,JAKARTA TIMUR,PULO GADUNG,JATINEGARA KAUM,24632,10117,14515,5137,19652,2021-08-09
3173021004,JAKARTA BARAT,GROGOL PETAMBURAN,JELAMBAR,30266,12427,17839,9096,26935,2021-08-09
3173021006,JAKARTA BARAT,GROGOL PETAMBURAN,JELAMBAR BARU,38246,15919,22327,10871,33198,2021-08-09
3173041006,JAKARTA BARAT,TAMBORA,JEMBATAN BESI,29314,14702,14612,4666,19278,2021-08-09
3173041008,JAKARTA BARAT,TAMBORA,JEMBATAN LIMA,21021,9989,11032,4393,15425,2021-08-09
3173081005,JAKARTA BARAT,KEMBANGAN,JOGLO,40839,17956,22883,9775,32658,2021-08-09
3171081001,JAKARTA PUSAT,JOHAR BARU,JOHAR BARU,37488,14818,22670,9471,32141,2021-08-09
3173041002,JAKARTA BARAT,TAMBORA,KALI ANYAR,23856,9298,14558,4109,18667,2021-08-09
3172041004,JAKARTA UTARA,CILINCING,KALIBARU,67684,33394,34290,11370,45660,2021-08-09
3174081002,JAKARTA SELATAN,PANCORAN,KALIBATA,41994,19820,22174,8805,30979,2021-08-09
3173061001,JAKARTA BARAT,KALI DERES,KALIDERES,72447,30465,41982,16152,58134,2021-08-09
3175051004,JAKARTA TIMUR,PASAR REBO,KALISARI,43212,18036,25176,11669,36845,2021-08-09
3173061004,JAKARTA BARAT,KALI DERES,KAMAL,53783,24634,29149,7528,36677,2021-08-09
3172011002,JAKARTA UTARA,PENJARINGAN,KAMAL MUARA,12930,4045,8885,4785,13670,2021-08-09
3171071007,JAKARTA PUSAT,TANAH ABANG,KAMPUNG BALI,11358,5587,5771,2458,8229,2021-08-09
3175031001,JAKARTA TIMUR,JATINEGARA,KAMPUNG MELAYU,25717,12439,13278,4876,18154,2021-08-09
3171081002,JAKARTA PUSAT,JOHAR BARU,KAMPUNG RAWA,21237,7063,14174,4729,18903,2021-08-09
3175041002,JAKARTA TIMUR,KRAMAT JATI,KAMPUNG TENGAH,43993,22040,21953,8815,30768,2021-08-09
3173011005,JAKARTA BARAT,CENGKARENG,KAPUK,134466,63245,71221,21581,92802,2021-08-09
3172011003,JAKARTA UTARA,PENJARINGAN,KAPUK MUARA,35781,13293,22488,11982,34470,2021-08-09
3171021002,JAKARTA PUSAT,SAWAH BESAR,KARANG ANYAR,25761,10483,15278,6187,21465,2021-08-09
3174021004,JAKARTA SELATAN,SETIA BUDI,KARET,9623,4386,5237,2675,7912,2021-08-09
3174021003,JAKARTA SELATAN,SETIA BUDI,KARET KUNINGAN,16055,6353,9702,4430,14132,2021-08-09
3174021002,JAKARTA SELATAN,SETIA BUDI,KARET SEMANGGI,2770,1034,1736,1048,2784,2021-08-09
3171071003,JAKARTA PUSAT,TANAH ABANG,KARET TENGSIN,19271,8303,10968,4131,15099,2021-08-09
3171021003,JAKARTA PUSAT,SAWAH BESAR,KARTINI,22292,9147,13145,6153,19298,2021-08-09
3175011003,JAKARTA TIMUR,MATRAMAN,KAYU MANIS,25284,11955,13329,5410,18739,2021-08-09
3175021006,JAKARTA TIMUR,PULO GADUNG,KAYU PUTIH,40696,16163,24533,12368,36901,2021-08-09
3173031006,JAKARTA BARAT,TAMAN SARI,KEAGUNGAN,17387,6916,10471,4298,14769,2021-08-09
3174041007,JAKARTA SELATAN,PASAR MINGGU,KEBAGUSAN,44552,19696,24856,10325,35181,2021-08-09
3174051006,JAKARTA SELATAN,KEBAYORAN LAMA,KEBAYORAN LAMA SELATAN,41212,17539,23673,10060,33733,2021-08-09
3174051001,JAKARTA SELATAN,KEBAYORAN LAMA,KEBAYORAN LAMA UTARA,42422,19047,23375,9273,32648,2021-08-09
3174011004,JAKARTA SELATAN,TEBET,KEBON BARU,35165,15053,20112,8908,29020,2021-08-09
3172021005,JAKARTA UTARA,TANJUNG PRIOK,KEBON BAWANG,50952,22377,28575,13017,41592,2021-08-09
3173051001,JAKARTA BARAT,KEBON JERUK,KEBON JERUK,53887,24823,29064,11786,40850,2021-08-09
3171071006,JAKARTA PUSAT,TANAH ABANG,KEBON KACANG,21531,10954,10577,4406,14983,2021-08-09
3171011005,JAKARTA PUSAT,GAMBIR,KEBON KELAPA,10163,4248,5915,2756,8671,2021-08-09
3171031002,JAKARTA PUSAT,KEMAYORAN,KEBON KOSONG,30019,13248,16771,7069,23840,2021-08-09
3175011005,JAKARTA TIMUR,MATRAMAN,KEBON MANGGIS,16490,6929,9561,4502,14063,2021-08-09
3171071005,JAKARTA PUSAT,TANAH ABANG,KEBON MELATI,32206,17531,14675,4817,19492,2021-08-09
3175081003,JAKARTA TIMUR,MAKASAR,KEBON PALA,46614,20624,25990,10452,36442,2021-08-09
3171061005,JAKARTA PUSAT,MENTENG,KEBON SIRIH,12299,5842,6457,2626,9083,2021-08-09
3173011004,JAKARTA BARAT,CENGKARENG,KEDAUNG KALI ANGKE,32612,12343,20269,6581,26850,2021-08-09
3173051007,JAKARTA BARAT,KEBON JERUK,KEDOYA SELATAN,32165,13171,18994,7457,26451,2021-08-09
3173051006,JAKARTA BARAT,KEBON JERUK,KEDOYA UTARA,45740,17395,28345,11806,40151,2021-08-09
3173051004,JAKARTA BARAT,KEBON JERUK,KELAPA DUA,23565,10441,13124,5178,18302,2021-08-09
3175091003,JAKARTA TIMUR,CIRACAS,KELAPA DUA WETAN,46875,18712,28163,12127,40290,2021-08-09
3172061003,JAKARTA UTARA,KELAPA GADING,KELAPA GADING BARAT,35717,12991,22726,13649,36375,2021-08-09
3172061001,JAKARTA UTARA,KELAPA GADING,KELAPA GADING TIMUR,33592,11313,22279,13634,35913,2021-08-09
3173071005,JAKARTA BARAT,PALMERAH,KEMANGGISAN,32139,14160,17979,7927,25906,2021-08-09
3171031001,JAKARTA PUSAT,KEMAYORAN,KEMAYORAN,20708,8519,12189,5347,17536,2021-08-09
3173081006,JAKARTA BARAT,KEMBANGAN,KEMBANGAN SELATAN,27130,11366,15764,7719,23483,2021-08-09
3173081001,JAKARTA BARAT,KEMBANGAN,KEMBANGAN UTARA,54451,22800,31651,11699,43350,2021-08-09
3171041002,JAKARTA PUSAT,SENEN,KENARI,9579,3795,5784,2647,8431,2021-08-09
3173041005,JAKARTA BARAT,TAMBORA,KERENDANG,19973,8581,11392,4340,15732,2021-08-09
3175071003,JAKARTA TIMUR,DUREN SAWIT,KLENDER,69978,34534,35444,13462,48906,2021-08-09
3172031001,JAKARTA UTARA,KOJA,KOJA,28175,12499,15676,7069,22745,2021-08-09
3173071006,JAKARTA BARAT,PALMERAH,KOTA BAMBU SELATAN,21158,9291,11867,4300,16167,2021-08-09
3173071003,JAKARTA BARAT,PALMERAH,KOTA BAMBU UTARA,24995,11449,13546,4837,18383,2021-08-09
3171041004,JAKARTA PUSAT,SENEN,KRAMAT,28835,13810,15025,5719,20744,2021-08-09
3175041001,JAKARTA TIMUR,KRAMAT JATI,KRAMAT JATI,34144,15226,18918,7675,26593,2021-08-09
3174071003,JAKARTA SELATAN,KEBAYORAN BARU,KRAMAT PELA,14413,5951,8462,3994,12456,2021-08-09
3173031002,JAKARTA BARAT,TAMAN SARI,KRUKUT,19244,8083,11161,4182,15343,2021-08-09
3174031005,JAKARTA SELATAN,MAMPANG PRAPATAN,KUNINGAN BARAT,12785,5255,7530,3594,11124,2021-08-09
3174021008,JAKARTA SELATAN,SETIA BUDI,KUNINGAN TIMUR,6008,2550,3458,1785,5243,2021-08-09
3171041005,JAKARTA PUSAT,SENEN,KWITANG,15486,6480,9006,3644,12650,2021-08-09
3172031003,JAKARTA UTARA,KOJA,LAGOA,59065,28275,30790,12136,42926,2021-08-09
3174061002,JAKARTA SELATAN,CILANDAK,LEBAK BULUS,37626,16520,21106,10257,31363,2021-08-09
3174091004,JAKARTA SELATAN,JAGAKARSA,LENTENG AGUNG,53946,23919,30027,11698,41725,2021-08-09
3175101007,JAKARTA TIMUR,CIPAYUNG,LUBANG BUAYA,63547,26707,36840,16903,53743,2021-08-09
3175081001,JAKARTA TIMUR,MAKASAR,MAKASAR,34390,14263,20127,8798,28925,2021-08-09
3175071006,JAKARTA TIMUR,DUREN SAWIT,MALAKA JAYA,30927,13159,17768,9076,26844,2021-08-09
3175071005,JAKARTA TIMUR,DUREN SAWIT,MALAKA SARI,27530,11610,15920,8200,24120,2021-08-09
3174031001,JAKARTA SELATAN,MAMPANG PRAPATAN,MAMPANG PRAPATAN,18159,7688,10471,4818,15289,2021-08-09
3173031005,JAKARTA BARAT,TAMAN SARI,MANGGA BESAR,7707,2834,4873,2477,7350,2021-08-09
3171021005,JAKARTA PUSAT,SAWAH BESAR,MANGGA DUA SELATAN,27442,11614,15828,7211,23039,2021-08-09
3174011007,JAKARTA SELATAN,TEBET,MANGGARAI,28373,11570,16803,6262,23065,2021-08-09
3174011006,JAKARTA SELATAN,TEBET,MANGGARAI SELATAN,23075,9317,13758,6365,20123,2021-08-09
3173031003,JAKARTA BARAT,TAMAN SARI,MAPHAR,16461,6906,9555,4501,14056,2021-08-09
3172041003,JAKARTA UTARA,CILINCING,MARUNDA,28943,12126,16817,5666,22483,2021-08-09
3174071001,JAKARTA SELATAN,KEBAYORAN BARU,MELAWAI,2627,977,1650,1163,2813,2021-08-09
3171061001,JAKARTA PUSAT,MENTENG,MENTENG,25624,12034,13590,5780,19370,2021-08-09
3174021005,JAKARTA SELATAN,SETIA BUDI,MENTENG ATAS,27816,11378,16438,7077,23515,2021-08-09
3174011003,JAKARTA SELATAN,TEBET,MENTENG DALAM,36028,15324,20704,9235,29939,2021-08-09
3173081003,JAKARTA BARAT,KEMBANGAN,MERUYA SELATAN,32130,13718,18412,7565,25977,2021-08-09
3173081002,JAKARTA BARAT,KEMBANGAN,MERUYA UTARA,43752,18592,25160,11339,36499,2021-08-09
3175101004,JAKARTA TIMUR,CIPAYUNG,MUNJUL,23871,9602,14269,5875,20144,2021-08-09
3172051002,JAKARTA UTARA,PADEMANGAN,PADEMANGAN BARAT,74240,32984,41256,15556,56812,2021-08-09
3172051001,JAKARTA UTARA,PADEMANGAN,PADEMANGAN TIMUR,37736,14085,23651,11352,35003,2021-08-09
3175011004,JAKARTA TIMUR,MATRAMAN,PAL MERIAM,19769,8943,10826,4786,15612,2021-08-09
3173071001,JAKARTA BARAT,PALMERAH,PALMERAH,63011,28083,34928,13540,48468,2021-08-09
3174081001,JAKARTA SELATAN,PANCORAN,PANCORAN,19421,8265,11156,5000,16156,2021-08-09
3172021003,JAKARTA UTARA,TANJUNG PRIOK,PAPANGGO,39097,15724,23373,10021,33394,2021-08-09
3171021001,JAKARTA PUSAT,SAWAH BESAR,PASAR BARU,12035,4389,7646,4034,11680,2021-08-09
3174021006,JAKARTA SELATAN,SETIA BUDI,PASAR MANGGIS,26752,11848,14904,6991,21895,2021-08-09
3174041001,JAKARTA SELATAN,PASAR MINGGU,PASAR MINGGU,24821,10332,14489,7383,21872,2021-08-09
3171041003,JAKARTA PUSAT,SENEN,PASEBAN,23533,10294,13239,5474,18713,2021-08-09
3173061005,JAKARTA BARAT,KALI DERES,PEGADUNGAN,75587,29888,45699,18973,64672,2021-08-09
3171061002,JAKARTA PUSAT,MENTENG,PEGANGSAAN,23455,11021,12434,4960,17394,2021-08-09
3172061002,JAKARTA UTARA,KELAPA GADING,PEGANGSAAN DUA,49976,16649,33327,17694,51021,2021-08-09
3172011004,JAKARTA UTARA,PENJARINGAN,PEJAGALAN,74578,31036,43542,21187,64729,2021-08-09
3174041006,JAKARTA SELATAN,PASAR MINGGU,PEJATEN BARAT,37346,16619,20727,10020,30747,2021-08-09
3174041005,JAKARTA SELATAN,PASAR MINGGU,PEJATEN TIMUR,57656,27200,30456,12959,43415,2021-08-09
3175051005,JAKARTA TIMUR,PASAR REBO,PEKAYON,43250,17565,25685,10701,36386,2021-08-09
3173041009,JAKARTA BARAT,TAMBORA,PEKOJAN,23587,9527,14060,6299,20359,2021-08-09
3174031003,JAKARTA SELATAN,MAMPANG PRAPATAN,PELA MAMPANG,43522,18261,25261,11515,36776,2021-08-09
3174081005,JAKARTA SELATAN,PANCORAN,PENGADEGAN,21478,8334,13144,5667,18811,2021-08-09
3175061003,JAKARTA TIMUR,CAKUNG,PENGGILINGAN,99255,47937,51318,16754,68072,2021-08-09
3172011001,JAKARTA UTARA,PENJARINGAN,PENJARINGAN,88308,41821,46487,18229,64716,2021-08-09
3174101001,JAKARTA SELATAN,PESANGGRAHAN,PESANGGRAHAN,27545,10698,16847,8066,24913,2021-08-09
3171071004,JAKARTA PUSAT,TANAH ABANG,PETAMBURAN,33271,17677,15594,5178,20772,2021-08-09
3174071008,JAKARTA SELATAN,KEBAYORAN BARU,PETOGOGAN,11499,4870,6629,3455,10084,2021-08-09
3171011004,JAKARTA PUSAT,GAMBIR,PETOJO SELATAN,14692,6288,8404,4218,12622,2021-08-09
3171011003,JAKARTA PUSAT,GAMBIR,PETOJO UTARA,17458,7565,9893,4235,14128,2021-08-09
3174101004,JAKARTA SELATAN,PESANGGRAHAN,PETUKANGAN SELATAN,37187,15522,21665,8769,30434,2021-08-09
3174101003,JAKARTA SELATAN,PESANGGRAHAN,PETUKANGAN UTARA,53716,24112,29604,12869,42473,2021-08-09
3175081002,JAKARTA TIMUR,MAKASAR,PINANG RANTI,27198,11956,15242,6515,21757,2021-08-09
3173031008,JAKARTA BARAT,TAMAN SARI,PINANGSIA,10729,4093,6636,3123,9759,2021-08-09
3175011001,JAKARTA TIMUR,MATRAMAN,PISANGAN BARU,31776,14872,16904,6525,23429,2021-08-09
3175021002,JAKARTA TIMUR,PULO GADUNG,PISANGAN TIMUR,41011,16667,24344,9733,34077,2021-08-09
3172011005,JAKARTA UTARA,PENJARINGAN,PLUIT,47783,19040,28743,18154,46897,2021-08-09
3175071002,JAKARTA TIMUR,DUREN SAWIT,PONDOK BAMBU,61550,29113,32437,14578,47015,2021-08-09
3175071004,JAKARTA TIMUR,DUREN SAWIT,PONDOK KELAPA,72015,30400,41615,18398,60013,2021-08-09
3175071007,JAKARTA TIMUR,DUREN SAWIT,PONDOK KOPI,35367,17347,18020,7310,25330,2021-08-09
3174061003,JAKARTA SELATAN,CILANDAK,PONDOK LABU,46464,18491,27973,13388,41361,2021-08-09
3174051002,JAKARTA SELATAN,KEBAYORAN LAMA,PONDOK PINANG,56169,23958,32211,15595,47806,2021-08-09
3175101003,JAKARTA TIMUR,CIPAYUNG,PONDOK RANGGON,25574,11054,14520,6244,20764,2021-08-09
3101011003,KAB.ADM.KEP.SERIBU,KEP. SERIBU UTARA,PULAU HARAPAN,2060,395,1665,825,2490,2021-08-09
3101011002,KAB.ADM.KEP.SERIBU,KEP. SERIBU UTARA,PULAU KELAPA,5528,1114,4414,1754,6168,2021-08-09
3101011001,KAB.ADM.KEP.SERIBU,KEP. SERIBU UTARA,PULAU PANGGANG,5450,995,4455,1782,6237,2021-08-09
3101021003,KAB.ADM.KEP.SERIBU,KEP. SERIBU SELATAN,PULAU PARI,2765,370,2395,1150,3545,2021-08-09
3101021002,KAB.ADM.KEP.SERIBU,KEP. SERIBU SELATAN,PULAU TIDUNG,4553,769,3784,2223,6007,2021-08-09
3101021001,KAB.ADM.KEP.SERIBU,KEP. SERIBU SELATAN,PULAU UNTUNG JAWA,1941,400,1541,776,2317,2021-08-09
3174071007,JAKARTA SELATAN,KEBAYORAN BARU,PULO,5835,2213,3622,2216,5838,2021-08-09
3175021001,JAKARTA TIMUR,PULO GADUNG,PULO GADUNG,34422,15092,19330,8338,27668,2021-08-09
3175061005,JAKARTA TIMUR,CAKUNG,PULO GEBANG,97301,44225,53076,18659,71735,2021-08-09
3174041004,JAKARTA SELATAN,PASAR MINGGU,RAGUNAN,39616,16018,23598,11081,34679,2021-08-09
3175091005,JAKARTA TIMUR,CIRACAS,RAMBUTAN,36771,17945,18826,7613,26439,2021-08-09
3172031006,JAKARTA UTARA,KOJA,RAWA BADAK SELATAN,42179,20265,21914,7877,29791,2021-08-09
3172031004,JAKARTA UTARA,KOJA,RAWA BADAK UTARA,34408,16165,18243,8213,26456,2021-08-09
3174071005,JAKARTA SELATAN,KEBAYORAN BARU,RAWA BARAT,5625,2165,3460,1973,5433,2021-08-09
3173011003,JAKARTA BARAT,CENGKARENG,RAWA BUAYA,63799,28940,34859,11813,46672,2021-08-09
3175031004,JAKARTA TIMUR,JATINEGARA,RAWA BUNGA,21434,10096,11338,4281,15619,2021-08-09
3174081003,JAKARTA SELATAN,PANCORAN,RAWA JATI,20509,8403,12106,5632,17738,2021-08-09
3175061002,JAKARTA TIMUR,CAKUNG,RAWA TERATE,24637,9563,15074,4019,19093,2021-08-09
3175021005,JAKARTA TIMUR,PULO GADUNG,RAWAMANGUN,37612,16255,21357,9559,30916,2021-08-09
3171051003,JAKARTA PUSAT,CEMPAKA PUTIH,RAWASARI,21967,9555,12412,6024,18436,2021-08-09
3173041010,JAKARTA BARAT,TAMBORA,ROA MALAKA,3484,1252,2232,1292,3524,2021-08-09
3172041006,JAKARTA UTARA,CILINCING,ROROTAN,41668,17089,24579,8804,33383,2021-08-09
3174071004,JAKARTA SELATAN,KEBAYORAN BARU,SELONG,2842,1072,1770,1199,2969,2021-08-09
3173061002,JAKARTA BARAT,KALI DERES,SEMANAN,71354,31736,39618,10548,50166,2021-08-09
3172041007,JAKARTA UTARA,CILINCING,SEMPER BARAT,68587,26797,41790,17779,59569,2021-08-09
3172041005,JAKARTA UTARA,CILINCING,SEMPER TIMUR,36267,15339,20928,9169,30097,2021-08-09
3174071006,JAKARTA SELATAN,KEBAYORAN BARU,SENAYAN,2771,1309,1462,848,2310,2021-08-09
3171041001,JAKARTA PUSAT,SENEN,SENEN,6804,2841,3963,1789,5752,2021-08-09
3171031004,JAKARTA PUSAT,KEMAYORAN,SERDANG,29668,12664,17004,6978,23982,2021-08-09
3174021001,JAKARTA SELATAN,SETIA BUDI,SETIA BUDI,3023,1327,1696,957,2653,2021-08-09
3175101005,JAKARTA TIMUR,CIPAYUNG,SETU,20572,9430,11142,4274,15416,2021-08-09
3173071002,JAKARTA BARAT,PALMERAH,SLIPI,16591,6904,9687,4439,14126,2021-08-09
3173081004,JAKARTA BARAT,KEMBANGAN,SRENGSENG,45523,20860,24663,10429,35092,2021-08-09
3174091002,JAKARTA SELATAN,JAGAKARSA,SRENGSENG SAWAH,58196,21355,36841,16699,53540,2021-08-09
3173051003,JAKARTA BARAT,KEBON JERUK,SUKABUMI SELATAN,37033,17586,19447,7070,26517,2021-08-09
3173051002,JAKARTA BARAT,KEBON JERUK,SUKABUMI UTARA,38290,19436,18854,7248,26102,2021-08-09
3172041002,JAKARTA UTARA,CILINCING,SUKAPURA,53949,23435,30514,12232,42746,2021-08-09
3171031007,JAKARTA PUSAT,KEMAYORAN,SUMUR BATU,22717,9896,12821,6130,18951,2021-08-09
3172021004,JAKARTA UTARA,TANJUNG PRIOK,SUNGAI BAMBU,29876,12345,17531,7843,25374,2021-08-09
3172021006,JAKARTA UTARA,TANJUNG PRIOK,SUNTER AGUNG,71805,26322,45483,23556,69039,2021-08-09
3172021002,JAKARTA UTARA,TANJUNG PRIOK,SUNTER JAYA,63031,24317,38714,18523,57237,2021-08-09
3175091004,JAKARTA TIMUR,CIRACAS,SUSUKAN,38257,15262,22995,9734,32729,2021-08-09
3173031001,JAKARTA BARAT,TAMAN SARI,TAMAN SARI,14348,5828,8520,4172,12692,2021-08-09
3173041001,JAKARTA BARAT,TAMBORA,TAMBORA,10204,4538,5666,2445,8111,2021-08-09
3173041004,JAKARTA BARAT,TAMBORA,TANAH SEREAL,26387,9455,16932,6625,23557,2021-08-09
3171081004,JAKARTA PUSAT,JOHAR BARU,TANAH TINGGI,37693,13882,23811,8980,32791,2021-08-09
3173031004,JAKARTA BARAT,TAMAN SARI,TANGKI,13324,5420,7904,3515,11419,2021-08-09
3174091005,JAKARTA SELATAN,JAGAKARSA,TANJUNG BARAT,39770,16438,23332,10246,33578,2021-08-09
3173021005,JAKARTA BARAT,GROGOL PETAMBURAN,TANJUNG DUREN SELATAN,25337,10162,15175,7322,22497,2021-08-09
3173021002,JAKARTA BARAT,GROGOL PETAMBURAN,TANJUNG DUREN UTARA,17010,6431,10579,5416,15995,2021-08-09
3172021001,JAKARTA UTARA,TANJUNG PRIOK,TANJUNG PRIOK,34588,13484,21104,7860,28964,2021-08-09
3174011002,JAKARTA SELATAN,TEBET,TEBET BARAT,21194,8126,13068,6939,20007,2021-08-09
3174011001,JAKARTA SELATAN,TEBET,TEBET TIMUR,18199,6903,11296,6056,17352,2021-08-09
3173061003,JAKARTA BARAT,KALI DERES,TEGAL ALUR,83647,35283,48364,14761,63125,2021-08-09
3174031004,JAKARTA SELATAN,MAMPANG PRAPATAN,TEGAL PARANG,32401,14774,17627,6966,24593,2021-08-09
3173021003,JAKARTA BARAT,GROGOL PETAMBURAN,TOMANG,29605,12187,17418,8433,25851,2021-08-09
3172031005,JAKARTA UTARA,KOJA,TUGU SELATAN,39122,18049,21073,8567,29640,2021-08-09
3172031002,JAKARTA UTARA,KOJA,TUGU UTARA,67670,32198,35472,14287,49759,2021-08-09
3175061006,JAKARTA TIMUR,CAKUNG,UJUNG MENTENG,29934,11790,18144,6811,24955,2021-08-09
3174101005,JAKARTA SELATAN,PESANGGRAHAN,ULUJAMI,40544,18312,22232,8561,30793,2021-08-09
3175011006,JAKARTA TIMUR,MATRAMAN,UTAN KAYU SELATAN,33511,14343,19168,8556,27724,2021-08-09
3175011002,JAKARTA TIMUR,MATRAMAN,UTAN KAYU UTARA,28169,12684,15485,6764,22249,2021-08-09
3171031008,JAKARTA PUSAT,KEMAYORAN,UTAN PANJANG,29208,12999,16209,5619,21828,2021-08-09
3172021007,JAKARTA UTARA,TANJUNG PRIOK,WARAKAS,44401,18504,25897,11162,37059,2021-08-09
3173021007,JAKARTA BARAT,GROGOL PETAMBURAN,WIJAYA KUSUMA,38934,17078,21856,9008,30864,2021-08-09
3172051003,JAKARTA UTARA,PADEMANGAN,ANCOL,23947,10555,13392,5597,18989,2021-08-10
3173041007,JAKARTA BARAT,TAMBORA,ANGKE,29381,11887,17494,6740,24234,2021-08-10
3175041005,JAKARTA TIMUR,KRAMAT JATI,BALE KAMBANG,29074,15053,14021,4986,19007,2021-08-10
3175031003,JAKARTA TIMUR,JATINEGARA,BALI MESTER,9752,4219,5533,2580,8113,2021-08-10
3175101006,JAKARTA TIMUR,CIPAYUNG,BAMBU APUS,26285,11084,15201,6578,21779,2021-08-10
3174031002,JAKARTA SELATAN,MAMPANG PRAPATAN,BANGKA,21566,9394,12172,5378,17550,2021-08-10
3175051002,JAKARTA TIMUR,PASAR REBO,BARU,23886,8992,14894,7898,22792,2021-08-10
3175041004,JAKARTA TIMUR,KRAMAT JATI,BATU AMPAR,47898,23643,24255,9689,33944,2021-08-10
3171071002,JAKARTA PUSAT,TANAH ABANG,BENDUNGAN HILIR,21494,9006,12488,5966,18454,2021-08-10
3175031002,JAKARTA TIMUR,JATINEGARA,BIDARA CINA,36689,18168,18521,7425,25946,2021-08-10
3174101002,JAKARTA SELATAN,PESANGGRAHAN,BINTARO,53098,22190,30908,14278,45186,2021-08-10
3174011005,JAKARTA SELATAN,TEBET,BUKIT DURI,34183,15275,18908,8154,27062,2021-08-10
3171041006,JAKARTA PUSAT,SENEN,BUNGUR,18144,7482,10662,4895,15557,2021-08-10
3175061007,JAKARTA TIMUR,CAKUNG,CAKUNG BARAT,57724,22335,35389,11629,47018,2021-08-10
3175061004,JAKARTA TIMUR,CAKUNG,CAKUNG TIMUR,58287,23164,35123,13745,48868,2021-08-10
3175041007,JAKARTA TIMUR,KRAMAT JATI,CAWANG,32762,15193,17569,7755,25324,2021-08-10
3175101008,JAKARTA TIMUR,CIPAYUNG,CEGER,18932,7743,11189,4541,15730,2021-08-10
3171031006,JAKARTA PUSAT,KEMAYORAN,CEMPAKA BARU,32581,15013,17568,7533,25101,2021-08-10
3171051002,JAKARTA PUSAT,CEMPAKA PUTIH,CEMPAKA PUTIH BARAT,35885,15454,20431,9373,29804,2021-08-10
3171051001,JAKARTA PUSAT,CEMPAKA PUTIH,CEMPAKA PUTIH TIMUR,24292,10470,13822,7331,21153,2021-08-10
3173011001,JAKARTA BARAT,CENGKARENG,CENGKARENG BARAT,66284,27909,38375,17118,55493,2021-08-10
3173011006,JAKARTA BARAT,CENGKARENG,CENGKARENG TIMUR,81027,34242,46785,18130,64915,2021-08-10
3175091002,JAKARTA TIMUR,CIRACAS,CIBUBUR,66364,26486,39878,18543,58421,2021-08-10
3171011002,JAKARTA PUSAT,GAMBIR,CIDENG,15390,5862,9528,4956,14484,2021-08-10
3174091003,JAKARTA SELATAN,JAGAKARSA,CIGANJUR,38497,16068,22429,10125,32554,2021-08-10
3175051003,JAKARTA TIMUR,PASAR REBO,CIJANTUNG,41419,16709,24710,11842,36552,2021-08-10
3171061003,JAKARTA PUSAT,MENTENG,CIKINI,8274,3835,4439,2184,6623,2021-08-10
3174081006,JAKARTA SELATAN,PANCORAN,CIKOKO,10547,3982,6565,2970,9535,2021-08-10
3174061001,JAKARTA SELATAN,CILANDAK,CILANDAK BARAT,51752,20926,30826,15623,46449,2021-08-10
3174041003,JAKARTA SELATAN,PASAR MINGGU,CILANDAK TIMUR,25145,9991,15154,8220,23374,2021-08-10
3175101002,JAKARTA TIMUR,CIPAYUNG,CILANGKAP,27635,11219,16416,6993,23409,2021-08-10
3175041006,JAKARTA TIMUR,KRAMAT JATI,CILILITAN,40181,19143,21038,9174,30212,2021-08-10
3172041001,JAKARTA UTARA,CILINCING,CILINCING,43609,19803,23806,9554,33360,2021-08-10
3175101001,JAKARTA TIMUR,CIPAYUNG,CIPAYUNG,26104,9821,16283,7793,24076,2021-08-10
3174091006,JAKARTA SELATAN,JAGAKARSA,CIPEDAK,38303,14788,23515,10983,34498,2021-08-10
3174061005,JAKARTA SELATAN,CILANDAK,CIPETE SELATAN,26704,11245,15459,7864,23323,2021-08-10
3174071010,JAKARTA SELATAN,KEBAYORAN BARU,CIPETE UTARA,34102,14380,19722,8777,28499,2021-08-10
3175021003,JAKARTA TIMUR,PULO GADUNG,CIPINANG,39306,16964,22342,10429,32771,2021-08-10
3175031007,JAKARTA TIMUR,JATINEGARA,CIPINANG BESAR SELATAN,35212,17579,17633,6820,24453,2021-08-10
3175031008,JAKARTA TIMUR,JATINEGARA,CIPINANG BESAR UTARA,45319,21668,23651,8348,31999,2021-08-10
3175031005,JAKARTA TIMUR,JATINEGARA,CIPINANG CEMPEDAK,32824,15330,17494,8070,25564,2021-08-10
3175081005,JAKARTA TIMUR,MAKASAR,CIPINANG MELAYU,42308,18484,23824,11265,35089,2021-08-10
3175031006,JAKARTA TIMUR,JATINEGARA,CIPINANG MUARA,55243,25677,29566,12362,41928,2021-08-10
3174051003,JAKARTA SELATAN,KEBAYORAN LAMA,CIPULIR,39937,18027,21910,9036,30946,2021-08-10
3175091001,JAKARTA TIMUR,CIRACAS,CIRACAS,64594,25693,38901,16310,55211,2021-08-10
3175041003,JAKARTA TIMUR,KRAMAT JATI,DUKUH,24609,10322,14287,5969,20256,2021-08-10
3175071001,JAKARTA TIMUR,DUREN SAWIT,DUREN SAWIT,61160,28558,32602,15993,48595,2021-08-10
3174081004,JAKARTA SELATAN,PANCORAN,DUREN TIGA,28319,11784,16535,6822,23357,2021-08-10
3173051005,JAKARTA BARAT,KEBON JERUK,DURI KEPA,60138,24003,36135,17408,53543,2021-08-10
3173011002,JAKARTA BARAT,CENGKARENG,DURI KOSAMBI,77923,36200,41723,16856,58579,2021-08-10
3171011006,JAKARTA PUSAT,GAMBIR,DURI PULO,19610,8191,11419,4205,15624,2021-08-10
3173041011,JAKARTA BARAT,TAMBORA,DURI SELATAN,14259,5298,8961,3797,12758,2021-08-10
3173041003,JAKARTA BARAT,TAMBORA,DURI UTARA,19844,7768,12076,4838,16914,2021-08-10
3171081003,JAKARTA PUSAT,JOHAR BARU,GALUR,18243,6713,11530,3917,15447,2021-08-10
3171011001,JAKARTA PUSAT,GAMBIR,GAMBIR,2191,821,1370,750,2120,2021-08-10
3174061004,JAKARTA SELATAN,CILANDAK,GANDARIA SELATAN,22119,9324,12795,5925,18720,2021-08-10
3174071009,JAKARTA SELATAN,KEBAYORAN BARU,GANDARIA UTARA,39922,17202,22720,10251,32971,2021-08-10
3175051001,JAKARTA TIMUR,PASAR REBO,GEDONG,35755,14638,21117,9537,30654,2021-08-10
3171071001,JAKARTA PUSAT,TANAH ABANG,GELORA,3127,1379,1748,827,2575,2021-08-10
3173031007,JAKARTA BARAT,TAMAN SARI,GLODOK,7837,2736,5101,3065,8166,2021-08-10
3171061004,JAKARTA PUSAT,MENTENG,GONDANGDIA,4100,1679,2421,1675,4096,2021-08-10
3173021001,JAKARTA BARAT,GROGOL PETAMBURAN,GROGOL,16876,6968,9908,4722,14630,2021-08-10
3174051005,JAKARTA SELATAN,KEBAYORAN LAMA,GROGOL SELATAN,44251,19668,24583,10051,34634,2021-08-10
3174051004,JAKARTA SELATAN,KEBAYORAN LAMA,GROGOL UTARA,42494,18392,24102,10276,34378,2021-08-10
3174021007,JAKARTA SELATAN,SETIA BUDI,GUNTUR,3985,1578,2407,1486,3893,2021-08-10
3174071002,JAKARTA SELATAN,KEBAYORAN BARU,GUNUNG,9436,3711,5725,3329,9054,2021-08-10
3171031005,JAKARTA PUSAT,KEMAYORAN,GUNUNG SAHARI SELATAN,19199,8163,11036,5379,16415,2021-08-10
3171021004,JAKARTA PUSAT,SAWAH BESAR,GUNUNG SAHARI UTARA,16650,6038,10612,5576,16188,2021-08-10
3175081004,JAKARTA TIMUR,MAKASAR,HALIM PERDANA KUSUMAH,28363,9089,19274,13161,32435,2021-08-10
3171031003,JAKARTA PUSAT,KEMAYORAN,HARAPAN MULIA,22557,9704,12853,5441,18294,2021-08-10
3174091001,JAKARTA SELATAN,JAGAKARSA,JAGAKARSA,62389,24627,37762,17682,55444,2021-08-10
3175021007,JAKARTA TIMUR,PULO GADUNG,JATI,32757,13945,18812,9344,28156,2021-08-10
3174041002,JAKARTA SELATAN,PASAR MINGGU,JATI PADANG,37502,15822,21680,10918,32598,2021-08-10
3173071004,JAKARTA BARAT,PALMERAH,JATI PULO,28738,11535,17203,6180,23383,2021-08-10
3175061001,JAKARTA TIMUR,CAKUNG,JATINEGARA,84160,37057,47103,15539,62642,2021-08-10
3175021004,JAKARTA TIMUR,PULO GADUNG,JATINEGARA KAUM,24632,9896,14736,5351,20087,2021-08-10
3173021004,JAKARTA BARAT,GROGOL PETAMBURAN,JELAMBAR,30266,12309,17957,9376,27333,2021-08-10
3173021006,JAKARTA BARAT,GROGOL PETAMBURAN,JELAMBAR BARU,38246,15759,22487,11167,33654,2021-08-10
3173041006,JAKARTA BARAT,TAMBORA,JEMBATAN BESI,29314,14498,14816,4914,19730,2021-08-10
3173041008,JAKARTA BARAT,TAMBORA,JEMBATAN LIMA,21021,9805,11216,4665,15881,2021-08-10
3173081005,JAKARTA BARAT,KEMBANGAN,JOGLO,40839,17731,23108,10110,33218,2021-08-10
3171081001,JAKARTA PUSAT,JOHAR BARU,JOHAR BARU,37488,14480,23008,9913,32921,2021-08-10
3173041002,JAKARTA BARAT,TAMBORA,KALI ANYAR,23856,9216,14640,4339,18979,2021-08-10
3172041004,JAKARTA UTARA,CILINCING,KALIBARU,67684,32913,34771,12580,47351,2021-08-10
3174081002,JAKARTA SELATAN,PANCORAN,KALIBATA,41994,19555,22439,9103,31542,2021-08-10
3173061001,JAKARTA BARAT,KALI DERES,KALIDERES,72447,30045,42402,16789,59191,2021-08-10
3175051004,JAKARTA TIMUR,PASAR REBO,KALISARI,43212,17671,25541,12059,37600,2021-08-10
3173061004,JAKARTA BARAT,KALI DERES,KAMAL,53783,24174,29609,7925,37534,2021-08-10
3172011002,JAKARTA UTARA,PENJARINGAN,KAMAL MUARA,12930,4045,8885,4958,13843,2021-08-10
3171071007,JAKARTA PUSAT,TANAH ABANG,KAMPUNG BALI,11358,5544,5814,2553,8367,2021-08-10
3175031001,JAKARTA TIMUR,JATINEGARA,KAMPUNG MELAYU,25717,12159,13558,5095,18653,2021-08-10
3171081002,JAKARTA PUSAT,JOHAR BARU,KAMPUNG RAWA,21237,6991,14246,5036,19282,2021-08-10
3175041002,JAKARTA TIMUR,KRAMAT JATI,KAMPUNG TENGAH,43993,21516,22477,9119,31596,2021-08-10
3173011005,JAKARTA BARAT,CENGKARENG,KAPUK,134466,61913,72553,22450,95003,2021-08-10
3172011003,JAKARTA UTARA,PENJARINGAN,KAPUK MUARA,35781,13155,22626,12384,35010,2021-08-10
3171021002,JAKARTA PUSAT,SAWAH BESAR,KARANG ANYAR,25761,10332,15429,6435,21864,2021-08-10
3174021004,JAKARTA SELATAN,SETIA BUDI,KARET,9623,4172,5451,2783,8234,2021-08-10
3174021003,JAKARTA SELATAN,SETIA BUDI,KARET KUNINGAN,16055,6258,9797,4759,14556,2021-08-10
3174021002,JAKARTA SELATAN,SETIA BUDI,KARET SEMANGGI,2770,1027,1743,1077,2820,2021-08-10
3171071003,JAKARTA PUSAT,TANAH ABANG,KARET TENGSIN,19271,8200,11071,4348,15419,2021-08-10
3171021003,JAKARTA PUSAT,SAWAH BESAR,KARTINI,22292,8991,13301,6380,19681,2021-08-10
3175011003,JAKARTA TIMUR,MATRAMAN,KAYU MANIS,25284,11725,13559,5618,19177,2021-08-10
3175021006,JAKARTA TIMUR,PULO GADUNG,KAYU PUTIH,40696,16044,24652,12839,37491,2021-08-10
3173031006,JAKARTA BARAT,TAMAN SARI,KEAGUNGAN,17387,6854,10533,4445,14978,2021-08-10
3174041007,JAKARTA SELATAN,PASAR MINGGU,KEBAGUSAN,44552,19443,25109,10850,35959,2021-08-10
3174051006,JAKARTA SELATAN,KEBAYORAN LAMA,KEBAYORAN LAMA SELATAN,41212,17226,23986,10297,34283,2021-08-10
3174051001,JAKARTA SELATAN,KEBAYORAN LAMA,KEBAYORAN LAMA UTARA,42422,18819,23603,9514,33117,2021-08-10
3174011004,JAKARTA SELATAN,TEBET,KEBON BARU,35165,14807,20358,9284,29642,2021-08-10
3172021005,JAKARTA UTARA,TANJUNG PRIOK,KEBON BAWANG,50952,22221,28731,13510,42241,2021-08-10
3173051001,JAKARTA BARAT,KEBON JERUK,KEBON JERUK,53887,24517,29370,12282,41652,2021-08-10
3171071006,JAKARTA PUSAT,TANAH ABANG,KEBON KACANG,21531,10829,10702,4632,15334,2021-08-10
3171011005,JAKARTA PUSAT,GAMBIR,KEBON KELAPA,10163,4203,5960,2829,8789,2021-08-10
3171031002,JAKARTA PUSAT,KEMAYORAN,KEBON KOSONG,30019,13099,16920,7489,24409,2021-08-10
3175011005,JAKARTA TIMUR,MATRAMAN,KEBON MANGGIS,16490,6843,9647,4675,14322,2021-08-10
3171071005,JAKARTA PUSAT,TANAH ABANG,KEBON MELATI,32206,17302,14904,5009,19913,2021-08-10
3175081003,JAKARTA TIMUR,MAKASAR,KEBON PALA,46614,20258,26356,10767,37123,2021-08-10
3171061005,JAKARTA PUSAT,MENTENG,KEBON SIRIH,12299,5758,6541,2745,9286,2021-08-10
3173011004,JAKARTA BARAT,CENGKARENG,KEDAUNG KALI ANGKE,32612,12274,20338,6800,27138,2021-08-10
3173051007,JAKARTA BARAT,KEBON JERUK,KEDOYA SELATAN,32165,12996,19169,7623,26792,2021-08-10
3173051006,JAKARTA BARAT,KEBON JERUK,KEDOYA UTARA,45740,17307,28433,12159,40592,2021-08-10
3173051004,JAKARTA BARAT,KEBON JERUK,KELAPA DUA,23565,10338,13227,5377,18604,2021-08-10
3175091003,JAKARTA TIMUR,CIRACAS,KELAPA DUA WETAN,46875,18460,28415,12548,40963,2021-08-10
3172061003,JAKARTA UTARA,KELAPA GADING,KELAPA GADING BARAT,35717,12969,22748,13955,36703,2021-08-10
3172061001,JAKARTA UTARA,KELAPA GADING,KELAPA GADING TIMUR,33592,11284,22308,13923,36231,2021-08-10
3173071005,JAKARTA BARAT,PALMERAH,KEMANGGISAN,32139,13970,18169,8233,26402,2021-08-10
3171031001,JAKARTA PUSAT,KEMAYORAN,KEMAYORAN,20708,8406,12302,5547,17849,2021-08-10
3173081006,JAKARTA BARAT,KEMBANGAN,KEMBANGAN SELATAN,27130,11277,15853,7857,23710,2021-08-10
3173081001,JAKARTA BARAT,KEMBANGAN,KEMBANGAN UTARA,54451,22559,31892,12307,44199,2021-08-10
3171041002,JAKARTA PUSAT,SENEN,KENARI,9579,3779,5800,2703,8503,2021-08-10
3173041005,JAKARTA BARAT,TAMBORA,KERENDANG,19973,8440,11533,4624,16157,2021-08-10
3175071003,JAKARTA TIMUR,DUREN SAWIT,KLENDER,69978,33742,36236,13901,50137,2021-08-10
3172031001,JAKARTA UTARA,KOJA,KOJA,28175,12369,15806,7419,23225,2021-08-10
3173071006,JAKARTA BARAT,PALMERAH,KOTA BAMBU SELATAN,21158,9183,11975,4520,16495,2021-08-10
3173071003,JAKARTA BARAT,PALMERAH,KOTA BAMBU UTARA,24995,11251,13744,5104,18848,2021-08-10
3171041004,JAKARTA PUSAT,SENEN,KRAMAT,28835,13686,15149,5925,21074,2021-08-10
3175041001,JAKARTA TIMUR,KRAMAT JATI,KRAMAT JATI,34144,14906,19238,7931,27169,2021-08-10
3174071003,JAKARTA SELATAN,KEBAYORAN BARU,KRAMAT PELA,14413,5897,8516,4108,12624,2021-08-10
3173031002,JAKARTA BARAT,TAMAN SARI,KRUKUT,19244,7954,11290,4381,15671,2021-08-10
3174031005,JAKARTA SELATAN,MAMPANG PRAPATAN,KUNINGAN BARAT,12785,5188,7597,3682,11279,2021-08-10
3174021008,JAKARTA SELATAN,SETIA BUDI,KUNINGAN TIMUR,6008,2504,3504,1833,5337,2021-08-10
3171041005,JAKARTA PUSAT,SENEN,KWITANG,15486,6441,9045,3789,12834,2021-08-10
3172031003,JAKARTA UTARA,KOJA,LAGOA,59065,27894,31171,12689,43860,2021-08-10
3174061002,JAKARTA SELATAN,CILANDAK,LEBAK BULUS,37626,16307,21319,10600,31919,2021-08-10
3174091004,JAKARTA SELATAN,JAGAKARSA,LENTENG AGUNG,53946,23565,30381,12159,42540,2021-08-10
3175101007,JAKARTA TIMUR,CIPAYUNG,LUBANG BUAYA,63547,25952,37595,17319,54914,2021-08-10
3175081001,JAKARTA TIMUR,MAKASAR,MAKASAR,34390,14106,20284,9008,29292,2021-08-10
3175071006,JAKARTA TIMUR,DUREN SAWIT,MALAKA JAYA,30927,13081,17846,9448,27294,2021-08-10
3175071005,JAKARTA TIMUR,DUREN SAWIT,MALAKA SARI,27530,11477,16053,8498,24551,2021-08-10
3174031001,JAKARTA SELATAN,MAMPANG PRAPATAN,MAMPANG PRAPATAN,18159,7578,10581,5047,15628,2021-08-10
3173031005,JAKARTA BARAT,TAMAN SARI,MANGGA BESAR,7707,2816,4891,2520,7411,2021-08-10
3171021005,JAKARTA PUSAT,SAWAH BESAR,MANGGA DUA SELATAN,27442,11366,16076,7530,23606,2021-08-10
3174011007,JAKARTA SELATAN,TEBET,MANGGARAI,28373,11305,17068,6413,23481,2021-08-10
3174011006,JAKARTA SELATAN,TEBET,MANGGARAI SELATAN,23075,9160,13915,6486,20401,2021-08-10
3173031003,JAKARTA BARAT,TAMAN SARI,MAPHAR,16461,6821,9640,4598,14238,2021-08-10
3172041003,JAKARTA UTARA,CILINCING,MARUNDA,28943,11930,17013,6054,23067,2021-08-10
3174071001,JAKARTA SELATAN,KEBAYORAN BARU,MELAWAI,2627,981,1646,1176,2822,2021-08-10
3171061001,JAKARTA PUSAT,MENTENG,MENTENG,25624,11776,13848,6001,19849,2021-08-10
3174021005,JAKARTA SELATAN,SETIA BUDI,MENTENG ATAS,27816,11151,16665,7395,24060,2021-08-10
3174011003,JAKARTA SELATAN,TEBET,MENTENG DALAM,36028,15076,20952,9549,30501,2021-08-10
3173081003,JAKARTA BARAT,KEMBANGAN,MERUYA SELATAN,32130,13505,18625,7735,26360,2021-08-10
3173081002,JAKARTA BARAT,KEMBANGAN,MERUYA UTARA,43752,18446,25306,11589,36895,2021-08-10
3175101004,JAKARTA TIMUR,CIPAYUNG,MUNJUL,23871,9370,14501,6072,20573,2021-08-10
3172051002,JAKARTA UTARA,PADEMANGAN,PADEMANGAN BARAT,74240,32559,41681,16490,58171,2021-08-10
3172051001,JAKARTA UTARA,PADEMANGAN,PADEMANGAN TIMUR,37736,14000,23736,11733,35469,2021-08-10
3175011004,JAKARTA TIMUR,MATRAMAN,PAL MERIAM,19769,8797,10972,4937,15909,2021-08-10
3173071001,JAKARTA BARAT,PALMERAH,PALMERAH,63011,27697,35314,14028,49342,2021-08-10
3174081001,JAKARTA SELATAN,PANCORAN,PANCORAN,19421,8179,11242,5298,16540,2021-08-10
3172021003,JAKARTA UTARA,TANJUNG PRIOK,PAPANGGO,39097,15495,23602,10501,34103,2021-08-10
3171021001,JAKARTA PUSAT,SAWAH BESAR,PASAR BARU,12035,4293,7742,4141,11883,2021-08-10
3174021006,JAKARTA SELATAN,SETIA BUDI,PASAR MANGGIS,26752,11624,15128,7380,22508,2021-08-10
3174041001,JAKARTA SELATAN,PASAR MINGGU,PASAR MINGGU,24821,10237,14584,7589,22173,2021-08-10
3171041003,JAKARTA PUSAT,SENEN,PASEBAN,23533,10188,13345,5614,18959,2021-08-10
3173061005,JAKARTA BARAT,KALI DERES,PEGADUNGAN,75587,29456,46131,19574,65705,2021-08-10
3171061002,JAKARTA PUSAT,MENTENG,PEGANGSAAN,23455,10876,12579,5123,17702,2021-08-10
3172061002,JAKARTA UTARA,KELAPA GADING,PEGANGSAAN DUA,49976,16559,33417,18463,51880,2021-08-10
3172011004,JAKARTA UTARA,PENJARINGAN,PEJAGALAN,74578,30558,44020,21955,65975,2021-08-10
3174041006,JAKARTA SELATAN,PASAR MINGGU,PEJATEN BARAT,37346,16398,20948,10462,31410,2021-08-10
3174041005,JAKARTA SELATAN,PASAR MINGGU,PEJATEN TIMUR,57656,26624,31032,13389,44421,2021-08-10
3175051005,JAKARTA TIMUR,PASAR REBO,PEKAYON,43250,17238,26012,11113,37125,2021-08-10
3173041009,JAKARTA BARAT,TAMBORA,PEKOJAN,23587,9457,14130,6490,20620,2021-08-10
3174031003,JAKARTA SELATAN,MAMPANG PRAPATAN,PELA MAMPANG,43522,18070,25452,12153,37605,2021-08-10
3174081005,JAKARTA SELATAN,PANCORAN,PENGADEGAN,21478,8235,13243,5827,19070,2021-08-10
3175061003,JAKARTA TIMUR,CAKUNG,PENGGILINGAN,99255,46769,52486,17470,69956,2021-08-10
3172011001,JAKARTA UTARA,PENJARINGAN,PENJARINGAN,88308,41322,46986,18887,65873,2021-08-10
3174101001,JAKARTA SELATAN,PESANGGRAHAN,PESANGGRAHAN,27545,10579,16966,8506,25472,2021-08-10
3171071004,JAKARTA PUSAT,TANAH ABANG,PETAMBURAN,33271,17431,15840,5410,21250,2021-08-10
3174071008,JAKARTA SELATAN,KEBAYORAN BARU,PETOGOGAN,11499,4800,6699,3576,10275,2021-08-10
3171011004,JAKARTA PUSAT,GAMBIR,PETOJO SELATAN,14692,6179,8513,4330,12843,2021-08-10
3171011003,JAKARTA PUSAT,GAMBIR,PETOJO UTARA,17458,7417,10041,4365,14406,2021-08-10
3174101004,JAKARTA SELATAN,PESANGGRAHAN,PETUKANGAN SELATAN,37187,15401,21786,9261,31047,2021-08-10
3174101003,JAKARTA SELATAN,PESANGGRAHAN,PETUKANGAN UTARA,53716,23739,29977,13267,43244,2021-08-10
3175081002,JAKARTA TIMUR,MAKASAR,PINANG RANTI,27198,11748,15450,6733,22183,2021-08-10
3173031008,JAKARTA BARAT,TAMAN SARI,PINANGSIA,10729,4043,6686,3238,9924,2021-08-10
3175011001,JAKARTA TIMUR,MATRAMAN,PISANGAN BARU,31776,14489,17287,6751,24038,2021-08-10
3175021002,JAKARTA TIMUR,PULO GADUNG,PISANGAN TIMUR,41011,16423,24588,10112,34700,2021-08-10
3172011005,JAKARTA UTARA,PENJARINGAN,PLUIT,47783,18957,28826,18504,47330,2021-08-10
3175071002,JAKARTA TIMUR,DUREN SAWIT,PONDOK BAMBU,61550,28572,32978,15031,48009,2021-08-10
3175071004,JAKARTA TIMUR,DUREN SAWIT,PONDOK KELAPA,72015,30138,41877,18924,60801,2021-08-10
3175071007,JAKARTA TIMUR,DUREN SAWIT,PONDOK KOPI,35367,17068,18299,7544,25843,2021-08-10
3174061003,JAKARTA SELATAN,CILANDAK,PONDOK LABU,46464,18390,28074,13821,41895,2021-08-10
3174051002,JAKARTA SELATAN,KEBAYORAN LAMA,PONDOK PINANG,56169,23719,32450,15910,48360,2021-08-10
3175101003,JAKARTA TIMUR,CIPAYUNG,PONDOK RANGGON,25574,10699,14875,6550,21425,2021-08-10
3101011003,KAB.ADM.KEP.SERIBU,KEP. SERIBU UTARA,PULAU HARAPAN,2060,390,1670,849,2519,2021-08-10
3101011002,KAB.ADM.KEP.SERIBU,KEP. SERIBU UTARA,PULAU KELAPA,5528,1107,4421,1843,6264,2021-08-10
3101011001,KAB.ADM.KEP.SERIBU,KEP. SERIBU UTARA,PULAU PANGGANG,5450,991,4459,1797,6256,2021-08-10
3101021003,KAB.ADM.KEP.SERIBU,KEP. SERIBU SELATAN,PULAU PARI,2765,362,2403,1167,3570,2021-08-10
3101021002,KAB.ADM.KEP.SERIBU,KEP. SERIBU SELATAN,PULAU TIDUNG,4553,758,3795,2265,6060,2021-08-10
3101021001,KAB.ADM.KEP.SERIBU,KEP. SERIBU SELATAN,PULAU UNTUNG JAWA,1941,400,1541,777,2318,2021-08-10
3174071007,JAKARTA SELATAN,KEBAYORAN BARU,PULO,5835,2204,3631,2261,5892,2021-08-10
3175021001,JAKARTA TIMUR,PULO GADUNG,PULO GADUNG,34422,14852,19570,8639,28209,2021-08-10
3175061005,JAKARTA TIMUR,CAKUNG,PULO GEBANG,97301,43627,53674,19625,73299,2021-08-10
3174041004,JAKARTA SELATAN,PASAR MINGGU,RAGUNAN,39616,15875,23741,11482,35223,2021-08-10
3175091005,JAKARTA TIMUR,CIRACAS,RAMBUTAN,36771,17588,19183,7948,27131,2021-08-10
3172031006,JAKARTA UTARA,KOJA,RAWA BADAK SELATAN,42179,20002,22177,8480,30657,2021-08-10
3172031004,JAKARTA UTARA,KOJA,RAWA BADAK UTARA,34408,15895,18513,8642,27155,2021-08-10
3174071005,JAKARTA SELATAN,KEBAYORAN BARU,RAWA BARAT,5625,2150,3475,2012,5487,2021-08-10
3173011003,JAKARTA BARAT,CENGKARENG,RAWA BUAYA,63799,27979,35820,12272,48092,2021-08-10
3175031004,JAKARTA TIMUR,JATINEGARA,RAWA BUNGA,21434,9880,11554,4414,15968,2021-08-10
3174081003,JAKARTA SELATAN,PANCORAN,RAWA JATI,20509,8338,12171,5880,18051,2021-08-10
3175061002,JAKARTA TIMUR,CAKUNG,RAWA TERATE,24637,9406,15231,4374,19605,2021-08-10
3175021005,JAKARTA TIMUR,PULO GADUNG,RAWAMANGUN,37612,16106,21506,9931,31437,2021-08-10
3171051003,JAKARTA PUSAT,CEMPAKA PUTIH,RAWASARI,21967,9437,12530,6239,18769,2021-08-10
3173041010,JAKARTA BARAT,TAMBORA,ROA MALAKA,3484,1243,2241,1332,3573,2021-08-10
3172041006,JAKARTA UTARA,CILINCING,ROROTAN,41668,16890,24778,9360,34138,2021-08-10
3174071004,JAKARTA SELATAN,KEBAYORAN BARU,SELONG,2842,1062,1780,1215,2995,2021-08-10
3173061002,JAKARTA BARAT,KALI DERES,SEMANAN,71354,31468,39886,11151,51037,2021-08-10
3172041007,JAKARTA UTARA,CILINCING,SEMPER BARAT,68587,26591,41996,18624,60620,2021-08-10
3172041005,JAKARTA UTARA,CILINCING,SEMPER TIMUR,36267,15092,21175,9549,30724,2021-08-10
3174071006,JAKARTA SELATAN,KEBAYORAN BARU,SENAYAN,2771,1294,1477,868,2345,2021-08-10
3171041001,JAKARTA PUSAT,SENEN,SENEN,6804,2778,4026,1937,5963,2021-08-10
3171031004,JAKARTA PUSAT,KEMAYORAN,SERDANG,29668,12461,17207,7307,24514,2021-08-10
3174021001,JAKARTA SELATAN,SETIA BUDI,SETIA BUDI,3023,1307,1716,974,2690,2021-08-10
3175101005,JAKARTA TIMUR,CIPAYUNG,SETU,20572,9229,11343,4451,15794,2021-08-10
3173071002,JAKARTA BARAT,PALMERAH,SLIPI,16591,6831,9760,4591,14351,2021-08-10
3173081004,JAKARTA BARAT,KEMBANGAN,SRENGSENG,45523,20652,24871,10796,35667,2021-08-10
3174091002,JAKARTA SELATAN,JAGAKARSA,SRENGSENG SAWAH,58196,21190,37006,17066,54072,2021-08-10
3173051003,JAKARTA BARAT,KEBON JERUK,SUKABUMI SELATAN,37033,17313,19720,7364,27084,2021-08-10
3173051002,JAKARTA BARAT,KEBON JERUK,SUKABUMI UTARA,38290,19168,19122,7533,26655,2021-08-10
3172041002,JAKARTA UTARA,CILINCING,SUKAPURA,53949,23176,30773,12911,43684,2021-08-10
3171031007,JAKARTA PUSAT,KEMAYORAN,SUMUR BATU,22717,9744,12973,6339,19312,2021-08-10
3172021004,JAKARTA UTARA,TANJUNG PRIOK,SUNGAI BAMBU,29876,12189,17687,8269,25956,2021-08-10
3172021006,JAKARTA UTARA,TANJUNG PRIOK,SUNTER AGUNG,71805,26117,45688,24325,70013,2021-08-10
3172021002,JAKARTA UTARA,TANJUNG PRIOK,SUNTER JAYA,63031,23978,39053,19418,58471,2021-08-10
3175091004,JAKARTA TIMUR,CIRACAS,SUSUKAN,38257,14894,23363,10121,33484,2021-08-10
3173031001,JAKARTA BARAT,TAMAN SARI,TAMAN SARI,14348,5766,8582,4261,12843,2021-08-10
3173041001,JAKARTA BARAT,TAMBORA,TAMBORA,10204,4456,5748,2505,8253,2021-08-10
3173041004,JAKARTA BARAT,TAMBORA,TANAH SEREAL,26387,9376,17011,6903,23914,2021-08-10
3171081004,JAKARTA PUSAT,JOHAR BARU,TANAH TINGGI,37693,13703,23990,9521,33511,2021-08-10
3173031004,JAKARTA BARAT,TAMAN SARI,TANGKI,13324,5356,7968,3642,11610,2021-08-10
3174091005,JAKARTA SELATAN,JAGAKARSA,TANJUNG BARAT,39770,16200,23570,10538,34108,2021-08-10
3173021005,JAKARTA BARAT,GROGOL PETAMBURAN,TANJUNG DUREN SELATAN,25337,10074,15263,7494,22757,2021-08-10
3173021002,JAKARTA BARAT,GROGOL PETAMBURAN,TANJUNG DUREN UTARA,17010,6396,10614,5531,16145,2021-08-10
3172021001,JAKARTA UTARA,TANJUNG PRIOK,TANJUNG PRIOK,34588,13358,21230,8168,29398,2021-08-10
3174011002,JAKARTA SELATAN,TEBET,TEBET BARAT,21194,8029,13165,7122,20287,2021-08-10
3174011001,JAKARTA SELATAN,TEBET,TEBET TIMUR,18199,6851,11348,6248,17596,2021-08-10
3173061003,JAKARTA BARAT,KALI DERES,TEGAL ALUR,83647,34725,48922,15476,64398,2021-08-10
3174031004,JAKARTA SELATAN,MAMPANG PRAPATAN,TEGAL PARANG,32401,14621,17780,7278,25058,2021-08-10
3173021003,JAKARTA BARAT,GROGOL PETAMBURAN,TOMANG,29605,12019,17586,8742,26328,2021-08-10
3172031005,JAKARTA UTARA,KOJA,TUGU SELATAN,39122,17917,21205,8910,30115,2021-08-10
3172031002,JAKARTA UTARA,KOJA,TUGU UTARA,67670,31784,35886,15217,51103,2021-08-10
3175061006,JAKARTA TIMUR,CAKUNG,UJUNG MENTENG,29934,11702,18232,7201,25433,2021-08-10
3174101005,JAKARTA SELATAN,PESANGGRAHAN,ULUJAMI,40544,18115,22429,8854,31283,2021-08-10
3175011006,JAKARTA TIMUR,MATRAMAN,UTAN KAYU SELATAN,33511,14062,19449,8893,28342,2021-08-10
3175011002,JAKARTA TIMUR,MATRAMAN,UTAN KAYU UTARA,28169,12506,15663,6992,22655,2021-08-10
3171031008,JAKARTA PUSAT,KEMAYORAN,UTAN PANJANG,29208,12767,16441,5916,22357,2021-08-10
3172021007,JAKARTA UTARA,TANJUNG PRIOK,WARAKAS,44401,18273,26128,11631,37759,2021-08-10
3173021007,JAKARTA BARAT,GROGOL PETAMBURAN,WIJAYA KUSUMA,38934,16890,22044,9323,31367,2021-08-10
3172051003,JAKARTA UTARA,PADEMANGAN,ANCOL,23947,10470,13477,5783,19260,2021-08-11
3173041007,JAKARTA BARAT,TAMBORA,ANGKE,29381,11799,17582,6936,24518,2021-08-11
3175041005,JAKARTA TIMUR,KRAMAT JATI,BALE KAMBANG,29074,14794,14280,5133,19413,2021-08-11
3175031003,JAKARTA TIMUR,JATINEGARA,BALI MESTER,9752,4163,5589,2621,8210,2021-08-11
3175101006,JAKARTA TIMUR,CIPAYUNG,BAMBU APUS,26285,10912,15373,6685,22058,2021-08-11
3174031002,JAKARTA SELATAN,MAMPANG PRAPATAN,BANGKA,21566,9311,12255,5535,17790,2021-08-11
3175051002,JAKARTA TIMUR,PASAR REBO,BARU,23886,8872,15014,8060,23074,2021-08-11
3175041004,JAKARTA TIMUR,KRAMAT JATI,BATU AMPAR,47898,23210,24688,9944,34632,2021-08-11
3171071002,JAKARTA PUSAT,TANAH ABANG,BENDUNGAN HILIR,21494,8922,12572,6128,18700,2021-08-11
3175031002,JAKARTA TIMUR,JATINEGARA,BIDARA CINA,36689,17838,18851,7648,26499,2021-08-11
3174101002,JAKARTA SELATAN,PESANGGRAHAN,BINTARO,53098,22002,31096,14634,45730,2021-08-11
3174011005,JAKARTA SELATAN,TEBET,BUKIT DURI,34183,15115,19068,8366,27434,2021-08-11
3171041006,JAKARTA PUSAT,SENEN,BUNGUR,18144,7380,10764,5064,15828,2021-08-11
3175061007,JAKARTA TIMUR,CAKUNG,CAKUNG BARAT,57724,22129,35595,12058,47653,2021-08-11
3175061004,JAKARTA TIMUR,CAKUNG,CAKUNG TIMUR,58287,22924,35363,14270,49633,2021-08-11
3175041007,JAKARTA TIMUR,KRAMAT JATI,CAWANG,32762,15002,17760,7902,25662,2021-08-11
3175101008,JAKARTA TIMUR,CIPAYUNG,CEGER,18932,7631,11301,4716,16017,2021-08-11
3171031006,JAKARTA PUSAT,KEMAYORAN,CEMPAKA BARU,32581,14841,17740,7779,25519,2021-08-11
3171051002,JAKARTA PUSAT,CEMPAKA PUTIH,CEMPAKA PUTIH BARAT,35885,15271,20614,9564,30178,2021-08-11
3171051001,JAKARTA PUSAT,CEMPAKA PUTIH,CEMPAKA PUTIH TIMUR,24292,10359,13933,7463,21396,2021-08-11
3173011001,JAKARTA BARAT,CENGKARENG,CENGKARENG BARAT,66284,27350,38934,17999,56933,2021-08-11
3173011006,JAKARTA BARAT,CENGKARENG,CENGKARENG TIMUR,81027,33866,47161,18789,65950,2021-08-11
3175091002,JAKARTA TIMUR,CIRACAS,CIBUBUR,66364,26073,40291,19309,59600,2021-08-11
3171011002,JAKARTA PUSAT,GAMBIR,CIDENG,15390,5794,9596,5038,14634,2021-08-11
3174091003,JAKARTA SELATAN,JAGAKARSA,CIGANJUR,38497,15918,22579,10565,33144,2021-08-11
3175051003,JAKARTA TIMUR,PASAR REBO,CIJANTUNG,41419,16491,24928,12093,37021,2021-08-11
3171061003,JAKARTA PUSAT,MENTENG,CIKINI,8274,3779,4495,2229,6724,2021-08-11
3174081006,JAKARTA SELATAN,PANCORAN,CIKOKO,10547,3938,6609,3052,9661,2021-08-11
3174061001,JAKARTA SELATAN,CILANDAK,CILANDAK BARAT,51752,20774,30978,16065,47043,2021-08-11
3174041003,JAKARTA SELATAN,PASAR MINGGU,CILANDAK TIMUR,25145,9933,15212,8374,23586,2021-08-11
3175101002,JAKARTA TIMUR,CIPAYUNG,CILANGKAP,27635,11052,16583,7232,23815,2021-08-11
3175041006,JAKARTA TIMUR,KRAMAT JATI,CILILITAN,40181,18906,21275,9350,30625,2021-08-11
3172041001,JAKARTA UTARA,CILINCING,CILINCING,43609,19415,24194,10162,34356,2021-08-11
3175101001,JAKARTA TIMUR,CIPAYUNG,CIPAYUNG,26104,9724,16380,7986,24366,2021-08-11
3174091006,JAKARTA SELATAN,JAGAKARSA,CIPEDAK,38303,14575,23728,11474,35202,2021-08-11
3174061005,JAKARTA SELATAN,CILANDAK,CIPETE SELATAN,26704,11180,15524,8039,23563,2021-08-11
3174071010,JAKARTA SELATAN,KEBAYORAN BARU,CIPETE UTARA,34102,14239,19863,9197,29060,2021-08-11
3175021003,JAKARTA TIMUR,PULO GADUNG,CIPINANG,39306,16737,22569,10691,33260,2021-08-11
3175031007,JAKARTA TIMUR,JATINEGARA,CIPINANG BESAR SELATAN,35212,17330,17882,7059,24941,2021-08-11
3175031008,JAKARTA TIMUR,JATINEGARA,CIPINANG BESAR UTARA,45319,21197,24122,8638,32760,2021-08-11
3175031005,JAKARTA TIMUR,JATINEGARA,CIPINANG CEMPEDAK,32824,15138,17686,8292,25978,2021-08-11
3175081005,JAKARTA TIMUR,MAKASAR,CIPINANG MELAYU,42308,18275,24033,11523,35556,2021-08-11
3175031006,JAKARTA TIMUR,JATINEGARA,CIPINANG MUARA,55243,25259,29984,12705,42689,2021-08-11
3174051003,JAKARTA SELATAN,KEBAYORAN LAMA,CIPULIR,39937,17776,22161,9331,31492,2021-08-11
3175091001,JAKARTA TIMUR,CIRACAS,CIRACAS,64594,25308,39286,16983,56269,2021-08-11
3175041003,JAKARTA TIMUR,KRAMAT JATI,DUKUH,24609,10157,14452,6072,20524,2021-08-11
3175071001,JAKARTA TIMUR,DUREN SAWIT,DUREN SAWIT,61160,28250,32910,16351,49261,2021-08-11
3174081004,JAKARTA SELATAN,PANCORAN,DUREN TIGA,28319,11649,16670,6972,23642,2021-08-11
3173051005,JAKARTA BARAT,KEBON JERUK,DURI KEPA,60138,23669,36469,17885,54354,2021-08-11
3173011002,JAKARTA BARAT,CENGKARENG,DURI KOSAMBI,77923,35850,42073,17240,59313,2021-08-11
3171011006,JAKARTA PUSAT,GAMBIR,DURI PULO,19610,8096,11514,4298,15812,2021-08-11
3173041011,JAKARTA BARAT,TAMBORA,DURI SELATAN,14259,5242,9017,3918,12935,2021-08-11
3173041003,JAKARTA BARAT,TAMBORA,DURI UTARA,19844,7697,12147,4994,17141,2021-08-11
3171081003,JAKARTA PUSAT,JOHAR BARU,GALUR,18243,6608,11635,4099,15734,2021-08-11
3171011001,JAKARTA PUSAT,GAMBIR,GAMBIR,2191,814,1377,762,2139,2021-08-11
3174061004,JAKARTA SELATAN,CILANDAK,GANDARIA SELATAN,22119,9155,12964,6162,19126,2021-08-11
3174071009,JAKARTA SELATAN,KEBAYORAN BARU,GANDARIA UTARA,39922,17032,22890,10502,33392,2021-08-11
3175051001,JAKARTA TIMUR,PASAR REBO,GEDONG,35755,14415,21340,9903,31243,2021-08-11
3171071001,JAKARTA PUSAT,TANAH ABANG,GELORA,3127,1349,1778,844,2622,2021-08-11
3173031007,JAKARTA BARAT,TAMAN SARI,GLODOK,7837,2717,5120,3113,8233,2021-08-11
3171061004,JAKARTA PUSAT,MENTENG,GONDANGDIA,4100,1672,2428,1692,4120,2021-08-11
3173021001,JAKARTA BARAT,GROGOL PETAMBURAN,GROGOL,16876,6911,9965,4811,14776,2021-08-11
3174051005,JAKARTA SELATAN,KEBAYORAN LAMA,GROGOL SELATAN,44251,19419,24832,10403,35235,2021-08-11
3174051004,JAKARTA SELATAN,KEBAYORAN LAMA,GROGOL UTARA,42494,18030,24464,10627,35091,2021-08-11
3174021007,JAKARTA SELATAN,SETIA BUDI,GUNTUR,3985,1555,2430,1509,3939,2021-08-11
3174071002,JAKARTA SELATAN,KEBAYORAN BARU,GUNUNG,9436,3690,5746,3395,9141,2021-08-11
3171031005,JAKARTA PUSAT,KEMAYORAN,GUNUNG SAHARI SELATAN,19199,8075,11124,5512,16636,2021-08-11
3171021004,JAKARTA PUSAT,SAWAH BESAR,GUNUNG SAHARI UTARA,16650,5954,10696,5693,16389,2021-08-11
3175081004,JAKARTA TIMUR,MAKASAR,HALIM PERDANA KUSUMAH,28363,8999,19364,13314,32678,2021-08-11
3171031003,JAKARTA PUSAT,KEMAYORAN,HARAPAN MULIA,22557,9589,12968,5646,18614,2021-08-11
3174091001,JAKARTA SELATAN,JAGAKARSA,JAGAKARSA,62389,24413,37976,18339,56315,2021-08-11
3175021007,JAKARTA TIMUR,PULO GADUNG,JATI,32757,13761,18996,9508,28504,2021-08-11
3174041002,JAKARTA SELATAN,PASAR MINGGU,JATI PADANG,37502,15685,21817,11157,32974,2021-08-11
3173071004,JAKARTA BARAT,PALMERAH,JATI PULO,28738,11449,17289,6293,23582,2021-08-11
3175061001,JAKARTA TIMUR,CAKUNG,JATINEGARA,84160,36428,47732,16404,64136,2021-08-11
3175021004,JAKARTA TIMUR,PULO GADUNG,JATINEGARA KAUM,24632,9685,14947,5516,20463,2021-08-11
3173021004,JAKARTA BARAT,GROGOL PETAMBURAN,JELAMBAR,30266,12202,18064,9519,27583,2021-08-11
3173021006,JAKARTA BARAT,GROGOL PETAMBURAN,JELAMBAR BARU,38246,15612,22634,11431,34065,2021-08-11
3173041006,JAKARTA BARAT,TAMBORA,JEMBATAN BESI,29314,14384,14930,5092,20022,2021-08-11
3173041008,JAKARTA BARAT,TAMBORA,JEMBATAN LIMA,21021,9712,11309,4789,16098,2021-08-11
3173081005,JAKARTA BARAT,KEMBANGAN,JOGLO,40839,17557,23282,10437,33719,2021-08-11
3171081001,JAKARTA PUSAT,JOHAR BARU,JOHAR BARU,37488,14224,23264,10229,33493,2021-08-11
3173041002,JAKARTA BARAT,TAMBORA,KALI ANYAR,23856,9168,14688,4545,19233,2021-08-11
3172041004,JAKARTA UTARA,CILINCING,KALIBARU,67684,32469,35215,13223,48438,2021-08-11
3174081002,JAKARTA SELATAN,PANCORAN,KALIBATA,41994,19366,22628,9308,31936,2021-08-11
3173061001,JAKARTA BARAT,KALI DERES,KALIDERES,72447,29763,42684,17395,60079,2021-08-11
3175051004,JAKARTA TIMUR,PASAR REBO,KALISARI,43212,17449,25763,12344,38107,2021-08-11
3173061004,JAKARTA BARAT,KALI DERES,KAMAL,53783,23683,30100,8194,38294,2021-08-11
3172011002,JAKARTA UTARA,PENJARINGAN,KAMAL MUARA,12930,4015,8915,5075,13990,2021-08-11
3171071007,JAKARTA PUSAT,TANAH ABANG,KAMPUNG BALI,11358,5473,5885,2671,8556,2021-08-11
3175031001,JAKARTA TIMUR,JATINEGARA,KAMPUNG MELAYU,25717,11946,13771,5226,18997,2021-08-11
3171081002,JAKARTA PUSAT,JOHAR BARU,KAMPUNG RAWA,21237,6916,14321,5274,19595,2021-08-11
3175041002,JAKARTA TIMUR,KRAMAT JATI,KAMPUNG TENGAH,43993,21154,22839,9322,32161,2021-08-11
3173011005,JAKARTA BARAT,CENGKARENG,KAPUK,134466,61148,73318,23291,96609,2021-08-11
3172011003,JAKARTA UTARA,PENJARINGAN,KAPUK MUARA,35781,13015,22766,12767,35533,2021-08-11
3171021002,JAKARTA PUSAT,SAWAH BESAR,KARANG ANYAR,25761,10204,15557,6635,22192,2021-08-11
3174021004,JAKARTA SELATAN,SETIA BUDI,KARET,9623,4132,5491,2832,8323,2021-08-11
3174021003,JAKARTA SELATAN,SETIA BUDI,KARET KUNINGAN,16055,6160,9895,4927,14822,2021-08-11
3174021002,JAKARTA SELATAN,SETIA BUDI,KARET SEMANGGI,2770,1017,1753,1104,2857,2021-08-11
3171071003,JAKARTA PUSAT,TANAH ABANG,KARET TENGSIN,19271,8128,11143,4511,15654,2021-08-11
3171021003,JAKARTA PUSAT,SAWAH BESAR,KARTINI,22292,8868,13424,6598,20022,2021-08-11
3175011003,JAKARTA TIMUR,MATRAMAN,KAYU MANIS,25284,11539,13745,5753,19498,2021-08-11
3175021006,JAKARTA TIMUR,PULO GADUNG,KAYU PUTIH,40696,15897,24799,13030,37829,2021-08-11
3173031006,JAKARTA BARAT,TAMAN SARI,KEAGUNGAN,17387,6801,10586,4562,15148,2021-08-11
3174041007,JAKARTA SELATAN,PASAR MINGGU,KEBAGUSAN,44552,19260,25292,11133,36425,2021-08-11
3174051006,JAKARTA SELATAN,KEBAYORAN LAMA,KEBAYORAN LAMA SELATAN,41212,17060,24152,10676,34828,2021-08-11
3174051001,JAKARTA SELATAN,KEBAYORAN LAMA,KEBAYORAN LAMA UTARA,42422,18532,23890,9812,33702,2021-08-11
3174011004,JAKARTA SELATAN,TEBET,KEBON BARU,35165,14620,20545,9565,30110,2021-08-11
3172021005,JAKARTA UTARA,TANJUNG PRIOK,KEBON BAWANG,50952,21969,28983,13985,42968,2021-08-11
3173051001,JAKARTA BARAT,KEBON JERUK,KEBON JERUK,53887,24335,29552,12652,42204,2021-08-11
3171071006,JAKARTA PUSAT,TANAH ABANG,KEBON KACANG,21531,10663,10868,4776,15644,2021-08-11
3171011005,JAKARTA PUSAT,GAMBIR,KEBON KELAPA,10163,4138,6025,2875,8900,2021-08-11
3171031002,JAKARTA PUSAT,KEMAYORAN,KEBON KOSONG,30019,12868,17151,7806,24957,2021-08-11
3175011005,JAKARTA TIMUR,MATRAMAN,KEBON MANGGIS,16490,6788,9702,4768,14470,2021-08-11
3171071005,JAKARTA PUSAT,TANAH ABANG,KEBON MELATI,32206,17088,15118,5197,20315,2021-08-11
3175081003,JAKARTA TIMUR,MAKASAR,KEBON PALA,46614,19931,26683,10978,37661,2021-08-11
3171061005,JAKARTA PUSAT,MENTENG,KEBON SIRIH,12299,5692,6607,2817,9424,2021-08-11
3173011004,JAKARTA BARAT,CENGKARENG,KEDAUNG KALI ANGKE,32612,12205,20407,6953,27360,2021-08-11
3173051007,JAKARTA BARAT,KEBON JERUK,KEDOYA SELATAN,32165,12861,19304,7795,27099,2021-08-11
3173051006,JAKARTA BARAT,KEBON JERUK,KEDOYA UTARA,45740,17202,28538,12375,40913,2021-08-11
3173051004,JAKARTA BARAT,KEBON JERUK,KELAPA DUA,23565,10267,13298,5604,18902,2021-08-11
3175091003,JAKARTA TIMUR,CIRACAS,KELAPA DUA WETAN,46875,18252,28623,12897,41520,2021-08-11
3172061003,JAKARTA UTARA,KELAPA GADING,KELAPA GADING BARAT,35717,12848,22869,14364,37233,2021-08-11
3172061001,JAKARTA UTARA,KELAPA GADING,KELAPA GADING TIMUR,33592,11193,22399,14140,36539,2021-08-11
3173071005,JAKARTA BARAT,PALMERAH,KEMANGGISAN,32139,13827,18312,8434,26746,2021-08-11
3171031001,JAKARTA PUSAT,KEMAYORAN,KEMAYORAN,20708,8323,12385,5721,18106,2021-08-11
3173081006,JAKARTA BARAT,KEMBANGAN,KEMBANGAN SELATAN,27130,11197,15933,8066,23999,2021-08-11
3173081001,JAKARTA BARAT,KEMBANGAN,KEMBANGAN UTARA,54451,22389,32062,12691,44753,2021-08-11
3171041002,JAKARTA PUSAT,SENEN,KENARI,9579,3747,5832,2745,8577,2021-08-11
3173041005,JAKARTA BARAT,TAMBORA,KERENDANG,19973,8342,11631,4907,16538,2021-08-11
3175071003,JAKARTA TIMUR,DUREN SAWIT,KLENDER,69978,33161,36817,14175,50992,2021-08-11
3172031001,JAKARTA UTARA,KOJA,KOJA,28175,12232,15943,7638,23581,2021-08-11
3173071006,JAKARTA BARAT,PALMERAH,KOTA BAMBU SELATAN,21158,9107,12051,4680,16731,2021-08-11
3173071003,JAKARTA BARAT,PALMERAH,KOTA BAMBU UTARA,24995,11141,13854,5294,19148,2021-08-11
3171041004,JAKARTA PUSAT,SENEN,KRAMAT,28835,13597,15238,6054,21292,2021-08-11
3175041001,JAKARTA TIMUR,KRAMAT JATI,KRAMAT JATI,34144,14692,19452,8107,27559,2021-08-11
3174071003,JAKARTA SELATAN,KEBAYORAN BARU,KRAMAT PELA,14413,5850,8563,4206,12769,2021-08-11
3173031002,JAKARTA BARAT,TAMAN SARI,KRUKUT,19244,7778,11466,4602,16068,2021-08-11
3174031005,JAKARTA SELATAN,MAMPANG PRAPATAN,KUNINGAN BARAT,12785,5139,7646,3765,11411,2021-08-11
3174021008,JAKARTA SELATAN,SETIA BUDI,KUNINGAN TIMUR,6008,2477,3531,1856,5387,2021-08-11
3171041005,JAKARTA PUSAT,SENEN,KWITANG,15486,6376,9110,3879,12989,2021-08-11
3172031003,JAKARTA UTARA,KOJA,LAGOA,59065,27542,31523,13254,44777,2021-08-11
3174061002,JAKARTA SELATAN,CILANDAK,LEBAK BULUS,37626,16132,21494,11015,32509,2021-08-11
3174091004,JAKARTA SELATAN,JAGAKARSA,LENTENG AGUNG,53946,23096,30850,12468,43318,2021-08-11
3175101007,JAKARTA TIMUR,CIPAYUNG,LUBANG BUAYA,63547,25472,38075,17733,55808,2021-08-11
3175081001,JAKARTA TIMUR,MAKASAR,MAKASAR,34390,13861,20529,9278,29807,2021-08-11
3175071006,JAKARTA TIMUR,DUREN SAWIT,MALAKA JAYA,30927,12964,17963,9649,27612,2021-08-11
3175071005,JAKARTA TIMUR,DUREN SAWIT,MALAKA SARI,27530,11290,16240,8757,24997,2021-08-11
3174031001,JAKARTA SELATAN,MAMPANG PRAPATAN,MAMPANG PRAPATAN,18159,7527,10632,5153,15785,2021-08-11
3173031005,JAKARTA BARAT,TAMAN SARI,MANGGA BESAR,7707,2799,4908,2559,7467,2021-08-11
3171021005,JAKARTA PUSAT,SAWAH BESAR,MANGGA DUA SELATAN,27442,11195,16247,7745,23992,2021-08-11
3174011007,JAKARTA SELATAN,TEBET,MANGGARAI,28373,11159,17214,6877,24091,2021-08-11
3174011006,JAKARTA SELATAN,TEBET,MANGGARAI SELATAN,23075,9075,14000,6605,20605,2021-08-11
3173031003,JAKARTA BARAT,TAMAN SARI,MAPHAR,16461,6760,9701,4692,14393,2021-08-11
3172041003,JAKARTA UTARA,CILINCING,MARUNDA,28943,11769,17174,6337,23511,2021-08-11
3174071001,JAKARTA SELATAN,KEBAYORAN BARU,MELAWAI,2627,978,1649,1197,2846,2021-08-11
3171061001,JAKARTA PUSAT,MENTENG,MENTENG,25624,11562,14062,6181,20243,2021-08-11
3174021005,JAKARTA SELATAN,SETIA BUDI,MENTENG ATAS,27816,11020,16796,7547,24343,2021-08-11
3174011003,JAKARTA SELATAN,TEBET,MENTENG DALAM,36028,14875,21153,9799,30952,2021-08-11
3173081003,JAKARTA BARAT,KEMBANGAN,MERUYA SELATAN,32130,13374,18756,7915,26671,2021-08-11
3173081002,JAKARTA BARAT,KEMBANGAN,MERUYA UTARA,43752,18305,25447,11862,37309,2021-08-11
3175101004,JAKARTA TIMUR,CIPAYUNG,MUNJUL,23871,9247,14624,6233,20857,2021-08-11
3172051002,JAKARTA UTARA,PADEMANGAN,PADEMANGAN BARAT,74240,32232,42008,17267,59275,2021-08-11
3172051001,JAKARTA UTARA,PADEMANGAN,PADEMANGAN TIMUR,37736,13803,23933,12160,36093,2021-08-11
3175011004,JAKARTA TIMUR,MATRAMAN,PAL MERIAM,19769,8648,11121,5068,16189,2021-08-11
3173071001,JAKARTA BARAT,PALMERAH,PALMERAH,63011,27452,35559,14511,50070,2021-08-11
3174081001,JAKARTA SELATAN,PANCORAN,PANCORAN,19421,8087,11334,5450,16784,2021-08-11
3172021003,JAKARTA UTARA,TANJUNG PRIOK,PAPANGGO,39097,15324,23773,10950,34723,2021-08-11
3171021001,JAKARTA PUSAT,SAWAH BESAR,PASAR BARU,12035,4216,7819,4234,12053,2021-08-11
3174021006,JAKARTA SELATAN,SETIA BUDI,PASAR MANGGIS,26752,11464,15288,7529,22817,2021-08-11
3174041001,JAKARTA SELATAN,PASAR MINGGU,PASAR MINGGU,24821,10186,14635,7717,22352,2021-08-11
3171041003,JAKARTA PUSAT,SENEN,PASEBAN,23533,10098,13435,5880,19315,2021-08-11
3173061005,JAKARTA BARAT,KALI DERES,PEGADUNGAN,75587,29201,46386,19957,66343,2021-08-11
3171061002,JAKARTA PUSAT,MENTENG,PEGANGSAAN,23455,10782,12673,5264,17937,2021-08-11
3172061002,JAKARTA UTARA,KELAPA GADING,PEGANGSAAN DUA,49976,16425,33551,18708,52259,2021-08-11
3172011004,JAKARTA UTARA,PENJARINGAN,PEJAGALAN,74578,30181,44397,22510,66907,2021-08-11
3174041006,JAKARTA SELATAN,PASAR MINGGU,PEJATEN BARAT,37346,16230,21116,10877,31993,2021-08-11
3174041005,JAKARTA SELATAN,PASAR MINGGU,PEJATEN TIMUR,57656,26142,31514,13815,45329,2021-08-11
3175051005,JAKARTA TIMUR,PASAR REBO,PEKAYON,43250,17062,26188,11490,37678,2021-08-11
3173041009,JAKARTA BARAT,TAMBORA,PEKOJAN,23587,9388,14199,6690,20889,2021-08-11
3174031003,JAKARTA SELATAN,MAMPANG PRAPATAN,PELA MAMPANG,43522,17896,25626,12599,38225,2021-08-11
3174081005,JAKARTA SELATAN,PANCORAN,PENGADEGAN,21478,8117,13361,5986,19347,2021-08-11
3175061003,JAKARTA TIMUR,CAKUNG,PENGGILINGAN,99255,46088,53167,18098,71265,2021-08-11
3172011001,JAKARTA UTARA,PENJARINGAN,PENJARINGAN,88308,40706,47602,19504,67106,2021-08-11
3174101001,JAKARTA SELATAN,PESANGGRAHAN,PESANGGRAHAN,27545,10477,17068,8747,25815,2021-08-11
3171071004,JAKARTA PUSAT,TANAH ABANG,PETAMBURAN,33271,17238,16033,5545,21578,2021-08-11
3174071008,JAKARTA SELATAN,KEBAYORAN BARU,PETOGOGAN,11499,4721,6778,3658,10436,2021-08-11
3171011004,JAKARTA PUSAT,GAMBIR,PETOJO SELATAN,14692,6105,8587,4429,13016,2021-08-11
3171011003,JAKARTA PUSAT,GAMBIR,PETOJO UTARA,17458,7297,10161,4451,14612,2021-08-11
3174101004,JAKARTA SELATAN,PESANGGRAHAN,PETUKANGAN SELATAN,37187,15263,21924,9498,31422,2021-08-11
3174101003,JAKARTA SELATAN,PESANGGRAHAN,PETUKANGAN UTARA,53716,23520,30196,13793,43989,2021-08-11
3175081002,JAKARTA TIMUR,MAKASAR,PINANG RANTI,27198,11574,15624,6855,22479,2021-08-11
3173031008,JAKARTA BARAT,TAMAN SARI,PINANGSIA,10729,4011,6718,3356,10074,2021-08-11
3175011001,JAKARTA TIMUR,MATRAMAN,PISANGAN BARU,31776,14282,17494,6952,24446,2021-08-11
3175021002,JAKARTA TIMUR,PULO GADUNG,PISANGAN TIMUR,41011,16226,24785,10428,35213,2021-08-11
3172011005,JAKARTA UTARA,PENJARINGAN,PLUIT,47783,18741,29042,18825,47867,2021-08-11
3175071002,JAKARTA TIMUR,DUREN SAWIT,PONDOK BAMBU,61550,28133,33417,15391,48808,2021-08-11
3175071004,JAKARTA TIMUR,DUREN SAWIT,PONDOK KELAPA,72015,29778,42237,19342,61579,2021-08-11
3175071007,JAKARTA TIMUR,DUREN SAWIT,PONDOK KOPI,35367,16829,18538,7844,26382,2021-08-11
3174061003,JAKARTA SELATAN,CILANDAK,PONDOK LABU,46464,18202,28262,14091,42353,2021-08-11
3174051002,JAKARTA SELATAN,KEBAYORAN LAMA,PONDOK PINANG,56169,23392,32777,16617,49394,2021-08-11
3175101003,JAKARTA TIMUR,CIPAYUNG,PONDOK RANGGON,25574,10481,15093,6724,21817,2021-08-11
3101011003,KAB.ADM.KEP.SERIBU,KEP. SERIBU UTARA,PULAU HARAPAN,2060,384,1676,880,2556,2021-08-11
3101011002,KAB.ADM.KEP.SERIBU,KEP. SERIBU UTARA,PULAU KELAPA,5528,1099,4429,1918,6347,2021-08-11
3101011001,KAB.ADM.KEP.SERIBU,KEP. SERIBU UTARA,PULAU PANGGANG,5450,986,4464,1806,6270,2021-08-11
3101021003,KAB.ADM.KEP.SERIBU,KEP. SERIBU SELATAN,PULAU PARI,2765,356,2409,1207,3616,2021-08-11
3101021002,KAB.ADM.KEP.SERIBU,KEP. SERIBU SELATAN,PULAU TIDUNG,4553,753,3800,2291,6091,2021-08-11
3101021001,KAB.ADM.KEP.SERIBU,KEP. SERIBU SELATAN,PULAU UNTUNG JAWA,1941,395,1546,779,2325,2021-08-11
3174071007,JAKARTA SELATAN,KEBAYORAN BARU,PULO,5835,2182,3653,2287,5940,2021-08-11
3175021001,JAKARTA TIMUR,PULO GADUNG,PULO GADUNG,34422,14672,19750,8837,28587,2021-08-11
3175061005,JAKARTA TIMUR,CAKUNG,PULO GEBANG,97301,42917,54384,20430,74814,2021-08-11
3174041004,JAKARTA SELATAN,PASAR MINGGU,RAGUNAN,39616,15708,23908,11712,35620,2021-08-11
3175091005,JAKARTA TIMUR,CIRACAS,RAMBUTAN,36771,17333,19438,8194,27632,2021-08-11
3172031006,JAKARTA UTARA,KOJA,RAWA BADAK SELATAN,42179,19807,22372,8850,31222,2021-08-11
3172031004,JAKARTA UTARA,KOJA,RAWA BADAK UTARA,34408,15680,18728,8938,27666,2021-08-11
3174071005,JAKARTA SELATAN,KEBAYORAN BARU,RAWA BARAT,5625,2132,3493,2051,5544,2021-08-11
3173011003,JAKARTA BARAT,CENGKARENG,RAWA BUAYA,63799,27687,36112,12566,48678,2021-08-11
3175031004,JAKARTA TIMUR,JATINEGARA,RAWA BUNGA,21434,9770,11664,4520,16184,2021-08-11
3174081003,JAKARTA SELATAN,PANCORAN,RAWA JATI,20509,8253,12256,6055,18311,2021-08-11
3175061002,JAKARTA TIMUR,CAKUNG,RAWA TERATE,24637,9306,15331,4730,20061,2021-08-11
3175021005,JAKARTA TIMUR,PULO GADUNG,RAWAMANGUN,37612,15942,21670,10224,31894,2021-08-11
3171051003,JAKARTA PUSAT,CEMPAKA PUTIH,RAWASARI,21967,9326,12641,6379,19020,2021-08-11
3173041010,JAKARTA BARAT,TAMBORA,ROA MALAKA,3484,1221,2263,1348,3611,2021-08-11
3172041006,JAKARTA UTARA,CILINCING,ROROTAN,41668,16645,25023,9752,34775,2021-08-11
3174071004,JAKARTA SELATAN,KEBAYORAN BARU,SELONG,2842,1058,1784,1238,3022,2021-08-11
3173061002,JAKARTA BARAT,KALI DERES,SEMANAN,71354,31213,40141,11597,51738,2021-08-11
3172041007,JAKARTA UTARA,CILINCING,SEMPER BARAT,68587,26304,42283,19508,61791,2021-08-11
3172041005,JAKARTA UTARA,CILINCING,SEMPER TIMUR,36267,14870,21397,9811,31208,2021-08-11
3174071006,JAKARTA SELATAN,KEBAYORAN BARU,SENAYAN,2771,1285,1486,884,2370,2021-08-11
3171041001,JAKARTA PUSAT,SENEN,SENEN,6804,2678,4126,2075,6201,2021-08-11
3171031004,JAKARTA PUSAT,KEMAYORAN,SERDANG,29668,12335,17333,7452,24785,2021-08-11
3174021001,JAKARTA SELATAN,SETIA BUDI,SETIA BUDI,3023,1290,1733,993,2726,2021-08-11
3175101005,JAKARTA TIMUR,CIPAYUNG,SETU,20572,9084,11488,4564,16052,2021-08-11
3173071002,JAKARTA BARAT,PALMERAH,SLIPI,16591,6771,9820,4751,14571,2021-08-11
3173081004,JAKARTA BARAT,KEMBANGAN,SRENGSENG,45523,20494,25029,11149,36178,2021-08-11
3174091002,JAKARTA SELATAN,JAGAKARSA,SRENGSENG SAWAH,58196,21007,37189,17571,54760,2021-08-11
3173051003,JAKARTA BARAT,KEBON JERUK,SUKABUMI SELATAN,37033,17164,19869,7612,27481,2021-08-11
3173051002,JAKARTA BARAT,KEBON JERUK,SUKABUMI UTARA,38290,18995,19295,7781,27076,2021-08-11
3172041002,JAKARTA UTARA,CILINCING,SUKAPURA,53949,22908,31041,13400,44441,2021-08-11
3171031007,JAKARTA PUSAT,KEMAYORAN,SUMUR BATU,22717,9625,13092,6525,19617,2021-08-11
3172021004,JAKARTA UTARA,TANJUNG PRIOK,SUNGAI BAMBU,29876,12083,17793,8496,26289,2021-08-11
3172021006,JAKARTA UTARA,TANJUNG PRIOK,SUNTER AGUNG,71805,25878,45927,24846,70773,2021-08-11
3172021002,JAKARTA UTARA,TANJUNG PRIOK,SUNTER JAYA,63031,23778,39253,19723,58976,2021-08-11
3175091004,JAKARTA TIMUR,CIRACAS,SUSUKAN,38257,14724,23533,10374,33907,2021-08-11
3173031001,JAKARTA BARAT,TAMAN SARI,TAMAN SARI,14348,5733,8615,4330,12945,2021-08-11
3173041001,JAKARTA BARAT,TAMBORA,TAMBORA,10204,4392,5812,2563,8375,2021-08-11
3173041004,JAKARTA BARAT,TAMBORA,TANAH SEREAL,26387,9308,17079,7120,24199,2021-08-11
3171081004,JAKARTA PUSAT,JOHAR BARU,TANAH TINGGI,37693,13537,24156,9901,34057,2021-08-11
3173031004,JAKARTA BARAT,TAMAN SARI,TANGKI,13324,5315,8009,3760,11769,2021-08-11
3174091005,JAKARTA SELATAN,JAGAKARSA,TANJUNG BARAT,39770,16023,23747,10771,34518,2021-08-11
3173021005,JAKARTA BARAT,GROGOL PETAMBURAN,TANJUNG DUREN SELATAN,25337,9975,15362,7650,23012,2021-08-11
3173021002,JAKARTA BARAT,GROGOL PETAMBURAN,TANJUNG DUREN UTARA,17010,6340,10670,5643,16313,2021-08-11
3172021001,JAKARTA UTARA,TANJUNG PRIOK,TANJUNG PRIOK,34588,13215,21373,8510,29883,2021-08-11
3174011002,JAKARTA SELATAN,TEBET,TEBET BARAT,21194,7961,13233,7263,20496,2021-08-11
3174011001,JAKARTA SELATAN,TEBET,TEBET TIMUR,18199,6806,11393,6393,17786,2021-08-11
3173061003,JAKARTA BARAT,KALI DERES,TEGAL ALUR,83647,34454,49193,16090,65283,2021-08-11
3174031004,JAKARTA SELATAN,MAMPANG PRAPATAN,TEGAL PARANG,32401,14478,17923,7539,25462,2021-08-11
3173021003,JAKARTA BARAT,GROGOL PETAMBURAN,TOMANG,29605,11890,17715,9007,26722,2021-08-11
3172031005,JAKARTA UTARA,KOJA,TUGU SELATAN,39122,17734,21388,9163,30551,2021-08-11
3172031002,JAKARTA UTARA,KOJA,TUGU UTARA,67670,31325,36345,15905,52250,2021-08-11
3175061006,JAKARTA TIMUR,CAKUNG,UJUNG MENTENG,29934,11434,18500,7507,26007,2021-08-11
3174101005,JAKARTA SELATAN,PESANGGRAHAN,ULUJAMI,40544,17912,22632,9364,31996,2021-08-11
3175011006,JAKARTA TIMUR,MATRAMAN,UTAN KAYU SELATAN,33511,13809,19702,9180,28882,2021-08-11
3175011002,JAKARTA TIMUR,MATRAMAN,UTAN KAYU UTARA,28169,12354,15815,7157,22972,2021-08-11
3171031008,JAKARTA PUSAT,KEMAYORAN,UTAN PANJANG,29208,12629,16579,6266,22845,2021-08-11
3172021007,JAKARTA UTARA,TANJUNG PRIOK,WARAKAS,44401,18077,26324,12038,38362,2021-08-11
3173021007,JAKARTA BARAT,GROGOL PETAMBURAN,WIJAYA KUSUMA,38934,16759,22175,9695,31870,2021-08-11
3172051003,JAKARTA UTARA,PADEMANGAN,ANCOL,23947,10376,13571,5864,19435,2021-08-12
3173041007,JAKARTA BARAT,TAMBORA,ANGKE,29381,11761,17620,6957,24577,2021-08-12
3175041005,JAKARTA TIMUR,KRAMAT JATI,BALE KAMBANG,29074,14655,14419,5174,19593,2021-08-12
3175031003,JAKARTA TIMUR,JATINEGARA,BALI MESTER,9752,4150,5602,2633,8235,2021-08-12
3175101006,JAKARTA TIMUR,CIPAYUNG,BAMBU APUS,26285,10860,15425,6711,22136,2021-08-12
3174031002,JAKARTA SELATAN,MAMPANG PRAPATAN,BANGKA,21566,9257,12309,5604,17913,2021-08-12
3175051002,JAKARTA TIMUR,PASAR REBO,BARU,23886,8858,15028,8082,23110,2021-08-12
3175041004,JAKARTA TIMUR,KRAMAT JATI,BATU AMPAR,47898,23078,24820,10004,34824,2021-08-12
3171071002,JAKARTA PUSAT,TANAH ABANG,BENDUNGAN HILIR,21494,8897,12597,6167,18764,2021-08-12
3175031002,JAKARTA TIMUR,JATINEGARA,BIDARA CINA,36689,17758,18931,7692,26623,2021-08-12
3174101002,JAKARTA SELATAN,PESANGGRAHAN,BINTARO,53098,21872,31226,14945,46171,2021-08-12
3174011005,JAKARTA SELATAN,TEBET,BUKIT DURI,34183,15044,19139,8406,27545,2021-08-12
3171041006,JAKARTA PUSAT,SENEN,BUNGUR,18144,7346,10798,5087,15885,2021-08-12
3175061007,JAKARTA TIMUR,CAKUNG,CAKUNG BARAT,57724,22044,35680,12125,47805,2021-08-12
3175061004,JAKARTA TIMUR,CAKUNG,CAKUNG TIMUR,58287,22848,35439,14338,49777,2021-08-12
3175041007,JAKARTA TIMUR,KRAMAT JATI,CAWANG,32762,14935,17827,7948,25775,2021-08-12
3175101008,JAKARTA TIMUR,CIPAYUNG,CEGER,18932,7566,11366,4734,16100,2021-08-12
3171031006,JAKARTA PUSAT,KEMAYORAN,CEMPAKA BARU,32581,14747,17834,7826,25660,2021-08-12
3171051002,JAKARTA PUSAT,CEMPAKA PUTIH,CEMPAKA PUTIH BARAT,35885,15218,20667,9613,30280,2021-08-12
3171051001,JAKARTA PUSAT,CEMPAKA PUTIH,CEMPAKA PUTIH TIMUR,24292,10320,13972,7490,21462,2021-08-12
3173011001,JAKARTA BARAT,CENGKARENG,CENGKARENG BARAT,66284,27189,39095,18118,57213,2021-08-12
3173011006,JAKARTA BARAT,CENGKARENG,CENGKARENG TIMUR,81027,33381,47646,18915,66561,2021-08-12
3175091002,JAKARTA TIMUR,CIRACAS,CIBUBUR,66364,25948,40416,19410,59826,2021-08-12
3171011002,JAKARTA PUSAT,GAMBIR,CIDENG,15390,5763,9627,5059,14686,2021-08-12
3174091003,JAKARTA SELATAN,JAGAKARSA,CIGANJUR,38497,15699,22798,10686,33484,2021-08-12
3175051003,JAKARTA TIMUR,PASAR REBO,CIJANTUNG,41419,16386,25033,12144,37177,2021-08-12
3171061003,JAKARTA PUSAT,MENTENG,CIKINI,8274,3769,4505,2236,6741,2021-08-12
3174081006,JAKARTA SELATAN,PANCORAN,CIKOKO,10547,3931,6616,3075,9691,2021-08-12
3174061001,JAKARTA SELATAN,CILANDAK,CILANDAK BARAT,51752,20725,31027,16134,47161,2021-08-12
3174041003,JAKARTA SELATAN,PASAR MINGGU,CILANDAK TIMUR,25145,9886,15259,8444,23703,2021-08-12
3175101002,JAKARTA TIMUR,CIPAYUNG,CILANGKAP,27635,10967,16668,7290,23958,2021-08-12
3175041006,JAKARTA TIMUR,KRAMAT JATI,CILILITAN,40181,18715,21466,9439,30905,2021-08-12
3172041001,JAKARTA UTARA,CILINCING,CILINCING,43609,19203,24406,10271,34677,2021-08-12
3175101001,JAKARTA TIMUR,CIPAYUNG,CIPAYUNG,26104,9671,16433,8044,24477,2021-08-12
3174091006,JAKARTA SELATAN,JAGAKARSA,CIPEDAK,38303,14451,23852,11541,35393,2021-08-12
3174061005,JAKARTA SELATAN,CILANDAK,CIPETE SELATAN,26704,11150,15554,8074,23628,2021-08-12
3174071010,JAKARTA SELATAN,KEBAYORAN BARU,CIPETE UTARA,34102,14175,19927,9256,29183,2021-08-12
3175021003,JAKARTA TIMUR,PULO GADUNG,CIPINANG,39306,16651,22655,10746,33401,2021-08-12
3175031007,JAKARTA TIMUR,JATINEGARA,CIPINANG BESAR SELATAN,35212,17217,17995,7103,25098,2021-08-12
3175031008,JAKARTA TIMUR,JATINEGARA,CIPINANG BESAR UTARA,45319,21034,24285,8690,32975,2021-08-12
3175031005,JAKARTA TIMUR,JATINEGARA,CIPINANG CEMPEDAK,32824,15085,17739,8348,26087,2021-08-12
3175081005,JAKARTA TIMUR,MAKASAR,CIPINANG MELAYU,42308,18193,24115,11552,35667,2021-08-12
3175031006,JAKARTA TIMUR,JATINEGARA,CIPINANG MUARA,55243,25090,30153,12801,42954,2021-08-12
3174051003,JAKARTA SELATAN,KEBAYORAN LAMA,CIPULIR,39937,17656,22281,9380,31661,2021-08-12
3175091001,JAKARTA TIMUR,CIRACAS,CIRACAS,64594,25170,39424,17078,56502,2021-08-12
3175041003,JAKARTA TIMUR,KRAMAT JATI,DUKUH,24609,10096,14513,6091,20604,2021-08-12
3175071001,JAKARTA TIMUR,DUREN SAWIT,DUREN SAWIT,61160,27834,33326,16427,49753,2021-08-12
3174081004,JAKARTA SELATAN,PANCORAN,DUREN TIGA,28319,11609,16710,7013,23723,2021-08-12
3173051005,JAKARTA BARAT,KEBON JERUK,DURI KEPA,60138,23604,36534,17964,54498,2021-08-12
3173011002,JAKARTA BARAT,CENGKARENG,DURI KOSAMBI,77923,35610,42313,17455,59768,2021-08-12
3171011006,JAKARTA PUSAT,GAMBIR,DURI PULO,19610,8035,11575,4337,15912,2021-08-12
3173041011,JAKARTA BARAT,TAMBORA,DURI SELATAN,14259,5203,9056,3945,13001,2021-08-12
3173041003,JAKARTA BARAT,TAMBORA,DURI UTARA,19844,7655,12189,5030,17219,2021-08-12
3171081003,JAKARTA PUSAT,JOHAR BARU,GALUR,18243,6550,11693,4148,15841,2021-08-12
3171011001,JAKARTA PUSAT,GAMBIR,GAMBIR,2191,812,1379,763,2142,2021-08-12
3174061004,JAKARTA SELATAN,CILANDAK,GANDARIA SELATAN,22119,9123,12996,6194,19190,2021-08-12
3174071009,JAKARTA SELATAN,KEBAYORAN BARU,GANDARIA UTARA,39922,16958,22964,10569,33533,2021-08-12
3175051001,JAKARTA TIMUR,PASAR REBO,GEDONG,35755,14346,21409,9959,31368,2021-08-12
3171071001,JAKARTA PUSAT,TANAH ABANG,GELORA,3127,1340,1787,851,2638,2021-08-12
3173031007,JAKARTA BARAT,TAMAN SARI,GLODOK,7837,2702,5135,3121,8256,2021-08-12
3171061004,JAKARTA PUSAT,MENTENG,GONDANGDIA,4100,1669,2431,1698,4129,2021-08-12
3173021001,JAKARTA BARAT,GROGOL PETAMBURAN,GROGOL,16876,6875,10001,4831,14832,2021-08-12
3174051005,JAKARTA SELATAN,KEBAYORAN LAMA,GROGOL SELATAN,44251,19242,25009,10436,35445,2021-08-12
3174051004,JAKARTA SELATAN,KEBAYORAN LAMA,GROGOL UTARA,42494,17887,24607,10670,35277,2021-08-12
3174021007,JAKARTA SELATAN,SETIA BUDI,GUNTUR,3985,1551,2434,1510,3944,2021-08-12
3174071002,JAKARTA SELATAN,KEBAYORAN BARU,GUNUNG,9436,3670,5766,3407,9173,2021-08-12
3171031005,JAKARTA PUSAT,KEMAYORAN,GUNUNG SAHARI SELATAN,19199,8014,11185,5583,16768,2021-08-12
3171021004,JAKARTA PUSAT,SAWAH BESAR,GUNUNG SAHARI UTARA,16650,5940,10710,5699,16409,2021-08-12
3175081004,JAKARTA TIMUR,MAKASAR,HALIM PERDANA KUSUMAH,28363,8974,19389,13340,32729,2021-08-12
3171031003,JAKARTA PUSAT,KEMAYORAN,HARAPAN MULIA,22557,9542,13015,5699,18714,2021-08-12
3174091001,JAKARTA SELATAN,JAGAKARSA,JAGAKARSA,62389,24351,38038,18446,56484,2021-08-12
3175021007,JAKARTA TIMUR,PULO GADUNG,JATI,32757,13695,19062,9544,28606,2021-08-12
3174041002,JAKARTA SELATAN,PASAR MINGGU,JATI PADANG,37502,15573,21929,11214,33143,2021-08-12
3173071004,JAKARTA BARAT,PALMERAH,JATI PULO,28738,11417,17321,6372,23693,2021-08-12
3175061001,JAKARTA TIMUR,CAKUNG,JATINEGARA,84160,36166,47994,16497,64491,2021-08-12
3175021004,JAKARTA TIMUR,PULO GADUNG,JATINEGARA KAUM,24632,9590,15042,5541,20583,2021-08-12
3173021004,JAKARTA BARAT,GROGOL PETAMBURAN,JELAMBAR,30266,12138,18128,9581,27709,2021-08-12
3173021006,JAKARTA BARAT,GROGOL PETAMBURAN,JELAMBAR BARU,38246,15530,22716,11473,34189,2021-08-12
3173041006,JAKARTA BARAT,TAMBORA,JEMBATAN BESI,29314,14318,14996,5156,20152,2021-08-12
3173041008,JAKARTA BARAT,TAMBORA,JEMBATAN LIMA,21021,9636,11385,4818,16203,2021-08-12
3173081005,JAKARTA BARAT,KEMBANGAN,JOGLO,40839,17467,23372,10468,33840,2021-08-12
3171081001,JAKARTA PUSAT,JOHAR BARU,JOHAR BARU,37488,14186,23302,10261,33563,2021-08-12
3173041002,JAKARTA BARAT,TAMBORA,KALI ANYAR,23856,9134,14722,4571,19293,2021-08-12
3172041004,JAKARTA UTARA,CILINCING,KALIBARU,67684,32062,35622,13619,49241,2021-08-12
3174081002,JAKARTA SELATAN,PANCORAN,KALIBATA,41994,19200,22794,9393,32187,2021-08-12
3173061001,JAKARTA BARAT,KALI DERES,KALIDERES,72447,29696,42751,17553,60304,2021-08-12
3175051004,JAKARTA TIMUR,PASAR REBO,KALISARI,43212,17417,25795,12398,38193,2021-08-12
3173061004,JAKARTA BARAT,KALI DERES,KAMAL,53783,23423,30360,8316,38676,2021-08-12
3172011002,JAKARTA UTARA,PENJARINGAN,KAMAL MUARA,12930,4008,8922,5085,14007,2021-08-12
3171071007,JAKARTA PUSAT,TANAH ABANG,KAMPUNG BALI,11358,5401,5957,2697,8654,2021-08-12
3175031001,JAKARTA TIMUR,JATINEGARA,KAMPUNG MELAYU,25717,11836,13881,5302,19183,2021-08-12
3171081002,JAKARTA PUSAT,JOHAR BARU,KAMPUNG RAWA,21237,6896,14341,5289,19630,2021-08-12
3175041002,JAKARTA TIMUR,KRAMAT JATI,KAMPUNG TENGAH,43993,21024,22969,9375,32344,2021-08-12
3173011005,JAKARTA BARAT,CENGKARENG,KAPUK,134466,60393,74073,23519,97592,2021-08-12
3172011003,JAKARTA UTARA,PENJARINGAN,KAPUK MUARA,35781,12937,22844,12864,35708,2021-08-12
3171021002,JAKARTA PUSAT,SAWAH BESAR,KARANG ANYAR,25761,10136,15625,6679,22304,2021-08-12
3174021004,JAKARTA SELATAN,SETIA BUDI,KARET,9623,4127,5496,2838,8334,2021-08-12
3174021003,JAKARTA SELATAN,SETIA BUDI,KARET KUNINGAN,16055,6114,9941,4951,14892,2021-08-12
3174021002,JAKARTA SELATAN,SETIA BUDI,KARET SEMANGGI,2770,1013,1757,1132,2889,2021-08-12
3171071003,JAKARTA PUSAT,TANAH ABANG,KARET TENGSIN,19271,8096,11175,4574,15749,2021-08-12
3171021003,JAKARTA PUSAT,SAWAH BESAR,KARTINI,22292,8815,13477,6643,20120,2021-08-12
3175011003,JAKARTA TIMUR,MATRAMAN,KAYU MANIS,25284,11462,13822,5787,19609,2021-08-12
3175021006,JAKARTA TIMUR,PULO GADUNG,KAYU PUTIH,40696,15820,24876,13090,37966,2021-08-12
3173031006,JAKARTA BARAT,TAMAN SARI,KEAGUNGAN,17387,6761,10626,4590,15216,2021-08-12
3174041007,JAKARTA SELATAN,PASAR MINGGU,KEBAGUSAN,44552,19124,25428,11335,36763,2021-08-12
3174051006,JAKARTA SELATAN,KEBAYORAN LAMA,KEBAYORAN LAMA SELATAN,41212,16867,24345,10772,35117,2021-08-12
3174051001,JAKARTA SELATAN,KEBAYORAN LAMA,KEBAYORAN LAMA UTARA,42422,18387,24035,9871,33906,2021-08-12
3174011004,JAKARTA SELATAN,TEBET,KEBON BARU,35165,14563,20602,9605,30207,2021-08-12
3172021005,JAKARTA UTARA,TANJUNG PRIOK,KEBON BAWANG,50952,21818,29134,14113,43247,2021-08-12
3173051001,JAKARTA BARAT,KEBON JERUK,KEBON JERUK,53887,24189,29698,12702,42400,2021-08-12
3171071006,JAKARTA PUSAT,TANAH ABANG,KEBON KACANG,21531,10610,10921,4808,15729,2021-08-12
3171011005,JAKARTA PUSAT,GAMBIR,KEBON KELAPA,10163,4112,6051,2907,8958,2021-08-12
3171031002,JAKARTA PUSAT,KEMAYORAN,KEBON KOSONG,30019,12798,17221,7876,25097,2021-08-12
3175011005,JAKARTA TIMUR,MATRAMAN,KEBON MANGGIS,16490,6755,9735,4792,14527,2021-08-12
3171071005,JAKARTA PUSAT,TANAH ABANG,KEBON MELATI,32206,16937,15269,5296,20565,2021-08-12
3175081003,JAKARTA TIMUR,MAKASAR,KEBON PALA,46614,19757,26857,11034,37891,2021-08-12
3171061005,JAKARTA PUSAT,MENTENG,KEBON SIRIH,12299,5660,6639,2831,9470,2021-08-12
3173011004,JAKARTA BARAT,CENGKARENG,KEDAUNG KALI ANGKE,32612,12165,20447,6990,27437,2021-08-12
3173051007,JAKARTA BARAT,KEBON JERUK,KEDOYA SELATAN,32165,12815,19350,7832,27182,2021-08-12
3173051006,JAKARTA BARAT,KEBON JERUK,KEDOYA UTARA,45740,17056,28684,12438,41122,2021-08-12
3173051004,JAKARTA BARAT,KEBON JERUK,KELAPA DUA,23565,10162,13403,5621,19024,2021-08-12
3175091003,JAKARTA TIMUR,CIRACAS,KELAPA DUA WETAN,46875,18073,28802,12972,41774,2021-08-12
3172061003,JAKARTA UTARA,KELAPA GADING,KELAPA GADING BARAT,35717,12777,22940,14444,37384,2021-08-12
3172061001,JAKARTA UTARA,KELAPA GADING,KELAPA GADING TIMUR,33592,11142,22450,14181,36631,2021-08-12
3173071005,JAKARTA BARAT,PALMERAH,KEMANGGISAN,32139,13756,18383,8466,26849,2021-08-12
3171031001,JAKARTA PUSAT,KEMAYORAN,KEMAYORAN,20708,8294,12414,5743,18157,2021-08-12
3173081006,JAKARTA BARAT,KEMBANGAN,KEMBANGAN SELATAN,27130,11138,15992,8096,24088,2021-08-12
3173081001,JAKARTA BARAT,KEMBANGAN,KEMBANGAN UTARA,54451,22283,32168,12854,45022,2021-08-12
3171041002,JAKARTA PUSAT,SENEN,KENARI,9579,3735,5844,2754,8598,2021-08-12
3173041005,JAKARTA BARAT,TAMBORA,KERENDANG,19973,8293,11680,4930,16610,2021-08-12
3175071003,JAKARTA TIMUR,DUREN SAWIT,KLENDER,69978,32891,37087,14283,51370,2021-08-12
3172031001,JAKARTA UTARA,KOJA,KOJA,28175,12142,16033,7710,23743,2021-08-12
3173071006,JAKARTA BARAT,PALMERAH,KOTA BAMBU SELATAN,21158,9054,12104,4695,16799,2021-08-12
3173071003,JAKARTA BARAT,PALMERAH,KOTA BAMBU UTARA,24995,11087,13908,5350,19258,2021-08-12
3171041004,JAKARTA PUSAT,SENEN,KRAMAT,28835,13464,15371,6152,21523,2021-08-12
3175041001,JAKARTA TIMUR,KRAMAT JATI,KRAMAT JATI,34144,14599,19545,8154,27699,2021-08-12
3174071003,JAKARTA SELATAN,KEBAYORAN BARU,KRAMAT PELA,14413,5836,8577,4225,12802,2021-08-12
3173031002,JAKARTA BARAT,TAMAN SARI,KRUKUT,19244,7700,11544,4671,16215,2021-08-12
3174031005,JAKARTA SELATAN,MAMPANG PRAPATAN,KUNINGAN BARAT,12785,5123,7662,3785,11447,2021-08-12
3174021008,JAKARTA SELATAN,SETIA BUDI,KUNINGAN TIMUR,6008,2461,3547,1880,5427,2021-08-12
3171041005,JAKARTA PUSAT,SENEN,KWITANG,15486,6352,9134,3901,13035,2021-08-12
3172031003,JAKARTA UTARA,KOJA,LAGOA,59065,27205,31860,13588,45448,2021-08-12
3174061002,JAKARTA SELATAN,CILANDAK,LEBAK BULUS,37626,16009,21617,11078,32695,2021-08-12
3174091004,JAKARTA SELATAN,JAGAKARSA,LENTENG AGUNG,53946,22986,30960,12588,43548,2021-08-12
3175101007,JAKARTA TIMUR,CIPAYUNG,LUBANG BUAYA,63547,25194,38353,17849,56202,2021-08-12
3175081001,JAKARTA TIMUR,MAKASAR,MAKASAR,34390,13761,20629,9328,29957,2021-08-12
3175071006,JAKARTA TIMUR,DUREN SAWIT,MALAKA JAYA,30927,12873,18054,9695,27749,2021-08-12
3175071005,JAKARTA TIMUR,DUREN SAWIT,MALAKA SARI,27530,11233,16297,8789,25086,2021-08-12
3174031001,JAKARTA SELATAN,MAMPANG PRAPATAN,MAMPANG PRAPATAN,18159,7471,10688,5184,15872,2021-08-12
3173031005,JAKARTA BARAT,TAMAN SARI,MANGGA BESAR,7707,2792,4915,2575,7490,2021-08-12
3171021005,JAKARTA PUSAT,SAWAH BESAR,MANGGA DUA SELATAN,27442,11139,16303,7816,24119,2021-08-12
3174011007,JAKARTA SELATAN,TEBET,MANGGARAI,28373,11059,17314,7020,24334,2021-08-12
3174011006,JAKARTA SELATAN,TEBET,MANGGARAI SELATAN,23075,9048,14027,6618,20645,2021-08-12
3173031003,JAKARTA BARAT,TAMAN SARI,MAPHAR,16461,6729,9732,4789,14521,2021-08-12
3172041003,JAKARTA UTARA,CILINCING,MARUNDA,28943,11706,17237,6357,23594,2021-08-12
3174071001,JAKARTA SELATAN,KEBAYORAN BARU,MELAWAI,2627,973,1654,1200,2854,2021-08-12
3171061001,JAKARTA PUSAT,MENTENG,MENTENG,25624,11444,14180,6271,20451,2021-08-12
3174021005,JAKARTA SELATAN,SETIA BUDI,MENTENG ATAS,27816,10955,16861,7632,24493,2021-08-12
3174011003,JAKARTA SELATAN,TEBET,MENTENG DALAM,36028,14780,21248,9835,31083,2021-08-12
3173081003,JAKARTA BARAT,KEMBANGAN,MERUYA SELATAN,32130,13302,18828,7954,26782,2021-08-12
3173081002,JAKARTA BARAT,KEMBANGAN,MERUYA UTARA,43752,18241,25511,11904,37415,2021-08-12
3175101004,JAKARTA TIMUR,CIPAYUNG,MUNJUL,23871,9164,14707,6332,21039,2021-08-12
3172051002,JAKARTA UTARA,PADEMANGAN,PADEMANGAN BARAT,74240,32027,42213,17696,59909,2021-08-12
3172051001,JAKARTA UTARA,PADEMANGAN,PADEMANGAN TIMUR,37736,13750,23986,12224,36210,2021-08-12
3175011004,JAKARTA TIMUR,MATRAMAN,PAL MERIAM,19769,8606,11163,5093,16256,2021-08-12
3173071001,JAKARTA BARAT,PALMERAH,PALMERAH,63011,27116,35895,14640,50535,2021-08-12
3174081001,JAKARTA SELATAN,PANCORAN,PANCORAN,19421,8047,11374,5465,16839,2021-08-12
3172021003,JAKARTA UTARA,TANJUNG PRIOK,PAPANGGO,39097,15225,23872,11121,34993,2021-08-12
3171021001,JAKARTA PUSAT,SAWAH BESAR,PASAR BARU,12035,4197,7838,4255,12093,2021-08-12
3174021006,JAKARTA SELATAN,SETIA BUDI,PASAR MANGGIS,26752,11416,15336,7618,22954,2021-08-12
3174041001,JAKARTA SELATAN,PASAR MINGGU,PASAR MINGGU,24821,10111,14710,7775,22485,2021-08-12
3171041003,JAKARTA PUSAT,SENEN,PASEBAN,23533,10083,13450,5907,19357,2021-08-12
3173061005,JAKARTA BARAT,KALI DERES,PEGADUNGAN,75587,29035,46552,20083,66635,2021-08-12
3171061002,JAKARTA PUSAT,MENTENG,PEGANGSAAN,23455,10714,12741,5310,18051,2021-08-12
3172061002,JAKARTA UTARA,KELAPA GADING,PEGANGSAAN DUA,49976,16378,33598,18778,52376,2021-08-12
3172011004,JAKARTA UTARA,PENJARINGAN,PEJAGALAN,74578,30017,44561,22643,67204,2021-08-12
3174041006,JAKARTA SELATAN,PASAR MINGGU,PEJATEN BARAT,37346,16129,21217,10921,32138,2021-08-12
3174041005,JAKARTA SELATAN,PASAR MINGGU,PEJATEN TIMUR,57656,25701,31955,14117,46072,2021-08-12
3175051005,JAKARTA TIMUR,PASAR REBO,PEKAYON,43250,16988,26262,11531,37793,2021-08-12
3173041009,JAKARTA BARAT,TAMBORA,PEKOJAN,23587,9346,14241,6720,20961,2021-08-12
3174031003,JAKARTA SELATAN,MAMPANG PRAPATAN,PELA MAMPANG,43522,17843,25679,12677,38356,2021-08-12
3174081005,JAKARTA SELATAN,PANCORAN,PENGADEGAN,21478,8088,13390,6023,19413,2021-08-12
3175061003,JAKARTA TIMUR,CAKUNG,PENGGILINGAN,99255,45901,53354,18183,71537,2021-08-12
3172011001,JAKARTA UTARA,PENJARINGAN,PENJARINGAN,88308,40357,47951,19866,67817,2021-08-12
3174101001,JAKARTA SELATAN,PESANGGRAHAN,PESANGGRAHAN,27545,10450,17095,8797,25892,2021-08-12
3171071004,JAKARTA PUSAT,TANAH ABANG,PETAMBURAN,33271,17175,16096,5684,21780,2021-08-12
3174071008,JAKARTA SELATAN,KEBAYORAN BARU,PETOGOGAN,11499,4698,6801,3696,10497,2021-08-12
3171011004,JAKARTA PUSAT,GAMBIR,PETOJO SELATAN,14692,6064,8628,4452,13080,2021-08-12
3171011003,JAKARTA PUSAT,GAMBIR,PETOJO UTARA,17458,7223,10235,4479,14714,2021-08-12
3174101004,JAKARTA SELATAN,PESANGGRAHAN,PETUKANGAN SELATAN,37187,15172,22015,9586,31601,2021-08-12
3174101003,JAKARTA SELATAN,PESANGGRAHAN,PETUKANGAN UTARA,53716,23416,30300,13835,44135,2021-08-12
3175081002,JAKARTA TIMUR,MAKASAR,PINANG RANTI,27198,11539,15659,6893,22552,2021-08-12
3173031008,JAKARTA BARAT,TAMAN SARI,PINANGSIA,10729,3998,6731,3404,10135,2021-08-12
3175011001,JAKARTA TIMUR,MATRAMAN,PISANGAN BARU,31776,14186,17590,6987,24577,2021-08-12
3175021002,JAKARTA TIMUR,PULO GADUNG,PISANGAN TIMUR,41011,16140,24871,10490,35361,2021-08-12
3172011005,JAKARTA UTARA,PENJARINGAN,PLUIT,47783,18610,29173,18891,48064,2021-08-12
3175071002,JAKARTA TIMUR,DUREN SAWIT,PONDOK BAMBU,61550,27940,33610,15489,49099,2021-08-12
3175071004,JAKARTA TIMUR,DUREN SAWIT,PONDOK KELAPA,72015,29625,42390,19447,61837,2021-08-12
3175071007,JAKARTA TIMUR,DUREN SAWIT,PONDOK KOPI,35367,16711,18656,7869,26525,2021-08-12
3174061003,JAKARTA SELATAN,CILANDAK,PONDOK LABU,46464,18091,28373,14333,42706,2021-08-12
3174051002,JAKARTA SELATAN,KEBAYORAN LAMA,PONDOK PINANG,56169,23026,33143,16739,49882,2021-08-12
3175101003,JAKARTA TIMUR,CIPAYUNG,PONDOK RANGGON,25574,10378,15196,6823,22019,2021-08-12
3101011003,KAB.ADM.KEP.SERIBU,KEP. SERIBU UTARA,PULAU HARAPAN,2060,382,1678,880,2558,2021-08-12
3101011002,KAB.ADM.KEP.SERIBU,KEP. SERIBU UTARA,PULAU KELAPA,5528,1098,4430,1920,6350,2021-08-12
3101011001,KAB.ADM.KEP.SERIBU,KEP. SERIBU UTARA,PULAU PANGGANG,5450,985,4465,1808,6273,2021-08-12
3101021003,KAB.ADM.KEP.SERIBU,KEP. SERIBU SELATAN,PULAU PARI,2765,354,2411,1243,3654,2021-08-12
3101021002,KAB.ADM.KEP.SERIBU,KEP. SERIBU SELATAN,PULAU TIDUNG,4553,747,3806,2322,6128,2021-08-12
3101021001,KAB.ADM.KEP.SERIBU,KEP. SERIBU SELATAN,PULAU UNTUNG JAWA,1941,393,1548,779,2327,2021-08-12
3174071007,JAKARTA SELATAN,KEBAYORAN BARU,PULO,5835,2175,3660,2292,5952,2021-08-12
3175021001,JAKARTA TIMUR,PULO GADUNG,PULO GADUNG,34422,14590,19832,8886,28718,2021-08-12
3175061005,JAKARTA TIMUR,CAKUNG,PULO GEBANG,97301,42734,54567,20518,75085,2021-08-12
3174041004,JAKARTA SELATAN,PASAR MINGGU,RAGUNAN,39616,15602,24014,11892,35906,2021-08-12
3175091005,JAKARTA TIMUR,CIRACAS,RAMBUTAN,36771,17267,19504,8245,27749,2021-08-12
3172031006,JAKARTA UTARA,KOJA,RAWA BADAK SELATAN,42179,19622,22557,9050,31607,2021-08-12
3172031004,JAKARTA UTARA,KOJA,RAWA BADAK UTARA,34408,15531,18877,9011,27888,2021-08-12
3174071005,JAKARTA SELATAN,KEBAYORAN BARU,RAWA BARAT,5625,2124,3501,2061,5562,2021-08-12
3173011003,JAKARTA BARAT,CENGKARENG,RAWA BUAYA,63799,27546,36253,12622,48875,2021-08-12
3175031004,JAKARTA TIMUR,JATINEGARA,RAWA BUNGA,21434,9728,11706,4566,16272,2021-08-12
3174081003,JAKARTA SELATAN,PANCORAN,RAWA JATI,20509,8224,12285,6087,18372,2021-08-12
3175061002,JAKARTA TIMUR,CAKUNG,RAWA TERATE,24637,9229,15408,4918,20326,2021-08-12
3175021005,JAKARTA TIMUR,PULO GADUNG,RAWAMANGUN,37612,15862,21750,10287,32037,2021-08-12
3171051003,JAKARTA PUSAT,CEMPAKA PUTIH,RAWASARI,21967,9281,12686,6409,19095,2021-08-12
3173041010,JAKARTA BARAT,TAMBORA,ROA MALAKA,3484,1219,2265,1349,3614,2021-08-12
3172041006,JAKARTA UTARA,CILINCING,ROROTAN,41668,16575,25093,9858,34951,2021-08-12
3174071004,JAKARTA SELATAN,KEBAYORAN BARU,SELONG,2842,1054,1788,1240,3028,2021-08-12
3173061002,JAKARTA BARAT,KALI DERES,SEMANAN,71354,31017,40337,11718,52055,2021-08-12
3172041007,JAKARTA UTARA,CILINCING,SEMPER BARAT,68587,26212,42375,19613,61988,2021-08-12
3172041005,JAKARTA UTARA,CILINCING,SEMPER TIMUR,36267,14762,21505,9870,31375,2021-08-12
3174071006,JAKARTA SELATAN,KEBAYORAN BARU,SENAYAN,2771,1271,1500,894,2394,2021-08-12
3171041001,JAKARTA PUSAT,SENEN,SENEN,6804,2673,4131,2081,6212,2021-08-12
3171031004,JAKARTA PUSAT,KEMAYORAN,SERDANG,29668,12230,17438,7588,25026,2021-08-12
3174021001,JAKARTA SELATAN,SETIA BUDI,SETIA BUDI,3023,1288,1735,997,2732,2021-08-12
3175101005,JAKARTA TIMUR,CIPAYUNG,SETU,20572,9005,11567,4615,16182,2021-08-12
3173071002,JAKARTA BARAT,PALMERAH,SLIPI,16591,6709,9882,4780,14662,2021-08-12
3173081004,JAKARTA BARAT,KEMBANGAN,SRENGSENG,45523,20389,25134,11189,36323,2021-08-12
3174091002,JAKARTA SELATAN,JAGAKARSA,SRENGSENG SAWAH,58196,20972,37224,17638,54862,2021-08-12
3173051003,JAKARTA BARAT,KEBON JERUK,SUKABUMI SELATAN,37033,16713,20320,7636,27956,2021-08-12
3173051002,JAKARTA BARAT,KEBON JERUK,SUKABUMI UTARA,38290,18449,19841,7818,27659,2021-08-12
3172041002,JAKARTA UTARA,CILINCING,SUKAPURA,53949,22751,31198,13529,44727,2021-08-12
3171031007,JAKARTA PUSAT,KEMAYORAN,SUMUR BATU,22717,9592,13125,6547,19672,2021-08-12
3172021004,JAKARTA UTARA,TANJUNG PRIOK,SUNGAI BAMBU,29876,12027,17849,8559,26408,2021-08-12
3172021006,JAKARTA UTARA,TANJUNG PRIOK,SUNTER AGUNG,71805,25813,45992,24962,70954,2021-08-12
3172021002,JAKARTA UTARA,TANJUNG PRIOK,SUNTER JAYA,63031,23434,39597,20109,59706,2021-08-12
3175091004,JAKARTA TIMUR,CIRACAS,SUSUKAN,38257,14659,23598,10401,33999,2021-08-12
3173031001,JAKARTA BARAT,TAMAN SARI,TAMAN SARI,14348,5693,8655,4377,13032,2021-08-12
3173041001,JAKARTA BARAT,TAMBORA,TAMBORA,10204,4365,5839,2569,8408,2021-08-12
3173041004,JAKARTA BARAT,TAMBORA,TANAH SEREAL,26387,9282,17105,7145,24250,2021-08-12
3171081004,JAKARTA PUSAT,JOHAR BARU,TANAH TINGGI,37693,13471,24222,9964,34186,2021-08-12
3173031004,JAKARTA BARAT,TAMAN SARI,TANGKI,13324,5285,8039,3823,11862,2021-08-12
3174091005,JAKARTA SELATAN,JAGAKARSA,TANJUNG BARAT,39770,15911,23859,10822,34681,2021-08-12
3173021005,JAKARTA BARAT,GROGOL PETAMBURAN,TANJUNG DUREN SELATAN,25337,9939,15398,7701,23099,2021-08-12
3173021002,JAKARTA BARAT,GROGOL PETAMBURAN,TANJUNG DUREN UTARA,17010,6320,10690,5658,16348,2021-08-12
3172021001,JAKARTA UTARA,TANJUNG PRIOK,TANJUNG PRIOK,34588,13149,21439,8661,30100,2021-08-12
3174011002,JAKARTA SELATAN,TEBET,TEBET BARAT,21194,7935,13259,7294,20553,2021-08-12
3174011001,JAKARTA SELATAN,TEBET,TEBET TIMUR,18199,6788,11411,6418,17829,2021-08-12
3173061003,JAKARTA BARAT,KALI DERES,TEGAL ALUR,83647,34262,49385,16247,65632,2021-08-12
3174031004,JAKARTA SELATAN,MAMPANG PRAPATAN,TEGAL PARANG,32401,14400,18001,7586,25587,2021-08-12
3173021003,JAKARTA BARAT,GROGOL PETAMBURAN,TOMANG,29605,11818,17787,9073,26860,2021-08-12
3172031005,JAKARTA UTARA,KOJA,TUGU SELATAN,39122,17563,21559,9240,30799,2021-08-12
3172031002,JAKARTA UTARA,KOJA,TUGU UTARA,67670,31066,36604,16121,52725,2021-08-12
3175061006,JAKARTA TIMUR,CAKUNG,UJUNG MENTENG,29934,11390,18544,7530,26074,2021-08-12
3174101005,JAKARTA SELATAN,PESANGGRAHAN,ULUJAMI,40544,17831,22713,9407,32120,2021-08-12
3175011006,JAKARTA TIMUR,MATRAMAN,UTAN KAYU SELATAN,33511,13745,19766,9226,28992,2021-08-12
3175011002,JAKARTA TIMUR,MATRAMAN,UTAN KAYU UTARA,28169,12305,15864,7209,23073,2021-08-12
3171031008,JAKARTA PUSAT,KEMAYORAN,UTAN PANJANG,29208,12564,16644,6319,22963,2021-08-12
3172021007,JAKARTA UTARA,TANJUNG PRIOK,WARAKAS,44401,17941,26460,12354,38814,2021-08-12
3173021007,JAKARTA BARAT,GROGOL PETAMBURAN,WIJAYA KUSUMA,38934,16671,22263,9776,32039,2021-08-12
3172051003,JAKARTA UTARA,PADEMANGAN,ANCOL,23947,10281,13666,6089,19755,2021-08-13
3173041007,JAKARTA BARAT,TAMBORA,ANGKE,29381,11597,17784,7131,24915,2021-08-13
3175041005,JAKARTA TIMUR,KRAMAT JATI,BALE KAMBANG,29074,14493,14581,5366,19947,2021-08-13
3175031003,JAKARTA TIMUR,JATINEGARA,BALI MESTER,9752,4121,5631,2711,8342,2021-08-13
3175101006,JAKARTA TIMUR,CIPAYUNG,BAMBU APUS,26285,10725,15560,6852,22412,2021-08-13
3174031002,JAKARTA SELATAN,MAMPANG PRAPATAN,BANGKA,21566,9159,12407,5829,18236,2021-08-13
3175051002,JAKARTA TIMUR,PASAR REBO,BARU,23886,8747,15139,8459,23598,2021-08-13
3175041004,JAKARTA TIMUR,KRAMAT JATI,BATU AMPAR,47898,22852,25046,10350,35396,2021-08-13
3171071002,JAKARTA PUSAT,TANAH ABANG,BENDUNGAN HILIR,21494,8829,12665,6430,19095,2021-08-13
3175031002,JAKARTA TIMUR,JATINEGARA,BIDARA CINA,36689,17551,19138,8040,27178,2021-08-13
3174101002,JAKARTA SELATAN,PESANGGRAHAN,BINTARO,53098,21741,31357,15598,46955,2021-08-13
3174011005,JAKARTA SELATAN,TEBET,BUKIT DURI,34183,14952,19231,8795,28026,2021-08-13
3171041006,JAKARTA PUSAT,SENEN,BUNGUR,18144,7272,10872,5261,16133,2021-08-13
3175061007,JAKARTA TIMUR,CAKUNG,CAKUNG BARAT,57724,21899,35825,12702,48527,2021-08-13
3175061004,JAKARTA TIMUR,CAKUNG,CAKUNG TIMUR,58287,22619,35668,15205,50873,2021-08-13
3175041007,JAKARTA TIMUR,KRAMAT JATI,CAWANG,32762,14780,17982,8194,26176,2021-08-13
3175101008,JAKARTA TIMUR,CIPAYUNG,CEGER,18932,7495,11437,4906,16343,2021-08-13
3171031006,JAKARTA PUSAT,KEMAYORAN,CEMPAKA BARU,32581,14608,17973,8101,26074,2021-08-13
3171051002,JAKARTA PUSAT,CEMPAKA PUTIH,CEMPAKA PUTIH BARAT,35885,15030,20855,10069,30924,2021-08-13
3171051001,JAKARTA PUSAT,CEMPAKA PUTIH,CEMPAKA PUTIH TIMUR,24292,10072,14220,7654,21874,2021-08-13
3173011001,JAKARTA BARAT,CENGKARENG,CENGKARENG BARAT,66284,26877,39407,18935,58342,2021-08-13
3173011006,JAKARTA BARAT,CENGKARENG,CENGKARENG TIMUR,81027,32830,48197,19678,67875,2021-08-13
3175091002,JAKARTA TIMUR,CIRACAS,CIBUBUR,66364,25656,40708,20061,60769,2021-08-13
3171011002,JAKARTA PUSAT,GAMBIR,CIDENG,15390,5703,9687,5201,14888,2021-08-13
3174091003,JAKARTA SELATAN,JAGAKARSA,CIGANJUR,38497,15484,23013,11040,34053,2021-08-13
3175051003,JAKARTA TIMUR,PASAR REBO,CIJANTUNG,41419,16175,25244,12646,37890,2021-08-13
3171061003,JAKARTA PUSAT,MENTENG,CIKINI,8274,3738,4536,2276,6812,2021-08-13
3174081006,JAKARTA SELATAN,PANCORAN,CIKOKO,10547,3900,6647,3168,9815,2021-08-13
3174061001,JAKARTA SELATAN,CILANDAK,CILANDAK BARAT,51752,20526,31226,16624,47850,2021-08-13
3174041003,JAKARTA SELATAN,PASAR MINGGU,CILANDAK TIMUR,25145,9801,15344,8747,24091,2021-08-13
3175101002,JAKARTA TIMUR,CIPAYUNG,CILANGKAP,27635,10866,16769,7558,24327,2021-08-13
3175041006,JAKARTA TIMUR,KRAMAT JATI,CILILITAN,40181,18456,21725,9723,31448,2021-08-13
3172041001,JAKARTA UTARA,CILINCING,CILINCING,43609,18891,24718,10743,35461,2021-08-13
3175101001,JAKARTA TIMUR,CIPAYUNG,CIPAYUNG,26104,9573,16531,8275,24806,2021-08-13
3174091006,JAKARTA SELATAN,JAGAKARSA,CIPEDAK,38303,14284,24019,12121,36140,2021-08-13
3174061005,JAKARTA SELATAN,CILANDAK,CIPETE SELATAN,26704,11037,15667,8461,24128,2021-08-13
3174071010,JAKARTA SELATAN,KEBAYORAN BARU,CIPETE UTARA,34102,14022,20080,9788,29868,2021-08-13
3175021003,JAKARTA TIMUR,PULO GADUNG,CIPINANG,39306,16529,22777,11084,33861,2021-08-13
3175031007,JAKARTA TIMUR,JATINEGARA,CIPINANG BESAR SELATAN,35212,16950,18262,7404,25666,2021-08-13
3175031008,JAKARTA TIMUR,JATINEGARA,CIPINANG BESAR UTARA,45319,20757,24562,9033,33595,2021-08-13
3175031005,JAKARTA TIMUR,JATINEGARA,CIPINANG CEMPEDAK,32824,14960,17864,8812,26676,2021-08-13
3175081005,JAKARTA TIMUR,MAKASAR,CIPINANG MELAYU,42308,17992,24316,11923,36239,2021-08-13
3175031006,JAKARTA TIMUR,JATINEGARA,CIPINANG MUARA,55243,24830,30413,13284,43697,2021-08-13
3174051003,JAKARTA SELATAN,KEBAYORAN LAMA,CIPULIR,39937,17530,22407,9571,31978,2021-08-13
3175091001,JAKARTA TIMUR,CIRACAS,CIRACAS,64594,24960,39634,17572,57206,2021-08-13
3175041003,JAKARTA TIMUR,KRAMAT JATI,DUKUH,24609,9937,14672,6447,21119,2021-08-13
3175071001,JAKARTA TIMUR,DUREN SAWIT,DUREN SAWIT,61160,27557,33603,16822,50425,2021-08-13
3174081004,JAKARTA SELATAN,PANCORAN,DUREN TIGA,28319,11524,16795,7415,24210,2021-08-13
3173051005,JAKARTA BARAT,KEBON JERUK,DURI KEPA,60138,23232,36906,18436,55342,2021-08-13
3173011002,JAKARTA BARAT,CENGKARENG,DURI KOSAMBI,77923,35243,42680,17970,60650,2021-08-13
3171011006,JAKARTA PUSAT,GAMBIR,DURI PULO,19610,7958,11652,4488,16140,2021-08-13
3173041011,JAKARTA BARAT,TAMBORA,DURI SELATAN,14259,5156,9103,4068,13171,2021-08-13
3173041003,JAKARTA BARAT,TAMBORA,DURI UTARA,19844,7597,12247,5157,17404,2021-08-13
3171081003,JAKARTA PUSAT,JOHAR BARU,GALUR,18243,6476,11767,4502,16269,2021-08-13
3171011001,JAKARTA PUSAT,GAMBIR,GAMBIR,2191,805,1386,768,2154,2021-08-13
3174061004,JAKARTA SELATAN,CILANDAK,GANDARIA SELATAN,22119,9034,13085,6593,19678,2021-08-13
3174071009,JAKARTA SELATAN,KEBAYORAN BARU,GANDARIA UTARA,39922,16711,23211,11056,34267,2021-08-13
3175051001,JAKARTA TIMUR,PASAR REBO,GEDONG,35755,14151,21604,10418,32022,2021-08-13
3171071001,JAKARTA PUSAT,TANAH ABANG,GELORA,3127,1330,1797,877,2674,2021-08-13
3173031007,JAKARTA BARAT,TAMAN SARI,GLODOK,7837,2692,5145,3158,8303,2021-08-13
3171061004,JAKARTA PUSAT,MENTENG,GONDANGDIA,4100,1660,2440,1717,4157,2021-08-13
3173021001,JAKARTA BARAT,GROGOL PETAMBURAN,GROGOL,16876,6806,10070,4996,15066,2021-08-13
3174051005,JAKARTA SELATAN,KEBAYORAN LAMA,GROGOL SELATAN,44251,19042,25209,10803,36012,2021-08-13
3174051004,JAKARTA SELATAN,KEBAYORAN LAMA,GROGOL UTARA,42494,17718,24776,11112,35888,2021-08-13
3174021007,JAKARTA SELATAN,SETIA BUDI,GUNTUR,3985,1532,2453,1578,4031,2021-08-13
3174071002,JAKARTA SELATAN,KEBAYORAN BARU,GUNUNG,9436,3644,5792,3487,9279,2021-08-13
3171031005,JAKARTA PUSAT,KEMAYORAN,GUNUNG SAHARI SELATAN,19199,7896,11303,5761,17064,2021-08-13
3171021004,JAKARTA PUSAT,SAWAH BESAR,GUNUNG SAHARI UTARA,16650,5863,10787,5903,16690,2021-08-13
3175081004,JAKARTA TIMUR,MAKASAR,HALIM PERDANA KUSUMAH,28363,8866,19497,13661,33158,2021-08-13
3171031003,JAKARTA PUSAT,KEMAYORAN,HARAPAN MULIA,22557,9439,13118,5912,19030,2021-08-13
3174091001,JAKARTA SELATAN,JAGAKARSA,JAGAKARSA,62389,24112,38277,19216,57493,2021-08-13
3175021007,JAKARTA TIMUR,PULO GADUNG,JATI,32757,13539,19218,9818,29036,2021-08-13
3174041002,JAKARTA SELATAN,PASAR MINGGU,JATI PADANG,37502,15422,22080,11622,33702,2021-08-13
3173071004,JAKARTA BARAT,PALMERAH,JATI PULO,28738,11299,17439,6802,24241,2021-08-13
3175061001,JAKARTA TIMUR,CAKUNG,JATINEGARA,84160,35868,48292,17598,65890,2021-08-13
3175021004,JAKARTA TIMUR,PULO GADUNG,JATINEGARA KAUM,24632,9453,15179,5777,20956,2021-08-13
3173021004,JAKARTA BARAT,GROGOL PETAMBURAN,JELAMBAR,30266,12034,18232,9838,28070,2021-08-13
3173021006,JAKARTA BARAT,GROGOL PETAMBURAN,JELAMBAR BARU,38246,15368,22878,11811,34689,2021-08-13
3173041006,JAKARTA BARAT,TAMBORA,JEMBATAN BESI,29314,14212,15102,5336,20438,2021-08-13
3173041008,JAKARTA BARAT,TAMBORA,JEMBATAN LIMA,21021,9558,11463,4992,16455,2021-08-13
3173081005,JAKARTA BARAT,KEMBANGAN,JOGLO,40839,17340,23499,10787,34286,2021-08-13
3171081001,JAKARTA PUSAT,JOHAR BARU,JOHAR BARU,37488,13968,23520,10833,34353,2021-08-13
3173041002,JAKARTA BARAT,TAMBORA,KALI ANYAR,23856,9058,14798,4747,19545,2021-08-13
3172041004,JAKARTA UTARA,CILINCING,KALIBARU,67684,31640,36044,14262,50306,2021-08-13
3174081002,JAKARTA SELATAN,PANCORAN,KALIBATA,41994,19018,22976,9798,32774,2021-08-13
3173061001,JAKARTA BARAT,KALI DERES,KALIDERES,72447,29450,42997,18299,61296,2021-08-13
3175051004,JAKARTA TIMUR,PASAR REBO,KALISARI,43212,17166,26046,12999,39045,2021-08-13
3173061004,JAKARTA BARAT,KALI DERES,KAMAL,53783,23294,30489,8877,39366,2021-08-13
3172011002,JAKARTA UTARA,PENJARINGAN,KAMAL MUARA,12930,3969,8961,5288,14249,2021-08-13
3171071007,JAKARTA PUSAT,TANAH ABANG,KAMPUNG BALI,11358,5326,6032,2842,8874,2021-08-13
3175031001,JAKARTA TIMUR,JATINEGARA,KAMPUNG MELAYU,25717,11735,13982,5613,19595,2021-08-13
3171081002,JAKARTA PUSAT,JOHAR BARU,KAMPUNG RAWA,21237,6832,14405,5730,20135,2021-08-13
3175041002,JAKARTA TIMUR,KRAMAT JATI,KAMPUNG TENGAH,43993,20808,23185,9711,32896,2021-08-13
3173011005,JAKARTA BARAT,CENGKARENG,KAPUK,134466,59595,74871,24811,99682,2021-08-13
3172011003,JAKARTA UTARA,PENJARINGAN,KAPUK MUARA,35781,12789,22992,13201,36193,2021-08-13
3171021002,JAKARTA PUSAT,SAWAH BESAR,KARANG ANYAR,25761,10024,15737,6929,22666,2021-08-13
3174021004,JAKARTA SELATAN,SETIA BUDI,KARET,9623,4045,5578,2927,8505,2021-08-13
3174021003,JAKARTA SELATAN,SETIA BUDI,KARET KUNINGAN,16055,6020,10035,5249,15284,2021-08-13
3174021002,JAKARTA SELATAN,SETIA BUDI,KARET SEMANGGI,2770,1010,1760,1166,2926,2021-08-13
3171071003,JAKARTA PUSAT,TANAH ABANG,KARET TENGSIN,19271,8035,11236,4829,16065,2021-08-13
3171021003,JAKARTA PUSAT,SAWAH BESAR,KARTINI,22292,8687,13605,6906,20511,2021-08-13
3175011003,JAKARTA TIMUR,MATRAMAN,KAYU MANIS,25284,11327,13957,6016,19973,2021-08-13
3175021006,JAKARTA TIMUR,PULO GADUNG,KAYU PUTIH,40696,15694,25002,13462,38464,2021-08-13
3173031006,JAKARTA BARAT,TAMAN SARI,KEAGUNGAN,17387,6693,10694,4824,15518,2021-08-13
3174041007,JAKARTA SELATAN,PASAR MINGGU,KEBAGUSAN,44552,18994,25558,11856,37414,2021-08-13
3174051006,JAKARTA SELATAN,KEBAYORAN LAMA,KEBAYORAN LAMA SELATAN,41212,16650,24562,11383,35945,2021-08-13
3174051001,JAKARTA SELATAN,KEBAYORAN LAMA,KEBAYORAN LAMA UTARA,42422,18270,24152,10190,34342,2021-08-13
3174011004,JAKARTA SELATAN,TEBET,KEBON BARU,35165,14418,20747,9991,30738,2021-08-13
3172021005,JAKARTA UTARA,TANJUNG PRIOK,KEBON BAWANG,50952,21572,29380,14616,43996,2021-08-13
3173051001,JAKARTA BARAT,KEBON JERUK,KEBON JERUK,53887,23988,29899,13183,43082,2021-08-13
3171071006,JAKARTA PUSAT,TANAH ABANG,KEBON KACANG,21531,10530,11001,4975,15976,2021-08-13
3171011005,JAKARTA PUSAT,GAMBIR,KEBON KELAPA,10163,4069,6094,2964,9058,2021-08-13
3171031002,JAKARTA PUSAT,KEMAYORAN,KEBON KOSONG,30019,12666,17353,8242,25595,2021-08-13
3175011005,JAKARTA TIMUR,MATRAMAN,KEBON MANGGIS,16490,6681,9809,4970,14779,2021-08-13
3171071005,JAKARTA PUSAT,TANAH ABANG,KEBON MELATI,32206,16778,15428,5910,21338,2021-08-13
3175081003,JAKARTA TIMUR,MAKASAR,KEBON PALA,46614,19530,27084,11552,38636,2021-08-13
3171061005,JAKARTA PUSAT,MENTENG,KEBON SIRIH,12299,5576,6723,2926,9649,2021-08-13
3173011004,JAKARTA BARAT,CENGKARENG,KEDAUNG KALI ANGKE,32612,12062,20550,7836,28386,2021-08-13
3173051007,JAKARTA BARAT,KEBON JERUK,KEDOYA SELATAN,32165,12656,19509,8144,27653,2021-08-13
3173051006,JAKARTA BARAT,KEBON JERUK,KEDOYA UTARA,45740,16888,28852,12858,41710,2021-08-13
3173051004,JAKARTA BARAT,KEBON JERUK,KELAPA DUA,23565,10005,13560,5927,19487,2021-08-13
3175091003,JAKARTA TIMUR,CIRACAS,KELAPA DUA WETAN,46875,17873,29002,13414,42416,2021-08-13
3172061003,JAKARTA UTARA,KELAPA GADING,KELAPA GADING BARAT,35717,12650,23067,14705,37772,2021-08-13
3172061001,JAKARTA UTARA,KELAPA GADING,KELAPA GADING TIMUR,33592,11043,22549,14410,36959,2021-08-13
3173071005,JAKARTA BARAT,PALMERAH,KEMANGGISAN,32139,13569,18570,8796,27366,2021-08-13
3171031001,JAKARTA PUSAT,KEMAYORAN,KEMAYORAN,20708,8218,12490,5942,18432,2021-08-13
3173081006,JAKARTA BARAT,KEMBANGAN,KEMBANGAN SELATAN,27130,11050,16080,8314,24394,2021-08-13
3173081001,JAKARTA BARAT,KEMBANGAN,KEMBANGAN UTARA,54451,22081,32370,13455,45825,2021-08-13
3171041002,JAKARTA PUSAT,SENEN,KENARI,9579,3710,5869,2829,8698,2021-08-13
3173041005,JAKARTA BARAT,TAMBORA,KERENDANG,19973,8192,11781,5135,16916,2021-08-13
3175071003,JAKARTA TIMUR,DUREN SAWIT,KLENDER,69978,32551,37427,14811,52238,2021-08-13
3172031001,JAKARTA UTARA,KOJA,KOJA,28175,11957,16218,8194,24412,2021-08-13
3173071006,JAKARTA BARAT,PALMERAH,KOTA BAMBU SELATAN,21158,9004,12154,4969,17123,2021-08-13
3173071003,JAKARTA BARAT,PALMERAH,KOTA BAMBU UTARA,24995,11006,13989,5720,19709,2021-08-13
3171041004,JAKARTA PUSAT,SENEN,KRAMAT,28835,13312,15523,6330,21853,2021-08-13
3175041001,JAKARTA TIMUR,KRAMAT JATI,KRAMAT JATI,34144,14436,19708,8441,28149,2021-08-13
3174071003,JAKARTA SELATAN,KEBAYORAN BARU,KRAMAT PELA,14413,5661,8752,4402,13154,2021-08-13
3173031002,JAKARTA BARAT,TAMAN SARI,KRUKUT,19244,7638,11606,4757,16363,2021-08-13
3174031005,JAKARTA SELATAN,MAMPANG PRAPATAN,KUNINGAN BARAT,12785,5081,7704,3948,11652,2021-08-13
3174021008,JAKARTA SELATAN,SETIA BUDI,KUNINGAN TIMUR,6008,2440,3568,1990,5558,2021-08-13
3171041005,JAKARTA PUSAT,SENEN,KWITANG,15486,6270,9216,4098,13314,2021-08-13
3172031003,JAKARTA UTARA,KOJA,LAGOA,59065,26774,32291,14248,46539,2021-08-13
3174061002,JAKARTA SELATAN,CILANDAK,LEBAK BULUS,37626,15842,21784,11365,33149,2021-08-13
3174091004,JAKARTA SELATAN,JAGAKARSA,LENTENG AGUNG,53946,22825,31121,13228,44349,2021-08-13
3175101007,JAKARTA TIMUR,CIPAYUNG,LUBANG BUAYA,63547,24771,38776,18367,57143,2021-08-13
3175081001,JAKARTA TIMUR,MAKASAR,MAKASAR,34390,13617,20773,9705,30478,2021-08-13
3175071006,JAKARTA TIMUR,DUREN SAWIT,MALAKA JAYA,30927,12774,18153,9990,28143,2021-08-13
3175071005,JAKARTA TIMUR,DUREN SAWIT,MALAKA SARI,27530,11079,16451,9067,25518,2021-08-13
3174031001,JAKARTA SELATAN,MAMPANG PRAPATAN,MAMPANG PRAPATAN,18159,7425,10734,5436,16170,2021-08-13
3173031005,JAKARTA BARAT,TAMAN SARI,MANGGA BESAR,7707,2765,4942,2769,7711,2021-08-13
3171021005,JAKARTA PUSAT,SAWAH BESAR,MANGGA DUA SELATAN,27442,10972,16470,8155,24625,2021-08-13
3174011007,JAKARTA SELATAN,TEBET,MANGGARAI,28373,10909,17464,7577,25041,2021-08-13
3174011006,JAKARTA SELATAN,TEBET,MANGGARAI SELATAN,23075,8975,14100,6951,21051,2021-08-13
3173031003,JAKARTA BARAT,TAMAN SARI,MAPHAR,16461,6670,9791,5065,14856,2021-08-13
3172041003,JAKARTA UTARA,CILINCING,MARUNDA,28943,11549,17394,6602,23996,2021-08-13
3174071001,JAKARTA SELATAN,KEBAYORAN BARU,MELAWAI,2627,967,1660,1214,2874,2021-08-13
3171061001,JAKARTA PUSAT,MENTENG,MENTENG,25624,11309,14315,6499,20814,2021-08-13
3174021005,JAKARTA SELATAN,SETIA BUDI,MENTENG ATAS,27816,10804,17012,8107,25119,2021-08-13
3174011003,JAKARTA SELATAN,TEBET,MENTENG DALAM,36028,14653,21375,10190,31565,2021-08-13
3173081003,JAKARTA BARAT,KEMBANGAN,MERUYA SELATAN,32130,13171,18959,8358,27317,2021-08-13
3173081002,JAKARTA BARAT,KEMBANGAN,MERUYA UTARA,43752,18121,25631,12351,37982,2021-08-13
3175101004,JAKARTA TIMUR,CIPAYUNG,MUNJUL,23871,9098,14773,6557,21330,2021-08-13
3172051002,JAKARTA UTARA,PADEMANGAN,PADEMANGAN BARAT,74240,31708,42532,18604,61136,2021-08-13
3172051001,JAKARTA UTARA,PADEMANGAN,PADEMANGAN TIMUR,37736,13633,24103,12650,36753,2021-08-13
3175011004,JAKARTA TIMUR,MATRAMAN,PAL MERIAM,19769,8516,11253,5258,16511,2021-08-13
3173071001,JAKARTA BARAT,PALMERAH,PALMERAH,63011,26824,36187,15340,51527,2021-08-13
3174081001,JAKARTA SELATAN,PANCORAN,PANCORAN,19421,7999,11422,5689,17111,2021-08-13
3172021003,JAKARTA UTARA,TANJUNG PRIOK,PAPANGGO,39097,15010,24087,11538,35625,2021-08-13
3171021001,JAKARTA PUSAT,SAWAH BESAR,PASAR BARU,12035,4140,7895,4475,12370,2021-08-13
3174021006,JAKARTA SELATAN,SETIA BUDI,PASAR MANGGIS,26752,11249,15503,7933,23436,2021-08-13
3174041001,JAKARTA SELATAN,PASAR MINGGU,PASAR MINGGU,24821,10048,14773,8008,22781,2021-08-13
3171041003,JAKARTA PUSAT,SENEN,PASEBAN,23533,9967,13566,6070,19636,2021-08-13
3173061005,JAKARTA BARAT,KALI DERES,PEGADUNGAN,75587,28805,46782,20986,67768,2021-08-13
3171061002,JAKARTA PUSAT,MENTENG,PEGANGSAAN,23455,10597,12858,5601,18459,2021-08-13
3172061002,JAKARTA UTARA,KELAPA GADING,PEGANGSAAN DUA,49976,16234,33742,19392,53134,2021-08-13
3172011004,JAKARTA UTARA,PENJARINGAN,PEJAGALAN,74578,29696,44882,23269,68151,2021-08-13
3174041006,JAKARTA SELATAN,PASAR MINGGU,PEJATEN BARAT,37346,15987,21359,11339,32698,2021-08-13
3174041005,JAKARTA SELATAN,PASAR MINGGU,PEJATEN TIMUR,57656,25386,32270,14730,47000,2021-08-13
3175051005,JAKARTA TIMUR,PASAR REBO,PEKAYON,43250,16802,26448,12048,38496,2021-08-13
3173041009,JAKARTA BARAT,TAMBORA,PEKOJAN,23587,9281,14306,6963,21269,2021-08-13
3174031003,JAKARTA SELATAN,MAMPANG PRAPATAN,PELA MAMPANG,43522,17593,25929,13286,39215,2021-08-13
3174081005,JAKARTA SELATAN,PANCORAN,PENGADEGAN,21478,8019,13459,6282,19741,2021-08-13
3175061003,JAKARTA TIMUR,CAKUNG,PENGGILINGAN,99255,45458,53797,19017,72814,2021-08-13
3172011001,JAKARTA UTARA,PENJARINGAN,PENJARINGAN,88308,39897,48411,20533,68944,2021-08-13
3174101001,JAKARTA SELATAN,PESANGGRAHAN,PESANGGRAHAN,27545,10361,17184,9028,26212,2021-08-13
3171071004,JAKARTA PUSAT,TANAH ABANG,PETAMBURAN,33271,17057,16214,6049,22263,2021-08-13
3174071008,JAKARTA SELATAN,KEBAYORAN BARU,PETOGOGAN,11499,4656,6843,3825,10668,2021-08-13
3171011004,JAKARTA PUSAT,GAMBIR,PETOJO SELATAN,14692,5996,8696,4641,13337,2021-08-13
3171011003,JAKARTA PUSAT,GAMBIR,PETOJO UTARA,17458,7163,10295,4589,14884,2021-08-13
3174101004,JAKARTA SELATAN,PESANGGRAHAN,PETUKANGAN SELATAN,37187,14972,22215,10124,32339,2021-08-13
3174101003,JAKARTA SELATAN,PESANGGRAHAN,PETUKANGAN UTARA,53716,23203,30513,14435,44948,2021-08-13
3175081002,JAKARTA TIMUR,MAKASAR,PINANG RANTI,27198,11355,15843,7382,23225,2021-08-13
3173031008,JAKARTA BARAT,TAMAN SARI,PINANGSIA,10729,3955,6774,3544,10318,2021-08-13
3175011001,JAKARTA TIMUR,MATRAMAN,PISANGAN BARU,31776,14029,17747,7285,25032,2021-08-13
3175021002,JAKARTA TIMUR,PULO GADUNG,PISANGAN TIMUR,41011,15994,25017,10976,35993,2021-08-13
3172011005,JAKARTA UTARA,PENJARINGAN,PLUIT,47783,18439,29344,19102,48446,2021-08-13
3175071002,JAKARTA TIMUR,DUREN SAWIT,PONDOK BAMBU,61550,27551,33999,16071,50070,2021-08-13
3175071004,JAKARTA TIMUR,DUREN SAWIT,PONDOK KELAPA,72015,29410,42605,19942,62547,2021-08-13
3175071007,JAKARTA TIMUR,DUREN SAWIT,PONDOK KOPI,35367,16585,18782,8185,26967,2021-08-13
3174061003,JAKARTA SELATAN,CILANDAK,PONDOK LABU,46464,17936,28528,14865,43393,2021-08-13
3174051002,JAKARTA SELATAN,KEBAYORAN LAMA,PONDOK PINANG,56169,22859,33310,17399,50709,2021-08-13
3175101003,JAKARTA TIMUR,CIPAYUNG,PONDOK RANGGON,25574,10249,15325,7046,22371,2021-08-13
3101011003,KAB.ADM.KEP.SERIBU,KEP. SERIBU UTARA,PULAU HARAPAN,2060,381,1679,886,2565,2021-08-13
3101011002,KAB.ADM.KEP.SERIBU,KEP. SERIBU UTARA,PULAU KELAPA,5528,1087,4441,1952,6393,2021-08-13
3101011001,KAB.ADM.KEP.SERIBU,KEP. SERIBU UTARA,PULAU PANGGANG,5450,981,4469,1810,6279,2021-08-13
3101021003,KAB.ADM.KEP.SERIBU,KEP. SERIBU SELATAN,PULAU PARI,2765,349,2416,1256,3672,2021-08-13
3101021002,KAB.ADM.KEP.SERIBU,KEP. SERIBU SELATAN,PULAU TIDUNG,4553,729,3824,2355,6179,2021-08-13
3101021001,KAB.ADM.KEP.SERIBU,KEP. SERIBU SELATAN,PULAU UNTUNG JAWA,1941,375,1566,788,2354,2021-08-13
3174071007,JAKARTA SELATAN,KEBAYORAN BARU,PULO,5835,2153,3682,2353,6035,2021-08-13
3175021001,JAKARTA TIMUR,PULO GADUNG,PULO GADUNG,34422,14460,19962,9197,29159,2021-08-13
3175061005,JAKARTA TIMUR,CAKUNG,PULO GEBANG,97301,42247,55054,21691,76745,2021-08-13
3174041004,JAKARTA SELATAN,PASAR MINGGU,RAGUNAN,39616,15427,24189,12365,36554,2021-08-13
3175091005,JAKARTA TIMUR,CIRACAS,RAMBUTAN,36771,17121,19650,8510,28160,2021-08-13
3172031006,JAKARTA UTARA,KOJA,RAWA BADAK SELATAN,42179,19417,22762,9563,32325,2021-08-13
3172031004,JAKARTA UTARA,KOJA,RAWA BADAK UTARA,34408,15371,19037,9352,28389,2021-08-13
3174071005,JAKARTA SELATAN,KEBAYORAN BARU,RAWA BARAT,5625,2103,3522,2107,5629,2021-08-13
3173011003,JAKARTA BARAT,CENGKARENG,RAWA BUAYA,63799,27232,36567,13143,49710,2021-08-13
3175031004,JAKARTA TIMUR,JATINEGARA,RAWA BUNGA,21434,9619,11815,4941,16756,2021-08-13
3174081003,JAKARTA SELATAN,PANCORAN,RAWA JATI,20509,8139,12370,6331,18701,2021-08-13
3175061002,JAKARTA TIMUR,CAKUNG,RAWA TERATE,24637,9163,15474,5329,20803,2021-08-13
3175021005,JAKARTA TIMUR,PULO GADUNG,RAWAMANGUN,37612,15719,21893,10737,32630,2021-08-13
3171051003,JAKARTA PUSAT,CEMPAKA PUTIH,RAWASARI,21967,9192,12775,6590,19365,2021-08-13
3173041010,JAKARTA BARAT,TAMBORA,ROA MALAKA,3484,1214,2270,1384,3654,2021-08-13
3172041006,JAKARTA UTARA,CILINCING,ROROTAN,41668,16351,25317,10590,35907,2021-08-13
3174071004,JAKARTA SELATAN,KEBAYORAN BARU,SELONG,2842,1051,1791,1259,3050,2021-08-13
3173061002,JAKARTA BARAT,KALI DERES,SEMANAN,71354,30643,40711,12785,53496,2021-08-13
3172041007,JAKARTA UTARA,CILINCING,SEMPER BARAT,68587,25985,42602,20392,62994,2021-08-13
3172041005,JAKARTA UTARA,CILINCING,SEMPER TIMUR,36267,14497,21770,10242,32012,2021-08-13
3174071006,JAKARTA SELATAN,KEBAYORAN BARU,SENAYAN,2771,1264,1507,911,2418,2021-08-13
3171041001,JAKARTA PUSAT,SENEN,SENEN,6804,2632,4172,2254,6426,2021-08-13
3171031004,JAKARTA PUSAT,KEMAYORAN,SERDANG,29668,12083,17585,7936,25521,2021-08-13
3174021001,JAKARTA SELATAN,SETIA BUDI,SETIA BUDI,3023,1261,1762,1019,2781,2021-08-13
3175101005,JAKARTA TIMUR,CIPAYUNG,SETU,20572,8902,11670,4828,16498,2021-08-13
3173071002,JAKARTA BARAT,PALMERAH,SLIPI,16591,6631,9960,5039,14999,2021-08-13
3173081004,JAKARTA BARAT,KEMBANGAN,SRENGSENG,45523,20225,25298,11664,36962,2021-08-13
3174091002,JAKARTA SELATAN,JAGAKARSA,SRENGSENG SAWAH,58196,20806,37390,18553,55943,2021-08-13
3173051003,JAKARTA BARAT,KEBON JERUK,SUKABUMI SELATAN,37033,16552,20481,7992,28473,2021-08-13
3173051002,JAKARTA BARAT,KEBON JERUK,SUKABUMI UTARA,38290,18042,20248,8232,28480,2021-08-13
3172041002,JAKARTA UTARA,CILINCING,SUKAPURA,53949,22539,31410,14125,45535,2021-08-13
3171031007,JAKARTA PUSAT,KEMAYORAN,SUMUR BATU,22717,9473,13244,6705,19949,2021-08-13
3172021004,JAKARTA UTARA,TANJUNG PRIOK,SUNGAI BAMBU,29876,11895,17981,8785,26766,2021-08-13
3172021006,JAKARTA UTARA,TANJUNG PRIOK,SUNTER AGUNG,71805,25592,46213,25493,71706,2021-08-13
3172021002,JAKARTA UTARA,TANJUNG PRIOK,SUNTER JAYA,63031,23157,39874,21039,60913,2021-08-13
3175091004,JAKARTA TIMUR,CIRACAS,SUSUKAN,38257,14471,23786,10667,34453,2021-08-13
3173031001,JAKARTA BARAT,TAMAN SARI,TAMAN SARI,14348,5649,8699,4531,13230,2021-08-13
3173041001,JAKARTA BARAT,TAMBORA,TAMBORA,10204,4320,5884,2639,8523,2021-08-13
3173041004,JAKARTA BARAT,TAMBORA,TANAH SEREAL,26387,9228,17159,7416,24575,2021-08-13
3171081004,JAKARTA PUSAT,JOHAR BARU,TANAH TINGGI,37693,13337,24356,10478,34834,2021-08-13
3173031004,JAKARTA BARAT,TAMAN SARI,TANGKI,13324,5212,8112,4027,12139,2021-08-13
3174091005,JAKARTA SELATAN,JAGAKARSA,TANJUNG BARAT,39770,15637,24133,11359,35492,2021-08-13
3173021005,JAKARTA BARAT,GROGOL PETAMBURAN,TANJUNG DUREN SELATAN,25337,9855,15482,7963,23445,2021-08-13
3173021002,JAKARTA BARAT,GROGOL PETAMBURAN,TANJUNG DUREN UTARA,17010,6272,10738,5776,16514,2021-08-13
3172021001,JAKARTA UTARA,TANJUNG PRIOK,TANJUNG PRIOK,34588,13019,21569,9075,30644,2021-08-13
3174011002,JAKARTA SELATAN,TEBET,TEBET BARAT,21194,7857,13337,7489,20826,2021-08-13
3174011001,JAKARTA SELATAN,TEBET,TEBET TIMUR,18199,6717,11482,6540,18022,2021-08-13
3173061003,JAKARTA BARAT,KALI DERES,TEGAL ALUR,83647,34028,49619,17245,66864,2021-08-13
3174031004,JAKARTA SELATAN,MAMPANG PRAPATAN,TEGAL PARANG,32401,14222,18179,8180,26359,2021-08-13
3173021003,JAKARTA BARAT,GROGOL PETAMBURAN,TOMANG,29605,11699,17906,9454,27360,2021-08-13
3172031005,JAKARTA UTARA,KOJA,TUGU SELATAN,39122,17403,21719,9515,31234,2021-08-13
3172031002,JAKARTA UTARA,KOJA,TUGU UTARA,67670,30690,36980,16806,53786,2021-08-13
3175061006,JAKARTA TIMUR,CAKUNG,UJUNG MENTENG,29934,11326,18608,8048,26656,2021-08-13
3174101005,JAKARTA SELATAN,PESANGGRAHAN,ULUJAMI,40544,17726,22818,9742,32560,2021-08-13
3175011006,JAKARTA TIMUR,MATRAMAN,UTAN KAYU SELATAN,33511,13577,19934,9591,29525,2021-08-13
3175011002,JAKARTA TIMUR,MATRAMAN,UTAN KAYU UTARA,28169,12163,16006,7445,23451,2021-08-13
3171031008,JAKARTA PUSAT,KEMAYORAN,UTAN PANJANG,29208,12416,16792,6706,23498,2021-08-13
3172021007,JAKARTA UTARA,TANJUNG PRIOK,WARAKAS,44401,17716,26685,12682,39367,2021-08-13
3173021007,JAKARTA BARAT,GROGOL PETAMBURAN,WIJAYA KUSUMA,38934,16564,22370,10164,32534,2021-08-13
3172051003,JAKARTA UTARA,PADEMANGAN,ANCOL,23947,10176,13771,6280,20051,2021-08-14
3173041007,JAKARTA BARAT,TAMBORA,ANGKE,29381,11386,17995,7534,25529,2021-08-14
3175041005,JAKARTA TIMUR,KRAMAT JATI,BALE KAMBANG,29074,14225,14849,5560,20409,2021-08-14
3175031003,JAKARTA TIMUR,JATINEGARA,BALI MESTER,9752,4075,5677,2814,8491,2021-08-14
3175101006,JAKARTA TIMUR,CIPAYUNG,BAMBU APUS,26285,10533,15752,7115,22867,2021-08-14
3174031002,JAKARTA SELATAN,MAMPANG PRAPATAN,BANGKA,21566,9062,12504,6082,18586,2021-08-14
3175051002,JAKARTA TIMUR,PASAR REBO,BARU,23886,8602,15284,8770,24054,2021-08-14
3175041004,JAKARTA TIMUR,KRAMAT JATI,BATU AMPAR,47898,22387,25511,10759,36270,2021-08-14
3171071002,JAKARTA PUSAT,TANAH ABANG,BENDUNGAN HILIR,21494,8748,12746,6675,19421,2021-08-14
3175031002,JAKARTA TIMUR,JATINEGARA,BIDARA CINA,36689,17290,19399,8384,27783,2021-08-14
3174101002,JAKARTA SELATAN,PESANGGRAHAN,BINTARO,53098,21579,31519,16326,47845,2021-08-14
3174011005,JAKARTA SELATAN,TEBET,BUKIT DURI,34183,14823,19360,9209,28569,2021-08-14
3171041006,JAKARTA PUSAT,SENEN,BUNGUR,18144,7171,10973,5421,16394,2021-08-14
3175061007,JAKARTA TIMUR,CAKUNG,CAKUNG BARAT,57724,21730,35994,13466,49460,2021-08-14
3175061004,JAKARTA TIMUR,CAKUNG,CAKUNG TIMUR,58287,22372,35915,15826,51741,2021-08-14
3175041007,JAKARTA TIMUR,KRAMAT JATI,CAWANG,32762,14584,18178,8425,26603,2021-08-14
3175101008,JAKARTA TIMUR,CIPAYUNG,CEGER,18932,7383,11549,5056,16605,2021-08-14
3171031006,JAKARTA PUSAT,KEMAYORAN,CEMPAKA BARU,32581,14398,18183,8519,26702,2021-08-14
3171051002,JAKARTA PUSAT,CEMPAKA PUTIH,CEMPAKA PUTIH BARAT,35885,14867,21018,10518,31536,2021-08-14
3171051001,JAKARTA PUSAT,CEMPAKA PUTIH,CEMPAKA PUTIH TIMUR,24292,9909,14383,7840,22223,2021-08-14
3173011001,JAKARTA BARAT,CENGKARENG,CENGKARENG BARAT,66284,26422,39862,20146,60008,2021-08-14
3173011006,JAKARTA BARAT,CENGKARENG,CENGKARENG TIMUR,81027,32298,48729,20482,69211,2021-08-14
3175091002,JAKARTA TIMUR,CIRACAS,CIBUBUR,66364,25329,41035,20865,61900,2021-08-14
3171011002,JAKARTA PUSAT,GAMBIR,CIDENG,15390,5638,9752,5347,15099,2021-08-14
3174091003,JAKARTA SELATAN,JAGAKARSA,CIGANJUR,38497,15272,23225,11535,34760,2021-08-14
3175051003,JAKARTA TIMUR,PASAR REBO,CIJANTUNG,41419,15954,25465,13068,38533,2021-08-14
3171061003,JAKARTA PUSAT,MENTENG,CIKINI,8274,3707,4567,2337,6904,2021-08-14
3174081006,JAKARTA SELATAN,PANCORAN,CIKOKO,10547,3877,6670,3313,9983,2021-08-14
3174061001,JAKARTA SELATAN,CILANDAK,CILANDAK BARAT,51752,20305,31447,17147,48594,2021-08-14
3174041003,JAKARTA SELATAN,PASAR MINGGU,CILANDAK TIMUR,25145,9598,15547,8957,24504,2021-08-14
3175101002,JAKARTA TIMUR,CIPAYUNG,CILANGKAP,27635,10696,16939,7830,24769,2021-08-14
3175041006,JAKARTA TIMUR,KRAMAT JATI,CILILITAN,40181,18211,21970,10041,32011,2021-08-14
3172041001,JAKARTA UTARA,CILINCING,CILINCING,43609,18617,24992,11415,36407,2021-08-14
3175101001,JAKARTA TIMUR,CIPAYUNG,CIPAYUNG,26104,9467,16637,8523,25160,2021-08-14
3174091006,JAKARTA SELATAN,JAGAKARSA,CIPEDAK,38303,14105,24198,12801,36999,2021-08-14
3174061005,JAKARTA SELATAN,CILANDAK,CIPETE SELATAN,26704,10918,15786,8896,24682,2021-08-14
3174071010,JAKARTA SELATAN,KEBAYORAN BARU,CIPETE UTARA,34102,13782,20320,10466,30786,2021-08-14
3175021003,JAKARTA TIMUR,PULO GADUNG,CIPINANG,39306,16351,22955,11476,34431,2021-08-14
3175031007,JAKARTA TIMUR,JATINEGARA,CIPINANG BESAR SELATAN,35212,16698,18514,7728,26242,2021-08-14
3175031008,JAKARTA TIMUR,JATINEGARA,CIPINANG BESAR UTARA,45319,20395,24924,9588,34512,2021-08-14
3175031005,JAKARTA TIMUR,JATINEGARA,CIPINANG CEMPEDAK,32824,14746,18078,9190,27268,2021-08-14
3175081005,JAKARTA TIMUR,MAKASAR,CIPINANG MELAYU,42308,17759,24549,12516,37065,2021-08-14
3175031006,JAKARTA TIMUR,JATINEGARA,CIPINANG MUARA,55243,24481,30762,13794,44556,2021-08-14
3174051003,JAKARTA SELATAN,KEBAYORAN LAMA,CIPULIR,39937,17353,22584,10206,32790,2021-08-14
3175091001,JAKARTA TIMUR,CIRACAS,CIRACAS,64594,24587,40007,18430,58437,2021-08-14
3175041003,JAKARTA TIMUR,KRAMAT JATI,DUKUH,24609,9791,14818,6691,21509,2021-08-14
3175071001,JAKARTA TIMUR,DUREN SAWIT,DUREN SAWIT,61160,27164,33996,17313,51309,2021-08-14
3174081004,JAKARTA SELATAN,PANCORAN,DUREN TIGA,28319,11432,16887,7802,24689,2021-08-14
3173051005,JAKARTA BARAT,KEBON JERUK,DURI KEPA,60138,22745,37393,19195,56588,2021-08-14
3173011002,JAKARTA BARAT,CENGKARENG,DURI KOSAMBI,77923,34603,43320,19054,62374,2021-08-14
3171011006,JAKARTA PUSAT,GAMBIR,DURI PULO,19610,7870,11740,4683,16423,2021-08-14
3173041011,JAKARTA BARAT,TAMBORA,DURI SELATAN,14259,5094,9165,4245,13410,2021-08-14
3173041003,JAKARTA BARAT,TAMBORA,DURI UTARA,19844,7494,12350,5393,17743,2021-08-14
3171081003,JAKARTA PUSAT,JOHAR BARU,GALUR,18243,6409,11834,4864,16698,2021-08-14
3171011001,JAKARTA PUSAT,GAMBIR,GAMBIR,2191,801,1390,785,2175,2021-08-14
3174061004,JAKARTA SELATAN,CILANDAK,GANDARIA SELATAN,22119,8890,13229,6823,20052,2021-08-14
3174071009,JAKARTA SELATAN,KEBAYORAN BARU,GANDARIA UTARA,39922,16452,23470,11765,35235,2021-08-14
3175051001,JAKARTA TIMUR,PASAR REBO,GEDONG,35755,13945,21810,10920,32730,2021-08-14
3171071001,JAKARTA PUSAT,TANAH ABANG,GELORA,3127,1323,1804,897,2701,2021-08-14
3173031007,JAKARTA BARAT,TAMAN SARI,GLODOK,7837,2662,5175,3209,8384,2021-08-14
3171061004,JAKARTA PUSAT,MENTENG,GONDANGDIA,4100,1643,2457,1737,4194,2021-08-14
3173021001,JAKARTA BARAT,GROGOL PETAMBURAN,GROGOL,16876,6730,10146,5193,15339,2021-08-14
3174051005,JAKARTA SELATAN,KEBAYORAN LAMA,GROGOL SELATAN,44251,18871,25380,11163,36543,2021-08-14
3174051004,JAKARTA SELATAN,KEBAYORAN LAMA,GROGOL UTARA,42494,17546,24948,11449,36397,2021-08-14
3174021007,JAKARTA SELATAN,SETIA BUDI,GUNTUR,3985,1505,2480,1622,4102,2021-08-14
3174071002,JAKARTA SELATAN,KEBAYORAN BARU,GUNUNG,9436,3603,5833,3606,9439,2021-08-14
3171031005,JAKARTA PUSAT,KEMAYORAN,GUNUNG SAHARI SELATAN,19199,7802,11397,5967,17364,2021-08-14
3171021004,JAKARTA PUSAT,SAWAH BESAR,GUNUNG SAHARI UTARA,16650,5789,10861,6101,16962,2021-08-14
3175081004,JAKARTA TIMUR,MAKASAR,HALIM PERDANA KUSUMAH,28363,8734,19629,13990,33619,2021-08-14
3171031003,JAKARTA PUSAT,KEMAYORAN,HARAPAN MULIA,22557,9328,13229,6148,19377,2021-08-14
3174091001,JAKARTA SELATAN,JAGAKARSA,JAGAKARSA,62389,23872,38517,20135,58652,2021-08-14
3175021007,JAKARTA TIMUR,PULO GADUNG,JATI,32757,13383,19374,10160,29534,2021-08-14
3174041002,JAKARTA SELATAN,PASAR MINGGU,JATI PADANG,37502,15268,22234,12079,34313,2021-08-14
3173071004,JAKARTA BARAT,PALMERAH,JATI PULO,28738,11168,17570,7245,24815,2021-08-14
3175061001,JAKARTA TIMUR,CAKUNG,JATINEGARA,84160,35535,48625,18613,67238,2021-08-14
3175021004,JAKARTA TIMUR,PULO GADUNG,JATINEGARA KAUM,24632,9306,15326,6011,21337,2021-08-14
3173021004,JAKARTA BARAT,GROGOL PETAMBURAN,JELAMBAR,30266,11892,18374,10181,28555,2021-08-14
3173021006,JAKARTA BARAT,GROGOL PETAMBURAN,JELAMBAR BARU,38246,15167,23079,12266,35345,2021-08-14
3173041006,JAKARTA BARAT,TAMBORA,JEMBATAN BESI,29314,13984,15330,5768,21098,2021-08-14
3173041008,JAKARTA BARAT,TAMBORA,JEMBATAN LIMA,21021,9307,11714,5274,16988,2021-08-14
3173081005,JAKARTA BARAT,KEMBANGAN,JOGLO,40839,17062,23777,11230,35007,2021-08-14
3171081001,JAKARTA PUSAT,JOHAR BARU,JOHAR BARU,37488,13801,23687,11394,35081,2021-08-14
3173041002,JAKARTA BARAT,TAMBORA,KALI ANYAR,23856,8931,14925,5123,20048,2021-08-14
3172041004,JAKARTA UTARA,CILINCING,KALIBARU,67684,31271,36413,14889,51302,2021-08-14
3174081002,JAKARTA SELATAN,PANCORAN,KALIBATA,41994,18843,23151,10213,33364,2021-08-14
3173061001,JAKARTA BARAT,KALI DERES,KALIDERES,72447,29082,43365,19346,62711,2021-08-14
3175051004,JAKARTA TIMUR,PASAR REBO,KALISARI,43212,16938,26274,13505,39779,2021-08-14
3173061004,JAKARTA BARAT,KALI DERES,KAMAL,53783,22939,30844,9609,40453,2021-08-14
3172011002,JAKARTA UTARA,PENJARINGAN,KAMAL MUARA,12930,3933,8997,5443,14440,2021-08-14
3171071007,JAKARTA PUSAT,TANAH ABANG,KAMPUNG BALI,11358,5228,6130,3007,9137,2021-08-14
3175031001,JAKARTA TIMUR,JATINEGARA,KAMPUNG MELAYU,25717,11561,14156,5836,19992,2021-08-14
3171081002,JAKARTA PUSAT,JOHAR BARU,KAMPUNG RAWA,21237,6719,14518,6129,20647,2021-08-14
3175041002,JAKARTA TIMUR,KRAMAT JATI,KAMPUNG TENGAH,43993,20500,23493,9995,33488,2021-08-14
3173011005,JAKARTA BARAT,CENGKARENG,KAPUK,134466,58843,75623,26464,102087,2021-08-14
3172011003,JAKARTA UTARA,PENJARINGAN,KAPUK MUARA,35781,12637,23144,13571,36715,2021-08-14
3171021002,JAKARTA PUSAT,SAWAH BESAR,KARANG ANYAR,25761,9870,15891,7273,23164,2021-08-14
3174021004,JAKARTA SELATAN,SETIA BUDI,KARET,9623,3951,5672,3037,8709,2021-08-14
3174021003,JAKARTA SELATAN,SETIA BUDI,KARET KUNINGAN,16055,5938,10117,5542,15659,2021-08-14
3174021002,JAKARTA SELATAN,SETIA BUDI,KARET SEMANGGI,2770,1002,1768,1177,2945,2021-08-14
3171071003,JAKARTA PUSAT,TANAH ABANG,KARET TENGSIN,19271,7950,11321,5112,16433,2021-08-14
3171021003,JAKARTA PUSAT,SAWAH BESAR,KARTINI,22292,8575,13717,7206,20923,2021-08-14
3175011003,JAKARTA TIMUR,MATRAMAN,KAYU MANIS,25284,11158,14126,6309,20435,2021-08-14
3175021006,JAKARTA TIMUR,PULO GADUNG,KAYU PUTIH,40696,15534,25162,13870,39032,2021-08-14
3173031006,JAKARTA BARAT,TAMAN SARI,KEAGUNGAN,17387,6587,10800,5249,16049,2021-08-14
3174041007,JAKARTA SELATAN,PASAR MINGGU,KEBAGUSAN,44552,18798,25754,12508,38262,2021-08-14
3174051006,JAKARTA SELATAN,KEBAYORAN LAMA,KEBAYORAN LAMA SELATAN,41212,16386,24826,12045,36871,2021-08-14
3174051001,JAKARTA SELATAN,KEBAYORAN LAMA,KEBAYORAN LAMA UTARA,42422,18034,24388,10899,35287,2021-08-14
3174011004,JAKARTA SELATAN,TEBET,KEBON BARU,35165,14255,20910,10482,31392,2021-08-14
3172021005,JAKARTA UTARA,TANJUNG PRIOK,KEBON BAWANG,50952,21239,29713,15157,44870,2021-08-14
3173051001,JAKARTA BARAT,KEBON JERUK,KEBON JERUK,53887,23672,30215,13821,44036,2021-08-14
3171071006,JAKARTA PUSAT,TANAH ABANG,KEBON KACANG,21531,10424,11107,5221,16328,2021-08-14
3171011005,JAKARTA PUSAT,GAMBIR,KEBON KELAPA,10163,4039,6124,3019,9143,2021-08-14
3171031002,JAKARTA PUSAT,KEMAYORAN,KEBON KOSONG,30019,12498,17521,8686,26207,2021-08-14
3175011005,JAKARTA TIMUR,MATRAMAN,KEBON MANGGIS,16490,6581,9909,5112,15021,2021-08-14
3171071005,JAKARTA PUSAT,TANAH ABANG,KEBON MELATI,32206,16583,15623,6540,22163,2021-08-14
3175081003,JAKARTA TIMUR,MAKASAR,KEBON PALA,46614,19242,27372,12032,39404,2021-08-14
3171061005,JAKARTA PUSAT,MENTENG,KEBON SIRIH,12299,5478,6821,3037,9858,2021-08-14
3173011004,JAKARTA BARAT,CENGKARENG,KEDAUNG KALI ANGKE,32612,11832,20780,8988,29768,2021-08-14
3173051007,JAKARTA BARAT,KEBON JERUK,KEDOYA SELATAN,32165,12512,19653,8599,28252,2021-08-14
3173051006,JAKARTA BARAT,KEBON JERUK,KEDOYA UTARA,45740,16750,28990,13331,42321,2021-08-14
3173051004,JAKARTA BARAT,KEBON JERUK,KELAPA DUA,23565,9787,13778,6161,19939,2021-08-14
3175091003,JAKARTA TIMUR,CIRACAS,KELAPA DUA WETAN,46875,17535,29340,14056,43396,2021-08-14
3172061003,JAKARTA UTARA,KELAPA GADING,KELAPA GADING BARAT,35717,12534,23183,14962,38145,2021-08-14
3172061001,JAKARTA UTARA,KELAPA GADING,KELAPA GADING TIMUR,33592,10928,22664,14671,37335,2021-08-14
3173071005,JAKARTA BARAT,PALMERAH,KEMANGGISAN,32139,13365,18774,9115,27889,2021-08-14
3171031001,JAKARTA PUSAT,KEMAYORAN,KEMAYORAN,20708,8071,12637,6253,18890,2021-08-14
3173081006,JAKARTA BARAT,KEMBANGAN,KEMBANGAN SELATAN,27130,10882,16248,8597,24845,2021-08-14
3173081001,JAKARTA BARAT,KEMBANGAN,KEMBANGAN UTARA,54451,21819,32632,14270,46902,2021-08-14
3171041002,JAKARTA PUSAT,SENEN,KENARI,9579,3674,5905,2900,8805,2021-08-14
3173041005,JAKARTA BARAT,TAMBORA,KERENDANG,19973,8031,11942,5507,17449,2021-08-14
3175071003,JAKARTA TIMUR,DUREN SAWIT,KLENDER,69978,31984,37994,15404,53398,2021-08-14
3172031001,JAKARTA UTARA,KOJA,KOJA,28175,11838,16337,8477,24814,2021-08-14
3173071006,JAKARTA BARAT,PALMERAH,KOTA BAMBU SELATAN,21158,8894,12264,5243,17507,2021-08-14
3173071003,JAKARTA BARAT,PALMERAH,KOTA BAMBU UTARA,24995,10907,14088,6034,20122,2021-08-14
3171041004,JAKARTA PUSAT,SENEN,KRAMAT,28835,13146,15689,6608,22297,2021-08-14
3175041001,JAKARTA TIMUR,KRAMAT JATI,KRAMAT JATI,34144,14172,19972,8769,28741,2021-08-14
3174071003,JAKARTA SELATAN,KEBAYORAN BARU,KRAMAT PELA,14413,5478,8935,4655,13590,2021-08-14
3173031002,JAKARTA BARAT,TAMAN SARI,KRUKUT,19244,7564,11680,4871,16551,2021-08-14
3174031005,JAKARTA SELATAN,MAMPANG PRAPATAN,KUNINGAN BARAT,12785,4955,7830,4111,11941,2021-08-14
3174021008,JAKARTA SELATAN,SETIA BUDI,KUNINGAN TIMUR,6008,2403,3605,2068,5673,2021-08-14
3171041005,JAKARTA PUSAT,SENEN,KWITANG,15486,6185,9301,4278,13579,2021-08-14
3172031003,JAKARTA UTARA,KOJA,LAGOA,59065,26376,32689,14948,47637,2021-08-14
3174061002,JAKARTA SELATAN,CILANDAK,LEBAK BULUS,37626,15630,21996,11647,33643,2021-08-14
3174091004,JAKARTA SELATAN,JAGAKARSA,LENTENG AGUNG,53946,22604,31342,13959,45301,2021-08-14
3175101007,JAKARTA TIMUR,CIPAYUNG,LUBANG BUAYA,63547,24358,39189,18881,58070,2021-08-14
3175081001,JAKARTA TIMUR,MAKASAR,MAKASAR,34390,13458,20932,10047,30979,2021-08-14
3175071006,JAKARTA TIMUR,DUREN SAWIT,MALAKA JAYA,30927,12618,18309,10302,28611,2021-08-14
3175071005,JAKARTA TIMUR,DUREN SAWIT,MALAKA SARI,27530,10929,16601,9341,25942,2021-08-14
3174031001,JAKARTA SELATAN,MAMPANG PRAPATAN,MAMPANG PRAPATAN,18159,7359,10800,5708,16508,2021-08-14
3173031005,JAKARTA BARAT,TAMAN SARI,MANGGA BESAR,7707,2731,4976,2946,7922,2021-08-14
3171021005,JAKARTA PUSAT,SAWAH BESAR,MANGGA DUA SELATAN,27442,10825,16617,8481,25098,2021-08-14
3174011007,JAKARTA SELATAN,TEBET,MANGGARAI,28373,10774,17599,7899,25498,2021-08-14
3174011006,JAKARTA SELATAN,TEBET,MANGGARAI SELATAN,23075,8881,14194,7396,21590,2021-08-14
3173031003,JAKARTA BARAT,TAMAN SARI,MAPHAR,16461,6564,9897,5260,15157,2021-08-14
3172041003,JAKARTA UTARA,CILINCING,MARUNDA,28943,11398,17545,6975,24520,2021-08-14
3174071001,JAKARTA SELATAN,KEBAYORAN BARU,MELAWAI,2627,959,1668,1228,2896,2021-08-14
3171061001,JAKARTA PUSAT,MENTENG,MENTENG,25624,11136,14488,6768,21256,2021-08-14
3174021005,JAKARTA SELATAN,SETIA BUDI,MENTENG ATAS,27816,10642,17174,8545,25719,2021-08-14
3174011003,JAKARTA SELATAN,TEBET,MENTENG DALAM,36028,14480,21548,10657,32205,2021-08-14
3173081003,JAKARTA BARAT,KEMBANGAN,MERUYA SELATAN,32130,13026,19104,8780,27884,2021-08-14
3173081002,JAKARTA BARAT,KEMBANGAN,MERUYA UTARA,43752,17966,25786,13034,38820,2021-08-14
3175101004,JAKARTA TIMUR,CIPAYUNG,MUNJUL,23871,8982,14889,6809,21698,2021-08-14
3172051002,JAKARTA UTARA,PADEMANGAN,PADEMANGAN BARAT,74240,31402,42838,19335,62173,2021-08-14
3172051001,JAKARTA UTARA,PADEMANGAN,PADEMANGAN TIMUR,37736,13444,24292,13364,37656,2021-08-14
3175011004,JAKARTA TIMUR,MATRAMAN,PAL MERIAM,19769,8446,11323,5440,16763,2021-08-14
3173071001,JAKARTA BARAT,PALMERAH,PALMERAH,63011,26442,36569,16040,52609,2021-08-14
3174081001,JAKARTA SELATAN,PANCORAN,PANCORAN,19421,7947,11474,5930,17404,2021-08-14
3172021003,JAKARTA UTARA,TANJUNG PRIOK,PAPANGGO,39097,14824,24273,11944,36217,2021-08-14
3171021001,JAKARTA PUSAT,SAWAH BESAR,PASAR BARU,12035,4093,7942,4632,12574,2021-08-14
3174021006,JAKARTA SELATAN,SETIA BUDI,PASAR MANGGIS,26752,11106,15646,8299,23945,2021-08-14
3174041001,JAKARTA SELATAN,PASAR MINGGU,PASAR MINGGU,24821,9945,14876,8234,23110,2021-08-14
3171041003,JAKARTA PUSAT,SENEN,PASEBAN,23533,9852,13681,6278,19959,2021-08-14
3173061005,JAKARTA BARAT,KALI DERES,PEGADUNGAN,75587,28362,47225,21793,69018,2021-08-14
3171061002,JAKARTA PUSAT,MENTENG,PEGANGSAAN,23455,10462,12993,5882,18875,2021-08-14
3172061002,JAKARTA UTARA,KELAPA GADING,PEGANGSAAN DUA,49976,16023,33953,19967,53920,2021-08-14
3172011004,JAKARTA UTARA,PENJARINGAN,PEJAGALAN,74578,29331,45247,24258,69505,2021-08-14
3174041006,JAKARTA SELATAN,PASAR MINGGU,PEJATEN BARAT,37346,15791,21555,11847,33402,2021-08-14
3174041005,JAKARTA SELATAN,PASAR MINGGU,PEJATEN TIMUR,57656,25115,32541,15310,47851,2021-08-14
3175051005,JAKARTA TIMUR,PASAR REBO,PEKAYON,43250,16601,26649,12755,39404,2021-08-14
3173041009,JAKARTA BARAT,TAMBORA,PEKOJAN,23587,9208,14379,7312,21691,2021-08-14
3174031003,JAKARTA SELATAN,MAMPANG PRAPATAN,PELA MAMPANG,43522,17331,26191,13929,40120,2021-08-14
3174081005,JAKARTA SELATAN,PANCORAN,PENGADEGAN,21478,7944,13534,6571,20105,2021-08-14
3175061003,JAKARTA TIMUR,CAKUNG,PENGGILINGAN,99255,45050,54205,20159,74364,2021-08-14
3172011001,JAKARTA UTARA,PENJARINGAN,PENJARINGAN,88308,39223,49085,21413,70498,2021-08-14
3174101001,JAKARTA SELATAN,PESANGGRAHAN,PESANGGRAHAN,27545,10273,17272,9251,26523,2021-08-14
3171071004,JAKARTA PUSAT,TANAH ABANG,PETAMBURAN,33271,16925,16346,6522,22868,2021-08-14
3174071008,JAKARTA SELATAN,KEBAYORAN BARU,PETOGOGAN,11499,4610,6889,3996,10885,2021-08-14
3171011004,JAKARTA PUSAT,GAMBIR,PETOJO SELATAN,14692,5926,8766,4769,13535,2021-08-14
3171011003,JAKARTA PUSAT,GAMBIR,PETOJO UTARA,17458,6996,10462,4744,15206,2021-08-14
3174101004,JAKARTA SELATAN,PESANGGRAHAN,PETUKANGAN SELATAN,37187,14784,22403,10760,33163,2021-08-14
3174101003,JAKARTA SELATAN,PESANGGRAHAN,PETUKANGAN UTARA,53716,22939,30777,15120,45897,2021-08-14
3175081002,JAKARTA TIMUR,MAKASAR,PINANG RANTI,27198,11170,16028,7701,23729,2021-08-14
3173031008,JAKARTA BARAT,TAMAN SARI,PINANGSIA,10729,3920,6809,3675,10484,2021-08-14
3175011001,JAKARTA TIMUR,MATRAMAN,PISANGAN BARU,31776,13813,17963,7538,25501,2021-08-14
3175021002,JAKARTA TIMUR,PULO GADUNG,PISANGAN TIMUR,41011,15794,25217,11463,36680,2021-08-14
3172011005,JAKARTA UTARA,PENJARINGAN,PLUIT,47783,18229,29554,19423,48977,2021-08-14
3175071002,JAKARTA TIMUR,DUREN SAWIT,PONDOK BAMBU,61550,27210,34340,16490,50830,2021-08-14
3175071004,JAKARTA TIMUR,DUREN SAWIT,PONDOK KELAPA,72015,29112,42903,20748,63651,2021-08-14
3175071007,JAKARTA TIMUR,DUREN SAWIT,PONDOK KOPI,35367,16386,18981,8474,27455,2021-08-14
3174061003,JAKARTA SELATAN,CILANDAK,PONDOK LABU,46464,17777,28687,15504,44191,2021-08-14
3174051002,JAKARTA SELATAN,KEBAYORAN LAMA,PONDOK PINANG,56169,22653,33516,18058,51574,2021-08-14
3175101003,JAKARTA TIMUR,CIPAYUNG,PONDOK RANGGON,25574,10111,15463,7301,22764,2021-08-14
3101011003,KAB.ADM.KEP.SERIBU,KEP. SERIBU UTARA,PULAU HARAPAN,2060,378,1682,907,2589,2021-08-14
3101011002,KAB.ADM.KEP.SERIBU,KEP. SERIBU UTARA,PULAU KELAPA,5528,1059,4469,1997,6466,2021-08-14
3101011001,KAB.ADM.KEP.SERIBU,KEP. SERIBU UTARA,PULAU PANGGANG,5450,968,4482,1919,6401,2021-08-14
3101021003,KAB.ADM.KEP.SERIBU,KEP. SERIBU SELATAN,PULAU PARI,2765,348,2417,1264,3681,2021-08-14
3101021002,KAB.ADM.KEP.SERIBU,KEP. SERIBU SELATAN,PULAU TIDUNG,4553,714,3839,2380,6219,2021-08-14
3101021001,KAB.ADM.KEP.SERIBU,KEP. SERIBU SELATAN,PULAU UNTUNG JAWA,1941,366,1575,790,2365,2021-08-14
3174071007,JAKARTA SELATAN,KEBAYORAN BARU,PULO,5835,2131,3704,2412,6116,2021-08-14
3175021001,JAKARTA TIMUR,PULO GADUNG,PULO GADUNG,34422,14297,20125,9587,29712,2021-08-14
3175061005,JAKARTA TIMUR,CAKUNG,PULO GEBANG,97301,41729,55572,22637,78209,2021-08-14
3174041004,JAKARTA SELATAN,PASAR MINGGU,RAGUNAN,39616,15210,24406,12873,37279,2021-08-14
3175091005,JAKARTA TIMUR,CIRACAS,RAMBUTAN,36771,16886,19885,8850,28735,2021-08-14
3172031006,JAKARTA UTARA,KOJA,RAWA BADAK SELATAN,42179,19221,22958,10166,33124,2021-08-14
3172031004,JAKARTA UTARA,KOJA,RAWA BADAK UTARA,34408,15185,19223,9710,28933,2021-08-14
3174071005,JAKARTA SELATAN,KEBAYORAN BARU,RAWA BARAT,5625,2084,3541,2192,5733,2021-08-14
3173011003,JAKARTA BARAT,CENGKARENG,RAWA BUAYA,63799,26881,36918,13781,50699,2021-08-14
3175031004,JAKARTA TIMUR,JATINEGARA,RAWA BUNGA,21434,9498,11936,5269,17205,2021-08-14
3174081003,JAKARTA SELATAN,PANCORAN,RAWA JATI,20509,8055,12454,6540,18994,2021-08-14
3175061002,JAKARTA TIMUR,CAKUNG,RAWA TERATE,24637,9101,15536,5565,21101,2021-08-14
3175021005,JAKARTA TIMUR,PULO GADUNG,RAWAMANGUN,37612,15535,22077,11185,33262,2021-08-14
3171051003,JAKARTA PUSAT,CEMPAKA PUTIH,RAWASARI,21967,9074,12893,6801,19694,2021-08-14
3173041010,JAKARTA BARAT,TAMBORA,ROA MALAKA,3484,1201,2283,1419,3702,2021-08-14
3172041006,JAKARTA UTARA,CILINCING,ROROTAN,41668,16172,25496,11244,36740,2021-08-14
3174071004,JAKARTA SELATAN,KEBAYORAN BARU,SELONG,2842,1042,1800,1272,3072,2021-08-14
3173061002,JAKARTA BARAT,KALI DERES,SEMANAN,71354,30215,41139,13922,55061,2021-08-14
3172041007,JAKARTA UTARA,CILINCING,SEMPER BARAT,68587,25663,42924,21480,64404,2021-08-14
3172041005,JAKARTA UTARA,CILINCING,SEMPER TIMUR,36267,14308,21959,10723,32682,2021-08-14
3174071006,JAKARTA SELATAN,KEBAYORAN BARU,SENAYAN,2771,1253,1518,932,2450,2021-08-14
3171041001,JAKARTA PUSAT,SENEN,SENEN,6804,2582,4222,2312,6534,2021-08-14
3171031004,JAKARTA PUSAT,KEMAYORAN,SERDANG,29668,11979,17689,8237,25926,2021-08-14
3174021001,JAKARTA SELATAN,SETIA BUDI,SETIA BUDI,3023,1209,1814,1048,2862,2021-08-14
3175101005,JAKARTA TIMUR,CIPAYUNG,SETU,20572,8734,11838,5003,16841,2021-08-14
3173071002,JAKARTA BARAT,PALMERAH,SLIPI,16591,6516,10075,5206,15281,2021-08-14
3173081004,JAKARTA BARAT,KEMBANGAN,SRENGSENG,45523,19917,25606,12257,37863,2021-08-14
3174091002,JAKARTA SELATAN,JAGAKARSA,SRENGSENG SAWAH,58196,20558,37638,19749,57387,2021-08-14
3173051003,JAKARTA BARAT,KEBON JERUK,SUKABUMI SELATAN,37033,16295,20738,8298,29036,2021-08-14
3173051002,JAKARTA BARAT,KEBON JERUK,SUKABUMI UTARA,38290,17774,20516,8669,29185,2021-08-14
3172041002,JAKARTA UTARA,CILINCING,SUKAPURA,53949,22314,31635,14783,46418,2021-08-14
3171031007,JAKARTA PUSAT,KEMAYORAN,SUMUR BATU,22717,9382,13335,6851,20186,2021-08-14
3172021004,JAKARTA UTARA,TANJUNG PRIOK,SUNGAI BAMBU,29876,11772,18104,9039,27143,2021-08-14
3172021006,JAKARTA UTARA,TANJUNG PRIOK,SUNTER AGUNG,71805,25294,46511,26272,72783,2021-08-14
3172021002,JAKARTA UTARA,TANJUNG PRIOK,SUNTER JAYA,63031,22972,40059,21596,61655,2021-08-14
3175091004,JAKARTA TIMUR,CIRACAS,SUSUKAN,38257,14264,23993,11041,35034,2021-08-14
3173031001,JAKARTA BARAT,TAMAN SARI,TAMAN SARI,14348,5596,8752,4713,13465,2021-08-14
3173041001,JAKARTA BARAT,TAMBORA,TAMBORA,10204,4245,5959,2731,8690,2021-08-14
3173041004,JAKARTA BARAT,TAMBORA,TANAH SEREAL,26387,9089,17298,7713,25011,2021-08-14
3171081004,JAKARTA PUSAT,JOHAR BARU,TANAH TINGGI,37693,13167,24526,10892,35418,2021-08-14
3173031004,JAKARTA BARAT,TAMAN SARI,TANGKI,13324,5157,8167,4234,12401,2021-08-14
3174091005,JAKARTA SELATAN,JAGAKARSA,TANJUNG BARAT,39770,15497,24273,11821,36094,2021-08-14
3173021005,JAKARTA BARAT,GROGOL PETAMBURAN,TANJUNG DUREN SELATAN,25337,9721,15616,8310,23926,2021-08-14
3173021002,JAKARTA BARAT,GROGOL PETAMBURAN,TANJUNG DUREN UTARA,17010,6215,10795,5930,16725,2021-08-14
3172021001,JAKARTA UTARA,TANJUNG PRIOK,TANJUNG PRIOK,34588,12907,21681,9431,31112,2021-08-14
3174011002,JAKARTA SELATAN,TEBET,TEBET BARAT,21194,7763,13431,7770,21201,2021-08-14
3174011001,JAKARTA SELATAN,TEBET,TEBET TIMUR,18199,6636,11563,6720,18283,2021-08-14
3173061003,JAKARTA BARAT,KALI DERES,TEGAL ALUR,83647,33532,50115,18192,68307,2021-08-14
3174031004,JAKARTA SELATAN,MAMPANG PRAPATAN,TEGAL PARANG,32401,14066,18335,8683,27018,2021-08-14
3173021003,JAKARTA BARAT,GROGOL PETAMBURAN,TOMANG,29605,11505,18100,9855,27955,2021-08-14
3172031005,JAKARTA UTARA,KOJA,TUGU SELATAN,39122,17254,21868,9956,31824,2021-08-14
3172031002,JAKARTA UTARA,KOJA,TUGU UTARA,67670,30361,37309,17482,54791,2021-08-14
3175061006,JAKARTA TIMUR,CAKUNG,UJUNG MENTENG,29934,11198,18736,8451,27187,2021-08-14
3174101005,JAKARTA SELATAN,PESANGGRAHAN,ULUJAMI,40544,17596,22948,10128,33076,2021-08-14
3175011006,JAKARTA TIMUR,MATRAMAN,UTAN KAYU SELATAN,33511,13371,20140,10020,30160,2021-08-14
3175011002,JAKARTA TIMUR,MATRAMAN,UTAN KAYU UTARA,28169,12037,16132,7784,23916,2021-08-14
3171031008,JAKARTA PUSAT,KEMAYORAN,UTAN PANJANG,29208,12259,16949,7019,23968,2021-08-14
3172021007,JAKARTA UTARA,TANJUNG PRIOK,WARAKAS,44401,17532,26869,13063,39932,2021-08-14
3173021007,JAKARTA BARAT,GROGOL PETAMBURAN,WIJAYA KUSUMA,38934,16337,22597,10742,33339,2021-08-14
3172051003,JAKARTA UTARA,PADEMANGAN,ANCOL,23947,10084,13863,6446,20309,2021-08-15
3173041007,JAKARTA BARAT,TAMBORA,ANGKE,29381,11118,18263,7885,26148,2021-08-15
3175041005,JAKARTA TIMUR,KRAMAT JATI,BALE KAMBANG,29074,14071,15003,5657,20660,2021-08-15
3175031003,JAKARTA TIMUR,JATINEGARA,BALI MESTER,9752,4047,5705,2880,8585,2021-08-15
3175101006,JAKARTA TIMUR,CIPAYUNG,BAMBU APUS,26285,10450,15835,7198,23033,2021-08-15
3174031002,JAKARTA SELATAN,MAMPANG PRAPATAN,BANGKA,21566,8965,12601,6249,18850,2021-08-15
3175051002,JAKARTA TIMUR,PASAR REBO,BARU,23886,8537,15349,8856,24205,2021-08-15
3175041004,JAKARTA TIMUR,KRAMAT JATI,BATU AMPAR,47898,22170,25728,11013,36741,2021-08-15
3171071002,JAKARTA PUSAT,TANAH ABANG,BENDUNGAN HILIR,21494,8641,12853,6828,19681,2021-08-15
3175031002,JAKARTA TIMUR,JATINEGARA,BIDARA CINA,36689,17137,19552,8549,28101,2021-08-15
3174101002,JAKARTA SELATAN,PESANGGRAHAN,BINTARO,53098,21357,31741,16781,48522,2021-08-15
3174011005,JAKARTA SELATAN,TEBET,BUKIT DURI,34183,14694,19489,9363,28852,2021-08-15
3171041006,JAKARTA PUSAT,SENEN,BUNGUR,18144,7106,11038,5491,16529,2021-08-15
3175061007,JAKARTA TIMUR,CAKUNG,CAKUNG BARAT,57724,21556,36168,14065,50233,2021-08-15
3175061004,JAKARTA TIMUR,CAKUNG,CAKUNG TIMUR,58287,22113,36174,16319,52493,2021-08-15
3175041007,JAKARTA TIMUR,KRAMAT JATI,CAWANG,32762,14439,18323,8606,26929,2021-08-15
3175101008,JAKARTA TIMUR,CIPAYUNG,CEGER,18932,7316,11616,5136,16752,2021-08-15
3171031006,JAKARTA PUSAT,KEMAYORAN,CEMPAKA BARU,32581,14255,18326,8680,27006,2021-08-15
3171051002,JAKARTA PUSAT,CEMPAKA PUTIH,CEMPAKA PUTIH BARAT,35885,14719,21166,10927,32093,2021-08-15
3171051001,JAKARTA PUSAT,CEMPAKA PUTIH,CEMPAKA PUTIH TIMUR,24292,9791,14501,7978,22479,2021-08-15
3173011001,JAKARTA BARAT,CENGKARENG,CENGKARENG BARAT,66284,26066,40218,20482,60700,2021-08-15
3173011006,JAKARTA BARAT,CENGKARENG,CENGKARENG TIMUR,81027,31779,49248,20937,70185,2021-08-15
3175091002,JAKARTA TIMUR,CIRACAS,CIBUBUR,66364,24994,41370,21583,62953,2021-08-15
3171011002,JAKARTA PUSAT,GAMBIR,CIDENG,15390,5567,9823,5455,15278,2021-08-15
3174091003,JAKARTA SELATAN,JAGAKARSA,CIGANJUR,38497,15031,23466,11807,35273,2021-08-15
3175051003,JAKARTA TIMUR,PASAR REBO,CIJANTUNG,41419,15737,25682,13325,39007,2021-08-15
3171061003,JAKARTA PUSAT,MENTENG,CIKINI,8274,3682,4592,2378,6970,2021-08-15
3174081006,JAKARTA SELATAN,PANCORAN,CIKOKO,10547,3854,6693,3420,10113,2021-08-15
3174061001,JAKARTA SELATAN,CILANDAK,CILANDAK BARAT,51752,20024,31728,17503,49231,2021-08-15
3174041003,JAKARTA SELATAN,PASAR MINGGU,CILANDAK TIMUR,25145,9519,15626,9076,24702,2021-08-15
3175101002,JAKARTA TIMUR,CIPAYUNG,CILANGKAP,27635,10603,17032,7963,24995,2021-08-15
3175041006,JAKARTA TIMUR,KRAMAT JATI,CILILITAN,40181,17990,22191,10296,32487,2021-08-15
3172041001,JAKARTA UTARA,CILINCING,CILINCING,43609,18497,25112,11603,36715,2021-08-15
3175101001,JAKARTA TIMUR,CIPAYUNG,CIPAYUNG,26104,9409,16695,8620,25315,2021-08-15
3174091006,JAKARTA SELATAN,JAGAKARSA,CIPEDAK,38303,13921,24382,13184,37566,2021-08-15
3174061005,JAKARTA SELATAN,CILANDAK,CIPETE SELATAN,26704,10854,15850,9075,24925,2021-08-15
3174071010,JAKARTA SELATAN,KEBAYORAN BARU,CIPETE UTARA,34102,13549,20553,10666,31219,2021-08-15
3175021003,JAKARTA TIMUR,PULO GADUNG,CIPINANG,39306,16247,23059,11617,34676,2021-08-15
3175031007,JAKARTA TIMUR,JATINEGARA,CIPINANG BESAR SELATAN,35212,16469,18743,7877,26620,2021-08-15
3175031008,JAKARTA TIMUR,JATINEGARA,CIPINANG BESAR UTARA,45319,20182,25137,9806,34943,2021-08-15
3175031005,JAKARTA TIMUR,JATINEGARA,CIPINANG CEMPEDAK,32824,14591,18233,9329,27562,2021-08-15
3175081005,JAKARTA TIMUR,MAKASAR,CIPINANG MELAYU,42308,17616,24692,12787,37479,2021-08-15
3175031006,JAKARTA TIMUR,JATINEGARA,CIPINANG MUARA,55243,24262,30981,14063,45044,2021-08-15
3174051003,JAKARTA SELATAN,KEBAYORAN LAMA,CIPULIR,39937,17158,22779,10493,33272,2021-08-15
3175091001,JAKARTA TIMUR,CIRACAS,CIRACAS,64594,24279,40315,18909,59224,2021-08-15
3175041003,JAKARTA TIMUR,KRAMAT JATI,DUKUH,24609,9694,14915,6798,21713,2021-08-15
3175071001,JAKARTA TIMUR,DUREN SAWIT,DUREN SAWIT,61160,26908,34252,17569,51821,2021-08-15
3174081004,JAKARTA SELATAN,PANCORAN,DUREN TIGA,28319,11314,17005,7969,24974,2021-08-15
3173051005,JAKARTA BARAT,KEBON JERUK,DURI KEPA,60138,22494,37644,19667,57311,2021-08-15
3173011002,JAKARTA BARAT,CENGKARENG,DURI KOSAMBI,77923,34095,43828,19460,63288,2021-08-15
3171011006,JAKARTA PUSAT,GAMBIR,DURI PULO,19610,7750,11860,5001,16861,2021-08-15
3173041011,JAKARTA BARAT,TAMBORA,DURI SELATAN,14259,5046,9213,4395,13608,2021-08-15
3173041003,JAKARTA BARAT,TAMBORA,DURI UTARA,19844,7366,12478,5544,18022,2021-08-15
3171081003,JAKARTA PUSAT,JOHAR BARU,GALUR,18243,6327,11916,4934,16850,2021-08-15
3171011001,JAKARTA PUSAT,GAMBIR,GAMBIR,2191,797,1394,796,2190,2021-08-15
3174061004,JAKARTA SELATAN,CILANDAK,GANDARIA SELATAN,22119,8828,13291,6927,20218,2021-08-15
3174071009,JAKARTA SELATAN,KEBAYORAN BARU,GANDARIA UTARA,39922,16206,23716,12195,35911,2021-08-15
3175051001,JAKARTA TIMUR,PASAR REBO,GEDONG,35755,13828,21927,11074,33001,2021-08-15
3171071001,JAKARTA PUSAT,TANAH ABANG,GELORA,3127,1307,1820,920,2740,2021-08-15
3173031007,JAKARTA BARAT,TAMAN SARI,GLODOK,7837,2627,5210,3251,8461,2021-08-15
3171061004,JAKARTA PUSAT,MENTENG,GONDANGDIA,4100,1628,2472,1758,4230,2021-08-15
3173021001,JAKARTA BARAT,GROGOL PETAMBURAN,GROGOL,16876,6648,10228,5308,15536,2021-08-15
3174051005,JAKARTA SELATAN,KEBAYORAN LAMA,GROGOL SELATAN,44251,18548,25703,11583,37286,2021-08-15
3174051004,JAKARTA SELATAN,KEBAYORAN LAMA,GROGOL UTARA,42494,17285,25209,11666,36875,2021-08-15
3174021007,JAKARTA SELATAN,SETIA BUDI,GUNTUR,3985,1496,2489,1659,4148,2021-08-15
3174071002,JAKARTA SELATAN,KEBAYORAN BARU,GUNUNG,9436,3568,5868,3658,9526,2021-08-15
3171031005,JAKARTA PUSAT,KEMAYORAN,GUNUNG SAHARI SELATAN,19199,7742,11457,6051,17508,2021-08-15
3171021004,JAKARTA PUSAT,SAWAH BESAR,GUNUNG SAHARI UTARA,16650,5760,10890,6178,17068,2021-08-15
3175081004,JAKARTA TIMUR,MAKASAR,HALIM PERDANA KUSUMAH,28363,8657,19706,14064,33770,2021-08-15
3171031003,JAKARTA PUSAT,KEMAYORAN,HARAPAN MULIA,22557,9266,13291,6242,19533,2021-08-15
3174091001,JAKARTA SELATAN,JAGAKARSA,JAGAKARSA,62389,23632,38757,20622,59379,2021-08-15
3175021007,JAKARTA TIMUR,PULO GADUNG,JATI,32757,13229,19528,10304,29832,2021-08-15
3174041002,JAKARTA SELATAN,PASAR MINGGU,JATI PADANG,37502,15154,22348,12237,34585,2021-08-15
3173071004,JAKARTA BARAT,PALMERAH,JATI PULO,28738,11052,17686,7335,25021,2021-08-15
3175061001,JAKARTA TIMUR,CAKUNG,JATINEGARA,84160,35123,49037,19247,68284,2021-08-15
3175021004,JAKARTA TIMUR,PULO GADUNG,JATINEGARA KAUM,24632,9186,15446,6149,21595,2021-08-15
3173021004,JAKARTA BARAT,GROGOL PETAMBURAN,JELAMBAR,30266,11774,18492,10345,28837,2021-08-15
3173021006,JAKARTA BARAT,GROGOL PETAMBURAN,JELAMBAR BARU,38246,14950,23296,12546,35842,2021-08-15
3173041006,JAKARTA BARAT,TAMBORA,JEMBATAN BESI,29314,13719,15595,6038,21633,2021-08-15
3173041008,JAKARTA BARAT,TAMBORA,JEMBATAN LIMA,21021,9072,11949,5444,17393,2021-08-15
3173081005,JAKARTA BARAT,KEMBANGAN,JOGLO,40839,16763,24076,11474,35550,2021-08-15
3171081001,JAKARTA PUSAT,JOHAR BARU,JOHAR BARU,37488,13603,23885,11595,35480,2021-08-15
3173041002,JAKARTA BARAT,TAMBORA,KALI ANYAR,23856,8818,15038,5412,20450,2021-08-15
3172041004,JAKARTA UTARA,CILINCING,KALIBARU,67684,30971,36713,15383,52096,2021-08-15
3174081002,JAKARTA SELATAN,PANCORAN,KALIBATA,41994,18635,23359,10456,33815,2021-08-15
3173061001,JAKARTA BARAT,KALI DERES,KALIDERES,72447,28660,43787,19902,63689,2021-08-15
3175051004,JAKARTA TIMUR,PASAR REBO,KALISARI,43212,16862,26350,13681,40031,2021-08-15
3173061004,JAKARTA BARAT,KALI DERES,KAMAL,53783,22481,31302,10052,41354,2021-08-15
3172011002,JAKARTA UTARA,PENJARINGAN,KAMAL MUARA,12930,3913,9017,5490,14507,2021-08-15
3171071007,JAKARTA PUSAT,TANAH ABANG,KAMPUNG BALI,11358,5173,6185,3063,9248,2021-08-15
3175031001,JAKARTA TIMUR,JATINEGARA,KAMPUNG MELAYU,25717,11464,14253,5923,20176,2021-08-15
3171081002,JAKARTA PUSAT,JOHAR BARU,KAMPUNG RAWA,21237,6597,14640,6230,20870,2021-08-15
3175041002,JAKARTA TIMUR,KRAMAT JATI,KAMPUNG TENGAH,43993,20288,23705,10192,33897,2021-08-15
3173011005,JAKARTA BARAT,CENGKARENG,KAPUK,134466,57997,76469,27643,104112,2021-08-15
3172011003,JAKARTA UTARA,PENJARINGAN,KAPUK MUARA,35781,12529,23252,13717,36969,2021-08-15
3171021002,JAKARTA PUSAT,SAWAH BESAR,KARANG ANYAR,25761,9735,16026,7402,23428,2021-08-15
3174021004,JAKARTA SELATAN,SETIA BUDI,KARET,9623,3920,5703,3087,8790,2021-08-15
3174021003,JAKARTA SELATAN,SETIA BUDI,KARET KUNINGAN,16055,5827,10228,5729,15957,2021-08-15
3174021002,JAKARTA SELATAN,SETIA BUDI,KARET SEMANGGI,2770,995,1775,1193,2968,2021-08-15
3171071003,JAKARTA PUSAT,TANAH ABANG,KARET TENGSIN,19271,7869,11402,5246,16648,2021-08-15
3171021003,JAKARTA PUSAT,SAWAH BESAR,KARTINI,22292,8514,13778,7317,21095,2021-08-15
3175011003,JAKARTA TIMUR,MATRAMAN,KAYU MANIS,25284,11041,14243,6415,20658,2021-08-15
3175021006,JAKARTA TIMUR,PULO GADUNG,KAYU PUTIH,40696,15413,25283,14080,39363,2021-08-15
3173031006,JAKARTA BARAT,TAMAN SARI,KEAGUNGAN,17387,6477,10910,5399,16309,2021-08-15
3174041007,JAKARTA SELATAN,PASAR MINGGU,KEBAGUSAN,44552,18639,25913,12796,38709,2021-08-15
3174051006,JAKARTA SELATAN,KEBAYORAN LAMA,KEBAYORAN LAMA SELATAN,41212,16153,25059,12544,37603,2021-08-15
3174051001,JAKARTA SELATAN,KEBAYORAN LAMA,KEBAYORAN LAMA UTARA,42422,17835,24587,11144,35731,2021-08-15
3174011004,JAKARTA SELATAN,TEBET,KEBON BARU,35165,14114,21051,10597,31648,2021-08-15
3172021005,JAKARTA UTARA,TANJUNG PRIOK,KEBON BAWANG,50952,20953,29999,15487,45486,2021-08-15
3173051001,JAKARTA BARAT,KEBON JERUK,KEBON JERUK,53887,23184,30703,14252,44955,2021-08-15
3171071006,JAKARTA PUSAT,TANAH ABANG,KEBON KACANG,21531,10305,11226,5354,16580,2021-08-15
3171011005,JAKARTA PUSAT,GAMBIR,KEBON KELAPA,10163,3983,6180,3135,9315,2021-08-15
3171031002,JAKARTA PUSAT,KEMAYORAN,KEBON KOSONG,30019,12352,17667,8827,26494,2021-08-15
3175011005,JAKARTA TIMUR,MATRAMAN,KEBON MANGGIS,16490,6470,10020,5293,15313,2021-08-15
3171071005,JAKARTA PUSAT,TANAH ABANG,KEBON MELATI,32206,16378,15828,6800,22628,2021-08-15
3175081003,JAKARTA TIMUR,MAKASAR,KEBON PALA,46614,18716,27898,12442,40340,2021-08-15
3171061005,JAKARTA PUSAT,MENTENG,KEBON SIRIH,12299,5375,6924,3092,10016,2021-08-15
3173011004,JAKARTA BARAT,CENGKARENG,KEDAUNG KALI ANGKE,32612,11730,20882,9177,30059,2021-08-15
3173051007,JAKARTA BARAT,KEBON JERUK,KEDOYA SELATAN,32165,12326,19839,8892,28731,2021-08-15
3173051006,JAKARTA BARAT,KEBON JERUK,KEDOYA UTARA,45740,16509,29231,13762,42993,2021-08-15
3173051004,JAKARTA BARAT,KEBON JERUK,KELAPA DUA,23565,9651,13914,6314,20228,2021-08-15
3175091003,JAKARTA TIMUR,CIRACAS,KELAPA DUA WETAN,46875,17338,29537,14361,43898,2021-08-15
3172061003,JAKARTA UTARA,KELAPA GADING,KELAPA GADING BARAT,35717,12410,23307,15091,38398,2021-08-15
3172061001,JAKARTA UTARA,KELAPA GADING,KELAPA GADING TIMUR,33592,10836,22756,14824,37580,2021-08-15
3173071005,JAKARTA BARAT,PALMERAH,KEMANGGISAN,32139,13156,18983,9328,28311,2021-08-15
3171031001,JAKARTA PUSAT,KEMAYORAN,KEMAYORAN,20708,8016,12692,6336,19028,2021-08-15
3173081006,JAKARTA BARAT,KEMBANGAN,KEMBANGAN SELATAN,27130,10744,16386,8812,25198,2021-08-15
3173081001,JAKARTA BARAT,KEMBANGAN,KEMBANGAN UTARA,54451,21488,32963,14785,47748,2021-08-15
3171041002,JAKARTA PUSAT,SENEN,KENARI,9579,3647,5932,2942,8874,2021-08-15
3173041005,JAKARTA BARAT,TAMBORA,KERENDANG,19973,7838,12135,5745,17880,2021-08-15
3175071003,JAKARTA TIMUR,DUREN SAWIT,KLENDER,69978,31639,38339,15818,54157,2021-08-15
3172031001,JAKARTA UTARA,KOJA,KOJA,28175,11724,16451,8666,25117,2021-08-15
3173071006,JAKARTA BARAT,PALMERAH,KOTA BAMBU SELATAN,21158,8720,12438,5310,17748,2021-08-15
3173071003,JAKARTA BARAT,PALMERAH,KOTA BAMBU UTARA,24995,10772,14223,6160,20383,2021-08-15
3171041004,JAKARTA PUSAT,SENEN,KRAMAT,28835,12963,15872,6763,22635,2021-08-15
3175041001,JAKARTA TIMUR,KRAMAT JATI,KRAMAT JATI,34144,13950,20194,8949,29143,2021-08-15
3174071003,JAKARTA SELATAN,KEBAYORAN BARU,KRAMAT PELA,14413,5418,8995,4743,13738,2021-08-15
3173031002,JAKARTA BARAT,TAMAN SARI,KRUKUT,19244,7432,11812,4989,16801,2021-08-15
3174031005,JAKARTA SELATAN,MAMPANG PRAPATAN,KUNINGAN BARAT,12785,4910,7875,4249,12124,2021-08-15
3174021008,JAKARTA SELATAN,SETIA BUDI,KUNINGAN TIMUR,6008,2375,3633,2096,5729,2021-08-15
3171041005,JAKARTA PUSAT,SENEN,KWITANG,15486,6138,9348,4372,13720,2021-08-15
3172031003,JAKARTA UTARA,KOJA,LAGOA,59065,26111,32954,15288,48242,2021-08-15
3174061002,JAKARTA SELATAN,CILANDAK,LEBAK BULUS,37626,15506,22120,12029,34149,2021-08-15
3174091004,JAKARTA SELATAN,JAGAKARSA,LENTENG AGUNG,53946,22204,31742,14689,46431,2021-08-15
3175101007,JAKARTA TIMUR,CIPAYUNG,LUBANG BUAYA,63547,24045,39502,19108,58610,2021-08-15
3175081001,JAKARTA TIMUR,MAKASAR,MAKASAR,34390,13330,21060,10194,31254,2021-08-15
3175071006,JAKARTA TIMUR,DUREN SAWIT,MALAKA JAYA,30927,12500,18427,10429,28856,2021-08-15
3175071005,JAKARTA TIMUR,DUREN SAWIT,MALAKA SARI,27530,10834,16696,9437,26133,2021-08-15
3174031001,JAKARTA SELATAN,MAMPANG PRAPATAN,MAMPANG PRAPATAN,18159,7283,10876,5902,16778,2021-08-15
3173031005,JAKARTA BARAT,TAMAN SARI,MANGGA BESAR,7707,2711,4996,2981,7977,2021-08-15
3171021005,JAKARTA PUSAT,SAWAH BESAR,MANGGA DUA SELATAN,27442,10742,16700,8633,25333,2021-08-15
3174011007,JAKARTA SELATAN,TEBET,MANGGARAI,28373,10657,17716,8009,25725,2021-08-15
3174011006,JAKARTA SELATAN,TEBET,MANGGARAI SELATAN,23075,8806,14269,7509,21778,2021-08-15
3173031003,JAKARTA BARAT,TAMAN SARI,MAPHAR,16461,6436,10025,5443,15468,2021-08-15
3172041003,JAKARTA UTARA,CILINCING,MARUNDA,28943,11338,17605,7041,24646,2021-08-15
3174071001,JAKARTA SELATAN,KEBAYORAN BARU,MELAWAI,2627,952,1675,1239,2914,2021-08-15
3171061001,JAKARTA PUSAT,MENTENG,MENTENG,25624,11009,14615,6886,21501,2021-08-15
3174021005,JAKARTA SELATAN,SETIA BUDI,MENTENG ATAS,27816,10520,17296,8744,26040,2021-08-15
3174011003,JAKARTA SELATAN,TEBET,MENTENG DALAM,36028,14349,21679,10916,32595,2021-08-15
3173081003,JAKARTA BARAT,KEMBANGAN,MERUYA SELATAN,32130,12833,19297,8970,28267,2021-08-15
3173081002,JAKARTA BARAT,KEMBANGAN,MERUYA UTARA,43752,17751,26001,13455,39456,2021-08-15
3175101004,JAKARTA TIMUR,CIPAYUNG,MUNJUL,23871,8895,14976,6898,21874,2021-08-15
3172051002,JAKARTA UTARA,PADEMANGAN,PADEMANGAN BARAT,74240,31056,43184,19976,63160,2021-08-15
3172051001,JAKARTA UTARA,PADEMANGAN,PADEMANGAN TIMUR,37736,13330,24406,13586,37992,2021-08-15
3175011004,JAKARTA TIMUR,MATRAMAN,PAL MERIAM,19769,8376,11393,5549,16942,2021-08-15
3173071001,JAKARTA BARAT,PALMERAH,PALMERAH,63011,26064,36947,16439,53386,2021-08-15
3174081001,JAKARTA SELATAN,PANCORAN,PANCORAN,19421,7799,11622,6147,17769,2021-08-15
3172021003,JAKARTA UTARA,TANJUNG PRIOK,PAPANGGO,39097,14731,24366,12140,36506,2021-08-15
3171021001,JAKARTA PUSAT,SAWAH BESAR,PASAR BARU,12035,4055,7980,4671,12651,2021-08-15
3174021006,JAKARTA SELATAN,SETIA BUDI,PASAR MANGGIS,26752,10855,15897,8488,24385,2021-08-15
3174041001,JAKARTA SELATAN,PASAR MINGGU,PASAR MINGGU,24821,9858,14963,8375,23338,2021-08-15
3171041003,JAKARTA PUSAT,SENEN,PASEBAN,23533,9751,13782,6426,20208,2021-08-15
3173061005,JAKARTA BARAT,KALI DERES,PEGADUNGAN,75587,27844,47743,22387,70130,2021-08-15
3171061002,JAKARTA PUSAT,MENTENG,PEGANGSAAN,23455,10364,13091,5993,19084,2021-08-15
3172061002,JAKARTA UTARA,KELAPA GADING,PEGANGSAAN DUA,49976,15941,34035,20244,54279,2021-08-15
3172011004,JAKARTA UTARA,PENJARINGAN,PEJAGALAN,74578,29125,45453,24721,70174,2021-08-15
3174041006,JAKARTA SELATAN,PASAR MINGGU,PEJATEN BARAT,37346,15675,21671,12090,33761,2021-08-15
3174041005,JAKARTA SELATAN,PASAR MINGGU,PEJATEN TIMUR,57656,24792,32864,15548,48412,2021-08-15
3175051005,JAKARTA TIMUR,PASAR REBO,PEKAYON,43250,16484,26766,13028,39794,2021-08-15
3173041009,JAKARTA BARAT,TAMBORA,PEKOJAN,23587,9116,14471,7472,21943,2021-08-15
3174031003,JAKARTA SELATAN,MAMPANG PRAPATAN,PELA MAMPANG,43522,17144,26378,14338,40716,2021-08-15
3174081005,JAKARTA SELATAN,PANCORAN,PENGADEGAN,21478,7883,13595,6654,20249,2021-08-15
3175061003,JAKARTA TIMUR,CAKUNG,PENGGILINGAN,99255,44643,54612,20700,75312,2021-08-15
3172011001,JAKARTA UTARA,PENJARINGAN,PENJARINGAN,88308,38833,49475,21759,71234,2021-08-15
3174101001,JAKARTA SELATAN,PESANGGRAHAN,PESANGGRAHAN,27545,10184,17361,9398,26759,2021-08-15
3171071004,JAKARTA PUSAT,TANAH ABANG,PETAMBURAN,33271,16695,16576,6721,23297,2021-08-15
3174071008,JAKARTA SELATAN,KEBAYORAN BARU,PETOGOGAN,11499,4581,6918,4070,10988,2021-08-15
3171011004,JAKARTA PUSAT,GAMBIR,PETOJO SELATAN,14692,5875,8817,4844,13661,2021-08-15
3171011003,JAKARTA PUSAT,GAMBIR,PETOJO UTARA,17458,6900,10558,4836,15394,2021-08-15
3174101004,JAKARTA SELATAN,PESANGGRAHAN,PETUKANGAN SELATAN,37187,14624,22563,11079,33642,2021-08-15
3174101003,JAKARTA SELATAN,PESANGGRAHAN,PETUKANGAN UTARA,53716,22582,31134,15691,46825,2021-08-15
3175081002,JAKARTA TIMUR,MAKASAR,PINANG RANTI,27198,11088,16110,7814,23924,2021-08-15
3173031008,JAKARTA BARAT,TAMAN SARI,PINANGSIA,10729,3859,6870,3762,10632,2021-08-15
3175011001,JAKARTA TIMUR,MATRAMAN,PISANGAN BARU,31776,13687,18089,7637,25726,2021-08-15
3175021002,JAKARTA TIMUR,PULO GADUNG,PISANGAN TIMUR,41011,15673,25338,11641,36979,2021-08-15
3172011005,JAKARTA UTARA,PENJARINGAN,PLUIT,47783,18072,29711,19698,49409,2021-08-15
3175071002,JAKARTA TIMUR,DUREN SAWIT,PONDOK BAMBU,61550,26989,34561,16725,51286,2021-08-15
3175071004,JAKARTA TIMUR,DUREN SAWIT,PONDOK KELAPA,72015,28739,43276,21067,64343,2021-08-15
3175071007,JAKARTA TIMUR,DUREN SAWIT,PONDOK KOPI,35367,16166,19201,8553,27754,2021-08-15
3174061003,JAKARTA SELATAN,CILANDAK,PONDOK LABU,46464,17489,28975,15954,44929,2021-08-15
3174051002,JAKARTA SELATAN,KEBAYORAN LAMA,PONDOK PINANG,56169,22400,33769,18492,52261,2021-08-15
3175101003,JAKARTA TIMUR,CIPAYUNG,PONDOK RANGGON,25574,9922,15652,7393,23045,2021-08-15
3101011003,KAB.ADM.KEP.SERIBU,KEP. SERIBU UTARA,PULAU HARAPAN,2060,375,1685,920,2605,2021-08-15
3101011002,KAB.ADM.KEP.SERIBU,KEP. SERIBU UTARA,PULAU KELAPA,5528,1023,4505,2026,6531,2021-08-15
3101011001,KAB.ADM.KEP.SERIBU,KEP. SERIBU UTARA,PULAU PANGGANG,5450,950,4500,1934,6434,2021-08-15
3101021003,KAB.ADM.KEP.SERIBU,KEP. SERIBU SELATAN,PULAU PARI,2765,347,2418,1271,3689,2021-08-15
3101021002,KAB.ADM.KEP.SERIBU,KEP. SERIBU SELATAN,PULAU TIDUNG,4553,703,3850,2393,6243,2021-08-15
3101021001,KAB.ADM.KEP.SERIBU,KEP. SERIBU SELATAN,PULAU UNTUNG JAWA,1941,358,1583,794,2377,2021-08-15
3174071007,JAKARTA SELATAN,KEBAYORAN BARU,PULO,5835,2110,3725,2448,6173,2021-08-15
3175021001,JAKARTA TIMUR,PULO GADUNG,PULO GADUNG,34422,14159,20263,9785,30048,2021-08-15
3175061005,JAKARTA TIMUR,CAKUNG,PULO GEBANG,97301,41315,55986,23313,79299,2021-08-15
3174041004,JAKARTA SELATAN,PASAR MINGGU,RAGUNAN,39616,15073,24543,13104,37647,2021-08-15
3175091005,JAKARTA TIMUR,CIRACAS,RAMBUTAN,36771,16662,20109,9119,29228,2021-08-15
3172031006,JAKARTA UTARA,KOJA,RAWA BADAK SELATAN,42179,19014,23165,10555,33720,2021-08-15
3172031004,JAKARTA UTARA,KOJA,RAWA BADAK UTARA,34408,15050,19358,9871,29229,2021-08-15
3174071005,JAKARTA SELATAN,KEBAYORAN BARU,RAWA BARAT,5625,2042,3583,2231,5814,2021-08-15
3173011003,JAKARTA BARAT,CENGKARENG,RAWA BUAYA,63799,26401,37398,14113,51511,2021-08-15
3175031004,JAKARTA TIMUR,JATINEGARA,RAWA BUNGA,21434,9396,12038,5364,17402,2021-08-15
3174081003,JAKARTA SELATAN,PANCORAN,RAWA JATI,20509,7991,12518,6634,19152,2021-08-15
3175061002,JAKARTA TIMUR,CAKUNG,RAWA TERATE,24637,9043,15594,5729,21323,2021-08-15
3175021005,JAKARTA TIMUR,PULO GADUNG,RAWAMANGUN,37612,15403,22209,11375,33584,2021-08-15
3171051003,JAKARTA PUSAT,CEMPAKA PUTIH,RAWASARI,21967,8955,13012,6910,19922,2021-08-15
3173041010,JAKARTA BARAT,TAMBORA,ROA MALAKA,3484,1115,2369,1424,3793,2021-08-15
3172041006,JAKARTA UTARA,CILINCING,ROROTAN,41668,16069,25599,11463,37062,2021-08-15
3174071004,JAKARTA SELATAN,KEBAYORAN BARU,SELONG,2842,1038,1804,1281,3085,2021-08-15
3173061002,JAKARTA BARAT,KALI DERES,SEMANAN,71354,29835,41519,14311,55830,2021-08-15
3172041007,JAKARTA UTARA,CILINCING,SEMPER BARAT,68587,25528,43059,21732,64791,2021-08-15
3172041005,JAKARTA UTARA,CILINCING,SEMPER TIMUR,36267,14208,22059,10868,32927,2021-08-15
3174071006,JAKARTA SELATAN,KEBAYORAN BARU,SENAYAN,2771,1246,1525,942,2467,2021-08-15
3171041001,JAKARTA PUSAT,SENEN,SENEN,6804,2565,4239,2346,6585,2021-08-15
3171031004,JAKARTA PUSAT,KEMAYORAN,SERDANG,29668,11869,17799,8389,26188,2021-08-15
3174021001,JAKARTA SELATAN,SETIA BUDI,SETIA BUDI,3023,1208,1815,1055,2870,2021-08-15
3175101005,JAKARTA TIMUR,CIPAYUNG,SETU,20572,8603,11969,5085,17054,2021-08-15
3173071002,JAKARTA BARAT,PALMERAH,SLIPI,16591,6389,10202,5284,15486,2021-08-15
3173081004,JAKARTA BARAT,KEMBANGAN,SRENGSENG,45523,19697,25826,12560,38386,2021-08-15
3174091002,JAKARTA SELATAN,JAGAKARSA,SRENGSENG SAWAH,58196,20129,38067,20810,58877,2021-08-15
3173051003,JAKARTA BARAT,KEBON JERUK,SUKABUMI SELATAN,37033,16014,21019,8464,29483,2021-08-15
3173051002,JAKARTA BARAT,KEBON JERUK,SUKABUMI UTARA,38290,17514,20776,8860,29636,2021-08-15
3172041002,JAKARTA UTARA,CILINCING,SUKAPURA,53949,22161,31788,15234,47022,2021-08-15
3171031007,JAKARTA PUSAT,KEMAYORAN,SUMUR BATU,22717,9322,13395,6941,20336,2021-08-15
3172021004,JAKARTA UTARA,TANJUNG PRIOK,SUNGAI BAMBU,29876,11688,18188,9196,27384,2021-08-15
3172021006,JAKARTA UTARA,TANJUNG PRIOK,SUNTER AGUNG,71805,25097,46708,26731,73439,2021-08-15
3172021002,JAKARTA UTARA,TANJUNG PRIOK,SUNTER JAYA,63031,22823,40208,21921,62129,2021-08-15
3175091004,JAKARTA TIMUR,CIRACAS,SUSUKAN,38257,14116,24141,11392,35533,2021-08-15
3173031001,JAKARTA BARAT,TAMAN SARI,TAMAN SARI,14348,5511,8837,4915,13752,2021-08-15
3173041001,JAKARTA BARAT,TAMBORA,TAMBORA,10204,4129,6075,2788,8863,2021-08-15
3173041004,JAKARTA BARAT,TAMBORA,TANAH SEREAL,26387,8969,17418,7952,25370,2021-08-15
3171081004,JAKARTA PUSAT,JOHAR BARU,TANAH TINGGI,37693,13021,24672,11058,35730,2021-08-15
3173031004,JAKARTA BARAT,TAMAN SARI,TANGKI,13324,5101,8223,4386,12609,2021-08-15
3174091005,JAKARTA SELATAN,JAGAKARSA,TANJUNG BARAT,39770,15372,24398,12067,36465,2021-08-15
3173021005,JAKARTA BARAT,GROGOL PETAMBURAN,TANJUNG DUREN SELATAN,25337,9671,15666,8447,24113,2021-08-15
3173021002,JAKARTA BARAT,GROGOL PETAMBURAN,TANJUNG DUREN UTARA,17010,6172,10838,6009,16847,2021-08-15
3172021001,JAKARTA UTARA,TANJUNG PRIOK,TANJUNG PRIOK,34588,12796,21792,9586,31378,2021-08-15
3174011002,JAKARTA SELATAN,TEBET,TEBET BARAT,21194,7679,13515,7887,21402,2021-08-15
3174011001,JAKARTA SELATAN,TEBET,TEBET TIMUR,18199,6591,11608,6811,18419,2021-08-15
3173061003,JAKARTA BARAT,KALI DERES,TEGAL ALUR,83647,32946,50701,18655,69356,2021-08-15
3174031004,JAKARTA SELATAN,MAMPANG PRAPATAN,TEGAL PARANG,32401,13916,18485,8932,27417,2021-08-15
3173021003,JAKARTA BARAT,GROGOL PETAMBURAN,TOMANG,29605,11391,18214,9996,28210,2021-08-15
3172031005,JAKARTA UTARA,KOJA,TUGU SELATAN,39122,17111,22011,10180,32191,2021-08-15
3172031002,JAKARTA UTARA,KOJA,TUGU UTARA,67670,30130,37540,17801,55341,2021-08-15
3175061006,JAKARTA TIMUR,CAKUNG,UJUNG MENTENG,29934,11045,18889,8652,27541,2021-08-15
3174101005,JAKARTA SELATAN,PESANGGRAHAN,ULUJAMI,40544,17457,23087,10375,33462,2021-08-15
3175011006,JAKARTA TIMUR,MATRAMAN,UTAN KAYU SELATAN,33511,13191,20320,10183,30503,2021-08-15
3175011002,JAKARTA TIMUR,MATRAMAN,UTAN KAYU UTARA,28169,11902,16267,7927,24194,2021-08-15
3171031008,JAKARTA PUSAT,KEMAYORAN,UTAN PANJANG,29208,12148,17060,7181,24241,2021-08-15
3172021007,JAKARTA UTARA,TANJUNG PRIOK,WARAKAS,44401,17366,27035,13299,40334,2021-08-15
3173021007,JAKARTA BARAT,GROGOL PETAMBURAN,WIJAYA KUSUMA,38934,16127,22807,11044,33851,2021-08-15
3172051003,JAKARTA UTARA,PADEMANGAN,ANCOL,23947,10004,13943,6511,20454,2021-08-16
3173041007,JAKARTA BARAT,TAMBORA,ANGKE,29381,11054,18327,7925,26252,2021-08-16
3175041005,JAKARTA TIMUR,KRAMAT JATI,BALE KAMBANG,29074,13990,15084,5698,20782,2021-08-16
3175031003,JAKARTA TIMUR,JATINEGARA,BALI MESTER,9752,4025,5727,2895,8622,2021-08-16
3175101006,JAKARTA TIMUR,CIPAYUNG,BAMBU APUS,26285,10370,15915,7335,23250,2021-08-16
3174031002,JAKARTA SELATAN,MAMPANG PRAPATAN,BANGKA,21566,8900,12666,6329,18995,2021-08-16
3175051002,JAKARTA TIMUR,PASAR REBO,BARU,23886,8469,15417,8928,24345,2021-08-16
3175041004,JAKARTA TIMUR,KRAMAT JATI,BATU AMPAR,47898,22057,25841,11096,36937,2021-08-16
3171071002,JAKARTA PUSAT,TANAH ABANG,BENDUNGAN HILIR,21494,8584,12910,6896,19806,2021-08-16
3175031002,JAKARTA TIMUR,JATINEGARA,BIDARA CINA,36689,17057,19632,8611,28243,2021-08-16
3174101002,JAKARTA SELATAN,PESANGGRAHAN,BINTARO,53098,21212,31886,16971,48857,2021-08-16
3174011005,JAKARTA SELATAN,TEBET,BUKIT DURI,34183,14541,19642,9501,29143,2021-08-16
3171041006,JAKARTA PUSAT,SENEN,BUNGUR,18144,7075,11069,5524,16593,2021-08-16
3175061007,JAKARTA TIMUR,CAKUNG,CAKUNG BARAT,57724,21393,36331,14498,50829,2021-08-16
3175061004,JAKARTA TIMUR,CAKUNG,CAKUNG TIMUR,58287,22041,36246,16409,52655,2021-08-16
3175041007,JAKARTA TIMUR,KRAMAT JATI,CAWANG,32762,14350,18412,8675,27087,2021-08-16
3175101008,JAKARTA TIMUR,CIPAYUNG,CEGER,18932,7283,11649,5170,16819,2021-08-16
3171031006,JAKARTA PUSAT,KEMAYORAN,CEMPAKA BARU,32581,14165,18416,8762,27178,2021-08-16
3171051002,JAKARTA PUSAT,CEMPAKA PUTIH,CEMPAKA PUTIH BARAT,35885,14637,21248,11166,32414,2021-08-16
3171051001,JAKARTA PUSAT,CEMPAKA PUTIH,CEMPAKA PUTIH TIMUR,24292,9735,14557,8059,22616,2021-08-16
3173011001,JAKARTA BARAT,CENGKARENG,CENGKARENG BARAT,66284,25810,40474,20652,61126,2021-08-16
3173011006,JAKARTA BARAT,CENGKARENG,CENGKARENG TIMUR,81027,31544,49483,21147,70630,2021-08-16
3175091002,JAKARTA TIMUR,CIRACAS,CIBUBUR,66364,24832,41532,21843,63375,2021-08-16
3171011002,JAKARTA PUSAT,GAMBIR,CIDENG,15390,5536,9854,5486,15340,2021-08-16
3174091003,JAKARTA SELATAN,JAGAKARSA,CIGANJUR,38497,14930,23567,11904,35471,2021-08-16
3175051003,JAKARTA TIMUR,PASAR REBO,CIJANTUNG,41419,15567,25852,13516,39368,2021-08-16
3171061003,JAKARTA PUSAT,MENTENG,CIKINI,8274,3593,4681,2410,7091,2021-08-16
3174081006,JAKARTA SELATAN,PANCORAN,CIKOKO,10547,3838,6709,3433,10142,2021-08-16
3174061001,JAKARTA SELATAN,CILANDAK,CILANDAK BARAT,51752,19936,31816,17712,49528,2021-08-16
3174041003,JAKARTA SELATAN,PASAR MINGGU,CILANDAK TIMUR,25145,9473,15672,9184,24856,2021-08-16
3175101002,JAKARTA TIMUR,CIPAYUNG,CILANGKAP,27635,10505,17130,8020,25150,2021-08-16
3175041006,JAKARTA TIMUR,KRAMAT JATI,CILILITAN,40181,17906,22275,10365,32640,2021-08-16
3172041001,JAKARTA UTARA,CILINCING,CILINCING,43609,18404,25205,11651,36856,2021-08-16
3175101001,JAKARTA TIMUR,CIPAYUNG,CIPAYUNG,26104,9368,16736,8690,25426,2021-08-16
3174091006,JAKARTA SELATAN,JAGAKARSA,CIPEDAK,38303,13799,24504,13244,37748,2021-08-16
3174061005,JAKARTA SELATAN,CILANDAK,CIPETE SELATAN,26704,10812,15892,9116,25008,2021-08-16
3174071010,JAKARTA SELATAN,KEBAYORAN BARU,CIPETE UTARA,34102,13453,20649,10718,31367,2021-08-16
3175021003,JAKARTA TIMUR,PULO GADUNG,CIPINANG,39306,16165,23141,11695,34836,2021-08-16
3175031007,JAKARTA TIMUR,JATINEGARA,CIPINANG BESAR SELATAN,35212,16342,18870,7952,26822,2021-08-16
3175031008,JAKARTA TIMUR,JATINEGARA,CIPINANG BESAR UTARA,45319,20097,25222,9863,35085,2021-08-16
3175031005,JAKARTA TIMUR,JATINEGARA,CIPINANG CEMPEDAK,32824,14509,18315,9390,27705,2021-08-16
3175081005,JAKARTA TIMUR,MAKASAR,CIPINANG MELAYU,42308,17541,24767,12852,37619,2021-08-16
3175031006,JAKARTA TIMUR,JATINEGARA,CIPINANG MUARA,55243,24117,31126,14151,45277,2021-08-16
3174051003,JAKARTA SELATAN,KEBAYORAN LAMA,CIPULIR,39937,17063,22874,10530,33404,2021-08-16
3175091001,JAKARTA TIMUR,CIRACAS,CIRACAS,64594,24066,40528,19422,59950,2021-08-16
3175041003,JAKARTA TIMUR,KRAMAT JATI,DUKUH,24609,9604,15005,6842,21847,2021-08-16
3175071001,JAKARTA TIMUR,DUREN SAWIT,DUREN SAWIT,61160,26756,34404,17660,52064,2021-08-16
3174081004,JAKARTA SELATAN,PANCORAN,DUREN TIGA,28319,11265,17054,8006,25060,2021-08-16
3173051005,JAKARTA BARAT,KEBON JERUK,DURI KEPA,60138,22389,37749,19779,57528,2021-08-16
3173011002,JAKARTA BARAT,CENGKARENG,DURI KOSAMBI,77923,33893,44030,19555,63585,2021-08-16
3171011006,JAKARTA PUSAT,GAMBIR,DURI PULO,19610,7701,11909,5060,16969,2021-08-16
3173041011,JAKARTA BARAT,TAMBORA,DURI SELATAN,14259,5016,9243,4411,13654,2021-08-16
3173041003,JAKARTA BARAT,TAMBORA,DURI UTARA,19844,7302,12542,5593,18135,2021-08-16
3171081003,JAKARTA PUSAT,JOHAR BARU,GALUR,18243,6261,11982,4979,16961,2021-08-16
3171011001,JAKARTA PUSAT,GAMBIR,GAMBIR,2191,797,1394,802,2196,2021-08-16
3174061004,JAKARTA SELATAN,CILANDAK,GANDARIA SELATAN,22119,8808,13311,6959,20270,2021-08-16
3174071009,JAKARTA SELATAN,KEBAYORAN BARU,GANDARIA UTARA,39922,16132,23790,12282,36072,2021-08-16
3175051001,JAKARTA TIMUR,PASAR REBO,GEDONG,35755,13769,21986,11153,33139,2021-08-16
3171071001,JAKARTA PUSAT,TANAH ABANG,GELORA,3127,1301,1826,943,2769,2021-08-16
3173031007,JAKARTA BARAT,TAMAN SARI,GLODOK,7837,2615,5222,3257,8479,2021-08-16
3171061004,JAKARTA PUSAT,MENTENG,GONDANGDIA,4100,1620,2480,1767,4247,2021-08-16
3173021001,JAKARTA BARAT,GROGOL PETAMBURAN,GROGOL,16876,6603,10273,5329,15602,2021-08-16
3174051005,JAKARTA SELATAN,KEBAYORAN LAMA,GROGOL SELATAN,44251,18346,25905,11643,37548,2021-08-16
3174051004,JAKARTA SELATAN,KEBAYORAN LAMA,GROGOL UTARA,42494,17137,25357,11764,37121,2021-08-16
3174021007,JAKARTA SELATAN,SETIA BUDI,GUNTUR,3985,1486,2499,1667,4166,2021-08-16
3174071002,JAKARTA SELATAN,KEBAYORAN BARU,GUNUNG,9436,3546,5890,3663,9553,2021-08-16
3171031005,JAKARTA PUSAT,KEMAYORAN,GUNUNG SAHARI SELATAN,19199,7698,11501,6079,17580,2021-08-16
3171021004,JAKARTA PUSAT,SAWAH BESAR,GUNUNG SAHARI UTARA,16650,5731,10919,6224,17143,2021-08-16
3175081004,JAKARTA TIMUR,MAKASAR,HALIM PERDANA KUSUMAH,28363,8618,19745,14097,33842,2021-08-16
3171031003,JAKARTA PUSAT,KEMAYORAN,HARAPAN MULIA,22557,9246,13311,6290,19601,2021-08-16
3174091001,JAKARTA SELATAN,JAGAKARSA,JAGAKARSA,62389,23516,38873,20766,59639,2021-08-16
3175021007,JAKARTA TIMUR,PULO GADUNG,JATI,32757,13173,19584,10373,29957,2021-08-16
3174041002,JAKARTA SELATAN,PASAR MINGGU,JATI PADANG,37502,14912,22590,12335,34925,2021-08-16
3173071004,JAKARTA BARAT,PALMERAH,JATI PULO,28738,11015,17723,7410,25133,2021-08-16
3175061001,JAKARTA TIMUR,CAKUNG,JATINEGARA,84160,34906,49254,19517,68771,2021-08-16
3175021004,JAKARTA TIMUR,PULO GADUNG,JATINEGARA KAUM,24632,9116,15516,6226,21742,2021-08-16
3173021004,JAKARTA BARAT,GROGOL PETAMBURAN,JELAMBAR,30266,11714,18552,10386,28938,2021-08-16
3173021006,JAKARTA BARAT,GROGOL PETAMBURAN,JELAMBAR BARU,38246,14846,23400,12604,36004,2021-08-16
3173041006,JAKARTA BARAT,TAMBORA,JEMBATAN BESI,29314,13646,15668,6079,21747,2021-08-16
3173041008,JAKARTA BARAT,TAMBORA,JEMBATAN LIMA,21021,8991,12030,5477,17507,2021-08-16
3173081005,JAKARTA BARAT,KEMBANGAN,JOGLO,40839,16657,24182,11596,35778,2021-08-16
3171081001,JAKARTA PUSAT,JOHAR BARU,JOHAR BARU,37488,13477,24011,11680,35691,2021-08-16
3173041002,JAKARTA BARAT,TAMBORA,KALI ANYAR,23856,8772,15084,5454,20538,2021-08-16
3172041004,JAKARTA UTARA,CILINCING,KALIBARU,67684,30645,37039,15695,52734,2021-08-16
3174081002,JAKARTA SELATAN,PANCORAN,KALIBATA,41994,18415,23579,10519,34098,2021-08-16
3173061001,JAKARTA BARAT,KALI DERES,KALIDERES,72447,28453,43994,20224,64218,2021-08-16
3175051004,JAKARTA TIMUR,PASAR REBO,KALISARI,43212,16724,26488,13816,40304,2021-08-16
3173061004,JAKARTA BARAT,KALI DERES,KAMAL,53783,22199,31584,10198,41782,2021-08-16
3172011002,JAKARTA UTARA,PENJARINGAN,KAMAL MUARA,12930,3902,9028,5502,14530,2021-08-16
3171071007,JAKARTA PUSAT,TANAH ABANG,KAMPUNG BALI,11358,5147,6211,3080,9291,2021-08-16
3175031001,JAKARTA TIMUR,JATINEGARA,KAMPUNG MELAYU,25717,11366,14351,5957,20308,2021-08-16
3171081002,JAKARTA PUSAT,JOHAR BARU,KAMPUNG RAWA,21237,6510,14727,6275,21002,2021-08-16
3175041002,JAKARTA TIMUR,KRAMAT JATI,KAMPUNG TENGAH,43993,20173,23820,10259,34079,2021-08-16
3173011005,JAKARTA BARAT,CENGKARENG,KAPUK,134466,57651,76815,28650,105465,2021-08-16
3172011003,JAKARTA UTARA,PENJARINGAN,KAPUK MUARA,35781,12442,23339,13847,37186,2021-08-16
3171021002,JAKARTA PUSAT,SAWAH BESAR,KARANG ANYAR,25761,9588,16173,7458,23631,2021-08-16
3174021004,JAKARTA SELATAN,SETIA BUDI,KARET,9623,3911,5712,3108,8820,2021-08-16
3174021003,JAKARTA SELATAN,SETIA BUDI,KARET KUNINGAN,16055,5778,10277,5792,16069,2021-08-16
3174021002,JAKARTA SELATAN,SETIA BUDI,KARET SEMANGGI,2770,991,1779,1204,2983,2021-08-16
3171071003,JAKARTA PUSAT,TANAH ABANG,KARET TENGSIN,19271,7751,11520,5303,16823,2021-08-16
3171021003,JAKARTA PUSAT,SAWAH BESAR,KARTINI,22292,8466,13826,7351,21177,2021-08-16
3175011003,JAKARTA TIMUR,MATRAMAN,KAYU MANIS,25284,10979,14305,6485,20790,2021-08-16
3175021006,JAKARTA TIMUR,PULO GADUNG,KAYU PUTIH,40696,15362,25334,14213,39547,2021-08-16
3173031006,JAKARTA BARAT,TAMAN SARI,KEAGUNGAN,17387,6438,10949,5439,16388,2021-08-16
3174041007,JAKARTA SELATAN,PASAR MINGGU,KEBAGUSAN,44552,18525,26027,12865,38892,2021-08-16
3174051006,JAKARTA SELATAN,KEBAYORAN LAMA,KEBAYORAN LAMA SELATAN,41212,16023,25189,12655,37844,2021-08-16
3174051001,JAKARTA SELATAN,KEBAYORAN LAMA,KEBAYORAN LAMA UTARA,42422,17737,24685,11206,35891,2021-08-16
3174011004,JAKARTA SELATAN,TEBET,KEBON BARU,35165,14060,21105,10663,31768,2021-08-16
3172021005,JAKARTA UTARA,TANJUNG PRIOK,KEBON BAWANG,50952,20700,30252,15698,45950,2021-08-16
3173051001,JAKARTA BARAT,KEBON JERUK,KEBON JERUK,53887,23005,30882,14374,45256,2021-08-16
3171071006,JAKARTA PUSAT,TANAH ABANG,KEBON KACANG,21531,10266,11265,5405,16670,2021-08-16
3171011005,JAKARTA PUSAT,GAMBIR,KEBON KELAPA,10163,3922,6241,3255,9496,2021-08-16
3171031002,JAKARTA PUSAT,KEMAYORAN,KEBON KOSONG,30019,12276,17743,8870,26613,2021-08-16
3175011005,JAKARTA TIMUR,MATRAMAN,KEBON MANGGIS,16490,6417,10073,5425,15498,2021-08-16
3171071005,JAKARTA PUSAT,TANAH ABANG,KEBON MELATI,32206,16252,15954,6870,22824,2021-08-16
3175081003,JAKARTA TIMUR,MAKASAR,KEBON PALA,46614,18599,28015,12528,40543,2021-08-16
3171061005,JAKARTA PUSAT,MENTENG,KEBON SIRIH,12299,5342,6957,3119,10076,2021-08-16
3173011004,JAKARTA BARAT,CENGKARENG,KEDAUNG KALI ANGKE,32612,11680,20932,9238,30170,2021-08-16
3173051007,JAKARTA BARAT,KEBON JERUK,KEDOYA SELATAN,32165,12249,19916,8973,28889,2021-08-16
3173051006,JAKARTA BARAT,KEBON JERUK,KEDOYA UTARA,45740,16390,29350,13935,43285,2021-08-16
3173051004,JAKARTA BARAT,KEBON JERUK,KELAPA DUA,23565,9615,13950,6354,20304,2021-08-16
3175091003,JAKARTA TIMUR,CIRACAS,KELAPA DUA WETAN,46875,17175,29700,14544,44244,2021-08-16
3172061003,JAKARTA UTARA,KELAPA GADING,KELAPA GADING BARAT,35717,12356,23361,15137,38498,2021-08-16
3172061001,JAKARTA UTARA,KELAPA GADING,KELAPA GADING TIMUR,33592,10803,22789,14863,37652,2021-08-16
3173071005,JAKARTA BARAT,PALMERAH,KEMANGGISAN,32139,13085,19054,9432,28486,2021-08-16
3171031001,JAKARTA PUSAT,KEMAYORAN,KEMAYORAN,20708,7953,12755,6396,19151,2021-08-16
3173081006,JAKARTA BARAT,KEMBANGAN,KEMBANGAN SELATAN,27130,10645,16485,8869,25354,2021-08-16
3173081001,JAKARTA BARAT,KEMBANGAN,KEMBANGAN UTARA,54451,21392,33059,14939,47998,2021-08-16
3171041002,JAKARTA PUSAT,SENEN,KENARI,9579,3637,5942,2966,8908,2021-08-16
3173041005,JAKARTA BARAT,TAMBORA,KERENDANG,19973,7762,12211,5772,17983,2021-08-16
3175071003,JAKARTA TIMUR,DUREN SAWIT,KLENDER,69978,31362,38616,16079,54695,2021-08-16
3172031001,JAKARTA UTARA,KOJA,KOJA,28175,11673,16502,8694,25196,2021-08-16
3173071006,JAKARTA BARAT,PALMERAH,KOTA BAMBU SELATAN,21158,8666,12492,5356,17848,2021-08-16
3173071003,JAKARTA BARAT,PALMERAH,KOTA BAMBU UTARA,24995,10713,14282,6231,20513,2021-08-16
3171041004,JAKARTA PUSAT,SENEN,KRAMAT,28835,12836,15999,6833,22832,2021-08-16
3175041001,JAKARTA TIMUR,KRAMAT JATI,KRAMAT JATI,34144,13871,20273,8997,29270,2021-08-16
3174071003,JAKARTA SELATAN,KEBAYORAN BARU,KRAMAT PELA,14413,5400,9013,4755,13768,2021-08-16
3173031002,JAKARTA BARAT,TAMAN SARI,KRUKUT,19244,7395,11849,5038,16887,2021-08-16
3174031005,JAKARTA SELATAN,MAMPANG PRAPATAN,KUNINGAN BARAT,12785,4878,7907,4273,12180,2021-08-16
3174021008,JAKARTA SELATAN,SETIA BUDI,KUNINGAN TIMUR,6008,2355,3653,2106,5759,2021-08-16
3171041005,JAKARTA PUSAT,SENEN,KWITANG,15486,6122,9364,4395,13759,2021-08-16
3172031003,JAKARTA UTARA,KOJA,LAGOA,59065,25810,33255,15463,48718,2021-08-16
3174061002,JAKARTA SELATAN,CILANDAK,LEBAK BULUS,37626,15291,22335,12159,34494,2021-08-16
3174091004,JAKARTA SELATAN,JAGAKARSA,LENTENG AGUNG,53946,22087,31859,14774,46633,2021-08-16
3175101007,JAKARTA TIMUR,CIPAYUNG,LUBANG BUAYA,63547,23891,39656,19177,58833,2021-08-16
3175081001,JAKARTA TIMUR,MAKASAR,MAKASAR,34390,13291,21099,10251,31350,2021-08-16
3175071006,JAKARTA TIMUR,DUREN SAWIT,MALAKA JAYA,30927,12423,18504,10472,28976,2021-08-16
3175071005,JAKARTA TIMUR,DUREN SAWIT,MALAKA SARI,27530,10811,16719,9470,26189,2021-08-16
3174031001,JAKARTA SELATAN,MAMPANG PRAPATAN,MAMPANG PRAPATAN,18159,7218,10941,6043,16984,2021-08-16
3173031005,JAKARTA BARAT,TAMAN SARI,MANGGA BESAR,7707,2706,5001,2989,7990,2021-08-16
3171021005,JAKARTA PUSAT,SAWAH BESAR,MANGGA DUA SELATAN,27442,10618,16824,8679,25503,2021-08-16
3174011007,JAKARTA SELATAN,TEBET,MANGGARAI,28373,10587,17786,8073,25859,2021-08-16
3174011006,JAKARTA SELATAN,TEBET,MANGGARAI SELATAN,23075,8754,14321,7551,21872,2021-08-16
3173031003,JAKARTA BARAT,TAMAN SARI,MAPHAR,16461,6398,10063,5475,15538,2021-08-16
3172041003,JAKARTA UTARA,CILINCING,MARUNDA,28943,11297,17646,7062,24708,2021-08-16
3174071001,JAKARTA SELATAN,KEBAYORAN BARU,MELAWAI,2627,949,1678,1243,2921,2021-08-16
3171061001,JAKARTA PUSAT,MENTENG,MENTENG,25624,10907,14717,7005,21722,2021-08-16
3174021005,JAKARTA SELATAN,SETIA BUDI,MENTENG ATAS,27816,10451,17365,8804,26169,2021-08-16
3174011003,JAKARTA SELATAN,TEBET,MENTENG DALAM,36028,14254,21774,10995,32769,2021-08-16
3173081003,JAKARTA BARAT,KEMBANGAN,MERUYA SELATAN,32130,12718,19412,9133,28545,2021-08-16
3173081002,JAKARTA BARAT,KEMBANGAN,MERUYA UTARA,43752,17650,26102,13581,39683,2021-08-16
3175101004,JAKARTA TIMUR,CIPAYUNG,MUNJUL,23871,8815,15056,7090,22146,2021-08-16
3172051002,JAKARTA UTARA,PADEMANGAN,PADEMANGAN BARAT,74240,30798,43442,20400,63842,2021-08-16
3172051001,JAKARTA UTARA,PADEMANGAN,PADEMANGAN TIMUR,37736,13210,24526,13682,38208,2021-08-16
3175011004,JAKARTA TIMUR,MATRAMAN,PAL MERIAM,19769,8312,11457,5595,17052,2021-08-16
3173071001,JAKARTA BARAT,PALMERAH,PALMERAH,63011,25899,37112,16671,53783,2021-08-16
3174081001,JAKARTA SELATAN,PANCORAN,PANCORAN,19421,7768,11653,6170,17823,2021-08-16
3172021003,JAKARTA UTARA,TANJUNG PRIOK,PAPANGGO,39097,14656,24441,12279,36720,2021-08-16
3171021001,JAKARTA PUSAT,SAWAH BESAR,PASAR BARU,12035,4046,7989,4686,12675,2021-08-16
3174021006,JAKARTA SELATAN,SETIA BUDI,PASAR MANGGIS,26752,10674,16078,8546,24624,2021-08-16
3174041001,JAKARTA SELATAN,PASAR MINGGU,PASAR MINGGU,24821,9771,15050,8432,23482,2021-08-16
3171041003,JAKARTA PUSAT,SENEN,PASEBAN,23533,9653,13880,6534,20414,2021-08-16
3173061005,JAKARTA BARAT,KALI DERES,PEGADUNGAN,75587,27563,48024,22644,70668,2021-08-16
3171061002,JAKARTA PUSAT,MENTENG,PEGANGSAAN,23455,10252,13203,6034,19237,2021-08-16
3172061002,JAKARTA UTARA,KELAPA GADING,PEGANGSAAN DUA,49976,15891,34085,20333,54418,2021-08-16
3172011004,JAKARTA UTARA,PENJARINGAN,PEJAGALAN,74578,28968,45610,25126,70736,2021-08-16
3174041006,JAKARTA SELATAN,PASAR MINGGU,PEJATEN BARAT,37346,15194,22152,12170,34322,2021-08-16
3174041005,JAKARTA SELATAN,PASAR MINGGU,PEJATEN TIMUR,57656,24409,33247,15679,48926,2021-08-16
3175051005,JAKARTA TIMUR,PASAR REBO,PEKAYON,43250,16381,26869,13149,40018,2021-08-16
3173041009,JAKARTA BARAT,TAMBORA,PEKOJAN,23587,9080,14507,7505,22012,2021-08-16
3174031003,JAKARTA SELATAN,MAMPANG PRAPATAN,PELA MAMPANG,43522,16855,26667,14422,41089,2021-08-16
3174081005,JAKARTA SELATAN,PANCORAN,PENGADEGAN,21478,7715,13763,6708,20471,2021-08-16
3175061003,JAKARTA TIMUR,CAKUNG,PENGGILINGAN,99255,44478,54777,21056,75833,2021-08-16
3172011001,JAKARTA UTARA,PENJARINGAN,PENJARINGAN,88308,38576,49732,21866,71598,2021-08-16
3174101001,JAKARTA SELATAN,PESANGGRAHAN,PESANGGRAHAN,27545,10059,17486,9425,26911,2021-08-16
3171071004,JAKARTA PUSAT,TANAH ABANG,PETAMBURAN,33271,16522,16749,6851,23600,2021-08-16
3174071008,JAKARTA SELATAN,KEBAYORAN BARU,PETOGOGAN,11499,4553,6946,4083,11029,2021-08-16
3171011004,JAKARTA PUSAT,GAMBIR,PETOJO SELATAN,14692,5844,8848,4859,13707,2021-08-16
3171011003,JAKARTA PUSAT,GAMBIR,PETOJO UTARA,17458,6844,10614,4859,15473,2021-08-16
3174101004,JAKARTA SELATAN,PESANGGRAHAN,PETUKANGAN SELATAN,37187,14539,22648,11182,33830,2021-08-16
3174101003,JAKARTA SELATAN,PESANGGRAHAN,PETUKANGAN UTARA,53716,22421,31295,15731,47026,2021-08-16
3175081002,JAKARTA TIMUR,MAKASAR,PINANG RANTI,27198,11048,16150,7861,24011,2021-08-16
3173031008,JAKARTA BARAT,TAMAN SARI,PINANGSIA,10729,3849,6880,3779,10659,2021-08-16
3175011001,JAKARTA TIMUR,MATRAMAN,PISANGAN BARU,31776,13612,18164,7722,25886,2021-08-16
3175021002,JAKARTA TIMUR,PULO GADUNG,PISANGAN TIMUR,41011,15604,25407,11698,37105,2021-08-16
3172011005,JAKARTA UTARA,PENJARINGAN,PLUIT,47783,17912,29871,19854,49725,2021-08-16
3175071002,JAKARTA TIMUR,DUREN SAWIT,PONDOK BAMBU,61550,26833,34717,16807,51524,2021-08-16
3175071004,JAKARTA TIMUR,DUREN SAWIT,PONDOK KELAPA,72015,28616,43399,21151,64550,2021-08-16
3175071007,JAKARTA TIMUR,DUREN SAWIT,PONDOK KOPI,35367,16035,19332,8596,27928,2021-08-16
3174061003,JAKARTA SELATAN,CILANDAK,PONDOK LABU,46464,17394,29070,16542,45612,2021-08-16
3174051002,JAKARTA SELATAN,KEBAYORAN LAMA,PONDOK PINANG,56169,22242,33927,18673,52600,2021-08-16
3175101003,JAKARTA TIMUR,CIPAYUNG,PONDOK RANGGON,25574,9852,15722,7448,23170,2021-08-16
3101011003,KAB.ADM.KEP.SERIBU,KEP. SERIBU UTARA,PULAU HARAPAN,2060,369,1691,927,2618,2021-08-16
3101011002,KAB.ADM.KEP.SERIBU,KEP. SERIBU UTARA,PULAU KELAPA,5528,1017,4511,2029,6540,2021-08-16
3101011001,KAB.ADM.KEP.SERIBU,KEP. SERIBU UTARA,PULAU PANGGANG,5450,949,4501,1944,6445,2021-08-16
3101021003,KAB.ADM.KEP.SERIBU,KEP. SERIBU SELATAN,PULAU PARI,2765,343,2422,1295,3717,2021-08-16
3101021002,KAB.ADM.KEP.SERIBU,KEP. SERIBU SELATAN,PULAU TIDUNG,4553,698,3855,2397,6252,2021-08-16
3101021001,KAB.ADM.KEP.SERIBU,KEP. SERIBU SELATAN,PULAU UNTUNG JAWA,1941,357,1584,803,2387,2021-08-16
3174071007,JAKARTA SELATAN,KEBAYORAN BARU,PULO,5835,2110,3725,2458,6183,2021-08-16
3175021001,JAKARTA TIMUR,PULO GADUNG,PULO GADUNG,34422,14095,20327,9872,30199,2021-08-16
3175061005,JAKARTA TIMUR,CAKUNG,PULO GEBANG,97301,41094,56207,23707,79914,2021-08-16
3174041004,JAKARTA SELATAN,PASAR MINGGU,RAGUNAN,39616,14967,24649,13275,37924,2021-08-16
3175091005,JAKARTA TIMUR,CIRACAS,RAMBUTAN,36771,16571,20200,9290,29490,2021-08-16
3172031006,JAKARTA UTARA,KOJA,RAWA BADAK SELATAN,42179,18892,23287,10614,33901,2021-08-16
3172031004,JAKARTA UTARA,KOJA,RAWA BADAK UTARA,34408,14979,19429,9922,29351,2021-08-16
3174071005,JAKARTA SELATAN,KEBAYORAN BARU,RAWA BARAT,5625,2026,3599,2236,5835,2021-08-16
3173011003,JAKARTA BARAT,CENGKARENG,RAWA BUAYA,63799,26223,37576,14195,51771,2021-08-16
3175031004,JAKARTA TIMUR,JATINEGARA,RAWA BUNGA,21434,9348,12086,5384,17470,2021-08-16
3174081003,JAKARTA SELATAN,PANCORAN,RAWA JATI,20509,7956,12553,6684,19237,2021-08-16
3175061002,JAKARTA TIMUR,CAKUNG,RAWA TERATE,24637,9008,15629,5820,21449,2021-08-16
3175021005,JAKARTA TIMUR,PULO GADUNG,RAWAMANGUN,37612,15345,22267,11462,33729,2021-08-16
3171051003,JAKARTA PUSAT,CEMPAKA PUTIH,RAWASARI,21967,8874,13093,7015,20108,2021-08-16
3173041010,JAKARTA BARAT,TAMBORA,ROA MALAKA,3484,1111,2373,1427,3800,2021-08-16
3172041006,JAKARTA UTARA,CILINCING,ROROTAN,41668,16029,25639,11501,37140,2021-08-16
3174071004,JAKARTA SELATAN,KEBAYORAN BARU,SELONG,2842,1034,1808,1281,3089,2021-08-16
3173061002,JAKARTA BARAT,KALI DERES,SEMANAN,71354,29450,41904,14452,56356,2021-08-16
3172041007,JAKARTA UTARA,CILINCING,SEMPER BARAT,68587,25393,43194,21816,65010,2021-08-16
3172041005,JAKARTA UTARA,CILINCING,SEMPER TIMUR,36267,14134,22133,10903,33036,2021-08-16
3174071006,JAKARTA SELATAN,KEBAYORAN BARU,SENAYAN,2771,1234,1537,947,2484,2021-08-16
3171041001,JAKARTA PUSAT,SENEN,SENEN,6804,2557,4247,2354,6601,2021-08-16
3171031004,JAKARTA PUSAT,KEMAYORAN,SERDANG,29668,11815,17853,8452,26305,2021-08-16
3174021001,JAKARTA SELATAN,SETIA BUDI,SETIA BUDI,3023,1200,1823,1063,2886,2021-08-16
3175101005,JAKARTA TIMUR,CIPAYUNG,SETU,20572,8522,12050,5121,17171,2021-08-16
3173071002,JAKARTA BARAT,PALMERAH,SLIPI,16591,6363,10228,5378,15606,2021-08-16
3173081004,JAKARTA BARAT,KEMBANGAN,SRENGSENG,45523,19570,25953,12692,38645,2021-08-16
3174091002,JAKARTA SELATAN,JAGAKARSA,SRENGSENG SAWAH,58196,20037,38159,20911,59070,2021-08-16
3173051003,JAKARTA BARAT,KEBON JERUK,SUKABUMI SELATAN,37033,15897,21136,8511,29647,2021-08-16
3173051002,JAKARTA BARAT,KEBON JERUK,SUKABUMI UTARA,38290,17386,20904,8916,29820,2021-08-16
3172041002,JAKARTA UTARA,CILINCING,SUKAPURA,53949,22059,31890,15458,47348,2021-08-16
3171031007,JAKARTA PUSAT,KEMAYORAN,SUMUR BATU,22717,9276,13441,6978,20419,2021-08-16
3172021004,JAKARTA UTARA,TANJUNG PRIOK,SUNGAI BAMBU,29876,11648,18228,9278,27506,2021-08-16
3172021006,JAKARTA UTARA,TANJUNG PRIOK,SUNTER AGUNG,71805,24995,46810,26931,73741,2021-08-16
3172021002,JAKARTA UTARA,TANJUNG PRIOK,SUNTER JAYA,63031,22716,40315,22047,62362,2021-08-16
3175091004,JAKARTA TIMUR,CIRACAS,SUSUKAN,38257,13993,24264,11637,35901,2021-08-16
3173031001,JAKARTA BARAT,TAMAN SARI,TAMAN SARI,14348,5477,8871,4965,13836,2021-08-16
3173041001,JAKARTA BARAT,TAMBORA,TAMBORA,10204,4079,6125,2796,8921,2021-08-16
3173041004,JAKARTA BARAT,TAMBORA,TANAH SEREAL,26387,8935,17452,7978,25430,2021-08-16
3171081004,JAKARTA PUSAT,JOHAR BARU,TANAH TINGGI,37693,12862,24831,11173,36004,2021-08-16
3173031004,JAKARTA BARAT,TAMAN SARI,TANGKI,13324,5074,8250,4412,12662,2021-08-16
3174091005,JAKARTA SELATAN,JAGAKARSA,TANJUNG BARAT,39770,15281,24489,12142,36631,2021-08-16
3173021005,JAKARTA BARAT,GROGOL PETAMBURAN,TANJUNG DUREN SELATAN,25337,9641,15696,8491,24187,2021-08-16
3173021002,JAKARTA BARAT,GROGOL PETAMBURAN,TANJUNG DUREN UTARA,17010,6159,10851,6033,16884,2021-08-16
3172021001,JAKARTA UTARA,TANJUNG PRIOK,TANJUNG PRIOK,34588,12734,21854,9687,31541,2021-08-16
3174011002,JAKARTA SELATAN,TEBET,TEBET BARAT,21194,7627,13567,7938,21505,2021-08-16
3174011001,JAKARTA SELATAN,TEBET,TEBET TIMUR,18199,6568,11631,6838,18469,2021-08-16
3173061003,JAKARTA BARAT,KALI DERES,TEGAL ALUR,83647,32694,50953,18886,69839,2021-08-16
3174031004,JAKARTA SELATAN,MAMPANG PRAPATAN,TEGAL PARANG,32401,13731,18670,8992,27662,2021-08-16
3173021003,JAKARTA BARAT,GROGOL PETAMBURAN,TOMANG,29605,11311,18294,10062,28356,2021-08-16
3172031005,JAKARTA UTARA,KOJA,TUGU SELATAN,39122,17020,22102,10249,32351,2021-08-16
3172031002,JAKARTA UTARA,KOJA,TUGU UTARA,67670,29873,37797,17945,55742,2021-08-16
3175061006,JAKARTA TIMUR,CAKUNG,UJUNG MENTENG,29934,10990,18944,8719,27663,2021-08-16
3174101005,JAKARTA SELATAN,PESANGGRAHAN,ULUJAMI,40544,17400,23144,10411,33555,2021-08-16
3175011006,JAKARTA TIMUR,MATRAMAN,UTAN KAYU SELATAN,33511,13081,20430,10254,30684,2021-08-16
3175011002,JAKARTA TIMUR,MATRAMAN,UTAN KAYU UTARA,28169,11841,16328,7990,24318,2021-08-16
3171031008,JAKARTA PUSAT,KEMAYORAN,UTAN PANJANG,29208,12081,17127,7236,24363,2021-08-16
3172021007,JAKARTA UTARA,TANJUNG PRIOK,WARAKAS,44401,17299,27102,13420,40522,2021-08-16
3173021007,JAKARTA BARAT,GROGOL PETAMBURAN,WIJAYA KUSUMA,38934,15983,22951,11096,34047,2021-08-16
3172051003,JAKARTA UTARA,PADEMANGAN,ANCOL,23947,9882,14065,6793,20858,2021-08-17
3173041007,JAKARTA BARAT,TAMBORA,ANGKE,29381,10931,18450,8071,26521,2021-08-17
3175041005,JAKARTA TIMUR,KRAMAT JATI,BALE KAMBANG,29074,13744,15330,5827,21157,2021-08-17
3175031003,JAKARTA TIMUR,JATINEGARA,BALI MESTER,9752,3993,5759,2953,8712,2021-08-17
3175101006,JAKARTA TIMUR,CIPAYUNG,BAMBU APUS,26285,10183,16102,7562,23664,2021-08-17
3174031002,JAKARTA SELATAN,MAMPANG PRAPATAN,BANGKA,21566,8830,12736,6596,19332,2021-08-17
3175051002,JAKARTA TIMUR,PASAR REBO,BARU,23886,8358,15528,9243,24771,2021-08-17
3175041004,JAKARTA TIMUR,KRAMAT JATI,BATU AMPAR,47898,21697,26201,11345,37546,2021-08-17
3171071002,JAKARTA PUSAT,TANAH ABANG,BENDUNGAN HILIR,21494,8517,12977,7059,20036,2021-08-17
3175031002,JAKARTA TIMUR,JATINEGARA,BIDARA CINA,36689,16833,19856,8884,28740,2021-08-17
3174101002,JAKARTA SELATAN,PESANGGRAHAN,BINTARO,53098,20982,32116,17446,49562,2021-08-17
3174011005,JAKARTA SELATAN,TEBET,BUKIT DURI,34183,14391,19792,9912,29704,2021-08-17
3171041006,JAKARTA PUSAT,SENEN,BUNGUR,18144,7003,11141,5667,16808,2021-08-17
3175061007,JAKARTA TIMUR,CAKUNG,CAKUNG BARAT,57724,21201,36523,15705,52228,2021-08-17
3175061004,JAKARTA TIMUR,CAKUNG,CAKUNG TIMUR,58287,21872,36415,17128,53543,2021-08-17
3175041007,JAKARTA TIMUR,KRAMAT JATI,CAWANG,32762,14179,18583,8884,27467,2021-08-17
3175101008,JAKARTA TIMUR,CIPAYUNG,CEGER,18932,7205,11727,5299,17026,2021-08-17
3171031006,JAKARTA PUSAT,KEMAYORAN,CEMPAKA BARU,32581,14007,18574,9048,27622,2021-08-17
3171051002,JAKARTA PUSAT,CEMPAKA PUTIH,CEMPAKA PUTIH BARAT,35885,14463,21422,11513,32935,2021-08-17
3171051001,JAKARTA PUSAT,CEMPAKA PUTIH,CEMPAKA PUTIH TIMUR,24292,9614,14678,8247,22925,2021-08-17
3173011001,JAKARTA BARAT,CENGKARENG,CENGKARENG BARAT,66284,25377,40907,21209,62116,2021-08-17
3173011006,JAKARTA BARAT,CENGKARENG,CENGKARENG TIMUR,81027,30884,50143,21915,72058,2021-08-17
3175091002,JAKARTA TIMUR,CIRACAS,CIBUBUR,66364,24462,41902,22480,64382,2021-08-17
3171011002,JAKARTA PUSAT,GAMBIR,CIDENG,15390,5487,9903,5631,15534,2021-08-17
3174091003,JAKARTA SELATAN,JAGAKARSA,CIGANJUR,38497,14674,23823,12229,36052,2021-08-17
3175051003,JAKARTA TIMUR,PASAR REBO,CIJANTUNG,41419,15379,26040,13755,39795,2021-08-17
3171061003,JAKARTA PUSAT,MENTENG,CIKINI,8274,3556,4718,2428,7146,2021-08-17
3174081006,JAKARTA SELATAN,PANCORAN,CIKOKO,10547,3800,6747,3486,10233,2021-08-17
3174061001,JAKARTA SELATAN,CILANDAK,CILANDAK BARAT,51752,19740,32012,18086,50098,2021-08-17
3174041003,JAKARTA SELATAN,PASAR MINGGU,CILANDAK TIMUR,25145,9388,15757,9337,25094,2021-08-17
3175101002,JAKARTA TIMUR,CIPAYUNG,CILANGKAP,27635,10363,17272,8263,25535,2021-08-17
3175041006,JAKARTA TIMUR,KRAMAT JATI,CILILITAN,40181,17686,22495,10602,33097,2021-08-17
3172041001,JAKARTA UTARA,CILINCING,CILINCING,43609,18170,25439,11923,37362,2021-08-17
3175101001,JAKARTA TIMUR,CIPAYUNG,CIPAYUNG,26104,9267,16837,8867,25704,2021-08-17
3174091006,JAKARTA SELATAN,JAGAKARSA,CIPEDAK,38303,13613,24690,13682,38372,2021-08-17
3174061005,JAKARTA SELATAN,CILANDAK,CIPETE SELATAN,26704,10692,16012,9444,25456,2021-08-17
3174071010,JAKARTA SELATAN,KEBAYORAN BARU,CIPETE UTARA,34102,13282,20820,11146,31966,2021-08-17
3175021003,JAKARTA TIMUR,PULO GADUNG,CIPINANG,39306,15981,23325,11979,35304,2021-08-17
3175031007,JAKARTA TIMUR,JATINEGARA,CIPINANG BESAR SELATAN,35212,16055,19157,8263,27420,2021-08-17
3175031008,JAKARTA TIMUR,JATINEGARA,CIPINANG BESAR UTARA,45319,19791,25528,10335,35863,2021-08-17
3175031005,JAKARTA TIMUR,JATINEGARA,CIPINANG CEMPEDAK,32824,14332,18492,9573,28065,2021-08-17
3175081005,JAKARTA TIMUR,MAKASAR,CIPINANG MELAYU,42308,17309,24999,13217,38216,2021-08-17
3175031006,JAKARTA TIMUR,JATINEGARA,CIPINANG MUARA,55243,23858,31385,14485,45870,2021-08-17
3174051003,JAKARTA SELATAN,KEBAYORAN LAMA,CIPULIR,39937,16863,23074,10797,33871,2021-08-17
3175091001,JAKARTA TIMUR,CIRACAS,CIRACAS,64594,23790,40804,19952,60756,2021-08-17
3175041003,JAKARTA TIMUR,KRAMAT JATI,DUKUH,24609,9418,15191,6972,22163,2021-08-17
3175071001,JAKARTA TIMUR,DUREN SAWIT,DUREN SAWIT,61160,26394,34766,18021,52787,2021-08-17
3174081004,JAKARTA SELATAN,PANCORAN,DUREN TIGA,28319,11099,17220,8277,25497,2021-08-17
3173051005,JAKARTA BARAT,KEBON JERUK,DURI KEPA,60138,22235,37903,20226,58129,2021-08-17
3173011002,JAKARTA BARAT,CENGKARENG,DURI KOSAMBI,77923,33266,44657,20488,65145,2021-08-17
3171011006,JAKARTA PUSAT,GAMBIR,DURI PULO,19610,7575,12035,5461,17496,2021-08-17
3173041011,JAKARTA BARAT,TAMBORA,DURI SELATAN,14259,4965,9294,4612,13906,2021-08-17
3173041003,JAKARTA BARAT,TAMBORA,DURI UTARA,19844,7220,12624,5786,18410,2021-08-17
3171081003,JAKARTA PUSAT,JOHAR BARU,GALUR,18243,6193,12050,5277,17327,2021-08-17
3171011001,JAKARTA PUSAT,GAMBIR,GAMBIR,2191,790,1401,815,2216,2021-08-17
3174061004,JAKARTA SELATAN,CILANDAK,GANDARIA SELATAN,22119,8716,13403,7091,20494,2021-08-17
3174071009,JAKARTA SELATAN,KEBAYORAN BARU,GANDARIA UTARA,39922,15821,24101,12677,36778,2021-08-17
3175051001,JAKARTA TIMUR,PASAR REBO,GEDONG,35755,13609,22146,11363,33509,2021-08-17
3171071001,JAKARTA PUSAT,TANAH ABANG,GELORA,3127,1291,1836,960,2796,2021-08-17
3173031007,JAKARTA BARAT,TAMAN SARI,GLODOK,7837,2597,5240,3280,8520,2021-08-17
3171061004,JAKARTA PUSAT,MENTENG,GONDANGDIA,4100,1610,2490,1790,4280,2021-08-17
3173021001,JAKARTA BARAT,GROGOL PETAMBURAN,GROGOL,16876,6526,10350,5485,15835,2021-08-17
3174051005,JAKARTA SELATAN,KEBAYORAN LAMA,GROGOL SELATAN,44251,18073,26178,12217,38395,2021-08-17
3174051004,JAKARTA SELATAN,KEBAYORAN LAMA,GROGOL UTARA,42494,16946,25548,12251,37799,2021-08-17
3174021007,JAKARTA SELATAN,SETIA BUDI,GUNTUR,3985,1479,2506,1678,4184,2021-08-17
3174071002,JAKARTA SELATAN,KEBAYORAN BARU,GUNUNG,9436,3520,5916,3712,9628,2021-08-17
3171031005,JAKARTA PUSAT,KEMAYORAN,GUNUNG SAHARI SELATAN,19199,7635,11564,6241,17805,2021-08-17
3171021004,JAKARTA PUSAT,SAWAH BESAR,GUNUNG SAHARI UTARA,16650,5649,11001,6382,17383,2021-08-17
3175081004,JAKARTA TIMUR,MAKASAR,HALIM PERDANA KUSUMAH,28363,8527,19836,14237,34073,2021-08-17
3171031003,JAKARTA PUSAT,KEMAYORAN,HARAPAN MULIA,22557,9090,13467,6535,20002,2021-08-17
3174091001,JAKARTA SELATAN,JAGAKARSA,JAGAKARSA,62389,23230,39159,21505,60664,2021-08-17
3175021007,JAKARTA TIMUR,PULO GADUNG,JATI,32757,13019,19738,10583,30321,2021-08-17
3174041002,JAKARTA SELATAN,PASAR MINGGU,JATI PADANG,37502,14676,22826,12677,35503,2021-08-17
3173071004,JAKARTA BARAT,PALMERAH,JATI PULO,28738,10852,17886,7875,25761,2021-08-17
3175061001,JAKARTA TIMUR,CAKUNG,JATINEGARA,84160,34476,49684,20377,70061,2021-08-17
3175021004,JAKARTA TIMUR,PULO GADUNG,JATINEGARA KAUM,24632,8980,15652,6560,22212,2021-08-17
3173021004,JAKARTA BARAT,GROGOL PETAMBURAN,JELAMBAR,30266,11563,18703,10647,29350,2021-08-17
3173021006,JAKARTA BARAT,GROGOL PETAMBURAN,JELAMBAR BARU,38246,14655,23591,12966,36557,2021-08-17
3173041006,JAKARTA BARAT,TAMBORA,JEMBATAN BESI,29314,13256,16058,6308,22366,2021-08-17
3173041008,JAKARTA BARAT,TAMBORA,JEMBATAN LIMA,21021,8770,12251,5597,17848,2021-08-17
3173081005,JAKARTA BARAT,KEMBANGAN,JOGLO,40839,16473,24366,11931,36297,2021-08-17
3171081001,JAKARTA PUSAT,JOHAR BARU,JOHAR BARU,37488,13302,24186,12127,36313,2021-08-17
3173041002,JAKARTA BARAT,TAMBORA,KALI ANYAR,23856,8705,15151,5564,20715,2021-08-17
3172041004,JAKARTA UTARA,CILINCING,KALIBARU,67684,30297,37387,16236,53623,2021-08-17
3174081002,JAKARTA SELATAN,PANCORAN,KALIBATA,41994,18222,23772,10748,34520,2021-08-17
3173061001,JAKARTA BARAT,KALI DERES,KALIDERES,72447,28164,44283,20919,65202,2021-08-17
3175051004,JAKARTA TIMUR,PASAR REBO,KALISARI,43212,16429,26783,14228,41011,2021-08-17
3173061004,JAKARTA BARAT,KALI DERES,KAMAL,53783,21937,31846,11065,42911,2021-08-17
3172011002,JAKARTA UTARA,PENJARINGAN,KAMAL MUARA,12930,3859,9071,5694,14765,2021-08-17
3171071007,JAKARTA PUSAT,TANAH ABANG,KAMPUNG BALI,11358,5091,6267,3129,9396,2021-08-17
3175031001,JAKARTA TIMUR,JATINEGARA,KAMPUNG MELAYU,25717,11244,14473,6269,20742,2021-08-17
3171081002,JAKARTA PUSAT,JOHAR BARU,KAMPUNG RAWA,21237,6423,14814,6600,21414,2021-08-17
3175041002,JAKARTA TIMUR,KRAMAT JATI,KAMPUNG TENGAH,43993,19782,24211,10519,34730,2021-08-17
3173011005,JAKARTA BARAT,CENGKARENG,KAPUK,134466,56948,77518,29879,107397,2021-08-17
3172011003,JAKARTA UTARA,PENJARINGAN,KAPUK MUARA,35781,12301,23480,14222,37702,2021-08-17
3171021002,JAKARTA PUSAT,SAWAH BESAR,KARANG ANYAR,25761,9359,16402,7793,24195,2021-08-17
3174021004,JAKARTA SELATAN,SETIA BUDI,KARET,9623,3819,5804,3190,8994,2021-08-17
3174021003,JAKARTA SELATAN,SETIA BUDI,KARET KUNINGAN,16055,5685,10370,5943,16313,2021-08-17
3174021002,JAKARTA SELATAN,SETIA BUDI,KARET SEMANGGI,2770,986,1784,1218,3002,2021-08-17
3171071003,JAKARTA PUSAT,TANAH ABANG,KARET TENGSIN,19271,7652,11619,5520,17139,2021-08-17
3171021003,JAKARTA PUSAT,SAWAH BESAR,KARTINI,22292,8340,13952,7628,21580,2021-08-17
3175011003,JAKARTA TIMUR,MATRAMAN,KAYU MANIS,25284,10816,14468,6693,21161,2021-08-17
3175021006,JAKARTA TIMUR,PULO GADUNG,KAYU PUTIH,40696,15189,25507,14479,39986,2021-08-17
3173031006,JAKARTA BARAT,TAMAN SARI,KEAGUNGAN,17387,6367,11020,5606,16626,2021-08-17
3174041007,JAKARTA SELATAN,PASAR MINGGU,KEBAGUSAN,44552,18292,26260,13317,39577,2021-08-17
3174051006,JAKARTA SELATAN,KEBAYORAN LAMA,KEBAYORAN LAMA SELATAN,41212,15749,25463,13181,38644,2021-08-17
3174051001,JAKARTA SELATAN,KEBAYORAN LAMA,KEBAYORAN LAMA UTARA,42422,17488,24934,11652,36586,2021-08-17
3174011004,JAKARTA SELATAN,TEBET,KEBON BARU,35165,13874,21291,10996,32287,2021-08-17
3172021005,JAKARTA UTARA,TANJUNG PRIOK,KEBON BAWANG,50952,20426,30526,16152,46678,2021-08-17
3173051001,JAKARTA BARAT,KEBON JERUK,KEBON JERUK,53887,22609,31278,14810,46088,2021-08-17
3171071006,JAKARTA PUSAT,TANAH ABANG,KEBON KACANG,21531,10158,11373,5535,16908,2021-08-17
3171011005,JAKARTA PUSAT,GAMBIR,KEBON KELAPA,10163,3871,6292,3311,9603,2021-08-17
3171031002,JAKARTA PUSAT,KEMAYORAN,KEBON KOSONG,30019,12139,17880,9195,27075,2021-08-17
3175011005,JAKARTA TIMUR,MATRAMAN,KEBON MANGGIS,16490,6350,10140,5548,15688,2021-08-17
3171071005,JAKARTA PUSAT,TANAH ABANG,KEBON MELATI,32206,16016,16190,7148,23338,2021-08-17
3175081003,JAKARTA TIMUR,MAKASAR,KEBON PALA,46614,18388,28226,13024,41250,2021-08-17
3171061005,JAKARTA PUSAT,MENTENG,KEBON SIRIH,12299,5290,7009,3201,10210,2021-08-17
3173011004,JAKARTA BARAT,CENGKARENG,KEDAUNG KALI ANGKE,32612,11606,21006,9612,30618,2021-08-17
3173051007,JAKARTA BARAT,KEBON JERUK,KEDOYA SELATAN,32165,12142,20023,9155,29178,2021-08-17
3173051006,JAKARTA BARAT,KEBON JERUK,KEDOYA UTARA,45740,16226,29514,14571,44085,2021-08-17
3173051004,JAKARTA BARAT,KEBON JERUK,KELAPA DUA,23565,9494,14071,6541,20612,2021-08-17
3175091003,JAKARTA TIMUR,CIRACAS,KELAPA DUA WETAN,46875,16883,29992,14915,44907,2021-08-17
3172061003,JAKARTA UTARA,KELAPA GADING,KELAPA GADING BARAT,35717,12236,23481,15492,38973,2021-08-17
3172061001,JAKARTA UTARA,KELAPA GADING,KELAPA GADING TIMUR,33592,10686,22906,15066,37972,2021-08-17
3173071005,JAKARTA BARAT,PALMERAH,KEMANGGISAN,32139,12848,19291,9707,28998,2021-08-17
3171031001,JAKARTA PUSAT,KEMAYORAN,KEMAYORAN,20708,7869,12839,6702,19541,2021-08-17
3173081006,JAKARTA BARAT,KEMBANGAN,KEMBANGAN SELATAN,27130,10524,16606,8989,25595,2021-08-17
3173081001,JAKARTA BARAT,KEMBANGAN,KEMBANGAN UTARA,54451,21165,33286,15460,48746,2021-08-17
3171041002,JAKARTA PUSAT,SENEN,KENARI,9579,3611,5968,3002,8970,2021-08-17
3173041005,JAKARTA BARAT,TAMBORA,KERENDANG,19973,7571,12402,5993,18395,2021-08-17
3175071003,JAKARTA TIMUR,DUREN SAWIT,KLENDER,69978,30885,39093,16542,55635,2021-08-17
3172031001,JAKARTA UTARA,KOJA,KOJA,28175,11556,16619,9019,25638,2021-08-17
3173071006,JAKARTA BARAT,PALMERAH,KOTA BAMBU SELATAN,21158,8497,12661,5685,18346,2021-08-17
3173071003,JAKARTA BARAT,PALMERAH,KOTA BAMBU UTARA,24995,10565,14430,6531,20961,2021-08-17
3171041004,JAKARTA PUSAT,SENEN,KRAMAT,28835,12674,16161,7053,23214,2021-08-17
3175041001,JAKARTA TIMUR,KRAMAT JATI,KRAMAT JATI,34144,13689,20455,9282,29737,2021-08-17
3174071003,JAKARTA SELATAN,KEBAYORAN BARU,KRAMAT PELA,14413,5358,9055,4927,13982,2021-08-17
3173031002,JAKARTA BARAT,TAMAN SARI,KRUKUT,19244,7289,11955,5311,17266,2021-08-17
3174031005,JAKARTA SELATAN,MAMPANG PRAPATAN,KUNINGAN BARAT,12785,4787,7998,4356,12354,2021-08-17
3174021008,JAKARTA SELATAN,SETIA BUDI,KUNINGAN TIMUR,6008,2300,3708,2200,5908,2021-08-17
3171041005,JAKARTA PUSAT,SENEN,KWITANG,15486,6047,9439,4477,13916,2021-08-17
3172031003,JAKARTA UTARA,KOJA,LAGOA,59065,25388,33677,16142,49819,2021-08-17
3174061002,JAKARTA SELATAN,CILANDAK,LEBAK BULUS,37626,15148,22478,12582,35060,2021-08-17
3174091004,JAKARTA SELATAN,JAGAKARSA,LENTENG AGUNG,53946,21767,32179,15280,47459,2021-08-17
3175101007,JAKARTA TIMUR,CIPAYUNG,LUBANG BUAYA,63547,23418,40129,19870,59999,2021-08-17
3175081001,JAKARTA TIMUR,MAKASAR,MAKASAR,34390,13122,21268,10653,31921,2021-08-17
3175071006,JAKARTA TIMUR,DUREN SAWIT,MALAKA JAYA,30927,12289,18638,10662,29300,2021-08-17
3175071005,JAKARTA TIMUR,DUREN SAWIT,MALAKA SARI,27530,10681,16849,9680,26529,2021-08-17
3174031001,JAKARTA SELATAN,MAMPANG PRAPATAN,MAMPANG PRAPATAN,18159,7136,11023,6178,17201,2021-08-17
3173031005,JAKARTA BARAT,TAMAN SARI,MANGGA BESAR,7707,2565,5142,3048,8190,2021-08-17
3171021005,JAKARTA PUSAT,SAWAH BESAR,MANGGA DUA SELATAN,27442,10473,16969,9024,25993,2021-08-17
3174011007,JAKARTA SELATAN,TEBET,MANGGARAI,28373,10370,18003,8384,26387,2021-08-17
3174011006,JAKARTA SELATAN,TEBET,MANGGARAI SELATAN,23075,8627,14448,7715,22163,2021-08-17
3173031003,JAKARTA BARAT,TAMAN SARI,MAPHAR,16461,6334,10127,5594,15721,2021-08-17
3172041003,JAKARTA UTARA,CILINCING,MARUNDA,28943,11141,17802,7296,25098,2021-08-17
3174071001,JAKARTA SELATAN,KEBAYORAN BARU,MELAWAI,2627,941,1686,1250,2936,2021-08-17
3171061001,JAKARTA PUSAT,MENTENG,MENTENG,25624,10734,14890,7282,22172,2021-08-17
3174021005,JAKARTA SELATAN,SETIA BUDI,MENTENG ATAS,27816,10299,17517,9174,26691,2021-08-17
3174011003,JAKARTA SELATAN,TEBET,MENTENG DALAM,36028,14077,21951,11298,33249,2021-08-17
3173081003,JAKARTA BARAT,KEMBANGAN,MERUYA SELATAN,32130,12572,19558,9374,28932,2021-08-17
3173081002,JAKARTA BARAT,KEMBANGAN,MERUYA UTARA,43752,17374,26378,14023,40401,2021-08-17
3175101004,JAKARTA TIMUR,CIPAYUNG,MUNJUL,23871,8711,15160,7316,22476,2021-08-17
3172051002,JAKARTA UTARA,PADEMANGAN,PADEMANGAN BARAT,74240,30441,43799,21231,65030,2021-08-17
3172051001,JAKARTA UTARA,PADEMANGAN,PADEMANGAN TIMUR,37736,13063,24673,14087,38760,2021-08-17
3175011004,JAKARTA TIMUR,MATRAMAN,PAL MERIAM,19769,8207,11562,5743,17305,2021-08-17
3173071001,JAKARTA BARAT,PALMERAH,PALMERAH,63011,25347,37664,17410,55074,2021-08-17
3174081001,JAKARTA SELATAN,PANCORAN,PANCORAN,19421,7567,11854,6469,18323,2021-08-17
3172021003,JAKARTA UTARA,TANJUNG PRIOK,PAPANGGO,39097,14444,24653,12591,37244,2021-08-17
3171021001,JAKARTA PUSAT,SAWAH BESAR,PASAR BARU,12035,4011,8024,4749,12773,2021-08-17
3174021006,JAKARTA SELATAN,SETIA BUDI,PASAR MANGGIS,26752,10499,16253,8711,24964,2021-08-17
3174041001,JAKARTA SELATAN,PASAR MINGGU,PASAR MINGGU,24821,9699,15122,8631,23753,2021-08-17
3171041003,JAKARTA PUSAT,SENEN,PASEBAN,23533,9535,13998,6783,20781,2021-08-17
3173061005,JAKARTA BARAT,KALI DERES,PEGADUNGAN,75587,27294,48293,23285,71578,2021-08-17
3171061002,JAKARTA PUSAT,MENTENG,PEGANGSAAN,23455,10119,13336,6193,19529,2021-08-17
3172061002,JAKARTA UTARA,KELAPA GADING,PEGANGSAAN DUA,49976,15740,34236,20853,55089,2021-08-17
3172011004,JAKARTA UTARA,PENJARINGAN,PEJAGALAN,74578,28593,45985,25878,71863,2021-08-17
3174041006,JAKARTA SELATAN,PASAR MINGGU,PEJATEN BARAT,37346,15020,22326,12458,34784,2021-08-17
3174041005,JAKARTA SELATAN,PASAR MINGGU,PEJATEN TIMUR,57656,24128,33528,16122,49650,2021-08-17
3175051005,JAKARTA TIMUR,PASAR REBO,PEKAYON,43250,16107,27143,13606,40749,2021-08-17
3173041009,JAKARTA BARAT,TAMBORA,PEKOJAN,23587,8336,15251,7581,22832,2021-08-17
3174031003,JAKARTA SELATAN,MAMPANG PRAPATAN,PELA MAMPANG,43522,16704,26818,14924,41742,2021-08-17
3174081005,JAKARTA SELATAN,PANCORAN,PENGADEGAN,21478,7647,13831,6868,20699,2021-08-17
3175061003,JAKARTA TIMUR,CAKUNG,PENGGILINGAN,99255,44024,55231,22077,77308,2021-08-17
3172011001,JAKARTA UTARA,PENJARINGAN,PENJARINGAN,88308,38072,50236,22678,72914,2021-08-17
3174101001,JAKARTA SELATAN,PESANGGRAHAN,PESANGGRAHAN,27545,9967,17578,9696,27274,2021-08-17
3171071004,JAKARTA PUSAT,TANAH ABANG,PETAMBURAN,33271,16332,16939,7175,24114,2021-08-17
3174071008,JAKARTA SELATAN,KEBAYORAN BARU,PETOGOGAN,11499,4501,6998,4146,11144,2021-08-17
3171011004,JAKARTA PUSAT,GAMBIR,PETOJO SELATAN,14692,5765,8927,4971,13898,2021-08-17
3171011003,JAKARTA PUSAT,GAMBIR,PETOJO UTARA,17458,6787,10671,5055,15726,2021-08-17
3174101004,JAKARTA SELATAN,PESANGGRAHAN,PETUKANGAN SELATAN,37187,14407,22780,11525,34305,2021-08-17
3174101003,JAKARTA SELATAN,PESANGGRAHAN,PETUKANGAN UTARA,53716,22059,31657,16232,47889,2021-08-17
3175081002,JAKARTA TIMUR,MAKASAR,PINANG RANTI,27198,10877,16321,8147,24468,2021-08-17
3173031008,JAKARTA BARAT,TAMAN SARI,PINANGSIA,10729,3803,6926,3898,10824,2021-08-17
3175011001,JAKARTA TIMUR,MATRAMAN,PISANGAN BARU,31776,13430,18346,7936,26282,2021-08-17
3175021002,JAKARTA TIMUR,PULO GADUNG,PISANGAN TIMUR,41011,15449,25562,12050,37612,2021-08-17
3172011005,JAKARTA UTARA,PENJARINGAN,PLUIT,47783,17672,30111,20100,50211,2021-08-17
3175071002,JAKARTA TIMUR,DUREN SAWIT,PONDOK BAMBU,61550,26363,35187,17239,52426,2021-08-17
3175071004,JAKARTA TIMUR,DUREN SAWIT,PONDOK KELAPA,72015,28269,43746,21493,65239,2021-08-17
3175071007,JAKARTA TIMUR,DUREN SAWIT,PONDOK KOPI,35367,15816,19551,8906,28457,2021-08-17
3174061003,JAKARTA SELATAN,CILANDAK,PONDOK LABU,46464,17212,29252,17125,46377,2021-08-17
3174051002,JAKARTA SELATAN,KEBAYORAN LAMA,PONDOK PINANG,56169,22014,34155,18996,53151,2021-08-17
3175101003,JAKARTA TIMUR,CIPAYUNG,PONDOK RANGGON,25574,9666,15908,7655,23563,2021-08-17
3101011003,KAB.ADM.KEP.SERIBU,KEP. SERIBU UTARA,PULAU HARAPAN,2060,366,1694,949,2643,2021-08-17
3101011002,KAB.ADM.KEP.SERIBU,KEP. SERIBU UTARA,PULAU KELAPA,5528,994,4534,2062,6596,2021-08-17
3101011001,KAB.ADM.KEP.SERIBU,KEP. SERIBU UTARA,PULAU PANGGANG,5450,939,4511,1959,6470,2021-08-17
3101021003,KAB.ADM.KEP.SERIBU,KEP. SERIBU SELATAN,PULAU PARI,2765,341,2424,1297,3721,2021-08-17
3101021002,KAB.ADM.KEP.SERIBU,KEP. SERIBU SELATAN,PULAU TIDUNG,4553,693,3860,2417,6277,2021-08-17
3101021001,KAB.ADM.KEP.SERIBU,KEP. SERIBU SELATAN,PULAU UNTUNG JAWA,1941,351,1590,808,2398,2021-08-17
3174071007,JAKARTA SELATAN,KEBAYORAN BARU,PULO,5835,2094,3741,2493,6234,2021-08-17
3175021001,JAKARTA TIMUR,PULO GADUNG,PULO GADUNG,34422,13917,20505,10189,30694,2021-08-17
3175061005,JAKARTA TIMUR,CAKUNG,PULO GEBANG,97301,40560,56741,24925,81666,2021-08-17
3174041004,JAKARTA SELATAN,PASAR MINGGU,RAGUNAN,39616,14766,24850,13634,38484,2021-08-17
3175091005,JAKARTA TIMUR,CIRACAS,RAMBUTAN,36771,16330,20441,9540,29981,2021-08-17
3172031006,JAKARTA UTARA,KOJA,RAWA BADAK SELATAN,42179,18713,23466,10998,34464,2021-08-17
3172031004,JAKARTA UTARA,KOJA,RAWA BADAK UTARA,34408,14812,19596,10209,29805,2021-08-17
3174071005,JAKARTA SELATAN,KEBAYORAN BARU,RAWA BARAT,5625,2009,3616,2271,5887,2021-08-17
3173011003,JAKARTA BARAT,CENGKARENG,RAWA BUAYA,63799,25739,38060,15477,53537,2021-08-17
3175031004,JAKARTA TIMUR,JATINEGARA,RAWA BUNGA,21434,9217,12217,5554,17771,2021-08-17
3174081003,JAKARTA SELATAN,PANCORAN,RAWA JATI,20509,7895,12614,6793,19407,2021-08-17
3175061002,JAKARTA TIMUR,CAKUNG,RAWA TERATE,24637,8939,15698,6122,21820,2021-08-17
3175021005,JAKARTA TIMUR,PULO GADUNG,RAWAMANGUN,37612,15176,22436,11734,34170,2021-08-17
3171051003,JAKARTA PUSAT,CEMPAKA PUTIH,RAWASARI,21967,8774,13193,7226,20419,2021-08-17
3173041010,JAKARTA BARAT,TAMBORA,ROA MALAKA,3484,1100,2384,1452,3836,2021-08-17
3172041006,JAKARTA UTARA,CILINCING,ROROTAN,41668,15867,25801,12176,37977,2021-08-17
3174071004,JAKARTA SELATAN,KEBAYORAN BARU,SELONG,2842,1025,1817,1290,3107,2021-08-17
3173061002,JAKARTA BARAT,KALI DERES,SEMANAN,71354,28981,42373,15087,57460,2021-08-17
3172041007,JAKARTA UTARA,CILINCING,SEMPER BARAT,68587,25126,43461,22618,66079,2021-08-17
3172041005,JAKARTA UTARA,CILINCING,SEMPER TIMUR,36267,13917,22350,11123,33473,2021-08-17
3174071006,JAKARTA SELATAN,KEBAYORAN BARU,SENAYAN,2771,1209,1562,965,2527,2021-08-17
3171041001,JAKARTA PUSAT,SENEN,SENEN,6804,2526,4278,2385,6663,2021-08-17
3171031004,JAKARTA PUSAT,KEMAYORAN,SERDANG,29668,11664,18004,8769,26773,2021-08-17
3174021001,JAKARTA SELATAN,SETIA BUDI,SETIA BUDI,3023,1177,1846,1098,2944,2021-08-17
3175101005,JAKARTA TIMUR,CIPAYUNG,SETU,20572,8356,12216,5281,17497,2021-08-17
3173071002,JAKARTA BARAT,PALMERAH,SLIPI,16591,6238,10353,5551,15904,2021-08-17
3173081004,JAKARTA BARAT,KEMBANGAN,SRENGSENG,45523,19351,26172,12926,39098,2021-08-17
3174091002,JAKARTA SELATAN,JAGAKARSA,SRENGSENG SAWAH,58196,19854,38342,21488,59830,2021-08-17
3173051003,JAKARTA BARAT,KEBON JERUK,SUKABUMI SELATAN,37033,15682,21351,8729,30080,2021-08-17
3173051002,JAKARTA BARAT,KEBON JERUK,SUKABUMI UTARA,38290,17121,21169,9148,30317,2021-08-17
3172041002,JAKARTA UTARA,CILINCING,SUKAPURA,53949,21828,32121,16077,48198,2021-08-17
3171031007,JAKARTA PUSAT,KEMAYORAN,SUMUR BATU,22717,9168,13549,7290,20839,2021-08-17
3172021004,JAKARTA UTARA,TANJUNG PRIOK,SUNGAI BAMBU,29876,11504,18372,9558,27930,2021-08-17
3172021006,JAKARTA UTARA,TANJUNG PRIOK,SUNTER AGUNG,71805,24627,47178,27574,74752,2021-08-17
3172021002,JAKARTA UTARA,TANJUNG PRIOK,SUNTER JAYA,63031,22513,40518,22876,63394,2021-08-17
3175091004,JAKARTA TIMUR,CIRACAS,SUSUKAN,38257,13888,24369,11811,36180,2021-08-17
3173031001,JAKARTA BARAT,TAMAN SARI,TAMAN SARI,14348,5408,8940,5082,14022,2021-08-17
3173041001,JAKARTA BARAT,TAMBORA,TAMBORA,10204,4008,6196,2912,9108,2021-08-17
3173041004,JAKARTA BARAT,TAMBORA,TANAH SEREAL,26387,8857,17530,8167,25697,2021-08-17
3171081004,JAKARTA PUSAT,JOHAR BARU,TANAH TINGGI,37693,12689,25004,11603,36607,2021-08-17
3173031004,JAKARTA BARAT,TAMAN SARI,TANGKI,13324,5032,8292,4553,12845,2021-08-17
3174091005,JAKARTA SELATAN,JAGAKARSA,TANJUNG BARAT,39770,15057,24713,12477,37190,2021-08-17
3173021005,JAKARTA BARAT,GROGOL PETAMBURAN,TANJUNG DUREN SELATAN,25337,9549,15788,8737,24525,2021-08-17
3173021002,JAKARTA BARAT,GROGOL PETAMBURAN,TANJUNG DUREN UTARA,17010,6093,10917,6196,17113,2021-08-17
3172021001,JAKARTA UTARA,TANJUNG PRIOK,TANJUNG PRIOK,34588,12579,22009,10006,32015,2021-08-17
3174011002,JAKARTA SELATAN,TEBET,TEBET BARAT,21194,7558,13636,8092,21728,2021-08-17
3174011001,JAKARTA SELATAN,TEBET,TEBET TIMUR,18199,6498,11701,6976,18677,2021-08-17
3173061003,JAKARTA BARAT,KALI DERES,TEGAL ALUR,83647,32340,51307,19855,71162,2021-08-17
3174031004,JAKARTA SELATAN,MAMPANG PRAPATAN,TEGAL PARANG,32401,13536,18865,9336,28201,2021-08-17
3173021003,JAKARTA BARAT,GROGOL PETAMBURAN,TOMANG,29605,11179,18426,10557,28983,2021-08-17
3172031005,JAKARTA UTARA,KOJA,TUGU SELATAN,39122,16815,22307,10559,32866,2021-08-17
3172031002,JAKARTA UTARA,KOJA,TUGU UTARA,67670,29442,38228,18741,56969,2021-08-17
3175061006,JAKARTA TIMUR,CAKUNG,UJUNG MENTENG,29934,10881,19053,9001,28054,2021-08-17
3174101005,JAKARTA SELATAN,PESANGGRAHAN,ULUJAMI,40544,17231,23313,10727,34040,2021-08-17
3175011006,JAKARTA TIMUR,MATRAMAN,UTAN KAYU SELATAN,33511,12908,20603,10510,31113,2021-08-17
3175011002,JAKARTA TIMUR,MATRAMAN,UTAN KAYU UTARA,28169,11711,16458,8205,24663,2021-08-17
3171031008,JAKARTA PUSAT,KEMAYORAN,UTAN PANJANG,29208,11904,17304,7741,25045,2021-08-17
3172021007,JAKARTA UTARA,TANJUNG PRIOK,WARAKAS,44401,17081,27320,13807,41127,2021-08-17
3173021007,JAKARTA BARAT,GROGOL PETAMBURAN,WIJAYA KUSUMA,38934,15727,23207,11495,34702,2021-08-17
3172051003,JAKARTA UTARA,PADEMANGAN,ANCOL,23947,9677,14270,6877,21147,2021-08-18
3173041007,JAKARTA BARAT,TAMBORA,ANGKE,29381,10880,18501,8084,26585,2021-08-18
3175041005,JAKARTA TIMUR,KRAMAT JATI,BALE KAMBANG,29074,13611,15463,5851,21314,2021-08-18
3175031003,JAKARTA TIMUR,JATINEGARA,BALI MESTER,9752,3978,5774,2956,8730,2021-08-18
3175101006,JAKARTA TIMUR,CIPAYUNG,BAMBU APUS,26285,10108,16177,7583,23760,2021-08-18
3174031002,JAKARTA SELATAN,MAMPANG PRAPATAN,BANGKA,21566,8807,12759,6642,19401,2021-08-18
3175051002,JAKARTA TIMUR,PASAR REBO,BARU,23886,8323,15563,9255,24818,2021-08-18
3175041004,JAKARTA TIMUR,KRAMAT JATI,BATU AMPAR,47898,21459,26439,11393,37832,2021-08-18
3171071002,JAKARTA PUSAT,TANAH ABANG,BENDUNGAN HILIR,21494,8480,13014,7114,20128,2021-08-18
3175031002,JAKARTA TIMUR,JATINEGARA,BIDARA CINA,36689,16745,19944,8911,28855,2021-08-18
3174101002,JAKARTA SELATAN,PESANGGRAHAN,BINTARO,53098,20854,32244,17455,49699,2021-08-18
3174011005,JAKARTA SELATAN,TEBET,BUKIT DURI,34183,14336,19847,9925,29772,2021-08-18
3171041006,JAKARTA PUSAT,SENEN,BUNGUR,18144,6995,11149,5671,16820,2021-08-18
3175061007,JAKARTA TIMUR,CAKUNG,CAKUNG BARAT,57724,21136,36588,15727,52315,2021-08-18
3175061004,JAKARTA TIMUR,CAKUNG,CAKUNG TIMUR,58287,21832,36455,17149,53604,2021-08-18
3175041007,JAKARTA TIMUR,KRAMAT JATI,CAWANG,32762,14132,18630,8892,27522,2021-08-18
3175101008,JAKARTA TIMUR,CIPAYUNG,CEGER,18932,7157,11775,5308,17083,2021-08-18
3171031006,JAKARTA PUSAT,KEMAYORAN,CEMPAKA BARU,32581,13962,18619,9076,27695,2021-08-18
3171051002,JAKARTA PUSAT,CEMPAKA PUTIH,CEMPAKA PUTIH BARAT,35885,14408,21477,11537,33014,2021-08-18
3171051001,JAKARTA PUSAT,CEMPAKA PUTIH,CEMPAKA PUTIH TIMUR,24292,9552,14740,8257,22997,2021-08-18
3173011001,JAKARTA BARAT,CENGKARENG,CENGKARENG BARAT,66284,25271,41013,21242,62255,2021-08-18
3173011006,JAKARTA BARAT,CENGKARENG,CENGKARENG TIMUR,81027,30531,50496,21998,72494,2021-08-18
3175091002,JAKARTA TIMUR,CIRACAS,CIBUBUR,66364,24380,41984,22549,64533,2021-08-18
3171011002,JAKARTA PUSAT,GAMBIR,CIDENG,15390,5463,9927,5649,15576,2021-08-18
3174091003,JAKARTA SELATAN,JAGAKARSA,CIGANJUR,38497,14660,23837,12239,36076,2021-08-18
3175051003,JAKARTA TIMUR,PASAR REBO,CIJANTUNG,41419,15262,26157,13801,39958,2021-08-18
3171061003,JAKARTA PUSAT,MENTENG,CIKINI,8274,3532,4742,2430,7172,2021-08-18
3174081006,JAKARTA SELATAN,PANCORAN,CIKOKO,10547,3788,6759,3488,10247,2021-08-18
3174061001,JAKARTA SELATAN,CILANDAK,CILANDAK BARAT,51752,19694,32058,18126,50184,2021-08-18
3174041003,JAKARTA SELATAN,PASAR MINGGU,CILANDAK TIMUR,25145,9379,15766,9350,25116,2021-08-18
3175101002,JAKARTA TIMUR,CIPAYUNG,CILANGKAP,27635,10302,17333,8324,25657,2021-08-18
3175041006,JAKARTA TIMUR,KRAMAT JATI,CILILITAN,40181,17591,22590,10630,33220,2021-08-18
3172041001,JAKARTA UTARA,CILINCING,CILINCING,43609,17975,25634,12073,37707,2021-08-18
3175101001,JAKARTA TIMUR,CIPAYUNG,CIPAYUNG,26104,9227,16877,8908,25785,2021-08-18
3174091006,JAKARTA SELATAN,JAGAKARSA,CIPEDAK,38303,13594,24709,13710,38419,2021-08-18
3174061005,JAKARTA SELATAN,CILANDAK,CIPETE SELATAN,26704,10672,16032,9461,25493,2021-08-18
3174071010,JAKARTA SELATAN,KEBAYORAN BARU,CIPETE UTARA,34102,13215,20887,11171,32058,2021-08-18
3175021003,JAKARTA TIMUR,PULO GADUNG,CIPINANG,39306,15908,23398,12012,35410,2021-08-18
3175031007,JAKARTA TIMUR,JATINEGARA,CIPINANG BESAR SELATAN,35212,15919,19293,8306,27599,2021-08-18
3175031008,JAKARTA TIMUR,JATINEGARA,CIPINANG BESAR UTARA,45319,19698,25621,10353,35974,2021-08-18
3175031005,JAKARTA TIMUR,JATINEGARA,CIPINANG CEMPEDAK,32824,14249,18575,9598,28173,2021-08-18
3175081005,JAKARTA TIMUR,MAKASAR,CIPINANG MELAYU,42308,17246,25062,13242,38304,2021-08-18
3175031006,JAKARTA TIMUR,JATINEGARA,CIPINANG MUARA,55243,23783,31460,14509,45969,2021-08-18
3174051003,JAKARTA SELATAN,KEBAYORAN LAMA,CIPULIR,39937,16756,23181,10806,33987,2021-08-18
3175091001,JAKARTA TIMUR,CIRACAS,CIRACAS,64594,23732,40862,19994,60856,2021-08-18
3175041003,JAKARTA TIMUR,KRAMAT JATI,DUKUH,24609,9365,15244,6979,22223,2021-08-18
3175071001,JAKARTA TIMUR,DUREN SAWIT,DUREN SAWIT,61160,26299,34861,18032,52893,2021-08-18
3174081004,JAKARTA SELATAN,PANCORAN,DUREN TIGA,28319,11073,17246,8293,25539,2021-08-18
3173051005,JAKARTA BARAT,KEBON JERUK,DURI KEPA,60138,22140,37998,20278,58276,2021-08-18
3173011002,JAKARTA BARAT,CENGKARENG,DURI KOSAMBI,77923,33044,44879,20554,65433,2021-08-18
3171011006,JAKARTA PUSAT,GAMBIR,DURI PULO,19610,7536,12074,5525,17599,2021-08-18
3173041011,JAKARTA BARAT,TAMBORA,DURI SELATAN,14259,4945,9314,4628,13942,2021-08-18
3173041003,JAKARTA BARAT,TAMBORA,DURI UTARA,19844,7193,12651,5796,18447,2021-08-18
3171081003,JAKARTA PUSAT,JOHAR BARU,GALUR,18243,6190,12053,5281,17334,2021-08-18
3171011001,JAKARTA PUSAT,GAMBIR,GAMBIR,2191,788,1403,815,2218,2021-08-18
3174061004,JAKARTA SELATAN,CILANDAK,GANDARIA SELATAN,22119,8690,13429,7100,20529,2021-08-18
3174071009,JAKARTA SELATAN,KEBAYORAN BARU,GANDARIA UTARA,39922,15757,24165,12742,36907,2021-08-18
3175051001,JAKARTA TIMUR,PASAR REBO,GEDONG,35755,13545,22210,11387,33597,2021-08-18
3171071001,JAKARTA PUSAT,TANAH ABANG,GELORA,3127,1289,1838,960,2798,2021-08-18
3173031007,JAKARTA BARAT,TAMAN SARI,GLODOK,7837,2574,5263,3284,8547,2021-08-18
3171061004,JAKARTA PUSAT,MENTENG,GONDANGDIA,4100,1610,2490,1791,4281,2021-08-18
3173021001,JAKARTA BARAT,GROGOL PETAMBURAN,GROGOL,16876,6507,10369,5494,15863,2021-08-18
3174051005,JAKARTA SELATAN,KEBAYORAN LAMA,GROGOL SELATAN,44251,17899,26352,12236,38588,2021-08-18
3174051004,JAKARTA SELATAN,KEBAYORAN LAMA,GROGOL UTARA,42494,16850,25644,12275,37919,2021-08-18
3174021007,JAKARTA SELATAN,SETIA BUDI,GUNTUR,3985,1478,2507,1679,4186,2021-08-18
3174071002,JAKARTA SELATAN,KEBAYORAN BARU,GUNUNG,9436,3502,5934,3713,9647,2021-08-18
3171031005,JAKARTA PUSAT,KEMAYORAN,GUNUNG SAHARI SELATAN,19199,7617,11582,6250,17832,2021-08-18
3171021004,JAKARTA PUSAT,SAWAH BESAR,GUNUNG SAHARI UTARA,16650,5637,11013,6388,17401,2021-08-18
3175081004,JAKARTA TIMUR,MAKASAR,HALIM PERDANA KUSUMAH,28363,8504,19859,14241,34100,2021-08-18
3171031003,JAKARTA PUSAT,KEMAYORAN,HARAPAN MULIA,22557,9067,13490,6539,20029,2021-08-18
3174091001,JAKARTA SELATAN,JAGAKARSA,JAGAKARSA,62389,23123,39266,21533,60799,2021-08-18
3175021007,JAKARTA TIMUR,PULO GADUNG,JATI,32757,12914,19843,10589,30432,2021-08-18
3174041002,JAKARTA SELATAN,PASAR MINGGU,JATI PADANG,37502,14618,22884,12697,35581,2021-08-18
3173071004,JAKARTA BARAT,PALMERAH,JATI PULO,28738,10816,17922,7888,25810,2021-08-18
3175061001,JAKARTA TIMUR,CAKUNG,JATINEGARA,84160,34374,49786,20404,70190,2021-08-18
3175021004,JAKARTA TIMUR,PULO GADUNG,JATINEGARA KAUM,24632,8949,15683,6578,22261,2021-08-18
3173021004,JAKARTA BARAT,GROGOL PETAMBURAN,JELAMBAR,30266,11505,18761,10657,29418,2021-08-18
3173021006,JAKARTA BARAT,GROGOL PETAMBURAN,JELAMBAR BARU,38246,14540,23706,12999,36705,2021-08-18
3173041006,JAKARTA BARAT,TAMBORA,JEMBATAN BESI,29314,13086,16228,6389,22617,2021-08-18
3173041008,JAKARTA BARAT,TAMBORA,JEMBATAN LIMA,21021,8648,12373,5619,17992,2021-08-18
3173081005,JAKARTA BARAT,KEMBANGAN,JOGLO,40839,16087,24752,11955,36707,2021-08-18
3171081001,JAKARTA PUSAT,JOHAR BARU,JOHAR BARU,37488,13275,24213,12137,36350,2021-08-18
3173041002,JAKARTA BARAT,TAMBORA,KALI ANYAR,23856,8668,15188,5585,20773,2021-08-18
3172041004,JAKARTA UTARA,CILINCING,KALIBARU,67684,29905,37779,16509,54288,2021-08-18
3174081002,JAKARTA SELATAN,PANCORAN,KALIBATA,41994,18127,23867,10768,34635,2021-08-18
3173061001,JAKARTA BARAT,KALI DERES,KALIDERES,72447,28012,44435,20950,65385,2021-08-18
3175051004,JAKARTA TIMUR,PASAR REBO,KALISARI,43212,16359,26853,14248,41101,2021-08-18
3173061004,JAKARTA BARAT,KALI DERES,KAMAL,53783,21754,32029,11089,43118,2021-08-18
3172011002,JAKARTA UTARA,PENJARINGAN,KAMAL MUARA,12930,3854,9076,5698,14774,2021-08-18
3171071007,JAKARTA PUSAT,TANAH ABANG,KAMPUNG BALI,11358,5067,6291,3133,9424,2021-08-18
3175031001,JAKARTA TIMUR,JATINEGARA,KAMPUNG MELAYU,25717,11165,14552,6293,20845,2021-08-18
3171081002,JAKARTA PUSAT,JOHAR BARU,KAMPUNG RAWA,21237,6371,14866,6631,21497,2021-08-18
3175041002,JAKARTA TIMUR,KRAMAT JATI,KAMPUNG TENGAH,43993,19589,24404,10587,34991,2021-08-18
3173011005,JAKARTA BARAT,CENGKARENG,KAPUK,134466,56296,78170,30497,108667,2021-08-18
3172011003,JAKARTA UTARA,PENJARINGAN,KAPUK MUARA,35781,12239,23542,14309,37851,2021-08-18
3171021002,JAKARTA PUSAT,SAWAH BESAR,KARANG ANYAR,25761,9252,16509,7834,24343,2021-08-18
3174021004,JAKARTA SELATAN,SETIA BUDI,KARET,9623,3816,5807,3193,9000,2021-08-18
3174021003,JAKARTA SELATAN,SETIA BUDI,KARET KUNINGAN,16055,5670,10385,5950,16335,2021-08-18
3174021002,JAKARTA SELATAN,SETIA BUDI,KARET SEMANGGI,2770,986,1784,1220,3004,2021-08-18
3171071003,JAKARTA PUSAT,TANAH ABANG,KARET TENGSIN,19271,7596,11675,5555,17230,2021-08-18
3171021003,JAKARTA PUSAT,SAWAH BESAR,KARTINI,22292,8317,13975,7635,21610,2021-08-18
3175011003,JAKARTA TIMUR,MATRAMAN,KAYU MANIS,25284,10717,14567,6726,21293,2021-08-18
3175021006,JAKARTA TIMUR,PULO GADUNG,KAYU PUTIH,40696,15135,25561,14509,40070,2021-08-18
3173031006,JAKARTA BARAT,TAMAN SARI,KEAGUNGAN,17387,6342,11045,5621,16666,2021-08-18
3174041007,JAKARTA SELATAN,PASAR MINGGU,KEBAGUSAN,44552,18182,26370,13334,39704,2021-08-18
3174051006,JAKARTA SELATAN,KEBAYORAN LAMA,KEBAYORAN LAMA SELATAN,41212,15665,25547,13247,38794,2021-08-18
3174051001,JAKARTA SELATAN,KEBAYORAN LAMA,KEBAYORAN LAMA UTARA,42422,17342,25080,11681,36761,2021-08-18
3174011004,JAKARTA SELATAN,TEBET,KEBON BARU,35165,13832,21333,11011,32344,2021-08-18
3172021005,JAKARTA UTARA,TANJUNG PRIOK,KEBON BAWANG,50952,20097,30855,16200,47055,2021-08-18
3173051001,JAKARTA BARAT,KEBON JERUK,KEBON JERUK,53887,22392,31495,14858,46353,2021-08-18
3171071006,JAKARTA PUSAT,TANAH ABANG,KEBON KACANG,21531,10125,11406,5548,16954,2021-08-18
3171011005,JAKARTA PUSAT,GAMBIR,KEBON KELAPA,10163,3830,6333,3331,9664,2021-08-18
3171031002,JAKARTA PUSAT,KEMAYORAN,KEBON KOSONG,30019,12099,17920,9205,27125,2021-08-18
3175011005,JAKARTA TIMUR,MATRAMAN,KEBON MANGGIS,16490,6297,10193,5599,15792,2021-08-18
3171071005,JAKARTA PUSAT,TANAH ABANG,KEBON MELATI,32206,15933,16273,7180,23453,2021-08-18
3175081003,JAKARTA TIMUR,MAKASAR,KEBON PALA,46614,18128,28486,13137,41623,2021-08-18
3171061005,JAKARTA PUSAT,MENTENG,KEBON SIRIH,12299,5262,7037,3207,10244,2021-08-18
3173011004,JAKARTA BARAT,CENGKARENG,KEDAUNG KALI ANGKE,32612,11574,21038,9646,30684,2021-08-18
3173051007,JAKARTA BARAT,KEBON JERUK,KEDOYA SELATAN,32165,12057,20108,9194,29302,2021-08-18
3173051006,JAKARTA BARAT,KEBON JERUK,KEDOYA UTARA,45740,16098,29642,14642,44284,2021-08-18
3173051004,JAKARTA BARAT,KEBON JERUK,KELAPA DUA,23565,9395,14170,6567,20737,2021-08-18
3175091003,JAKARTA TIMUR,CIRACAS,KELAPA DUA WETAN,46875,16806,30069,14954,45023,2021-08-18
3172061003,JAKARTA UTARA,KELAPA GADING,KELAPA GADING BARAT,35717,12179,23538,15525,39063,2021-08-18
3172061001,JAKARTA UTARA,KELAPA GADING,KELAPA GADING TIMUR,33592,10625,22967,15113,38080,2021-08-18
3173071005,JAKARTA BARAT,PALMERAH,KEMANGGISAN,32139,12655,19484,9731,29215,2021-08-18
3171031001,JAKARTA PUSAT,KEMAYORAN,KEMAYORAN,20708,7848,12860,6713,19573,2021-08-18
3173081006,JAKARTA BARAT,KEMBANGAN,KEMBANGAN SELATAN,27130,10486,16644,9008,25652,2021-08-18
3173081001,JAKARTA BARAT,KEMBANGAN,KEMBANGAN UTARA,54451,21047,33404,15614,49018,2021-08-18
3171041002,JAKARTA PUSAT,SENEN,KENARI,9579,3600,5979,3004,8983,2021-08-18
3173041005,JAKARTA BARAT,TAMBORA,KERENDANG,19973,7511,12462,6019,18481,2021-08-18
3175071003,JAKARTA TIMUR,DUREN SAWIT,KLENDER,69978,30699,39279,16570,55849,2021-08-18
3172031001,JAKARTA UTARA,KOJA,KOJA,28175,11435,16740,9053,25793,2021-08-18
3173071006,JAKARTA BARAT,PALMERAH,KOTA BAMBU SELATAN,21158,8427,12731,5687,18418,2021-08-18
3173071003,JAKARTA BARAT,PALMERAH,KOTA BAMBU UTARA,24995,10513,14482,6543,21025,2021-08-18
3171041004,JAKARTA PUSAT,SENEN,KRAMAT,28835,12643,16192,7069,23261,2021-08-18
3175041001,JAKARTA TIMUR,KRAMAT JATI,KRAMAT JATI,34144,13627,20517,9298,29815,2021-08-18
3174071003,JAKARTA SELATAN,KEBAYORAN BARU,KRAMAT PELA,14413,5345,9068,4937,14005,2021-08-18
3173031002,JAKARTA BARAT,TAMAN SARI,KRUKUT,19244,7251,11993,5324,17317,2021-08-18
3174031005,JAKARTA SELATAN,MAMPANG PRAPATAN,KUNINGAN BARAT,12785,4743,8042,4362,12404,2021-08-18
3174021008,JAKARTA SELATAN,SETIA BUDI,KUNINGAN TIMUR,6008,2287,3721,2202,5923,2021-08-18
3171041005,JAKARTA PUSAT,SENEN,KWITANG,15486,6036,9450,4484,13934,2021-08-18
3172031003,JAKARTA UTARA,KOJA,LAGOA,59065,24843,34222,16378,50600,2021-08-18
3174061002,JAKARTA SELATAN,CILANDAK,LEBAK BULUS,37626,15042,22584,12629,35213,2021-08-18
3174091004,JAKARTA SELATAN,JAGAKARSA,LENTENG AGUNG,53946,21720,32226,15314,47540,2021-08-18
3175101007,JAKARTA TIMUR,CIPAYUNG,LUBANG BUAYA,63547,23197,40350,19930,60280,2021-08-18
3175081001,JAKARTA TIMUR,MAKASAR,MAKASAR,34390,13048,21342,10695,32037,2021-08-18
3175071006,JAKARTA TIMUR,DUREN SAWIT,MALAKA JAYA,30927,12257,18670,10673,29343,2021-08-18
3175071005,JAKARTA TIMUR,DUREN SAWIT,MALAKA SARI,27530,10656,16874,9685,26559,2021-08-18
3174031001,JAKARTA SELATAN,MAMPANG PRAPATAN,MAMPANG PRAPATAN,18159,7105,11054,6189,17243,2021-08-18
3173031005,JAKARTA BARAT,TAMAN SARI,MANGGA BESAR,7707,2562,5145,3049,8194,2021-08-18
3171021005,JAKARTA PUSAT,SAWAH BESAR,MANGGA DUA SELATAN,27442,10424,17018,9057,26075,2021-08-18
3174011007,JAKARTA SELATAN,TEBET,MANGGARAI,28373,10310,18063,8404,26467,2021-08-18
3174011006,JAKARTA SELATAN,TEBET,MANGGARAI SELATAN,23075,8596,14479,7724,22203,2021-08-18
3173031003,JAKARTA BARAT,TAMAN SARI,MAPHAR,16461,6270,10191,5605,15796,2021-08-18
3172041003,JAKARTA UTARA,CILINCING,MARUNDA,28943,11046,17897,7303,25200,2021-08-18
3174071001,JAKARTA SELATAN,KEBAYORAN BARU,MELAWAI,2627,940,1687,1250,2937,2021-08-18
3171061001,JAKARTA PUSAT,MENTENG,MENTENG,25624,10641,14983,7325,22308,2021-08-18
3174021005,JAKARTA SELATAN,SETIA BUDI,MENTENG ATAS,27816,10250,17566,9191,26757,2021-08-18
3174011003,JAKARTA SELATAN,TEBET,MENTENG DALAM,36028,13993,22035,11414,33449,2021-08-18
3173081003,JAKARTA BARAT,KEMBANGAN,MERUYA SELATAN,32130,12470,19660,9415,29075,2021-08-18
3173081002,JAKARTA BARAT,KEMBANGAN,MERUYA UTARA,43752,17085,26667,14060,40727,2021-08-18
3175101004,JAKARTA TIMUR,CIPAYUNG,MUNJUL,23871,8642,15229,7332,22561,2021-08-18
3172051002,JAKARTA UTARA,PADEMANGAN,PADEMANGAN BARAT,74240,30136,44104,21398,65502,2021-08-18
3172051001,JAKARTA UTARA,PADEMANGAN,PADEMANGAN TIMUR,37736,12980,24756,14133,38889,2021-08-18
3175011004,JAKARTA TIMUR,MATRAMAN,PAL MERIAM,19769,8163,11606,5766,17372,2021-08-18
3173071001,JAKARTA BARAT,PALMERAH,PALMERAH,63011,25124,37887,17495,55382,2021-08-18
3174081001,JAKARTA SELATAN,PANCORAN,PANCORAN,19421,7542,11879,6475,18354,2021-08-18
3172021003,JAKARTA UTARA,TANJUNG PRIOK,PAPANGGO,39097,14333,24764,12622,37386,2021-08-18
3171021001,JAKARTA PUSAT,SAWAH BESAR,PASAR BARU,12035,4007,8028,4755,12783,2021-08-18
3174021006,JAKARTA SELATAN,SETIA BUDI,PASAR MANGGIS,26752,10457,16295,8722,25017,2021-08-18
3174041001,JAKARTA SELATAN,PASAR MINGGU,PASAR MINGGU,24821,9664,15157,8678,23835,2021-08-18
3171041003,JAKARTA PUSAT,SENEN,PASEBAN,23533,9503,14030,6798,20828,2021-08-18
3173061005,JAKARTA BARAT,KALI DERES,PEGADUNGAN,75587,27129,48458,23321,71779,2021-08-18
3171061002,JAKARTA PUSAT,MENTENG,PEGANGSAAN,23455,10074,13381,6208,19589,2021-08-18
3172061002,JAKARTA UTARA,KELAPA GADING,PEGANGSAAN DUA,49976,15666,34310,20886,55196,2021-08-18
3172011004,JAKARTA UTARA,PENJARINGAN,PEJAGALAN,74578,28397,46181,26042,72223,2021-08-18
3174041006,JAKARTA SELATAN,PASAR MINGGU,PEJATEN BARAT,37346,14942,22404,12469,34873,2021-08-18
3174041005,JAKARTA SELATAN,PASAR MINGGU,PEJATEN TIMUR,57656,23964,33692,16188,49880,2021-08-18
3175051005,JAKARTA TIMUR,PASAR REBO,PEKAYON,43250,16016,27234,13655,40889,2021-08-18
3173041009,JAKARTA BARAT,TAMBORA,PEKOJAN,23587,8323,15264,7591,22855,2021-08-18
3174031003,JAKARTA SELATAN,MAMPANG PRAPATAN,PELA MAMPANG,43522,16651,26871,14941,41812,2021-08-18
3174081005,JAKARTA SELATAN,PANCORAN,PENGADEGAN,21478,7629,13849,6883,20732,2021-08-18
3175061003,JAKARTA TIMUR,CAKUNG,PENGGILINGAN,99255,43910,55345,22201,77546,2021-08-18
3172011001,JAKARTA UTARA,PENJARINGAN,PENJARINGAN,88308,37655,50653,22886,73539,2021-08-18
3174101001,JAKARTA SELATAN,PESANGGRAHAN,PESANGGRAHAN,27545,9956,17589,9701,27290,2021-08-18
3171071004,JAKARTA PUSAT,TANAH ABANG,PETAMBURAN,33271,16240,17031,7235,24266,2021-08-18
3174071008,JAKARTA SELATAN,KEBAYORAN BARU,PETOGOGAN,11499,4487,7012,4158,11170,2021-08-18
3171011004,JAKARTA PUSAT,GAMBIR,PETOJO SELATAN,14692,5734,8958,4981,13939,2021-08-18
3171011003,JAKARTA PUSAT,GAMBIR,PETOJO UTARA,17458,6742,10716,5070,15786,2021-08-18
3174101004,JAKARTA SELATAN,PESANGGRAHAN,PETUKANGAN SELATAN,37187,14382,22805,11531,34336,2021-08-18
3174101003,JAKARTA SELATAN,PESANGGRAHAN,PETUKANGAN UTARA,53716,21921,31795,16250,48045,2021-08-18
3175081002,JAKARTA TIMUR,MAKASAR,PINANG RANTI,27198,10830,16368,8172,24540,2021-08-18
3173031008,JAKARTA BARAT,TAMAN SARI,PINANGSIA,10729,3789,6940,3909,10849,2021-08-18
3175011001,JAKARTA TIMUR,MATRAMAN,PISANGAN BARU,31776,13347,18429,8081,26510,2021-08-18
3175021002,JAKARTA TIMUR,PULO GADUNG,PISANGAN TIMUR,41011,15377,25634,12064,37698,2021-08-18
3172011005,JAKARTA UTARA,PENJARINGAN,PLUIT,47783,17549,30234,20146,50380,2021-08-18
3175071002,JAKARTA TIMUR,DUREN SAWIT,PONDOK BAMBU,61550,26243,35307,17244,52551,2021-08-18
3175071004,JAKARTA TIMUR,DUREN SAWIT,PONDOK KELAPA,72015,28143,43872,21513,65385,2021-08-18
3175071007,JAKARTA TIMUR,DUREN SAWIT,PONDOK KOPI,35367,15739,19628,8912,28540,2021-08-18
3174061003,JAKARTA SELATAN,CILANDAK,PONDOK LABU,46464,17159,29305,17208,46513,2021-08-18
3174051002,JAKARTA SELATAN,KEBAYORAN LAMA,PONDOK PINANG,56169,21824,34345,19026,53371,2021-08-18
3175101003,JAKARTA TIMUR,CIPAYUNG,PONDOK RANGGON,25574,9570,16004,7675,23679,2021-08-18
3101011003,KAB.ADM.KEP.SERIBU,KEP. SERIBU UTARA,PULAU HARAPAN,2060,363,1697,955,2652,2021-08-18
3101011002,KAB.ADM.KEP.SERIBU,KEP. SERIBU UTARA,PULAU KELAPA,5528,993,4535,2067,6602,2021-08-18
3101011001,KAB.ADM.KEP.SERIBU,KEP. SERIBU UTARA,PULAU PANGGANG,5450,932,4518,1968,6486,2021-08-18
3101021003,KAB.ADM.KEP.SERIBU,KEP. SERIBU SELATAN,PULAU PARI,2765,339,2426,1304,3730,2021-08-18
3101021002,KAB.ADM.KEP.SERIBU,KEP. SERIBU SELATAN,PULAU TIDUNG,4553,692,3861,2418,6279,2021-08-18
3101021001,KAB.ADM.KEP.SERIBU,KEP. SERIBU SELATAN,PULAU UNTUNG JAWA,1941,350,1591,808,2399,2021-08-18
3174071007,JAKARTA SELATAN,KEBAYORAN BARU,PULO,5835,2091,3744,2495,6239,2021-08-18
3175021001,JAKARTA TIMUR,PULO GADUNG,PULO GADUNG,34422,13792,20630,10215,30845,2021-08-18
3175061005,JAKARTA TIMUR,CAKUNG,PULO GEBANG,97301,40345,56956,25009,81965,2021-08-18
3174041004,JAKARTA SELATAN,PASAR MINGGU,RAGUNAN,39616,14737,24879,13646,38525,2021-08-18
3175091005,JAKARTA TIMUR,CIRACAS,RAMBUTAN,36771,16232,20539,9578,30117,2021-08-18
3172031006,JAKARTA UTARA,KOJA,RAWA BADAK SELATAN,42179,18376,23803,11181,34984,2021-08-18
3172031004,JAKARTA UTARA,KOJA,RAWA BADAK UTARA,34408,14632,19776,10236,30012,2021-08-18
3174071005,JAKARTA SELATAN,KEBAYORAN BARU,RAWA BARAT,5625,1997,3628,2271,5899,2021-08-18
3173011003,JAKARTA BARAT,CENGKARENG,RAWA BUAYA,63799,25540,38259,15706,53965,2021-08-18
3175031004,JAKARTA TIMUR,JATINEGARA,RAWA BUNGA,21434,9119,12315,5582,17897,2021-08-18
3174081003,JAKARTA SELATAN,PANCORAN,RAWA JATI,20509,7869,12640,6802,19442,2021-08-18
3175061002,JAKARTA TIMUR,CAKUNG,RAWA TERATE,24637,8928,15709,6135,21844,2021-08-18
3175021005,JAKARTA TIMUR,PULO GADUNG,RAWAMANGUN,37612,15080,22532,11746,34278,2021-08-18
3171051003,JAKARTA PUSAT,CEMPAKA PUTIH,RAWASARI,21967,8736,13231,7256,20487,2021-08-18
3173041010,JAKARTA BARAT,TAMBORA,ROA MALAKA,3484,1100,2384,1453,3837,2021-08-18
3172041006,JAKARTA UTARA,CILINCING,ROROTAN,41668,15750,25918,12186,38104,2021-08-18
3174071004,JAKARTA SELATAN,KEBAYORAN BARU,SELONG,2842,1024,1818,1290,3108,2021-08-18
3173061002,JAKARTA BARAT,KALI DERES,SEMANAN,71354,28664,42690,15149,57839,2021-08-18
3172041007,JAKARTA UTARA,CILINCING,SEMPER BARAT,68587,24968,43619,22677,66296,2021-08-18
3172041005,JAKARTA UTARA,CILINCING,SEMPER TIMUR,36267,13786,22481,11170,33651,2021-08-18
3174071006,JAKARTA SELATAN,KEBAYORAN BARU,SENAYAN,2771,1197,1574,967,2541,2021-08-18
3171041001,JAKARTA PUSAT,SENEN,SENEN,6804,2521,4283,2387,6670,2021-08-18
3171031004,JAKARTA PUSAT,KEMAYORAN,SERDANG,29668,11617,18051,8795,26846,2021-08-18
3174021001,JAKARTA SELATAN,SETIA BUDI,SETIA BUDI,3023,1177,1846,1098,2944,2021-08-18
3175101005,JAKARTA TIMUR,CIPAYUNG,SETU,20572,8250,12322,5292,17614,2021-08-18
3173071002,JAKARTA BARAT,PALMERAH,SLIPI,16591,6198,10393,5561,15954,2021-08-18
3173081004,JAKARTA BARAT,KEMBANGAN,SRENGSENG,45523,18891,26632,13037,39669,2021-08-18
3174091002,JAKARTA SELATAN,JAGAKARSA,SRENGSENG SAWAH,58196,19822,38374,21508,59882,2021-08-18
3173051003,JAKARTA BARAT,KEBON JERUK,SUKABUMI SELATAN,37033,15449,21584,8770,30354,2021-08-18
3173051002,JAKARTA BARAT,KEBON JERUK,SUKABUMI UTARA,38290,16869,21421,9175,30596,2021-08-18
3172041002,JAKARTA UTARA,CILINCING,SUKAPURA,53949,21613,32336,16141,48477,2021-08-18
3171031007,JAKARTA PUSAT,KEMAYORAN,SUMUR BATU,22717,9136,13581,7301,20882,2021-08-18
3172021004,JAKARTA UTARA,TANJUNG PRIOK,SUNGAI BAMBU,29876,11414,18462,9590,28052,2021-08-18
3172021006,JAKARTA UTARA,TANJUNG PRIOK,SUNTER AGUNG,71805,24586,47219,27588,74807,2021-08-18
3172021002,JAKARTA UTARA,TANJUNG PRIOK,SUNTER JAYA,63031,22349,40682,22896,63578,2021-08-18
3175091004,JAKARTA TIMUR,CIRACAS,SUSUKAN,38257,13845,24412,11850,36262,2021-08-18
3173031001,JAKARTA BARAT,TAMAN SARI,TAMAN SARI,14348,5376,8972,5097,14069,2021-08-18
3173041001,JAKARTA BARAT,TAMBORA,TAMBORA,10204,3989,6215,2915,9130,2021-08-18
3173041004,JAKARTA BARAT,TAMBORA,TANAH SEREAL,26387,8780,17607,8182,25789,2021-08-18
3171081004,JAKARTA PUSAT,JOHAR BARU,TANAH TINGGI,37693,12639,25054,11622,36676,2021-08-18
3173031004,JAKARTA BARAT,TAMAN SARI,TANGKI,13324,5013,8311,4565,12876,2021-08-18
3174091005,JAKARTA SELATAN,JAGAKARSA,TANJUNG BARAT,39770,15017,24753,12497,37250,2021-08-18
3173021005,JAKARTA BARAT,GROGOL PETAMBURAN,TANJUNG DUREN SELATAN,25337,9523,15814,8768,24582,2021-08-18
3173021002,JAKARTA BARAT,GROGOL PETAMBURAN,TANJUNG DUREN UTARA,17010,6079,10931,6206,17137,2021-08-18
3172021001,JAKARTA UTARA,TANJUNG PRIOK,TANJUNG PRIOK,34588,12540,22048,10057,32105,2021-08-18
3174011002,JAKARTA SELATAN,TEBET,TEBET BARAT,21194,7537,13657,8101,21758,2021-08-18
3174011001,JAKARTA SELATAN,TEBET,TEBET TIMUR,18199,6488,11711,6988,18699,2021-08-18
3173061003,JAKARTA BARAT,KALI DERES,TEGAL ALUR,83647,32049,51598,19990,71588,2021-08-18
3174031004,JAKARTA SELATAN,MAMPANG PRAPATAN,TEGAL PARANG,32401,13411,18990,9355,28345,2021-08-18
3173021003,JAKARTA BARAT,GROGOL PETAMBURAN,TOMANG,29605,11145,18460,10573,29033,2021-08-18
3172031005,JAKARTA UTARA,KOJA,TUGU SELATAN,39122,16498,22624,10602,33226,2021-08-18
3172031002,JAKARTA UTARA,KOJA,TUGU UTARA,67670,29053,38617,18898,57515,2021-08-18
3175061006,JAKARTA TIMUR,CAKUNG,UJUNG MENTENG,29934,10865,19069,9012,28081,2021-08-18
3174101005,JAKARTA SELATAN,PESANGGRAHAN,ULUJAMI,40544,16960,23584,10759,34343,2021-08-18
3175011006,JAKARTA TIMUR,MATRAMAN,UTAN KAYU SELATAN,33511,12852,20659,10526,31185,2021-08-18
3175011002,JAKARTA TIMUR,MATRAMAN,UTAN KAYU UTARA,28169,11655,16514,8217,24731,2021-08-18
3171031008,JAKARTA PUSAT,KEMAYORAN,UTAN PANJANG,29208,11877,17331,7749,25080,2021-08-18
3172021007,JAKARTA UTARA,TANJUNG PRIOK,WARAKAS,44401,16892,27509,13849,41358,2021-08-18
3173021007,JAKARTA BARAT,GROGOL PETAMBURAN,WIJAYA KUSUMA,38934,15271,23663,11547,35210,2021-08-18
3172051003,JAKARTA UTARA,PADEMANGAN,ANCOL,23947,9638,14309,7096,21405,2021-08-19
3173041007,JAKARTA BARAT,TAMBORA,ANGKE,29381,10838,18543,8363,26906,2021-08-19
3175041005,JAKARTA TIMUR,KRAMAT JATI,BALE KAMBANG,29074,13413,15661,5971,21632,2021-08-19
3175031003,JAKARTA TIMUR,JATINEGARA,BALI MESTER,9752,3957,5795,3000,8795,2021-08-19
3175101006,JAKARTA TIMUR,CIPAYUNG,BAMBU APUS,26285,10030,16255,7779,24034,2021-08-19
3174031002,JAKARTA SELATAN,MAMPANG PRAPATAN,BANGKA,21566,8753,12813,6905,19718,2021-08-19
3175051002,JAKARTA TIMUR,PASAR REBO,BARU,23886,8266,15620,9462,25082,2021-08-19
3175041004,JAKARTA TIMUR,KRAMAT JATI,BATU AMPAR,47898,21250,26648,11588,38236,2021-08-19
3171071002,JAKARTA PUSAT,TANAH ABANG,BENDUNGAN HILIR,21494,8423,13071,7263,20334,2021-08-19
3175031002,JAKARTA TIMUR,JATINEGARA,BIDARA CINA,36689,16632,20057,9140,29197,2021-08-19
3174101002,JAKARTA SELATAN,PESANGGRAHAN,BINTARO,53098,20713,32385,17904,50289,2021-08-19
3174011005,JAKARTA SELATAN,TEBET,BUKIT DURI,34183,14225,19958,10172,30130,2021-08-19
3171041006,JAKARTA PUSAT,SENEN,BUNGUR,18144,6957,11187,5773,16960,2021-08-19
3175061007,JAKARTA TIMUR,CAKUNG,CAKUNG BARAT,57724,21031,36693,16246,52939,2021-08-19
3175061004,JAKARTA TIMUR,CAKUNG,CAKUNG TIMUR,58287,21594,36693,18137,54830,2021-08-19
3175041007,JAKARTA TIMUR,KRAMAT JATI,CAWANG,32762,13999,18763,9089,27852,2021-08-19
3175101008,JAKARTA TIMUR,CIPAYUNG,CEGER,18932,7111,11821,5416,17237,2021-08-19
3171031006,JAKARTA PUSAT,KEMAYORAN,CEMPAKA BARU,32581,13782,18799,9285,28084,2021-08-19
3171051002,JAKARTA PUSAT,CEMPAKA PUTIH,CEMPAKA PUTIH BARAT,35885,14291,21594,11790,33384,2021-08-19
3171051001,JAKARTA PUSAT,CEMPAKA PUTIH,CEMPAKA PUTIH TIMUR,24292,9454,14838,8414,23252,2021-08-19
3173011001,JAKARTA BARAT,CENGKARENG,CENGKARENG BARAT,66284,25021,41263,21750,63013,2021-08-19
3173011006,JAKARTA BARAT,CENGKARENG,CENGKARENG TIMUR,81027,30313,50714,22626,73340,2021-08-19
3175091002,JAKARTA TIMUR,CIRACAS,CIBUBUR,66364,24119,42245,23316,65561,2021-08-19
3171011002,JAKARTA PUSAT,GAMBIR,CIDENG,15390,5444,9946,5783,15729,2021-08-19
3174091003,JAKARTA SELATAN,JAGAKARSA,CIGANJUR,38497,14539,23958,12608,36566,2021-08-19
3175051003,JAKARTA TIMUR,PASAR REBO,CIJANTUNG,41419,15127,26292,14069,40361,2021-08-19
3171061003,JAKARTA PUSAT,MENTENG,CIKINI,8274,3500,4774,2522,7296,2021-08-19
3174081006,JAKARTA SELATAN,PANCORAN,CIKOKO,10547,3764,6783,3527,10310,2021-08-19
3174061001,JAKARTA SELATAN,CILANDAK,CILANDAK BARAT,51752,19541,32211,18520,50731,2021-08-19
3174041003,JAKARTA SELATAN,PASAR MINGGU,CILANDAK TIMUR,25145,9302,15843,9552,25395,2021-08-19
3175101002,JAKARTA TIMUR,CIPAYUNG,CILANGKAP,27635,10227,17408,8611,26019,2021-08-19
3175041006,JAKARTA TIMUR,KRAMAT JATI,CILILITAN,40181,17451,22730,10849,33579,2021-08-19
3172041001,JAKARTA UTARA,CILINCING,CILINCING,43609,17856,25753,12354,38107,2021-08-19
3175101001,JAKARTA TIMUR,CIPAYUNG,CIPAYUNG,26104,9150,16954,9050,26004,2021-08-19
3174091006,JAKARTA SELATAN,JAGAKARSA,CIPEDAK,38303,13492,24811,14079,38890,2021-08-19
3174061005,JAKARTA SELATAN,CILANDAK,CIPETE SELATAN,26704,10580,16124,9841,25965,2021-08-19
3174071010,JAKARTA SELATAN,KEBAYORAN BARU,CIPETE UTARA,34102,13131,20971,11565,32536,2021-08-19
3175021003,JAKARTA TIMUR,PULO GADUNG,CIPINANG,39306,15767,23539,12249,35788,2021-08-19
3175031007,JAKARTA TIMUR,JATINEGARA,CIPINANG BESAR SELATAN,35212,15801,19411,8639,28050,2021-08-19
3175031008,JAKARTA TIMUR,JATINEGARA,CIPINANG BESAR UTARA,45319,19557,25762,10694,36456,2021-08-19
3175031005,JAKARTA TIMUR,JATINEGARA,CIPINANG CEMPEDAK,32824,14151,18673,9856,28529,2021-08-19
3175081005,JAKARTA TIMUR,MAKASAR,CIPINANG MELAYU,42308,17143,25165,13490,38655,2021-08-19
3175031006,JAKARTA TIMUR,JATINEGARA,CIPINANG MUARA,55243,23611,31632,14807,46439,2021-08-19
3174051003,JAKARTA SELATAN,KEBAYORAN LAMA,CIPULIR,39937,16662,23275,11034,34309,2021-08-19
3175091001,JAKARTA TIMUR,CIRACAS,CIRACAS,64594,23493,41101,20585,61686,2021-08-19
3175041003,JAKARTA TIMUR,KRAMAT JATI,DUKUH,24609,9239,15370,7122,22492,2021-08-19
3175071001,JAKARTA TIMUR,DUREN SAWIT,DUREN SAWIT,61160,26117,35043,18347,53390,2021-08-19
3174081004,JAKARTA SELATAN,PANCORAN,DUREN TIGA,28319,11012,17307,8423,25730,2021-08-19
3173051005,JAKARTA BARAT,KEBON JERUK,DURI KEPA,60138,22022,38116,20712,58828,2021-08-19
3173011002,JAKARTA BARAT,CENGKARENG,DURI KOSAMBI,77923,32775,45148,21097,66245,2021-08-19
3171011006,JAKARTA PUSAT,GAMBIR,DURI PULO,19610,7457,12153,5787,17940,2021-08-19
3173041011,JAKARTA BARAT,TAMBORA,DURI SELATAN,14259,4922,9337,4831,14168,2021-08-19
3173041003,JAKARTA BARAT,TAMBORA,DURI UTARA,19844,7152,12692,5927,18619,2021-08-19
3171081003,JAKARTA PUSAT,JOHAR BARU,GALUR,18243,6100,12143,5546,17689,2021-08-19
3171011001,JAKARTA PUSAT,GAMBIR,GAMBIR,2191,781,1410,826,2236,2021-08-19
3174061004,JAKARTA SELATAN,CILANDAK,GANDARIA SELATAN,22119,8614,13505,7286,20791,2021-08-19
3174071009,JAKARTA SELATAN,KEBAYORAN BARU,GANDARIA UTARA,39922,15662,24260,13140,37400,2021-08-19
3175051001,JAKARTA TIMUR,PASAR REBO,GEDONG,35755,13435,22320,11651,33971,2021-08-19
3171071001,JAKARTA PUSAT,TANAH ABANG,GELORA,3127,1282,1845,973,2818,2021-08-19
3173031007,JAKARTA BARAT,TAMAN SARI,GLODOK,7837,2554,5283,3343,8626,2021-08-19
3171061004,JAKARTA PUSAT,MENTENG,GONDANGDIA,4100,1600,2500,1813,4313,2021-08-19
3173021001,JAKARTA BARAT,GROGOL PETAMBURAN,GROGOL,16876,6472,10404,5656,16060,2021-08-19
3174051005,JAKARTA SELATAN,KEBAYORAN LAMA,GROGOL SELATAN,44251,17779,26472,12464,38936,2021-08-19
3174051004,JAKARTA SELATAN,KEBAYORAN LAMA,GROGOL UTARA,42494,16772,25722,12530,38252,2021-08-19
3174021007,JAKARTA SELATAN,SETIA BUDI,GUNTUR,3985,1469,2516,1695,4211,2021-08-19
3174071002,JAKARTA SELATAN,KEBAYORAN BARU,GUNUNG,9436,3480,5956,3787,9743,2021-08-19
3171031005,JAKARTA PUSAT,KEMAYORAN,GUNUNG SAHARI SELATAN,19199,7561,11638,6424,18062,2021-08-19
3171021004,JAKARTA PUSAT,SAWAH BESAR,GUNUNG SAHARI UTARA,16650,5581,11069,6520,17589,2021-08-19
3175081004,JAKARTA TIMUR,MAKASAR,HALIM PERDANA KUSUMAH,28363,8439,19924,14399,34323,2021-08-19
3171031003,JAKARTA PUSAT,KEMAYORAN,HARAPAN MULIA,22557,8988,13569,6671,20240,2021-08-19
3174091001,JAKARTA SELATAN,JAGAKARSA,JAGAKARSA,62389,22941,39448,22269,61717,2021-08-19
3175021007,JAKARTA TIMUR,PULO GADUNG,JATI,32757,12825,19932,10752,30684,2021-08-19
3174041002,JAKARTA SELATAN,PASAR MINGGU,JATI PADANG,37502,14510,22992,12967,35959,2021-08-19
3173071004,JAKARTA BARAT,PALMERAH,JATI PULO,28738,10749,17989,8230,26219,2021-08-19
3175061001,JAKARTA TIMUR,CAKUNG,JATINEGARA,84160,33918,50242,21206,71448,2021-08-19
3175021004,JAKARTA TIMUR,PULO GADUNG,JATINEGARA KAUM,24632,8888,15744,6785,22529,2021-08-19
3173021004,JAKARTA BARAT,GROGOL PETAMBURAN,JELAMBAR,30266,11421,18845,10954,29799,2021-08-19
3173021006,JAKARTA BARAT,GROGOL PETAMBURAN,JELAMBAR BARU,38246,14452,23794,13360,37154,2021-08-19
3173041006,JAKARTA BARAT,TAMBORA,JEMBATAN BESI,29314,13022,16292,6629,22921,2021-08-19
3173041008,JAKARTA BARAT,TAMBORA,JEMBATAN LIMA,21021,8613,12408,5741,18149,2021-08-19
3173081005,JAKARTA BARAT,KEMBANGAN,JOGLO,40839,16033,24806,12294,37100,2021-08-19
3171081001,JAKARTA PUSAT,JOHAR BARU,JOHAR BARU,37488,13068,24420,12441,36861,2021-08-19
3173041002,JAKARTA BARAT,TAMBORA,KALI ANYAR,23856,8640,15216,5816,21032,2021-08-19
3172041004,JAKARTA UTARA,CILINCING,KALIBARU,67684,29594,38090,16979,55069,2021-08-19
3174081002,JAKARTA SELATAN,PANCORAN,KALIBATA,41994,18041,23953,11035,34988,2021-08-19
3173061001,JAKARTA BARAT,KALI DERES,KALIDERES,72447,27900,44547,21604,66151,2021-08-19
3175051004,JAKARTA TIMUR,PASAR REBO,KALISARI,43212,16176,27036,14618,41654,2021-08-19
3173061004,JAKARTA BARAT,KALI DERES,KAMAL,53783,21501,32282,11600,43882,2021-08-19
3172011002,JAKARTA UTARA,PENJARINGAN,KAMAL MUARA,12930,3820,9110,5791,14901,2021-08-19
3171071007,JAKARTA PUSAT,TANAH ABANG,KAMPUNG BALI,11358,5049,6309,3180,9489,2021-08-19
3175031001,JAKARTA TIMUR,JATINEGARA,KAMPUNG MELAYU,25717,11080,14637,6437,21074,2021-08-19
3171081002,JAKARTA PUSAT,JOHAR BARU,KAMPUNG RAWA,21237,6293,14944,6908,21852,2021-08-19
3175041002,JAKARTA TIMUR,KRAMAT JATI,KAMPUNG TENGAH,43993,19339,24654,10811,35465,2021-08-19
3173011005,JAKARTA BARAT,CENGKARENG,KAPUK,134466,56000,78466,31747,110213,2021-08-19
3172011003,JAKARTA UTARA,PENJARINGAN,KAPUK MUARA,35781,12162,23619,14652,38271,2021-08-19
3171021002,JAKARTA PUSAT,SAWAH BESAR,KARANG ANYAR,25761,9207,16554,8052,24606,2021-08-19
3174021004,JAKARTA SELATAN,SETIA BUDI,KARET,9623,3799,5824,3252,9076,2021-08-19
3174021003,JAKARTA SELATAN,SETIA BUDI,KARET KUNINGAN,16055,5630,10425,6108,16533,2021-08-19
3174021002,JAKARTA SELATAN,SETIA BUDI,KARET SEMANGGI,2770,981,1789,1230,3019,2021-08-19
3171071003,JAKARTA PUSAT,TANAH ABANG,KARET TENGSIN,19271,7536,11735,5710,17445,2021-08-19
3171021003,JAKARTA PUSAT,SAWAH BESAR,KARTINI,22292,8260,14032,7815,21847,2021-08-19
3175011003,JAKARTA TIMUR,MATRAMAN,KAYU MANIS,25284,10636,14648,6854,21502,2021-08-19
3175021006,JAKARTA TIMUR,PULO GADUNG,KAYU PUTIH,40696,15030,25666,14782,40448,2021-08-19
3173031006,JAKARTA BARAT,TAMAN SARI,KEAGUNGAN,17387,6325,11062,5818,16880,2021-08-19
3174041007,JAKARTA SELATAN,PASAR MINGGU,KEBAGUSAN,44552,17922,26630,13768,40398,2021-08-19
3174051006,JAKARTA SELATAN,KEBAYORAN LAMA,KEBAYORAN LAMA SELATAN,41212,15528,25684,13711,39395,2021-08-19
3174051001,JAKARTA SELATAN,KEBAYORAN LAMA,KEBAYORAN LAMA UTARA,42422,17264,25158,11905,37063,2021-08-19
3174011004,JAKARTA SELATAN,TEBET,KEBON BARU,35165,13711,21454,11246,32700,2021-08-19
3172021005,JAKARTA UTARA,TANJUNG PRIOK,KEBON BAWANG,50952,19770,31182,16501,47683,2021-08-19
3173051001,JAKARTA BARAT,KEBON JERUK,KEBON JERUK,53887,22279,31608,15192,46800,2021-08-19
3171071006,JAKARTA PUSAT,TANAH ABANG,KEBON KACANG,21531,10048,11483,5661,17144,2021-08-19
3171011005,JAKARTA PUSAT,GAMBIR,KEBON KELAPA,10163,3817,6346,3361,9707,2021-08-19
3171031002,JAKARTA PUSAT,KEMAYORAN,KEBON KOSONG,30019,12007,18012,9378,27390,2021-08-19
3175011005,JAKARTA TIMUR,MATRAMAN,KEBON MANGGIS,16490,6252,10238,5674,15912,2021-08-19
3171071005,JAKARTA PUSAT,TANAH ABANG,KEBON MELATI,32206,15830,16376,7433,23809,2021-08-19
3175081003,JAKARTA TIMUR,MAKASAR,KEBON PALA,46614,18020,28594,13442,42036,2021-08-19
3171061005,JAKARTA PUSAT,MENTENG,KEBON SIRIH,12299,5239,7060,3284,10344,2021-08-19
3173011004,JAKARTA BARAT,CENGKARENG,KEDAUNG KALI ANGKE,32612,11455,21157,10471,31628,2021-08-19
3173051007,JAKARTA BARAT,KEBON JERUK,KEDOYA SELATAN,32165,11987,20178,9549,29727,2021-08-19
3173051006,JAKARTA BARAT,KEBON JERUK,KEDOYA UTARA,45740,16020,29720,15123,44843,2021-08-19
3173051004,JAKARTA BARAT,KEBON JERUK,KELAPA DUA,23565,9355,14210,6692,20902,2021-08-19
3175091003,JAKARTA TIMUR,CIRACAS,KELAPA DUA WETAN,46875,16654,30221,15378,45599,2021-08-19
3172061003,JAKARTA UTARA,KELAPA GADING,KELAPA GADING BARAT,35717,12070,23647,15770,39417,2021-08-19
3172061001,JAKARTA UTARA,KELAPA GADING,KELAPA GADING TIMUR,33592,10566,23026,15280,38306,2021-08-19
3173071005,JAKARTA BARAT,PALMERAH,KEMANGGISAN,32139,12512,19627,9963,29590,2021-08-19
3171031001,JAKARTA PUSAT,KEMAYORAN,KEMAYORAN,20708,7784,12924,6860,19784,2021-08-19
3173081006,JAKARTA BARAT,KEMBANGAN,KEMBANGAN SELATAN,27130,10452,16678,9196,25874,2021-08-19
3173081001,JAKARTA BARAT,KEMBANGAN,KEMBANGAN UTARA,54451,20937,33514,16098,49612,2021-08-19
3171041002,JAKARTA PUSAT,SENEN,KENARI,9579,3584,5995,3041,9036,2021-08-19
3173041005,JAKARTA BARAT,TAMBORA,KERENDANG,19973,7479,12494,6181,18675,2021-08-19
3175071003,JAKARTA TIMUR,DUREN SAWIT,KLENDER,69978,30450,39528,17048,56576,2021-08-19
3172031001,JAKARTA UTARA,KOJA,KOJA,28175,11344,16831,9197,26028,2021-08-19
3173071006,JAKARTA BARAT,PALMERAH,KOTA BAMBU SELATAN,21158,8388,12770,5811,18581,2021-08-19
3173071003,JAKARTA BARAT,PALMERAH,KOTA BAMBU UTARA,24995,10413,14582,6793,21375,2021-08-19
3171041004,JAKARTA PUSAT,SENEN,KRAMAT,28835,12538,16297,7226,23523,2021-08-19
3175041001,JAKARTA TIMUR,KRAMAT JATI,KRAMAT JATI,34144,13504,20640,9474,30114,2021-08-19
3174071003,JAKARTA SELATAN,KEBAYORAN BARU,KRAMAT PELA,14413,5292,9121,5090,14211,2021-08-19
3173031002,JAKARTA BARAT,TAMAN SARI,KRUKUT,19244,7219,12025,5440,17465,2021-08-19
3174031005,JAKARTA SELATAN,MAMPANG PRAPATAN,KUNINGAN BARAT,12785,4707,8078,4467,12545,2021-08-19
3174021008,JAKARTA SELATAN,SETIA BUDI,KUNINGAN TIMUR,6008,2264,3744,2252,5996,2021-08-19
3171041005,JAKARTA PUSAT,SENEN,KWITANG,15486,5996,9490,4685,14175,2021-08-19
3172031003,JAKARTA UTARA,KOJA,LAGOA,59065,24637,34428,16930,51358,2021-08-19
3174061002,JAKARTA SELATAN,CILANDAK,LEBAK BULUS,37626,14962,22664,12950,35614,2021-08-19
3174091004,JAKARTA SELATAN,JAGAKARSA,LENTENG AGUNG,53946,21593,32353,15732,48085,2021-08-19
3175101007,JAKARTA TIMUR,CIPAYUNG,LUBANG BUAYA,63547,22971,40576,20603,61179,2021-08-19
3175081001,JAKARTA TIMUR,MAKASAR,MAKASAR,34390,12956,21434,11038,32472,2021-08-19
3175071006,JAKARTA TIMUR,DUREN SAWIT,MALAKA JAYA,30927,12147,18780,11069,29849,2021-08-19
3175071005,JAKARTA TIMUR,DUREN SAWIT,MALAKA SARI,27530,10562,16968,9940,26908,2021-08-19
3174031001,JAKARTA SELATAN,MAMPANG PRAPATAN,MAMPANG PRAPATAN,18159,7046,11113,6277,17390,2021-08-19
3173031005,JAKARTA BARAT,TAMAN SARI,MANGGA BESAR,7707,2549,5158,3132,8290,2021-08-19
3171021005,JAKARTA PUSAT,SAWAH BESAR,MANGGA DUA SELATAN,27442,10329,17113,9234,26347,2021-08-19
3174011007,JAKARTA SELATAN,TEBET,MANGGARAI,28373,10217,18156,8676,26832,2021-08-19
3174011006,JAKARTA SELATAN,TEBET,MANGGARAI SELATAN,23075,8535,14540,7857,22397,2021-08-19
3173031003,JAKARTA BARAT,TAMAN SARI,MAPHAR,16461,6241,10220,5783,16003,2021-08-19
3172041003,JAKARTA UTARA,CILINCING,MARUNDA,28943,10921,18022,7481,25503,2021-08-19
3174071001,JAKARTA SELATAN,KEBAYORAN BARU,MELAWAI,2627,933,1694,1259,2953,2021-08-19
3171061001,JAKARTA PUSAT,MENTENG,MENTENG,25624,10560,15064,7468,22532,2021-08-19
3174021005,JAKARTA SELATAN,SETIA BUDI,MENTENG ATAS,27816,10176,17640,9458,27098,2021-08-19
3174011003,JAKARTA SELATAN,TEBET,MENTENG DALAM,36028,13889,22139,11772,33911,2021-08-19
3173081003,JAKARTA BARAT,KEMBANGAN,MERUYA SELATAN,32130,12422,19708,9580,29288,2021-08-19
3173081002,JAKARTA BARAT,KEMBANGAN,MERUYA UTARA,43752,17015,26737,14278,41015,2021-08-19
3175101004,JAKARTA TIMUR,CIPAYUNG,MUNJUL,23871,8600,15271,7533,22804,2021-08-19
3172051002,JAKARTA UTARA,PADEMANGAN,PADEMANGAN BARAT,74240,29934,44306,21958,66264,2021-08-19
3172051001,JAKARTA UTARA,PADEMANGAN,PADEMANGAN TIMUR,37736,12880,24856,14377,39233,2021-08-19
3175011004,JAKARTA TIMUR,MATRAMAN,PAL MERIAM,19769,8133,11636,5878,17514,2021-08-19
3173071001,JAKARTA BARAT,PALMERAH,PALMERAH,63011,24942,38069,18122,56191,2021-08-19
3174081001,JAKARTA SELATAN,PANCORAN,PANCORAN,19421,7512,11909,6550,18459,2021-08-19
3172021003,JAKARTA UTARA,TANJUNG PRIOK,PAPANGGO,39097,14184,24913,12937,37850,2021-08-19
3171021001,JAKARTA PUSAT,SAWAH BESAR,PASAR BARU,12035,3991,8044,4853,12897,2021-08-19
3174021006,JAKARTA SELATAN,SETIA BUDI,PASAR MANGGIS,26752,10366,16386,8970,25356,2021-08-19
3174041001,JAKARTA SELATAN,PASAR MINGGU,PASAR MINGGU,24821,9525,15296,8848,24144,2021-08-19
3171041003,JAKARTA PUSAT,SENEN,PASEBAN,23533,9435,14098,6992,21090,2021-08-19
3173061005,JAKARTA BARAT,KALI DERES,PEGADUNGAN,75587,27012,48575,23915,72490,2021-08-19
3171061002,JAKARTA PUSAT,MENTENG,PEGANGSAAN,23455,9996,13459,6357,19816,2021-08-19
3172061002,JAKARTA UTARA,KELAPA GADING,PEGANGSAAN DUA,49976,15591,34385,21304,55689,2021-08-19
3172011004,JAKARTA UTARA,PENJARINGAN,PEJAGALAN,74578,28240,46338,26498,72836,2021-08-19
3174041006,JAKARTA SELATAN,PASAR MINGGU,PEJATEN BARAT,37346,14819,22527,12772,35299,2021-08-19
3174041005,JAKARTA SELATAN,PASAR MINGGU,PEJATEN TIMUR,57656,23830,33826,16556,50382,2021-08-19
3175051005,JAKARTA TIMUR,PASAR REBO,PEKAYON,43250,15894,27356,14113,41469,2021-08-19
3173041009,JAKARTA BARAT,TAMBORA,PEKOJAN,23587,8289,15298,7881,23179,2021-08-19
3174031003,JAKARTA SELATAN,MAMPANG PRAPATAN,PELA MAMPANG,43522,16505,27017,15550,42567,2021-08-19
3174081005,JAKARTA SELATAN,PANCORAN,PENGADEGAN,21478,7577,13901,7004,20905,2021-08-19
3175061003,JAKARTA TIMUR,CAKUNG,PENGGILINGAN,99255,43594,55661,23174,78835,2021-08-19
3172011001,JAKARTA UTARA,PENJARINGAN,PENJARINGAN,88308,37440,50868,23401,74269,2021-08-19
3174101001,JAKARTA SELATAN,PESANGGRAHAN,PESANGGRAHAN,27545,9903,17642,9893,27535,2021-08-19
3171071004,JAKARTA PUSAT,TANAH ABANG,PETAMBURAN,33271,16170,17101,7350,24451,2021-08-19
3174071008,JAKARTA SELATAN,KEBAYORAN BARU,PETOGOGAN,11499,4471,7028,4235,11263,2021-08-19
3171011004,JAKARTA PUSAT,GAMBIR,PETOJO SELATAN,14692,5704,8988,5083,14071,2021-08-19
3171011003,JAKARTA PUSAT,GAMBIR,PETOJO UTARA,17458,6691,10767,5174,15941,2021-08-19
3174101004,JAKARTA SELATAN,PESANGGRAHAN,PETUKANGAN SELATAN,37187,14280,22907,11847,34754,2021-08-19
3174101003,JAKARTA SELATAN,PESANGGRAHAN,PETUKANGAN UTARA,53716,21830,31886,16537,48423,2021-08-19
3175081002,JAKARTA TIMUR,MAKASAR,PINANG RANTI,27198,10715,16483,8518,25001,2021-08-19
3173031008,JAKARTA BARAT,TAMAN SARI,PINANGSIA,10729,3727,7002,3960,10962,2021-08-19
3175011001,JAKARTA TIMUR,MATRAMAN,PISANGAN BARU,31776,13272,18504,8282,26786,2021-08-19
3175021002,JAKARTA TIMUR,PULO GADUNG,PISANGAN TIMUR,41011,15249,25762,12327,38089,2021-08-19
3172011005,JAKARTA UTARA,PENJARINGAN,PLUIT,47783,17479,30304,20324,50628,2021-08-19
3175071002,JAKARTA TIMUR,DUREN SAWIT,PONDOK BAMBU,61550,25957,35593,17724,53317,2021-08-19
3175071004,JAKARTA TIMUR,DUREN SAWIT,PONDOK KELAPA,72015,27917,44098,21901,65999,2021-08-19
3175071007,JAKARTA TIMUR,DUREN SAWIT,PONDOK KOPI,35367,15634,19733,9237,28970,2021-08-19
3174061003,JAKARTA SELATAN,CILANDAK,PONDOK LABU,46464,17040,29424,17661,47085,2021-08-19
3174051002,JAKARTA SELATAN,KEBAYORAN LAMA,PONDOK PINANG,56169,21724,34445,19425,53870,2021-08-19
3175101003,JAKARTA TIMUR,CIPAYUNG,PONDOK RANGGON,25574,9501,16073,7889,23962,2021-08-19
3101011003,KAB.ADM.KEP.SERIBU,KEP. SERIBU UTARA,PULAU HARAPAN,2060,359,1701,960,2661,2021-08-19
3101011002,KAB.ADM.KEP.SERIBU,KEP. SERIBU UTARA,PULAU KELAPA,5528,964,4564,2203,6767,2021-08-19
3101011001,KAB.ADM.KEP.SERIBU,KEP. SERIBU UTARA,PULAU PANGGANG,5450,925,4525,1989,6514,2021-08-19
3101021003,KAB.ADM.KEP.SERIBU,KEP. SERIBU SELATAN,PULAU PARI,2765,339,2426,1305,3731,2021-08-19
3101021002,KAB.ADM.KEP.SERIBU,KEP. SERIBU SELATAN,PULAU TIDUNG,4553,687,3866,2459,6325,2021-08-19
3101021001,KAB.ADM.KEP.SERIBU,KEP. SERIBU SELATAN,PULAU UNTUNG JAWA,1941,348,1593,811,2404,2021-08-19
3174071007,JAKARTA SELATAN,KEBAYORAN BARU,PULO,5835,2080,3755,2545,6300,2021-08-19
3175021001,JAKARTA TIMUR,PULO GADUNG,PULO GADUNG,34422,13683,20739,10448,31187,2021-08-19
3175061005,JAKARTA TIMUR,CAKUNG,PULO GEBANG,97301,40036,57265,26167,83432,2021-08-19
3174041004,JAKARTA SELATAN,PASAR MINGGU,RAGUNAN,39616,14619,24997,13986,38983,2021-08-19
3175091005,JAKARTA TIMUR,CIRACAS,RAMBUTAN,36771,16112,20659,9863,30522,2021-08-19
3172031006,JAKARTA UTARA,KOJA,RAWA BADAK SELATAN,42179,18270,23909,11378,35287,2021-08-19
3172031004,JAKARTA UTARA,KOJA,RAWA BADAK UTARA,34408,14514,19894,10447,30341,2021-08-19
3174071005,JAKARTA SELATAN,KEBAYORAN BARU,RAWA BARAT,5625,1988,3637,2302,5939,2021-08-19
3173011003,JAKARTA BARAT,CENGKARENG,RAWA BUAYA,63799,25347,38452,16338,54790,2021-08-19
3175031004,JAKARTA TIMUR,JATINEGARA,RAWA BUNGA,21434,9057,12377,5868,18245,2021-08-19
3174081003,JAKARTA SELATAN,PANCORAN,RAWA JATI,20509,7821,12688,6889,19577,2021-08-19
3175061002,JAKARTA TIMUR,CAKUNG,RAWA TERATE,24637,8873,15764,6307,22071,2021-08-19
3175021005,JAKARTA TIMUR,PULO GADUNG,RAWAMANGUN,37612,14952,22660,11982,34642,2021-08-19
3171051003,JAKARTA PUSAT,CEMPAKA PUTIH,RAWASARI,21967,8689,13278,7356,20634,2021-08-19
3173041010,JAKARTA BARAT,TAMBORA,ROA MALAKA,3484,1094,2390,1478,3868,2021-08-19
3172041006,JAKARTA UTARA,CILINCING,ROROTAN,41668,15479,26189,12702,38891,2021-08-19
3174071004,JAKARTA SELATAN,KEBAYORAN BARU,SELONG,2842,1023,1819,1304,3123,2021-08-19
3173061002,JAKARTA BARAT,KALI DERES,SEMANAN,71354,28461,42893,15930,58823,2021-08-19
3172041007,JAKARTA UTARA,CILINCING,SEMPER BARAT,68587,24738,43849,23256,67105,2021-08-19
3172041005,JAKARTA UTARA,CILINCING,SEMPER TIMUR,36267,13694,22573,11478,34051,2021-08-19
3174071006,JAKARTA SELATAN,KEBAYORAN BARU,SENAYAN,2771,1188,1583,984,2567,2021-08-19
3171041001,JAKARTA PUSAT,SENEN,SENEN,6804,2498,4306,2427,6733,2021-08-19
3171031004,JAKARTA PUSAT,KEMAYORAN,SERDANG,29668,11517,18151,9042,27193,2021-08-19
3174021001,JAKARTA SELATAN,SETIA BUDI,SETIA BUDI,3023,1170,1853,1121,2974,2021-08-19
3175101005,JAKARTA TIMUR,CIPAYUNG,SETU,20572,8208,12364,5447,17811,2021-08-19
3173071002,JAKARTA BARAT,PALMERAH,SLIPI,16591,6163,10428,5683,16111,2021-08-19
3173081004,JAKARTA BARAT,KEMBANGAN,SRENGSENG,45523,18729,26794,13429,40223,2021-08-19
3174091002,JAKARTA SELATAN,JAGAKARSA,SRENGSENG SAWAH,58196,19664,38532,21991,60523,2021-08-19
3173051003,JAKARTA BARAT,KEBON JERUK,SUKABUMI SELATAN,37033,15350,21683,8969,30652,2021-08-19
3173051002,JAKARTA BARAT,KEBON JERUK,SUKABUMI UTARA,38290,16785,21505,9381,30886,2021-08-19
3172041002,JAKARTA UTARA,CILINCING,SUKAPURA,53949,21475,32474,16618,49092,2021-08-19
3171031007,JAKARTA PUSAT,KEMAYORAN,SUMUR BATU,22717,9054,13663,7392,21055,2021-08-19
3172021004,JAKARTA UTARA,TANJUNG PRIOK,SUNGAI BAMBU,29876,11323,18553,9777,28330,2021-08-19
3172021006,JAKARTA UTARA,TANJUNG PRIOK,SUNTER AGUNG,71805,24236,47569,28348,75917,2021-08-19
3172021002,JAKARTA UTARA,TANJUNG PRIOK,SUNTER JAYA,63031,22196,40835,23374,64209,2021-08-19
3175091004,JAKARTA TIMUR,CIRACAS,SUSUKAN,38257,13754,24503,12060,36563,2021-08-19
3173031001,JAKARTA BARAT,TAMAN SARI,TAMAN SARI,14348,5354,8994,5194,14188,2021-08-19
3173041001,JAKARTA BARAT,TAMBORA,TAMBORA,10204,3971,6233,2994,9227,2021-08-19
3173041004,JAKARTA BARAT,TAMBORA,TANAH SEREAL,26387,8738,17649,8381,26030,2021-08-19
3171081004,JAKARTA PUSAT,JOHAR BARU,TANAH TINGGI,37693,12538,25155,11872,37027,2021-08-19
3173031004,JAKARTA BARAT,TAMAN SARI,TANGKI,13324,4980,8344,4677,13021,2021-08-19
3174091005,JAKARTA SELATAN,JAGAKARSA,TANJUNG BARAT,39770,14932,24838,12740,37578,2021-08-19
3173021005,JAKARTA BARAT,GROGOL PETAMBURAN,TANJUNG DUREN SELATAN,25337,9446,15891,8985,24876,2021-08-19
3173021002,JAKARTA BARAT,GROGOL PETAMBURAN,TANJUNG DUREN UTARA,17010,6035,10975,6344,17319,2021-08-19
3172021001,JAKARTA UTARA,TANJUNG PRIOK,TANJUNG PRIOK,34588,12458,22130,10403,32533,2021-08-19
3174011002,JAKARTA SELATAN,TEBET,TEBET BARAT,21194,7468,13726,8225,21951,2021-08-19
3174011001,JAKARTA SELATAN,TEBET,TEBET TIMUR,18199,6429,11770,7093,18863,2021-08-19
3173061003,JAKARTA BARAT,KALI DERES,TEGAL ALUR,83647,31868,51779,20765,72544,2021-08-19
3174031004,JAKARTA SELATAN,MAMPANG PRAPATAN,TEGAL PARANG,32401,13347,19054,9590,28644,2021-08-19
3173021003,JAKARTA BARAT,GROGOL PETAMBURAN,TOMANG,29605,11013,18592,10947,29539,2021-08-19
3172031005,JAKARTA UTARA,KOJA,TUGU SELATAN,39122,16403,22719,10882,33601,2021-08-19
3172031002,JAKARTA UTARA,KOJA,TUGU UTARA,67670,28760,38910,19542,58452,2021-08-19
3175061006,JAKARTA TIMUR,CAKUNG,UJUNG MENTENG,29934,10802,19132,9514,28646,2021-08-19
3174101005,JAKARTA SELATAN,PESANGGRAHAN,ULUJAMI,40544,16879,23665,11190,34855,2021-08-19
3175011006,JAKARTA TIMUR,MATRAMAN,UTAN KAYU SELATAN,33511,12741,20770,10734,31504,2021-08-19
3175011002,JAKARTA TIMUR,MATRAMAN,UTAN KAYU UTARA,28169,11560,16609,8357,24966,2021-08-19
3171031008,JAKARTA PUSAT,KEMAYORAN,UTAN PANJANG,29208,11791,17417,7896,25313,2021-08-19
3172021007,JAKARTA UTARA,TANJUNG PRIOK,WARAKAS,44401,16789,27612,14125,41737,2021-08-19
3173021007,JAKARTA BARAT,GROGOL PETAMBURAN,WIJAYA KUSUMA,38934,15222,23712,12027,35739,2021-08-19
3172051003,JAKARTA UTARA,PADEMANGAN,ANCOL,23947,9592,14355,7314,21669,2021-08-20
3173041007,JAKARTA BARAT,TAMBORA,ANGKE,29381,10793,18588,8635,27223,2021-08-20
3175041005,JAKARTA TIMUR,KRAMAT JATI,BALE KAMBANG,29074,13307,15767,6097,21864,2021-08-20
3175031003,JAKARTA TIMUR,JATINEGARA,BALI MESTER,9752,3927,5825,3058,8883,2021-08-20
3175101006,JAKARTA TIMUR,CIPAYUNG,BAMBU APUS,26285,9955,16330,7977,24307,2021-08-20
3174031002,JAKARTA SELATAN,MAMPANG PRAPATAN,BANGKA,21566,8718,12848,7102,19950,2021-08-20
3175051002,JAKARTA TIMUR,PASAR REBO,BARU,23886,8183,15703,9806,25509,2021-08-20
3175041004,JAKARTA TIMUR,KRAMAT JATI,BATU AMPAR,47898,21143,26755,11838,38593,2021-08-20
3171071002,JAKARTA PUSAT,TANAH ABANG,BENDUNGAN HILIR,21494,8382,13112,7414,20526,2021-08-20
3175031002,JAKARTA TIMUR,JATINEGARA,BIDARA CINA,36689,16542,20147,9393,29540,2021-08-20
3174101002,JAKARTA SELATAN,PESANGGRAHAN,BINTARO,53098,20628,32470,18385,50855,2021-08-20
3174011005,JAKARTA SELATAN,TEBET,BUKIT DURI,34183,14142,20041,10426,30467,2021-08-20
3171041006,JAKARTA PUSAT,SENEN,BUNGUR,18144,6920,11224,5890,17114,2021-08-20
3175061007,JAKARTA TIMUR,CAKUNG,CAKUNG BARAT,57724,20882,36842,16981,53823,2021-08-20
3175061004,JAKARTA TIMUR,CAKUNG,CAKUNG TIMUR,58287,21433,36854,18756,55610,2021-08-20
3175041007,JAKARTA TIMUR,KRAMAT JATI,CAWANG,32762,13901,18861,9311,28172,2021-08-20
3175101008,JAKARTA TIMUR,CIPAYUNG,CEGER,18932,7081,11851,5568,17419,2021-08-20
3171031006,JAKARTA PUSAT,KEMAYORAN,CEMPAKA BARU,32581,13583,18998,9530,28528,2021-08-20
3171051002,JAKARTA PUSAT,CEMPAKA PUTIH,CEMPAKA PUTIH BARAT,35885,14210,21675,11972,33647,2021-08-20
3171051001,JAKARTA PUSAT,CEMPAKA PUTIH,CEMPAKA PUTIH TIMUR,24292,9385,14907,8588,23495,2021-08-20
3173011001,JAKARTA BARAT,CENGKARENG,CENGKARENG BARAT,66284,24828,41456,22430,63886,2021-08-20
3173011006,JAKARTA BARAT,CENGKARENG,CENGKARENG TIMUR,81027,30059,50968,23163,74131,2021-08-20
3175091002,JAKARTA TIMUR,CIRACAS,CIBUBUR,66364,23929,42435,23818,66253,2021-08-20
3171011002,JAKARTA PUSAT,GAMBIR,CIDENG,15390,5412,9978,5861,15839,2021-08-20
3174091003,JAKARTA SELATAN,JAGAKARSA,CIGANJUR,38497,14449,24048,13004,37052,2021-08-20
3175051003,JAKARTA TIMUR,PASAR REBO,CIJANTUNG,41419,15020,26399,14302,40701,2021-08-20
3171061003,JAKARTA PUSAT,MENTENG,CIKINI,8274,3478,4796,2571,7367,2021-08-20
3174081006,JAKARTA SELATAN,PANCORAN,CIKOKO,10547,3746,6801,3601,10402,2021-08-20
3174061001,JAKARTA SELATAN,CILANDAK,CILANDAK BARAT,51752,19395,32357,18959,51316,2021-08-20
3174041003,JAKARTA SELATAN,PASAR MINGGU,CILANDAK TIMUR,25145,9246,15899,9730,25629,2021-08-20
3175101002,JAKARTA TIMUR,CIPAYUNG,CILANGKAP,27635,10141,17494,8840,26334,2021-08-20
3175041006,JAKARTA TIMUR,KRAMAT JATI,CILILITAN,40181,17341,22840,11099,33939,2021-08-20
3172041001,JAKARTA UTARA,CILINCING,CILINCING,43609,17724,25885,12789,38674,2021-08-20
3175101001,JAKARTA TIMUR,CIPAYUNG,CIPAYUNG,26104,9087,17017,9232,26249,2021-08-20
3174091006,JAKARTA SELATAN,JAGAKARSA,CIPEDAK,38303,13364,24939,14515,39454,2021-08-20
3174061005,JAKARTA SELATAN,CILANDAK,CIPETE SELATAN,26704,10499,16205,10084,26289,2021-08-20
3174071010,JAKARTA SELATAN,KEBAYORAN BARU,CIPETE UTARA,34102,13038,21064,11863,32927,2021-08-20
3175021003,JAKARTA TIMUR,PULO GADUNG,CIPINANG,39306,15658,23648,12598,36246,2021-08-20
3175031007,JAKARTA TIMUR,JATINEGARA,CIPINANG BESAR SELATAN,35212,15702,19510,8897,28407,2021-08-20
3175031008,JAKARTA TIMUR,JATINEGARA,CIPINANG BESAR UTARA,45319,19446,25873,11042,36915,2021-08-20
3175031005,JAKARTA TIMUR,JATINEGARA,CIPINANG CEMPEDAK,32824,14094,18730,10042,28772,2021-08-20
3175081005,JAKARTA TIMUR,MAKASAR,CIPINANG MELAYU,42308,17030,25278,13822,39100,2021-08-20
3175031006,JAKARTA TIMUR,JATINEGARA,CIPINANG MUARA,55243,23503,31740,15122,46862,2021-08-20
3174051003,JAKARTA SELATAN,KEBAYORAN LAMA,CIPULIR,39937,16583,23354,11463,34817,2021-08-20
3175091001,JAKARTA TIMUR,CIRACAS,CIRACAS,64594,23285,41309,21157,62466,2021-08-20
3175041003,JAKARTA TIMUR,KRAMAT JATI,DUKUH,24609,9210,15399,7241,22640,2021-08-20
3175071001,JAKARTA TIMUR,DUREN SAWIT,DUREN SAWIT,61160,25812,35348,18656,54004,2021-08-20
3174081004,JAKARTA SELATAN,PANCORAN,DUREN TIGA,28319,10961,17358,8572,25930,2021-08-20
3173051005,JAKARTA BARAT,KEBON JERUK,DURI KEPA,60138,21896,38242,21082,59324,2021-08-20
3173011002,JAKARTA BARAT,CENGKARENG,DURI KOSAMBI,77923,32453,45470,21625,67095,2021-08-20
3171011006,JAKARTA PUSAT,GAMBIR,DURI PULO,19610,7390,12220,6061,18281,2021-08-20
3173041011,JAKARTA BARAT,TAMBORA,DURI SELATAN,14259,4898,9361,4937,14298,2021-08-20
3173041003,JAKARTA BARAT,TAMBORA,DURI UTARA,19844,7111,12733,6209,18942,2021-08-20
3171081003,JAKARTA PUSAT,JOHAR BARU,GALUR,18243,6016,12227,5809,18036,2021-08-20
3171011001,JAKARTA PUSAT,GAMBIR,GAMBIR,2191,776,1415,836,2251,2021-08-20
3174061004,JAKARTA SELATAN,CILANDAK,GANDARIA SELATAN,22119,8552,13567,7452,21019,2021-08-20
3174071009,JAKARTA SELATAN,KEBAYORAN BARU,GANDARIA UTARA,39922,15561,24361,13463,37824,2021-08-20
3175051001,JAKARTA TIMUR,PASAR REBO,GEDONG,35755,13345,22410,11851,34261,2021-08-20
3171071001,JAKARTA PUSAT,TANAH ABANG,GELORA,3127,1276,1851,996,2847,2021-08-20
3173031007,JAKARTA BARAT,TAMAN SARI,GLODOK,7837,2533,5304,3397,8701,2021-08-20
3171061004,JAKARTA PUSAT,MENTENG,GONDANGDIA,4100,1588,2512,1830,4342,2021-08-20
3173021001,JAKARTA BARAT,GROGOL PETAMBURAN,GROGOL,16876,6443,10433,5765,16198,2021-08-20
3174051005,JAKARTA SELATAN,KEBAYORAN LAMA,GROGOL SELATAN,44251,17671,26580,13021,39601,2021-08-20
3174051004,JAKARTA SELATAN,KEBAYORAN LAMA,GROGOL UTARA,42494,16696,25798,12973,38771,2021-08-20
3174021007,JAKARTA SELATAN,SETIA BUDI,GUNTUR,3985,1458,2527,1714,4241,2021-08-20
3174071002,JAKARTA SELATAN,KEBAYORAN BARU,GUNUNG,9436,3460,5976,3878,9854,2021-08-20
3171031005,JAKARTA PUSAT,KEMAYORAN,GUNUNG SAHARI SELATAN,19199,7488,11711,6626,18337,2021-08-20
3171021004,JAKARTA PUSAT,SAWAH BESAR,GUNUNG SAHARI UTARA,16650,5553,11097,6648,17745,2021-08-20
3175081004,JAKARTA TIMUR,MAKASAR,HALIM PERDANA KUSUMAH,28363,8396,19967,14610,34577,2021-08-20
3171031003,JAKARTA PUSAT,KEMAYORAN,HARAPAN MULIA,22557,8913,13644,6836,20480,2021-08-20
3174091001,JAKARTA SELATAN,JAGAKARSA,JAGAKARSA,62389,22799,39590,23066,62656,2021-08-20
3175021007,JAKARTA TIMUR,PULO GADUNG,JATI,32757,12763,19994,10956,30950,2021-08-20
3174041002,JAKARTA SELATAN,PASAR MINGGU,JATI PADANG,37502,14421,23081,13293,36374,2021-08-20
3173071004,JAKARTA BARAT,PALMERAH,JATI PULO,28738,10703,18035,8523,26558,2021-08-20
3175061001,JAKARTA TIMUR,CAKUNG,JATINEGARA,84160,33704,50456,22291,72747,2021-08-20
3175021004,JAKARTA TIMUR,PULO GADUNG,JATINEGARA KAUM,24632,8849,15783,7001,22784,2021-08-20
3173021004,JAKARTA BARAT,GROGOL PETAMBURAN,JELAMBAR,30266,11359,18907,11207,30114,2021-08-20
3173021006,JAKARTA BARAT,GROGOL PETAMBURAN,JELAMBAR BARU,38246,14368,23878,13708,37586,2021-08-20
3173041006,JAKARTA BARAT,TAMBORA,JEMBATAN BESI,29314,12966,16348,6893,23241,2021-08-20
3173041008,JAKARTA BARAT,TAMBORA,JEMBATAN LIMA,21021,8563,12458,5903,18361,2021-08-20
3173081005,JAKARTA BARAT,KEMBANGAN,JOGLO,40839,15962,24877,12638,37515,2021-08-20
3171081001,JAKARTA PUSAT,JOHAR BARU,JOHAR BARU,37488,12935,24553,12899,37452,2021-08-20
3173041002,JAKARTA BARAT,TAMBORA,KALI ANYAR,23856,8616,15240,6032,21272,2021-08-20
3172041004,JAKARTA UTARA,CILINCING,KALIBARU,67684,29411,38273,17459,55732,2021-08-20
3174081002,JAKARTA SELATAN,PANCORAN,KALIBATA,41994,17946,24048,11570,35618,2021-08-20
3173061001,JAKARTA BARAT,KALI DERES,KALIDERES,72447,27803,44644,22334,66978,2021-08-20
3175051004,JAKARTA TIMUR,PASAR REBO,KALISARI,43212,15945,27267,14942,42209,2021-08-20
3173061004,JAKARTA BARAT,KALI DERES,KAMAL,53783,21320,32463,11988,44451,2021-08-20
3172011002,JAKARTA UTARA,PENJARINGAN,KAMAL MUARA,12930,3808,9122,5903,15025,2021-08-20
3171071007,JAKARTA PUSAT,TANAH ABANG,KAMPUNG BALI,11358,5015,6343,3254,9597,2021-08-20
3175031001,JAKARTA TIMUR,JATINEGARA,KAMPUNG MELAYU,25717,11037,14680,6729,21409,2021-08-20
3171081002,JAKARTA PUSAT,JOHAR BARU,KAMPUNG RAWA,21237,6212,15025,7215,22240,2021-08-20
3175041002,JAKARTA TIMUR,KRAMAT JATI,KAMPUNG TENGAH,43993,19233,24760,11221,35981,2021-08-20
3173011005,JAKARTA BARAT,CENGKARENG,KAPUK,134466,55675,78791,33482,112273,2021-08-20
3172011003,JAKARTA UTARA,PENJARINGAN,KAPUK MUARA,35781,12068,23713,15005,38718,2021-08-20
3171021002,JAKARTA PUSAT,SAWAH BESAR,KARANG ANYAR,25761,9155,16606,8309,24915,2021-08-20
3174021004,JAKARTA SELATAN,SETIA BUDI,KARET,9623,3775,5848,3304,9152,2021-08-20
3174021003,JAKARTA SELATAN,SETIA BUDI,KARET KUNINGAN,16055,5600,10455,6223,16678,2021-08-20
3174021002,JAKARTA SELATAN,SETIA BUDI,KARET SEMANGGI,2770,978,1792,1247,3039,2021-08-20
3171071003,JAKARTA PUSAT,TANAH ABANG,KARET TENGSIN,19271,7485,11786,5855,17641,2021-08-20
3171021003,JAKARTA PUSAT,SAWAH BESAR,KARTINI,22292,8209,14083,7996,22079,2021-08-20
3175011003,JAKARTA TIMUR,MATRAMAN,KAYU MANIS,25284,10581,14703,7001,21704,2021-08-20
3175021006,JAKARTA TIMUR,PULO GADUNG,KAYU PUTIH,40696,14963,25733,15009,40742,2021-08-20
3173031006,JAKARTA BARAT,TAMAN SARI,KEAGUNGAN,17387,6299,11088,6040,17128,2021-08-20
3174041007,JAKARTA SELATAN,PASAR MINGGU,KEBAGUSAN,44552,17715,26837,14082,40919,2021-08-20
3174051006,JAKARTA SELATAN,KEBAYORAN LAMA,KEBAYORAN LAMA SELATAN,41212,15409,25803,14160,39963,2021-08-20
3174051001,JAKARTA SELATAN,KEBAYORAN LAMA,KEBAYORAN LAMA UTARA,42422,17177,25245,12296,37541,2021-08-20
3174011004,JAKARTA SELATAN,TEBET,KEBON BARU,35165,13590,21575,11519,33094,2021-08-20
3172021005,JAKARTA UTARA,TANJUNG PRIOK,KEBON BAWANG,50952,19498,31454,16944,48398,2021-08-20
3173051001,JAKARTA BARAT,KEBON JERUK,KEBON JERUK,53887,22135,31752,15537,47289,2021-08-20
3171071006,JAKARTA PUSAT,TANAH ABANG,KEBON KACANG,21531,9964,11567,5758,17325,2021-08-20
3171011005,JAKARTA PUSAT,GAMBIR,KEBON KELAPA,10163,3793,6370,3396,9766,2021-08-20
3171031002,JAKARTA PUSAT,KEMAYORAN,KEBON KOSONG,30019,11936,18083,9544,27627,2021-08-20
3175011005,JAKARTA TIMUR,MATRAMAN,KEBON MANGGIS,16490,6228,10262,5759,16021,2021-08-20
3171071005,JAKARTA PUSAT,TANAH ABANG,KEBON MELATI,32206,15755,16451,7690,24141,2021-08-20
3175081003,JAKARTA TIMUR,MAKASAR,KEBON PALA,46614,17922,28692,13876,42568,2021-08-20
3171061005,JAKARTA PUSAT,MENTENG,KEBON SIRIH,12299,5209,7090,3463,10553,2021-08-20
3173011004,JAKARTA BARAT,CENGKARENG,KEDAUNG KALI ANGKE,32612,11397,21215,11074,32289,2021-08-20
3173051007,JAKARTA BARAT,KEBON JERUK,KEDOYA SELATAN,32165,11941,20224,9917,30141,2021-08-20
3173051006,JAKARTA BARAT,KEBON JERUK,KEDOYA UTARA,45740,15932,29808,15535,45343,2021-08-20
3173051004,JAKARTA BARAT,KEBON JERUK,KELAPA DUA,23565,9306,14259,6833,21092,2021-08-20
3175091003,JAKARTA TIMUR,CIRACAS,KELAPA DUA WETAN,46875,16529,30346,15701,46047,2021-08-20
3172061003,JAKARTA UTARA,KELAPA GADING,KELAPA GADING BARAT,35717,11967,23750,16073,39823,2021-08-20
3172061001,JAKARTA UTARA,KELAPA GADING,KELAPA GADING TIMUR,33592,10517,23075,15407,38482,2021-08-20
3173071005,JAKARTA BARAT,PALMERAH,KEMANGGISAN,32139,12419,19720,10189,29909,2021-08-20
3171031001,JAKARTA PUSAT,KEMAYORAN,KEMAYORAN,20708,7719,12989,6999,19988,2021-08-20
3173081006,JAKARTA BARAT,KEMBANGAN,KEMBANGAN SELATAN,27130,10346,16784,9513,26297,2021-08-20
3173081001,JAKARTA BARAT,KEMBANGAN,KEMBANGAN UTARA,54451,20799,33652,16694,50346,2021-08-20
3171041002,JAKARTA PUSAT,SENEN,KENARI,9579,3561,6018,3097,9115,2021-08-20
3173041005,JAKARTA BARAT,TAMBORA,KERENDANG,19973,7446,12527,6324,18851,2021-08-20
3175071003,JAKARTA TIMUR,DUREN SAWIT,KLENDER,69978,30237,39741,17546,57287,2021-08-20
3172031001,JAKARTA UTARA,KOJA,KOJA,28175,11270,16905,9340,26245,2021-08-20
3173071006,JAKARTA BARAT,PALMERAH,KOTA BAMBU SELATAN,21158,8345,12813,5996,18809,2021-08-20
3173071003,JAKARTA BARAT,PALMERAH,KOTA BAMBU UTARA,24995,10244,14751,7063,21814,2021-08-20
3171041004,JAKARTA PUSAT,SENEN,KRAMAT,28835,12453,16382,7384,23766,2021-08-20
3175041001,JAKARTA TIMUR,KRAMAT JATI,KRAMAT JATI,34144,13395,20749,9686,30435,2021-08-20
3174071003,JAKARTA SELATAN,KEBAYORAN BARU,KRAMAT PELA,14413,5247,9166,5222,14388,2021-08-20
3173031002,JAKARTA BARAT,TAMAN SARI,KRUKUT,19244,7192,12052,5604,17656,2021-08-20
3174031005,JAKARTA SELATAN,MAMPANG PRAPATAN,KUNINGAN BARAT,12785,4682,8103,4544,12647,2021-08-20
3174021008,JAKARTA SELATAN,SETIA BUDI,KUNINGAN TIMUR,6008,2248,3760,2300,6060,2021-08-20
3171041005,JAKARTA PUSAT,SENEN,KWITANG,15486,5949,9537,4852,14389,2021-08-20
3172031003,JAKARTA UTARA,KOJA,LAGOA,59065,24410,34655,17397,52052,2021-08-20
3174061002,JAKARTA SELATAN,CILANDAK,LEBAK BULUS,37626,14838,22788,13341,36129,2021-08-20
3174091004,JAKARTA SELATAN,JAGAKARSA,LENTENG AGUNG,53946,21491,32455,16142,48597,2021-08-20
3175101007,JAKARTA TIMUR,CIPAYUNG,LUBANG BUAYA,63547,22790,40757,21477,62234,2021-08-20
3175081001,JAKARTA TIMUR,MAKASAR,MAKASAR,34390,12896,21494,11269,32763,2021-08-20
3175071006,JAKARTA TIMUR,DUREN SAWIT,MALAKA JAYA,30927,12075,18852,11359,30211,2021-08-20
3175071005,JAKARTA TIMUR,DUREN SAWIT,MALAKA SARI,27530,10463,17067,10196,27263,2021-08-20
3174031001,JAKARTA SELATAN,MAMPANG PRAPATAN,MAMPANG PRAPATAN,18159,7027,11132,6480,17612,2021-08-20
3173031005,JAKARTA BARAT,TAMAN SARI,MANGGA BESAR,7707,2539,5168,3165,8333,2021-08-20
3171021005,JAKARTA PUSAT,SAWAH BESAR,MANGGA DUA SELATAN,27442,10238,17204,9379,26583,2021-08-20
3174011007,JAKARTA SELATAN,TEBET,MANGGARAI,28373,10138,18235,8984,27219,2021-08-20
3174011006,JAKARTA SELATAN,TEBET,MANGGARAI SELATAN,23075,8477,14598,8125,22723,2021-08-20
3173031003,JAKARTA BARAT,TAMAN SARI,MAPHAR,16461,6197,10264,5927,16191,2021-08-20
3172041003,JAKARTA UTARA,CILINCING,MARUNDA,28943,10807,18136,7668,25804,2021-08-20
3174071001,JAKARTA SELATAN,KEBAYORAN BARU,MELAWAI,2627,930,1697,1267,2964,2021-08-20
3171061001,JAKARTA PUSAT,MENTENG,MENTENG,25624,10489,15135,7679,22814,2021-08-20
3174021005,JAKARTA SELATAN,SETIA BUDI,MENTENG ATAS,27816,10069,17747,9647,27394,2021-08-20
3174011003,JAKARTA SELATAN,TEBET,MENTENG DALAM,36028,13813,22215,12051,34266,2021-08-20
3173081003,JAKARTA BARAT,KEMBANGAN,MERUYA SELATAN,32130,12378,19752,9768,29520,2021-08-20
3173081002,JAKARTA BARAT,KEMBANGAN,MERUYA UTARA,43752,16952,26800,14664,41464,2021-08-20
3175101004,JAKARTA TIMUR,CIPAYUNG,MUNJUL,23871,8556,15315,7791,23106,2021-08-20
3172051002,JAKARTA UTARA,PADEMANGAN,PADEMANGAN BARAT,74240,29780,44460,22507,66967,2021-08-20
3172051001,JAKARTA UTARA,PADEMANGAN,PADEMANGAN TIMUR,37736,12754,24982,14629,39611,2021-08-20
3175011004,JAKARTA TIMUR,MATRAMAN,PAL MERIAM,19769,8096,11673,5999,17672,2021-08-20
3173071001,JAKARTA BARAT,PALMERAH,PALMERAH,63011,24817,38194,18678,56872,2021-08-20
3174081001,JAKARTA SELATAN,PANCORAN,PANCORAN,19421,7487,11934,6671,18605,2021-08-20
3172021003,JAKARTA UTARA,TANJUNG PRIOK,PAPANGGO,39097,14043,25054,13204,38258,2021-08-20
3171021001,JAKARTA PUSAT,SAWAH BESAR,PASAR BARU,12035,3968,8067,4937,13004,2021-08-20
3174021006,JAKARTA SELATAN,SETIA BUDI,PASAR MANGGIS,26752,10287,16465,9172,25637,2021-08-20
3174041001,JAKARTA SELATAN,PASAR MINGGU,PASAR MINGGU,24821,9461,15360,8997,24357,2021-08-20
3171041003,JAKARTA PUSAT,SENEN,PASEBAN,23533,9360,14173,7205,21378,2021-08-20
3173061005,JAKARTA BARAT,KALI DERES,PEGADUNGAN,75587,26917,48670,24477,73147,2021-08-20
3171061002,JAKARTA PUSAT,MENTENG,PEGANGSAAN,23455,9930,13525,6484,20009,2021-08-20
3172061002,JAKARTA UTARA,KELAPA GADING,PEGANGSAAN DUA,49976,15512,34464,21694,56158,2021-08-20
3172011004,JAKARTA UTARA,PENJARINGAN,PEJAGALAN,74578,28079,46499,27002,73501,2021-08-20
3174041006,JAKARTA SELATAN,PASAR MINGGU,PEJATEN BARAT,37346,14705,22641,13040,35681,2021-08-20
3174041005,JAKARTA SELATAN,PASAR MINGGU,PEJATEN TIMUR,57656,23495,34161,16916,51077,2021-08-20
3175051005,JAKARTA TIMUR,PASAR REBO,PEKAYON,43250,15752,27498,14527,42025,2021-08-20
3173041009,JAKARTA BARAT,TAMBORA,PEKOJAN,23587,8261,15326,8212,23538,2021-08-20
3174031003,JAKARTA SELATAN,MAMPANG PRAPATAN,PELA MAMPANG,43522,16424,27098,15865,42963,2021-08-20
3174081005,JAKARTA SELATAN,PANCORAN,PENGADEGAN,21478,7531,13947,7158,21105,2021-08-20
3175061003,JAKARTA TIMUR,CAKUNG,PENGGILINGAN,99255,43142,56113,24398,80511,2021-08-20
3172011001,JAKARTA UTARA,PENJARINGAN,PENJARINGAN,88308,37226,51082,24172,75254,2021-08-20
3174101001,JAKARTA SELATAN,PESANGGRAHAN,PESANGGRAHAN,27545,9796,17749,10128,27877,2021-08-20
3171071004,JAKARTA PUSAT,TANAH ABANG,PETAMBURAN,33271,16070,17201,7592,24793,2021-08-20
3174071008,JAKARTA SELATAN,KEBAYORAN BARU,PETOGOGAN,11499,4450,7049,4299,11348,2021-08-20
3171011004,JAKARTA PUSAT,GAMBIR,PETOJO SELATAN,14692,5674,9018,5159,14177,2021-08-20
3171011003,JAKARTA PUSAT,GAMBIR,PETOJO UTARA,17458,6633,10825,5286,16111,2021-08-20
3174101004,JAKARTA SELATAN,PESANGGRAHAN,PETUKANGAN SELATAN,37187,14181,23006,12254,35260,2021-08-20
3174101003,JAKARTA SELATAN,PESANGGRAHAN,PETUKANGAN UTARA,53716,21698,32018,17086,49104,2021-08-20
3175081002,JAKARTA TIMUR,MAKASAR,PINANG RANTI,27198,10635,16563,8898,25461,2021-08-20
3173031008,JAKARTA BARAT,TAMAN SARI,PINANGSIA,10729,3694,7035,4030,11065,2021-08-20
3175011001,JAKARTA TIMUR,MATRAMAN,PISANGAN BARU,31776,13170,18606,8465,27071,2021-08-20
3175021002,JAKARTA TIMUR,PULO GADUNG,PISANGAN TIMUR,41011,15177,25834,12590,38424,2021-08-20
3172011005,JAKARTA UTARA,PENJARINGAN,PLUIT,47783,17424,30359,20470,50829,2021-08-20
3175071002,JAKARTA TIMUR,DUREN SAWIT,PONDOK BAMBU,61550,25749,35801,18174,53975,2021-08-20
3175071004,JAKARTA TIMUR,DUREN SAWIT,PONDOK KELAPA,72015,27780,44235,22339,66574,2021-08-20
3175071007,JAKARTA TIMUR,DUREN SAWIT,PONDOK KOPI,35367,15559,19808,9536,29344,2021-08-20
3174061003,JAKARTA SELATAN,CILANDAK,PONDOK LABU,46464,16904,29560,18201,47761,2021-08-20
3174051002,JAKARTA SELATAN,KEBAYORAN LAMA,PONDOK PINANG,56169,21612,34557,19842,54399,2021-08-20
3175101003,JAKARTA TIMUR,CIPAYUNG,PONDOK RANGGON,25574,9430,16144,8090,24234,2021-08-20
3101011003,KAB.ADM.KEP.SERIBU,KEP. SERIBU UTARA,PULAU HARAPAN,2060,358,1702,968,2670,2021-08-20
3101011002,KAB.ADM.KEP.SERIBU,KEP. SERIBU UTARA,PULAU KELAPA,5528,961,4567,2308,6875,2021-08-20
3101011001,KAB.ADM.KEP.SERIBU,KEP. SERIBU UTARA,PULAU PANGGANG,5450,922,4528,2013,6541,2021-08-20
3101021003,KAB.ADM.KEP.SERIBU,KEP. SERIBU SELATAN,PULAU PARI,2765,335,2430,1341,3771,2021-08-20
3101021002,KAB.ADM.KEP.SERIBU,KEP. SERIBU SELATAN,PULAU TIDUNG,4553,682,3871,2486,6357,2021-08-20
3101021001,KAB.ADM.KEP.SERIBU,KEP. SERIBU SELATAN,PULAU UNTUNG JAWA,1941,346,1595,823,2418,2021-08-20
3174071007,JAKARTA SELATAN,KEBAYORAN BARU,PULO,5835,2067,3768,2584,6352,2021-08-20
3175021001,JAKARTA TIMUR,PULO GADUNG,PULO GADUNG,34422,13604,20818,10655,31473,2021-08-20
3175061005,JAKARTA TIMUR,CAKUNG,PULO GEBANG,97301,39555,57746,27445,85191,2021-08-20
3174041004,JAKARTA SELATAN,PASAR MINGGU,RAGUNAN,39616,14509,25107,14294,39401,2021-08-20
3175091005,JAKARTA TIMUR,CIRACAS,RAMBUTAN,36771,15995,20776,10241,31017,2021-08-20
3172031006,JAKARTA UTARA,KOJA,RAWA BADAK SELATAN,42179,18092,24087,11821,35908,2021-08-20
3172031004,JAKARTA UTARA,KOJA,RAWA BADAK UTARA,34408,14375,20033,10630,30663,2021-08-20
3174071005,JAKARTA SELATAN,KEBAYORAN BARU,RAWA BARAT,5625,1975,3650,2337,5987,2021-08-20
3173011003,JAKARTA BARAT,CENGKARENG,RAWA BUAYA,63799,25190,38609,16843,55452,2021-08-20
3175031004,JAKARTA TIMUR,JATINEGARA,RAWA BUNGA,21434,9000,12434,6114,18548,2021-08-20
3174081003,JAKARTA SELATAN,PANCORAN,RAWA JATI,20509,7769,12740,7018,19758,2021-08-20
3175061002,JAKARTA TIMUR,CAKUNG,RAWA TERATE,24637,8833,15804,6809,22613,2021-08-20
3175021005,JAKARTA TIMUR,PULO GADUNG,RAWAMANGUN,37612,14874,22738,12203,34941,2021-08-20
3171051003,JAKARTA PUSAT,CEMPAKA PUTIH,RAWASARI,21967,8629,13338,7500,20838,2021-08-20
3173041010,JAKARTA BARAT,TAMBORA,ROA MALAKA,3484,1087,2397,1499,3896,2021-08-20
3172041006,JAKARTA UTARA,CILINCING,ROROTAN,41668,15315,26353,12982,39335,2021-08-20
3174071004,JAKARTA SELATAN,KEBAYORAN BARU,SELONG,2842,1019,1823,1316,3139,2021-08-20
3173061002,JAKARTA BARAT,KALI DERES,SEMANAN,71354,28293,43061,17027,60088,2021-08-20
3172041007,JAKARTA UTARA,CILINCING,SEMPER BARAT,68587,24481,44106,23786,67892,2021-08-20
3172041005,JAKARTA UTARA,CILINCING,SEMPER TIMUR,36267,13542,22725,11685,34410,2021-08-20
3174071006,JAKARTA SELATAN,KEBAYORAN BARU,SENAYAN,2771,1184,1587,1004,2591,2021-08-20
3171041001,JAKARTA PUSAT,SENEN,SENEN,6804,2485,4319,2475,6794,2021-08-20
3171031004,JAKARTA PUSAT,KEMAYORAN,SERDANG,29668,11461,18207,9298,27505,2021-08-20
3174021001,JAKARTA SELATAN,SETIA BUDI,SETIA BUDI,3023,1165,1858,1148,3006,2021-08-20
3175101005,JAKARTA TIMUR,CIPAYUNG,SETU,20572,8166,12406,5632,18038,2021-08-20
3173071002,JAKARTA BARAT,PALMERAH,SLIPI,16591,6126,10465,5781,16246,2021-08-20
3173081004,JAKARTA BARAT,KEMBANGAN,SRENGSENG,45523,18526,26997,13737,40734,2021-08-20
3174091002,JAKARTA SELATAN,JAGAKARSA,SRENGSENG SAWAH,58196,19558,38638,22490,61128,2021-08-20
3173051003,JAKARTA BARAT,KEBON JERUK,SUKABUMI SELATAN,37033,15279,21754,9272,31026,2021-08-20
3173051002,JAKARTA BARAT,KEBON JERUK,SUKABUMI UTARA,38290,16726,21564,9626,31190,2021-08-20
3172041002,JAKARTA UTARA,CILINCING,SUKAPURA,53949,21318,32631,17213,49844,2021-08-20
3171031007,JAKARTA PUSAT,KEMAYORAN,SUMUR BATU,22717,8983,13734,7563,21297,2021-08-20
3172021004,JAKARTA UTARA,TANJUNG PRIOK,SUNGAI BAMBU,29876,11245,18631,9951,28582,2021-08-20
3172021006,JAKARTA UTARA,TANJUNG PRIOK,SUNTER AGUNG,71805,24009,47796,29065,76861,2021-08-20
3172021002,JAKARTA UTARA,TANJUNG PRIOK,SUNTER JAYA,63031,22104,40927,23818,64745,2021-08-20
3175091004,JAKARTA TIMUR,CIRACAS,SUSUKAN,38257,13661,24596,12299,36895,2021-08-20
3173031001,JAKARTA BARAT,TAMAN SARI,TAMAN SARI,14348,5343,9005,5287,14292,2021-08-20
3173041001,JAKARTA BARAT,TAMBORA,TAMBORA,10204,3944,6260,3098,9358,2021-08-20
3173041004,JAKARTA BARAT,TAMBORA,TANAH SEREAL,26387,8689,17698,8567,26265,2021-08-20
3171081004,JAKARTA PUSAT,JOHAR BARU,TANAH TINGGI,37693,12399,25294,12171,37465,2021-08-20
3173031004,JAKARTA BARAT,TAMAN SARI,TANGKI,13324,4950,8374,4753,13127,2021-08-20
3174091005,JAKARTA SELATAN,JAGAKARSA,TANJUNG BARAT,39770,14847,24923,12953,37876,2021-08-20
3173021005,JAKARTA BARAT,GROGOL PETAMBURAN,TANJUNG DUREN SELATAN,25337,9370,15967,9185,25152,2021-08-20
3173021002,JAKARTA BARAT,GROGOL PETAMBURAN,TANJUNG DUREN UTARA,17010,5983,11027,6450,17477,2021-08-20
3172021001,JAKARTA UTARA,TANJUNG PRIOK,TANJUNG PRIOK,34588,12388,22200,10743,32943,2021-08-20
3174011002,JAKARTA SELATAN,TEBET,TEBET BARAT,21194,7423,13771,8342,22113,2021-08-20
3174011001,JAKARTA SELATAN,TEBET,TEBET TIMUR,18199,6386,11813,7223,19036,2021-08-20
3173061003,JAKARTA BARAT,KALI DERES,TEGAL ALUR,83647,31712,51935,21605,73540,2021-08-20
3174031004,JAKARTA SELATAN,MAMPANG PRAPATAN,TEGAL PARANG,32401,13296,19105,9874,28979,2021-08-20
3173021003,JAKARTA BARAT,GROGOL PETAMBURAN,TOMANG,29605,10926,18679,11205,29884,2021-08-20
3172031005,JAKARTA UTARA,KOJA,TUGU SELATAN,39122,16300,22822,11269,34091,2021-08-20
3172031002,JAKARTA UTARA,KOJA,TUGU UTARA,67670,28559,39111,20125,59236,2021-08-20
3175061006,JAKARTA TIMUR,CAKUNG,UJUNG MENTENG,29934,10753,19181,9743,28924,2021-08-20
3174101005,JAKARTA SELATAN,PESANGGRAHAN,ULUJAMI,40544,16794,23750,11694,35444,2021-08-20
3175011006,JAKARTA TIMUR,MATRAMAN,UTAN KAYU SELATAN,33511,12653,20858,10975,31833,2021-08-20
3175011002,JAKARTA TIMUR,MATRAMAN,UTAN KAYU UTARA,28169,11483,16686,8504,25190,2021-08-20
3171031008,JAKARTA PUSAT,KEMAYORAN,UTAN PANJANG,29208,11674,17534,8315,25849,2021-08-20
3172021007,JAKARTA UTARA,TANJUNG PRIOK,WARAKAS,44401,16642,27759,14407,42166,2021-08-20
3173021007,JAKARTA BARAT,GROGOL PETAMBURAN,WIJAYA KUSUMA,38934,15166,23768,12544,36312,2021-08-20
3172051003,JAKARTA UTARA,PADEMANGAN,ANCOL,23947,9573,14374,7336,21710,2021-08-21
3173041007,JAKARTA BARAT,TAMBORA,ANGKE,29381,10760,18621,8844,27465,2021-08-21
3175041005,JAKARTA TIMUR,KRAMAT JATI,BALE KAMBANG,29074,13261,15813,6170,21983,2021-08-21
3175031003,JAKARTA TIMUR,JATINEGARA,BALI MESTER,9752,3923,5829,3097,8926,2021-08-21
3175101006,JAKARTA TIMUR,CIPAYUNG,BAMBU APUS,26285,9912,16373,8078,24451,2021-08-21
3174031002,JAKARTA SELATAN,MAMPANG PRAPATAN,BANGKA,21566,8691,12875,7219,20094,2021-08-21
3175051002,JAKARTA TIMUR,PASAR REBO,BARU,23886,8122,15764,10072,25836,2021-08-21
3175041004,JAKARTA TIMUR,KRAMAT JATI,BATU AMPAR,47898,21058,26840,12078,38918,2021-08-21
3171071002,JAKARTA PUSAT,TANAH ABANG,BENDUNGAN HILIR,21494,8334,13160,7550,20710,2021-08-21
3175031002,JAKARTA TIMUR,JATINEGARA,BIDARA CINA,36689,16454,20235,9645,29880,2021-08-21
3174101002,JAKARTA SELATAN,PESANGGRAHAN,BINTARO,53098,20549,32549,18770,51319,2021-08-21
3174011005,JAKARTA SELATAN,TEBET,BUKIT DURI,34183,14048,20135,10657,30792,2021-08-21
3171041006,JAKARTA PUSAT,SENEN,BUNGUR,18144,6874,11270,5983,17253,2021-08-21
3175061007,JAKARTA TIMUR,CAKUNG,CAKUNG BARAT,57724,20774,36950,17487,54437,2021-08-21
3175061004,JAKARTA TIMUR,CAKUNG,CAKUNG TIMUR,58287,21330,36957,19464,56421,2021-08-21
3175041007,JAKARTA TIMUR,KRAMAT JATI,CAWANG,32762,13815,18947,9530,28477,2021-08-21
3175101008,JAKARTA TIMUR,CIPAYUNG,CEGER,18932,7068,11864,5638,17502,2021-08-21
3171031006,JAKARTA PUSAT,KEMAYORAN,CEMPAKA BARU,32581,13484,19097,9752,28849,2021-08-21
3171051002,JAKARTA PUSAT,CEMPAKA PUTIH,CEMPAKA PUTIH BARAT,35885,14124,21761,12188,33949,2021-08-21
3171051001,JAKARTA PUSAT,CEMPAKA PUTIH,CEMPAKA PUTIH TIMUR,24292,9336,14956,8721,23677,2021-08-21
3173011001,JAKARTA BARAT,CENGKARENG,CENGKARENG BARAT,66284,24711,41573,23143,64716,2021-08-21
3173011006,JAKARTA BARAT,CENGKARENG,CENGKARENG TIMUR,81027,29900,51127,23964,75091,2021-08-21
3175091002,JAKARTA TIMUR,CIRACAS,CIBUBUR,66364,23854,42510,23986,66496,2021-08-21
3171011002,JAKARTA PUSAT,GAMBIR,CIDENG,15390,5388,10002,5926,15928,2021-08-21
3174091003,JAKARTA SELATAN,JAGAKARSA,CIGANJUR,38497,14374,24123,13325,37448,2021-08-21
3175051003,JAKARTA TIMUR,PASAR REBO,CIJANTUNG,41419,14887,26532,14734,41266,2021-08-21
3171061003,JAKARTA PUSAT,MENTENG,CIKINI,8274,3463,4811,2614,7425,2021-08-21
3174081006,JAKARTA SELATAN,PANCORAN,CIKOKO,10547,3738,6809,3632,10441,2021-08-21
3174061001,JAKARTA SELATAN,CILANDAK,CILANDAK BARAT,51752,19299,32453,19184,51637,2021-08-21
3174041003,JAKARTA SELATAN,PASAR MINGGU,CILANDAK TIMUR,25145,9189,15956,9948,25904,2021-08-21
3175101002,JAKARTA TIMUR,CIPAYUNG,CILANGKAP,27635,10088,17547,8984,26531,2021-08-21
3175041006,JAKARTA TIMUR,KRAMAT JATI,CILILITAN,40181,17266,22915,11310,34225,2021-08-21
3172041001,JAKARTA UTARA,CILINCING,CILINCING,43609,17697,25912,12851,38763,2021-08-21
3175101001,JAKARTA TIMUR,CIPAYUNG,CIPAYUNG,26104,9043,17061,9401,26462,2021-08-21
3174091006,JAKARTA SELATAN,JAGAKARSA,CIPEDAK,38303,13289,25014,14840,39854,2021-08-21
3174061005,JAKARTA SELATAN,CILANDAK,CIPETE SELATAN,26704,10451,16253,10296,26549,2021-08-21
3174071010,JAKARTA SELATAN,KEBAYORAN BARU,CIPETE UTARA,34102,12960,21142,12149,33291,2021-08-21
3175021003,JAKARTA TIMUR,PULO GADUNG,CIPINANG,39306,15501,23805,12859,36664,2021-08-21
3175031007,JAKARTA TIMUR,JATINEGARA,CIPINANG BESAR SELATAN,35212,15618,19594,9202,28796,2021-08-21
3175031008,JAKARTA TIMUR,JATINEGARA,CIPINANG BESAR UTARA,45319,19357,25962,11297,37259,2021-08-21
3175031005,JAKARTA TIMUR,JATINEGARA,CIPINANG CEMPEDAK,32824,14024,18800,10268,29068,2021-08-21
3175081005,JAKARTA TIMUR,MAKASAR,CIPINANG MELAYU,42308,16941,25367,14123,39490,2021-08-21
3175031006,JAKARTA TIMUR,JATINEGARA,CIPINANG MUARA,55243,23364,31879,15407,47286,2021-08-21
3174051003,JAKARTA SELATAN,KEBAYORAN LAMA,CIPULIR,39937,16475,23462,11706,35168,2021-08-21
3175091001,JAKARTA TIMUR,CIRACAS,CIRACAS,64594,23147,41447,21410,62857,2021-08-21
3175041003,JAKARTA TIMUR,KRAMAT JATI,DUKUH,24609,9181,15428,7471,22899,2021-08-21
3175071001,JAKARTA TIMUR,DUREN SAWIT,DUREN SAWIT,61160,25570,35590,18996,54586,2021-08-21
3174081004,JAKARTA SELATAN,PANCORAN,DUREN TIGA,28319,10897,17422,8746,26168,2021-08-21
3173051005,JAKARTA BARAT,KEBON JERUK,DURI KEPA,60138,21845,38293,21197,59490,2021-08-21
3173011002,JAKARTA BARAT,CENGKARENG,DURI KOSAMBI,77923,32266,45657,21877,67534,2021-08-21
3171011006,JAKARTA PUSAT,GAMBIR,DURI PULO,19610,7336,12274,6263,18537,2021-08-21
3173041011,JAKARTA BARAT,TAMBORA,DURI SELATAN,14259,4884,9375,4966,14341,2021-08-21
3173041003,JAKARTA BARAT,TAMBORA,DURI UTARA,19844,7079,12765,6314,19079,2021-08-21
3171081003,JAKARTA PUSAT,JOHAR BARU,GALUR,18243,5971,12272,5990,18262,2021-08-21
3171011001,JAKARTA PUSAT,GAMBIR,GAMBIR,2191,775,1416,848,2264,2021-08-21
3174061004,JAKARTA SELATAN,CILANDAK,GANDARIA SELATAN,22119,8506,13613,7523,21136,2021-08-21
3174071009,JAKARTA SELATAN,KEBAYORAN BARU,GANDARIA UTARA,39922,15462,24460,13894,38354,2021-08-21
3175051001,JAKARTA TIMUR,PASAR REBO,GEDONG,35755,13271,22484,12068,34552,2021-08-21
3171071001,JAKARTA PUSAT,TANAH ABANG,GELORA,3127,1272,1855,1013,2868,2021-08-21
3173031007,JAKARTA BARAT,TAMAN SARI,GLODOK,7837,2527,5310,3413,8723,2021-08-21
3171061004,JAKARTA PUSAT,MENTENG,GONDANGDIA,4100,1573,2527,1847,4374,2021-08-21
3173021001,JAKARTA BARAT,GROGOL PETAMBURAN,GROGOL,16876,6411,10465,5846,16311,2021-08-21
3174051005,JAKARTA SELATAN,KEBAYORAN LAMA,GROGOL SELATAN,44251,17570,26681,13407,40088,2021-08-21
3174051004,JAKARTA SELATAN,KEBAYORAN LAMA,GROGOL UTARA,42494,16637,25857,13363,39220,2021-08-21
3174021007,JAKARTA SELATAN,SETIA BUDI,GUNTUR,3985,1449,2536,1735,4271,2021-08-21
3174071002,JAKARTA SELATAN,KEBAYORAN BARU,GUNUNG,9436,3445,5991,3964,9955,2021-08-21
3171031005,JAKARTA PUSAT,KEMAYORAN,GUNUNG SAHARI SELATAN,19199,7432,11767,6724,18491,2021-08-21
3171021004,JAKARTA PUSAT,SAWAH BESAR,GUNUNG SAHARI UTARA,16650,5524,11126,6756,17882,2021-08-21
3175081004,JAKARTA TIMUR,MAKASAR,HALIM PERDANA KUSUMAH,28363,8325,20038,14824,34862,2021-08-21
3171031003,JAKARTA PUSAT,KEMAYORAN,HARAPAN MULIA,22557,8843,13714,6976,20690,2021-08-21
3174091001,JAKARTA SELATAN,JAGAKARSA,JAGAKARSA,62389,22653,39736,23773,63509,2021-08-21
3175021007,JAKARTA TIMUR,PULO GADUNG,JATI,32757,12703,20054,11127,31181,2021-08-21
3174041002,JAKARTA SELATAN,PASAR MINGGU,JATI PADANG,37502,14340,23162,13548,36710,2021-08-21
3173071004,JAKARTA BARAT,PALMERAH,JATI PULO,28738,10683,18055,8592,26647,2021-08-21
3175061001,JAKARTA TIMUR,CAKUNG,JATINEGARA,84160,33546,50614,22876,73490,2021-08-21
3175021004,JAKARTA TIMUR,PULO GADUNG,JATINEGARA KAUM,24632,8808,15824,7224,23048,2021-08-21
3173021004,JAKARTA BARAT,GROGOL PETAMBURAN,JELAMBAR,30266,11294,18972,11336,30308,2021-08-21
3173021006,JAKARTA BARAT,GROGOL PETAMBURAN,JELAMBAR BARU,38246,14307,23939,13876,37815,2021-08-21
3173041006,JAKARTA BARAT,TAMBORA,JEMBATAN BESI,29314,12933,16381,7038,23419,2021-08-21
3173041008,JAKARTA BARAT,TAMBORA,JEMBATAN LIMA,21021,8540,12481,5954,18435,2021-08-21
3173081005,JAKARTA BARAT,KEMBANGAN,JOGLO,40839,15887,24952,12867,37819,2021-08-21
3171081001,JAKARTA PUSAT,JOHAR BARU,JOHAR BARU,37488,12835,24653,13200,37853,2021-08-21
3173041002,JAKARTA BARAT,TAMBORA,KALI ANYAR,23856,8603,15253,6079,21332,2021-08-21
3172041004,JAKARTA UTARA,CILINCING,KALIBARU,67684,29366,38318,17513,55831,2021-08-21
3174081002,JAKARTA SELATAN,PANCORAN,KALIBATA,41994,17864,24130,11918,36048,2021-08-21
3173061001,JAKARTA BARAT,KALI DERES,KALIDERES,72447,27769,44678,22690,67368,2021-08-21
3175051004,JAKARTA TIMUR,PASAR REBO,KALISARI,43212,15819,27393,15274,42667,2021-08-21
3173061004,JAKARTA BARAT,KALI DERES,KAMAL,53783,21224,32559,12670,45229,2021-08-21
3172011002,JAKARTA UTARA,PENJARINGAN,KAMAL MUARA,12930,3802,9128,5926,15054,2021-08-21
3171071007,JAKARTA PUSAT,TANAH ABANG,KAMPUNG BALI,11358,4977,6381,3322,9703,2021-08-21
3175031001,JAKARTA TIMUR,JATINEGARA,KAMPUNG MELAYU,25717,11008,14709,6885,21594,2021-08-21
3171081002,JAKARTA PUSAT,JOHAR BARU,KAMPUNG RAWA,21237,6162,15075,7395,22470,2021-08-21
3175041002,JAKARTA TIMUR,KRAMAT JATI,KAMPUNG TENGAH,43993,19163,24830,11424,36254,2021-08-21
3173011005,JAKARTA BARAT,CENGKARENG,KAPUK,134466,55504,78962,34342,113304,2021-08-21
3172011003,JAKARTA UTARA,PENJARINGAN,KAPUK MUARA,35781,12042,23739,15061,38800,2021-08-21
3171021002,JAKARTA PUSAT,SAWAH BESAR,KARANG ANYAR,25761,9104,16657,8559,25216,2021-08-21
3174021004,JAKARTA SELATAN,SETIA BUDI,KARET,9623,3756,5867,3373,9240,2021-08-21
3174021003,JAKARTA SELATAN,SETIA BUDI,KARET KUNINGAN,16055,5566,10489,6333,16822,2021-08-21
3174021002,JAKARTA SELATAN,SETIA BUDI,KARET SEMANGGI,2770,972,1798,1264,3062,2021-08-21
3171071003,JAKARTA PUSAT,TANAH ABANG,KARET TENGSIN,19271,7442,11829,6038,17867,2021-08-21
3171021003,JAKARTA PUSAT,SAWAH BESAR,KARTINI,22292,8169,14123,8150,22273,2021-08-21
3175011003,JAKARTA TIMUR,MATRAMAN,KAYU MANIS,25284,10529,14755,7143,21898,2021-08-21
3175021006,JAKARTA TIMUR,PULO GADUNG,KAYU PUTIH,40696,14907,25789,15250,41039,2021-08-21
3173031006,JAKARTA BARAT,TAMAN SARI,KEAGUNGAN,17387,6291,11096,6077,17173,2021-08-21
3174041007,JAKARTA SELATAN,PASAR MINGGU,KEBAGUSAN,44552,17644,26908,14476,41384,2021-08-21
3174051006,JAKARTA SELATAN,KEBAYORAN LAMA,KEBAYORAN LAMA SELATAN,41212,15300,25912,14448,40360,2021-08-21
3174051001,JAKARTA SELATAN,KEBAYORAN LAMA,KEBAYORAN LAMA UTARA,42422,17092,25330,12555,37885,2021-08-21
3174011004,JAKARTA SELATAN,TEBET,KEBON BARU,35165,13502,21663,11688,33351,2021-08-21
3172021005,JAKARTA UTARA,TANJUNG PRIOK,KEBON BAWANG,50952,19470,31482,17007,48489,2021-08-21
3173051001,JAKARTA BARAT,KEBON JERUK,KEBON JERUK,53887,22063,31824,15764,47588,2021-08-21
3171071006,JAKARTA PUSAT,TANAH ABANG,KEBON KACANG,21531,9926,11605,5858,17463,2021-08-21
3171011005,JAKARTA PUSAT,GAMBIR,KEBON KELAPA,10163,3773,6390,3430,9820,2021-08-21
3171031002,JAKARTA PUSAT,KEMAYORAN,KEBON KOSONG,30019,11832,18187,9764,27951,2021-08-21
3175011005,JAKARTA TIMUR,MATRAMAN,KEBON MANGGIS,16490,6199,10291,5842,16133,2021-08-21
3171071005,JAKARTA PUSAT,TANAH ABANG,KEBON MELATI,32206,15683,16523,7853,24376,2021-08-21
3175081003,JAKARTA TIMUR,MAKASAR,KEBON PALA,46614,17766,28848,14421,43269,2021-08-21
3171061005,JAKARTA PUSAT,MENTENG,KEBON SIRIH,12299,5196,7103,3514,10617,2021-08-21
3173011004,JAKARTA BARAT,CENGKARENG,KEDAUNG KALI ANGKE,32612,11334,21278,11433,32711,2021-08-21
3173051007,JAKARTA BARAT,KEBON JERUK,KEDOYA SELATAN,32165,11914,20251,9980,30231,2021-08-21
3173051006,JAKARTA BARAT,KEBON JERUK,KEDOYA UTARA,45740,15905,29835,15610,45445,2021-08-21
3173051004,JAKARTA BARAT,KEBON JERUK,KELAPA DUA,23565,9283,14282,6913,21195,2021-08-21
3175091003,JAKARTA TIMUR,CIRACAS,KELAPA DUA WETAN,46875,16401,30474,16062,46536,2021-08-21
3172061003,JAKARTA UTARA,KELAPA GADING,KELAPA GADING BARAT,35717,11945,23772,16156,39928,2021-08-21
3172061001,JAKARTA UTARA,KELAPA GADING,KELAPA GADING TIMUR,33592,10469,23123,15486,38609,2021-08-21
3173071005,JAKARTA BARAT,PALMERAH,KEMANGGISAN,32139,12379,19760,10276,30036,2021-08-21
3171031001,JAKARTA PUSAT,KEMAYORAN,KEMAYORAN,20708,7677,13031,7131,20162,2021-08-21
3173081006,JAKARTA BARAT,KEMBANGAN,KEMBANGAN SELATAN,27130,10311,16819,9686,26505,2021-08-21
3173081001,JAKARTA BARAT,KEMBANGAN,KEMBANGAN UTARA,54451,20757,33694,16832,50526,2021-08-21
3171041002,JAKARTA PUSAT,SENEN,KENARI,9579,3548,6031,3141,9172,2021-08-21
3173041005,JAKARTA BARAT,TAMBORA,KERENDANG,19973,7424,12549,6413,18962,2021-08-21
3175071003,JAKARTA TIMUR,DUREN SAWIT,KLENDER,69978,30047,39931,17995,57926,2021-08-21
3172031001,JAKARTA UTARA,KOJA,KOJA,28175,11257,16918,9380,26298,2021-08-21
3173071006,JAKARTA BARAT,PALMERAH,KOTA BAMBU SELATAN,21158,8330,12828,6040,18868,2021-08-21
3173071003,JAKARTA BARAT,PALMERAH,KOTA BAMBU UTARA,24995,10009,14986,7289,22275,2021-08-21
3171041004,JAKARTA PUSAT,SENEN,KRAMAT,28835,12363,16472,7535,24007,2021-08-21
3175041001,JAKARTA TIMUR,KRAMAT JATI,KRAMAT JATI,34144,13326,20818,9896,30714,2021-08-21
3174071003,JAKARTA SELATAN,KEBAYORAN BARU,KRAMAT PELA,14413,5205,9208,5360,14568,2021-08-21
3173031002,JAKARTA BARAT,TAMAN SARI,KRUKUT,19244,7178,12066,5656,17722,2021-08-21
3174031005,JAKARTA SELATAN,MAMPANG PRAPATAN,KUNINGAN BARAT,12785,4652,8133,4651,12784,2021-08-21
3174021008,JAKARTA SELATAN,SETIA BUDI,KUNINGAN TIMUR,6008,2229,3779,2356,6135,2021-08-21
3171041005,JAKARTA PUSAT,SENEN,KWITANG,15486,5912,9574,4979,14553,2021-08-21
3172031003,JAKARTA UTARA,KOJA,LAGOA,59065,24333,34732,17548,52280,2021-08-21
3174061002,JAKARTA SELATAN,CILANDAK,LEBAK BULUS,37626,14779,22847,13467,36314,2021-08-21
3174091004,JAKARTA SELATAN,JAGAKARSA,LENTENG AGUNG,53946,21401,32545,16630,49175,2021-08-21
3175101007,JAKARTA TIMUR,CIPAYUNG,LUBANG BUAYA,63547,22620,40927,21820,62747,2021-08-21
3175081001,JAKARTA TIMUR,MAKASAR,MAKASAR,34390,12793,21597,11628,33225,2021-08-21
3175071006,JAKARTA TIMUR,DUREN SAWIT,MALAKA JAYA,30927,12005,18922,11551,30473,2021-08-21
3175071005,JAKARTA TIMUR,DUREN SAWIT,MALAKA SARI,27530,10348,17182,10479,27661,2021-08-21
3174031001,JAKARTA SELATAN,MAMPANG PRAPATAN,MAMPANG PRAPATAN,18159,6999,11160,6595,17755,2021-08-21
3173031005,JAKARTA BARAT,TAMAN SARI,MANGGA BESAR,7707,2519,5188,3178,8366,2021-08-21
3171021005,JAKARTA PUSAT,SAWAH BESAR,MANGGA DUA SELATAN,27442,10209,17233,9605,26838,2021-08-21
3174011007,JAKARTA SELATAN,TEBET,MANGGARAI,28373,10083,18290,9237,27527,2021-08-21
3174011006,JAKARTA SELATAN,TEBET,MANGGARAI SELATAN,23075,8430,14645,8293,22938,2021-08-21
3173031003,JAKARTA BARAT,TAMAN SARI,MAPHAR,16461,6178,10283,5975,16258,2021-08-21
3172041003,JAKARTA UTARA,CILINCING,MARUNDA,28943,10797,18146,7692,25838,2021-08-21
3174071001,JAKARTA SELATAN,KEBAYORAN BARU,MELAWAI,2627,923,1704,1279,2983,2021-08-21
3171061001,JAKARTA PUSAT,MENTENG,MENTENG,25624,10420,15204,7973,23177,2021-08-21
3174021005,JAKARTA SELATAN,SETIA BUDI,MENTENG ATAS,27816,10002,17814,9832,27646,2021-08-21
3174011003,JAKARTA SELATAN,TEBET,MENTENG DALAM,36028,13759,22269,12275,34544,2021-08-21
3173081003,JAKARTA BARAT,KEMBANGAN,MERUYA SELATAN,32130,12349,19781,10002,29783,2021-08-21
3173081002,JAKARTA BARAT,KEMBANGAN,MERUYA UTARA,43752,16904,26848,14821,41669,2021-08-21
3175101004,JAKARTA TIMUR,CIPAYUNG,MUNJUL,23871,8526,15345,7912,23257,2021-08-21
3172051002,JAKARTA UTARA,PADEMANGAN,PADEMANGAN BARAT,74240,29733,44507,22658,67165,2021-08-21
3172051001,JAKARTA UTARA,PADEMANGAN,PADEMANGAN TIMUR,37736,12735,25001,14708,39709,2021-08-21
3175011004,JAKARTA TIMUR,MATRAMAN,PAL MERIAM,19769,8043,11726,6128,17854,2021-08-21
3173071001,JAKARTA BARAT,PALMERAH,PALMERAH,63011,24769,38242,18847,57089,2021-08-21
3174081001,JAKARTA SELATAN,PANCORAN,PANCORAN,19421,7451,11970,6751,18721,2021-08-21
3172021003,JAKARTA UTARA,TANJUNG PRIOK,PAPANGGO,39097,14022,25075,13264,38339,2021-08-21
3171021001,JAKARTA PUSAT,SAWAH BESAR,PASAR BARU,12035,3942,8093,4998,13091,2021-08-21
3174021006,JAKARTA SELATAN,SETIA BUDI,PASAR MANGGIS,26752,10217,16535,9330,25865,2021-08-21
3174041001,JAKARTA SELATAN,PASAR MINGGU,PASAR MINGGU,24821,9420,15401,9155,24556,2021-08-21
3171041003,JAKARTA PUSAT,SENEN,PASEBAN,23533,9290,14243,7409,21652,2021-08-21
3173061005,JAKARTA BARAT,KALI DERES,PEGADUNGAN,75587,26834,48753,24975,73728,2021-08-21
3171061002,JAKARTA PUSAT,MENTENG,PEGANGSAAN,23455,9795,13660,6655,20315,2021-08-21
3172061002,JAKARTA UTARA,KELAPA GADING,PEGANGSAAN DUA,49976,15475,34501,21831,56332,2021-08-21
3172011004,JAKARTA UTARA,PENJARINGAN,PEJAGALAN,74578,28033,46545,27226,73771,2021-08-21
3174041006,JAKARTA SELATAN,PASAR MINGGU,PEJATEN BARAT,37346,14615,22731,13320,36051,2021-08-21
3174041005,JAKARTA SELATAN,PASAR MINGGU,PEJATEN TIMUR,57656,23388,34268,17294,51562,2021-08-21
3175051005,JAKARTA TIMUR,PASAR REBO,PEKAYON,43250,15649,27601,14954,42555,2021-08-21
3173041009,JAKARTA BARAT,TAMBORA,PEKOJAN,23587,8233,15354,8419,23773,2021-08-21
3174031003,JAKARTA SELATAN,MAMPANG PRAPATAN,PELA MAMPANG,43522,16351,27171,16221,43392,2021-08-21
3174081005,JAKARTA SELATAN,PANCORAN,PENGADEGAN,21478,7457,14021,7286,21307,2021-08-21
3175061003,JAKARTA TIMUR,CAKUNG,PENGGILINGAN,99255,42803,56452,25629,82081,2021-08-21
3172011001,JAKARTA UTARA,PENJARINGAN,PENJARINGAN,88308,37159,51149,24319,75468,2021-08-21
3174101001,JAKARTA SELATAN,PESANGGRAHAN,PESANGGRAHAN,27545,9735,17810,10261,28071,2021-08-21
3171071004,JAKARTA PUSAT,TANAH ABANG,PETAMBURAN,33271,16001,17270,7830,25100,2021-08-21
3174071008,JAKARTA SELATAN,KEBAYORAN BARU,PETOGOGAN,11499,4429,7070,4362,11432,2021-08-21
3171011004,JAKARTA PUSAT,GAMBIR,PETOJO SELATAN,14692,5655,9037,5238,14275,2021-08-21
3171011003,JAKARTA PUSAT,GAMBIR,PETOJO UTARA,17458,6586,10872,5419,16291,2021-08-21
3174101004,JAKARTA SELATAN,PESANGGRAHAN,PETUKANGAN SELATAN,37187,14086,23101,12671,35772,2021-08-21
3174101003,JAKARTA SELATAN,PESANGGRAHAN,PETUKANGAN UTARA,53716,21627,32089,17510,49599,2021-08-21
3175081002,JAKARTA TIMUR,MAKASAR,PINANG RANTI,27198,10566,16632,9231,25863,2021-08-21
3173031008,JAKARTA BARAT,TAMAN SARI,PINANGSIA,10729,3687,7042,4068,11110,2021-08-21
3175011001,JAKARTA TIMUR,MATRAMAN,PISANGAN BARU,31776,13079,18697,8619,27316,2021-08-21
3175021002,JAKARTA TIMUR,PULO GADUNG,PISANGAN TIMUR,41011,15109,25902,12875,38777,2021-08-21
3172011005,JAKARTA UTARA,PENJARINGAN,PLUIT,47783,17391,30392,20528,50920,2021-08-21
3175071002,JAKARTA TIMUR,DUREN SAWIT,PONDOK BAMBU,61550,25628,35922,18426,54348,2021-08-21
3175071004,JAKARTA TIMUR,DUREN SAWIT,PONDOK KELAPA,72015,27636,44379,22983,67362,2021-08-21
3175071007,JAKARTA TIMUR,DUREN SAWIT,PONDOK KOPI,35367,15481,19886,9832,29718,2021-08-21
3174061003,JAKARTA SELATAN,CILANDAK,PONDOK LABU,46464,16829,29635,18507,48142,2021-08-21
3174051002,JAKARTA SELATAN,KEBAYORAN LAMA,PONDOK PINANG,56169,21539,34630,20201,54831,2021-08-21
3175101003,JAKARTA TIMUR,CIPAYUNG,PONDOK RANGGON,25574,9417,16157,8150,24307,2021-08-21
3101011003,KAB.ADM.KEP.SERIBU,KEP. SERIBU UTARA,PULAU HARAPAN,2060,354,1706,974,2680,2021-08-21
3101011002,KAB.ADM.KEP.SERIBU,KEP. SERIBU UTARA,PULAU KELAPA,5528,958,4570,2381,6951,2021-08-21
3101011001,KAB.ADM.KEP.SERIBU,KEP. SERIBU UTARA,PULAU PANGGANG,5450,916,4534,2016,6550,2021-08-21
3101021003,KAB.ADM.KEP.SERIBU,KEP. SERIBU SELATAN,PULAU PARI,2765,335,2430,1347,3777,2021-08-21
3101021002,KAB.ADM.KEP.SERIBU,KEP. SERIBU SELATAN,PULAU TIDUNG,4553,680,3873,2501,6374,2021-08-21
3101021001,KAB.ADM.KEP.SERIBU,KEP. SERIBU SELATAN,PULAU UNTUNG JAWA,1941,340,1601,829,2430,2021-08-21
3174071007,JAKARTA SELATAN,KEBAYORAN BARU,PULO,5835,2053,3782,2616,6398,2021-08-21
3175021001,JAKARTA TIMUR,PULO GADUNG,PULO GADUNG,34422,13568,20854,10785,31639,2021-08-21
3175061005,JAKARTA TIMUR,CAKUNG,PULO GEBANG,97301,39179,58122,28428,86550,2021-08-21
3174041004,JAKARTA SELATAN,PASAR MINGGU,RAGUNAN,39616,14431,25185,14679,39864,2021-08-21
3175091005,JAKARTA TIMUR,CIRACAS,RAMBUTAN,36771,15920,20851,10541,31392,2021-08-21
3172031006,JAKARTA UTARA,KOJA,RAWA BADAK SELATAN,42179,17975,24204,11970,36174,2021-08-21
3172031004,JAKARTA UTARA,KOJA,RAWA BADAK UTARA,34408,14346,20062,10671,30733,2021-08-21
3174071005,JAKARTA SELATAN,KEBAYORAN BARU,RAWA BARAT,5625,1963,3662,2406,6068,2021-08-21
3173011003,JAKARTA BARAT,CENGKARENG,RAWA BUAYA,63799,25088,38711,17467,56178,2021-08-21
3175031004,JAKARTA TIMUR,JATINEGARA,RAWA BUNGA,21434,8954,12480,6319,18799,2021-08-21
3174081003,JAKARTA SELATAN,PANCORAN,RAWA JATI,20509,7724,12785,7156,19941,2021-08-21
3175061002,JAKARTA TIMUR,CAKUNG,RAWA TERATE,24637,8756,15881,7146,23027,2021-08-21
3175021005,JAKARTA TIMUR,PULO GADUNG,RAWAMANGUN,37612,14814,22798,12423,35221,2021-08-21
3171051003,JAKARTA PUSAT,CEMPAKA PUTIH,RAWASARI,21967,8590,13377,7664,21041,2021-08-21
3173041010,JAKARTA BARAT,TAMBORA,ROA MALAKA,3484,1081,2403,1522,3925,2021-08-21
3172041006,JAKARTA UTARA,CILINCING,ROROTAN,41668,15299,26369,13008,39377,2021-08-21
3174071004,JAKARTA SELATAN,KEBAYORAN BARU,SELONG,2842,1013,1829,1332,3161,2021-08-21
3173061002,JAKARTA BARAT,KALI DERES,SEMANAN,71354,28207,43147,17538,60685,2021-08-21
3172041007,JAKARTA UTARA,CILINCING,SEMPER BARAT,68587,24439,44148,23872,68020,2021-08-21
3172041005,JAKARTA UTARA,CILINCING,SEMPER TIMUR,36267,13491,22776,11844,34620,2021-08-21
3174071006,JAKARTA SELATAN,KEBAYORAN BARU,SENAYAN,2771,1178,1593,1020,2613,2021-08-21
3171041001,JAKARTA PUSAT,SENEN,SENEN,6804,2463,4341,2525,6866,2021-08-21
3171031004,JAKARTA PUSAT,KEMAYORAN,SERDANG,29668,11408,18260,9507,27767,2021-08-21
3174021001,JAKARTA SELATAN,SETIA BUDI,SETIA BUDI,3023,1158,1865,1169,3034,2021-08-21
3175101005,JAKARTA TIMUR,CIPAYUNG,SETU,20572,8129,12443,5783,18226,2021-08-21
3173071002,JAKARTA BARAT,PALMERAH,SLIPI,16591,6100,10491,5898,16389,2021-08-21
3173081004,JAKARTA BARAT,KEMBANGAN,SRENGSENG,45523,18476,27047,13914,40961,2021-08-21
3174091002,JAKARTA SELATAN,JAGAKARSA,SRENGSENG SAWAH,58196,19452,38744,22766,61510,2021-08-21
3173051003,JAKARTA BARAT,KEBON JERUK,SUKABUMI SELATAN,37033,15248,21785,9402,31187,2021-08-21
3173051002,JAKARTA BARAT,KEBON JERUK,SUKABUMI UTARA,38290,16694,21596,9733,31329,2021-08-21
3172041002,JAKARTA UTARA,CILINCING,SUKAPURA,53949,21289,32660,17300,49960,2021-08-21
3171031007,JAKARTA PUSAT,KEMAYORAN,SUMUR BATU,22717,8918,13799,7742,21541,2021-08-21
3172021004,JAKARTA UTARA,TANJUNG PRIOK,SUNGAI BAMBU,29876,11226,18650,9986,28636,2021-08-21
3172021006,JAKARTA UTARA,TANJUNG PRIOK,SUNTER AGUNG,71805,23976,47829,29190,77019,2021-08-21
3172021002,JAKARTA UTARA,TANJUNG PRIOK,SUNTER JAYA,63031,22056,40975,24003,64978,2021-08-21
3175091004,JAKARTA TIMUR,CIRACAS,SUSUKAN,38257,13593,24664,12435,37099,2021-08-21
3173031001,JAKARTA BARAT,TAMAN SARI,TAMAN SARI,14348,5330,9018,5313,14331,2021-08-21
3173041001,JAKARTA BARAT,TAMBORA,TAMBORA,10204,3931,6273,3157,9430,2021-08-21
3173041004,JAKARTA BARAT,TAMBORA,TANAH SEREAL,26387,8665,17722,8632,26354,2021-08-21
3171081004,JAKARTA PUSAT,JOHAR BARU,TANAH TINGGI,37693,12320,25373,12380,37753,2021-08-21
3173031004,JAKARTA BARAT,TAMAN SARI,TANGKI,13324,4932,8392,4782,13174,2021-08-21
3174091005,JAKARTA SELATAN,JAGAKARSA,TANJUNG BARAT,39770,14766,25004,13126,38130,2021-08-21
3173021005,JAKARTA BARAT,GROGOL PETAMBURAN,TANJUNG DUREN SELATAN,25337,9319,16018,9328,25346,2021-08-21
3173021002,JAKARTA BARAT,GROGOL PETAMBURAN,TANJUNG DUREN UTARA,17010,5953,11057,6517,17574,2021-08-21
3172021001,JAKARTA UTARA,TANJUNG PRIOK,TANJUNG PRIOK,34588,12377,22211,10785,32996,2021-08-21
3174011002,JAKARTA SELATAN,TEBET,TEBET BARAT,21194,7375,13819,8462,22281,2021-08-21
3174011001,JAKARTA SELATAN,TEBET,TEBET TIMUR,18199,6352,11847,7330,19177,2021-08-21
3173061003,JAKARTA BARAT,KALI DERES,TEGAL ALUR,83647,31607,52040,22304,74344,2021-08-21
3174031004,JAKARTA SELATAN,MAMPANG PRAPATAN,TEGAL PARANG,32401,13242,19159,10040,29199,2021-08-21
3173021003,JAKARTA BARAT,GROGOL PETAMBURAN,TOMANG,29605,10850,18755,11421,30176,2021-08-21
3172031005,JAKARTA UTARA,KOJA,TUGU SELATAN,39122,16268,22854,11369,34223,2021-08-21
3172031002,JAKARTA UTARA,KOJA,TUGU UTARA,67670,28408,39262,20494,59756,2021-08-21
3175061006,JAKARTA TIMUR,CAKUNG,UJUNG MENTENG,29934,10683,19251,9861,29112,2021-08-21
3174101005,JAKARTA SELATAN,PESANGGRAHAN,ULUJAMI,40544,16697,23847,12047,35894,2021-08-21
3175011006,JAKARTA TIMUR,MATRAMAN,UTAN KAYU SELATAN,33511,12578,20933,11172,32105,2021-08-21
3175011002,JAKARTA TIMUR,MATRAMAN,UTAN KAYU UTARA,28169,11413,16756,8681,25437,2021-08-21
3171031008,JAKARTA PUSAT,KEMAYORAN,UTAN PANJANG,29208,11594,17614,8586,26200,2021-08-21
3172021007,JAKARTA UTARA,TANJUNG PRIOK,WARAKAS,44401,16621,27780,14467,42247,2021-08-21
3173021007,JAKARTA BARAT,GROGOL PETAMBURAN,WIJAYA KUSUMA,38934,15128,23806,12783,36589,2021-08-21
3172051003,JAKARTA UTARA,PADEMANGAN,ANCOL,23947,9529,14418,7595,22013,2021-08-22
3173041007,JAKARTA BARAT,TAMBORA,ANGKE,29381,10726,18655,9008,27663,2021-08-22
3175041005,JAKARTA TIMUR,KRAMAT JATI,BALE KAMBANG,29074,13139,15935,6288,22223,2021-08-22
3175031003,JAKARTA TIMUR,JATINEGARA,BALI MESTER,9752,3890,5862,3133,8995,2021-08-22
3175101006,JAKARTA TIMUR,CIPAYUNG,BAMBU APUS,26285,9895,16390,8213,24603,2021-08-22
3174031002,JAKARTA SELATAN,MAMPANG PRAPATAN,BANGKA,21566,8574,12992,7347,20339,2021-08-22
3175051002,JAKARTA TIMUR,PASAR REBO,BARU,23886,8106,15780,10097,25877,2021-08-22
3175041004,JAKARTA TIMUR,KRAMAT JATI,BATU AMPAR,47898,20952,26946,12236,39182,2021-08-22
3171071002,JAKARTA PUSAT,TANAH ABANG,BENDUNGAN HILIR,21494,8303,13191,7630,20821,2021-08-22
3175031002,JAKARTA TIMUR,JATINEGARA,BIDARA CINA,36689,16365,20324,9743,30067,2021-08-22
3174101002,JAKARTA SELATAN,PESANGGRAHAN,BINTARO,53098,20506,32592,19127,51719,2021-08-22
3174011005,JAKARTA SELATAN,TEBET,BUKIT DURI,34183,14014,20169,10726,30895,2021-08-22
3171041006,JAKARTA PUSAT,SENEN,BUNGUR,18144,6859,11285,6049,17334,2021-08-22
3175061007,JAKARTA TIMUR,CAKUNG,CAKUNG BARAT,57724,20705,37019,17900,54919,2021-08-22
3175061004,JAKARTA TIMUR,CAKUNG,CAKUNG TIMUR,58287,21287,37000,19680,56680,2021-08-22
3175041007,JAKARTA TIMUR,KRAMAT JATI,CAWANG,32762,13763,18999,9600,28599,2021-08-22
3175101008,JAKARTA TIMUR,CIPAYUNG,CEGER,18932,7046,11886,5781,17667,2021-08-22
3171031006,JAKARTA PUSAT,KEMAYORAN,CEMPAKA BARU,32581,13381,19200,9876,29076,2021-08-22
3171051002,JAKARTA PUSAT,CEMPAKA PUTIH,CEMPAKA PUTIH BARAT,35885,14071,21814,12432,34246,2021-08-22
3171051001,JAKARTA PUSAT,CEMPAKA PUTIH,CEMPAKA PUTIH TIMUR,24292,9231,15061,8832,23893,2021-08-22
3173011001,JAKARTA BARAT,CENGKARENG,CENGKARENG BARAT,66284,24658,41626,23562,65188,2021-08-22
3173011006,JAKARTA BARAT,CENGKARENG,CENGKARENG TIMUR,81027,29686,51341,24489,75830,2021-08-22
3175091002,JAKARTA TIMUR,CIRACAS,CIBUBUR,66364,23668,42696,24310,67006,2021-08-22
3171011002,JAKARTA PUSAT,GAMBIR,CIDENG,15390,5369,10021,6032,16053,2021-08-22
3174091003,JAKARTA SELATAN,JAGAKARSA,CIGANJUR,38497,14330,24167,13508,37675,2021-08-22
3175051003,JAKARTA TIMUR,PASAR REBO,CIJANTUNG,41419,14817,26602,14813,41415,2021-08-22
3171061003,JAKARTA PUSAT,MENTENG,CIKINI,8274,3446,4828,2636,7464,2021-08-22
3174081006,JAKARTA SELATAN,PANCORAN,CIKOKO,10547,3729,6818,3659,10477,2021-08-22
3174061001,JAKARTA SELATAN,CILANDAK,CILANDAK BARAT,51752,19192,32560,19383,51943,2021-08-22
3174041003,JAKARTA SELATAN,PASAR MINGGU,CILANDAK TIMUR,25145,9155,15990,10074,26064,2021-08-22
3175101002,JAKARTA TIMUR,CIPAYUNG,CILANGKAP,27635,10071,17564,9051,26615,2021-08-22
3175041006,JAKARTA TIMUR,KRAMAT JATI,CILILITAN,40181,17201,22980,11449,34429,2021-08-22
3172041001,JAKARTA UTARA,CILINCING,CILINCING,43609,17591,26018,13223,39241,2021-08-22
3175101001,JAKARTA TIMUR,CIPAYUNG,CIPAYUNG,26104,9020,17084,9471,26555,2021-08-22
3174091006,JAKARTA SELATAN,JAGAKARSA,CIPEDAK,38303,13175,25128,14929,40057,2021-08-22
3174061005,JAKARTA SELATAN,CILANDAK,CIPETE SELATAN,26704,10420,16284,10371,26655,2021-08-22
3174071010,JAKARTA SELATAN,KEBAYORAN BARU,CIPETE UTARA,34102,12918,21184,12219,33403,2021-08-22
3175021003,JAKARTA TIMUR,PULO GADUNG,CIPINANG,39306,15382,23924,13046,36970,2021-08-22
3175031007,JAKARTA TIMUR,JATINEGARA,CIPINANG BESAR SELATAN,35212,15568,19644,9289,28933,2021-08-22
3175031008,JAKARTA TIMUR,JATINEGARA,CIPINANG BESAR UTARA,45319,19309,26010,11429,37439,2021-08-22
3175031005,JAKARTA TIMUR,JATINEGARA,CIPINANG CEMPEDAK,32824,13959,18865,10501,29366,2021-08-22
3175081005,JAKARTA TIMUR,MAKASAR,CIPINANG MELAYU,42308,16840,25468,14255,39723,2021-08-22
3175031006,JAKARTA TIMUR,JATINEGARA,CIPINANG MUARA,55243,23289,31954,15620,47574,2021-08-22
3174051003,JAKARTA SELATAN,KEBAYORAN LAMA,CIPULIR,39937,16435,23502,11911,35413,2021-08-22
3175091001,JAKARTA TIMUR,CIRACAS,CIRACAS,64594,23045,41549,21670,63219,2021-08-22
3175041003,JAKARTA TIMUR,KRAMAT JATI,DUKUH,24609,9120,15489,7533,23022,2021-08-22
3175071001,JAKARTA TIMUR,DUREN SAWIT,DUREN SAWIT,61160,25455,35705,19185,54890,2021-08-22
3174081004,JAKARTA SELATAN,PANCORAN,DUREN TIGA,28319,10861,17458,8838,26296,2021-08-22
3173051005,JAKARTA BARAT,KEBON JERUK,DURI KEPA,60138,21717,38421,21801,60222,2021-08-22
3173011002,JAKARTA BARAT,CENGKARENG,DURI KOSAMBI,77923,32126,45797,22360,68157,2021-08-22
3171011006,JAKARTA PUSAT,GAMBIR,DURI PULO,19610,7245,12365,6391,18756,2021-08-22
3173041011,JAKARTA BARAT,TAMBORA,DURI SELATAN,14259,4868,9391,5136,14527,2021-08-22
3173041003,JAKARTA BARAT,TAMBORA,DURI UTARA,19844,7056,12788,6420,19208,2021-08-22
3171081003,JAKARTA PUSAT,JOHAR BARU,GALUR,18243,5952,12291,6086,18377,2021-08-22
3171011001,JAKARTA PUSAT,GAMBIR,GAMBIR,2191,772,1419,852,2271,2021-08-22
3174061004,JAKARTA SELATAN,CILANDAK,GANDARIA SELATAN,22119,8483,13636,7589,21225,2021-08-22
3174071009,JAKARTA SELATAN,KEBAYORAN BARU,GANDARIA UTARA,39922,15412,24510,14096,38606,2021-08-22
3175051001,JAKARTA TIMUR,PASAR REBO,GEDONG,35755,13237,22518,12153,34671,2021-08-22
3171071001,JAKARTA PUSAT,TANAH ABANG,GELORA,3127,1266,1861,1020,2881,2021-08-22
3173031007,JAKARTA BARAT,TAMAN SARI,GLODOK,7837,2517,5320,3447,8767,2021-08-22
3171061004,JAKARTA PUSAT,MENTENG,GONDANGDIA,4100,1565,2535,1856,4391,2021-08-22
3173021001,JAKARTA BARAT,GROGOL PETAMBURAN,GROGOL,16876,6387,10489,5964,16453,2021-08-22
3174051005,JAKARTA SELATAN,KEBAYORAN LAMA,GROGOL SELATAN,44251,17528,26723,13825,40548,2021-08-22
3174051004,JAKARTA SELATAN,KEBAYORAN LAMA,GROGOL UTARA,42494,16589,25905,13579,39484,2021-08-22
3174021007,JAKARTA SELATAN,SETIA BUDI,GUNTUR,3985,1444,2541,1744,4285,2021-08-22
3174071002,JAKARTA SELATAN,KEBAYORAN BARU,GUNUNG,9436,3431,6005,3998,10003,2021-08-22
3171031005,JAKARTA PUSAT,KEMAYORAN,GUNUNG SAHARI SELATAN,19199,7411,11788,6775,18563,2021-08-22
3171021004,JAKARTA PUSAT,SAWAH BESAR,GUNUNG SAHARI UTARA,16650,5502,11148,6809,17957,2021-08-22
3175081004,JAKARTA TIMUR,MAKASAR,HALIM PERDANA KUSUMAH,28363,8288,20075,14907,34982,2021-08-22
3171031003,JAKARTA PUSAT,KEMAYORAN,HARAPAN MULIA,22557,8817,13740,7049,20789,2021-08-22
3174091001,JAKARTA SELATAN,JAGAKARSA,JAGAKARSA,62389,22442,39947,23985,63932,2021-08-22
3175021007,JAKARTA TIMUR,PULO GADUNG,JATI,32757,12644,20113,11257,31370,2021-08-22
3174041002,JAKARTA SELATAN,PASAR MINGGU,JATI PADANG,37502,14304,23198,13645,36843,2021-08-22
3173071004,JAKARTA BARAT,PALMERAH,JATI PULO,28738,10620,18118,8933,27051,2021-08-22
3175061001,JAKARTA TIMUR,CAKUNG,JATINEGARA,84160,33439,50721,23372,74093,2021-08-22
3175021004,JAKARTA TIMUR,PULO GADUNG,JATINEGARA KAUM,24632,8768,15864,7320,23184,2021-08-22
3173021004,JAKARTA BARAT,GROGOL PETAMBURAN,JELAMBAR,30266,11252,19014,11588,30602,2021-08-22
3173021006,JAKARTA BARAT,GROGOL PETAMBURAN,JELAMBAR BARU,38246,14248,23998,14122,38120,2021-08-22
3173041006,JAKARTA BARAT,TAMBORA,JEMBATAN BESI,29314,12889,16425,7301,23726,2021-08-22
3173041008,JAKARTA BARAT,TAMBORA,JEMBATAN LIMA,21021,8496,12525,6129,18654,2021-08-22
3173081005,JAKARTA BARAT,KEMBANGAN,JOGLO,40839,15857,24982,13012,37994,2021-08-22
3171081001,JAKARTA PUSAT,JOHAR BARU,JOHAR BARU,37488,12733,24755,13432,38187,2021-08-22
3173041002,JAKARTA BARAT,TAMBORA,KALI ANYAR,23856,8564,15292,6464,21756,2021-08-22
3172041004,JAKARTA UTARA,CILINCING,KALIBARU,67684,29183,38501,18021,56522,2021-08-22
3174081002,JAKARTA SELATAN,PANCORAN,KALIBATA,41994,17821,24173,12111,36284,2021-08-22
3173061001,JAKARTA BARAT,KALI DERES,KALIDERES,72447,27651,44796,23724,68520,2021-08-22
3175051004,JAKARTA TIMUR,PASAR REBO,KALISARI,43212,15801,27411,15356,42767,2021-08-22
3173061004,JAKARTA BARAT,KALI DERES,KAMAL,53783,21186,32597,12927,45524,2021-08-22
3172011002,JAKARTA UTARA,PENJARINGAN,KAMAL MUARA,12930,3784,9146,6063,15209,2021-08-22
3171071007,JAKARTA PUSAT,TANAH ABANG,KAMPUNG BALI,11358,4968,6390,3345,9735,2021-08-22
3175031001,JAKARTA TIMUR,JATINEGARA,KAMPUNG MELAYU,25717,10984,14733,6930,21663,2021-08-22
3171081002,JAKARTA PUSAT,JOHAR BARU,KAMPUNG RAWA,21237,6122,15115,7563,22678,2021-08-22
3175041002,JAKARTA TIMUR,KRAMAT JATI,KAMPUNG TENGAH,43993,19104,24889,11535,36424,2021-08-22
3173011005,JAKARTA BARAT,CENGKARENG,KAPUK,134466,55375,79091,35044,114135,2021-08-22
3172011003,JAKARTA UTARA,PENJARINGAN,KAPUK MUARA,35781,11946,23835,15432,39267,2021-08-22
3171021002,JAKARTA PUSAT,SAWAH BESAR,KARANG ANYAR,25761,9094,16667,8648,25315,2021-08-22
3174021004,JAKARTA SELATAN,SETIA BUDI,KARET,9623,3750,5873,3403,9276,2021-08-22
3174021003,JAKARTA SELATAN,SETIA BUDI,KARET KUNINGAN,16055,5543,10512,6385,16897,2021-08-22
3174021002,JAKARTA SELATAN,SETIA BUDI,KARET SEMANGGI,2770,970,1800,1288,3088,2021-08-22
3171071003,JAKARTA PUSAT,TANAH ABANG,KARET TENGSIN,19271,7419,11852,6130,17982,2021-08-22
3171021003,JAKARTA PUSAT,SAWAH BESAR,KARTINI,22292,8147,14145,8232,22377,2021-08-22
3175011003,JAKARTA TIMUR,MATRAMAN,KAYU MANIS,25284,10512,14772,7222,21994,2021-08-22
3175021006,JAKARTA TIMUR,PULO GADUNG,KAYU PUTIH,40696,14821,25875,15453,41328,2021-08-22
3173031006,JAKARTA BARAT,TAMAN SARI,KEAGUNGAN,17387,6255,11132,6269,17401,2021-08-22
3174041007,JAKARTA SELATAN,PASAR MINGGU,KEBAGUSAN,44552,17608,26944,14593,41537,2021-08-22
3174051006,JAKARTA SELATAN,KEBAYORAN LAMA,KEBAYORAN LAMA SELATAN,41212,15242,25970,14610,40580,2021-08-22
3174051001,JAKARTA SELATAN,KEBAYORAN LAMA,KEBAYORAN LAMA UTARA,42422,17021,25401,12731,38132,2021-08-22
3174011004,JAKARTA SELATAN,TEBET,KEBON BARU,35165,13483,21682,11746,33428,2021-08-22
3172021005,JAKARTA UTARA,TANJUNG PRIOK,KEBON BAWANG,50952,19350,31602,17358,48960,2021-08-22
3173051001,JAKARTA BARAT,KEBON JERUK,KEBON JERUK,53887,21972,31915,16052,47967,2021-08-22
3171071006,JAKARTA PUSAT,TANAH ABANG,KEBON KACANG,21531,9872,11659,5918,17577,2021-08-22
3171011005,JAKARTA PUSAT,GAMBIR,KEBON KELAPA,10163,3769,6394,3463,9857,2021-08-22
3171031002,JAKARTA PUSAT,KEMAYORAN,KEBON KOSONG,30019,11781,18238,9866,28104,2021-08-22
3175011005,JAKARTA TIMUR,MATRAMAN,KEBON MANGGIS,16490,6187,10303,5875,16178,2021-08-22
3171071005,JAKARTA PUSAT,TANAH ABANG,KEBON MELATI,32206,15612,16594,7940,24534,2021-08-22
3175081003,JAKARTA TIMUR,MAKASAR,KEBON PALA,46614,17610,29004,14676,43680,2021-08-22
3171061005,JAKARTA PUSAT,MENTENG,KEBON SIRIH,12299,5189,7110,3548,10658,2021-08-22
3173011004,JAKARTA BARAT,CENGKARENG,KEDAUNG KALI ANGKE,32612,11312,21300,11543,32843,2021-08-22
3173051007,JAKARTA BARAT,KEBON JERUK,KEDOYA SELATAN,32165,11863,20302,10277,30579,2021-08-22
3173051006,JAKARTA BARAT,KEBON JERUK,KEDOYA UTARA,45740,15835,29905,16068,45973,2021-08-22
3173051004,JAKARTA BARAT,KEBON JERUK,KELAPA DUA,23565,9245,14320,7066,21386,2021-08-22
3175091003,JAKARTA TIMUR,CIRACAS,KELAPA DUA WETAN,46875,16357,30518,16221,46739,2021-08-22
3172061003,JAKARTA UTARA,KELAPA GADING,KELAPA GADING BARAT,35717,11873,23844,16399,40243,2021-08-22
3172061001,JAKARTA UTARA,KELAPA GADING,KELAPA GADING TIMUR,33592,10388,23204,15706,38910,2021-08-22
3173071005,JAKARTA BARAT,PALMERAH,KEMANGGISAN,32139,12265,19874,10470,30344,2021-08-22
3171031001,JAKARTA PUSAT,KEMAYORAN,KEMAYORAN,20708,7653,13055,7178,20233,2021-08-22
3173081006,JAKARTA BARAT,KEMBANGAN,KEMBANGAN SELATAN,27130,10256,16874,9957,26831,2021-08-22
3173081001,JAKARTA BARAT,KEMBANGAN,KEMBANGAN UTARA,54451,20688,33763,17372,51135,2021-08-22
3171041002,JAKARTA PUSAT,SENEN,KENARI,9579,3537,6042,3177,9219,2021-08-22
3173041005,JAKARTA BARAT,TAMBORA,KERENDANG,19973,7385,12588,6650,19238,2021-08-22
3175071003,JAKARTA TIMUR,DUREN SAWIT,KLENDER,69978,29894,40084,18391,58475,2021-08-22
3172031001,JAKARTA UTARA,KOJA,KOJA,28175,11193,16982,9504,26486,2021-08-22
3173071006,JAKARTA BARAT,PALMERAH,KOTA BAMBU SELATAN,21158,8273,12885,6160,19045,2021-08-22
3173071003,JAKARTA BARAT,PALMERAH,KOTA BAMBU UTARA,24995,9986,15009,7358,22367,2021-08-22
3171041004,JAKARTA PUSAT,SENEN,KRAMAT,28835,12153,16682,7790,24472,2021-08-22
3175041001,JAKARTA TIMUR,KRAMAT JATI,KRAMAT JATI,34144,13276,20868,9995,30863,2021-08-22
3174071003,JAKARTA SELATAN,KEBAYORAN BARU,KRAMAT PELA,14413,5193,9220,5399,14619,2021-08-22
3173031002,JAKARTA BARAT,TAMAN SARI,KRUKUT,19244,7137,12107,5808,17915,2021-08-22
3174031005,JAKARTA SELATAN,MAMPANG PRAPATAN,KUNINGAN BARAT,12785,4610,8175,4725,12900,2021-08-22
3174021008,JAKARTA SELATAN,SETIA BUDI,KUNINGAN TIMUR,6008,2224,3784,2374,6158,2021-08-22
3171041005,JAKARTA PUSAT,SENEN,KWITANG,15486,5898,9588,5041,14629,2021-08-22
3172031003,JAKARTA UTARA,KOJA,LAGOA,59065,24152,34913,18109,53022,2021-08-22
3174061002,JAKARTA SELATAN,CILANDAK,LEBAK BULUS,37626,14740,22886,13577,36463,2021-08-22
3174091004,JAKARTA SELATAN,JAGAKARSA,LENTENG AGUNG,53946,21364,32582,16837,49419,2021-08-22
3175101007,JAKARTA TIMUR,CIPAYUNG,LUBANG BUAYA,63547,22527,41020,22377,63397,2021-08-22
3175081001,JAKARTA TIMUR,MAKASAR,MAKASAR,34390,12743,21647,11772,33419,2021-08-22
3175071006,JAKARTA TIMUR,DUREN SAWIT,MALAKA JAYA,30927,11954,18973,11617,30590,2021-08-22
3175071005,JAKARTA TIMUR,DUREN SAWIT,MALAKA SARI,27530,10310,17220,10548,27768,2021-08-22
3174031001,JAKARTA SELATAN,MAMPANG PRAPATAN,MAMPANG PRAPATAN,18159,6876,11283,6693,17976,2021-08-22
3173031005,JAKARTA BARAT,TAMAN SARI,MANGGA BESAR,7707,2509,5198,3254,8452,2021-08-22
3171021005,JAKARTA PUSAT,SAWAH BESAR,MANGGA DUA SELATAN,27442,10167,17275,9673,26948,2021-08-22
3174011007,JAKARTA SELATAN,TEBET,MANGGARAI,28373,10067,18306,9279,27585,2021-08-22
3174011006,JAKARTA SELATAN,TEBET,MANGGARAI SELATAN,23075,8417,14658,8355,23013,2021-08-22
3173031003,JAKARTA BARAT,TAMAN SARI,MAPHAR,16461,6151,10310,6102,16412,2021-08-22
3172041003,JAKARTA UTARA,CILINCING,MARUNDA,28943,10698,18245,7840,26085,2021-08-22
3174071001,JAKARTA SELATAN,KEBAYORAN BARU,MELAWAI,2627,920,1707,1282,2989,2021-08-22
3171061001,JAKARTA PUSAT,MENTENG,MENTENG,25624,10391,15233,8119,23352,2021-08-22
3174021005,JAKARTA SELATAN,SETIA BUDI,MENTENG ATAS,27816,9926,17890,9904,27794,2021-08-22
3174011003,JAKARTA SELATAN,TEBET,MENTENG DALAM,36028,13721,22307,12357,34664,2021-08-22
3173081003,JAKARTA BARAT,KEMBANGAN,MERUYA SELATAN,32130,12273,19857,10176,30033,2021-08-22
3173081002,JAKARTA BARAT,KEMBANGAN,MERUYA UTARA,43752,16836,26916,15234,42150,2021-08-22
3175101004,JAKARTA TIMUR,CIPAYUNG,MUNJUL,23871,8459,15412,7992,23404,2021-08-22
3172051002,JAKARTA UTARA,PADEMANGAN,PADEMANGAN BARAT,74240,29479,44761,23135,67896,2021-08-22
3172051001,JAKARTA UTARA,PADEMANGAN,PADEMANGAN TIMUR,37736,12618,25118,15062,40180,2021-08-22
3175011004,JAKARTA TIMUR,MATRAMAN,PAL MERIAM,19769,8019,11750,6179,17929,2021-08-22
3173071001,JAKARTA BARAT,PALMERAH,PALMERAH,63011,24565,38446,19348,57794,2021-08-22
3174081001,JAKARTA SELATAN,PANCORAN,PANCORAN,19421,7441,11980,6796,18776,2021-08-22
3172021003,JAKARTA UTARA,TANJUNG PRIOK,PAPANGGO,39097,13919,25178,13602,38780,2021-08-22
3171021001,JAKARTA PUSAT,SAWAH BESAR,PASAR BARU,12035,3930,8105,5044,13149,2021-08-22
3174021006,JAKARTA SELATAN,SETIA BUDI,PASAR MANGGIS,26752,10174,16578,9418,25996,2021-08-22
3174041001,JAKARTA SELATAN,PASAR MINGGU,PASAR MINGGU,24821,9383,15438,9297,24735,2021-08-22
3171041003,JAKARTA PUSAT,SENEN,PASEBAN,23533,9265,14268,7512,21780,2021-08-22
3173061005,JAKARTA BARAT,KALI DERES,PEGADUNGAN,75587,26784,48803,25495,74298,2021-08-22
3171061002,JAKARTA PUSAT,MENTENG,PEGANGSAAN,23455,9749,13706,6721,20427,2021-08-22
3172061002,JAKARTA UTARA,KELAPA GADING,PEGANGSAAN DUA,49976,15338,34638,22190,56828,2021-08-22
3172011004,JAKARTA UTARA,PENJARINGAN,PEJAGALAN,74578,27849,46729,27708,74437,2021-08-22
3174041006,JAKARTA SELATAN,PASAR MINGGU,PEJATEN BARAT,37346,14571,22775,13423,36198,2021-08-22
3174041005,JAKARTA SELATAN,PASAR MINGGU,PEJATEN TIMUR,57656,23346,34310,17462,51772,2021-08-22
3175051005,JAKARTA TIMUR,PASAR REBO,PEKAYON,43250,15622,27628,15052,42680,2021-08-22
3173041009,JAKARTA BARAT,TAMBORA,PEKOJAN,23587,8215,15372,8506,23878,2021-08-22
3174031003,JAKARTA SELATAN,MAMPANG PRAPATAN,PELA MAMPANG,43522,16230,27292,16361,43653,2021-08-22
3174081005,JAKARTA SELATAN,PANCORAN,PENGADEGAN,21478,7443,14035,7328,21363,2021-08-22
3175061003,JAKARTA TIMUR,CAKUNG,PENGGILINGAN,99255,42667,56588,25988,82576,2021-08-22
3172011001,JAKARTA UTARA,PENJARINGAN,PENJARINGAN,88308,36943,51365,24798,76163,2021-08-22
3174101001,JAKARTA SELATAN,PESANGGRAHAN,PESANGGRAHAN,27545,9707,17838,10343,28181,2021-08-22
3171071004,JAKARTA PUSAT,TANAH ABANG,PETAMBURAN,33271,15959,17312,7902,25214,2021-08-22
3174071008,JAKARTA SELATAN,KEBAYORAN BARU,PETOGOGAN,11499,4414,7085,4391,11476,2021-08-22
3171011004,JAKARTA PUSAT,GAMBIR,PETOJO SELATAN,14692,5647,9045,5275,14320,2021-08-22
3171011003,JAKARTA PUSAT,GAMBIR,PETOJO UTARA,17458,6568,10890,5490,16380,2021-08-22
3174101004,JAKARTA SELATAN,PESANGGRAHAN,PETUKANGAN SELATAN,37187,14066,23121,12797,35918,2021-08-22
3174101003,JAKARTA SELATAN,PESANGGRAHAN,PETUKANGAN UTARA,53716,21546,32170,17871,50041,2021-08-22
3175081002,JAKARTA TIMUR,MAKASAR,PINANG RANTI,27198,10534,16664,9326,25990,2021-08-22
3173031008,JAKARTA BARAT,TAMAN SARI,PINANGSIA,10729,3662,7067,4140,11207,2021-08-22
3175011001,JAKARTA TIMUR,MATRAMAN,PISANGAN BARU,31776,13058,18718,8700,27418,2021-08-22
3175021002,JAKARTA TIMUR,PULO GADUNG,PISANGAN TIMUR,41011,15053,25958,12975,38933,2021-08-22
3172011005,JAKARTA UTARA,PENJARINGAN,PLUIT,47783,17289,30494,20768,51262,2021-08-22
3175071002,JAKARTA TIMUR,DUREN SAWIT,PONDOK BAMBU,61550,25540,36010,18632,54642,2021-08-22
3175071004,JAKARTA TIMUR,DUREN SAWIT,PONDOK KELAPA,72015,27566,44449,23133,67582,2021-08-22
3175071007,JAKARTA TIMUR,DUREN SAWIT,PONDOK KOPI,35367,15430,19937,9906,29843,2021-08-22
3174061003,JAKARTA SELATAN,CILANDAK,PONDOK LABU,46464,16775,29689,18699,48388,2021-08-22
3174051002,JAKARTA SELATAN,KEBAYORAN LAMA,PONDOK PINANG,56169,21484,34685,20427,55112,2021-08-22
3175101003,JAKARTA TIMUR,CIPAYUNG,PONDOK RANGGON,25574,9375,16199,8321,24520,2021-08-22
3101011003,KAB.ADM.KEP.SERIBU,KEP. SERIBU UTARA,PULAU HARAPAN,2060,354,1706,974,2680,2021-08-22
3101011002,KAB.ADM.KEP.SERIBU,KEP. SERIBU UTARA,PULAU KELAPA,5528,958,4570,2387,6957,2021-08-22
3101011001,KAB.ADM.KEP.SERIBU,KEP. SERIBU UTARA,PULAU PANGGANG,5450,916,4534,2016,6550,2021-08-22
3101021003,KAB.ADM.KEP.SERIBU,KEP. SERIBU SELATAN,PULAU PARI,2765,333,2432,1352,3784,2021-08-22
3101021002,KAB.ADM.KEP.SERIBU,KEP. SERIBU SELATAN,PULAU TIDUNG,4553,676,3877,2563,6440,2021-08-22
3101021001,KAB.ADM.KEP.SERIBU,KEP. SERIBU SELATAN,PULAU UNTUNG JAWA,1941,335,1606,835,2441,2021-08-22
3174071007,JAKARTA SELATAN,KEBAYORAN BARU,PULO,5835,2038,3797,2660,6457,2021-08-22
3175021001,JAKARTA TIMUR,PULO GADUNG,PULO GADUNG,34422,13493,20929,10986,31915,2021-08-22
3175061005,JAKARTA TIMUR,CAKUNG,PULO GEBANG,97301,39082,58219,28746,86965,2021-08-22
3174041004,JAKARTA SELATAN,PASAR MINGGU,RAGUNAN,39616,14391,25225,14858,40083,2021-08-22
3175091005,JAKARTA TIMUR,CIRACAS,RAMBUTAN,36771,15870,20901,10631,31532,2021-08-22
3172031006,JAKARTA UTARA,KOJA,RAWA BADAK SELATAN,42179,17878,24301,12165,36466,2021-08-22
3172031004,JAKARTA UTARA,KOJA,RAWA BADAK UTARA,34408,14206,20202,10857,31059,2021-08-22
3174071005,JAKARTA SELATAN,KEBAYORAN BARU,RAWA BARAT,5625,1957,3668,2425,6093,2021-08-22
3173011003,JAKARTA BARAT,CENGKARENG,RAWA BUAYA,63799,25006,38793,18074,56867,2021-08-22
3175031004,JAKARTA TIMUR,JATINEGARA,RAWA BUNGA,21434,8930,12504,6355,18859,2021-08-22
3174081003,JAKARTA SELATAN,PANCORAN,RAWA JATI,20509,7703,12806,7205,20011,2021-08-22
3175061002,JAKARTA TIMUR,CAKUNG,RAWA TERATE,24637,8733,15904,7437,23341,2021-08-22
3175021005,JAKARTA TIMUR,PULO GADUNG,RAWAMANGUN,37612,14741,22871,12583,35454,2021-08-22
3171051003,JAKARTA PUSAT,CEMPAKA PUTIH,RAWASARI,21967,8561,13406,7732,21138,2021-08-22
3173041010,JAKARTA BARAT,TAMBORA,ROA MALAKA,3484,1080,2404,1532,3936,2021-08-22
3172041006,JAKARTA UTARA,CILINCING,ROROTAN,41668,15111,26557,13453,40010,2021-08-22
3174071004,JAKARTA SELATAN,KEBAYORAN BARU,SELONG,2842,1009,1833,1341,3174,2021-08-22
3173061002,JAKARTA BARAT,KALI DERES,SEMANAN,71354,28146,43208,17920,61128,2021-08-22
3172041007,JAKARTA UTARA,CILINCING,SEMPER BARAT,68587,24281,44306,24490,68796,2021-08-22
3172041005,JAKARTA UTARA,CILINCING,SEMPER TIMUR,36267,13395,22872,12046,34918,2021-08-22
3174071006,JAKARTA SELATAN,KEBAYORAN BARU,SENAYAN,2771,1178,1593,1030,2623,2021-08-22
3171041001,JAKARTA PUSAT,SENEN,SENEN,6804,2459,4345,2541,6886,2021-08-22
3171031004,JAKARTA PUSAT,KEMAYORAN,SERDANG,29668,11353,18315,9635,27950,2021-08-22
3174021001,JAKARTA SELATAN,SETIA BUDI,SETIA BUDI,3023,1155,1868,1177,3045,2021-08-22
3175101005,JAKARTA TIMUR,CIPAYUNG,SETU,20572,8107,12465,5865,18330,2021-08-22
3173071002,JAKARTA BARAT,PALMERAH,SLIPI,16591,6077,10514,5947,16461,2021-08-22
3173081004,JAKARTA BARAT,KEMBANGAN,SRENGSENG,45523,18396,27127,14086,41213,2021-08-22
3174091002,JAKARTA SELATAN,JAGAKARSA,SRENGSENG SAWAH,58196,19405,38791,22904,61695,2021-08-22
3173051003,JAKARTA BARAT,KEBON JERUK,SUKABUMI SELATAN,37033,15193,21840,9667,31507,2021-08-22
3173051002,JAKARTA BARAT,KEBON JERUK,SUKABUMI UTARA,38290,16635,21655,9996,31651,2021-08-22
3172041002,JAKARTA UTARA,CILINCING,SUKAPURA,53949,21137,32812,17872,50684,2021-08-22
3171031007,JAKARTA PUSAT,KEMAYORAN,SUMUR BATU,22717,8881,13836,7807,21643,2021-08-22
3172021004,JAKARTA UTARA,TANJUNG PRIOK,SUNGAI BAMBU,29876,11157,18719,10182,28901,2021-08-22
3172021006,JAKARTA UTARA,TANJUNG PRIOK,SUNTER AGUNG,71805,23818,47987,29704,77691,2021-08-22
3172021002,JAKARTA UTARA,TANJUNG PRIOK,SUNTER JAYA,63031,21524,41507,24417,65924,2021-08-22
3175091004,JAKARTA TIMUR,CIRACAS,SUSUKAN,38257,13554,24703,12543,37246,2021-08-22
3173031001,JAKARTA BARAT,TAMAN SARI,TAMAN SARI,14348,5309,9039,5540,14579,2021-08-22
3173041001,JAKARTA BARAT,TAMBORA,TAMBORA,10204,3915,6289,3205,9494,2021-08-22
3173041004,JAKARTA BARAT,TAMBORA,TANAH SEREAL,26387,8604,17783,8854,26637,2021-08-22
3171081004,JAKARTA PUSAT,JOHAR BARU,TANAH TINGGI,37693,12258,25435,12532,37967,2021-08-22
3173031004,JAKARTA BARAT,TAMAN SARI,TANGKI,13324,4912,8412,4939,13351,2021-08-22
3174091005,JAKARTA SELATAN,JAGAKARSA,TANJUNG BARAT,39770,14678,25092,13240,38332,2021-08-22
3173021005,JAKARTA BARAT,GROGOL PETAMBURAN,TANJUNG DUREN SELATAN,25337,9274,16063,9438,25501,2021-08-22
3173021002,JAKARTA BARAT,GROGOL PETAMBURAN,TANJUNG DUREN UTARA,17010,5927,11083,6577,17660,2021-08-22
3172021001,JAKARTA UTARA,TANJUNG PRIOK,TANJUNG PRIOK,34588,12282,22306,11091,33397,2021-08-22
3174011002,JAKARTA SELATAN,TEBET,TEBET BARAT,21194,7352,13842,8528,22370,2021-08-22
3174011001,JAKARTA SELATAN,TEBET,TEBET TIMUR,18199,6325,11874,7372,19246,2021-08-22
3173061003,JAKARTA BARAT,KALI DERES,TEGAL ALUR,83647,31558,52089,22706,74795,2021-08-22
3174031004,JAKARTA SELATAN,MAMPANG PRAPATAN,TEGAL PARANG,32401,13003,19398,10170,29568,2021-08-22
3173021003,JAKARTA BARAT,GROGOL PETAMBURAN,TOMANG,29605,10812,18793,11553,30346,2021-08-22
3172031005,JAKARTA UTARA,KOJA,TUGU SELATAN,39122,16150,22972,11708,34680,2021-08-22
3172031002,JAKARTA UTARA,KOJA,TUGU UTARA,67670,28245,39425,20861,60286,2021-08-22
3175061006,JAKARTA TIMUR,CAKUNG,UJUNG MENTENG,29934,10667,19267,10000,29267,2021-08-22
3174101005,JAKARTA SELATAN,PESANGGRAHAN,ULUJAMI,40544,16661,23883,12354,36237,2021-08-22
3175011006,JAKARTA TIMUR,MATRAMAN,UTAN KAYU SELATAN,33511,12538,20973,11252,32225,2021-08-22
3175011002,JAKARTA TIMUR,MATRAMAN,UTAN KAYU UTARA,28169,11394,16775,8739,25514,2021-08-22
3171031008,JAKARTA PUSAT,KEMAYORAN,UTAN PANJANG,29208,11559,17649,8685,26334,2021-08-22
3172021007,JAKARTA UTARA,TANJUNG PRIOK,WARAKAS,44401,16532,27869,14778,42647,2021-08-22
3173021007,JAKARTA BARAT,GROGOL PETAMBURAN,WIJAYA KUSUMA,38934,15091,23843,13203,37046,2021-08-22
3172051003,JAKARTA UTARA,PADEMANGAN,ANCOL,23947,9527,14420,7636,22056,2021-08-23
3173041007,JAKARTA BARAT,TAMBORA,ANGKE,29381,10722,18659,9045,27704,2021-08-23
3175041005,JAKARTA TIMUR,KRAMAT JATI,BALE KAMBANG,29074,13133,15941,6320,22261,2021-08-23
3175031003,JAKARTA TIMUR,JATINEGARA,BALI MESTER,9752,3887,5865,3143,9008,2021-08-23
3175101006,JAKARTA TIMUR,CIPAYUNG,BAMBU APUS,26285,9889,16396,8245,24641,2021-08-23
3174031002,JAKARTA SELATAN,MAMPANG PRAPATAN,BANGKA,21566,8559,13007,7433,20440,2021-08-23
3175051002,JAKARTA TIMUR,PASAR REBO,BARU,23886,8101,15785,10104,25889,2021-08-23
3175041004,JAKARTA TIMUR,KRAMAT JATI,BATU AMPAR,47898,20935,26963,12332,39295,2021-08-23
3171071002,JAKARTA PUSAT,TANAH ABANG,BENDUNGAN HILIR,21494,8294,13200,7651,20851,2021-08-23
3175031002,JAKARTA TIMUR,JATINEGARA,BIDARA CINA,36689,16349,20340,9777,30117,2021-08-23
3174101002,JAKARTA SELATAN,PESANGGRAHAN,BINTARO,53098,20483,32615,19373,51988,2021-08-23
3174011005,JAKARTA SELATAN,TEBET,BUKIT DURI,34183,14002,20181,10760,30941,2021-08-23
3171041006,JAKARTA PUSAT,SENEN,BUNGUR,18144,6859,11285,6064,17349,2021-08-23
3175061007,JAKARTA TIMUR,CAKUNG,CAKUNG BARAT,57724,20687,37037,17999,55036,2021-08-23
3175061004,JAKARTA TIMUR,CAKUNG,CAKUNG TIMUR,58287,21265,37022,19850,56872,2021-08-23
3175041007,JAKARTA TIMUR,KRAMAT JATI,CAWANG,32762,13756,19006,9634,28640,2021-08-23
3175101008,JAKARTA TIMUR,CIPAYUNG,CEGER,18932,7045,11887,5797,17684,2021-08-23
3171031006,JAKARTA PUSAT,KEMAYORAN,CEMPAKA BARU,32581,13277,19304,10011,29315,2021-08-23
3171051002,JAKARTA PUSAT,CEMPAKA PUTIH,CEMPAKA PUTIH BARAT,35885,14062,21823,12567,34390,2021-08-23
3171051001,JAKARTA PUSAT,CEMPAKA PUTIH,CEMPAKA PUTIH TIMUR,24292,9225,15067,8869,23936,2021-08-23
3173011001,JAKARTA BARAT,CENGKARENG,CENGKARENG BARAT,66284,24638,41646,23642,65288,2021-08-23
3173011006,JAKARTA BARAT,CENGKARENG,CENGKARENG TIMUR,81027,29673,51354,24551,75905,2021-08-23
3175091002,JAKARTA TIMUR,CIRACAS,CIBUBUR,66364,23659,42705,24350,67055,2021-08-23
3171011002,JAKARTA PUSAT,GAMBIR,CIDENG,15390,5367,10023,6049,16072,2021-08-23
3174091003,JAKARTA SELATAN,JAGAKARSA,CIGANJUR,38497,14307,24190,13563,37753,2021-08-23
3175051003,JAKARTA TIMUR,PASAR REBO,CIJANTUNG,41419,14814,26605,14837,41442,2021-08-23
3171061003,JAKARTA PUSAT,MENTENG,CIKINI,8274,3439,4835,2698,7533,2021-08-23
3174081006,JAKARTA SELATAN,PANCORAN,CIKOKO,10547,3728,6819,3662,10481,2021-08-23
3174061001,JAKARTA SELATAN,CILANDAK,CILANDAK BARAT,51752,19152,32600,19493,52093,2021-08-23
3174041003,JAKARTA SELATAN,PASAR MINGGU,CILANDAK TIMUR,25145,9143,16002,10183,26185,2021-08-23
3175101002,JAKARTA TIMUR,CIPAYUNG,CILANGKAP,27635,10067,17568,9063,26631,2021-08-23
3175041006,JAKARTA TIMUR,KRAMAT JATI,CILILITAN,40181,17182,22999,11512,34511,2021-08-23
3172041001,JAKARTA UTARA,CILINCING,CILINCING,43609,17549,26060,13274,39334,2021-08-23
3175101001,JAKARTA TIMUR,CIPAYUNG,CIPAYUNG,26104,9016,17088,9489,26577,2021-08-23
3174091006,JAKARTA SELATAN,JAGAKARSA,CIPEDAK,38303,13165,25138,14963,40101,2021-08-23
3174061005,JAKARTA SELATAN,CILANDAK,CIPETE SELATAN,26704,10411,16293,10432,26725,2021-08-23
3174071010,JAKARTA SELATAN,KEBAYORAN BARU,CIPETE UTARA,34102,12904,21198,12299,33497,2021-08-23
3175021003,JAKARTA TIMUR,PULO GADUNG,CIPINANG,39306,15359,23947,13107,37054,2021-08-23
3175031007,JAKARTA TIMUR,JATINEGARA,CIPINANG BESAR SELATAN,35212,15558,19654,9315,28969,2021-08-23
3175031008,JAKARTA TIMUR,JATINEGARA,CIPINANG BESAR UTARA,45319,19281,26038,11467,37505,2021-08-23
3175031005,JAKARTA TIMUR,JATINEGARA,CIPINANG CEMPEDAK,32824,13931,18893,10599,29492,2021-08-23
3175081005,JAKARTA TIMUR,MAKASAR,CIPINANG MELAYU,42308,16825,25483,14301,39784,2021-08-23
3175031006,JAKARTA TIMUR,JATINEGARA,CIPINANG MUARA,55243,23281,31962,15694,47656,2021-08-23
3174051003,JAKARTA SELATAN,KEBAYORAN LAMA,CIPULIR,39937,16423,23514,11996,35510,2021-08-23
3175091001,JAKARTA TIMUR,CIRACAS,CIRACAS,64594,23027,41567,21788,63355,2021-08-23
3175041003,JAKARTA TIMUR,KRAMAT JATI,DUKUH,24609,9115,15494,7563,23057,2021-08-23
3175071001,JAKARTA TIMUR,DUREN SAWIT,DUREN SAWIT,61160,25437,35723,19237,54960,2021-08-23
3174081004,JAKARTA SELATAN,PANCORAN,DUREN TIGA,28319,10856,17463,8867,26330,2021-08-23
3173051005,JAKARTA BARAT,KEBON JERUK,DURI KEPA,60138,21659,38479,21938,60417,2021-08-23
3173011002,JAKARTA BARAT,CENGKARENG,DURI KOSAMBI,77923,32091,45832,22566,68398,2021-08-23
3171011006,JAKARTA PUSAT,GAMBIR,DURI PULO,19610,7241,12369,6407,18776,2021-08-23
3173041011,JAKARTA BARAT,TAMBORA,DURI SELATAN,14259,4864,9395,5158,14553,2021-08-23
3173041003,JAKARTA BARAT,TAMBORA,DURI UTARA,19844,7050,12794,6454,19248,2021-08-23
3171081003,JAKARTA PUSAT,JOHAR BARU,GALUR,18243,5947,12296,6127,18423,2021-08-23
3171011001,JAKARTA PUSAT,GAMBIR,GAMBIR,2191,768,1423,855,2278,2021-08-23
3174061004,JAKARTA SELATAN,CILANDAK,GANDARIA SELATAN,22119,8471,13648,7620,21268,2021-08-23
3174071009,JAKARTA SELATAN,KEBAYORAN BARU,GANDARIA UTARA,39922,15395,24527,14143,38670,2021-08-23
3175051001,JAKARTA TIMUR,PASAR REBO,GEDONG,35755,13226,22529,12176,34705,2021-08-23
3171071001,JAKARTA PUSAT,TANAH ABANG,GELORA,3127,1258,1869,1027,2896,2021-08-23
3173031007,JAKARTA BARAT,TAMAN SARI,GLODOK,7837,2514,5323,3452,8775,2021-08-23
3171061004,JAKARTA PUSAT,MENTENG,GONDANGDIA,4100,1563,2537,1862,4399,2021-08-23
3173021001,JAKARTA BARAT,GROGOL PETAMBURAN,GROGOL,16876,6383,10493,5975,16468,2021-08-23
3174051005,JAKARTA SELATAN,KEBAYORAN LAMA,GROGOL SELATAN,44251,17502,26749,14180,40929,2021-08-23
3174051004,JAKARTA SELATAN,KEBAYORAN LAMA,GROGOL UTARA,42494,16580,25914,13624,39538,2021-08-23
3174021007,JAKARTA SELATAN,SETIA BUDI,GUNTUR,3985,1444,2541,1745,4286,2021-08-23
3174071002,JAKARTA SELATAN,KEBAYORAN BARU,GUNUNG,9436,3430,6006,4018,10024,2021-08-23
3171031005,JAKARTA PUSAT,KEMAYORAN,GUNUNG SAHARI SELATAN,19199,7407,11792,6796,18588,2021-08-23
3171021004,JAKARTA PUSAT,SAWAH BESAR,GUNUNG SAHARI UTARA,16650,5497,11153,6825,17978,2021-08-23
3175081004,JAKARTA TIMUR,MAKASAR,HALIM PERDANA KUSUMAH,28363,8267,20096,14939,35035,2021-08-23
3171031003,JAKARTA PUSAT,KEMAYORAN,HARAPAN MULIA,22557,8807,13750,7132,20882,2021-08-23
3174091001,JAKARTA SELATAN,JAGAKARSA,JAGAKARSA,62389,22414,39975,24079,64054,2021-08-23
3175021007,JAKARTA TIMUR,PULO GADUNG,JATI,32757,12626,20131,11302,31433,2021-08-23
3174041002,JAKARTA SELATAN,PASAR MINGGU,JATI PADANG,37502,14297,23205,13690,36895,2021-08-23
3173071004,JAKARTA BARAT,PALMERAH,JATI PULO,28738,10612,18126,8950,27076,2021-08-23
3175061001,JAKARTA TIMUR,CAKUNG,JATINEGARA,84160,33406,50754,23563,74317,2021-08-23
3175021004,JAKARTA TIMUR,PULO GADUNG,JATINEGARA KAUM,24632,8753,15879,7346,23225,2021-08-23
3173021004,JAKARTA BARAT,GROGOL PETAMBURAN,JELAMBAR,30266,11243,19023,11684,30707,2021-08-23
3173021006,JAKARTA BARAT,GROGOL PETAMBURAN,JELAMBAR BARU,38246,14240,24006,14209,38215,2021-08-23
3173041006,JAKARTA BARAT,TAMBORA,JEMBATAN BESI,29314,12870,16444,7436,23880,2021-08-23
3173041008,JAKARTA BARAT,TAMBORA,JEMBATAN LIMA,21021,8491,12530,6153,18683,2021-08-23
3173081005,JAKARTA BARAT,KEMBANGAN,JOGLO,40839,15842,24997,13117,38114,2021-08-23
3171081001,JAKARTA PUSAT,JOHAR BARU,JOHAR BARU,37488,12725,24763,13599,38362,2021-08-23
3173041002,JAKARTA BARAT,TAMBORA,KALI ANYAR,23856,8553,15303,6512,21815,2021-08-23
3172041004,JAKARTA UTARA,CILINCING,KALIBARU,67684,29152,38532,18050,56582,2021-08-23
3174081002,JAKARTA SELATAN,PANCORAN,KALIBATA,41994,17806,24188,12147,36335,2021-08-23
3173061001,JAKARTA BARAT,KALI DERES,KALIDERES,72447,27584,44863,24043,68906,2021-08-23
3175051004,JAKARTA TIMUR,PASAR REBO,KALISARI,43212,15794,27418,15375,42793,2021-08-23
3173061004,JAKARTA BARAT,KALI DERES,KAMAL,53783,21141,32642,13109,45751,2021-08-23
3172011002,JAKARTA UTARA,PENJARINGAN,KAMAL MUARA,12930,3783,9147,6066,15213,2021-08-23
3171071007,JAKARTA PUSAT,TANAH ABANG,KAMPUNG BALI,11358,4939,6419,3355,9774,2021-08-23
3175031001,JAKARTA TIMUR,JATINEGARA,KAMPUNG MELAYU,25717,10973,14744,6960,21704,2021-08-23
3171081002,JAKARTA PUSAT,JOHAR BARU,KAMPUNG RAWA,21237,6117,15120,7604,22724,2021-08-23
3175041002,JAKARTA TIMUR,KRAMAT JATI,KAMPUNG TENGAH,43993,19103,24890,11593,36483,2021-08-23
3173011005,JAKARTA BARAT,CENGKARENG,KAPUK,134466,55349,79117,35134,114251,2021-08-23
3172011003,JAKARTA UTARA,PENJARINGAN,KAPUK MUARA,35781,11937,23844,15451,39295,2021-08-23
3171021002,JAKARTA PUSAT,SAWAH BESAR,KARANG ANYAR,25761,9093,16668,8656,25324,2021-08-23
3174021004,JAKARTA SELATAN,SETIA BUDI,KARET,9623,3750,5873,3414,9287,2021-08-23
3174021003,JAKARTA SELATAN,SETIA BUDI,KARET KUNINGAN,16055,5541,10514,6396,16910,2021-08-23
3174021002,JAKARTA SELATAN,SETIA BUDI,KARET SEMANGGI,2770,970,1800,1288,3088,2021-08-23
3171071003,JAKARTA PUSAT,TANAH ABANG,KARET TENGSIN,19271,7407,11864,6211,18075,2021-08-23
3171021003,JAKARTA PUSAT,SAWAH BESAR,KARTINI,22292,8145,14147,8249,22396,2021-08-23
3175011003,JAKARTA TIMUR,MATRAMAN,KAYU MANIS,25284,10496,14788,7262,22050,2021-08-23
3175021006,JAKARTA TIMUR,PULO GADUNG,KAYU PUTIH,40696,14715,25981,15606,41587,2021-08-23
3173031006,JAKARTA BARAT,TAMAN SARI,KEAGUNGAN,17387,6252,11135,6277,17412,2021-08-23
3174041007,JAKARTA SELATAN,PASAR MINGGU,KEBAGUSAN,44552,17588,26964,14634,41598,2021-08-23
3174051006,JAKARTA SELATAN,KEBAYORAN LAMA,KEBAYORAN LAMA SELATAN,41212,15227,25985,14687,40672,2021-08-23
3174051001,JAKARTA SELATAN,KEBAYORAN LAMA,KEBAYORAN LAMA UTARA,42422,17013,25409,12828,38237,2021-08-23
3174011004,JAKARTA SELATAN,TEBET,KEBON BARU,35165,13472,21693,11775,33468,2021-08-23
3172021005,JAKARTA UTARA,TANJUNG PRIOK,KEBON BAWANG,50952,19310,31642,17525,49167,2021-08-23
3173051001,JAKARTA BARAT,KEBON JERUK,KEBON JERUK,53887,21948,31939,16091,48030,2021-08-23
3171071006,JAKARTA PUSAT,TANAH ABANG,KEBON KACANG,21531,9857,11674,5938,17612,2021-08-23
3171011005,JAKARTA PUSAT,GAMBIR,KEBON KELAPA,10163,3764,6399,3589,9988,2021-08-23
3171031002,JAKARTA PUSAT,KEMAYORAN,KEBON KOSONG,30019,11776,18243,9905,28148,2021-08-23
3175011005,JAKARTA TIMUR,MATRAMAN,KEBON MANGGIS,16490,6183,10307,5902,16209,2021-08-23
3171071005,JAKARTA PUSAT,TANAH ABANG,KEBON MELATI,32206,15547,16659,7989,24648,2021-08-23
3175081003,JAKARTA TIMUR,MAKASAR,KEBON PALA,46614,17577,29037,14797,43834,2021-08-23
3171061005,JAKARTA PUSAT,MENTENG,KEBON SIRIH,12299,5183,7116,3730,10846,2021-08-23
3173011004,JAKARTA BARAT,CENGKARENG,KEDAUNG KALI ANGKE,32612,11303,21309,11570,32879,2021-08-23
3173051007,JAKARTA BARAT,KEBON JERUK,KEDOYA SELATAN,32165,11856,20309,10314,30623,2021-08-23
3173051006,JAKARTA BARAT,KEBON JERUK,KEDOYA UTARA,45740,15812,29928,16161,46089,2021-08-23
3173051004,JAKARTA BARAT,KEBON JERUK,KELAPA DUA,23565,9239,14326,7091,21417,2021-08-23
3175091003,JAKARTA TIMUR,CIRACAS,KELAPA DUA WETAN,46875,16354,30521,16260,46781,2021-08-23
3172061003,JAKARTA UTARA,KELAPA GADING,KELAPA GADING BARAT,35717,11863,23854,16433,40287,2021-08-23
3172061001,JAKARTA UTARA,KELAPA GADING,KELAPA GADING TIMUR,33592,10340,23252,15742,38994,2021-08-23
3173071005,JAKARTA BARAT,PALMERAH,KEMANGGISAN,32139,12258,19881,10546,30427,2021-08-23
3171031001,JAKARTA PUSAT,KEMAYORAN,KEMAYORAN,20708,7649,13059,7212,20271,2021-08-23
3173081006,JAKARTA BARAT,KEMBANGAN,KEMBANGAN SELATAN,27130,10249,16881,10033,26914,2021-08-23
3173081001,JAKARTA BARAT,KEMBANGAN,KEMBANGAN UTARA,54451,20674,33777,17444,51221,2021-08-23
3171041002,JAKARTA PUSAT,SENEN,KENARI,9579,3536,6043,3193,9236,2021-08-23
3173041005,JAKARTA BARAT,TAMBORA,KERENDANG,19973,7380,12593,6688,19281,2021-08-23
3175071003,JAKARTA TIMUR,DUREN SAWIT,KLENDER,69978,29873,40105,18453,58558,2021-08-23
3172031001,JAKARTA UTARA,KOJA,KOJA,28175,11172,17003,9545,26548,2021-08-23
3173071006,JAKARTA BARAT,PALMERAH,KOTA BAMBU SELATAN,21158,8268,12890,6168,19058,2021-08-23
3173071003,JAKARTA BARAT,PALMERAH,KOTA BAMBU UTARA,24995,9981,15014,7375,22389,2021-08-23
3171041004,JAKARTA PUSAT,SENEN,KRAMAT,28835,11947,16888,8005,24893,2021-08-23
3175041001,JAKARTA TIMUR,KRAMAT JATI,KRAMAT JATI,34144,13274,20870,10023,30893,2021-08-23
3174071003,JAKARTA SELATAN,KEBAYORAN BARU,KRAMAT PELA,14413,5191,9222,5413,14635,2021-08-23
3173031002,JAKARTA BARAT,TAMAN SARI,KRUKUT,19244,7135,12109,5828,17937,2021-08-23
3174031005,JAKARTA SELATAN,MAMPANG PRAPATAN,KUNINGAN BARAT,12785,4605,8180,4735,12915,2021-08-23
3174021008,JAKARTA SELATAN,SETIA BUDI,KUNINGAN TIMUR,6008,2220,3788,2377,6165,2021-08-23
3171041005,JAKARTA PUSAT,SENEN,KWITANG,15486,5892,9594,5058,14652,2021-08-23
3172031003,JAKARTA UTARA,KOJA,LAGOA,59065,24051,35014,18424,53438,2021-08-23
3174061002,JAKARTA SELATAN,CILANDAK,LEBAK BULUS,37626,14717,22909,13645,36554,2021-08-23
3174091004,JAKARTA SELATAN,JAGAKARSA,LENTENG AGUNG,53946,21157,32789,17081,49870,2021-08-23
3175101007,JAKARTA TIMUR,CIPAYUNG,LUBANG BUAYA,63547,22518,41029,22427,63456,2021-08-23
3175081001,JAKARTA TIMUR,MAKASAR,MAKASAR,34390,12721,21669,11817,33486,2021-08-23
3175071006,JAKARTA TIMUR,DUREN SAWIT,MALAKA JAYA,30927,11940,18987,11649,30636,2021-08-23
3175071005,JAKARTA TIMUR,DUREN SAWIT,MALAKA SARI,27530,10303,17227,10570,27797,2021-08-23
3174031001,JAKARTA SELATAN,MAMPANG PRAPATAN,MAMPANG PRAPATAN,18159,6822,11337,6705,18042,2021-08-23
3173031005,JAKARTA BARAT,TAMAN SARI,MANGGA BESAR,7707,2504,5203,3258,8461,2021-08-23
3171021005,JAKARTA PUSAT,SAWAH BESAR,MANGGA DUA SELATAN,27442,10166,17276,9683,26959,2021-08-23
3174011007,JAKARTA SELATAN,TEBET,MANGGARAI,28373,10063,18310,9334,27644,2021-08-23
3174011006,JAKARTA SELATAN,TEBET,MANGGARAI SELATAN,23075,8412,14663,8367,23030,2021-08-23
3173031003,JAKARTA BARAT,TAMAN SARI,MAPHAR,16461,6146,10315,6144,16459,2021-08-23
3172041003,JAKARTA UTARA,CILINCING,MARUNDA,28943,10667,18276,7854,26130,2021-08-23
3174071001,JAKARTA SELATAN,KEBAYORAN BARU,MELAWAI,2627,920,1707,1285,2992,2021-08-23
3171061001,JAKARTA PUSAT,MENTENG,MENTENG,25624,10338,15286,8172,23458,2021-08-23
3174021005,JAKARTA SELATAN,SETIA BUDI,MENTENG ATAS,27816,9919,17897,9921,27818,2021-08-23
3174011003,JAKARTA SELATAN,TEBET,MENTENG DALAM,36028,13710,22318,12379,34697,2021-08-23
3173081003,JAKARTA BARAT,KEMBANGAN,MERUYA SELATAN,32130,12245,19885,10310,30195,2021-08-23
3173081002,JAKARTA BARAT,KEMBANGAN,MERUYA UTARA,43752,16793,26959,15313,42272,2021-08-23
3175101004,JAKARTA TIMUR,CIPAYUNG,MUNJUL,23871,8452,15419,8000,23419,2021-08-23
3172051002,JAKARTA UTARA,PADEMANGAN,PADEMANGAN BARAT,74240,29458,44782,23260,68042,2021-08-23
3172051001,JAKARTA UTARA,PADEMANGAN,PADEMANGAN TIMUR,37736,12601,25135,15125,40260,2021-08-23
3175011004,JAKARTA TIMUR,MATRAMAN,PAL MERIAM,19769,8011,11758,6207,17965,2021-08-23
3173071001,JAKARTA BARAT,PALMERAH,PALMERAH,63011,24547,38464,19412,57876,2021-08-23
3174081001,JAKARTA SELATAN,PANCORAN,PANCORAN,19421,7432,11989,6812,18801,2021-08-23
3172021003,JAKARTA UTARA,TANJUNG PRIOK,PAPANGGO,39097,13906,25191,13656,38847,2021-08-23
3171021001,JAKARTA PUSAT,SAWAH BESAR,PASAR BARU,12035,3922,8113,5057,13170,2021-08-23
3174021006,JAKARTA SELATAN,SETIA BUDI,PASAR MANGGIS,26752,10171,16581,9438,26019,2021-08-23
3174041001,JAKARTA SELATAN,PASAR MINGGU,PASAR MINGGU,24821,9377,15444,9321,24765,2021-08-23
3171041003,JAKARTA PUSAT,SENEN,PASEBAN,23533,9257,14276,7577,21853,2021-08-23
3173061005,JAKARTA BARAT,KALI DERES,PEGADUNGAN,75587,26760,48827,25751,74578,2021-08-23
3171061002,JAKARTA PUSAT,MENTENG,PEGANGSAAN,23455,9621,13834,6781,20615,2021-08-23
3172061002,JAKARTA UTARA,KELAPA GADING,PEGANGSAAN DUA,49976,15299,34677,22249,56926,2021-08-23
3172011004,JAKARTA UTARA,PENJARINGAN,PEJAGALAN,74578,27818,46760,27805,74565,2021-08-23
3174041006,JAKARTA SELATAN,PASAR MINGGU,PEJATEN BARAT,37346,14564,22782,13459,36241,2021-08-23
3174041005,JAKARTA SELATAN,PASAR MINGGU,PEJATEN TIMUR,57656,23312,34344,17505,51849,2021-08-23
3175051005,JAKARTA TIMUR,PASAR REBO,PEKAYON,43250,15612,27638,15072,42710,2021-08-23
3173041009,JAKARTA BARAT,TAMBORA,PEKOJAN,23587,8207,15380,8529,23909,2021-08-23
3174031003,JAKARTA SELATAN,MAMPANG PRAPATAN,PELA MAMPANG,43522,16207,27315,16408,43723,2021-08-23
3174081005,JAKARTA SELATAN,PANCORAN,PENGADEGAN,21478,7438,14040,7339,21379,2021-08-23
3175061003,JAKARTA TIMUR,CAKUNG,PENGGILINGAN,99255,42628,56627,26159,82786,2021-08-23
3172011001,JAKARTA UTARA,PENJARINGAN,PENJARINGAN,88308,36895,51413,24911,76324,2021-08-23
3174101001,JAKARTA SELATAN,PESANGGRAHAN,PESANGGRAHAN,27545,9688,17857,10382,28239,2021-08-23
3171071004,JAKARTA PUSAT,TANAH ABANG,PETAMBURAN,33271,15943,17328,7936,25264,2021-08-23
3174071008,JAKARTA SELATAN,KEBAYORAN BARU,PETOGOGAN,11499,4409,7090,4408,11498,2021-08-23
3171011004,JAKARTA PUSAT,GAMBIR,PETOJO SELATAN,14692,5644,9048,5286,14334,2021-08-23
3171011003,JAKARTA PUSAT,GAMBIR,PETOJO UTARA,17458,6565,10893,5512,16405,2021-08-23
3174101004,JAKARTA SELATAN,PESANGGRAHAN,PETUKANGAN SELATAN,37187,14060,23127,12838,35965,2021-08-23
3174101003,JAKARTA SELATAN,PESANGGRAHAN,PETUKANGAN UTARA,53716,21542,32174,17948,50122,2021-08-23
3175081002,JAKARTA TIMUR,MAKASAR,PINANG RANTI,27198,10531,16667,9360,26027,2021-08-23
3173031008,JAKARTA BARAT,TAMAN SARI,PINANGSIA,10729,3660,7069,4151,11220,2021-08-23
3175011001,JAKARTA TIMUR,MATRAMAN,PISANGAN BARU,31776,12985,18791,8767,27558,2021-08-23
3175021002,JAKARTA TIMUR,PULO GADUNG,PISANGAN TIMUR,41011,15043,25968,13027,38995,2021-08-23
3172011005,JAKARTA UTARA,PENJARINGAN,PLUIT,47783,17284,30499,20795,51294,2021-08-23
3175071002,JAKARTA TIMUR,DUREN SAWIT,PONDOK BAMBU,61550,25533,36017,18692,54709,2021-08-23
3175071004,JAKARTA TIMUR,DUREN SAWIT,PONDOK KELAPA,72015,27549,44466,23174,67640,2021-08-23
3175071007,JAKARTA TIMUR,DUREN SAWIT,PONDOK KOPI,35367,15424,19943,9928,29871,2021-08-23
3174061003,JAKARTA SELATAN,CILANDAK,PONDOK LABU,46464,16612,29852,18842,48694,2021-08-23
3174051002,JAKARTA SELATAN,KEBAYORAN LAMA,PONDOK PINANG,56169,21463,34706,20571,55277,2021-08-23
3175101003,JAKARTA TIMUR,CIPAYUNG,PONDOK RANGGON,25574,9375,16199,8329,24528,2021-08-23
3101011003,KAB.ADM.KEP.SERIBU,KEP. SERIBU UTARA,PULAU HARAPAN,2060,354,1706,974,2680,2021-08-23
3101011002,KAB.ADM.KEP.SERIBU,KEP. SERIBU UTARA,PULAU KELAPA,5528,957,4571,2387,6958,2021-08-23
3101011001,KAB.ADM.KEP.SERIBU,KEP. SERIBU UTARA,PULAU PANGGANG,5450,916,4534,2017,6551,2021-08-23
3101021003,KAB.ADM.KEP.SERIBU,KEP. SERIBU SELATAN,PULAU PARI,2765,333,2432,1352,3784,2021-08-23
3101021002,KAB.ADM.KEP.SERIBU,KEP. SERIBU SELATAN,PULAU TIDUNG,4553,675,3878,2565,6443,2021-08-23
3101021001,KAB.ADM.KEP.SERIBU,KEP. SERIBU SELATAN,PULAU UNTUNG JAWA,1941,335,1606,835,2441,2021-08-23
3174071007,JAKARTA SELATAN,KEBAYORAN BARU,PULO,5835,2036,3799,2667,6466,2021-08-23
3175021001,JAKARTA TIMUR,PULO GADUNG,PULO GADUNG,34422,13470,20952,11064,32016,2021-08-23
3175061005,JAKARTA TIMUR,CAKUNG,PULO GEBANG,97301,39027,58274,28986,87260,2021-08-23
3174041004,JAKARTA SELATAN,PASAR MINGGU,RAGUNAN,39616,14378,25238,14977,40215,2021-08-23
3175091005,JAKARTA TIMUR,CIRACAS,RAMBUTAN,36771,15857,20914,10683,31597,2021-08-23
3172031006,JAKARTA UTARA,KOJA,RAWA BADAK SELATAN,42179,17848,24331,12252,36583,2021-08-23
3172031004,JAKARTA UTARA,KOJA,RAWA BADAK UTARA,34408,14189,20219,10923,31142,2021-08-23
3174071005,JAKARTA SELATAN,KEBAYORAN BARU,RAWA BARAT,5625,1955,3670,2429,6099,2021-08-23
3173011003,JAKARTA BARAT,CENGKARENG,RAWA BUAYA,63799,24999,38800,18143,56943,2021-08-23
3175031004,JAKARTA TIMUR,JATINEGARA,RAWA BUNGA,21434,8925,12509,6377,18886,2021-08-23
3174081003,JAKARTA SELATAN,PANCORAN,RAWA JATI,20509,7700,12809,7224,20033,2021-08-23
3175061002,JAKARTA TIMUR,CAKUNG,RAWA TERATE,24637,8714,15923,7528,23451,2021-08-23
3175021005,JAKARTA TIMUR,PULO GADUNG,RAWAMANGUN,37612,14727,22885,12664,35549,2021-08-23
3171051003,JAKARTA PUSAT,CEMPAKA PUTIH,RAWASARI,21967,8552,13415,7783,21198,2021-08-23
3173041010,JAKARTA BARAT,TAMBORA,ROA MALAKA,3484,1080,2404,1532,3936,2021-08-23
3172041006,JAKARTA UTARA,CILINCING,ROROTAN,41668,15102,26566,13482,40048,2021-08-23
3174071004,JAKARTA SELATAN,KEBAYORAN BARU,SELONG,2842,1009,1833,1342,3175,2021-08-23
3173061002,JAKARTA BARAT,KALI DERES,SEMANAN,71354,28120,43234,18041,61275,2021-08-23
3172041007,JAKARTA UTARA,CILINCING,SEMPER BARAT,68587,24256,44331,24591,68922,2021-08-23
3172041005,JAKARTA UTARA,CILINCING,SEMPER TIMUR,36267,13384,22883,12070,34953,2021-08-23
3174071006,JAKARTA SELATAN,KEBAYORAN BARU,SENAYAN,2771,1176,1595,1032,2627,2021-08-23
3171041001,JAKARTA PUSAT,SENEN,SENEN,6804,2457,4347,2547,6894,2021-08-23
3171031004,JAKARTA PUSAT,KEMAYORAN,SERDANG,29668,11341,18327,9680,28007,2021-08-23
3174021001,JAKARTA SELATAN,SETIA BUDI,SETIA BUDI,3023,1155,1868,1179,3047,2021-08-23
3175101005,JAKARTA TIMUR,CIPAYUNG,SETU,20572,8105,12467,5879,18346,2021-08-23
3173071002,JAKARTA BARAT,PALMERAH,SLIPI,16591,6062,10529,5956,16485,2021-08-23
3173081004,JAKARTA BARAT,KEMBANGAN,SRENGSENG,45523,18379,27144,14158,41302,2021-08-23
3174091002,JAKARTA SELATAN,JAGAKARSA,SRENGSENG SAWAH,58196,19382,38814,22944,61758,2021-08-23
3173051003,JAKARTA BARAT,KEBON JERUK,SUKABUMI SELATAN,37033,15180,21853,9704,31557,2021-08-23
3173051002,JAKARTA BARAT,KEBON JERUK,SUKABUMI UTARA,38290,16622,21668,10020,31688,2021-08-23
3172041002,JAKARTA UTARA,CILINCING,SUKAPURA,53949,21085,32864,17947,50811,2021-08-23
3171031007,JAKARTA PUSAT,KEMAYORAN,SUMUR BATU,22717,8865,13852,7850,21702,2021-08-23
3172021004,JAKARTA UTARA,TANJUNG PRIOK,SUNGAI BAMBU,29876,11151,18725,10218,28943,2021-08-23
3172021006,JAKARTA UTARA,TANJUNG PRIOK,SUNTER AGUNG,71805,23705,48100,29907,78007,2021-08-23
3172021002,JAKARTA UTARA,TANJUNG PRIOK,SUNTER JAYA,63031,21457,41574,24495,66069,2021-08-23
3175091004,JAKARTA TIMUR,CIRACAS,SUSUKAN,38257,13544,24713,12591,37304,2021-08-23
3173031001,JAKARTA BARAT,TAMAN SARI,TAMAN SARI,14348,5300,9048,5571,14619,2021-08-23
3173041001,JAKARTA BARAT,TAMBORA,TAMBORA,10204,3913,6291,3208,9499,2021-08-23
3173041004,JAKARTA BARAT,TAMBORA,TANAH SEREAL,26387,8599,17788,8883,26671,2021-08-23
3171081004,JAKARTA PUSAT,JOHAR BARU,TANAH TINGGI,37693,12249,25444,12663,38107,2021-08-23
3173031004,JAKARTA BARAT,TAMAN SARI,TANGKI,13324,4911,8413,4965,13378,2021-08-23
3174091005,JAKARTA SELATAN,JAGAKARSA,TANJUNG BARAT,39770,14653,25117,13285,38402,2021-08-23
3173021005,JAKARTA BARAT,GROGOL PETAMBURAN,TANJUNG DUREN SELATAN,25337,9267,16070,9501,25571,2021-08-23
3173021002,JAKARTA BARAT,GROGOL PETAMBURAN,TANJUNG DUREN UTARA,17010,5922,11088,6607,17695,2021-08-23
3172021001,JAKARTA UTARA,TANJUNG PRIOK,TANJUNG PRIOK,34588,12257,22331,11150,33481,2021-08-23
3174011002,JAKARTA SELATAN,TEBET,TEBET BARAT,21194,7347,13847,8548,22395,2021-08-23
3174011001,JAKARTA SELATAN,TEBET,TEBET TIMUR,18199,6321,11878,7397,19275,2021-08-23
3173061003,JAKARTA BARAT,KALI DERES,TEGAL ALUR,83647,31420,52227,22967,75194,2021-08-23
3174031004,JAKARTA SELATAN,MAMPANG PRAPATAN,TEGAL PARANG,32401,12994,19407,10194,29601,2021-08-23
3173021003,JAKARTA BARAT,GROGOL PETAMBURAN,TOMANG,29605,10806,18799,11580,30379,2021-08-23
3172031005,JAKARTA UTARA,KOJA,TUGU SELATAN,39122,16031,23091,11996,35087,2021-08-23
3172031002,JAKARTA UTARA,KOJA,TUGU UTARA,67670,28151,39519,21136,60655,2021-08-23
3175061006,JAKARTA TIMUR,CAKUNG,UJUNG MENTENG,29934,10612,19322,10177,29499,2021-08-23
3174101005,JAKARTA SELATAN,PESANGGRAHAN,ULUJAMI,40544,16653,23891,12403,36294,2021-08-23
3175011006,JAKARTA TIMUR,MATRAMAN,UTAN KAYU SELATAN,33511,12512,20999,11307,32306,2021-08-23
3175011002,JAKARTA TIMUR,MATRAMAN,UTAN KAYU UTARA,28169,11373,16796,8785,25581,2021-08-23
3171031008,JAKARTA PUSAT,KEMAYORAN,UTAN PANJANG,29208,11547,17661,8767,26428,2021-08-23
3172021007,JAKARTA UTARA,TANJUNG PRIOK,WARAKAS,44401,16508,27893,14851,42744,2021-08-23
3173021007,JAKARTA BARAT,GROGOL PETAMBURAN,WIJAYA KUSUMA,38934,15076,23858,13326,37184,2021-08-23
3172051003,JAKARTA UTARA,PADEMANGAN,ANCOL,23947,9465,14482,7877,22359,2021-08-24
3173041007,JAKARTA BARAT,TAMBORA,ANGKE,29381,10680,18701,9271,27972,2021-08-24
3175041005,JAKARTA TIMUR,KRAMAT JATI,BALE KAMBANG,29074,13063,16011,6509,22520,2021-08-24
3175031003,JAKARTA TIMUR,JATINEGARA,BALI MESTER,9752,3853,5899,3215,9114,2021-08-24
3175101006,JAKARTA TIMUR,CIPAYUNG,BAMBU APUS,26285,9811,16474,8592,25066,2021-08-24
3174031002,JAKARTA SELATAN,MAMPANG PRAPATAN,BANGKA,21566,8521,13045,7636,20681,2021-08-24
3175051002,JAKARTA TIMUR,PASAR REBO,BARU,23886,8023,15863,10300,26163,2021-08-24
3175041004,JAKARTA TIMUR,KRAMAT JATI,BATU AMPAR,47898,20793,27105,12710,39815,2021-08-24
3171071002,JAKARTA PUSAT,TANAH ABANG,BENDUNGAN HILIR,21494,8243,13251,7809,21060,2021-08-24
3175031002,JAKARTA TIMUR,JATINEGARA,BIDARA CINA,36689,16265,20424,9991,30415,2021-08-24
3174101002,JAKARTA SELATAN,PESANGGRAHAN,BINTARO,53098,20374,32724,19599,52323,2021-08-24
3174011005,JAKARTA SELATAN,TEBET,BUKIT DURI,34183,13877,20306,10977,31283,2021-08-24
3171041006,JAKARTA PUSAT,SENEN,BUNGUR,18144,6810,11334,6197,17531,2021-08-24
3175061007,JAKARTA TIMUR,CAKUNG,CAKUNG BARAT,57724,20541,37183,18620,55803,2021-08-24
3175061004,JAKARTA TIMUR,CAKUNG,CAKUNG TIMUR,58287,21068,37219,20520,57739,2021-08-24
3175041007,JAKARTA TIMUR,KRAMAT JATI,CAWANG,32762,13655,19107,9873,28980,2021-08-24
3175101008,JAKARTA TIMUR,CIPAYUNG,CEGER,18932,7001,11931,5982,17913,2021-08-24
3171031006,JAKARTA PUSAT,KEMAYORAN,CEMPAKA BARU,32581,13141,19440,10192,29632,2021-08-24
3171051002,JAKARTA PUSAT,CEMPAKA PUTIH,CEMPAKA PUTIH BARAT,35885,13964,21921,12825,34746,2021-08-24
3171051001,JAKARTA PUSAT,CEMPAKA PUTIH,CEMPAKA PUTIH TIMUR,24292,9150,15142,9031,24173,2021-08-24
3173011001,JAKARTA BARAT,CENGKARENG,CENGKARENG BARAT,66284,24453,41831,24161,65992,2021-08-24
3173011006,JAKARTA BARAT,CENGKARENG,CENGKARENG TIMUR,81027,29346,51681,24903,76584,2021-08-24
3175091002,JAKARTA TIMUR,CIRACAS,CIBUBUR,66364,23459,42905,24864,67769,2021-08-24
3171011002,JAKARTA PUSAT,GAMBIR,CIDENG,15390,5339,10051,6159,16210,2021-08-24
3174091003,JAKARTA SELATAN,JAGAKARSA,CIGANJUR,38497,14227,24270,13826,38096,2021-08-24
3175051003,JAKARTA TIMUR,PASAR REBO,CIJANTUNG,41419,14671,26748,15238,41986,2021-08-24
3171061003,JAKARTA PUSAT,MENTENG,CIKINI,8274,3415,4859,2751,7610,2021-08-24
3174081006,JAKARTA SELATAN,PANCORAN,CIKOKO,10547,3720,6827,3736,10563,2021-08-24
3174061001,JAKARTA SELATAN,CILANDAK,CILANDAK BARAT,51752,19040,32712,19701,52413,2021-08-24
3174041003,JAKARTA SELATAN,PASAR MINGGU,CILANDAK TIMUR,25145,9101,16044,10329,26373,2021-08-24
3175101002,JAKARTA TIMUR,CIPAYUNG,CILANGKAP,27635,9980,17655,9363,27018,2021-08-24
3175041006,JAKARTA TIMUR,KRAMAT JATI,CILILITAN,40181,17063,23118,11811,34929,2021-08-24
3172041001,JAKARTA UTARA,CILINCING,CILINCING,43609,17424,26185,13550,39735,2021-08-24
3175101001,JAKARTA TIMUR,CIPAYUNG,CIPAYUNG,26104,8897,17207,9783,26990,2021-08-24
3174091006,JAKARTA SELATAN,JAGAKARSA,CIPEDAK,38303,13104,25199,15160,40359,2021-08-24
3174061005,JAKARTA SELATAN,CILANDAK,CIPETE SELATAN,26704,10345,16359,10614,26973,2021-08-24
3174071010,JAKARTA SELATAN,KEBAYORAN BARU,CIPETE UTARA,34102,12834,21268,12581,33849,2021-08-24
3175021003,JAKARTA TIMUR,PULO GADUNG,CIPINANG,39306,15276,24030,13357,37387,2021-08-24
3175031007,JAKARTA TIMUR,JATINEGARA,CIPINANG BESAR SELATAN,35212,15433,19779,9636,29415,2021-08-24
3175031008,JAKARTA TIMUR,JATINEGARA,CIPINANG BESAR UTARA,45319,19151,26168,11824,37992,2021-08-24
3175031005,JAKARTA TIMUR,JATINEGARA,CIPINANG CEMPEDAK,32824,13845,18979,10761,29740,2021-08-24
3175081005,JAKARTA TIMUR,MAKASAR,CIPINANG MELAYU,42308,16700,25608,14566,40174,2021-08-24
3175031006,JAKARTA TIMUR,JATINEGARA,CIPINANG MUARA,55243,23196,32047,16058,48105,2021-08-24
3174051003,JAKARTA SELATAN,KEBAYORAN LAMA,CIPULIR,39937,16335,23602,12253,35855,2021-08-24
3175091001,JAKARTA TIMUR,CIRACAS,CIRACAS,64594,22794,41800,22466,64266,2021-08-24
3175041003,JAKARTA TIMUR,KRAMAT JATI,DUKUH,24609,9024,15585,7769,23354,2021-08-24
3175071001,JAKARTA TIMUR,DUREN SAWIT,DUREN SAWIT,61160,25319,35841,19605,55446,2021-08-24
3174081004,JAKARTA SELATAN,PANCORAN,DUREN TIGA,28319,10802,17517,9026,26543,2021-08-24
3173051005,JAKARTA BARAT,KEBON JERUK,DURI KEPA,60138,21549,38589,22282,60871,2021-08-24
3173011002,JAKARTA BARAT,CENGKARENG,DURI KOSAMBI,77923,31874,46049,23068,69117,2021-08-24
3171011006,JAKARTA PUSAT,GAMBIR,DURI PULO,19610,7215,12395,6550,18945,2021-08-24
3173041011,JAKARTA BARAT,TAMBORA,DURI SELATAN,14259,4835,9424,5337,14761,2021-08-24
3173041003,JAKARTA BARAT,TAMBORA,DURI UTARA,19844,7020,12824,6746,19570,2021-08-24
3171081003,JAKARTA PUSAT,JOHAR BARU,GALUR,18243,5914,12329,6284,18613,2021-08-24
3171011001,JAKARTA PUSAT,GAMBIR,GAMBIR,2191,760,1431,867,2298,2021-08-24
3174061004,JAKARTA SELATAN,CILANDAK,GANDARIA SELATAN,22119,8419,13700,7738,21438,2021-08-24
3174071009,JAKARTA SELATAN,KEBAYORAN BARU,GANDARIA UTARA,39922,15323,24599,14381,38980,2021-08-24
3175051001,JAKARTA TIMUR,PASAR REBO,GEDONG,35755,13139,22616,12393,35009,2021-08-24
3171071001,JAKARTA PUSAT,TANAH ABANG,GELORA,3127,1255,1872,1047,2919,2021-08-24
3173031007,JAKARTA BARAT,TAMAN SARI,GLODOK,7837,2495,5342,3486,8828,2021-08-24
3171061004,JAKARTA PUSAT,MENTENG,GONDANGDIA,4100,1551,2549,1881,4430,2021-08-24
3173021001,JAKARTA BARAT,GROGOL PETAMBURAN,GROGOL,16876,6343,10533,6057,16590,2021-08-24
3174051005,JAKARTA SELATAN,KEBAYORAN LAMA,GROGOL SELATAN,44251,17353,26898,14574,41472,2021-08-24
3174051004,JAKARTA SELATAN,KEBAYORAN LAMA,GROGOL UTARA,42494,16502,25992,13890,39882,2021-08-24
3174021007,JAKARTA SELATAN,SETIA BUDI,GUNTUR,3985,1433,2552,1763,4315,2021-08-24
3174071002,JAKARTA SELATAN,KEBAYORAN BARU,GUNUNG,9436,3410,6026,4066,10092,2021-08-24
3171031005,JAKARTA PUSAT,KEMAYORAN,GUNUNG SAHARI SELATAN,19199,7321,11878,6918,18796,2021-08-24
3171021004,JAKARTA PUSAT,SAWAH BESAR,GUNUNG SAHARI UTARA,16650,5469,11181,6959,18140,2021-08-24
3175081004,JAKARTA TIMUR,MAKASAR,HALIM PERDANA KUSUMAH,28363,8209,20154,15087,35241,2021-08-24
3171031003,JAKARTA PUSAT,KEMAYORAN,HARAPAN MULIA,22557,8735,13822,7394,21216,2021-08-24
3174091001,JAKARTA SELATAN,JAGAKARSA,JAGAKARSA,62389,22288,40101,24538,64639,2021-08-24
3175021007,JAKARTA TIMUR,PULO GADUNG,JATI,32757,12520,20237,11509,31746,2021-08-24
3174041002,JAKARTA SELATAN,PASAR MINGGU,JATI PADANG,37502,14215,23287,13971,37258,2021-08-24
3173071004,JAKARTA BARAT,PALMERAH,JATI PULO,28738,10560,18178,9254,27432,2021-08-24
3175061001,JAKARTA TIMUR,CAKUNG,JATINEGARA,84160,33184,50976,24427,75403,2021-08-24
3175021004,JAKARTA TIMUR,PULO GADUNG,JATINEGARA KAUM,24632,8714,15918,7578,23496,2021-08-24
3173021004,JAKARTA BARAT,GROGOL PETAMBURAN,JELAMBAR,30266,11177,19089,11901,30990,2021-08-24
3173021006,JAKARTA BARAT,GROGOL PETAMBURAN,JELAMBAR BARU,38246,14164,24082,14574,38656,2021-08-24
3173041006,JAKARTA BARAT,TAMBORA,JEMBATAN BESI,29314,12785,16529,7678,24207,2021-08-24
3173041008,JAKARTA BARAT,TAMBORA,JEMBATAN LIMA,21021,8440,12581,6318,18899,2021-08-24
3173081005,JAKARTA BARAT,KEMBANGAN,JOGLO,40839,15778,25061,13339,38400,2021-08-24
3171081001,JAKARTA PUSAT,JOHAR BARU,JOHAR BARU,37488,12636,24852,13951,38803,2021-08-24
3173041002,JAKARTA BARAT,TAMBORA,KALI ANYAR,23856,8374,15482,6839,22321,2021-08-24
3172041004,JAKARTA UTARA,CILINCING,KALIBARU,67684,28949,38735,18494,57229,2021-08-24
3174081002,JAKARTA SELATAN,PANCORAN,KALIBATA,41994,17730,24264,12367,36631,2021-08-24
3173061001,JAKARTA BARAT,KALI DERES,KALIDERES,72447,27488,44959,24732,69691,2021-08-24
3175051004,JAKARTA TIMUR,PASAR REBO,KALISARI,43212,15654,27558,15706,43264,2021-08-24
3173061004,JAKARTA BARAT,KALI DERES,KAMAL,53783,20961,32822,13652,46474,2021-08-24
3172011002,JAKARTA UTARA,PENJARINGAN,KAMAL MUARA,12930,3751,9179,6141,15320,2021-08-24
3171071007,JAKARTA PUSAT,TANAH ABANG,KAMPUNG BALI,11358,4919,6439,3418,9857,2021-08-24
3175031001,JAKARTA TIMUR,JATINEGARA,KAMPUNG MELAYU,25717,10922,14795,7117,21912,2021-08-24
3171081002,JAKARTA PUSAT,JOHAR BARU,KAMPUNG RAWA,21237,6053,15184,7896,23080,2021-08-24
3175041002,JAKARTA TIMUR,KRAMAT JATI,KAMPUNG TENGAH,43993,19016,24977,11894,36871,2021-08-24
3173011005,JAKARTA BARAT,CENGKARENG,KAPUK,134466,54731,79735,36190,115925,2021-08-24
3172011003,JAKARTA UTARA,PENJARINGAN,KAPUK MUARA,35781,11843,23938,15775,39713,2021-08-24
3171021002,JAKARTA PUSAT,SAWAH BESAR,KARANG ANYAR,25761,9047,16714,8948,25662,2021-08-24
3174021004,JAKARTA SELATAN,SETIA BUDI,KARET,9623,3730,5893,3673,9566,2021-08-24
3174021003,JAKARTA SELATAN,SETIA BUDI,KARET KUNINGAN,16055,5501,10554,6497,17051,2021-08-24
3174021002,JAKARTA SELATAN,SETIA BUDI,KARET SEMANGGI,2770,967,1803,1295,3098,2021-08-24
3171071003,JAKARTA PUSAT,TANAH ABANG,KARET TENGSIN,19271,7364,11907,6394,18301,2021-08-24
3171021003,JAKARTA PUSAT,SAWAH BESAR,KARTINI,22292,8101,14191,8424,22615,2021-08-24
3175011003,JAKARTA TIMUR,MATRAMAN,KAYU MANIS,25284,10441,14843,7385,22228,2021-08-24
3175021006,JAKARTA TIMUR,PULO GADUNG,KAYU PUTIH,40696,14645,26051,15807,41858,2021-08-24
3173031006,JAKARTA BARAT,TAMAN SARI,KEAGUNGAN,17387,6223,11164,6373,17537,2021-08-24
3174041007,JAKARTA SELATAN,PASAR MINGGU,KEBAGUSAN,44552,17481,27071,14966,42037,2021-08-24
3174051006,JAKARTA SELATAN,KEBAYORAN LAMA,KEBAYORAN LAMA SELATAN,41212,15114,26098,14874,40972,2021-08-24
3174051001,JAKARTA SELATAN,KEBAYORAN LAMA,KEBAYORAN LAMA UTARA,42422,16939,25483,13045,38528,2021-08-24
3174011004,JAKARTA SELATAN,TEBET,KEBON BARU,35165,13377,21788,12013,33801,2021-08-24
3172021005,JAKARTA UTARA,TANJUNG PRIOK,KEBON BAWANG,50952,19185,31767,17851,49618,2021-08-24
3173051001,JAKARTA BARAT,KEBON JERUK,KEBON JERUK,53887,21829,32058,16492,48550,2021-08-24
3171071006,JAKARTA PUSAT,TANAH ABANG,KEBON KACANG,21531,9799,11732,6133,17865,2021-08-24
3171011005,JAKARTA PUSAT,GAMBIR,KEBON KELAPA,10163,3742,6421,3629,10050,2021-08-24
3171031002,JAKARTA PUSAT,KEMAYORAN,KEBON KOSONG,30019,11699,18320,10109,28429,2021-08-24
3175011005,JAKARTA TIMUR,MATRAMAN,KEBON MANGGIS,16490,6155,10335,5999,16334,2021-08-24
3171071005,JAKARTA PUSAT,TANAH ABANG,KEBON MELATI,32206,15444,16762,8177,24939,2021-08-24
3175081003,JAKARTA TIMUR,MAKASAR,KEBON PALA,46614,17473,29141,15491,44632,2021-08-24
3171061005,JAKARTA PUSAT,MENTENG,KEBON SIRIH,12299,5126,7173,3805,10978,2021-08-24
3173011004,JAKARTA BARAT,CENGKARENG,KEDAUNG KALI ANGKE,32612,11229,21383,11677,33060,2021-08-24
3173051007,JAKARTA BARAT,KEBON JERUK,KEDOYA SELATAN,32165,11807,20358,10528,30886,2021-08-24
3173051006,JAKARTA BARAT,KEBON JERUK,KEDOYA UTARA,45740,15753,29987,16518,46505,2021-08-24
3173051004,JAKARTA BARAT,KEBON JERUK,KELAPA DUA,23565,9186,14379,7301,21680,2021-08-24
3175091003,JAKARTA TIMUR,CIRACAS,KELAPA DUA WETAN,46875,16244,30631,16595,47226,2021-08-24
3172061003,JAKARTA UTARA,KELAPA GADING,KELAPA GADING BARAT,35717,11792,23925,16619,40544,2021-08-24
3172061001,JAKARTA UTARA,KELAPA GADING,KELAPA GADING TIMUR,33592,10246,23346,15942,39288,2021-08-24
3173071005,JAKARTA BARAT,PALMERAH,KEMANGGISAN,32139,12206,19933,10713,30646,2021-08-24
3171031001,JAKARTA PUSAT,KEMAYORAN,KEMAYORAN,20708,7616,13092,7328,20420,2021-08-24
3173081006,JAKARTA BARAT,KEMBANGAN,KEMBANGAN SELATAN,27130,10200,16930,10142,27072,2021-08-24
3173081001,JAKARTA BARAT,KEMBANGAN,KEMBANGAN UTARA,54451,20569,33882,18040,51922,2021-08-24
3171041002,JAKARTA PUSAT,SENEN,KENARI,9579,3521,6058,3286,9344,2021-08-24
3173041005,JAKARTA BARAT,TAMBORA,KERENDANG,19973,7327,12646,6799,19445,2021-08-24
3175071003,JAKARTA TIMUR,DUREN SAWIT,KLENDER,69978,29741,40237,19176,59413,2021-08-24
3172031001,JAKARTA UTARA,KOJA,KOJA,28175,11129,17046,9664,26710,2021-08-24
3173071006,JAKARTA BARAT,PALMERAH,KOTA BAMBU SELATAN,21158,8222,12936,6352,19288,2021-08-24
3173071003,JAKARTA BARAT,PALMERAH,KOTA BAMBU UTARA,24995,9890,15105,7644,22749,2021-08-24
3171041004,JAKARTA PUSAT,SENEN,KRAMAT,28835,11855,16980,8278,25258,2021-08-24
3175041001,JAKARTA TIMUR,KRAMAT JATI,KRAMAT JATI,34144,13181,20963,10285,31248,2021-08-24
3174071003,JAKARTA SELATAN,KEBAYORAN BARU,KRAMAT PELA,14413,5162,9251,5530,14781,2021-08-24
3173031002,JAKARTA BARAT,TAMAN SARI,KRUKUT,19244,7081,12163,6083,18246,2021-08-24
3174031005,JAKARTA SELATAN,MAMPANG PRAPATAN,KUNINGAN BARAT,12785,4583,8202,4803,13005,2021-08-24
3174021008,JAKARTA SELATAN,SETIA BUDI,KUNINGAN TIMUR,6008,2206,3802,2414,6216,2021-08-24
3171041005,JAKARTA PUSAT,SENEN,KWITANG,15486,5860,9626,5177,14803,2021-08-24
3172031003,JAKARTA UTARA,KOJA,LAGOA,59065,23910,35155,18791,53946,2021-08-24
3174061002,JAKARTA SELATAN,CILANDAK,LEBAK BULUS,37626,14620,23006,13917,36923,2021-08-24
3174091004,JAKARTA SELATAN,JAGAKARSA,LENTENG AGUNG,53946,21032,32914,17543,50457,2021-08-24
3175101007,JAKARTA TIMUR,CIPAYUNG,LUBANG BUAYA,63547,22369,41178,22903,64081,2021-08-24
3175081001,JAKARTA TIMUR,MAKASAR,MAKASAR,34390,12601,21789,12215,34004,2021-08-24
3175071006,JAKARTA TIMUR,DUREN SAWIT,MALAKA JAYA,30927,11886,19041,11892,30933,2021-08-24
3175071005,JAKARTA TIMUR,DUREN SAWIT,MALAKA SARI,27530,10248,17282,10762,28044,2021-08-24
3174031001,JAKARTA SELATAN,MAMPANG PRAPATAN,MAMPANG PRAPATAN,18159,6800,11359,6787,18146,2021-08-24
3173031005,JAKARTA BARAT,TAMAN SARI,MANGGA BESAR,7707,2486,5221,3317,8538,2021-08-24
3171021005,JAKARTA PUSAT,SAWAH BESAR,MANGGA DUA SELATAN,27442,10077,17365,9837,27202,2021-08-24
3174011007,JAKARTA SELATAN,TEBET,MANGGARAI,28373,9970,18403,9588,27991,2021-08-24
3174011006,JAKARTA SELATAN,TEBET,MANGGARAI SELATAN,23075,8364,14711,8470,23181,2021-08-24
3173031003,JAKARTA BARAT,TAMAN SARI,MAPHAR,16461,6113,10348,6223,16571,2021-08-24
3172041003,JAKARTA UTARA,CILINCING,MARUNDA,28943,10584,18359,8012,26371,2021-08-24
3174071001,JAKARTA SELATAN,KEBAYORAN BARU,MELAWAI,2627,916,1711,1306,3017,2021-08-24
3171061001,JAKARTA PUSAT,MENTENG,MENTENG,25624,10267,15357,8369,23726,2021-08-24
3174021005,JAKARTA SELATAN,SETIA BUDI,MENTENG ATAS,27816,9864,17952,10121,28073,2021-08-24
3174011003,JAKARTA SELATAN,TEBET,MENTENG DALAM,36028,13640,22388,12624,35012,2021-08-24
3173081003,JAKARTA BARAT,KEMBANGAN,MERUYA SELATAN,32130,12188,19942,10568,30510,2021-08-24
3173081002,JAKARTA BARAT,KEMBANGAN,MERUYA UTARA,43752,16720,27032,15519,42551,2021-08-24
3175101004,JAKARTA TIMUR,CIPAYUNG,MUNJUL,23871,8402,15469,8194,23663,2021-08-24
3172051002,JAKARTA UTARA,PADEMANGAN,PADEMANGAN BARAT,74240,29305,44935,23873,68808,2021-08-24
3172051001,JAKARTA UTARA,PADEMANGAN,PADEMANGAN TIMUR,37736,12494,25242,15507,40749,2021-08-24
3175011004,JAKARTA TIMUR,MATRAMAN,PAL MERIAM,19769,7981,11788,6291,18079,2021-08-24
3173071001,JAKARTA BARAT,PALMERAH,PALMERAH,63011,24422,38589,19875,58464,2021-08-24
3174081001,JAKARTA SELATAN,PANCORAN,PANCORAN,19421,7401,12020,6918,18938,2021-08-24
3172021003,JAKARTA UTARA,TANJUNG PRIOK,PAPANGGO,39097,13818,25279,13902,39181,2021-08-24
3171021001,JAKARTA PUSAT,SAWAH BESAR,PASAR BARU,12035,3906,8129,5134,13263,2021-08-24
3174021006,JAKARTA SELATAN,SETIA BUDI,PASAR MANGGIS,26752,10095,16657,9597,26254,2021-08-24
3174041001,JAKARTA SELATAN,PASAR MINGGU,PASAR MINGGU,24821,9322,15499,9506,25005,2021-08-24
3171041003,JAKARTA PUSAT,SENEN,PASEBAN,23533,9186,14347,7725,22072,2021-08-24
3173061005,JAKARTA BARAT,KALI DERES,PEGADUNGAN,75587,26605,48982,26708,75690,2021-08-24
3171061002,JAKARTA PUSAT,MENTENG,PEGANGSAAN,23455,9490,13965,7039,21004,2021-08-24
3172061002,JAKARTA UTARA,KELAPA GADING,PEGANGSAAN DUA,49976,15217,34759,22563,57322,2021-08-24
3172011004,JAKARTA UTARA,PENJARINGAN,PEJAGALAN,74578,27656,46922,28262,75184,2021-08-24
3174041006,JAKARTA SELATAN,PASAR MINGGU,PEJATEN BARAT,37346,14454,22892,13638,36530,2021-08-24
3174041005,JAKARTA SELATAN,PASAR MINGGU,PEJATEN TIMUR,57656,23211,34445,17850,52295,2021-08-24
3175051005,JAKARTA TIMUR,PASAR REBO,PEKAYON,43250,15478,27772,15417,43189,2021-08-24
3173041009,JAKARTA BARAT,TAMBORA,PEKOJAN,23587,8152,15435,8789,24224,2021-08-24
3174031003,JAKARTA SELATAN,MAMPANG PRAPATAN,PELA MAMPANG,43522,16134,27388,16709,44097,2021-08-24
3174081005,JAKARTA SELATAN,PANCORAN,PENGADEGAN,21478,7375,14103,7419,21522,2021-08-24
3175061003,JAKARTA TIMUR,CAKUNG,PENGGILINGAN,99255,42390,56865,27143,84008,2021-08-24
3172011001,JAKARTA UTARA,PENJARINGAN,PENJARINGAN,88308,36681,51627,25707,77334,2021-08-24
3174101001,JAKARTA SELATAN,PESANGGRAHAN,PESANGGRAHAN,27545,9630,17915,10573,28488,2021-08-24
3171071004,JAKARTA PUSAT,TANAH ABANG,PETAMBURAN,33271,15854,17417,8188,25605,2021-08-24
3174071008,JAKARTA SELATAN,KEBAYORAN BARU,PETOGOGAN,11499,4394,7105,4439,11544,2021-08-24
3171011004,JAKARTA PUSAT,GAMBIR,PETOJO SELATAN,14692,5618,9074,5362,14436,2021-08-24
3171011003,JAKARTA PUSAT,GAMBIR,PETOJO UTARA,17458,6536,10922,5613,16535,2021-08-24
3174101004,JAKARTA SELATAN,PESANGGRAHAN,PETUKANGAN SELATAN,37187,13980,23207,13032,36239,2021-08-24
3174101003,JAKARTA SELATAN,PESANGGRAHAN,PETUKANGAN UTARA,53716,21453,32263,18368,50631,2021-08-24
3175081002,JAKARTA TIMUR,MAKASAR,PINANG RANTI,27198,10432,16766,9737,26503,2021-08-24
3173031008,JAKARTA BARAT,TAMAN SARI,PINANGSIA,10729,3624,7105,4237,11342,2021-08-24
3175011001,JAKARTA TIMUR,MATRAMAN,PISANGAN BARU,31776,12917,18859,8940,27799,2021-08-24
3175021002,JAKARTA TIMUR,PULO GADUNG,PISANGAN TIMUR,41011,14955,26056,13443,39499,2021-08-24
3172011005,JAKARTA UTARA,PENJARINGAN,PLUIT,47783,16930,30853,20948,51801,2021-08-24
3175071002,JAKARTA TIMUR,DUREN SAWIT,PONDOK BAMBU,61550,25349,36201,19129,55330,2021-08-24
3175071004,JAKARTA TIMUR,DUREN SAWIT,PONDOK KELAPA,72015,27379,44636,23677,68313,2021-08-24
3175071007,JAKARTA TIMUR,DUREN SAWIT,PONDOK KOPI,35367,15341,20026,10233,30259,2021-08-24
3174061003,JAKARTA SELATAN,CILANDAK,PONDOK LABU,46464,16527,29937,19136,49073,2021-08-24
3174051002,JAKARTA SELATAN,KEBAYORAN LAMA,PONDOK PINANG,56169,21393,34776,20874,55650,2021-08-24
3175101003,JAKARTA TIMUR,CIPAYUNG,PONDOK RANGGON,25574,9312,16262,8492,24754,2021-08-24
3101011003,KAB.ADM.KEP.SERIBU,KEP. SERIBU UTARA,PULAU HARAPAN,2060,349,1711,983,2694,2021-08-24
3101011002,KAB.ADM.KEP.SERIBU,KEP. SERIBU UTARA,PULAU KELAPA,5528,943,4585,2483,7068,2021-08-24
3101011001,KAB.ADM.KEP.SERIBU,KEP. SERIBU UTARA,PULAU PANGGANG,5450,906,4544,2040,6584,2021-08-24
3101021003,KAB.ADM.KEP.SERIBU,KEP. SERIBU SELATAN,PULAU PARI,2765,332,2433,1361,3794,2021-08-24
3101021002,KAB.ADM.KEP.SERIBU,KEP. SERIBU SELATAN,PULAU TIDUNG,4553,669,3884,2585,6469,2021-08-24
3101021001,KAB.ADM.KEP.SERIBU,KEP. SERIBU SELATAN,PULAU UNTUNG JAWA,1941,333,1608,841,2449,2021-08-24
3174071007,JAKARTA SELATAN,KEBAYORAN BARU,PULO,5835,2019,3816,2684,6500,2021-08-24
3175021001,JAKARTA TIMUR,PULO GADUNG,PULO GADUNG,34422,13392,21030,11297,32327,2021-08-24
3175061005,JAKARTA TIMUR,CAKUNG,PULO GEBANG,97301,38756,58545,29916,88461,2021-08-24
3174041004,JAKARTA SELATAN,PASAR MINGGU,RAGUNAN,39616,14306,25310,15289,40599,2021-08-24
3175091005,JAKARTA TIMUR,CIRACAS,RAMBUTAN,36771,15693,21078,11110,32188,2021-08-24
3172031006,JAKARTA UTARA,KOJA,RAWA BADAK SELATAN,42179,17726,24453,12577,37030,2021-08-24
3172031004,JAKARTA UTARA,KOJA,RAWA BADAK UTARA,34408,14087,20321,11150,31471,2021-08-24
3174071005,JAKARTA SELATAN,KEBAYORAN BARU,RAWA BARAT,5625,1947,3678,2452,6130,2021-08-24
3173011003,JAKARTA BARAT,CENGKARENG,RAWA BUAYA,63799,24797,39002,18721,57723,2021-08-24
3175031004,JAKARTA TIMUR,JATINEGARA,RAWA BUNGA,21434,8875,12559,6549,19108,2021-08-24
3174081003,JAKARTA SELATAN,PANCORAN,RAWA JATI,20509,7655,12854,7319,20173,2021-08-24
3175061002,JAKARTA TIMUR,CAKUNG,RAWA TERATE,24637,8666,15971,7807,23778,2021-08-24
3175021005,JAKARTA TIMUR,PULO GADUNG,RAWAMANGUN,37612,14633,22979,13002,35981,2021-08-24
3171051003,JAKARTA PUSAT,CEMPAKA PUTIH,RAWASARI,21967,8501,13466,7953,21419,2021-08-24
3173041010,JAKARTA BARAT,TAMBORA,ROA MALAKA,3484,1072,2412,1550,3962,2021-08-24
3172041006,JAKARTA UTARA,CILINCING,ROROTAN,41668,15004,26664,13641,40305,2021-08-24
3174071004,JAKARTA SELATAN,KEBAYORAN BARU,SELONG,2842,1002,1840,1355,3195,2021-08-24
3173061002,JAKARTA BARAT,KALI DERES,SEMANAN,71354,27985,43369,18633,62002,2021-08-24
3172041007,JAKARTA UTARA,CILINCING,SEMPER BARAT,68587,24119,44468,24897,69365,2021-08-24
3172041005,JAKARTA UTARA,CILINCING,SEMPER TIMUR,36267,13301,22966,12286,35252,2021-08-24
3174071006,JAKARTA SELATAN,KEBAYORAN BARU,SENAYAN,2771,1164,1607,1042,2649,2021-08-24
3171041001,JAKARTA PUSAT,SENEN,SENEN,6804,2448,4356,2584,6940,2021-08-24
3171031004,JAKARTA PUSAT,KEMAYORAN,SERDANG,29668,11271,18397,9864,28261,2021-08-24
3174021001,JAKARTA SELATAN,SETIA BUDI,SETIA BUDI,3023,1148,1875,1200,3075,2021-08-24
3175101005,JAKARTA TIMUR,CIPAYUNG,SETU,20572,8061,12511,6122,18633,2021-08-24
3173071002,JAKARTA BARAT,PALMERAH,SLIPI,16591,6034,10557,6077,16634,2021-08-24
3173081004,JAKARTA BARAT,KEMBANGAN,SRENGSENG,45523,18185,27338,14517,41855,2021-08-24
3174091002,JAKARTA SELATAN,JAGAKARSA,SRENGSENG SAWAH,58196,19271,38925,23297,62222,2021-08-24
3173051003,JAKARTA BARAT,KEBON JERUK,SUKABUMI SELATAN,37033,15107,21926,9940,31866,2021-08-24
3173051002,JAKARTA BARAT,KEBON JERUK,SUKABUMI UTARA,38290,16537,21753,10297,32050,2021-08-24
3172041002,JAKARTA UTARA,CILINCING,SUKAPURA,53949,20973,32976,18385,51361,2021-08-24
3171031007,JAKARTA PUSAT,KEMAYORAN,SUMUR BATU,22717,8830,13887,7948,21835,2021-08-24
3172021004,JAKARTA UTARA,TANJUNG PRIOK,SUNGAI BAMBU,29876,11084,18792,10375,29167,2021-08-24
3172021006,JAKARTA UTARA,TANJUNG PRIOK,SUNTER AGUNG,71805,23471,48334,30403,78737,2021-08-24
3172021002,JAKARTA UTARA,TANJUNG PRIOK,SUNTER JAYA,63031,21356,41675,25149,66824,2021-08-24
3175091004,JAKARTA TIMUR,CIRACAS,SUSUKAN,38257,13448,24809,12874,37683,2021-08-24
3173031001,JAKARTA BARAT,TAMAN SARI,TAMAN SARI,14348,5261,9087,5676,14763,2021-08-24
3173041001,JAKARTA BARAT,TAMBORA,TAMBORA,10204,3889,6315,3283,9598,2021-08-24
3173041004,JAKARTA BARAT,TAMBORA,TANAH SEREAL,26387,8536,17851,9087,26938,2021-08-24
3171081004,JAKARTA PUSAT,JOHAR BARU,TANAH TINGGI,37693,12191,25502,12970,38472,2021-08-24
3173031004,JAKARTA BARAT,TAMAN SARI,TANGKI,13324,4874,8450,5042,13492,2021-08-24
3174091005,JAKARTA SELATAN,JAGAKARSA,TANJUNG BARAT,39770,14582,25188,13433,38621,2021-08-24
3173021005,JAKARTA BARAT,GROGOL PETAMBURAN,TANJUNG DUREN SELATAN,25337,9207,16130,9637,25767,2021-08-24
3173021002,JAKARTA BARAT,GROGOL PETAMBURAN,TANJUNG DUREN UTARA,17010,5892,11118,6711,17829,2021-08-24
3172021001,JAKARTA UTARA,TANJUNG PRIOK,TANJUNG PRIOK,34588,12177,22411,11431,33842,2021-08-24
3174011002,JAKARTA SELATAN,TEBET,TEBET BARAT,21194,7305,13889,8645,22534,2021-08-24
3174011001,JAKARTA SELATAN,TEBET,TEBET TIMUR,18199,6283,11916,7488,19404,2021-08-24
3173061003,JAKARTA BARAT,KALI DERES,TEGAL ALUR,83647,31225,52422,23781,76203,2021-08-24
3174031004,JAKARTA SELATAN,MAMPANG PRAPATAN,TEGAL PARANG,32401,12941,19460,10398,29858,2021-08-24
3173021003,JAKARTA BARAT,GROGOL PETAMBURAN,TOMANG,29605,10729,18876,11839,30715,2021-08-24
3172031005,JAKARTA UTARA,KOJA,TUGU SELATAN,39122,15924,23198,12222,35420,2021-08-24
3172031002,JAKARTA UTARA,KOJA,TUGU UTARA,67670,27966,39704,21516,61220,2021-08-24
3175061006,JAKARTA TIMUR,CAKUNG,UJUNG MENTENG,29934,10555,19379,10424,29803,2021-08-24
3174101005,JAKARTA SELATAN,PESANGGRAHAN,ULUJAMI,40544,16568,23976,12722,36698,2021-08-24
3175011006,JAKARTA TIMUR,MATRAMAN,UTAN KAYU SELATAN,33511,12422,21089,11518,32607,2021-08-24
3175011002,JAKARTA TIMUR,MATRAMAN,UTAN KAYU UTARA,28169,11317,16852,8930,25782,2021-08-24
3171031008,JAKARTA PUSAT,KEMAYORAN,UTAN PANJANG,29208,11481,17727,9061,26788,2021-08-24
3172021007,JAKARTA UTARA,TANJUNG PRIOK,WARAKAS,44401,16435,27966,15065,43031,2021-08-24
3173021007,JAKARTA BARAT,GROGOL PETAMBURAN,WIJAYA KUSUMA,38934,14989,23945,13728,37673,2021-08-24
3172051003,JAKARTA UTARA,PADEMANGAN,ANCOL,23947,9416,14531,8011,22542,2021-08-25
3173041007,JAKARTA BARAT,TAMBORA,ANGKE,29381,10616,18765,9523,28288,2021-08-25
3175041005,JAKARTA TIMUR,KRAMAT JATI,BALE KAMBANG,29074,12971,16103,6660,22763,2021-08-25
3175031003,JAKARTA TIMUR,JATINEGARA,BALI MESTER,9752,3818,5934,3279,9213,2021-08-25
3175101006,JAKARTA TIMUR,CIPAYUNG,BAMBU APUS,26285,9721,16564,8853,25417,2021-08-25
3174031002,JAKARTA SELATAN,MAMPANG PRAPATAN,BANGKA,21566,8456,13110,7841,20951,2021-08-25
3175051002,JAKARTA TIMUR,PASAR REBO,BARU,23886,7974,15912,10515,26427,2021-08-25
3175041004,JAKARTA TIMUR,KRAMAT JATI,BATU AMPAR,47898,20657,27241,13141,40382,2021-08-25
3171071002,JAKARTA PUSAT,TANAH ABANG,BENDUNGAN HILIR,21494,8195,13299,8007,21306,2021-08-25
3175031002,JAKARTA TIMUR,JATINEGARA,BIDARA CINA,36689,16172,20517,10331,30848,2021-08-25
3174101002,JAKARTA SELATAN,PESANGGRAHAN,BINTARO,53098,20273,32825,20116,52941,2021-08-25
3174011005,JAKARTA SELATAN,TEBET,BUKIT DURI,34183,13738,20445,11212,31657,2021-08-25
3171041006,JAKARTA PUSAT,SENEN,BUNGUR,18144,6757,11387,6367,17754,2021-08-25
3175061007,JAKARTA TIMUR,CAKUNG,CAKUNG BARAT,57724,20296,37428,19050,56478,2021-08-25
3175061004,JAKARTA TIMUR,CAKUNG,CAKUNG TIMUR,58287,20969,37318,21014,58332,2021-08-25
3175041007,JAKARTA TIMUR,KRAMAT JATI,CAWANG,32762,13532,19230,10105,29335,2021-08-25
3175101008,JAKARTA TIMUR,CIPAYUNG,CEGER,18932,6967,11965,6190,18155,2021-08-25
3171031006,JAKARTA PUSAT,KEMAYORAN,CEMPAKA BARU,32581,12960,19621,10439,30060,2021-08-25
3171051002,JAKARTA PUSAT,CEMPAKA PUTIH,CEMPAKA PUTIH BARAT,35885,13884,22001,13132,35133,2021-08-25
3171051001,JAKARTA PUSAT,CEMPAKA PUTIH,CEMPAKA PUTIH TIMUR,24292,9085,15207,9194,24401,2021-08-25
3173011001,JAKARTA BARAT,CENGKARENG,CENGKARENG BARAT,66284,24247,42037,24863,66900,2021-08-25
3173011006,JAKARTA BARAT,CENGKARENG,CENGKARENG TIMUR,81027,29152,51875,25329,77204,2021-08-25
3175091002,JAKARTA TIMUR,CIRACAS,CIBUBUR,66364,23251,43113,25420,68533,2021-08-25
3171011002,JAKARTA PUSAT,GAMBIR,CIDENG,15390,5321,10069,6234,16303,2021-08-25
3174091003,JAKARTA SELATAN,JAGAKARSA,CIGANJUR,38497,14148,24349,14086,38435,2021-08-25
3175051003,JAKARTA TIMUR,PASAR REBO,CIJANTUNG,41419,14584,26835,15753,42588,2021-08-25
3171061003,JAKARTA PUSAT,MENTENG,CIKINI,8274,3390,4884,2787,7671,2021-08-25
3174081006,JAKARTA SELATAN,PANCORAN,CIKOKO,10547,3698,6849,3863,10712,2021-08-25
3174061001,JAKARTA SELATAN,CILANDAK,CILANDAK BARAT,51752,18900,32852,19952,52804,2021-08-25
3174041003,JAKARTA SELATAN,PASAR MINGGU,CILANDAK TIMUR,25145,9055,16090,10458,26548,2021-08-25
3175101002,JAKARTA TIMUR,CIPAYUNG,CILANGKAP,27635,9907,17728,9723,27451,2021-08-25
3175041006,JAKARTA TIMUR,KRAMAT JATI,CILILITAN,40181,16948,23233,12090,35323,2021-08-25
3172041001,JAKARTA UTARA,CILINCING,CILINCING,43609,17310,26299,13784,40083,2021-08-25
3175101001,JAKARTA TIMUR,CIPAYUNG,CIPAYUNG,26104,8789,17315,10110,27425,2021-08-25
3174091006,JAKARTA SELATAN,JAGAKARSA,CIPEDAK,38303,13048,25255,15393,40648,2021-08-25
3174061005,JAKARTA SELATAN,CILANDAK,CIPETE SELATAN,26704,10261,16443,10776,27219,2021-08-25
3174071010,JAKARTA SELATAN,KEBAYORAN BARU,CIPETE UTARA,34102,12736,21366,12817,34183,2021-08-25
3175021003,JAKARTA TIMUR,PULO GADUNG,CIPINANG,39306,15183,24123,13620,37743,2021-08-25
3175031007,JAKARTA TIMUR,JATINEGARA,CIPINANG BESAR SELATAN,35212,15282,19930,9901,29831,2021-08-25
3175031008,JAKARTA TIMUR,JATINEGARA,CIPINANG BESAR UTARA,45319,19042,26277,12264,38541,2021-08-25
3175031005,JAKARTA TIMUR,JATINEGARA,CIPINANG CEMPEDAK,32824,13751,19073,10999,30072,2021-08-25
3175081005,JAKARTA TIMUR,MAKASAR,CIPINANG MELAYU,42308,16577,25731,15140,40871,2021-08-25
3175031006,JAKARTA TIMUR,JATINEGARA,CIPINANG MUARA,55243,23017,32226,16531,48757,2021-08-25
3174051003,JAKARTA SELATAN,KEBAYORAN LAMA,CIPULIR,39937,16255,23682,12522,36204,2021-08-25
3175091001,JAKARTA TIMUR,CIRACAS,CIRACAS,64594,22592,42002,23083,65085,2021-08-25
3175041003,JAKARTA TIMUR,KRAMAT JATI,DUKUH,24609,8954,15655,8109,23764,2021-08-25
3175071001,JAKARTA TIMUR,DUREN SAWIT,DUREN SAWIT,61160,25159,36001,19980,55981,2021-08-25
3174081004,JAKARTA SELATAN,PANCORAN,DUREN TIGA,28319,10718,17601,9168,26769,2021-08-25
3173051005,JAKARTA BARAT,KEBON JERUK,DURI KEPA,60138,21436,38702,22854,61556,2021-08-25
3173011002,JAKARTA BARAT,CENGKARENG,DURI KOSAMBI,77923,31661,46262,23450,69712,2021-08-25
3171011006,JAKARTA PUSAT,GAMBIR,DURI PULO,19610,7195,12415,6726,19141,2021-08-25
3173041011,JAKARTA BARAT,TAMBORA,DURI SELATAN,14259,4811,9448,5447,14895,2021-08-25
3173041003,JAKARTA BARAT,TAMBORA,DURI UTARA,19844,6991,12853,7016,19869,2021-08-25
3171081003,JAKARTA PUSAT,JOHAR BARU,GALUR,18243,5883,12360,6376,18736,2021-08-25
3171011001,JAKARTA PUSAT,GAMBIR,GAMBIR,2191,757,1434,885,2319,2021-08-25
3174061004,JAKARTA SELATAN,CILANDAK,GANDARIA SELATAN,22119,8386,13733,7852,21585,2021-08-25
3174071009,JAKARTA SELATAN,KEBAYORAN BARU,GANDARIA UTARA,39922,15221,24701,14739,39440,2021-08-25
3175051001,JAKARTA TIMUR,PASAR REBO,GEDONG,35755,13051,22704,12704,35408,2021-08-25
3171071001,JAKARTA PUSAT,TANAH ABANG,GELORA,3127,1248,1879,1074,2953,2021-08-25
3173031007,JAKARTA BARAT,TAMAN SARI,GLODOK,7837,2486,5351,3510,8861,2021-08-25
3171061004,JAKARTA PUSAT,MENTENG,GONDANGDIA,4100,1536,2564,1895,4459,2021-08-25
3173021001,JAKARTA BARAT,GROGOL PETAMBURAN,GROGOL,16876,6272,10604,6235,16839,2021-08-25
3174051005,JAKARTA SELATAN,KEBAYORAN LAMA,GROGOL SELATAN,44251,17231,27020,14906,41926,2021-08-25
3174051004,JAKARTA SELATAN,KEBAYORAN LAMA,GROGOL UTARA,42494,16395,26099,14187,40286,2021-08-25
3174021007,JAKARTA SELATAN,SETIA BUDI,GUNTUR,3985,1427,2558,1780,4338,2021-08-25
3174071002,JAKARTA SELATAN,KEBAYORAN BARU,GUNUNG,9436,3385,6051,4131,10182,2021-08-25
3171031005,JAKARTA PUSAT,KEMAYORAN,GUNUNG SAHARI SELATAN,19199,7270,11929,7086,19015,2021-08-25
3171021004,JAKARTA PUSAT,SAWAH BESAR,GUNUNG SAHARI UTARA,16650,5427,11223,7079,18302,2021-08-25
3175081004,JAKARTA TIMUR,MAKASAR,HALIM PERDANA KUSUMAH,28363,8171,20192,15265,35457,2021-08-25
3171031003,JAKARTA PUSAT,KEMAYORAN,HARAPAN MULIA,22557,8603,13954,7647,21601,2021-08-25
3174091001,JAKARTA SELATAN,JAGAKARSA,JAGAKARSA,62389,22124,40265,24953,65218,2021-08-25
3175021007,JAKARTA TIMUR,PULO GADUNG,JATI,32757,12428,20329,11698,32027,2021-08-25
3174041002,JAKARTA SELATAN,PASAR MINGGU,JATI PADANG,37502,14102,23400,14299,37699,2021-08-25
3173071004,JAKARTA BARAT,PALMERAH,JATI PULO,28738,10499,18239,9564,27803,2021-08-25
3175061001,JAKARTA TIMUR,CAKUNG,JATINEGARA,84160,32988,51172,25525,76697,2021-08-25
3175021004,JAKARTA TIMUR,PULO GADUNG,JATINEGARA KAUM,24632,8664,15968,7763,23731,2021-08-25
3173021004,JAKARTA BARAT,GROGOL PETAMBURAN,JELAMBAR,30266,11105,19161,12131,31292,2021-08-25
3173021006,JAKARTA BARAT,GROGOL PETAMBURAN,JELAMBAR BARU,38246,14104,24142,14866,39008,2021-08-25
3173041006,JAKARTA BARAT,TAMBORA,JEMBATAN BESI,29314,12703,16611,7910,24521,2021-08-25
3173041008,JAKARTA BARAT,TAMBORA,JEMBATAN LIMA,21021,8383,12638,6471,19109,2021-08-25
3173081005,JAKARTA BARAT,KEMBANGAN,JOGLO,40839,15701,25138,13651,38789,2021-08-25
3171081001,JAKARTA PUSAT,JOHAR BARU,JOHAR BARU,37488,12566,24922,14209,39131,2021-08-25
3173041002,JAKARTA BARAT,TAMBORA,KALI ANYAR,23856,8331,15525,7286,22811,2021-08-25
3172041004,JAKARTA UTARA,CILINCING,KALIBARU,67684,28711,38973,19036,58009,2021-08-25
3174081002,JAKARTA SELATAN,PANCORAN,KALIBATA,41994,17638,24356,12587,36943,2021-08-25
3173061001,JAKARTA BARAT,KALI DERES,KALIDERES,72447,27397,45050,25508,70558,2021-08-25
3175051004,JAKARTA TIMUR,PASAR REBO,KALISARI,43212,15513,27699,16158,43857,2021-08-25
3173061004,JAKARTA BARAT,KALI DERES,KAMAL,53783,20853,32930,14144,47074,2021-08-25
3172011002,JAKARTA UTARA,PENJARINGAN,KAMAL MUARA,12930,3718,9212,6202,15414,2021-08-25
3171071007,JAKARTA PUSAT,TANAH ABANG,KAMPUNG BALI,11358,4896,6462,3488,9950,2021-08-25
3175031001,JAKARTA TIMUR,JATINEGARA,KAMPUNG MELAYU,25717,10862,14855,7318,22173,2021-08-25
3171081002,JAKARTA PUSAT,JOHAR BARU,KAMPUNG RAWA,21237,6014,15223,8064,23287,2021-08-25
3175041002,JAKARTA TIMUR,KRAMAT JATI,KAMPUNG TENGAH,43993,18895,25098,12192,37290,2021-08-25
3173011005,JAKARTA BARAT,CENGKARENG,KAPUK,134466,54390,80076,37240,117316,2021-08-25
3172011003,JAKARTA UTARA,PENJARINGAN,KAPUK MUARA,35781,11761,24020,16064,40084,2021-08-25
3171021002,JAKARTA PUSAT,SAWAH BESAR,KARANG ANYAR,25761,8995,16766,9184,25950,2021-08-25
3174021004,JAKARTA SELATAN,SETIA BUDI,KARET,9623,3709,5914,3725,9639,2021-08-25
3174021003,JAKARTA SELATAN,SETIA BUDI,KARET KUNINGAN,16055,5459,10596,6592,17188,2021-08-25
3174021002,JAKARTA SELATAN,SETIA BUDI,KARET SEMANGGI,2770,964,1806,1308,3114,2021-08-25
3171071003,JAKARTA PUSAT,TANAH ABANG,KARET TENGSIN,19271,7311,11960,6701,18661,2021-08-25
3171021003,JAKARTA PUSAT,SAWAH BESAR,KARTINI,22292,8055,14237,8543,22780,2021-08-25
3175011003,JAKARTA TIMUR,MATRAMAN,KAYU MANIS,25284,10382,14902,7552,22454,2021-08-25
3175021006,JAKARTA TIMUR,PULO GADUNG,KAYU PUTIH,40696,14571,26125,16080,42205,2021-08-25
3173031006,JAKARTA BARAT,TAMAN SARI,KEAGUNGAN,17387,6193,11194,6545,17739,2021-08-25
3174041007,JAKARTA SELATAN,PASAR MINGGU,KEBAGUSAN,44552,17378,27174,15373,42547,2021-08-25
3174051006,JAKARTA SELATAN,KEBAYORAN LAMA,KEBAYORAN LAMA SELATAN,41212,15026,26186,15062,41248,2021-08-25
3174051001,JAKARTA SELATAN,KEBAYORAN LAMA,KEBAYORAN LAMA UTARA,42422,16831,25591,13422,39013,2021-08-25
3174011004,JAKARTA SELATAN,TEBET,KEBON BARU,35165,13286,21879,12312,34191,2021-08-25
3172021005,JAKARTA UTARA,TANJUNG PRIOK,KEBON BAWANG,50952,19045,31907,18437,50344,2021-08-25
3173051001,JAKARTA BARAT,KEBON JERUK,KEBON JERUK,53887,21697,32190,16934,49124,2021-08-25
3171071006,JAKARTA PUSAT,TANAH ABANG,KEBON KACANG,21531,9732,11799,6326,18125,2021-08-25
3171011005,JAKARTA PUSAT,GAMBIR,KEBON KELAPA,10163,3720,6443,3686,10129,2021-08-25
3171031002,JAKARTA PUSAT,KEMAYORAN,KEBON KOSONG,30019,11603,18416,10450,28866,2021-08-25
3175011005,JAKARTA TIMUR,MATRAMAN,KEBON MANGGIS,16490,6115,10375,6068,16443,2021-08-25
3171071005,JAKARTA PUSAT,TANAH ABANG,KEBON MELATI,32206,15360,16846,8426,25272,2021-08-25
3175081003,JAKARTA TIMUR,MAKASAR,KEBON PALA,46614,17369,29245,15862,45107,2021-08-25
3171061005,JAKARTA PUSAT,MENTENG,KEBON SIRIH,12299,5022,7277,3883,11160,2021-08-25
3173011004,JAKARTA BARAT,CENGKARENG,KEDAUNG KALI ANGKE,32612,11095,21517,11808,33325,2021-08-25
3173051007,JAKARTA BARAT,KEBON JERUK,KEDOYA SELATAN,32165,11738,20427,10874,31301,2021-08-25
3173051006,JAKARTA BARAT,KEBON JERUK,KEDOYA UTARA,45740,15659,30081,17038,47119,2021-08-25
3173051004,JAKARTA BARAT,KEBON JERUK,KELAPA DUA,23565,9144,14421,7518,21939,2021-08-25
3175091003,JAKARTA TIMUR,CIRACAS,KELAPA DUA WETAN,46875,16133,30742,17037,47779,2021-08-25
3172061003,JAKARTA UTARA,KELAPA GADING,KELAPA GADING BARAT,35717,11716,24001,16730,40731,2021-08-25
3172061001,JAKARTA UTARA,KELAPA GADING,KELAPA GADING TIMUR,33592,10156,23436,16063,39499,2021-08-25
3173071005,JAKARTA BARAT,PALMERAH,KEMANGGISAN,32139,12137,20002,10952,30954,2021-08-25
3171031001,JAKARTA PUSAT,KEMAYORAN,KEMAYORAN,20708,7559,13149,7530,20679,2021-08-25
3173081006,JAKARTA BARAT,KEMBANGAN,KEMBANGAN SELATAN,27130,10128,17002,10357,27359,2021-08-25
3173081001,JAKARTA BARAT,KEMBANGAN,KEMBANGAN UTARA,54451,20459,33992,18569,52561,2021-08-25
3171041002,JAKARTA PUSAT,SENEN,KENARI,9579,3498,6081,3356,9437,2021-08-25
3173041005,JAKARTA BARAT,TAMBORA,KERENDANG,19973,7264,12709,7031,19740,2021-08-25
3175071003,JAKARTA TIMUR,DUREN SAWIT,KLENDER,69978,29550,40428,19829,60257,2021-08-25
3172031001,JAKARTA UTARA,KOJA,KOJA,28175,11085,17090,9813,26903,2021-08-25
3173071006,JAKARTA BARAT,PALMERAH,KOTA BAMBU SELATAN,21158,8157,13001,6584,19585,2021-08-25
3173071003,JAKARTA BARAT,PALMERAH,KOTA BAMBU UTARA,24995,9834,15161,7879,23040,2021-08-25
3171041004,JAKARTA PUSAT,SENEN,KRAMAT,28835,11623,17212,8468,25680,2021-08-25
3175041001,JAKARTA TIMUR,KRAMAT JATI,KRAMAT JATI,34144,13098,21046,10515,31561,2021-08-25
3174071003,JAKARTA SELATAN,KEBAYORAN BARU,KRAMAT PELA,14413,5117,9296,5640,14936,2021-08-25
3173031002,JAKARTA BARAT,TAMAN SARI,KRUKUT,19244,7041,12203,6474,18677,2021-08-25
3174031005,JAKARTA SELATAN,MAMPANG PRAPATAN,KUNINGAN BARAT,12785,4557,8228,4902,13130,2021-08-25
3174021008,JAKARTA SELATAN,SETIA BUDI,KUNINGAN TIMUR,6008,2191,3817,2437,6254,2021-08-25
3171041005,JAKARTA PUSAT,SENEN,KWITANG,15486,5815,9671,5281,14952,2021-08-25
3172031003,JAKARTA UTARA,KOJA,LAGOA,59065,23776,35289,19173,54462,2021-08-25
3174061002,JAKARTA SELATAN,CILANDAK,LEBAK BULUS,37626,14523,23103,14076,37179,2021-08-25
3174091004,JAKARTA SELATAN,JAGAKARSA,LENTENG AGUNG,53946,20900,33046,17913,50959,2021-08-25
3175101007,JAKARTA TIMUR,CIPAYUNG,LUBANG BUAYA,63547,22188,41359,23281,64640,2021-08-25
3175081001,JAKARTA TIMUR,MAKASAR,MAKASAR,34390,12492,21898,12497,34395,2021-08-25
3175071006,JAKARTA TIMUR,DUREN SAWIT,MALAKA JAYA,30927,11812,19115,12051,31166,2021-08-25
3175071005,JAKARTA TIMUR,DUREN SAWIT,MALAKA SARI,27530,10159,17371,10944,28315,2021-08-25
3174031001,JAKARTA SELATAN,MAMPANG PRAPATAN,MAMPANG PRAPATAN,18159,6768,11391,6960,18351,2021-08-25
3173031005,JAKARTA BARAT,TAMAN SARI,MANGGA BESAR,7707,2475,5232,3339,8571,2021-08-25
3171021005,JAKARTA PUSAT,SAWAH BESAR,MANGGA DUA SELATAN,27442,10004,17438,10005,27443,2021-08-25
3174011007,JAKARTA SELATAN,TEBET,MANGGARAI,28373,9868,18505,9883,28388,2021-08-25
3174011006,JAKARTA SELATAN,TEBET,MANGGARAI SELATAN,23075,8282,14793,8624,23417,2021-08-25
3173031003,JAKARTA BARAT,TAMAN SARI,MAPHAR,16461,6088,10373,6308,16681,2021-08-25
3172041003,JAKARTA UTARA,CILINCING,MARUNDA,28943,10532,18411,8219,26630,2021-08-25
3174071001,JAKARTA SELATAN,KEBAYORAN BARU,MELAWAI,2627,907,1720,1318,3038,2021-08-25
3171061001,JAKARTA PUSAT,MENTENG,MENTENG,25624,10170,15454,8627,24081,2021-08-25
3174021005,JAKARTA SELATAN,SETIA BUDI,MENTENG ATAS,27816,9791,18025,10315,28340,2021-08-25
3174011003,JAKARTA SELATAN,TEBET,MENTENG DALAM,36028,13516,22512,13081,35593,2021-08-25
3173081003,JAKARTA BARAT,KEMBANGAN,MERUYA SELATAN,32130,12121,20009,10826,30835,2021-08-25
3173081002,JAKARTA BARAT,KEMBANGAN,MERUYA UTARA,43752,16612,27140,15959,43099,2021-08-25
3175101004,JAKARTA TIMUR,CIPAYUNG,MUNJUL,23871,8345,15526,8647,24173,2021-08-25
3172051002,JAKARTA UTARA,PADEMANGAN,PADEMANGAN BARAT,74240,29124,45116,24458,69574,2021-08-25
3172051001,JAKARTA UTARA,PADEMANGAN,PADEMANGAN TIMUR,37736,12369,25367,15895,41262,2021-08-25
3175011004,JAKARTA TIMUR,MATRAMAN,PAL MERIAM,19769,7921,11848,6397,18245,2021-08-25
3173071001,JAKARTA BARAT,PALMERAH,PALMERAH,63011,24283,38728,20416,59144,2021-08-25
3174081001,JAKARTA SELATAN,PANCORAN,PANCORAN,19421,7334,12087,7109,19196,2021-08-25
3172021003,JAKARTA UTARA,TANJUNG PRIOK,PAPANGGO,39097,13725,25372,14097,39469,2021-08-25
3171021001,JAKARTA PUSAT,SAWAH BESAR,PASAR BARU,12035,3888,8147,5239,13386,2021-08-25
3174021006,JAKARTA SELATAN,SETIA BUDI,PASAR MANGGIS,26752,10015,16737,9796,26533,2021-08-25
3174041001,JAKARTA SELATAN,PASAR MINGGU,PASAR MINGGU,24821,9249,15572,9701,25273,2021-08-25
3171041003,JAKARTA PUSAT,SENEN,PASEBAN,23533,9111,14422,7980,22402,2021-08-25
3173061005,JAKARTA BARAT,KALI DERES,PEGADUNGAN,75587,26463,49124,27516,76640,2021-08-25
3171061002,JAKARTA PUSAT,MENTENG,PEGANGSAAN,23455,9314,14141,7262,21403,2021-08-25
3172061002,JAKARTA UTARA,KELAPA GADING,PEGANGSAAN DUA,49976,15117,34859,22746,57605,2021-08-25
3172011004,JAKARTA UTARA,PENJARINGAN,PEJAGALAN,74578,27518,47060,28589,75649,2021-08-25
3174041006,JAKARTA SELATAN,PASAR MINGGU,PEJATEN BARAT,37346,14331,23015,13891,36906,2021-08-25
3174041005,JAKARTA SELATAN,PASAR MINGGU,PEJATEN TIMUR,57656,23074,34582,18234,52816,2021-08-25
3175051005,JAKARTA TIMUR,PASAR REBO,PEKAYON,43250,15307,27943,15898,43841,2021-08-25
3173041009,JAKARTA BARAT,TAMBORA,PEKOJAN,23587,8107,15480,8977,24457,2021-08-25
3174031003,JAKARTA SELATAN,MAMPANG PRAPATAN,PELA MAMPANG,43522,16060,27462,17123,44585,2021-08-25
3174081005,JAKARTA SELATAN,PANCORAN,PENGADEGAN,21478,7319,14159,7497,21656,2021-08-25
3175061003,JAKARTA TIMUR,CAKUNG,PENGGILINGAN,99255,42132,57123,27919,85042,2021-08-25
3172011001,JAKARTA UTARA,PENJARINGAN,PENJARINGAN,88308,36499,51809,26257,78066,2021-08-25
3174101001,JAKARTA SELATAN,PESANGGRAHAN,PESANGGRAHAN,27545,9595,17950,10873,28823,2021-08-25
3171071004,JAKARTA PUSAT,TANAH ABANG,PETAMBURAN,33271,15763,17508,8437,25945,2021-08-25
3174071008,JAKARTA SELATAN,KEBAYORAN BARU,PETOGOGAN,11499,4364,7135,4525,11660,2021-08-25
3171011004,JAKARTA PUSAT,GAMBIR,PETOJO SELATAN,14692,5586,9106,5475,14581,2021-08-25
3171011003,JAKARTA PUSAT,GAMBIR,PETOJO UTARA,17458,6510,10948,5694,16642,2021-08-25
3174101004,JAKARTA SELATAN,PESANGGRAHAN,PETUKANGAN SELATAN,37187,13913,23274,13311,36585,2021-08-25
3174101003,JAKARTA SELATAN,PESANGGRAHAN,PETUKANGAN UTARA,53716,21334,32382,19011,51393,2021-08-25
3175081002,JAKARTA TIMUR,MAKASAR,PINANG RANTI,27198,10333,16865,9968,26833,2021-08-25
3173031008,JAKARTA BARAT,TAMAN SARI,PINANGSIA,10729,3602,7127,4299,11426,2021-08-25
3175011001,JAKARTA TIMUR,MATRAMAN,PISANGAN BARU,31776,12807,18969,9174,28143,2021-08-25
3175021002,JAKARTA TIMUR,PULO GADUNG,PISANGAN TIMUR,41011,14873,26138,13814,39952,2021-08-25
3172011005,JAKARTA UTARA,PENJARINGAN,PLUIT,47783,16776,31007,21136,52143,2021-08-25
3175071002,JAKARTA TIMUR,DUREN SAWIT,PONDOK BAMBU,61550,25117,36433,19530,55963,2021-08-25
3175071004,JAKARTA TIMUR,DUREN SAWIT,PONDOK KELAPA,72015,27230,44785,24484,69269,2021-08-25
3175071007,JAKARTA TIMUR,DUREN SAWIT,PONDOK KOPI,35367,15268,20099,10606,30705,2021-08-25
3174061003,JAKARTA SELATAN,CILANDAK,PONDOK LABU,46464,16426,30038,19493,49531,2021-08-25
3174051002,JAKARTA SELATAN,KEBAYORAN LAMA,PONDOK PINANG,56169,21291,34878,21225,56103,2021-08-25
3175101003,JAKARTA TIMUR,CIPAYUNG,PONDOK RANGGON,25574,9217,16357,8822,25179,2021-08-25
3101011003,KAB.ADM.KEP.SERIBU,KEP. SERIBU UTARA,PULAU HARAPAN,2060,344,1716,991,2707,2021-08-25
3101011002,KAB.ADM.KEP.SERIBU,KEP. SERIBU UTARA,PULAU KELAPA,5528,931,4597,2546,7143,2021-08-25
3101011001,KAB.ADM.KEP.SERIBU,KEP. SERIBU UTARA,PULAU PANGGANG,5450,900,4550,2051,6601,2021-08-25
3101021003,KAB.ADM.KEP.SERIBU,KEP. SERIBU SELATAN,PULAU PARI,2765,326,2439,1363,3802,2021-08-25
3101021002,KAB.ADM.KEP.SERIBU,KEP. SERIBU SELATAN,PULAU TIDUNG,4553,664,3889,2595,6484,2021-08-25
3101021001,KAB.ADM.KEP.SERIBU,KEP. SERIBU SELATAN,PULAU UNTUNG JAWA,1941,332,1609,850,2459,2021-08-25
3174071007,JAKARTA SELATAN,KEBAYORAN BARU,PULO,5835,2004,3831,2702,6533,2021-08-25
3175021001,JAKARTA TIMUR,PULO GADUNG,PULO GADUNG,34422,13304,21118,11571,32689,2021-08-25
3175061005,JAKARTA TIMUR,CAKUNG,PULO GEBANG,97301,38447,58854,30730,89584,2021-08-25
3174041004,JAKARTA SELATAN,PASAR MINGGU,RAGUNAN,39616,14220,25396,15557,40953,2021-08-25
3175091005,JAKARTA TIMUR,CIRACAS,RAMBUTAN,36771,15578,21193,11537,32730,2021-08-25
3172031006,JAKARTA UTARA,KOJA,RAWA BADAK SELATAN,42179,17589,24590,12916,37506,2021-08-25
3172031004,JAKARTA UTARA,KOJA,RAWA BADAK UTARA,34408,13906,20502,11364,31866,2021-08-25
3174071005,JAKARTA SELATAN,KEBAYORAN BARU,RAWA BARAT,5625,1933,3692,2484,6176,2021-08-25
3173011003,JAKARTA BARAT,CENGKARENG,RAWA BUAYA,63799,24589,39210,19515,58725,2021-08-25
3175031004,JAKARTA TIMUR,JATINEGARA,RAWA BUNGA,21434,8820,12614,6758,19372,2021-08-25
3174081003,JAKARTA SELATAN,PANCORAN,RAWA JATI,20509,7586,12923,7406,20329,2021-08-25
3175061002,JAKARTA TIMUR,CAKUNG,RAWA TERATE,24637,8556,16081,8022,24103,2021-08-25
3175021005,JAKARTA TIMUR,PULO GADUNG,RAWAMANGUN,37612,14544,23068,13351,36419,2021-08-25
3171051003,JAKARTA PUSAT,CEMPAKA PUTIH,RAWASARI,21967,8452,13515,8116,21631,2021-08-25
3173041010,JAKARTA BARAT,TAMBORA,ROA MALAKA,3484,1070,2414,1577,3991,2021-08-25
3172041006,JAKARTA UTARA,CILINCING,ROROTAN,41668,14837,26831,14004,40835,2021-08-25
3174071004,JAKARTA SELATAN,KEBAYORAN BARU,SELONG,2842,994,1848,1366,3214,2021-08-25
3173061002,JAKARTA BARAT,KALI DERES,SEMANAN,71354,27836,43518,19420,62938,2021-08-25
3172041007,JAKARTA UTARA,CILINCING,SEMPER BARAT,68587,23961,44626,25460,70086,2021-08-25
3172041005,JAKARTA UTARA,CILINCING,SEMPER TIMUR,36267,13205,23062,12498,35560,2021-08-25
3174071006,JAKARTA SELATAN,KEBAYORAN BARU,SENAYAN,2771,1154,1617,1057,2674,2021-08-25
3171041001,JAKARTA PUSAT,SENEN,SENEN,6804,2430,4374,2653,7027,2021-08-25
3171031004,JAKARTA PUSAT,KEMAYORAN,SERDANG,29668,11217,18451,10062,28513,2021-08-25
3174021001,JAKARTA SELATAN,SETIA BUDI,SETIA BUDI,3023,1142,1881,1211,3092,2021-08-25
3175101005,JAKARTA TIMUR,CIPAYUNG,SETU,20572,7988,12584,6355,18939,2021-08-25
3173071002,JAKARTA BARAT,PALMERAH,SLIPI,16591,5995,10596,6191,16787,2021-08-25
3173081004,JAKARTA BARAT,KEMBANGAN,SRENGSENG,45523,18017,27506,15030,42536,2021-08-25
3174091002,JAKARTA SELATAN,JAGAKARSA,SRENGSENG SAWAH,58196,19159,39037,23618,62655,2021-08-25
3173051003,JAKARTA BARAT,KEBON JERUK,SUKABUMI SELATAN,37033,14973,22060,10171,32231,2021-08-25
3173051002,JAKARTA BARAT,KEBON JERUK,SUKABUMI UTARA,38290,16412,21878,10582,32460,2021-08-25
3172041002,JAKARTA UTARA,CILINCING,SUKAPURA,53949,20822,33127,18761,51888,2021-08-25
3171031007,JAKARTA PUSAT,KEMAYORAN,SUMUR BATU,22717,8772,13945,8075,22020,2021-08-25
3172021004,JAKARTA UTARA,TANJUNG PRIOK,SUNGAI BAMBU,29876,11027,18849,10585,29434,2021-08-25
3172021006,JAKARTA UTARA,TANJUNG PRIOK,SUNTER AGUNG,71805,23312,48493,30967,79460,2021-08-25
3172021002,JAKARTA UTARA,TANJUNG PRIOK,SUNTER JAYA,63031,21171,41860,25674,67534,2021-08-25
3175091004,JAKARTA TIMUR,CIRACAS,SUSUKAN,38257,13252,25005,13629,38634,2021-08-25
3173031001,JAKARTA BARAT,TAMAN SARI,TAMAN SARI,14348,5237,9111,5780,14891,2021-08-25
3173041001,JAKARTA BARAT,TAMBORA,TAMBORA,10204,3863,6341,3343,9684,2021-08-25
3173041004,JAKARTA BARAT,TAMBORA,TANAH SEREAL,26387,8462,17925,9272,27197,2021-08-25
3171081004,JAKARTA PUSAT,JOHAR BARU,TANAH TINGGI,37693,12109,25584,13245,38829,2021-08-25
3173031004,JAKARTA BARAT,TAMAN SARI,TANGKI,13324,4823,8501,5212,13713,2021-08-25
3174091005,JAKARTA SELATAN,JAGAKARSA,TANJUNG BARAT,39770,14475,25295,13693,38988,2021-08-25
3173021005,JAKARTA BARAT,GROGOL PETAMBURAN,TANJUNG DUREN SELATAN,25337,9160,16177,9860,26037,2021-08-25
3173021002,JAKARTA BARAT,GROGOL PETAMBURAN,TANJUNG DUREN UTARA,17010,5850,11160,6804,17964,2021-08-25
3172021001,JAKARTA UTARA,TANJUNG PRIOK,TANJUNG PRIOK,34588,12109,22479,11742,34221,2021-08-25
3174011002,JAKARTA SELATAN,TEBET,TEBET BARAT,21194,7246,13948,8824,22772,2021-08-25
3174011001,JAKARTA SELATAN,TEBET,TEBET TIMUR,18199,6226,11973,7609,19582,2021-08-25
3173061003,JAKARTA BARAT,KALI DERES,TEGAL ALUR,83647,31003,52644,24748,77392,2021-08-25
3174031004,JAKARTA SELATAN,MAMPANG PRAPATAN,TEGAL PARANG,32401,12880,19521,10660,30181,2021-08-25
3173021003,JAKARTA BARAT,GROGOL PETAMBURAN,TOMANG,29605,10680,18925,11996,30921,2021-08-25
3172031005,JAKARTA UTARA,KOJA,TUGU SELATAN,39122,15824,23298,12601,35899,2021-08-25
3172031002,JAKARTA UTARA,KOJA,TUGU UTARA,67670,27740,39930,21994,61924,2021-08-25
3175061006,JAKARTA TIMUR,CAKUNG,UJUNG MENTENG,29934,10452,19482,10671,30153,2021-08-25
3174101005,JAKARTA SELATAN,PESANGGRAHAN,ULUJAMI,40544,16449,24095,13210,37305,2021-08-25
3175011006,JAKARTA TIMUR,MATRAMAN,UTAN KAYU SELATAN,33511,12340,21171,11722,32893,2021-08-25
3175011002,JAKARTA TIMUR,MATRAMAN,UTAN KAYU UTARA,28169,11185,16984,9102,26086,2021-08-25
3171031008,JAKARTA PUSAT,KEMAYORAN,UTAN PANJANG,29208,11402,17806,9311,27117,2021-08-25
3172021007,JAKARTA UTARA,TANJUNG PRIOK,WARAKAS,44401,16358,28043,15291,43334,2021-08-25
3173021007,JAKARTA BARAT,GROGOL PETAMBURAN,WIJAYA KUSUMA,38934,14917,24017,14125,38142,2021-08-25
3172051003,JAKARTA UTARA,PADEMANGAN,ANCOL,23947,9368,14579,8223,22802,2021-08-26
3173041007,JAKARTA BARAT,TAMBORA,ANGKE,29381,10574,18807,9688,28495,2021-08-26
3175041005,JAKARTA TIMUR,KRAMAT JATI,BALE KAMBANG,29074,12829,16245,6970,23215,2021-08-26
3175031003,JAKARTA TIMUR,JATINEGARA,BALI MESTER,9752,3789,5963,3361,9324,2021-08-26
3175101006,JAKARTA TIMUR,CIPAYUNG,BAMBU APUS,26285,9670,16615,9067,25682,2021-08-26
3174031002,JAKARTA SELATAN,MAMPANG PRAPATAN,BANGKA,21566,8398,13168,7988,21156,2021-08-26
3175051002,JAKARTA TIMUR,PASAR REBO,BARU,23886,7940,15946,10646,26592,2021-08-26
3175041004,JAKARTA TIMUR,KRAMAT JATI,BATU AMPAR,47898,20453,27445,13744,41189,2021-08-26
3171071002,JAKARTA PUSAT,TANAH ABANG,BENDUNGAN HILIR,21494,8158,13336,8158,21494,2021-08-26
3175031002,JAKARTA TIMUR,JATINEGARA,BIDARA CINA,36689,16057,20632,10669,31301,2021-08-26
3174101002,JAKARTA SELATAN,PESANGGRAHAN,BINTARO,53098,20167,32931,20547,53478,2021-08-26
3174011005,JAKARTA SELATAN,TEBET,BUKIT DURI,34183,13577,20606,11561,32167,2021-08-26
3171041006,JAKARTA PUSAT,SENEN,BUNGUR,18144,6698,11446,6470,17916,2021-08-26
3175061007,JAKARTA TIMUR,CAKUNG,CAKUNG BARAT,57724,20177,37547,19661,57208,2021-08-26
3175061004,JAKARTA TIMUR,CAKUNG,CAKUNG TIMUR,58287,20817,37470,21848,59318,2021-08-26
3175041007,JAKARTA TIMUR,KRAMAT JATI,CAWANG,32762,13413,19349,10362,29711,2021-08-26
3175101008,JAKARTA TIMUR,CIPAYUNG,CEGER,18932,6933,11999,6417,18416,2021-08-26
3171031006,JAKARTA PUSAT,KEMAYORAN,CEMPAKA BARU,32581,12790,19791,10745,30536,2021-08-26
3171051002,JAKARTA PUSAT,CEMPAKA PUTIH,CEMPAKA PUTIH BARAT,35885,13791,22094,13489,35583,2021-08-26
3171051001,JAKARTA PUSAT,CEMPAKA PUTIH,CEMPAKA PUTIH TIMUR,24292,9013,15279,9361,24640,2021-08-26
3173011001,JAKARTA BARAT,CENGKARENG,CENGKARENG BARAT,66284,24108,42176,25145,67321,2021-08-26
3173011006,JAKARTA BARAT,CENGKARENG,CENGKARENG TIMUR,81027,28980,52047,25746,77793,2021-08-26
3175091002,JAKARTA TIMUR,CIRACAS,CIBUBUR,66364,23048,43316,26018,69334,2021-08-26
3171011002,JAKARTA PUSAT,GAMBIR,CIDENG,15390,5289,10101,6308,16409,2021-08-26
3174091003,JAKARTA SELATAN,JAGAKARSA,CIGANJUR,38497,14042,24455,14404,38859,2021-08-26
3175051003,JAKARTA TIMUR,PASAR REBO,CIJANTUNG,41419,14478,26941,16096,43037,2021-08-26
3171061003,JAKARTA PUSAT,MENTENG,CIKINI,8274,3250,5024,2892,7916,2021-08-26
3174081006,JAKARTA SELATAN,PANCORAN,CIKOKO,10547,3672,6875,3942,10817,2021-08-26
3174061001,JAKARTA SELATAN,CILANDAK,CILANDAK BARAT,51752,18778,32974,20367,53341,2021-08-26
3174041003,JAKARTA SELATAN,PASAR MINGGU,CILANDAK TIMUR,25145,8994,16151,10620,26771,2021-08-26
3175101002,JAKARTA TIMUR,CIPAYUNG,CILANGKAP,27635,9837,17798,9960,27758,2021-08-26
3175041006,JAKARTA TIMUR,KRAMAT JATI,CILILITAN,40181,16820,23361,12363,35724,2021-08-26
3172041001,JAKARTA UTARA,CILINCING,CILINCING,43609,17194,26415,14069,40484,2021-08-26
3175101001,JAKARTA TIMUR,CIPAYUNG,CIPAYUNG,26104,8693,17411,10257,27668,2021-08-26
3174091006,JAKARTA SELATAN,JAGAKARSA,CIPEDAK,38303,12975,25328,15644,40972,2021-08-26
3174061005,JAKARTA SELATAN,CILANDAK,CIPETE SELATAN,26704,10179,16525,10988,27513,2021-08-26
3174071010,JAKARTA SELATAN,KEBAYORAN BARU,CIPETE UTARA,34102,12632,21470,13120,34590,2021-08-26
3175021003,JAKARTA TIMUR,PULO GADUNG,CIPINANG,39306,15070,24236,13943,38179,2021-08-26
3175031007,JAKARTA TIMUR,JATINEGARA,CIPINANG BESAR SELATAN,35212,15077,20135,10314,30449,2021-08-26
3175031008,JAKARTA TIMUR,JATINEGARA,CIPINANG BESAR UTARA,45319,18922,26397,12844,39241,2021-08-26
3175031005,JAKARTA TIMUR,JATINEGARA,CIPINANG CEMPEDAK,32824,13665,19159,11193,30352,2021-08-26
3175081005,JAKARTA TIMUR,MAKASAR,CIPINANG MELAYU,42308,16456,25852,15520,41372,2021-08-26
3175031006,JAKARTA TIMUR,JATINEGARA,CIPINANG MUARA,55243,22847,32396,16945,49341,2021-08-26
3174051003,JAKARTA SELATAN,KEBAYORAN LAMA,CIPULIR,39937,16176,23761,12774,36535,2021-08-26
3175091001,JAKARTA TIMUR,CIRACAS,CIRACAS,64594,22409,42185,23638,65823,2021-08-26
3175041003,JAKARTA TIMUR,KRAMAT JATI,DUKUH,24609,8890,15719,8355,24074,2021-08-26
3175071001,JAKARTA TIMUR,DUREN SAWIT,DUREN SAWIT,61160,24987,36173,20434,56607,2021-08-26
3174081004,JAKARTA SELATAN,PANCORAN,DUREN TIGA,28319,10631,17688,9387,27075,2021-08-26
3173051005,JAKARTA BARAT,KEBON JERUK,DURI KEPA,60138,21319,38819,23274,62093,2021-08-26
3173011002,JAKARTA BARAT,CENGKARENG,DURI KOSAMBI,77923,31379,46544,24140,70684,2021-08-26
3171011006,JAKARTA PUSAT,GAMBIR,DURI PULO,19610,7167,12443,6881,19324,2021-08-26
3173041011,JAKARTA BARAT,TAMBORA,DURI SELATAN,14259,4786,9473,5542,15015,2021-08-26
3173041003,JAKARTA BARAT,TAMBORA,DURI UTARA,19844,6950,12894,7244,20138,2021-08-26
3171081003,JAKARTA PUSAT,JOHAR BARU,GALUR,18243,5854,12389,6514,18903,2021-08-26
3171011001,JAKARTA PUSAT,GAMBIR,GAMBIR,2191,751,1440,904,2344,2021-08-26
3174061004,JAKARTA SELATAN,CILANDAK,GANDARIA SELATAN,22119,8318,13801,8129,21930,2021-08-26
3174071009,JAKARTA SELATAN,KEBAYORAN BARU,GANDARIA UTARA,39922,15124,24798,15133,39931,2021-08-26
3175051001,JAKARTA TIMUR,PASAR REBO,GEDONG,35755,12963,22792,13044,35836,2021-08-26
3171071001,JAKARTA PUSAT,TANAH ABANG,GELORA,3127,1232,1895,1094,2989,2021-08-26
3173031007,JAKARTA BARAT,TAMAN SARI,GLODOK,7837,2465,5372,3558,8930,2021-08-26
3171061004,JAKARTA PUSAT,MENTENG,GONDANGDIA,4100,1524,2576,1917,4493,2021-08-26
3173021001,JAKARTA BARAT,GROGOL PETAMBURAN,GROGOL,16876,6229,10647,6379,17026,2021-08-26
3174051005,JAKARTA SELATAN,KEBAYORAN LAMA,GROGOL SELATAN,44251,17127,27124,15215,42339,2021-08-26
3174051004,JAKARTA SELATAN,KEBAYORAN LAMA,GROGOL UTARA,42494,16311,26183,14381,40564,2021-08-26
3174021007,JAKARTA SELATAN,SETIA BUDI,GUNTUR,3985,1417,2568,1800,4368,2021-08-26
3174071002,JAKARTA SELATAN,KEBAYORAN BARU,GUNUNG,9436,3366,6070,4161,10231,2021-08-26
3171031005,JAKARTA PUSAT,KEMAYORAN,GUNUNG SAHARI SELATAN,19199,7232,11967,7219,19186,2021-08-26
3171021004,JAKARTA PUSAT,SAWAH BESAR,GUNUNG SAHARI UTARA,16650,5390,11260,7229,18489,2021-08-26
3175081004,JAKARTA TIMUR,MAKASAR,HALIM PERDANA KUSUMAH,28363,8099,20264,15362,35626,2021-08-26
3171031003,JAKARTA PUSAT,KEMAYORAN,HARAPAN MULIA,22557,8482,14075,7892,21967,2021-08-26
3174091001,JAKARTA SELATAN,JAGAKARSA,JAGAKARSA,62389,21990,40399,25482,65881,2021-08-26
3175021007,JAKARTA TIMUR,PULO GADUNG,JATI,32757,12346,20411,11912,32323,2021-08-26
3174041002,JAKARTA SELATAN,PASAR MINGGU,JATI PADANG,37502,14004,23498,14591,38089,2021-08-26
3173071004,JAKARTA BARAT,PALMERAH,JATI PULO,28738,10428,18310,9890,28200,2021-08-26
3175061001,JAKARTA TIMUR,CAKUNG,JATINEGARA,84160,32761,51399,26972,78371,2021-08-26
3175021004,JAKARTA TIMUR,PULO GADUNG,JATINEGARA KAUM,24632,8623,16009,8002,24011,2021-08-26
3173021004,JAKARTA BARAT,GROGOL PETAMBURAN,JELAMBAR,30266,11040,19226,12347,31573,2021-08-26
3173021006,JAKARTA BARAT,GROGOL PETAMBURAN,JELAMBAR BARU,38246,14040,24206,15093,39299,2021-08-26
3173041006,JAKARTA BARAT,TAMBORA,JEMBATAN BESI,29314,12643,16671,8159,24830,2021-08-26
3173041008,JAKARTA BARAT,TAMBORA,JEMBATAN LIMA,21021,8336,12685,6638,19323,2021-08-26
3173081005,JAKARTA BARAT,KEMBANGAN,JOGLO,40839,15613,25226,13925,39151,2021-08-26
3171081001,JAKARTA PUSAT,JOHAR BARU,JOHAR BARU,37488,12480,25008,14536,39544,2021-08-26
3173041002,JAKARTA BARAT,TAMBORA,KALI ANYAR,23856,8283,15573,7543,23116,2021-08-26
3172041004,JAKARTA UTARA,CILINCING,KALIBARU,67684,28543,39141,19446,58587,2021-08-26
3174081002,JAKARTA SELATAN,PANCORAN,KALIBATA,41994,17552,24442,12877,37319,2021-08-26
3173061001,JAKARTA BARAT,KALI DERES,KALIDERES,72447,27288,45159,26247,71406,2021-08-26
3175051004,JAKARTA TIMUR,PASAR REBO,KALISARI,43212,15392,27820,16528,44348,2021-08-26
3173061004,JAKARTA BARAT,KALI DERES,KAMAL,53783,20778,33005,14628,47633,2021-08-26
3172011002,JAKARTA UTARA,PENJARINGAN,KAMAL MUARA,12930,3672,9258,6288,15546,2021-08-26
3171071007,JAKARTA PUSAT,TANAH ABANG,KAMPUNG BALI,11358,4852,6506,3595,10101,2021-08-26
3175031001,JAKARTA TIMUR,JATINEGARA,KAMPUNG MELAYU,25717,10809,14908,7547,22455,2021-08-26
3171081002,JAKARTA PUSAT,JOHAR BARU,KAMPUNG RAWA,21237,5955,15282,8278,23560,2021-08-26
3175041002,JAKARTA TIMUR,KRAMAT JATI,KAMPUNG TENGAH,43993,18735,25258,12537,37795,2021-08-26
3173011005,JAKARTA BARAT,CENGKARENG,KAPUK,134466,54073,80393,37968,118361,2021-08-26
3172011003,JAKARTA UTARA,PENJARINGAN,KAPUK MUARA,35781,11698,24083,16312,40395,2021-08-26
3171021002,JAKARTA PUSAT,SAWAH BESAR,KARANG ANYAR,25761,8948,16813,9435,26248,2021-08-26
3174021004,JAKARTA SELATAN,SETIA BUDI,KARET,9623,3676,5947,3780,9727,2021-08-26
3174021003,JAKARTA SELATAN,SETIA BUDI,KARET KUNINGAN,16055,5422,10633,6717,17350,2021-08-26
3174021002,JAKARTA SELATAN,SETIA BUDI,KARET SEMANGGI,2770,962,1808,1320,3128,2021-08-26
3171071003,JAKARTA PUSAT,TANAH ABANG,KARET TENGSIN,19271,7262,12009,6925,18934,2021-08-26
3171021003,JAKARTA PUSAT,SAWAH BESAR,KARTINI,22292,8012,14280,8742,23022,2021-08-26
3175011003,JAKARTA TIMUR,MATRAMAN,KAYU MANIS,25284,10315,14969,7714,22683,2021-08-26
3175021006,JAKARTA TIMUR,PULO GADUNG,KAYU PUTIH,40696,14509,26187,16391,42578,2021-08-26
3173031006,JAKARTA BARAT,TAMAN SARI,KEAGUNGAN,17387,6161,11226,6636,17862,2021-08-26
3174041007,JAKARTA SELATAN,PASAR MINGGU,KEBAGUSAN,44552,17255,27297,15865,43162,2021-08-26
3174051006,JAKARTA SELATAN,KEBAYORAN LAMA,KEBAYORAN LAMA SELATAN,41212,14922,26290,15271,41561,2021-08-26
3174051001,JAKARTA SELATAN,KEBAYORAN LAMA,KEBAYORAN LAMA UTARA,42422,16743,25679,13739,39418,2021-08-26
3174011004,JAKARTA SELATAN,TEBET,KEBON BARU,35165,13194,21971,12731,34702,2021-08-26
3172021005,JAKARTA UTARA,TANJUNG PRIOK,KEBON BAWANG,50952,18936,32016,18859,50875,2021-08-26
3173051001,JAKARTA BARAT,KEBON JERUK,KEBON JERUK,53887,21561,32326,17390,49716,2021-08-26
3171071006,JAKARTA PUSAT,TANAH ABANG,KEBON KACANG,21531,9658,11873,6602,18475,2021-08-26
3171011005,JAKARTA PUSAT,GAMBIR,KEBON KELAPA,10163,3692,6471,3800,10271,2021-08-26
3171031002,JAKARTA PUSAT,KEMAYORAN,KEBON KOSONG,30019,11538,18481,10678,29159,2021-08-26
3175011005,JAKARTA TIMUR,MATRAMAN,KEBON MANGGIS,16490,6093,10397,6124,16521,2021-08-26
3171071005,JAKARTA PUSAT,TANAH ABANG,KEBON MELATI,32206,15218,16988,8703,25691,2021-08-26
3175081003,JAKARTA TIMUR,MAKASAR,KEBON PALA,46614,17268,29346,16212,45558,2021-08-26
3171061005,JAKARTA PUSAT,MENTENG,KEBON SIRIH,12299,4888,7411,4016,11427,2021-08-26
3173011004,JAKARTA BARAT,CENGKARENG,KEDAUNG KALI ANGKE,32612,11007,21605,11940,33545,2021-08-26
3173051007,JAKARTA BARAT,KEBON JERUK,KEDOYA SELATAN,32165,11675,20490,11233,31723,2021-08-26
3173051006,JAKARTA BARAT,KEBON JERUK,KEDOYA UTARA,45740,15566,30174,17610,47784,2021-08-26
3173051004,JAKARTA BARAT,KEBON JERUK,KELAPA DUA,23565,9105,14460,7725,22185,2021-08-26
3175091003,JAKARTA TIMUR,CIRACAS,KELAPA DUA WETAN,46875,16049,30826,17345,48171,2021-08-26
3172061003,JAKARTA UTARA,KELAPA GADING,KELAPA GADING BARAT,35717,11657,24060,16997,41057,2021-08-26
3172061001,JAKARTA UTARA,KELAPA GADING,KELAPA GADING TIMUR,33592,10068,23524,16252,39776,2021-08-26
3173071005,JAKARTA BARAT,PALMERAH,KEMANGGISAN,32139,12063,20076,11203,31279,2021-08-26
3171031001,JAKARTA PUSAT,KEMAYORAN,KEMAYORAN,20708,7509,13199,7698,20897,2021-08-26
3173081006,JAKARTA BARAT,KEMBANGAN,KEMBANGAN SELATAN,27130,10071,17059,10667,27726,2021-08-26
3173081001,JAKARTA BARAT,KEMBANGAN,KEMBANGAN UTARA,54451,20324,34127,19134,53261,2021-08-26
3171041002,JAKARTA PUSAT,SENEN,KENARI,9579,3459,6120,3513,9633,2021-08-26
3173041005,JAKARTA BARAT,TAMBORA,KERENDANG,19973,7235,12738,7199,19937,2021-08-26
3175071003,JAKARTA TIMUR,DUREN SAWIT,KLENDER,69978,29393,40585,20523,61108,2021-08-26
3172031001,JAKARTA UTARA,KOJA,KOJA,28175,10988,17187,10031,27218,2021-08-26
3173071006,JAKARTA BARAT,PALMERAH,KOTA BAMBU SELATAN,21158,8090,13068,6806,19874,2021-08-26
3173071003,JAKARTA BARAT,PALMERAH,KOTA BAMBU UTARA,24995,9727,15268,8167,23435,2021-08-26
3171041004,JAKARTA PUSAT,SENEN,KRAMAT,28835,11393,17442,8718,26160,2021-08-26
3175041001,JAKARTA TIMUR,KRAMAT JATI,KRAMAT JATI,34144,13028,21116,10747,31863,2021-08-26
3174071003,JAKARTA SELATAN,KEBAYORAN BARU,KRAMAT PELA,14413,5067,9346,5788,15134,2021-08-26
3173031002,JAKARTA BARAT,TAMAN SARI,KRUKUT,19244,7017,12227,6549,18776,2021-08-26
3174031005,JAKARTA SELATAN,MAMPANG PRAPATAN,KUNINGAN BARAT,12785,4526,8259,5015,13274,2021-08-26
3174021008,JAKARTA SELATAN,SETIA BUDI,KUNINGAN TIMUR,6008,2177,3831,2476,6307,2021-08-26
3171041005,JAKARTA PUSAT,SENEN,KWITANG,15486,5779,9707,5378,15085,2021-08-26
3172031003,JAKARTA UTARA,KOJA,LAGOA,59065,23599,35466,19764,55230,2021-08-26
3174061002,JAKARTA SELATAN,CILANDAK,LEBAK BULUS,37626,14431,23195,14375,37570,2021-08-26
3174091004,JAKARTA SELATAN,JAGAKARSA,LENTENG AGUNG,53946,20745,33201,18396,51597,2021-08-26
3175101007,JAKARTA TIMUR,CIPAYUNG,LUBANG BUAYA,63547,22019,41528,23902,65430,2021-08-26
3175081001,JAKARTA TIMUR,MAKASAR,MAKASAR,34390,12385,22005,12776,34781,2021-08-26
3175071006,JAKARTA TIMUR,DUREN SAWIT,MALAKA JAYA,30927,11754,19173,12331,31504,2021-08-26
3175071005,JAKARTA TIMUR,DUREN SAWIT,MALAKA SARI,27530,10065,17465,11170,28635,2021-08-26
3174031001,JAKARTA SELATAN,MAMPANG PRAPATAN,MAMPANG PRAPATAN,18159,6742,11417,7092,18509,2021-08-26
3173031005,JAKARTA BARAT,TAMAN SARI,MANGGA BESAR,7707,2461,5246,3392,8638,2021-08-26
3171021005,JAKARTA PUSAT,SAWAH BESAR,MANGGA DUA SELATAN,27442,9949,17493,10365,27858,2021-08-26
3174011007,JAKARTA SELATAN,TEBET,MANGGARAI,28373,9777,18596,10225,28821,2021-08-26
3174011006,JAKARTA SELATAN,TEBET,MANGGARAI SELATAN,23075,8182,14893,8813,23706,2021-08-26
3173031003,JAKARTA BARAT,TAMAN SARI,MAPHAR,16461,6038,10423,6432,16855,2021-08-26
3172041003,JAKARTA UTARA,CILINCING,MARUNDA,28943,10454,18489,8402,26891,2021-08-26
3174071001,JAKARTA SELATAN,KEBAYORAN BARU,MELAWAI,2627,900,1727,1335,3062,2021-08-26
3171061001,JAKARTA PUSAT,MENTENG,MENTENG,25624,10114,15510,8765,24275,2021-08-26
3174021005,JAKARTA SELATAN,SETIA BUDI,MENTENG ATAS,27816,9712,18104,10568,28672,2021-08-26
3174011003,JAKARTA SELATAN,TEBET,MENTENG DALAM,36028,13369,22659,13461,36120,2021-08-26
3173081003,JAKARTA BARAT,KEMBANGAN,MERUYA SELATAN,32130,12047,20083,11082,31165,2021-08-26
3173081002,JAKARTA BARAT,KEMBANGAN,MERUYA UTARA,43752,16547,27205,16406,43611,2021-08-26
3175101004,JAKARTA TIMUR,CIPAYUNG,MUNJUL,23871,8297,15574,8994,24568,2021-08-26
3172051002,JAKARTA UTARA,PADEMANGAN,PADEMANGAN BARAT,74240,28942,45298,24969,70267,2021-08-26
3172051001,JAKARTA UTARA,PADEMANGAN,PADEMANGAN TIMUR,37736,12297,25439,16255,41694,2021-08-26
3175011004,JAKARTA TIMUR,MATRAMAN,PAL MERIAM,19769,7882,11887,6506,18393,2021-08-26
3173071001,JAKARTA BARAT,PALMERAH,PALMERAH,63011,24113,38898,20858,59756,2021-08-26
3174081001,JAKARTA SELATAN,PANCORAN,PANCORAN,19421,7291,12130,7199,19329,2021-08-26
3172021003,JAKARTA UTARA,TANJUNG PRIOK,PAPANGGO,39097,13653,25444,14486,39930,2021-08-26
3171021001,JAKARTA PUSAT,SAWAH BESAR,PASAR BARU,12035,3870,8165,5360,13525,2021-08-26
3174021006,JAKARTA SELATAN,SETIA BUDI,PASAR MANGGIS,26752,9947,16805,9971,26776,2021-08-26
3174041001,JAKARTA SELATAN,PASAR MINGGU,PASAR MINGGU,24821,9167,15654,9901,25555,2021-08-26
3171041003,JAKARTA PUSAT,SENEN,PASEBAN,23533,9053,14480,8140,22620,2021-08-26
3173061005,JAKARTA BARAT,KALI DERES,PEGADUNGAN,75587,26357,49230,28109,77339,2021-08-26
3171061002,JAKARTA PUSAT,MENTENG,PEGANGSAAN,23455,9220,14235,7453,21688,2021-08-26
3172061002,JAKARTA UTARA,KELAPA GADING,PEGANGSAAN DUA,49976,15032,34944,23069,58013,2021-08-26
3172011004,JAKARTA UTARA,PENJARINGAN,PEJAGALAN,74578,27365,47213,28938,76151,2021-08-26
3174041006,JAKARTA SELATAN,PASAR MINGGU,PEJATEN BARAT,37346,14214,23132,14195,37327,2021-08-26
3174041005,JAKARTA SELATAN,PASAR MINGGU,PEJATEN TIMUR,57656,22915,34741,18779,53520,2021-08-26
3175051005,JAKARTA TIMUR,PASAR REBO,PEKAYON,43250,15194,28056,16248,44304,2021-08-26
3173041009,JAKARTA BARAT,TAMBORA,PEKOJAN,23587,8061,15526,9198,24724,2021-08-26
3174031003,JAKARTA SELATAN,MAMPANG PRAPATAN,PELA MAMPANG,43522,15963,27559,17518,45077,2021-08-26
3174081005,JAKARTA SELATAN,PANCORAN,PENGADEGAN,21478,7276,14202,7590,21792,2021-08-26
3175061003,JAKARTA TIMUR,CAKUNG,PENGGILINGAN,99255,41842,57413,28996,86409,2021-08-26
3172011001,JAKARTA UTARA,PENJARINGAN,PENJARINGAN,88308,36355,51953,26950,78903,2021-08-26
3174101001,JAKARTA SELATAN,PESANGGRAHAN,PESANGGRAHAN,27545,9541,18004,11032,29036,2021-08-26
3171071004,JAKARTA PUSAT,TANAH ABANG,PETAMBURAN,33271,15633,17638,8656,26294,2021-08-26
3174071008,JAKARTA SELATAN,KEBAYORAN BARU,PETOGOGAN,11499,4322,7177,4586,11763,2021-08-26
3171011004,JAKARTA PUSAT,GAMBIR,PETOJO SELATAN,14692,5560,9132,5567,14699,2021-08-26
3171011003,JAKARTA PUSAT,GAMBIR,PETOJO UTARA,17458,6483,10975,5792,16767,2021-08-26
3174101004,JAKARTA SELATAN,PESANGGRAHAN,PETUKANGAN SELATAN,37187,13841,23346,13824,37170,2021-08-26
3174101003,JAKARTA SELATAN,PESANGGRAHAN,PETUKANGAN UTARA,53716,21234,32482,19251,51733,2021-08-26
3175081002,JAKARTA TIMUR,MAKASAR,PINANG RANTI,27198,10230,16968,10202,27170,2021-08-26
3173031008,JAKARTA BARAT,TAMAN SARI,PINANGSIA,10729,3514,7215,4365,11580,2021-08-26
3175011001,JAKARTA TIMUR,MATRAMAN,PISANGAN BARU,31776,12711,19065,9434,28499,2021-08-26
3175021002,JAKARTA TIMUR,PULO GADUNG,PISANGAN TIMUR,41011,14795,26216,14365,40581,2021-08-26
3172011005,JAKARTA UTARA,PENJARINGAN,PLUIT,47783,16605,31178,21399,52577,2021-08-26
3175071002,JAKARTA TIMUR,DUREN SAWIT,PONDOK BAMBU,61550,24916,36634,20064,56698,2021-08-26
3175071004,JAKARTA TIMUR,DUREN SAWIT,PONDOK KELAPA,72015,27057,44958,24980,69938,2021-08-26
3175071007,JAKARTA TIMUR,DUREN SAWIT,PONDOK KOPI,35367,15188,20179,10917,31096,2021-08-26
3174061003,JAKARTA SELATAN,CILANDAK,PONDOK LABU,46464,16279,30185,19804,49989,2021-08-26
3174051002,JAKARTA SELATAN,KEBAYORAN LAMA,PONDOK PINANG,56169,21069,35100,21570,56670,2021-08-26
3175101003,JAKARTA TIMUR,CIPAYUNG,PONDOK RANGGON,25574,9168,16406,9081,25487,2021-08-26
3101011003,KAB.ADM.KEP.SERIBU,KEP. SERIBU UTARA,PULAU HARAPAN,2060,344,1716,993,2709,2021-08-26
3101011002,KAB.ADM.KEP.SERIBU,KEP. SERIBU UTARA,PULAU KELAPA,5528,917,4611,2573,7184,2021-08-26
3101011001,KAB.ADM.KEP.SERIBU,KEP. SERIBU UTARA,PULAU PANGGANG,5450,891,4559,2063,6622,2021-08-26
3101021003,KAB.ADM.KEP.SERIBU,KEP. SERIBU SELATAN,PULAU PARI,2765,326,2439,1372,3811,2021-08-26
3101021002,KAB.ADM.KEP.SERIBU,KEP. SERIBU SELATAN,PULAU TIDUNG,4553,661,3892,2602,6494,2021-08-26
3101021001,KAB.ADM.KEP.SERIBU,KEP. SERIBU SELATAN,PULAU UNTUNG JAWA,1941,331,1610,855,2465,2021-08-26
3174071007,JAKARTA SELATAN,KEBAYORAN BARU,PULO,5835,1987,3848,2756,6604,2021-08-26
3175021001,JAKARTA TIMUR,PULO GADUNG,PULO GADUNG,34422,13233,21189,11814,33003,2021-08-26
3175061005,JAKARTA TIMUR,CAKUNG,PULO GEBANG,97301,38230,59071,31585,90656,2021-08-26
3174041004,JAKARTA SELATAN,PASAR MINGGU,RAGUNAN,39616,14115,25501,15894,41395,2021-08-26
3175091005,JAKARTA TIMUR,CIRACAS,RAMBUTAN,36771,15495,21276,11846,33122,2021-08-26
3172031006,JAKARTA UTARA,KOJA,RAWA BADAK SELATAN,42179,17412,24767,13309,38076,2021-08-26
3172031004,JAKARTA UTARA,KOJA,RAWA BADAK UTARA,34408,13792,20616,11578,32194,2021-08-26
3174071005,JAKARTA SELATAN,KEBAYORAN BARU,RAWA BARAT,5625,1910,3715,2502,6217,2021-08-26
3173011003,JAKARTA BARAT,CENGKARENG,RAWA BUAYA,63799,24326,39473,19933,59406,2021-08-26
3175031004,JAKARTA TIMUR,JATINEGARA,RAWA BUNGA,21434,8763,12671,6949,19620,2021-08-26
3174081003,JAKARTA SELATAN,PANCORAN,RAWA JATI,20509,7548,12961,7499,20460,2021-08-26
3175061002,JAKARTA TIMUR,CAKUNG,RAWA TERATE,24637,8500,16137,8474,24611,2021-08-26
3175021005,JAKARTA TIMUR,PULO GADUNG,RAWAMANGUN,37612,14459,23153,13690,36843,2021-08-26
3171051003,JAKARTA PUSAT,CEMPAKA PUTIH,RAWASARI,21967,8415,13552,8291,21843,2021-08-26
3173041010,JAKARTA BARAT,TAMBORA,ROA MALAKA,3484,1064,2420,1593,4013,2021-08-26
3172041006,JAKARTA UTARA,CILINCING,ROROTAN,41668,14708,26960,14314,41274,2021-08-26
3174071004,JAKARTA SELATAN,KEBAYORAN BARU,SELONG,2842,988,1854,1375,3229,2021-08-26
3173061002,JAKARTA BARAT,KALI DERES,SEMANAN,71354,27678,43676,19897,63573,2021-08-26
3172041007,JAKARTA UTARA,CILINCING,SEMPER BARAT,68587,23814,44773,25855,70628,2021-08-26
3172041005,JAKARTA UTARA,CILINCING,SEMPER TIMUR,36267,13121,23146,12765,35911,2021-08-26
3174071006,JAKARTA SELATAN,KEBAYORAN BARU,SENAYAN,2771,1142,1629,1067,2696,2021-08-26
3171041001,JAKARTA PUSAT,SENEN,SENEN,6804,2402,4402,2732,7134,2021-08-26
3171031004,JAKARTA PUSAT,KEMAYORAN,SERDANG,29668,11154,18514,10285,28799,2021-08-26
3174021001,JAKARTA SELATAN,SETIA BUDI,SETIA BUDI,3023,1135,1888,1233,3121,2021-08-26
3175101005,JAKARTA TIMUR,CIPAYUNG,SETU,20572,7941,12631,6542,19173,2021-08-26
3173071002,JAKARTA BARAT,PALMERAH,SLIPI,16591,5941,10650,6329,16979,2021-08-26
3173081004,JAKARTA BARAT,KEMBANGAN,SRENGSENG,45523,17866,27657,15527,43184,2021-08-26
3174091002,JAKARTA SELATAN,JAGAKARSA,SRENGSENG SAWAH,58196,19074,39122,23896,63018,2021-08-26
3173051003,JAKARTA BARAT,KEBON JERUK,SUKABUMI SELATAN,37033,14863,22170,10448,32618,2021-08-26
3173051002,JAKARTA BARAT,KEBON JERUK,SUKABUMI UTARA,38290,16328,21962,10798,32760,2021-08-26
3172041002,JAKARTA UTARA,CILINCING,SUKAPURA,53949,20708,33241,19223,52464,2021-08-26
3171031007,JAKARTA PUSAT,KEMAYORAN,SUMUR BATU,22717,8701,14016,8305,22321,2021-08-26
3172021004,JAKARTA UTARA,TANJUNG PRIOK,SUNGAI BAMBU,29876,10967,18909,10773,29682,2021-08-26
3172021006,JAKARTA UTARA,TANJUNG PRIOK,SUNTER AGUNG,71805,23163,48642,31439,80081,2021-08-26
3172021002,JAKARTA UTARA,TANJUNG PRIOK,SUNTER JAYA,63031,21081,41950,26348,68298,2021-08-26
3175091004,JAKARTA TIMUR,CIRACAS,SUSUKAN,38257,13163,25094,13829,38923,2021-08-26
3173031001,JAKARTA BARAT,TAMAN SARI,TAMAN SARI,14348,5209,9139,5886,15025,2021-08-26
3173041001,JAKARTA BARAT,TAMBORA,TAMBORA,10204,3847,6357,3411,9768,2021-08-26
3173041004,JAKARTA BARAT,TAMBORA,TANAH SEREAL,26387,8435,17952,9436,27388,2021-08-26
3171081004,JAKARTA PUSAT,JOHAR BARU,TANAH TINGGI,37693,12034,25659,13544,39203,2021-08-26
3173031004,JAKARTA BARAT,TAMAN SARI,TANGKI,13324,4764,8560,5378,13938,2021-08-26
3174091005,JAKARTA SELATAN,JAGAKARSA,TANJUNG BARAT,39770,14373,25397,14078,39475,2021-08-26
3173021005,JAKARTA BARAT,GROGOL PETAMBURAN,TANJUNG DUREN SELATAN,25337,9115,16222,10078,26300,2021-08-26
3173021002,JAKARTA BARAT,GROGOL PETAMBURAN,TANJUNG DUREN UTARA,17010,5815,11195,6906,18101,2021-08-26
3172021001,JAKARTA UTARA,TANJUNG PRIOK,TANJUNG PRIOK,34588,12031,22557,12085,34642,2021-08-26
3174011002,JAKARTA SELATAN,TEBET,TEBET BARAT,21194,7191,14003,8972,22975,2021-08-26
3174011001,JAKARTA SELATAN,TEBET,TEBET TIMUR,18199,6177,12022,7728,19750,2021-08-26
3173061003,JAKARTA BARAT,KALI DERES,TEGAL ALUR,83647,30859,52788,25312,78100,2021-08-26
3174031004,JAKARTA SELATAN,MAMPANG PRAPATAN,TEGAL PARANG,32401,12827,19574,10929,30503,2021-08-26
3173021003,JAKARTA BARAT,GROGOL PETAMBURAN,TOMANG,29605,10610,18995,12188,31183,2021-08-26
3172031005,JAKARTA UTARA,KOJA,TUGU SELATAN,39122,15653,23469,12840,36309,2021-08-26
3172031002,JAKARTA UTARA,KOJA,TUGU UTARA,67670,27501,40169,22586,62755,2021-08-26
3175061006,JAKARTA TIMUR,CAKUNG,UJUNG MENTENG,29934,10363,19571,11045,30616,2021-08-26
3174101005,JAKARTA SELATAN,PESANGGRAHAN,ULUJAMI,40544,16344,24200,13546,37746,2021-08-26
3175011006,JAKARTA TIMUR,MATRAMAN,UTAN KAYU SELATAN,33511,12238,21273,11941,33214,2021-08-26
3175011002,JAKARTA TIMUR,MATRAMAN,UTAN KAYU UTARA,28169,11116,17053,9278,26331,2021-08-26
3171031008,JAKARTA PUSAT,KEMAYORAN,UTAN PANJANG,29208,11333,17875,9558,27433,2021-08-26
3172021007,JAKARTA UTARA,TANJUNG PRIOK,WARAKAS,44401,16241,28160,15629,43789,2021-08-26
3173021007,JAKARTA BARAT,GROGOL PETAMBURAN,WIJAYA KUSUMA,38934,14854,24080,14360,38440,2021-08-26
3172051003,JAKARTA UTARA,PADEMANGAN,ANCOL,23947,9359,14588,8271,22859,2021-08-27
3173041007,JAKARTA BARAT,TAMBORA,ANGKE,29381,10569,18812,9719,28531,2021-08-27
3175041005,JAKARTA TIMUR,KRAMAT JATI,BALE KAMBANG,29074,12772,16302,7068,23370,2021-08-27
3175031003,JAKARTA TIMUR,JATINEGARA,BALI MESTER,9752,3786,5966,3369,9335,2021-08-27
3175101006,JAKARTA TIMUR,CIPAYUNG,BAMBU APUS,26285,9648,16637,9111,25748,2021-08-27
3174031002,JAKARTA SELATAN,MAMPANG PRAPATAN,BANGKA,21566,8368,13198,8097,21295,2021-08-27
3175051002,JAKARTA TIMUR,PASAR REBO,BARU,23886,7934,15952,10677,26629,2021-08-27
3175041004,JAKARTA TIMUR,KRAMAT JATI,BATU AMPAR,47898,20408,27490,13918,41408,2021-08-27
3171071002,JAKARTA PUSAT,TANAH ABANG,BENDUNGAN HILIR,21494,8142,13352,8203,21555,2021-08-27
3175031002,JAKARTA TIMUR,JATINEGARA,BIDARA CINA,36689,16040,20649,10742,31391,2021-08-27
3174101002,JAKARTA SELATAN,PESANGGRAHAN,BINTARO,53098,20130,32968,20631,53599,2021-08-27
3174011005,JAKARTA SELATAN,TEBET,BUKIT DURI,34183,13522,20661,11641,32302,2021-08-27
3171041006,JAKARTA PUSAT,SENEN,BUNGUR,18144,6667,11477,6585,18062,2021-08-27
3175061007,JAKARTA TIMUR,CAKUNG,CAKUNG BARAT,57724,20155,37569,19727,57296,2021-08-27
3175061004,JAKARTA TIMUR,CAKUNG,CAKUNG TIMUR,58287,20804,37483,22028,59511,2021-08-27
3175041007,JAKARTA TIMUR,KRAMAT JATI,CAWANG,32762,13389,19373,10416,29789,2021-08-27
3175101008,JAKARTA TIMUR,CIPAYUNG,CEGER,18932,6921,12011,6461,18472,2021-08-27
3171031006,JAKARTA PUSAT,KEMAYORAN,CEMPAKA BARU,32581,12692,19889,10914,30803,2021-08-27
3171051002,JAKARTA PUSAT,CEMPAKA PUTIH,CEMPAKA PUTIH BARAT,35885,13729,22156,13738,35894,2021-08-27
3171051001,JAKARTA PUSAT,CEMPAKA PUTIH,CEMPAKA PUTIH TIMUR,24292,8978,15314,9486,24800,2021-08-27
3173011001,JAKARTA BARAT,CENGKARENG,CENGKARENG BARAT,66284,24088,42196,25364,67560,2021-08-27
3173011006,JAKARTA BARAT,CENGKARENG,CENGKARENG TIMUR,81027,28961,52066,25884,77950,2021-08-27
3175091002,JAKARTA TIMUR,CIRACAS,CIBUBUR,66364,23022,43342,26093,69435,2021-08-27
3171011002,JAKARTA PUSAT,GAMBIR,CIDENG,15390,5282,10108,6326,16434,2021-08-27
3174091003,JAKARTA SELATAN,JAGAKARSA,CIGANJUR,38497,14006,24491,14467,38958,2021-08-27
3175051003,JAKARTA TIMUR,PASAR REBO,CIJANTUNG,41419,14462,26957,16167,43124,2021-08-27
3171061003,JAKARTA PUSAT,MENTENG,CIKINI,8274,3248,5026,2900,7926,2021-08-27
3174081006,JAKARTA SELATAN,PANCORAN,CIKOKO,10547,3666,6881,3962,10843,2021-08-27
3174061001,JAKARTA SELATAN,CILANDAK,CILANDAK BARAT,51752,18709,33043,20583,53626,2021-08-27
3174041003,JAKARTA SELATAN,PASAR MINGGU,CILANDAK TIMUR,25145,8976,16169,10692,26861,2021-08-27
3175101002,JAKARTA TIMUR,CIPAYUNG,CILANGKAP,27635,9822,17813,10033,27846,2021-08-27
3175041006,JAKARTA TIMUR,KRAMAT JATI,CILILITAN,40181,16781,23400,12517,35917,2021-08-27
3172041001,JAKARTA UTARA,CILINCING,CILINCING,43609,17174,26435,14101,40536,2021-08-27
3175101001,JAKARTA TIMUR,CIPAYUNG,CIPAYUNG,26104,8672,17432,10305,27737,2021-08-27
3174091006,JAKARTA SELATAN,JAGAKARSA,CIPEDAK,38303,12947,25356,15705,41061,2021-08-27
3174061005,JAKARTA SELATAN,CILANDAK,CIPETE SELATAN,26704,10129,16575,11088,27663,2021-08-27
3174071010,JAKARTA SELATAN,KEBAYORAN BARU,CIPETE UTARA,34102,12576,21526,13252,34778,2021-08-27
3175021003,JAKARTA TIMUR,PULO GADUNG,CIPINANG,39306,15055,24251,13967,38218,2021-08-27
3175031007,JAKARTA TIMUR,JATINEGARA,CIPINANG BESAR SELATAN,35212,14981,20231,10416,30647,2021-08-27
3175031008,JAKARTA TIMUR,JATINEGARA,CIPINANG BESAR UTARA,45319,18892,26427,12907,39334,2021-08-27
3175031005,JAKARTA TIMUR,JATINEGARA,CIPINANG CEMPEDAK,32824,13649,19175,11245,30420,2021-08-27
3175081005,JAKARTA TIMUR,MAKASAR,CIPINANG MELAYU,42308,16430,25878,15573,41451,2021-08-27
3175031006,JAKARTA TIMUR,JATINEGARA,CIPINANG MUARA,55243,22818,32425,17016,49441,2021-08-27
3174051003,JAKARTA SELATAN,KEBAYORAN LAMA,CIPULIR,39937,16150,23787,12846,36633,2021-08-27
3175091001,JAKARTA TIMUR,CIRACAS,CIRACAS,64594,22386,42208,23673,65881,2021-08-27
3175041003,JAKARTA TIMUR,KRAMAT JATI,DUKUH,24609,8882,15727,8378,24105,2021-08-27
3175071001,JAKARTA TIMUR,DUREN SAWIT,DUREN SAWIT,61160,24960,36200,20486,56686,2021-08-27
3174081004,JAKARTA SELATAN,PANCORAN,DUREN TIGA,28319,10615,17704,9444,27148,2021-08-27
3173051005,JAKARTA BARAT,KEBON JERUK,DURI KEPA,60138,21309,38829,23332,62161,2021-08-27
3173011002,JAKARTA BARAT,CENGKARENG,DURI KOSAMBI,77923,31360,46563,24409,70972,2021-08-27
3171011006,JAKARTA PUSAT,GAMBIR,DURI PULO,19610,7152,12458,6977,19435,2021-08-27
3173041011,JAKARTA BARAT,TAMBORA,DURI SELATAN,14259,4779,9480,5545,15025,2021-08-27
3173041003,JAKARTA BARAT,TAMBORA,DURI UTARA,19844,6942,12902,7262,20164,2021-08-27
3171081003,JAKARTA PUSAT,JOHAR BARU,GALUR,18243,5833,12410,6669,19079,2021-08-27
3171011001,JAKARTA PUSAT,GAMBIR,GAMBIR,2191,751,1440,907,2347,2021-08-27
3174061004,JAKARTA SELATAN,CILANDAK,GANDARIA SELATAN,22119,8285,13834,8260,22094,2021-08-27
3174071009,JAKARTA SELATAN,KEBAYORAN BARU,GANDARIA UTARA,39922,15085,24837,15255,40092,2021-08-27
3175051001,JAKARTA TIMUR,PASAR REBO,GEDONG,35755,12946,22809,13093,35902,2021-08-27
3171071001,JAKARTA PUSAT,TANAH ABANG,GELORA,3127,1231,1896,1100,2996,2021-08-27
3173031007,JAKARTA BARAT,TAMAN SARI,GLODOK,7837,2459,5378,3572,8950,2021-08-27
3171061004,JAKARTA PUSAT,MENTENG,GONDANGDIA,4100,1523,2577,1922,4499,2021-08-27
3173021001,JAKARTA BARAT,GROGOL PETAMBURAN,GROGOL,16876,6220,10656,6409,17065,2021-08-27
3174051005,JAKARTA SELATAN,KEBAYORAN LAMA,GROGOL SELATAN,44251,17102,27149,15351,42500,2021-08-27
3174051004,JAKARTA SELATAN,KEBAYORAN LAMA,GROGOL UTARA,42494,16272,26222,14678,40900,2021-08-27
3174021007,JAKARTA SELATAN,SETIA BUDI,GUNTUR,3985,1415,2570,1806,4376,2021-08-27
3174071002,JAKARTA SELATAN,KEBAYORAN BARU,GUNUNG,9436,3361,6075,4181,10256,2021-08-27
3171031005,JAKARTA PUSAT,KEMAYORAN,GUNUNG SAHARI SELATAN,19199,7217,11982,7304,19286,2021-08-27
3171021004,JAKARTA PUSAT,SAWAH BESAR,GUNUNG SAHARI UTARA,16650,5382,11268,7267,18535,2021-08-27
3175081004,JAKARTA TIMUR,MAKASAR,HALIM PERDANA KUSUMAH,28363,8085,20278,15372,35650,2021-08-27
3171031003,JAKARTA PUSAT,KEMAYORAN,HARAPAN MULIA,22557,8444,14113,8085,22198,2021-08-27
3174091001,JAKARTA SELATAN,JAGAKARSA,JAGAKARSA,62389,21940,40449,25654,66103,2021-08-27
3175021007,JAKARTA TIMUR,PULO GADUNG,JATI,32757,12320,20437,11943,32380,2021-08-27
3174041002,JAKARTA SELATAN,PASAR MINGGU,JATI PADANG,37502,13905,23597,14745,38342,2021-08-27
3173071004,JAKARTA BARAT,PALMERAH,JATI PULO,28738,10417,18321,9913,28234,2021-08-27
3175061001,JAKARTA TIMUR,CAKUNG,JATINEGARA,84160,32738,51422,27100,78522,2021-08-27
3175021004,JAKARTA TIMUR,PULO GADUNG,JATINEGARA KAUM,24632,8605,16027,8029,24056,2021-08-27
3173021004,JAKARTA BARAT,GROGOL PETAMBURAN,JELAMBAR,30266,11010,19256,12425,31681,2021-08-27
3173021006,JAKARTA BARAT,GROGOL PETAMBURAN,JELAMBAR BARU,38246,14029,24217,15155,39372,2021-08-27
3173041006,JAKARTA BARAT,TAMBORA,JEMBATAN BESI,29314,12635,16679,8178,24857,2021-08-27
3173041008,JAKARTA BARAT,TAMBORA,JEMBATAN LIMA,21021,8330,12691,6659,19350,2021-08-27
3173081005,JAKARTA BARAT,KEMBANGAN,JOGLO,40839,15597,25242,13977,39219,2021-08-27
3171081001,JAKARTA PUSAT,JOHAR BARU,JOHAR BARU,37488,12440,25048,14899,39947,2021-08-27
3173041002,JAKARTA BARAT,TAMBORA,KALI ANYAR,23856,8278,15578,7556,23134,2021-08-27
3172041004,JAKARTA UTARA,CILINCING,KALIBARU,67684,28528,39156,19508,58664,2021-08-27
3174081002,JAKARTA SELATAN,PANCORAN,KALIBATA,41994,17525,24469,12939,37408,2021-08-27
3173061001,JAKARTA BARAT,KALI DERES,KALIDERES,72447,27248,45199,26430,71629,2021-08-27
3175051004,JAKARTA TIMUR,PASAR REBO,KALISARI,43212,15372,27840,16580,44420,2021-08-27
3173061004,JAKARTA BARAT,KALI DERES,KAMAL,53783,20737,33046,14933,47979,2021-08-27
3172011002,JAKARTA UTARA,PENJARINGAN,KAMAL MUARA,12930,3670,9260,6304,15564,2021-08-27
3171071007,JAKARTA PUSAT,TANAH ABANG,KAMPUNG BALI,11358,4810,6548,3644,10192,2021-08-27
3175031001,JAKARTA TIMUR,JATINEGARA,KAMPUNG MELAYU,25717,10804,14913,7573,22486,2021-08-27
3171081002,JAKARTA PUSAT,JOHAR BARU,KAMPUNG RAWA,21237,5936,15301,8360,23661,2021-08-27
3175041002,JAKARTA TIMUR,KRAMAT JATI,KAMPUNG TENGAH,43993,18712,25281,12634,37915,2021-08-27
3173011005,JAKARTA BARAT,CENGKARENG,KAPUK,134466,54044,80422,38174,118596,2021-08-27
3172011003,JAKARTA UTARA,PENJARINGAN,KAPUK MUARA,35781,11691,24090,16343,40433,2021-08-27
3171021002,JAKARTA PUSAT,SAWAH BESAR,KARANG ANYAR,25761,8925,16836,9644,26480,2021-08-27
3174021004,JAKARTA SELATAN,SETIA BUDI,KARET,9623,3662,5961,3824,9785,2021-08-27
3174021003,JAKARTA SELATAN,SETIA BUDI,KARET KUNINGAN,16055,5411,10644,6773,17417,2021-08-27
3174021002,JAKARTA SELATAN,SETIA BUDI,KARET SEMANGGI,2770,961,1809,1323,3132,2021-08-27
3171071003,JAKARTA PUSAT,TANAH ABANG,KARET TENGSIN,19271,7237,12034,7000,19034,2021-08-27
3171021003,JAKARTA PUSAT,SAWAH BESAR,KARTINI,22292,7990,14302,8870,23172,2021-08-27
3175011003,JAKARTA TIMUR,MATRAMAN,KAYU MANIS,25284,10305,14979,7756,22735,2021-08-27
3175021006,JAKARTA TIMUR,PULO GADUNG,KAYU PUTIH,40696,14461,26235,16461,42696,2021-08-27
3173031006,JAKARTA BARAT,TAMAN SARI,KEAGUNGAN,17387,6151,11236,6655,17891,2021-08-27
3174041007,JAKARTA SELATAN,PASAR MINGGU,KEBAGUSAN,44552,17196,27356,16064,43420,2021-08-27
3174051006,JAKARTA SELATAN,KEBAYORAN LAMA,KEBAYORAN LAMA SELATAN,41212,14874,26338,15345,41683,2021-08-27
3174051001,JAKARTA SELATAN,KEBAYORAN LAMA,KEBAYORAN LAMA UTARA,42422,16680,25742,13868,39610,2021-08-27
3174011004,JAKARTA SELATAN,TEBET,KEBON BARU,35165,13106,22059,13057,35116,2021-08-27
3172021005,JAKARTA UTARA,TANJUNG PRIOK,KEBON BAWANG,50952,18907,32045,18940,50985,2021-08-27
3173051001,JAKARTA BARAT,KEBON JERUK,KEBON JERUK,53887,21544,32343,17432,49775,2021-08-27
3171071006,JAKARTA PUSAT,TANAH ABANG,KEBON KACANG,21531,9649,11882,6616,18498,2021-08-27
3171011005,JAKARTA PUSAT,GAMBIR,KEBON KELAPA,10163,3673,6490,3892,10382,2021-08-27
3171031002,JAKARTA PUSAT,KEMAYORAN,KEBON KOSONG,30019,11469,18550,10801,29351,2021-08-27
3175011005,JAKARTA TIMUR,MATRAMAN,KEBON MANGGIS,16490,6081,10409,6167,16576,2021-08-27
3171071005,JAKARTA PUSAT,TANAH ABANG,KEBON MELATI,32206,15200,17006,8734,25740,2021-08-27
3175081003,JAKARTA TIMUR,MAKASAR,KEBON PALA,46614,17249,29365,16268,45633,2021-08-27
3171061005,JAKARTA PUSAT,MENTENG,KEBON SIRIH,12299,4860,7439,4099,11538,2021-08-27
3173011004,JAKARTA BARAT,CENGKARENG,KEDAUNG KALI ANGKE,32612,11000,21612,12076,33688,2021-08-27
3173051007,JAKARTA BARAT,KEBON JERUK,KEDOYA SELATAN,32165,11668,20497,11268,31765,2021-08-27
3173051006,JAKARTA BARAT,KEBON JERUK,KEDOYA UTARA,45740,15552,30188,17646,47834,2021-08-27
3173051004,JAKARTA BARAT,KEBON JERUK,KELAPA DUA,23565,9101,14464,7742,22206,2021-08-27
3175091003,JAKARTA TIMUR,CIRACAS,KELAPA DUA WETAN,46875,16023,30852,17380,48232,2021-08-27
3172061003,JAKARTA UTARA,KELAPA GADING,KELAPA GADING BARAT,35717,11638,24079,17080,41159,2021-08-27
3172061001,JAKARTA UTARA,KELAPA GADING,KELAPA GADING TIMUR,33592,10051,23541,16341,39882,2021-08-27
3173071005,JAKARTA BARAT,PALMERAH,KEMANGGISAN,32139,12051,20088,11246,31334,2021-08-27
3171031001,JAKARTA PUSAT,KEMAYORAN,KEMAYORAN,20708,7485,13223,7834,21057,2021-08-27
3173081006,JAKARTA BARAT,KEMBANGAN,KEMBANGAN SELATAN,27130,10066,17064,10681,27745,2021-08-27
3173081001,JAKARTA BARAT,KEMBANGAN,KEMBANGAN UTARA,54451,20311,34140,19176,53316,2021-08-27
3171041002,JAKARTA PUSAT,SENEN,KENARI,9579,3451,6128,3569,9697,2021-08-27
3173041005,JAKARTA BARAT,TAMBORA,KERENDANG,19973,7232,12741,7214,19955,2021-08-27
3175071003,JAKARTA TIMUR,DUREN SAWIT,KLENDER,69978,29370,40608,20729,61337,2021-08-27
3172031001,JAKARTA UTARA,KOJA,KOJA,28175,10978,17197,10096,27293,2021-08-27
3173071006,JAKARTA BARAT,PALMERAH,KOTA BAMBU SELATAN,21158,8082,13076,6815,19891,2021-08-27
3173071003,JAKARTA BARAT,PALMERAH,KOTA BAMBU UTARA,24995,9714,15281,8181,23462,2021-08-27
3171041004,JAKARTA PUSAT,SENEN,KRAMAT,28835,11275,17560,8948,26508,2021-08-27
3175041001,JAKARTA TIMUR,KRAMAT JATI,KRAMAT JATI,34144,13010,21134,10793,31927,2021-08-27
3174071003,JAKARTA SELATAN,KEBAYORAN BARU,KRAMAT PELA,14413,5052,9361,5847,15208,2021-08-27
3173031002,JAKARTA BARAT,TAMAN SARI,KRUKUT,19244,7015,12229,6564,18793,2021-08-27
3174031005,JAKARTA SELATAN,MAMPANG PRAPATAN,KUNINGAN BARAT,12785,4512,8273,5071,13344,2021-08-27
3174021008,JAKARTA SELATAN,SETIA BUDI,KUNINGAN TIMUR,6008,2168,3840,2494,6334,2021-08-27
3171041005,JAKARTA PUSAT,SENEN,KWITANG,15486,5763,9723,5481,15204,2021-08-27
3172031003,JAKARTA UTARA,KOJA,LAGOA,59065,23571,35494,19863,55357,2021-08-27
3174061002,JAKARTA SELATAN,CILANDAK,LEBAK BULUS,37626,14387,23239,14530,37769,2021-08-27
3174091004,JAKARTA SELATAN,JAGAKARSA,LENTENG AGUNG,53946,20698,33248,18556,51804,2021-08-27
3175101007,JAKARTA TIMUR,CIPAYUNG,LUBANG BUAYA,63547,21972,41575,24016,65591,2021-08-27
3175081001,JAKARTA TIMUR,MAKASAR,MAKASAR,34390,12360,22030,12814,34844,2021-08-27
3175071006,JAKARTA TIMUR,DUREN SAWIT,MALAKA JAYA,30927,11736,19191,12372,31563,2021-08-27
3175071005,JAKARTA TIMUR,DUREN SAWIT,MALAKA SARI,27530,10052,17478,11188,28666,2021-08-27
3174031001,JAKARTA SELATAN,MAMPANG PRAPATAN,MAMPANG PRAPATAN,18159,6726,11433,7155,18588,2021-08-27
3173031005,JAKARTA BARAT,TAMAN SARI,MANGGA BESAR,7707,2459,5248,3403,8651,2021-08-27
3171021005,JAKARTA PUSAT,SAWAH BESAR,MANGGA DUA SELATAN,27442,9899,17543,10499,28042,2021-08-27
3174011007,JAKARTA SELATAN,TEBET,MANGGARAI,28373,9738,18635,10467,29102,2021-08-27
3174011006,JAKARTA SELATAN,TEBET,MANGGARAI SELATAN,23075,8143,14932,8967,23899,2021-08-27
3173031003,JAKARTA BARAT,TAMAN SARI,MAPHAR,16461,6032,10429,6468,16897,2021-08-27
3172041003,JAKARTA UTARA,CILINCING,MARUNDA,28943,10448,18495,8434,26929,2021-08-27
3174071001,JAKARTA SELATAN,KEBAYORAN BARU,MELAWAI,2627,900,1727,1343,3070,2021-08-27
3171061001,JAKARTA PUSAT,MENTENG,MENTENG,25624,10097,15527,8802,24329,2021-08-27
3174021005,JAKARTA SELATAN,SETIA BUDI,MENTENG ATAS,27816,9661,18155,10783,28938,2021-08-27
3174011003,JAKARTA SELATAN,TEBET,MENTENG DALAM,36028,13329,22699,13604,36303,2021-08-27
3173081003,JAKARTA BARAT,KEMBANGAN,MERUYA SELATAN,32130,12040,20090,11120,31210,2021-08-27
3173081002,JAKARTA BARAT,KEMBANGAN,MERUYA UTARA,43752,16530,27222,16472,43694,2021-08-27
3175101004,JAKARTA TIMUR,CIPAYUNG,MUNJUL,23871,8282,15589,9017,24606,2021-08-27
3172051002,JAKARTA UTARA,PADEMANGAN,PADEMANGAN BARAT,74240,28916,45324,25062,70386,2021-08-27
3172051001,JAKARTA UTARA,PADEMANGAN,PADEMANGAN TIMUR,37736,12291,25445,16346,41791,2021-08-27
3175011004,JAKARTA TIMUR,MATRAMAN,PAL MERIAM,19769,7872,11897,6557,18454,2021-08-27
3173071001,JAKARTA BARAT,PALMERAH,PALMERAH,63011,24101,38910,20948,59858,2021-08-27
3174081001,JAKARTA SELATAN,PANCORAN,PANCORAN,19421,7278,12143,7226,19369,2021-08-27
3172021003,JAKARTA UTARA,TANJUNG PRIOK,PAPANGGO,39097,13642,25455,14580,40035,2021-08-27
3171021001,JAKARTA PUSAT,SAWAH BESAR,PASAR BARU,12035,3862,8173,5416,13589,2021-08-27
3174021006,JAKARTA SELATAN,SETIA BUDI,PASAR MANGGIS,26752,9909,16843,10073,26916,2021-08-27
3174041001,JAKARTA SELATAN,PASAR MINGGU,PASAR MINGGU,24821,9145,15676,9991,25667,2021-08-27
3171041003,JAKARTA PUSAT,SENEN,PASEBAN,23533,9011,14522,8258,22780,2021-08-27
3173061005,JAKARTA BARAT,KALI DERES,PEGADUNGAN,75587,26311,49276,28382,77658,2021-08-27
3171061002,JAKARTA PUSAT,MENTENG,PEGANGSAAN,23455,9163,14292,7531,21823,2021-08-27
3172061002,JAKARTA UTARA,KELAPA GADING,PEGANGSAAN DUA,49976,14980,34996,23246,58242,2021-08-27
3172011004,JAKARTA UTARA,PENJARINGAN,PEJAGALAN,74578,27346,47232,29033,76265,2021-08-27
3174041006,JAKARTA SELATAN,PASAR MINGGU,PEJATEN BARAT,37346,14156,23190,14394,37584,2021-08-27
3174041005,JAKARTA SELATAN,PASAR MINGGU,PEJATEN TIMUR,57656,22837,34819,19118,53937,2021-08-27
3175051005,JAKARTA TIMUR,PASAR REBO,PEKAYON,43250,15183,28067,16306,44373,2021-08-27
3173041009,JAKARTA BARAT,TAMBORA,PEKOJAN,23587,8056,15531,9224,24755,2021-08-27
3174031003,JAKARTA SELATAN,MAMPANG PRAPATAN,PELA MAMPANG,43522,15893,27629,17755,45384,2021-08-27
3174081005,JAKARTA SELATAN,PANCORAN,PENGADEGAN,21478,7265,14213,7641,21854,2021-08-27
3175061003,JAKARTA TIMUR,CAKUNG,PENGGILINGAN,99255,41796,57459,29130,86589,2021-08-27
3172011001,JAKARTA UTARA,PENJARINGAN,PENJARINGAN,88308,36334,51974,27095,79069,2021-08-27
3174101001,JAKARTA SELATAN,PESANGGRAHAN,PESANGGRAHAN,27545,9531,18014,11130,29144,2021-08-27
3171071004,JAKARTA PUSAT,TANAH ABANG,PETAMBURAN,33271,15619,17652,8841,26493,2021-08-27
3174071008,JAKARTA SELATAN,KEBAYORAN BARU,PETOGOGAN,11499,4311,7188,4604,11792,2021-08-27
3171011004,JAKARTA PUSAT,GAMBIR,PETOJO SELATAN,14692,5553,9139,5607,14746,2021-08-27
3171011003,JAKARTA PUSAT,GAMBIR,PETOJO UTARA,17458,6471,10987,5819,16806,2021-08-27
3174101004,JAKARTA SELATAN,PESANGGRAHAN,PETUKANGAN SELATAN,37187,13811,23376,13882,37258,2021-08-27
3174101003,JAKARTA SELATAN,PESANGGRAHAN,PETUKANGAN UTARA,53716,21210,32506,19330,51836,2021-08-27
3175081002,JAKARTA TIMUR,MAKASAR,PINANG RANTI,27198,10209,16989,10261,27250,2021-08-27
3173031008,JAKARTA BARAT,TAMAN SARI,PINANGSIA,10729,3511,7218,4386,11604,2021-08-27
3175011001,JAKARTA TIMUR,MATRAMAN,PISANGAN BARU,31776,12680,19096,9527,28623,2021-08-27
3175021002,JAKARTA TIMUR,PULO GADUNG,PISANGAN TIMUR,41011,14774,26237,14421,40658,2021-08-27
3172011005,JAKARTA UTARA,PENJARINGAN,PLUIT,47783,16583,31200,21450,52650,2021-08-27
3175071002,JAKARTA TIMUR,DUREN SAWIT,PONDOK BAMBU,61550,24873,36677,20185,56862,2021-08-27
3175071004,JAKARTA TIMUR,DUREN SAWIT,PONDOK KELAPA,72015,27036,44979,25131,70110,2021-08-27
3175071007,JAKARTA TIMUR,DUREN SAWIT,PONDOK KOPI,35367,15174,20193,10977,31170,2021-08-27
3174061003,JAKARTA SELATAN,CILANDAK,PONDOK LABU,46464,16214,30250,19988,50238,2021-08-27
3174051002,JAKARTA SELATAN,KEBAYORAN LAMA,PONDOK PINANG,56169,21024,35145,21717,56862,2021-08-27
3175101003,JAKARTA TIMUR,CIPAYUNG,PONDOK RANGGON,25574,9152,16422,9099,25521,2021-08-27
3101011003,KAB.ADM.KEP.SERIBU,KEP. SERIBU UTARA,PULAU HARAPAN,2060,344,1716,996,2712,2021-08-27
3101011002,KAB.ADM.KEP.SERIBU,KEP. SERIBU UTARA,PULAU KELAPA,5528,916,4612,2574,7186,2021-08-27
3101011001,KAB.ADM.KEP.SERIBU,KEP. SERIBU UTARA,PULAU PANGGANG,5450,890,4560,2065,6625,2021-08-27
3101021003,KAB.ADM.KEP.SERIBU,KEP. SERIBU SELATAN,PULAU PARI,2765,326,2439,1373,3812,2021-08-27
3101021002,KAB.ADM.KEP.SERIBU,KEP. SERIBU SELATAN,PULAU TIDUNG,4553,660,3893,2612,6505,2021-08-27
3101021001,KAB.ADM.KEP.SERIBU,KEP. SERIBU SELATAN,PULAU UNTUNG JAWA,1941,331,1610,856,2466,2021-08-27
3174071007,JAKARTA SELATAN,KEBAYORAN BARU,PULO,5835,1982,3853,2773,6626,2021-08-27
3175021001,JAKARTA TIMUR,PULO GADUNG,PULO GADUNG,34422,13202,21220,11854,33074,2021-08-27
3175061005,JAKARTA TIMUR,CAKUNG,PULO GEBANG,97301,38137,59164,31816,90980,2021-08-27
3174041004,JAKARTA SELATAN,PASAR MINGGU,RAGUNAN,39616,14048,25568,16040,41608,2021-08-27
3175091005,JAKARTA TIMUR,CIRACAS,RAMBUTAN,36771,15476,21295,11901,33196,2021-08-27
3172031006,JAKARTA UTARA,KOJA,RAWA BADAK SELATAN,42179,17376,24803,13483,38286,2021-08-27
3172031004,JAKARTA UTARA,KOJA,RAWA BADAK UTARA,34408,13779,20629,11638,32267,2021-08-27
3174071005,JAKARTA SELATAN,KEBAYORAN BARU,RAWA BARAT,5625,1905,3720,2518,6238,2021-08-27
3173011003,JAKARTA BARAT,CENGKARENG,RAWA BUAYA,63799,24289,39510,20101,59611,2021-08-27
3175031004,JAKARTA TIMUR,JATINEGARA,RAWA BUNGA,21434,8753,12681,6991,19672,2021-08-27
3174081003,JAKARTA SELATAN,PANCORAN,RAWA JATI,20509,7522,12987,7541,20528,2021-08-27
3175061002,JAKARTA TIMUR,CAKUNG,RAWA TERATE,24637,8490,16147,8567,24714,2021-08-27
3175021005,JAKARTA TIMUR,PULO GADUNG,RAWAMANGUN,37612,14420,23192,13762,36954,2021-08-27
3171051003,JAKARTA PUSAT,CEMPAKA PUTIH,RAWASARI,21967,8392,13575,8429,22004,2021-08-27
3173041010,JAKARTA BARAT,TAMBORA,ROA MALAKA,3484,1064,2420,1595,4015,2021-08-27
3172041006,JAKARTA UTARA,CILINCING,ROROTAN,41668,14693,26975,14356,41331,2021-08-27
3174071004,JAKARTA SELATAN,KEBAYORAN BARU,SELONG,2842,987,1855,1382,3237,2021-08-27
3173061002,JAKARTA BARAT,KALI DERES,SEMANAN,71354,27617,43737,20527,64264,2021-08-27
3172041007,JAKARTA UTARA,CILINCING,SEMPER BARAT,68587,23778,44809,25970,70779,2021-08-27
3172041005,JAKARTA UTARA,CILINCING,SEMPER TIMUR,36267,13097,23170,12841,36011,2021-08-27
3174071006,JAKARTA SELATAN,KEBAYORAN BARU,SENAYAN,2771,1131,1640,1077,2717,2021-08-27
3171041001,JAKARTA PUSAT,SENEN,SENEN,6804,2396,4408,2751,7159,2021-08-27
3171031004,JAKARTA PUSAT,KEMAYORAN,SERDANG,29668,11118,18550,10435,28985,2021-08-27
3174021001,JAKARTA SELATAN,SETIA BUDI,SETIA BUDI,3023,1132,1891,1245,3136,2021-08-27
3175101005,JAKARTA TIMUR,CIPAYUNG,SETU,20572,7930,12642,6576,19218,2021-08-27
3173071002,JAKARTA BARAT,PALMERAH,SLIPI,16591,5937,10654,6385,17039,2021-08-27
3173081004,JAKARTA BARAT,KEMBANGAN,SRENGSENG,45523,17851,27672,15570,43242,2021-08-27
3174091002,JAKARTA SELATAN,JAGAKARSA,SRENGSENG SAWAH,58196,19032,39164,24038,63202,2021-08-27
3173051003,JAKARTA BARAT,KEBON JERUK,SUKABUMI SELATAN,37033,14854,22179,10471,32650,2021-08-27
3173051002,JAKARTA BARAT,KEBON JERUK,SUKABUMI UTARA,38290,16308,21982,10831,32813,2021-08-27
3172041002,JAKARTA UTARA,CILINCING,SUKAPURA,53949,20674,33275,19320,52595,2021-08-27
3171031007,JAKARTA PUSAT,KEMAYORAN,SUMUR BATU,22717,8655,14062,8405,22467,2021-08-27
3172021004,JAKARTA UTARA,TANJUNG PRIOK,SUNGAI BAMBU,29876,10957,18919,10788,29707,2021-08-27
3172021006,JAKARTA UTARA,TANJUNG PRIOK,SUNTER AGUNG,71805,23128,48677,31558,80235,2021-08-27
3172021002,JAKARTA UTARA,TANJUNG PRIOK,SUNTER JAYA,63031,21043,41988,26497,68485,2021-08-27
3175091004,JAKARTA TIMUR,CIRACAS,SUSUKAN,38257,13151,25106,13858,38964,2021-08-27
3173031001,JAKARTA BARAT,TAMAN SARI,TAMAN SARI,14348,5203,9145,5901,15046,2021-08-27
3173041001,JAKARTA BARAT,TAMBORA,TAMBORA,10204,3845,6359,3423,9782,2021-08-27
3173041004,JAKARTA BARAT,TAMBORA,TANAH SEREAL,26387,8429,17958,9454,27412,2021-08-27
3171081004,JAKARTA PUSAT,JOHAR BARU,TANAH TINGGI,37693,11963,25730,13814,39544,2021-08-27
3173031004,JAKARTA BARAT,TAMAN SARI,TANGKI,13324,4757,8567,5408,13975,2021-08-27
3174091005,JAKARTA SELATAN,JAGAKARSA,TANJUNG BARAT,39770,14339,25431,14211,39642,2021-08-27
3173021005,JAKARTA BARAT,GROGOL PETAMBURAN,TANJUNG DUREN SELATAN,25337,9103,16234,10127,26361,2021-08-27
3173021002,JAKARTA BARAT,GROGOL PETAMBURAN,TANJUNG DUREN UTARA,17010,5808,11202,6945,18147,2021-08-27
3172021001,JAKARTA UTARA,TANJUNG PRIOK,TANJUNG PRIOK,34588,12022,22566,12221,34787,2021-08-27
3174011002,JAKARTA SELATAN,TEBET,TEBET BARAT,21194,7169,14025,9055,23080,2021-08-27
3174011001,JAKARTA SELATAN,TEBET,TEBET TIMUR,18199,6161,12038,7785,19823,2021-08-27
3173061003,JAKARTA BARAT,KALI DERES,TEGAL ALUR,83647,30818,52829,25688,78517,2021-08-27
3174031004,JAKARTA SELATAN,MAMPANG PRAPATAN,TEGAL PARANG,32401,12788,19613,11154,30767,2021-08-27
3173021003,JAKARTA BARAT,GROGOL PETAMBURAN,TOMANG,29605,10594,19011,12253,31264,2021-08-27
3172031005,JAKARTA UTARA,KOJA,TUGU SELATAN,39122,15628,23494,12886,36380,2021-08-27
3172031002,JAKARTA UTARA,KOJA,TUGU UTARA,67670,27416,40254,22753,63007,2021-08-27
3175061006,JAKARTA TIMUR,CAKUNG,UJUNG MENTENG,29934,10355,19579,11196,30775,2021-08-27
3174101005,JAKARTA SELATAN,PESANGGRAHAN,ULUJAMI,40544,16322,24222,13694,37916,2021-08-27
3175011006,JAKARTA TIMUR,MATRAMAN,UTAN KAYU SELATAN,33511,12223,21288,12003,33291,2021-08-27
3175011002,JAKARTA TIMUR,MATRAMAN,UTAN KAYU UTARA,28169,11097,17072,9310,26382,2021-08-27
3171031008,JAKARTA PUSAT,KEMAYORAN,UTAN PANJANG,29208,11289,17919,9738,27657,2021-08-27
3172021007,JAKARTA UTARA,TANJUNG PRIOK,WARAKAS,44401,16219,28182,15694,43876,2021-08-27
3173021007,JAKARTA BARAT,GROGOL PETAMBURAN,WIJAYA KUSUMA,38934,14831,24103,14499,38602,2021-08-27
3172051003,JAKARTA UTARA,PADEMANGAN,ANCOL,23947,9273,14674,8641,23315,2021-08-29
3173041007,JAKARTA BARAT,TAMBORA,ANGKE,29381,10471,18910,10192,29102,2021-08-29
3175041005,JAKARTA TIMUR,KRAMAT JATI,BALE KAMBANG,29074,12568,16506,7533,24039,2021-08-29
3175031003,JAKARTA TIMUR,JATINEGARA,BALI MESTER,9752,3734,6018,3512,9530,2021-08-29
3175101006,JAKARTA TIMUR,CIPAYUNG,BAMBU APUS,26285,9537,16748,9673,26421,2021-08-29
3174031002,JAKARTA SELATAN,MAMPANG PRAPATAN,BANGKA,21566,8351,13215,8149,21364,2021-08-29
3175051002,JAKARTA TIMUR,PASAR REBO,BARU,23886,7822,16064,10982,27046,2021-08-29
3175041004,JAKARTA TIMUR,KRAMAT JATI,BATU AMPAR,47898,20038,27860,14862,42722,2021-08-29
3171071002,JAKARTA PUSAT,TANAH ABANG,BENDUNGAN HILIR,21494,8077,13417,8432,21849,2021-08-29
3175031002,JAKARTA TIMUR,JATINEGARA,BIDARA CINA,36689,15666,21023,11338,32361,2021-08-29
3174101002,JAKARTA SELATAN,PESANGGRAHAN,BINTARO,53098,20095,33003,20749,53752,2021-08-29
3174011005,JAKARTA SELATAN,TEBET,BUKIT DURI,34183,13464,20719,11769,32488,2021-08-29
3171041006,JAKARTA PUSAT,SENEN,BUNGUR,18144,6583,11561,6914,18475,2021-08-29
3175061007,JAKARTA TIMUR,CAKUNG,CAKUNG BARAT,57724,19883,37841,21240,59081,2021-08-29
3175061004,JAKARTA TIMUR,CAKUNG,CAKUNG TIMUR,58287,20479,37808,23458,61266,2021-08-29
3175041007,JAKARTA TIMUR,KRAMAT JATI,CAWANG,32762,13208,19554,10943,30497,2021-08-29
3175101008,JAKARTA TIMUR,CIPAYUNG,CEGER,18932,6824,12108,7144,19252,2021-08-29
3171031006,JAKARTA PUSAT,KEMAYORAN,CEMPAKA BARU,32581,12577,20004,11445,31449,2021-08-29
3171051002,JAKARTA PUSAT,CEMPAKA PUTIH,CEMPAKA PUTIH BARAT,35885,13606,22279,14524,36803,2021-08-29
3171051001,JAKARTA PUSAT,CEMPAKA PUTIH,CEMPAKA PUTIH TIMUR,24292,8902,15390,9885,25275,2021-08-29
3173011001,JAKARTA BARAT,CENGKARENG,CENGKARENG BARAT,66284,23858,42426,26187,68613,2021-08-29
3173011006,JAKARTA BARAT,CENGKARENG,CENGKARENG TIMUR,81027,28504,52523,27300,79823,2021-08-29
3175091002,JAKARTA TIMUR,CIRACAS,CIBUBUR,66364,22696,43668,27280,70948,2021-08-29
3171011002,JAKARTA PUSAT,GAMBIR,CIDENG,15390,5242,10148,6480,16628,2021-08-29
3174091003,JAKARTA SELATAN,JAGAKARSA,CIGANJUR,38497,13978,24519,14533,39052,2021-08-29
3175051003,JAKARTA TIMUR,PASAR REBO,CIJANTUNG,41419,14181,27238,16808,44046,2021-08-29
3171061003,JAKARTA PUSAT,MENTENG,CIKINI,8274,3165,5109,3021,8130,2021-08-29
3174081006,JAKARTA SELATAN,PANCORAN,CIKOKO,10547,3653,6894,4005,10899,2021-08-29
3174061001,JAKARTA SELATAN,CILANDAK,CILANDAK BARAT,51752,18676,33076,20692,53768,2021-08-29
3174041003,JAKARTA SELATAN,PASAR MINGGU,CILANDAK TIMUR,25145,8965,16180,10759,26939,2021-08-29
3175101002,JAKARTA TIMUR,CIPAYUNG,CILANGKAP,27635,9709,17926,10611,28537,2021-08-29
3175041006,JAKARTA TIMUR,KRAMAT JATI,CILILITAN,40181,16544,23637,13749,37386,2021-08-29
3172041001,JAKARTA UTARA,CILINCING,CILINCING,43609,16918,26691,14753,41444,2021-08-29
3175101001,JAKARTA TIMUR,CIPAYUNG,CIPAYUNG,26104,8498,17606,10753,28359,2021-08-29
3174091006,JAKARTA SELATAN,JAGAKARSA,CIPEDAK,38303,12934,25369,15775,41144,2021-08-29
3174061005,JAKARTA SELATAN,CILANDAK,CIPETE SELATAN,26704,10097,16607,11140,27747,2021-08-29
3174071010,JAKARTA SELATAN,KEBAYORAN BARU,CIPETE UTARA,34102,12553,21549,13320,34869,2021-08-29
3175021003,JAKARTA TIMUR,PULO GADUNG,CIPINANG,39306,14854,24452,14662,39114,2021-08-29
3175031007,JAKARTA TIMUR,JATINEGARA,CIPINANG BESAR SELATAN,35212,14536,20676,11101,31777,2021-08-29
3175031008,JAKARTA TIMUR,JATINEGARA,CIPINANG BESAR UTARA,45319,18641,26678,13985,40663,2021-08-29
3175031005,JAKARTA TIMUR,JATINEGARA,CIPINANG CEMPEDAK,32824,13474,19350,11672,31022,2021-08-29
3175081005,JAKARTA TIMUR,MAKASAR,CIPINANG MELAYU,42308,16205,26103,16320,42423,2021-08-29
3175031006,JAKARTA TIMUR,JATINEGARA,CIPINANG MUARA,55243,22526,32717,18405,51122,2021-08-29
3174051003,JAKARTA SELATAN,KEBAYORAN LAMA,CIPULIR,39937,16109,23828,12983,36811,2021-08-29
3175091001,JAKARTA TIMUR,CIRACAS,CIRACAS,64594,21971,42623,24697,67320,2021-08-29
3175041003,JAKARTA TIMUR,KRAMAT JATI,DUKUH,24609,8742,15867,8806,24673,2021-08-29
3175071001,JAKARTA TIMUR,DUREN SAWIT,DUREN SAWIT,61160,24682,36478,21368,57846,2021-08-29
3174081004,JAKARTA SELATAN,PANCORAN,DUREN TIGA,28319,10587,17732,9521,27253,2021-08-29
3173051005,JAKARTA BARAT,KEBON JERUK,DURI KEPA,60138,21010,39128,24728,63856,2021-08-29
3173011002,JAKARTA BARAT,CENGKARENG,DURI KOSAMBI,77923,30870,47053,25409,72462,2021-08-29
3171011006,JAKARTA PUSAT,GAMBIR,DURI PULO,19610,7083,12527,7277,19804,2021-08-29
3173041011,JAKARTA BARAT,TAMBORA,DURI SELATAN,14259,4712,9547,5881,15428,2021-08-29
3173041003,JAKARTA BARAT,TAMBORA,DURI UTARA,19844,6856,12988,7637,20625,2021-08-29
3171081003,JAKARTA PUSAT,JOHAR BARU,GALUR,18243,5778,12465,7018,19483,2021-08-29
3171011001,JAKARTA PUSAT,GAMBIR,GAMBIR,2191,746,1445,923,2368,2021-08-29
3174061004,JAKARTA SELATAN,CILANDAK,GANDARIA SELATAN,22119,8269,13850,8310,22160,2021-08-29
3174071009,JAKARTA SELATAN,KEBAYORAN BARU,GANDARIA UTARA,39922,15066,24856,15344,40200,2021-08-29
3175051001,JAKARTA TIMUR,PASAR REBO,GEDONG,35755,12789,22966,13827,36793,2021-08-29
3171071001,JAKARTA PUSAT,TANAH ABANG,GELORA,3127,1213,1914,1192,3106,2021-08-29
3173031007,JAKARTA BARAT,TAMAN SARI,GLODOK,7837,2410,5427,3763,9190,2021-08-29
3171061004,JAKARTA PUSAT,MENTENG,GONDANGDIA,4100,1510,2590,1953,4543,2021-08-29
3173021001,JAKARTA BARAT,GROGOL PETAMBURAN,GROGOL,16876,6165,10711,6624,17335,2021-08-29
3174051005,JAKARTA SELATAN,KEBAYORAN LAMA,GROGOL SELATAN,44251,17068,27183,15491,42674,2021-08-29
3174051004,JAKARTA SELATAN,KEBAYORAN LAMA,GROGOL UTARA,42494,16215,26279,14965,41244,2021-08-29
3174021007,JAKARTA SELATAN,SETIA BUDI,GUNTUR,3985,1405,2580,1824,4404,2021-08-29
3174071002,JAKARTA SELATAN,KEBAYORAN BARU,GUNUNG,9436,3359,6077,4207,10284,2021-08-29
3171031005,JAKARTA PUSAT,KEMAYORAN,GUNUNG SAHARI SELATAN,19199,7133,12066,7614,19680,2021-08-29
3171021004,JAKARTA PUSAT,SAWAH BESAR,GUNUNG SAHARI UTARA,16650,5322,11328,7603,18931,2021-08-29
3175081004,JAKARTA TIMUR,MAKASAR,HALIM PERDANA KUSUMAH,28363,8008,20355,15599,35954,2021-08-29
3171031003,JAKARTA PUSAT,KEMAYORAN,HARAPAN MULIA,22557,8336,14221,8465,22686,2021-08-29
3174091001,JAKARTA SELATAN,JAGAKARSA,JAGAKARSA,62389,21911,40478,25760,66238,2021-08-29
3175021007,JAKARTA TIMUR,PULO GADUNG,JATI,32757,12142,20615,12385,33000,2021-08-29
3174041002,JAKARTA SELATAN,PASAR MINGGU,JATI PADANG,37502,13885,23617,14840,38457,2021-08-29
3173071004,JAKARTA BARAT,PALMERAH,JATI PULO,28738,10176,18562,10510,29072,2021-08-29
3175061001,JAKARTA TIMUR,CAKUNG,JATINEGARA,84160,32344,51816,29844,81660,2021-08-29
3175021004,JAKARTA TIMUR,PULO GADUNG,JATINEGARA KAUM,24632,8528,16104,8498,24602,2021-08-29
3173021004,JAKARTA BARAT,GROGOL PETAMBURAN,JELAMBAR,30266,10896,19370,12771,32141,2021-08-29
3173021006,JAKARTA BARAT,GROGOL PETAMBURAN,JELAMBAR BARU,38246,13864,24382,15602,39984,2021-08-29
3173041006,JAKARTA BARAT,TAMBORA,JEMBATAN BESI,29314,12471,16843,8676,25519,2021-08-29
3173041008,JAKARTA BARAT,TAMBORA,JEMBATAN LIMA,21021,8230,12791,6968,19759,2021-08-29
3173081005,JAKARTA BARAT,KEMBANGAN,JOGLO,40839,15415,25424,14745,40169,2021-08-29
3171081001,JAKARTA PUSAT,JOHAR BARU,JOHAR BARU,37488,12313,25175,15516,40691,2021-08-29
3173041002,JAKARTA BARAT,TAMBORA,KALI ANYAR,23856,8198,15658,8127,23785,2021-08-29
3172041004,JAKARTA UTARA,CILINCING,KALIBARU,67684,28093,39591,20709,60300,2021-08-29
3174081002,JAKARTA SELATAN,PANCORAN,KALIBATA,41994,17484,24510,13036,37546,2021-08-29
3173061001,JAKARTA BARAT,KALI DERES,KALIDERES,72447,27063,45384,27655,73039,2021-08-29
3175051004,JAKARTA TIMUR,PASAR REBO,KALISARI,43212,15146,28066,17474,45540,2021-08-29
3173061004,JAKARTA BARAT,KALI DERES,KAMAL,53783,20579,33204,16280,49484,2021-08-29
3172011002,JAKARTA UTARA,PENJARINGAN,KAMAL MUARA,12930,3531,9399,6530,15929,2021-08-29
3171071007,JAKARTA PUSAT,TANAH ABANG,KAMPUNG BALI,11358,4680,6678,3842,10520,2021-08-29
3175031001,JAKARTA TIMUR,JATINEGARA,KAMPUNG MELAYU,25717,10698,15019,8075,23094,2021-08-29
3171081002,JAKARTA PUSAT,JOHAR BARU,KAMPUNG RAWA,21237,5873,15364,8625,23989,2021-08-29
3175041002,JAKARTA TIMUR,KRAMAT JATI,KAMPUNG TENGAH,43993,18359,25634,13266,38900,2021-08-29
3173011005,JAKARTA BARAT,CENGKARENG,KAPUK,134466,53301,81165,40948,122113,2021-08-29
3172011003,JAKARTA UTARA,PENJARINGAN,KAPUK MUARA,35781,11491,24290,17068,41358,2021-08-29
3171021002,JAKARTA PUSAT,SAWAH BESAR,KARANG ANYAR,25761,8831,16930,10128,27058,2021-08-29
3174021004,JAKARTA SELATAN,SETIA BUDI,KARET,9623,3647,5976,3856,9832,2021-08-29
3174021003,JAKARTA SELATAN,SETIA BUDI,KARET KUNINGAN,16055,5399,10656,6822,17478,2021-08-29
3174021002,JAKARTA SELATAN,SETIA BUDI,KARET SEMANGGI,2770,960,1810,1334,3144,2021-08-29
3171071003,JAKARTA PUSAT,TANAH ABANG,KARET TENGSIN,19271,7160,12111,7310,19421,2021-08-29
3171021003,JAKARTA PUSAT,SAWAH BESAR,KARTINI,22292,7917,14375,9172,23547,2021-08-29
3175011003,JAKARTA TIMUR,MATRAMAN,KAYU MANIS,25284,10159,15125,8156,23281,2021-08-29
3175021006,JAKARTA TIMUR,PULO GADUNG,KAYU PUTIH,40696,14286,26410,17183,43593,2021-08-29
3173031006,JAKARTA BARAT,TAMAN SARI,KEAGUNGAN,17387,6104,11283,6881,18164,2021-08-29
3174041007,JAKARTA SELATAN,PASAR MINGGU,KEBAGUSAN,44552,17173,27379,16165,43544,2021-08-29
3174051006,JAKARTA SELATAN,KEBAYORAN LAMA,KEBAYORAN LAMA SELATAN,41212,14851,26361,15445,41806,2021-08-29
3174051001,JAKARTA SELATAN,KEBAYORAN LAMA,KEBAYORAN LAMA UTARA,42422,16656,25766,13980,39746,2021-08-29
3174011004,JAKARTA SELATAN,TEBET,KEBON BARU,35165,13048,22117,13189,35306,2021-08-29
3172021005,JAKARTA UTARA,TANJUNG PRIOK,KEBON BAWANG,50952,18723,32229,19611,51840,2021-08-29
3173051001,JAKARTA BARAT,KEBON JERUK,KEBON JERUK,53887,21179,32708,18622,51330,2021-08-29
3171071006,JAKARTA PUSAT,TANAH ABANG,KEBON KACANG,21531,9436,12095,6998,19093,2021-08-29
3171011005,JAKARTA PUSAT,GAMBIR,KEBON KELAPA,10163,3635,6528,4038,10566,2021-08-29
3171031002,JAKARTA PUSAT,KEMAYORAN,KEBON KOSONG,30019,11310,18709,11235,29944,2021-08-29
3175011005,JAKARTA TIMUR,MATRAMAN,KEBON MANGGIS,16490,6021,10469,6301,16770,2021-08-29
3171071005,JAKARTA PUSAT,TANAH ABANG,KEBON MELATI,32206,14811,17395,9450,26845,2021-08-29
3175081003,JAKARTA TIMUR,MAKASAR,KEBON PALA,46614,17098,29516,16807,46323,2021-08-29
3171061005,JAKARTA PUSAT,MENTENG,KEBON SIRIH,12299,4749,7550,4448,11998,2021-08-29
3173011004,JAKARTA BARAT,CENGKARENG,KEDAUNG KALI ANGKE,32612,10865,21747,12472,34219,2021-08-29
3173051007,JAKARTA BARAT,KEBON JERUK,KEDOYA SELATAN,32165,11514,20651,11985,32636,2021-08-29
3173051006,JAKARTA BARAT,KEBON JERUK,KEDOYA UTARA,45740,15305,30435,18986,49421,2021-08-29
3173051004,JAKARTA BARAT,KEBON JERUK,KELAPA DUA,23565,8987,14578,8197,22775,2021-08-29
3175091003,JAKARTA TIMUR,CIRACAS,KELAPA DUA WETAN,46875,15691,31184,18369,49553,2021-08-29
3172061003,JAKARTA UTARA,KELAPA GADING,KELAPA GADING BARAT,35717,11503,24214,17543,41757,2021-08-29
3172061001,JAKARTA UTARA,KELAPA GADING,KELAPA GADING TIMUR,33592,9939,23653,16874,40527,2021-08-29
3173071005,JAKARTA BARAT,PALMERAH,KEMANGGISAN,32139,11892,20247,11811,32058,2021-08-29
3171031001,JAKARTA PUSAT,KEMAYORAN,KEMAYORAN,20708,7435,13273,8220,21493,2021-08-29
3173081006,JAKARTA BARAT,KEMBANGAN,KEMBANGAN SELATAN,27130,9932,17198,11312,28510,2021-08-29
3173081001,JAKARTA BARAT,KEMBANGAN,KEMBANGAN UTARA,54451,20087,34364,20169,54533,2021-08-29
3171041002,JAKARTA PUSAT,SENEN,KENARI,9579,3411,6168,3753,9921,2021-08-29
3173041005,JAKARTA BARAT,TAMBORA,KERENDANG,19973,7130,12843,7629,20472,2021-08-29
3175071003,JAKARTA TIMUR,DUREN SAWIT,KLENDER,69978,28992,40986,21664,62650,2021-08-29
3172031001,JAKARTA UTARA,KOJA,KOJA,28175,10836,17339,10486,27825,2021-08-29
3173071006,JAKARTA BARAT,PALMERAH,KOTA BAMBU SELATAN,21158,7932,13226,7230,20456,2021-08-29
3173071003,JAKARTA BARAT,PALMERAH,KOTA BAMBU UTARA,24995,9549,15446,8735,24181,2021-08-29
3171041004,JAKARTA PUSAT,SENEN,KRAMAT,28835,11117,17718,9293,27011,2021-08-29
3175041001,JAKARTA TIMUR,KRAMAT JATI,KRAMAT JATI,34144,12834,21310,11320,32630,2021-08-29
3174071003,JAKARTA SELATAN,KEBAYORAN BARU,KRAMAT PELA,14413,5049,9364,5887,15251,2021-08-29
3173031002,JAKARTA BARAT,TAMAN SARI,KRUKUT,19244,6858,12386,6953,19339,2021-08-29
3174031005,JAKARTA SELATAN,MAMPANG PRAPATAN,KUNINGAN BARAT,12785,4502,8283,5099,13382,2021-08-29
3174021008,JAKARTA SELATAN,SETIA BUDI,KUNINGAN TIMUR,6008,2165,3843,2515,6358,2021-08-29
3171041005,JAKARTA PUSAT,SENEN,KWITANG,15486,5704,9782,5641,15423,2021-08-29
3172031003,JAKARTA UTARA,KOJA,LAGOA,59065,23224,35841,20837,56678,2021-08-29
3174061002,JAKARTA SELATAN,CILANDAK,LEBAK BULUS,37626,14359,23267,14629,37896,2021-08-29
3174091004,JAKARTA SELATAN,JAGAKARSA,LENTENG AGUNG,53946,20652,33294,18685,51979,2021-08-29
3175101007,JAKARTA TIMUR,CIPAYUNG,LUBANG BUAYA,63547,21668,41879,25034,66913,2021-08-29
3175081001,JAKARTA TIMUR,MAKASAR,MAKASAR,34390,12228,22162,13307,35469,2021-08-29
3175071006,JAKARTA TIMUR,DUREN SAWIT,MALAKA JAYA,30927,11575,19352,12905,32257,2021-08-29
3175071005,JAKARTA TIMUR,DUREN SAWIT,MALAKA SARI,27530,9905,17625,11624,29249,2021-08-29
3174031001,JAKARTA SELATAN,MAMPANG PRAPATAN,MAMPANG PRAPATAN,18159,6711,11448,7195,18643,2021-08-29
3173031005,JAKARTA BARAT,TAMAN SARI,MANGGA BESAR,7707,2409,5298,3508,8806,2021-08-29
3171021005,JAKARTA PUSAT,SAWAH BESAR,MANGGA DUA SELATAN,27442,9810,17632,10916,28548,2021-08-29
3174011007,JAKARTA SELATAN,TEBET,MANGGARAI,28373,9705,18668,10598,29266,2021-08-29
3174011006,JAKARTA SELATAN,TEBET,MANGGARAI SELATAN,23075,8111,14964,9050,24014,2021-08-29
3173031003,JAKARTA BARAT,TAMAN SARI,MAPHAR,16461,5953,10508,6717,17225,2021-08-29
3172041003,JAKARTA UTARA,CILINCING,MARUNDA,28943,10262,18681,8840,27521,2021-08-29
3174071001,JAKARTA SELATAN,KEBAYORAN BARU,MELAWAI,2627,900,1727,1349,3076,2021-08-29
3171061001,JAKARTA PUSAT,MENTENG,MENTENG,25624,9945,15679,9190,24869,2021-08-29
3174021005,JAKARTA SELATAN,SETIA BUDI,MENTENG ATAS,27816,9621,18195,10908,29103,2021-08-29
3174011003,JAKARTA SELATAN,TEBET,MENTENG DALAM,36028,13289,22739,13746,36485,2021-08-29
3173081003,JAKARTA BARAT,KEMBANGAN,MERUYA SELATAN,32130,11931,20199,11683,31882,2021-08-29
3173081002,JAKARTA BARAT,KEMBANGAN,MERUYA UTARA,43752,16382,27370,17208,44578,2021-08-29
3175101004,JAKARTA TIMUR,CIPAYUNG,MUNJUL,23871,8187,15684,9525,25209,2021-08-29
3172051002,JAKARTA UTARA,PADEMANGAN,PADEMANGAN BARAT,74240,28396,45844,26987,72831,2021-08-29
3172051001,JAKARTA UTARA,PADEMANGAN,PADEMANGAN TIMUR,37736,12133,25603,17026,42629,2021-08-29
3175011004,JAKARTA TIMUR,MATRAMAN,PAL MERIAM,19769,7804,11965,6838,18803,2021-08-29
3173071001,JAKARTA BARAT,PALMERAH,PALMERAH,63011,23832,39179,22150,61329,2021-08-29
3174081001,JAKARTA SELATAN,PANCORAN,PANCORAN,19421,7265,12156,7281,19437,2021-08-29
3172021003,JAKARTA UTARA,TANJUNG PRIOK,PAPANGGO,39097,13439,25658,15363,41021,2021-08-29
3171021001,JAKARTA PUSAT,SAWAH BESAR,PASAR BARU,12035,3817,8218,5614,13832,2021-08-29
3174021006,JAKARTA SELATAN,SETIA BUDI,PASAR MANGGIS,26752,9870,16882,10171,27053,2021-08-29
3174041001,JAKARTA SELATAN,PASAR MINGGU,PASAR MINGGU,24821,9129,15692,10047,25739,2021-08-29
3171041003,JAKARTA PUSAT,SENEN,PASEBAN,23533,8918,14615,8529,23144,2021-08-29
3173061005,JAKARTA BARAT,KALI DERES,PEGADUNGAN,75587,26127,49460,29719,79179,2021-08-29
3171061002,JAKARTA PUSAT,MENTENG,PEGANGSAAN,23455,9013,14442,7866,22308,2021-08-29
3172061002,JAKARTA UTARA,KELAPA GADING,PEGANGSAAN DUA,49976,14765,35211,23980,59191,2021-08-29
3172011004,JAKARTA UTARA,PENJARINGAN,PEJAGALAN,74578,27034,47544,29834,77378,2021-08-29
3174041006,JAKARTA SELATAN,PASAR MINGGU,PEJATEN BARAT,37346,14126,23220,14478,37698,2021-08-29
3174041005,JAKARTA SELATAN,PASAR MINGGU,PEJATEN TIMUR,57656,22755,34901,19317,54218,2021-08-29
3175051005,JAKARTA TIMUR,PASAR REBO,PEKAYON,43250,14999,28251,17251,45502,2021-08-29
3173041009,JAKARTA BARAT,TAMBORA,PEKOJAN,23587,7977,15610,9702,25312,2021-08-29
3174031003,JAKARTA SELATAN,MAMPANG PRAPATAN,PELA MAMPANG,43522,15857,27665,17863,45528,2021-08-29
3174081005,JAKARTA SELATAN,PANCORAN,PENGADEGAN,21478,7239,14239,7710,21949,2021-08-29
3175061003,JAKARTA TIMUR,CAKUNG,PENGGILINGAN,99255,41176,58079,30713,88792,2021-08-29
3172011001,JAKARTA UTARA,PENJARINGAN,PENJARINGAN,88308,35556,52752,28682,81434,2021-08-29
3174101001,JAKARTA SELATAN,PESANGGRAHAN,PESANGGRAHAN,27545,9510,18035,11211,29246,2021-08-29
3171071004,JAKARTA PUSAT,TANAH ABANG,PETAMBURAN,33271,15354,17917,9265,27182,2021-08-29
3174071008,JAKARTA SELATAN,KEBAYORAN BARU,PETOGOGAN,11499,4301,7198,4648,11846,2021-08-29
3171011004,JAKARTA PUSAT,GAMBIR,PETOJO SELATAN,14692,5509,9183,5726,14909,2021-08-29
3171011003,JAKARTA PUSAT,GAMBIR,PETOJO UTARA,17458,6413,11045,6140,17185,2021-08-29
3174101004,JAKARTA SELATAN,PESANGGRAHAN,PETUKANGAN SELATAN,37187,13787,23400,13969,37369,2021-08-29
3174101003,JAKARTA SELATAN,PESANGGRAHAN,PETUKANGAN UTARA,53716,21162,32554,19517,52071,2021-08-29
3175081002,JAKARTA TIMUR,MAKASAR,PINANG RANTI,27198,10098,17100,10631,27731,2021-08-29
3173031008,JAKARTA BARAT,TAMAN SARI,PINANGSIA,10729,3477,7252,4554,11806,2021-08-29
3175011001,JAKARTA TIMUR,MATRAMAN,PISANGAN BARU,31776,12540,19236,10036,29272,2021-08-29
3175021002,JAKARTA TIMUR,PULO GADUNG,PISANGAN TIMUR,41011,14568,26443,15342,41785,2021-08-29
3172011005,JAKARTA UTARA,PENJARINGAN,PLUIT,47783,16259,31524,21963,53487,2021-08-29
3175071002,JAKARTA TIMUR,DUREN SAWIT,PONDOK BAMBU,61550,24532,37018,20864,57882,2021-08-29
3175071004,JAKARTA TIMUR,DUREN SAWIT,PONDOK KELAPA,72015,26838,45177,26180,71357,2021-08-29
3175071007,JAKARTA TIMUR,DUREN SAWIT,PONDOK KOPI,35367,15031,20336,11556,31892,2021-08-29
3174061003,JAKARTA SELATAN,CILANDAK,PONDOK LABU,46464,16195,30269,20083,50352,2021-08-29
3174051002,JAKARTA SELATAN,KEBAYORAN LAMA,PONDOK PINANG,56169,20993,35176,21855,57031,2021-08-29
3175101003,JAKARTA TIMUR,CIPAYUNG,PONDOK RANGGON,25574,9054,16520,9483,26003,2021-08-29
3101011003,KAB.ADM.KEP.SERIBU,KEP. SERIBU UTARA,PULAU HARAPAN,2060,343,1717,998,2715,2021-08-29
3101011002,KAB.ADM.KEP.SERIBU,KEP. SERIBU UTARA,PULAU KELAPA,5528,907,4621,2600,7221,2021-08-29
3101011001,KAB.ADM.KEP.SERIBU,KEP. SERIBU UTARA,PULAU PANGGANG,5450,875,4575,2096,6671,2021-08-29
3101021003,KAB.ADM.KEP.SERIBU,KEP. SERIBU SELATAN,PULAU PARI,2765,323,2442,1373,3815,2021-08-29
3101021002,KAB.ADM.KEP.SERIBU,KEP. SERIBU SELATAN,PULAU TIDUNG,4553,635,3918,2628,6546,2021-08-29
3101021001,KAB.ADM.KEP.SERIBU,KEP. SERIBU SELATAN,PULAU UNTUNG JAWA,1941,328,1613,888,2501,2021-08-29
3174071007,JAKARTA SELATAN,KEBAYORAN BARU,PULO,5835,1978,3857,2794,6651,2021-08-29
3175021001,JAKARTA TIMUR,PULO GADUNG,PULO GADUNG,34422,12954,21468,12362,33830,2021-08-29
3175061005,JAKARTA TIMUR,CAKUNG,PULO GEBANG,97301,37552,59749,33796,93545,2021-08-29
3174041004,JAKARTA SELATAN,PASAR MINGGU,RAGUNAN,39616,14020,25596,16127,41723,2021-08-29
3175091005,JAKARTA TIMUR,CIRACAS,RAMBUTAN,36771,15271,21500,12525,34025,2021-08-29
3172031006,JAKARTA UTARA,KOJA,RAWA BADAK SELATAN,42179,17065,25114,14281,39395,2021-08-29
3172031004,JAKARTA UTARA,KOJA,RAWA BADAK UTARA,34408,13494,20914,12125,33039,2021-08-29
3174071005,JAKARTA SELATAN,KEBAYORAN BARU,RAWA BARAT,5625,1898,3727,2536,6263,2021-08-29
3173011003,JAKARTA BARAT,CENGKARENG,RAWA BUAYA,63799,23838,39961,20964,60925,2021-08-29
3175031004,JAKARTA TIMUR,JATINEGARA,RAWA BUNGA,21434,8647,12787,7384,20171,2021-08-29
3174081003,JAKARTA SELATAN,PANCORAN,RAWA JATI,20509,7485,13024,7595,20619,2021-08-29
3175061002,JAKARTA TIMUR,CAKUNG,RAWA TERATE,24637,8362,16275,9483,25758,2021-08-29
3175021005,JAKARTA TIMUR,PULO GADUNG,RAWAMANGUN,37612,14163,23449,14498,37947,2021-08-29
3171051003,JAKARTA PUSAT,CEMPAKA PUTIH,RAWASARI,21967,8304,13663,8730,22393,2021-08-29
3173041010,JAKARTA BARAT,TAMBORA,ROA MALAKA,3484,1059,2425,1637,4062,2021-08-29
3172041006,JAKARTA UTARA,CILINCING,ROROTAN,41668,14419,27249,14997,42246,2021-08-29
3174071004,JAKARTA SELATAN,KEBAYORAN BARU,SELONG,2842,980,1862,1388,3250,2021-08-29
3173061002,JAKARTA BARAT,KALI DERES,SEMANAN,71354,27392,43962,22170,66132,2021-08-29
3172041007,JAKARTA UTARA,CILINCING,SEMPER BARAT,68587,23342,45245,27768,73013,2021-08-29
3172041005,JAKARTA UTARA,CILINCING,SEMPER TIMUR,36267,12892,23375,13308,36683,2021-08-29
3174071006,JAKARTA SELATAN,KEBAYORAN BARU,SENAYAN,2771,1128,1643,1080,2723,2021-08-29
3171041001,JAKARTA PUSAT,SENEN,SENEN,6804,2364,4440,2905,7345,2021-08-29
3171031004,JAKARTA PUSAT,KEMAYORAN,SERDANG,29668,11007,18661,10942,29603,2021-08-29
3174021001,JAKARTA SELATAN,SETIA BUDI,SETIA BUDI,3023,1125,1898,1259,3157,2021-08-29
3175101005,JAKARTA TIMUR,CIPAYUNG,SETU,20572,7854,12718,6941,19659,2021-08-29
3173071002,JAKARTA BARAT,PALMERAH,SLIPI,16591,5849,10742,6636,17378,2021-08-29
3173081004,JAKARTA BARAT,KEMBANGAN,SRENGSENG,45523,17565,27958,16546,44504,2021-08-29
3174091002,JAKARTA SELATAN,JAGAKARSA,SRENGSENG SAWAH,58196,18981,39215,24131,63346,2021-08-29
3173051003,JAKARTA BARAT,KEBON JERUK,SUKABUMI SELATAN,37033,14669,22364,11013,33377,2021-08-29
3173051002,JAKARTA BARAT,KEBON JERUK,SUKABUMI UTARA,38290,16088,22202,11308,33510,2021-08-29
3172041002,JAKARTA UTARA,CILINCING,SUKAPURA,53949,20369,33580,20269,53849,2021-08-29
3171031007,JAKARTA PUSAT,KEMAYORAN,SUMUR BATU,22717,8543,14174,8821,22995,2021-08-29
3172021004,JAKARTA UTARA,TANJUNG PRIOK,SUNGAI BAMBU,29876,10797,19079,11151,30230,2021-08-29
3172021006,JAKARTA UTARA,TANJUNG PRIOK,SUNTER AGUNG,71805,22774,49031,32712,81743,2021-08-29
3172021002,JAKARTA UTARA,TANJUNG PRIOK,SUNTER JAYA,63031,20773,42258,27813,70071,2021-08-29
3175091004,JAKARTA TIMUR,CIRACAS,SUSUKAN,38257,13007,25250,14585,39835,2021-08-29
3173031001,JAKARTA BARAT,TAMAN SARI,TAMAN SARI,14348,5136,9212,6156,15368,2021-08-29
3173041001,JAKARTA BARAT,TAMBORA,TAMBORA,10204,3786,6418,3568,9986,2021-08-29
3173041004,JAKARTA BARAT,TAMBORA,TANAH SEREAL,26387,8236,18151,10370,28521,2021-08-29
3171081004,JAKARTA PUSAT,JOHAR BARU,TANAH TINGGI,37693,11798,25895,14344,40239,2021-08-29
3173031004,JAKARTA BARAT,TAMAN SARI,TANGKI,13324,4690,8634,5620,14254,2021-08-29
3174091005,JAKARTA SELATAN,JAGAKARSA,TANJUNG BARAT,39770,14282,25488,14478,39966,2021-08-29
3173021005,JAKARTA BARAT,GROGOL PETAMBURAN,TANJUNG DUREN SELATAN,25337,9006,16331,10521,26852,2021-08-29
3173021002,JAKARTA BARAT,GROGOL PETAMBURAN,TANJUNG DUREN UTARA,17010,5741,11269,7165,18434,2021-08-29
3172021001,JAKARTA UTARA,TANJUNG PRIOK,TANJUNG PRIOK,34588,11854,22734,12899,35633,2021-08-29
3174011002,JAKARTA SELATAN,TEBET,TEBET BARAT,21194,7147,14047,9143,23190,2021-08-29
3174011001,JAKARTA SELATAN,TEBET,TEBET TIMUR,18199,6133,12066,7848,19914,2021-08-29
3173061003,JAKARTA BARAT,KALI DERES,TEGAL ALUR,83647,30590,53057,27117,80174,2021-08-29
3174031004,JAKARTA SELATAN,MAMPANG PRAPATAN,TEGAL PARANG,32401,12768,19633,11221,30854,2021-08-29
3173021003,JAKARTA BARAT,GROGOL PETAMBURAN,TOMANG,29605,10470,19135,12644,31779,2021-08-29
3172031005,JAKARTA UTARA,KOJA,TUGU SELATAN,39122,15314,23808,13564,37372,2021-08-29
3172031002,JAKARTA UTARA,KOJA,TUGU UTARA,67670,27034,40636,23679,64315,2021-08-29
3175061006,JAKARTA TIMUR,CAKUNG,UJUNG MENTENG,29934,10214,19720,11910,31630,2021-08-29
3174101005,JAKARTA SELATAN,PESANGGRAHAN,ULUJAMI,40544,16286,24258,13791,38049,2021-08-29
3175011006,JAKARTA TIMUR,MATRAMAN,UTAN KAYU SELATAN,33511,12067,21444,12469,33913,2021-08-29
3175011002,JAKARTA TIMUR,MATRAMAN,UTAN KAYU UTARA,28169,11001,17168,9685,26853,2021-08-29
3171031008,JAKARTA PUSAT,KEMAYORAN,UTAN PANJANG,29208,11201,18007,10313,28320,2021-08-29
3172021007,JAKARTA UTARA,TANJUNG PRIOK,WARAKAS,44401,15690,28711,16563,45274,2021-08-29
3173021007,JAKARTA BARAT,GROGOL PETAMBURAN,WIJAYA KUSUMA,38934,14608,24326,15280,39606,2021-08-29
3172051003,JAKARTA UTARA,PADEMANGAN,ANCOL,23947,9272,14675,8652,23327,2021-08-30
3173041007,JAKARTA BARAT,TAMBORA,ANGKE,29381,10461,18920,10211,29131,2021-08-30
3175041005,JAKARTA TIMUR,KRAMAT JATI,BALE KAMBANG,29074,12565,16509,7536,24045,2021-08-30
3175031003,JAKARTA TIMUR,JATINEGARA,BALI MESTER,9752,3731,6021,3513,9534,2021-08-30
3175101006,JAKARTA TIMUR,CIPAYUNG,BAMBU APUS,26285,9537,16748,9684,26432,2021-08-30
3174031002,JAKARTA SELATAN,MAMPANG PRAPATAN,BANGKA,21566,8350,13216,8158,21374,2021-08-30
3175051002,JAKARTA TIMUR,PASAR REBO,BARU,23886,7821,16065,10986,27051,2021-08-30
3175041004,JAKARTA TIMUR,KRAMAT JATI,BATU AMPAR,47898,20028,27870,14872,42742,2021-08-30
3171071002,JAKARTA PUSAT,TANAH ABANG,BENDUNGAN HILIR,21494,8074,13420,8452,21872,2021-08-30
3175031002,JAKARTA TIMUR,JATINEGARA,BIDARA CINA,36689,15663,21026,11350,32376,2021-08-30
3174101002,JAKARTA SELATAN,PESANGGRAHAN,BINTARO,53098,20092,33006,20756,53762,2021-08-30
3174011005,JAKARTA SELATAN,TEBET,BUKIT DURI,34183,13463,20720,11775,32495,2021-08-30
3171041006,JAKARTA PUSAT,SENEN,BUNGUR,18144,6583,11561,6925,18486,2021-08-30
3175061007,JAKARTA TIMUR,CAKUNG,CAKUNG BARAT,57724,19872,37852,21321,59173,2021-08-30
3175061004,JAKARTA TIMUR,CAKUNG,CAKUNG TIMUR,58287,20470,37817,23476,61293,2021-08-30
3175041007,JAKARTA TIMUR,KRAMAT JATI,CAWANG,32762,13198,19564,10983,30547,2021-08-30
3175101008,JAKARTA TIMUR,CIPAYUNG,CEGER,18932,6821,12111,7172,19283,2021-08-30
3171031006,JAKARTA PUSAT,KEMAYORAN,CEMPAKA BARU,32581,12573,20008,11460,31468,2021-08-30
3171051002,JAKARTA PUSAT,CEMPAKA PUTIH,CEMPAKA PUTIH BARAT,35885,13600,22285,14541,36826,2021-08-30
3171051001,JAKARTA PUSAT,CEMPAKA PUTIH,CEMPAKA PUTIH TIMUR,24292,8893,15399,9895,25294,2021-08-30
3173011001,JAKARTA BARAT,CENGKARENG,CENGKARENG BARAT,66284,23831,42453,26204,68657,2021-08-30
3173011006,JAKARTA BARAT,CENGKARENG,CENGKARENG TIMUR,81027,28454,52573,27342,79915,2021-08-30
3175091002,JAKARTA TIMUR,CIRACAS,CIBUBUR,66364,22685,43679,27313,70992,2021-08-30
3171011002,JAKARTA PUSAT,GAMBIR,CIDENG,15390,5227,10163,6518,16681,2021-08-30
3174091003,JAKARTA SELATAN,JAGAKARSA,CIGANJUR,38497,13977,24520,14541,39061,2021-08-30
3175051003,JAKARTA TIMUR,PASAR REBO,CIJANTUNG,41419,14177,27242,16819,44061,2021-08-30
3171061003,JAKARTA PUSAT,MENTENG,CIKINI,8274,3164,5110,3023,8133,2021-08-30
3174081006,JAKARTA SELATAN,PANCORAN,CIKOKO,10547,3652,6895,4007,10902,2021-08-30
3174061001,JAKARTA SELATAN,CILANDAK,CILANDAK BARAT,51752,18675,33077,20704,53781,2021-08-30
3174041003,JAKARTA SELATAN,PASAR MINGGU,CILANDAK TIMUR,25145,8964,16181,10762,26943,2021-08-30
3175101002,JAKARTA TIMUR,CIPAYUNG,CILANGKAP,27635,9707,17928,10614,28542,2021-08-30
3175041006,JAKARTA TIMUR,KRAMAT JATI,CILILITAN,40181,16538,23643,13772,37415,2021-08-30
3172041001,JAKARTA UTARA,CILINCING,CILINCING,43609,16909,26700,14784,41484,2021-08-30
3175101001,JAKARTA TIMUR,CIPAYUNG,CIPAYUNG,26104,8496,17608,10762,28370,2021-08-30
3174091006,JAKARTA SELATAN,JAGAKARSA,CIPEDAK,38303,12933,25370,15779,41149,2021-08-30
3174061005,JAKARTA SELATAN,CILANDAK,CIPETE SELATAN,26704,10095,16609,11145,27754,2021-08-30
3174071010,JAKARTA SELATAN,KEBAYORAN BARU,CIPETE UTARA,34102,12551,21551,13327,34878,2021-08-30
3175021003,JAKARTA TIMUR,PULO GADUNG,CIPINANG,39306,14850,24456,14706,39162,2021-08-30
3175031007,JAKARTA TIMUR,JATINEGARA,CIPINANG BESAR SELATAN,35212,14515,20697,11141,31838,2021-08-30
3175031008,JAKARTA TIMUR,JATINEGARA,CIPINANG BESAR UTARA,45319,18634,26685,14022,40707,2021-08-30
3175031005,JAKARTA TIMUR,JATINEGARA,CIPINANG CEMPEDAK,32824,13468,19356,11685,31041,2021-08-30
3175081005,JAKARTA TIMUR,MAKASAR,CIPINANG MELAYU,42308,16203,26105,16330,42435,2021-08-30
3175031006,JAKARTA TIMUR,JATINEGARA,CIPINANG MUARA,55243,22518,32725,18458,51183,2021-08-30
3174051003,JAKARTA SELATAN,KEBAYORAN LAMA,CIPULIR,39937,16106,23831,12992,36823,2021-08-30
3175091001,JAKARTA TIMUR,CIRACAS,CIRACAS,64594,21956,42638,24734,67372,2021-08-30
3175041003,JAKARTA TIMUR,KRAMAT JATI,DUKUH,24609,8741,15868,8810,24678,2021-08-30
3175071001,JAKARTA TIMUR,DUREN SAWIT,DUREN SAWIT,61160,24668,36492,21394,57886,2021-08-30
3174081004,JAKARTA SELATAN,PANCORAN,DUREN TIGA,28319,10587,17732,9525,27257,2021-08-30
3173051005,JAKARTA BARAT,KEBON JERUK,DURI KEPA,60138,20994,39144,24784,63928,2021-08-30
3173011002,JAKARTA BARAT,CENGKARENG,DURI KOSAMBI,77923,30855,47068,25446,72514,2021-08-30
3171011006,JAKARTA PUSAT,GAMBIR,DURI PULO,19610,7081,12529,7289,19818,2021-08-30
3173041011,JAKARTA BARAT,TAMBORA,DURI SELATAN,14259,4706,9553,5895,15448,2021-08-30
3173041003,JAKARTA BARAT,TAMBORA,DURI UTARA,19844,6849,12995,7661,20656,2021-08-30
3171081003,JAKARTA PUSAT,JOHAR BARU,GALUR,18243,5772,12471,7031,19502,2021-08-30
3171011001,JAKARTA PUSAT,GAMBIR,GAMBIR,2191,746,1445,923,2368,2021-08-30
3174061004,JAKARTA SELATAN,CILANDAK,GANDARIA SELATAN,22119,8269,13850,8314,22164,2021-08-30
3174071009,JAKARTA SELATAN,KEBAYORAN BARU,GANDARIA UTARA,39922,15062,24860,15350,40210,2021-08-30
3175051001,JAKARTA TIMUR,PASAR REBO,GEDONG,35755,12785,22970,13835,36805,2021-08-30
3171071001,JAKARTA PUSAT,TANAH ABANG,GELORA,3127,1213,1914,1194,3108,2021-08-30
3173031007,JAKARTA BARAT,TAMAN SARI,GLODOK,7837,2406,5431,3792,9223,2021-08-30
3171061004,JAKARTA PUSAT,MENTENG,GONDANGDIA,4100,1510,2590,1954,4544,2021-08-30
3173021001,JAKARTA BARAT,GROGOL PETAMBURAN,GROGOL,16876,6163,10713,6635,17348,2021-08-30
3174051005,JAKARTA SELATAN,KEBAYORAN LAMA,GROGOL SELATAN,44251,17067,27184,15496,42680,2021-08-30
3174051004,JAKARTA SELATAN,KEBAYORAN LAMA,GROGOL UTARA,42494,16211,26283,14973,41256,2021-08-30
3174021007,JAKARTA SELATAN,SETIA BUDI,GUNTUR,3985,1403,2582,1824,4406,2021-08-30
3174071002,JAKARTA SELATAN,KEBAYORAN BARU,GUNUNG,9436,3359,6077,4207,10284,2021-08-30
3171031005,JAKARTA PUSAT,KEMAYORAN,GUNUNG SAHARI SELATAN,19199,7129,12070,7619,19689,2021-08-30
3171021004,JAKARTA PUSAT,SAWAH BESAR,GUNUNG SAHARI UTARA,16650,5318,11332,7616,18948,2021-08-30
3175081004,JAKARTA TIMUR,MAKASAR,HALIM PERDANA KUSUMAH,28363,8004,20359,15601,35960,2021-08-30
3171031003,JAKARTA PUSAT,KEMAYORAN,HARAPAN MULIA,22557,8333,14224,8468,22692,2021-08-30
3174091001,JAKARTA SELATAN,JAGAKARSA,JAGAKARSA,62389,21910,40479,25770,66249,2021-08-30
3175021007,JAKARTA TIMUR,PULO GADUNG,JATI,32757,12130,20627,12409,33036,2021-08-30
3174041002,JAKARTA SELATAN,PASAR MINGGU,JATI PADANG,37502,13883,23619,14843,38462,2021-08-30
3173071004,JAKARTA BARAT,PALMERAH,JATI PULO,28738,10166,18572,10525,29097,2021-08-30
3175061001,JAKARTA TIMUR,CAKUNG,JATINEGARA,84160,32327,51833,29905,81738,2021-08-30
3175021004,JAKARTA TIMUR,PULO GADUNG,JATINEGARA KAUM,24632,8526,16106,8521,24627,2021-08-30
3173021004,JAKARTA BARAT,GROGOL PETAMBURAN,JELAMBAR,30266,10886,19380,12802,32182,2021-08-30
3173021006,JAKARTA BARAT,GROGOL PETAMBURAN,JELAMBAR BARU,38246,13849,24397,15644,40041,2021-08-30
3173041006,JAKARTA BARAT,TAMBORA,JEMBATAN BESI,29314,12462,16852,8690,25542,2021-08-30
3173041008,JAKARTA BARAT,TAMBORA,JEMBATAN LIMA,21021,8225,12796,6974,19770,2021-08-30
3173081005,JAKARTA BARAT,KEMBANGAN,JOGLO,40839,15412,25427,14752,40179,2021-08-30
3171081001,JAKARTA PUSAT,JOHAR BARU,JOHAR BARU,37488,12312,25176,15536,40712,2021-08-30
3173041002,JAKARTA BARAT,TAMBORA,KALI ANYAR,23856,8192,15664,8144,23808,2021-08-30
3172041004,JAKARTA UTARA,CILINCING,KALIBARU,67684,28005,39679,21031,60710,2021-08-30
3174081002,JAKARTA SELATAN,PANCORAN,KALIBATA,41994,17484,24510,13046,37556,2021-08-30
3173061001,JAKARTA BARAT,KALI DERES,KALIDERES,72447,27043,45404,27870,73274,2021-08-30
3175051004,JAKARTA TIMUR,PASAR REBO,KALISARI,43212,15140,28072,17489,45561,2021-08-30
3173061004,JAKARTA BARAT,KALI DERES,KAMAL,53783,20553,33230,16341,49571,2021-08-30
3172011002,JAKARTA UTARA,PENJARINGAN,KAMAL MUARA,12930,3527,9403,6532,15935,2021-08-30
3171071007,JAKARTA PUSAT,TANAH ABANG,KAMPUNG BALI,11358,4680,6678,3851,10529,2021-08-30
3175031001,JAKARTA TIMUR,JATINEGARA,KAMPUNG MELAYU,25717,10694,15023,8084,23107,2021-08-30
3171081002,JAKARTA PUSAT,JOHAR BARU,KAMPUNG RAWA,21237,5871,15366,8629,23995,2021-08-30
3175041002,JAKARTA TIMUR,KRAMAT JATI,KAMPUNG TENGAH,43993,18355,25638,13279,38917,2021-08-30
3173011005,JAKARTA BARAT,CENGKARENG,KAPUK,134466,53254,81212,41004,122216,2021-08-30
3172011003,JAKARTA UTARA,PENJARINGAN,KAPUK MUARA,35781,11479,24302,17085,41387,2021-08-30
3171021002,JAKARTA PUSAT,SAWAH BESAR,KARANG ANYAR,25761,8824,16937,10152,27089,2021-08-30
3174021004,JAKARTA SELATAN,SETIA BUDI,KARET,9623,3647,5976,3859,9835,2021-08-30
3174021003,JAKARTA SELATAN,SETIA BUDI,KARET KUNINGAN,16055,5399,10656,6827,17483,2021-08-30
3174021002,JAKARTA SELATAN,SETIA BUDI,KARET SEMANGGI,2770,960,1810,1334,3144,2021-08-30
3171071003,JAKARTA PUSAT,TANAH ABANG,KARET TENGSIN,19271,7147,12124,7364,19488,2021-08-30
3171021003,JAKARTA PUSAT,SAWAH BESAR,KARTINI,22292,7912,14380,9185,23565,2021-08-30
3175011003,JAKARTA TIMUR,MATRAMAN,KAYU MANIS,25284,10157,15127,8182,23309,2021-08-30
3175021006,JAKARTA TIMUR,PULO GADUNG,KAYU PUTIH,40696,14271,26425,17217,43642,2021-08-30
3173031006,JAKARTA BARAT,TAMAN SARI,KEAGUNGAN,17387,6098,11289,6908,18197,2021-08-30
3174041007,JAKARTA SELATAN,PASAR MINGGU,KEBAGUSAN,44552,17170,27382,16173,43555,2021-08-30
3174051006,JAKARTA SELATAN,KEBAYORAN LAMA,KEBAYORAN LAMA SELATAN,41212,14849,26363,15452,41815,2021-08-30
3174051001,JAKARTA SELATAN,KEBAYORAN LAMA,KEBAYORAN LAMA UTARA,42422,16651,25771,13989,39760,2021-08-30
3174011004,JAKARTA SELATAN,TEBET,KEBON BARU,35165,13045,22120,13203,35323,2021-08-30
3172021005,JAKARTA UTARA,TANJUNG PRIOK,KEBON BAWANG,50952,18710,32242,19635,51877,2021-08-30
3173051001,JAKARTA BARAT,KEBON JERUK,KEBON JERUK,53887,21173,32714,18660,51374,2021-08-30
3171071006,JAKARTA PUSAT,TANAH ABANG,KEBON KACANG,21531,9430,12101,7006,19107,2021-08-30
3171011005,JAKARTA PUSAT,GAMBIR,KEBON KELAPA,10163,3634,6529,4052,10581,2021-08-30
3171031002,JAKARTA PUSAT,KEMAYORAN,KEBON KOSONG,30019,11304,18715,11242,29957,2021-08-30
3175011005,JAKARTA TIMUR,MATRAMAN,KEBON MANGGIS,16490,6016,10474,6310,16784,2021-08-30
3171071005,JAKARTA PUSAT,TANAH ABANG,KEBON MELATI,32206,14800,17406,9473,26879,2021-08-30
3175081003,JAKARTA TIMUR,MAKASAR,KEBON PALA,46614,17097,29517,16822,46339,2021-08-30
3171061005,JAKARTA PUSAT,MENTENG,KEBON SIRIH,12299,4747,7552,4456,12008,2021-08-30
3173011004,JAKARTA BARAT,CENGKARENG,KEDAUNG KALI ANGKE,32612,10862,21750,12482,34232,2021-08-30
3173051007,JAKARTA BARAT,KEBON JERUK,KEDOYA SELATAN,32165,11510,20655,12027,32682,2021-08-30
3173051006,JAKARTA BARAT,KEBON JERUK,KEDOYA UTARA,45740,15298,30442,19106,49548,2021-08-30
3173051004,JAKARTA BARAT,KEBON JERUK,KELAPA DUA,23565,8980,14585,8202,22787,2021-08-30
3175091003,JAKARTA TIMUR,CIRACAS,KELAPA DUA WETAN,46875,15683,31192,18396,49588,2021-08-30
3172061003,JAKARTA UTARA,KELAPA GADING,KELAPA GADING BARAT,35717,11496,24221,17561,41782,2021-08-30
3172061001,JAKARTA UTARA,KELAPA GADING,KELAPA GADING TIMUR,33592,9933,23659,16889,40548,2021-08-30
3173071005,JAKARTA BARAT,PALMERAH,KEMANGGISAN,32139,11888,20251,11835,32086,2021-08-30
3171031001,JAKARTA PUSAT,KEMAYORAN,KEMAYORAN,20708,7430,13278,8239,21517,2021-08-30
3173081006,JAKARTA BARAT,KEMBANGAN,KEMBANGAN SELATAN,27130,9927,17203,11337,28540,2021-08-30
3173081001,JAKARTA BARAT,KEMBANGAN,KEMBANGAN UTARA,54451,20079,34372,20198,54570,2021-08-30
3171041002,JAKARTA PUSAT,SENEN,KENARI,9579,3411,6168,3761,9929,2021-08-30
3173041005,JAKARTA BARAT,TAMBORA,KERENDANG,19973,7123,12850,7648,20498,2021-08-30
3175071003,JAKARTA TIMUR,DUREN SAWIT,KLENDER,69978,28967,41011,21723,62734,2021-08-30
3172031001,JAKARTA UTARA,KOJA,KOJA,28175,10831,17344,10499,27843,2021-08-30
3173071006,JAKARTA BARAT,PALMERAH,KOTA BAMBU SELATAN,21158,7928,13230,7234,20464,2021-08-30
3173071003,JAKARTA BARAT,PALMERAH,KOTA BAMBU UTARA,24995,9537,15458,8756,24214,2021-08-30
3171041004,JAKARTA PUSAT,SENEN,KRAMAT,28835,11117,17718,9306,27024,2021-08-30
3175041001,JAKARTA TIMUR,KRAMAT JATI,KRAMAT JATI,34144,12828,21316,11329,32645,2021-08-30
3174071003,JAKARTA SELATAN,KEBAYORAN BARU,KRAMAT PELA,14413,5049,9364,5887,15251,2021-08-30
3173031002,JAKARTA BARAT,TAMAN SARI,KRUKUT,19244,6857,12387,6971,19358,2021-08-30
3174031005,JAKARTA SELATAN,MAMPANG PRAPATAN,KUNINGAN BARAT,12785,4501,8284,5105,13389,2021-08-30
3174021008,JAKARTA SELATAN,SETIA BUDI,KUNINGAN TIMUR,6008,2165,3843,2516,6359,2021-08-30
3171041005,JAKARTA PUSAT,SENEN,KWITANG,15486,5704,9782,5654,15436,2021-08-30
3172031003,JAKARTA UTARA,KOJA,LAGOA,59065,23204,35861,20890,56751,2021-08-30
3174061002,JAKARTA SELATAN,CILANDAK,LEBAK BULUS,37626,14358,23268,14637,37905,2021-08-30
3174091004,JAKARTA SELATAN,JAGAKARSA,LENTENG AGUNG,53946,20649,33297,18691,51988,2021-08-30
3175101007,JAKARTA TIMUR,CIPAYUNG,LUBANG BUAYA,63547,21663,41884,25047,66931,2021-08-30
3175081001,JAKARTA TIMUR,MAKASAR,MAKASAR,34390,12224,22166,13316,35482,2021-08-30
3175071006,JAKARTA TIMUR,DUREN SAWIT,MALAKA JAYA,30927,11572,19355,12921,32276,2021-08-30
3175071005,JAKARTA TIMUR,DUREN SAWIT,MALAKA SARI,27530,9900,17630,11631,29261,2021-08-30
3174031001,JAKARTA SELATAN,MAMPANG PRAPATAN,MAMPANG PRAPATAN,18159,6711,11448,7199,18647,2021-08-30
3173031005,JAKARTA BARAT,TAMAN SARI,MANGGA BESAR,7707,2406,5301,3516,8817,2021-08-30
3171021005,JAKARTA PUSAT,SAWAH BESAR,MANGGA DUA SELATAN,27442,9802,17640,10928,28568,2021-08-30
3174011007,JAKARTA SELATAN,TEBET,MANGGARAI,28373,9701,18672,10606,29278,2021-08-30
3174011006,JAKARTA SELATAN,TEBET,MANGGARAI SELATAN,23075,8111,14964,9057,24021,2021-08-30
3173031003,JAKARTA BARAT,TAMAN SARI,MAPHAR,16461,5944,10517,6773,17290,2021-08-30
3172041003,JAKARTA UTARA,CILINCING,MARUNDA,28943,10259,18684,8849,27533,2021-08-30
3174071001,JAKARTA SELATAN,KEBAYORAN BARU,MELAWAI,2627,900,1727,1349,3076,2021-08-30
3171061001,JAKARTA PUSAT,MENTENG,MENTENG,25624,9943,15681,9197,24878,2021-08-30
3174021005,JAKARTA SELATAN,SETIA BUDI,MENTENG ATAS,27816,9617,18199,10914,29113,2021-08-30
3174011003,JAKARTA SELATAN,TEBET,MENTENG DALAM,36028,13286,22742,13756,36498,2021-08-30
3173081003,JAKARTA BARAT,KEMBANGAN,MERUYA SELATAN,32130,11927,20203,11704,31907,2021-08-30
3173081002,JAKARTA BARAT,KEMBANGAN,MERUYA UTARA,43752,16377,27375,17219,44594,2021-08-30
3175101004,JAKARTA TIMUR,CIPAYUNG,MUNJUL,23871,8186,15685,9532,25217,2021-08-30
3172051002,JAKARTA UTARA,PADEMANGAN,PADEMANGAN BARAT,74240,28369,45871,27030,72901,2021-08-30
3172051001,JAKARTA UTARA,PADEMANGAN,PADEMANGAN TIMUR,37736,12119,25617,17047,42664,2021-08-30
3175011004,JAKARTA TIMUR,MATRAMAN,PAL MERIAM,19769,7800,11969,6849,18818,2021-08-30
3173071001,JAKARTA BARAT,PALMERAH,PALMERAH,63011,23828,39183,22165,61348,2021-08-30
3174081001,JAKARTA SELATAN,PANCORAN,PANCORAN,19421,7264,12157,7283,19440,2021-08-30
3172021003,JAKARTA UTARA,TANJUNG PRIOK,PAPANGGO,39097,13435,25662,15386,41048,2021-08-30
3171021001,JAKARTA PUSAT,SAWAH BESAR,PASAR BARU,12035,3814,8221,5617,13838,2021-08-30
3174021006,JAKARTA SELATAN,SETIA BUDI,PASAR MANGGIS,26752,9870,16882,10186,27068,2021-08-30
3174041001,JAKARTA SELATAN,PASAR MINGGU,PASAR MINGGU,24821,9128,15693,10047,25740,2021-08-30
3171041003,JAKARTA PUSAT,SENEN,PASEBAN,23533,8915,14618,8539,23157,2021-08-30
3173061005,JAKARTA BARAT,KALI DERES,PEGADUNGAN,75587,26112,49475,29798,79273,2021-08-30
3171061002,JAKARTA PUSAT,MENTENG,PEGANGSAAN,23455,9012,14443,7874,22317,2021-08-30
3172061002,JAKARTA UTARA,KELAPA GADING,PEGANGSAAN DUA,49976,14749,35227,24015,59242,2021-08-30
3172011004,JAKARTA UTARA,PENJARINGAN,PEJAGALAN,74578,26970,47608,29912,77520,2021-08-30
3174041006,JAKARTA SELATAN,PASAR MINGGU,PEJATEN BARAT,37346,14125,23221,14483,37704,2021-08-30
3174041005,JAKARTA SELATAN,PASAR MINGGU,PEJATEN TIMUR,57656,22749,34907,19327,54234,2021-08-30
3175051005,JAKARTA TIMUR,PASAR REBO,PEKAYON,43250,14996,28254,17261,45515,2021-08-30
3173041009,JAKARTA BARAT,TAMBORA,PEKOJAN,23587,7968,15619,9742,25361,2021-08-30
3174031003,JAKARTA SELATAN,MAMPANG PRAPATAN,PELA MAMPANG,43522,15856,27666,17876,45542,2021-08-30
3174081005,JAKARTA SELATAN,PANCORAN,PENGADEGAN,21478,7237,14241,7716,21957,2021-08-30
3175061003,JAKARTA TIMUR,CAKUNG,PENGGILINGAN,99255,41166,58089,30758,88847,2021-08-30
3172011001,JAKARTA UTARA,PENJARINGAN,PENJARINGAN,88308,35476,52832,28760,81592,2021-08-30
3174101001,JAKARTA SELATAN,PESANGGRAHAN,PESANGGRAHAN,27545,9508,18037,11214,29251,2021-08-30
3171071004,JAKARTA PUSAT,TANAH ABANG,PETAMBURAN,33271,15348,17923,9311,27234,2021-08-30
3174071008,JAKARTA SELATAN,KEBAYORAN BARU,PETOGOGAN,11499,4300,7199,4651,11850,2021-08-30
3171011004,JAKARTA PUSAT,GAMBIR,PETOJO SELATAN,14692,5508,9184,5737,14921,2021-08-30
3171011003,JAKARTA PUSAT,GAMBIR,PETOJO UTARA,17458,6412,11046,6158,17204,2021-08-30
3174101004,JAKARTA SELATAN,PESANGGRAHAN,PETUKANGAN SELATAN,37187,13786,23401,13971,37372,2021-08-30
3174101003,JAKARTA SELATAN,PESANGGRAHAN,PETUKANGAN UTARA,53716,21158,32558,19538,52096,2021-08-30
3175081002,JAKARTA TIMUR,MAKASAR,PINANG RANTI,27198,10097,17101,10635,27736,2021-08-30
3173031008,JAKARTA BARAT,TAMAN SARI,PINANGSIA,10729,3470,7259,4568,11827,2021-08-30
3175011001,JAKARTA TIMUR,MATRAMAN,PISANGAN BARU,31776,12536,19240,10059,29299,2021-08-30
3175021002,JAKARTA TIMUR,PULO GADUNG,PISANGAN TIMUR,41011,14549,26462,15407,41869,2021-08-30
3172011005,JAKARTA UTARA,PENJARINGAN,PLUIT,47783,16204,31579,22038,53617,2021-08-30
3175071002,JAKARTA TIMUR,DUREN SAWIT,PONDOK BAMBU,61550,24527,37023,20897,57920,2021-08-30
3175071004,JAKARTA TIMUR,DUREN SAWIT,PONDOK KELAPA,72015,26832,45183,26217,71400,2021-08-30
3175071007,JAKARTA TIMUR,DUREN SAWIT,PONDOK KOPI,35367,15025,20342,11568,31910,2021-08-30
3174061003,JAKARTA SELATAN,CILANDAK,PONDOK LABU,46464,16193,30271,20085,50356,2021-08-30
3174051002,JAKARTA SELATAN,KEBAYORAN LAMA,PONDOK PINANG,56169,20990,35179,21862,57041,2021-08-30
3175101003,JAKARTA TIMUR,CIPAYUNG,PONDOK RANGGON,25574,9052,16522,9487,26009,2021-08-30
3101011003,KAB.ADM.KEP.SERIBU,KEP. SERIBU UTARA,PULAU HARAPAN,2060,343,1717,999,2716,2021-08-30
3101011002,KAB.ADM.KEP.SERIBU,KEP. SERIBU UTARA,PULAU KELAPA,5528,907,4621,2601,7222,2021-08-30
3101011001,KAB.ADM.KEP.SERIBU,KEP. SERIBU UTARA,PULAU PANGGANG,5450,875,4575,2097,6672,2021-08-30
3101021003,KAB.ADM.KEP.SERIBU,KEP. SERIBU SELATAN,PULAU PARI,2765,323,2442,1373,3815,2021-08-30
3101021002,KAB.ADM.KEP.SERIBU,KEP. SERIBU SELATAN,PULAU TIDUNG,4553,634,3919,2630,6549,2021-08-30
3101021001,KAB.ADM.KEP.SERIBU,KEP. SERIBU SELATAN,PULAU UNTUNG JAWA,1941,328,1613,889,2502,2021-08-30
3174071007,JAKARTA SELATAN,KEBAYORAN BARU,PULO,5835,1978,3857,2795,6652,2021-08-30
3175021001,JAKARTA TIMUR,PULO GADUNG,PULO GADUNG,34422,12941,21481,12380,33861,2021-08-30
3175061005,JAKARTA TIMUR,CAKUNG,PULO GEBANG,97301,37531,59770,33847,93617,2021-08-30
3174041004,JAKARTA SELATAN,PASAR MINGGU,RAGUNAN,39616,14018,25598,16135,41733,2021-08-30
3175091005,JAKARTA TIMUR,CIRACAS,RAMBUTAN,36771,15269,21502,12531,34033,2021-08-30
3172031006,JAKARTA UTARA,KOJA,RAWA BADAK SELATAN,42179,17035,25144,14327,39471,2021-08-30
3172031004,JAKARTA UTARA,KOJA,RAWA BADAK UTARA,34408,13488,20920,12136,33056,2021-08-30
3174071005,JAKARTA SELATAN,KEBAYORAN BARU,RAWA BARAT,5625,1898,3727,2538,6265,2021-08-30
3173011003,JAKARTA BARAT,CENGKARENG,RAWA BUAYA,63799,23835,39964,20991,60955,2021-08-30
3175031004,JAKARTA TIMUR,JATINEGARA,RAWA BUNGA,21434,8647,12787,7391,20178,2021-08-30
3174081003,JAKARTA SELATAN,PANCORAN,RAWA JATI,20509,7485,13024,7597,20621,2021-08-30
3175061002,JAKARTA TIMUR,CAKUNG,RAWA TERATE,24637,8359,16278,9500,25778,2021-08-30
3175021005,JAKARTA TIMUR,PULO GADUNG,RAWAMANGUN,37612,14136,23476,14550,38026,2021-08-30
3171051003,JAKARTA PUSAT,CEMPAKA PUTIH,RAWASARI,21967,8301,13666,8735,22401,2021-08-30
3173041010,JAKARTA BARAT,TAMBORA,ROA MALAKA,3484,1058,2426,1640,4066,2021-08-30
3172041006,JAKARTA UTARA,CILINCING,ROROTAN,41668,14417,27251,15014,42265,2021-08-30
3174071004,JAKARTA SELATAN,KEBAYORAN BARU,SELONG,2842,980,1862,1389,3251,2021-08-30
3173061002,JAKARTA BARAT,KALI DERES,SEMANAN,71354,27373,43981,22262,66243,2021-08-30
3172041007,JAKARTA UTARA,CILINCING,SEMPER BARAT,68587,23332,45255,27800,73055,2021-08-30
3172041005,JAKARTA UTARA,CILINCING,SEMPER TIMUR,36267,12882,23385,13324,36709,2021-08-30
3174071006,JAKARTA SELATAN,KEBAYORAN BARU,SENAYAN,2771,1128,1643,1080,2723,2021-08-30
3171041001,JAKARTA PUSAT,SENEN,SENEN,6804,2363,4441,2906,7347,2021-08-30
3171031004,JAKARTA PUSAT,KEMAYORAN,SERDANG,29668,11000,18668,10952,29620,2021-08-30
3174021001,JAKARTA SELATAN,SETIA BUDI,SETIA BUDI,3023,1125,1898,1262,3160,2021-08-30
3175101005,JAKARTA TIMUR,CIPAYUNG,SETU,20572,7852,12720,6948,19668,2021-08-30
3173071002,JAKARTA BARAT,PALMERAH,SLIPI,16591,5848,10743,6641,17384,2021-08-30
3173081004,JAKARTA BARAT,KEMBANGAN,SRENGSENG,45523,17560,27963,16556,44519,2021-08-30
3174091002,JAKARTA SELATAN,JAGAKARSA,SRENGSENG SAWAH,58196,18979,39217,24147,63364,2021-08-30
3173051003,JAKARTA BARAT,KEBON JERUK,SUKABUMI SELATAN,37033,14663,22370,11021,33391,2021-08-30
3173051002,JAKARTA BARAT,KEBON JERUK,SUKABUMI UTARA,38290,16031,22259,11317,33576,2021-08-30
3172041002,JAKARTA UTARA,CILINCING,SUKAPURA,53949,20357,33592,20312,53904,2021-08-30
3171031007,JAKARTA PUSAT,KEMAYORAN,SUMUR BATU,22717,8541,14176,8827,23003,2021-08-30
3172021004,JAKARTA UTARA,TANJUNG PRIOK,SUNGAI BAMBU,29876,10795,19081,11172,30253,2021-08-30
3172021006,JAKARTA UTARA,TANJUNG PRIOK,SUNTER AGUNG,71805,22768,49037,32751,81788,2021-08-30
3172021002,JAKARTA UTARA,TANJUNG PRIOK,SUNTER JAYA,63031,20762,42269,27845,70114,2021-08-30
3175091004,JAKARTA TIMUR,CIRACAS,SUSUKAN,38257,13005,25252,14595,39847,2021-08-30
3173031001,JAKARTA BARAT,TAMAN SARI,TAMAN SARI,14348,5119,9229,6203,15432,2021-08-30
3173041001,JAKARTA BARAT,TAMBORA,TAMBORA,10204,3782,6422,3577,9999,2021-08-30
3173041004,JAKARTA BARAT,TAMBORA,TANAH SEREAL,26387,8202,18185,10557,28742,2021-08-30
3171081004,JAKARTA PUSAT,JOHAR BARU,TANAH TINGGI,37693,11793,25900,14351,40251,2021-08-30
3173031004,JAKARTA BARAT,TAMAN SARI,TANGKI,13324,4686,8638,5645,14283,2021-08-30
3174091005,JAKARTA SELATAN,JAGAKARSA,TANJUNG BARAT,39770,14279,25491,14481,39972,2021-08-30
3173021005,JAKARTA BARAT,GROGOL PETAMBURAN,TANJUNG DUREN SELATAN,25337,9002,16335,10536,26871,2021-08-30
3173021002,JAKARTA BARAT,GROGOL PETAMBURAN,TANJUNG DUREN UTARA,17010,5738,11272,7177,18449,2021-08-30
3172021001,JAKARTA UTARA,TANJUNG PRIOK,TANJUNG PRIOK,34588,11847,22741,12919,35660,2021-08-30
3174011002,JAKARTA SELATAN,TEBET,TEBET BARAT,21194,7144,14050,9150,23200,2021-08-30
3174011001,JAKARTA SELATAN,TEBET,TEBET TIMUR,18199,6127,12072,7853,19925,2021-08-30
3173061003,JAKARTA BARAT,KALI DERES,TEGAL ALUR,83647,30562,53085,27161,80246,2021-08-30
3174031004,JAKARTA SELATAN,MAMPANG PRAPATAN,TEGAL PARANG,32401,12768,19633,11226,30859,2021-08-30
3173021003,JAKARTA BARAT,GROGOL PETAMBURAN,TOMANG,29605,10461,19144,12663,31807,2021-08-30
3172031005,JAKARTA UTARA,KOJA,TUGU SELATAN,39122,15287,23835,13610,37445,2021-08-30
3172031002,JAKARTA UTARA,KOJA,TUGU UTARA,67670,27015,40655,23735,64390,2021-08-30
3175061006,JAKARTA TIMUR,CAKUNG,UJUNG MENTENG,29934,10206,19728,11931,31659,2021-08-30
3174101005,JAKARTA SELATAN,PESANGGRAHAN,ULUJAMI,40544,16283,24261,13796,38057,2021-08-30
3175011006,JAKARTA TIMUR,MATRAMAN,UTAN KAYU SELATAN,33511,12063,21448,12483,33931,2021-08-30
3175011002,JAKARTA TIMUR,MATRAMAN,UTAN KAYU UTARA,28169,10997,17172,9704,26876,2021-08-30
3171031008,JAKARTA PUSAT,KEMAYORAN,UTAN PANJANG,29208,11198,18010,10321,28331,2021-08-30
3172021007,JAKARTA UTARA,TANJUNG PRIOK,WARAKAS,44401,15669,28732,16584,45316,2021-08-30
3173021007,JAKARTA BARAT,GROGOL PETAMBURAN,WIJAYA KUSUMA,38934,14599,24335,15301,39636,2021-08-30
3172051003,JAKARTA UTARA,PADEMANGAN,ANCOL,23947,9191,14756,8935,23691,2021-08-31
3173041007,JAKARTA BARAT,TAMBORA,ANGKE,29381,10400,18981,10470,29451,2021-08-31
3175041005,JAKARTA TIMUR,KRAMAT JATI,BALE KAMBANG,29074,12510,16564,7766,24330,2021-08-31
3175031003,JAKARTA TIMUR,JATINEGARA,BALI MESTER,9752,3704,6048,3671,9719,2021-08-31
3175101006,JAKARTA TIMUR,CIPAYUNG,BAMBU APUS,26285,9416,16869,10118,26987,2021-08-31
3174031002,JAKARTA SELATAN,MAMPANG PRAPATAN,BANGKA,21566,8345,13221,8177,21398,2021-08-31
3175051002,JAKARTA TIMUR,PASAR REBO,BARU,23886,7751,16135,11238,27373,2021-08-31
3175041004,JAKARTA TIMUR,KRAMAT JATI,BATU AMPAR,47898,19908,27990,15342,43332,2021-08-31
3171071002,JAKARTA PUSAT,TANAH ABANG,BENDUNGAN HILIR,21494,8033,13461,8671,22132,2021-08-31
3175031002,JAKARTA TIMUR,JATINEGARA,BIDARA CINA,36689,15563,21126,11822,32948,2021-08-31
3174101002,JAKARTA SELATAN,PESANGGRAHAN,BINTARO,53098,20075,33023,20805,53828,2021-08-31
3174011005,JAKARTA SELATAN,TEBET,BUKIT DURI,34183,13443,20740,11850,32590,2021-08-31
3171041006,JAKARTA PUSAT,SENEN,BUNGUR,18144,6524,11620,7159,18779,2021-08-31
3175061007,JAKARTA TIMUR,CAKUNG,CAKUNG BARAT,57724,19732,37992,22435,60427,2021-08-31
3175061004,JAKARTA TIMUR,CAKUNG,CAKUNG TIMUR,58287,20304,37983,24270,62253,2021-08-31
3175041007,JAKARTA TIMUR,KRAMAT JATI,CAWANG,32762,13055,19707,11291,30998,2021-08-31
3175101008,JAKARTA TIMUR,CIPAYUNG,CEGER,18932,6739,12193,7707,19900,2021-08-31
3171031006,JAKARTA PUSAT,KEMAYORAN,CEMPAKA BARU,32581,12183,20398,11808,32206,2021-08-31
3171051002,JAKARTA PUSAT,CEMPAKA PUTIH,CEMPAKA PUTIH BARAT,35885,13413,22472,15049,37521,2021-08-31
3171051001,JAKARTA PUSAT,CEMPAKA PUTIH,CEMPAKA PUTIH TIMUR,24292,8774,15518,10122,25640,2021-08-31
3173011001,JAKARTA BARAT,CENGKARENG,CENGKARENG BARAT,66284,23650,42634,26634,69268,2021-08-31
3173011006,JAKARTA BARAT,CENGKARENG,CENGKARENG TIMUR,81027,28255,52772,27820,80592,2021-08-31
3175091002,JAKARTA TIMUR,CIRACAS,CIBUBUR,66364,22468,43896,27979,71875,2021-08-31
3171011002,JAKARTA PUSAT,GAMBIR,CIDENG,15390,5212,10178,6651,16829,2021-08-31
3174091003,JAKARTA SELATAN,JAGAKARSA,CIGANJUR,38497,13961,24536,14581,39117,2021-08-31
3175051003,JAKARTA TIMUR,PASAR REBO,CIJANTUNG,41419,14083,27336,17240,44576,2021-08-31
3171061003,JAKARTA PUSAT,MENTENG,CIKINI,8274,3082,5192,3099,8291,2021-08-31
3174081006,JAKARTA SELATAN,PANCORAN,CIKOKO,10547,3645,6902,4027,10929,2021-08-31
3174061001,JAKARTA SELATAN,CILANDAK,CILANDAK BARAT,51752,18662,33090,20759,53849,2021-08-31
3174041003,JAKARTA SELATAN,PASAR MINGGU,CILANDAK TIMUR,25145,8957,16188,10782,26970,2021-08-31
3175101002,JAKARTA TIMUR,CIPAYUNG,CILANGKAP,27635,9632,18003,11031,29034,2021-08-31
3175041006,JAKARTA TIMUR,KRAMAT JATI,CILILITAN,40181,16387,23794,14145,37939,2021-08-31
3172041001,JAKARTA UTARA,CILINCING,CILINCING,43609,16783,26826,15176,42002,2021-08-31
3175101001,JAKARTA TIMUR,CIPAYUNG,CIPAYUNG,26104,8444,17660,11085,28745,2021-08-31
3174091006,JAKARTA SELATAN,JAGAKARSA,CIPEDAK,38303,12920,25383,15815,41198,2021-08-31
3174061005,JAKARTA SELATAN,CILANDAK,CIPETE SELATAN,26704,10087,16617,11172,27789,2021-08-31
3174071010,JAKARTA SELATAN,KEBAYORAN BARU,CIPETE UTARA,34102,12539,21563,13368,34931,2021-08-31
3175021003,JAKARTA TIMUR,PULO GADUNG,CIPINANG,39306,14732,24574,15018,39592,2021-08-31
3175031007,JAKARTA TIMUR,JATINEGARA,CIPINANG BESAR SELATAN,35212,14319,20893,11520,32413,2021-08-31
3175031008,JAKARTA TIMUR,JATINEGARA,CIPINANG BESAR UTARA,45319,18463,26856,14722,41578,2021-08-31
3175031005,JAKARTA TIMUR,JATINEGARA,CIPINANG CEMPEDAK,32824,13309,19515,12024,31539,2021-08-31
3175081005,JAKARTA TIMUR,MAKASAR,CIPINANG MELAYU,42308,16106,26202,16826,43028,2021-08-31
3175031006,JAKARTA TIMUR,JATINEGARA,CIPINANG MUARA,55243,22366,32877,19063,51940,2021-08-31
3174051003,JAKARTA SELATAN,KEBAYORAN LAMA,CIPULIR,39937,16076,23861,13052,36913,2021-08-31
3175091001,JAKARTA TIMUR,CIRACAS,CIRACAS,64594,21788,42806,25430,68236,2021-08-31
3175041003,JAKARTA TIMUR,KRAMAT JATI,DUKUH,24609,8670,15939,9354,25293,2021-08-31
3175071001,JAKARTA TIMUR,DUREN SAWIT,DUREN SAWIT,61160,24495,36665,21758,58423,2021-08-31
3174081004,JAKARTA SELATAN,PANCORAN,DUREN TIGA,28319,10557,17762,9571,27333,2021-08-31
3173051005,JAKARTA BARAT,KEBON JERUK,DURI KEPA,60138,20835,39303,25156,64459,2021-08-31
3173011002,JAKARTA BARAT,CENGKARENG,DURI KOSAMBI,77923,30638,47285,25926,73211,2021-08-31
3171011006,JAKARTA PUSAT,GAMBIR,DURI PULO,19610,7018,12592,7472,20064,2021-08-31
3173041011,JAKARTA BARAT,TAMBORA,DURI SELATAN,14259,4665,9594,6100,15694,2021-08-31
3173041003,JAKARTA BARAT,TAMBORA,DURI UTARA,19844,6788,13056,7936,20992,2021-08-31
3171081003,JAKARTA PUSAT,JOHAR BARU,GALUR,18243,5727,12516,7305,19821,2021-08-31
3171011001,JAKARTA PUSAT,GAMBIR,GAMBIR,2191,741,1450,932,2382,2021-08-31
3174061004,JAKARTA SELATAN,CILANDAK,GANDARIA SELATAN,22119,8266,13853,8341,22194,2021-08-31
3174071009,JAKARTA SELATAN,KEBAYORAN BARU,GANDARIA UTARA,39922,15043,24879,15401,40280,2021-08-31
3175051001,JAKARTA TIMUR,PASAR REBO,GEDONG,35755,12710,23045,14301,37346,2021-08-31
3171071001,JAKARTA PUSAT,TANAH ABANG,GELORA,3127,1204,1923,1212,3135,2021-08-31
3173031007,JAKARTA BARAT,TAMAN SARI,GLODOK,7837,2386,5451,3849,9300,2021-08-31
3171061004,JAKARTA PUSAT,MENTENG,GONDANGDIA,4100,1504,2596,1964,4560,2021-08-31
3173021001,JAKARTA BARAT,GROGOL PETAMBURAN,GROGOL,16876,6120,10756,6772,17528,2021-08-31
3174051005,JAKARTA SELATAN,KEBAYORAN LAMA,GROGOL SELATAN,44251,17048,27203,15561,42764,2021-08-31
3174051004,JAKARTA SELATAN,KEBAYORAN LAMA,GROGOL UTARA,42494,16173,26321,15110,41431,2021-08-31
3174021007,JAKARTA SELATAN,SETIA BUDI,GUNTUR,3985,1397,2588,1832,4420,2021-08-31
3174071002,JAKARTA SELATAN,KEBAYORAN BARU,GUNUNG,9436,3357,6079,4219,10298,2021-08-31
3171031005,JAKARTA PUSAT,KEMAYORAN,GUNUNG SAHARI SELATAN,19199,7062,12137,7836,19973,2021-08-31
3171021004,JAKARTA PUSAT,SAWAH BESAR,GUNUNG SAHARI UTARA,16650,5276,11374,7814,19188,2021-08-31
3175081004,JAKARTA TIMUR,MAKASAR,HALIM PERDANA KUSUMAH,28363,7952,20411,15735,36146,2021-08-31
3171031003,JAKARTA PUSAT,KEMAYORAN,HARAPAN MULIA,22557,8243,14314,8776,23090,2021-08-31
3174091001,JAKARTA SELATAN,JAGAKARSA,JAGAKARSA,62389,21894,40495,25850,66345,2021-08-31
3175021007,JAKARTA TIMUR,PULO GADUNG,JATI,32757,12044,20713,12800,33513,2021-08-31
3174041002,JAKARTA SELATAN,PASAR MINGGU,JATI PADANG,37502,13871,23631,14894,38525,2021-08-31
3173071004,JAKARTA BARAT,PALMERAH,JATI PULO,28738,9962,18776,10852,29628,2021-08-31
3175061001,JAKARTA TIMUR,CAKUNG,JATINEGARA,84160,31977,52183,31512,83695,2021-08-31
3175021004,JAKARTA TIMUR,PULO GADUNG,JATINEGARA KAUM,24632,8456,16176,8858,25034,2021-08-31
3173021004,JAKARTA BARAT,GROGOL PETAMBURAN,JELAMBAR,30266,10836,19430,13060,32490,2021-08-31
3173021006,JAKARTA BARAT,GROGOL PETAMBURAN,JELAMBAR BARU,38246,13767,24479,16010,40489,2021-08-31
3173041006,JAKARTA BARAT,TAMBORA,JEMBATAN BESI,29314,12179,17135,8968,26103,2021-08-31
3173041008,JAKARTA BARAT,TAMBORA,JEMBATAN LIMA,21021,8175,12846,7133,19979,2021-08-31
3173081005,JAKARTA BARAT,KEMBANGAN,JOGLO,40839,15302,25537,15084,40621,2021-08-31
3171081001,JAKARTA PUSAT,JOHAR BARU,JOHAR BARU,37488,12212,25276,15906,41182,2021-08-31
3173041002,JAKARTA BARAT,TAMBORA,KALI ANYAR,23856,8162,15694,8446,24140,2021-08-31
3172041004,JAKARTA UTARA,CILINCING,KALIBARU,67684,27684,40000,21523,61523,2021-08-31
3174081002,JAKARTA SELATAN,PANCORAN,KALIBATA,41994,17459,24535,13137,37672,2021-08-31
3173061001,JAKARTA BARAT,KALI DERES,KALIDERES,72447,26884,45563,29085,74648,2021-08-31
3175051004,JAKARTA TIMUR,PASAR REBO,KALISARI,43212,15002,28210,18078,46288,2021-08-31
3173061004,JAKARTA BARAT,KALI DERES,KAMAL,53783,20367,33416,17454,50870,2021-08-31
3172011002,JAKARTA UTARA,PENJARINGAN,KAMAL MUARA,12930,3493,9437,6645,16082,2021-08-31
3171071007,JAKARTA PUSAT,TANAH ABANG,KAMPUNG BALI,11358,4542,6816,3952,10768,2021-08-31
3175031001,JAKARTA TIMUR,JATINEGARA,KAMPUNG MELAYU,25717,10604,15113,8386,23499,2021-08-31
3171081002,JAKARTA PUSAT,JOHAR BARU,KAMPUNG RAWA,21237,5816,15421,8905,24326,2021-08-31
3175041002,JAKARTA TIMUR,KRAMAT JATI,KAMPUNG TENGAH,43993,18170,25823,13667,39490,2021-08-31
3173011005,JAKARTA BARAT,CENGKARENG,KAPUK,134466,52609,81857,42273,124130,2021-08-31
3172011003,JAKARTA UTARA,PENJARINGAN,KAPUK MUARA,35781,11374,24407,17393,41800,2021-08-31
3171021002,JAKARTA PUSAT,SAWAH BESAR,KARANG ANYAR,25761,8743,17018,10492,27510,2021-08-31
3174021004,JAKARTA SELATAN,SETIA BUDI,KARET,9623,3644,5979,3880,9859,2021-08-31
3174021003,JAKARTA SELATAN,SETIA BUDI,KARET KUNINGAN,16055,5391,10664,6859,17523,2021-08-31
3174021002,JAKARTA SELATAN,SETIA BUDI,KARET SEMANGGI,2770,958,1812,1340,3152,2021-08-31
3171071003,JAKARTA PUSAT,TANAH ABANG,KARET TENGSIN,19271,7088,12183,7504,19687,2021-08-31
3171021003,JAKARTA PUSAT,SAWAH BESAR,KARTINI,22292,7849,14443,9430,23873,2021-08-31
3175011003,JAKARTA TIMUR,MATRAMAN,KAYU MANIS,25284,10061,15223,8410,23633,2021-08-31
3175021006,JAKARTA TIMUR,PULO GADUNG,KAYU PUTIH,40696,14169,26527,17614,44141,2021-08-31
3173031006,JAKARTA BARAT,TAMAN SARI,KEAGUNGAN,17387,6054,11333,7093,18426,2021-08-31
3174041007,JAKARTA SELATAN,PASAR MINGGU,KEBAGUSAN,44552,17152,27400,16224,43624,2021-08-31
3174051006,JAKARTA SELATAN,KEBAYORAN LAMA,KEBAYORAN LAMA SELATAN,41212,14835,26377,15508,41885,2021-08-31
3174051001,JAKARTA SELATAN,KEBAYORAN LAMA,KEBAYORAN LAMA UTARA,42422,16640,25782,14056,39838,2021-08-31
3174011004,JAKARTA SELATAN,TEBET,KEBON BARU,35165,13027,22138,13259,35397,2021-08-31
3172021005,JAKARTA UTARA,TANJUNG PRIOK,KEBON BAWANG,50952,18570,32382,20087,52469,2021-08-31
3173051001,JAKARTA BARAT,KEBON JERUK,KEBON JERUK,53887,20917,32970,19294,52264,2021-08-31
3171071006,JAKARTA PUSAT,TANAH ABANG,KEBON KACANG,21531,9242,12289,7239,19528,2021-08-31
3171011005,JAKARTA PUSAT,GAMBIR,KEBON KELAPA,10163,3619,6544,4114,10658,2021-08-31
3171031002,JAKARTA PUSAT,KEMAYORAN,KEBON KOSONG,30019,10986,19033,11569,30602,2021-08-31
3175011005,JAKARTA TIMUR,MATRAMAN,KEBON MANGGIS,16490,5987,10503,6553,17056,2021-08-31
3171071005,JAKARTA PUSAT,TANAH ABANG,KEBON MELATI,32206,14522,17684,10000,27684,2021-08-31
3175081003,JAKARTA TIMUR,MAKASAR,KEBON PALA,46614,17012,29602,17132,46734,2021-08-31
3171061005,JAKARTA PUSAT,MENTENG,KEBON SIRIH,12299,4674,7625,4635,12260,2021-08-31
3173011004,JAKARTA BARAT,CENGKARENG,KEDAUNG KALI ANGKE,32612,10733,21879,13669,35548,2021-08-31
3173051007,JAKARTA BARAT,KEBON JERUK,KEDOYA SELATAN,32165,11346,20819,12404,33223,2021-08-31
3173051006,JAKARTA BARAT,KEBON JERUK,KEDOYA UTARA,45740,15115,30625,20006,50631,2021-08-31
3173051004,JAKARTA BARAT,KEBON JERUK,KELAPA DUA,23565,8903,14662,8390,23052,2021-08-31
3175091003,JAKARTA TIMUR,CIRACAS,KELAPA DUA WETAN,46875,15514,31361,18892,50253,2021-08-31
3172061003,JAKARTA UTARA,KELAPA GADING,KELAPA GADING BARAT,35717,11426,24291,17797,42088,2021-08-31
3172061001,JAKARTA UTARA,KELAPA GADING,KELAPA GADING TIMUR,33592,9884,23708,17120,40828,2021-08-31
3173071005,JAKARTA BARAT,PALMERAH,KEMANGGISAN,32139,11756,20383,12162,32545,2021-08-31
3171031001,JAKARTA PUSAT,KEMAYORAN,KEMAYORAN,20708,7355,13353,8469,21822,2021-08-31
3173081006,JAKARTA BARAT,KEMBANGAN,KEMBANGAN SELATAN,27130,9866,17264,11502,28766,2021-08-31
3173081001,JAKARTA BARAT,KEMBANGAN,KEMBANGAN UTARA,54451,19930,34521,20982,55503,2021-08-31
3171041002,JAKARTA PUSAT,SENEN,KENARI,9579,3373,6206,3930,10136,2021-08-31
3173041005,JAKARTA BARAT,TAMBORA,KERENDANG,19973,7071,12902,7847,20749,2021-08-31
3175071003,JAKARTA TIMUR,DUREN SAWIT,KLENDER,69978,28674,41304,22399,63703,2021-08-31
3172031001,JAKARTA UTARA,KOJA,KOJA,28175,10750,17425,10728,28153,2021-08-31
3173071006,JAKARTA BARAT,PALMERAH,KOTA BAMBU SELATAN,21158,7838,13320,7499,20819,2021-08-31
3173071003,JAKARTA BARAT,PALMERAH,KOTA BAMBU UTARA,24995,9441,15554,8998,24552,2021-08-31
3171041004,JAKARTA PUSAT,SENEN,KRAMAT,28835,11040,17795,9673,27468,2021-08-31
3175041001,JAKARTA TIMUR,KRAMAT JATI,KRAMAT JATI,34144,12733,21411,11792,33203,2021-08-31
3174071003,JAKARTA SELATAN,KEBAYORAN BARU,KRAMAT PELA,14413,5036,9377,5919,15296,2021-08-31
3173031002,JAKARTA BARAT,TAMAN SARI,KRUKUT,19244,6784,12460,7344,19804,2021-08-31
3174031005,JAKARTA SELATAN,MAMPANG PRAPATAN,KUNINGAN BARAT,12785,4499,8286,5117,13403,2021-08-31
3174021008,JAKARTA SELATAN,SETIA BUDI,KUNINGAN TIMUR,6008,2162,3846,2521,6367,2021-08-31
3171041005,JAKARTA PUSAT,SENEN,KWITANG,15486,5659,9827,5928,15755,2021-08-31
3172031003,JAKARTA UTARA,KOJA,LAGOA,59065,22987,36078,21385,57463,2021-08-31
3174061002,JAKARTA SELATAN,CILANDAK,LEBAK BULUS,37626,14344,23282,14686,37968,2021-08-31
3174091004,JAKARTA SELATAN,JAGAKARSA,LENTENG AGUNG,53946,20618,33328,18781,52109,2021-08-31
3175101007,JAKARTA TIMUR,CIPAYUNG,LUBANG BUAYA,63547,21543,42004,25472,67476,2021-08-31
3175081001,JAKARTA TIMUR,MAKASAR,MAKASAR,34390,12148,22242,13643,35885,2021-08-31
3175071006,JAKARTA TIMUR,DUREN SAWIT,MALAKA JAYA,30927,11486,19441,13178,32619,2021-08-31
3175071005,JAKARTA TIMUR,DUREN SAWIT,MALAKA SARI,27530,9846,17684,11796,29480,2021-08-31
3174031001,JAKARTA SELATAN,MAMPANG PRAPATAN,MAMPANG PRAPATAN,18159,6704,11455,7225,18680,2021-08-31
3173031005,JAKARTA BARAT,TAMAN SARI,MANGGA BESAR,7707,2396,5311,3569,8880,2021-08-31
3171021005,JAKARTA PUSAT,SAWAH BESAR,MANGGA DUA SELATAN,27442,9672,17770,11210,28980,2021-08-31
3174011007,JAKARTA SELATAN,TEBET,MANGGARAI,28373,9673,18700,10669,29369,2021-08-31
3174011006,JAKARTA SELATAN,TEBET,MANGGARAI SELATAN,23075,8092,14983,9114,24097,2021-08-31
3173031003,JAKARTA BARAT,TAMAN SARI,MAPHAR,16461,5905,10556,6890,17446,2021-08-31
3172041003,JAKARTA UTARA,CILINCING,MARUNDA,28943,10155,18788,9086,27874,2021-08-31
3174071001,JAKARTA SELATAN,KEBAYORAN BARU,MELAWAI,2627,898,1729,1356,3085,2021-08-31
3171061001,JAKARTA PUSAT,MENTENG,MENTENG,25624,9875,15749,9440,25189,2021-08-31
3174021005,JAKARTA SELATAN,SETIA BUDI,MENTENG ATAS,27816,9596,18220,10971,29191,2021-08-31
3174011003,JAKARTA SELATAN,TEBET,MENTENG DALAM,36028,13258,22770,13824,36594,2021-08-31
3173081003,JAKARTA BARAT,KEMBANGAN,MERUYA SELATAN,32130,11853,20277,12133,32410,2021-08-31
3173081002,JAKARTA BARAT,KEMBANGAN,MERUYA UTARA,43752,16314,27438,17500,44938,2021-08-31
3175101004,JAKARTA TIMUR,CIPAYUNG,MUNJUL,23871,8144,15727,9881,25608,2021-08-31
3172051002,JAKARTA UTARA,PADEMANGAN,PADEMANGAN BARAT,74240,28197,46043,27748,73791,2021-08-31
3172051001,JAKARTA UTARA,PADEMANGAN,PADEMANGAN TIMUR,37736,11937,25799,17404,43203,2021-08-31
3175011004,JAKARTA TIMUR,MATRAMAN,PAL MERIAM,19769,7758,12011,7038,19049,2021-08-31
3173071001,JAKARTA BARAT,PALMERAH,PALMERAH,63011,23599,39412,22908,62320,2021-08-31
3174081001,JAKARTA SELATAN,PANCORAN,PANCORAN,19421,7259,12162,7317,19479,2021-08-31
3172021003,JAKARTA UTARA,TANJUNG PRIOK,PAPANGGO,39097,13249,25848,15880,41728,2021-08-31
3171021001,JAKARTA PUSAT,SAWAH BESAR,PASAR BARU,12035,3803,8232,5696,13928,2021-08-31
3174021006,JAKARTA SELATAN,SETIA BUDI,PASAR MANGGIS,26752,9850,16902,10245,27147,2021-08-31
3174041001,JAKARTA SELATAN,PASAR MINGGU,PASAR MINGGU,24821,9119,15702,10076,25778,2021-08-31
3171041003,JAKARTA PUSAT,SENEN,PASEBAN,23533,8806,14727,8880,23607,2021-08-31
3173061005,JAKARTA BARAT,KALI DERES,PEGADUNGAN,75587,25959,49628,31047,80675,2021-08-31
3171061002,JAKARTA PUSAT,MENTENG,PEGANGSAAN,23455,8948,14507,8077,22584,2021-08-31
3172061002,JAKARTA UTARA,KELAPA GADING,PEGANGSAAN DUA,49976,14573,35403,24694,60097,2021-08-31
3172011004,JAKARTA UTARA,PENJARINGAN,PEJAGALAN,74578,26809,47769,30506,78275,2021-08-31
3174041006,JAKARTA SELATAN,PASAR MINGGU,PEJATEN BARAT,37346,14102,23244,14535,37779,2021-08-31
3174041005,JAKARTA SELATAN,PASAR MINGGU,PEJATEN TIMUR,57656,22697,34959,19519,54478,2021-08-31
3175051005,JAKARTA TIMUR,PASAR REBO,PEKAYON,43250,14883,28367,17777,46144,2021-08-31
3173041009,JAKARTA BARAT,TAMBORA,PEKOJAN,23587,7914,15673,10009,25682,2021-08-31
3174031003,JAKARTA SELATAN,MAMPANG PRAPATAN,PELA MAMPANG,43522,15841,27681,17928,45609,2021-08-31
3174081005,JAKARTA SELATAN,PANCORAN,PENGADEGAN,21478,7227,14251,7747,21998,2021-08-31
3175061003,JAKARTA TIMUR,CAKUNG,PENGGILINGAN,99255,40802,58453,31838,90291,2021-08-31
3172011001,JAKARTA UTARA,PENJARINGAN,PENJARINGAN,88308,35104,53204,29742,82946,2021-08-31
3174101001,JAKARTA SELATAN,PESANGGRAHAN,PESANGGRAHAN,27545,9505,18040,11247,29287,2021-08-31
3171071004,JAKARTA PUSAT,TANAH ABANG,PETAMBURAN,33271,15117,18154,9742,27896,2021-08-31
3174071008,JAKARTA SELATAN,KEBAYORAN BARU,PETOGOGAN,11499,4293,7206,4666,11872,2021-08-31
3171011004,JAKARTA PUSAT,GAMBIR,PETOJO SELATAN,14692,5480,9212,5845,15057,2021-08-31
3171011003,JAKARTA PUSAT,GAMBIR,PETOJO UTARA,17458,6387,11071,6370,17441,2021-08-31
3174101004,JAKARTA SELATAN,PESANGGRAHAN,PETUKANGAN SELATAN,37187,13781,23406,14009,37415,2021-08-31
3174101003,JAKARTA SELATAN,PESANGGRAHAN,PETUKANGAN UTARA,53716,21137,32579,19632,52211,2021-08-31
3175081002,JAKARTA TIMUR,MAKASAR,PINANG RANTI,27198,10020,17178,10828,28006,2021-08-31
3173031008,JAKARTA BARAT,TAMAN SARI,PINANGSIA,10729,3453,7276,4641,11917,2021-08-31
3175011001,JAKARTA TIMUR,MATRAMAN,PISANGAN BARU,31776,12392,19384,10443,29827,2021-08-31
3175021002,JAKARTA TIMUR,PULO GADUNG,PISANGAN TIMUR,41011,14469,26542,15857,42399,2021-08-31
3172011005,JAKARTA UTARA,PENJARINGAN,PLUIT,47783,15977,31806,22446,54252,2021-08-31
3175071002,JAKARTA TIMUR,DUREN SAWIT,PONDOK BAMBU,61550,24368,37182,21476,58658,2021-08-31
3175071004,JAKARTA TIMUR,DUREN SAWIT,PONDOK KELAPA,72015,26717,45298,26732,72030,2021-08-31
3175071007,JAKARTA TIMUR,DUREN SAWIT,PONDOK KOPI,35367,14931,20436,11834,32270,2021-08-31
3174061003,JAKARTA SELATAN,CILANDAK,PONDOK LABU,46464,16185,30279,20128,50407,2021-08-31
3174051002,JAKARTA SELATAN,KEBAYORAN LAMA,PONDOK PINANG,56169,20981,35188,21924,57112,2021-08-31
3175101003,JAKARTA TIMUR,CIPAYUNG,PONDOK RANGGON,25574,8979,16595,9745,26340,2021-08-31
3101011003,KAB.ADM.KEP.SERIBU,KEP. SERIBU UTARA,PULAU HARAPAN,2060,341,1719,1002,2721,2021-08-31
3101011002,KAB.ADM.KEP.SERIBU,KEP. SERIBU UTARA,PULAU KELAPA,5528,903,4625,2614,7239,2021-08-31
3101011001,KAB.ADM.KEP.SERIBU,KEP. SERIBU UTARA,PULAU PANGGANG,5450,864,4586,2114,6700,2021-08-31
3101021003,KAB.ADM.KEP.SERIBU,KEP. SERIBU SELATAN,PULAU PARI,2765,322,2443,1392,3835,2021-08-31
3101021002,KAB.ADM.KEP.SERIBU,KEP. SERIBU SELATAN,PULAU TIDUNG,4553,633,3920,2638,6558,2021-08-31
3101021001,KAB.ADM.KEP.SERIBU,KEP. SERIBU SELATAN,PULAU UNTUNG JAWA,1941,325,1616,933,2549,2021-08-31
3174071007,JAKARTA SELATAN,KEBAYORAN BARU,PULO,5835,1973,3862,2801,6663,2021-08-31
3175021001,JAKARTA TIMUR,PULO GADUNG,PULO GADUNG,34422,12847,21575,12697,34272,2021-08-31
3175061005,JAKARTA TIMUR,CAKUNG,PULO GEBANG,97301,37104,60197,34847,95044,2021-08-31
3174041004,JAKARTA SELATAN,PASAR MINGGU,RAGUNAN,39616,14001,25615,16185,41800,2021-08-31
3175091005,JAKARTA TIMUR,CIRACAS,RAMBUTAN,36771,15063,21708,12816,34524,2021-08-31
3172031006,JAKARTA UTARA,KOJA,RAWA BADAK SELATAN,42179,16714,25465,14573,40038,2021-08-31
3172031004,JAKARTA UTARA,KOJA,RAWA BADAK UTARA,34408,13339,21069,12415,33484,2021-08-31
3174071005,JAKARTA SELATAN,KEBAYORAN BARU,RAWA BARAT,5625,1896,3729,2553,6282,2021-08-31
3173011003,JAKARTA BARAT,CENGKARENG,RAWA BUAYA,63799,23591,40208,21731,61939,2021-08-31
3175031004,JAKARTA TIMUR,JATINEGARA,RAWA BUNGA,21434,8595,12839,7581,20420,2021-08-31
3174081003,JAKARTA SELATAN,PANCORAN,RAWA JATI,20509,7456,13053,7630,20683,2021-08-31
3175061002,JAKARTA TIMUR,CAKUNG,RAWA TERATE,24637,8301,16336,10003,26339,2021-08-31
3175021005,JAKARTA TIMUR,PULO GADUNG,RAWAMANGUN,37612,14004,23608,14935,38543,2021-08-31
3171051003,JAKARTA PUSAT,CEMPAKA PUTIH,RAWASARI,21967,8229,13738,9016,22754,2021-08-31
3173041010,JAKARTA BARAT,TAMBORA,ROA MALAKA,3484,1053,2431,1664,4095,2021-08-31
3172041006,JAKARTA UTARA,CILINCING,ROROTAN,41668,14283,27385,15535,42920,2021-08-31
3174071004,JAKARTA SELATAN,KEBAYORAN BARU,SELONG,2842,980,1862,1394,3256,2021-08-31
3173061002,JAKARTA BARAT,KALI DERES,SEMANAN,71354,27239,44115,23238,67353,2021-08-31
3172041007,JAKARTA UTARA,CILINCING,SEMPER BARAT,68587,23133,45454,28472,73926,2021-08-31
3172041005,JAKARTA UTARA,CILINCING,SEMPER TIMUR,36267,12807,23460,13527,36987,2021-08-31
3174071006,JAKARTA SELATAN,KEBAYORAN BARU,SENAYAN,2771,1127,1644,1083,2727,2021-08-31
3171041001,JAKARTA PUSAT,SENEN,SENEN,6804,2354,4450,2956,7406,2021-08-31
3171031004,JAKARTA PUSAT,KEMAYORAN,SERDANG,29668,10879,18789,11253,30042,2021-08-31
3174021001,JAKARTA SELATAN,SETIA BUDI,SETIA BUDI,3023,1123,1900,1268,3168,2021-08-31
3175101005,JAKARTA TIMUR,CIPAYUNG,SETU,20572,7794,12778,7175,19953,2021-08-31
3173071002,JAKARTA BARAT,PALMERAH,SLIPI,16591,5777,10814,6799,17613,2021-08-31
3173081004,JAKARTA BARAT,KEMBANGAN,SRENGSENG,45523,17444,28079,16941,45020,2021-08-31
3174091002,JAKARTA SELATAN,JAGAKARSA,SRENGSENG SAWAH,58196,18960,39236,24215,63451,2021-08-31
3173051003,JAKARTA BARAT,KEBON JERUK,SUKABUMI SELATAN,37033,14553,22480,11174,33654,2021-08-31
3173051002,JAKARTA BARAT,KEBON JERUK,SUKABUMI UTARA,38290,15801,22489,11553,34042,2021-08-31
3172041002,JAKARTA UTARA,CILINCING,SUKAPURA,53949,20172,33777,20956,54733,2021-08-31
3171031007,JAKARTA PUSAT,KEMAYORAN,SUMUR BATU,22717,8430,14287,9093,23380,2021-08-31
3172021004,JAKARTA UTARA,TANJUNG PRIOK,SUNGAI BAMBU,29876,10712,19164,11428,30592,2021-08-31
3172021006,JAKARTA UTARA,TANJUNG PRIOK,SUNTER AGUNG,71805,22588,49217,33575,82792,2021-08-31
3172021002,JAKARTA UTARA,TANJUNG PRIOK,SUNTER JAYA,63031,20520,42511,28541,71052,2021-08-31
3175091004,JAKARTA TIMUR,CIRACAS,SUSUKAN,38257,12927,25330,14970,40300,2021-08-31
3173031001,JAKARTA BARAT,TAMAN SARI,TAMAN SARI,14348,5077,9271,6351,15622,2021-08-31
3173041001,JAKARTA BARAT,TAMBORA,TAMBORA,10204,3758,6446,3652,10098,2021-08-31
3173041004,JAKARTA BARAT,TAMBORA,TANAH SEREAL,26387,8022,18365,11592,29957,2021-08-31
3171081004,JAKARTA PUSAT,JOHAR BARU,TANAH TINGGI,37693,11703,25990,14837,40827,2021-08-31
3173031004,JAKARTA BARAT,TAMAN SARI,TANGKI,13324,4627,8697,5744,14441,2021-08-31
3174091005,JAKARTA SELATAN,JAGAKARSA,TANJUNG BARAT,39770,14240,25530,14630,40160,2021-08-31
3173021005,JAKARTA BARAT,GROGOL PETAMBURAN,TANJUNG DUREN SELATAN,25337,8952,16385,10778,27163,2021-08-31
3173021002,JAKARTA BARAT,GROGOL PETAMBURAN,TANJUNG DUREN UTARA,17010,5703,11307,7322,18629,2021-08-31
3172021001,JAKARTA UTARA,TANJUNG PRIOK,TANJUNG PRIOK,34588,11749,22839,13301,36140,2021-08-31
3174011002,JAKARTA SELATAN,TEBET,TEBET BARAT,21194,7132,14062,9199,23261,2021-08-31
3174011001,JAKARTA SELATAN,TEBET,TEBET TIMUR,18199,6117,12082,7875,19957,2021-08-31
3173061003,JAKARTA BARAT,KALI DERES,TEGAL ALUR,83647,30359,53288,28058,81346,2021-08-31
3174031004,JAKARTA SELATAN,MAMPANG PRAPATAN,TEGAL PARANG,32401,12751,19650,11260,30910,2021-08-31
3173021003,JAKARTA BARAT,GROGOL PETAMBURAN,TOMANG,29605,10369,19236,12926,32162,2021-08-31
3172031005,JAKARTA UTARA,KOJA,TUGU SELATAN,39122,15068,24054,14063,38117,2021-08-31
3172031002,JAKARTA UTARA,KOJA,TUGU UTARA,67670,26646,41024,24349,65373,2021-08-31
3175061006,JAKARTA TIMUR,CAKUNG,UJUNG MENTENG,29934,10120,19814,12327,32141,2021-08-31
3174101005,JAKARTA SELATAN,PESANGGRAHAN,ULUJAMI,40544,16269,24275,13856,38131,2021-08-31
3175011006,JAKARTA TIMUR,MATRAMAN,UTAN KAYU SELATAN,33511,11938,21573,12791,34364,2021-08-31
3175011002,JAKARTA TIMUR,MATRAMAN,UTAN KAYU UTARA,28169,10914,17255,9907,27162,2021-08-31
3171031008,JAKARTA PUSAT,KEMAYORAN,UTAN PANJANG,29208,11087,18121,10834,28955,2021-08-31
3172021007,JAKARTA UTARA,TANJUNG PRIOK,WARAKAS,44401,15389,29012,17116,46128,2021-08-31
3173021007,JAKARTA BARAT,GROGOL PETAMBURAN,WIJAYA KUSUMA,38934,14489,24445,15658,40103,2021-08-31
3172051003,JAKARTA UTARA,PADEMANGAN,ANCOL,23947,9138,14809,9230,24039,2021-09-01
3173041007,JAKARTA BARAT,TAMBORA,ANGKE,29381,10347,19034,10733,29767,2021-09-01
3175041005,JAKARTA TIMUR,KRAMAT JATI,BALE KAMBANG,29074,12455,16619,7968,24587,2021-09-01
3175031003,JAKARTA TIMUR,JATINEGARA,BALI MESTER,9752,3689,6063,3777,9840,2021-09-01
3175101006,JAKARTA TIMUR,CIPAYUNG,BAMBU APUS,26285,9350,16935,10591,27526,2021-09-01
3174031002,JAKARTA SELATAN,MAMPANG PRAPATAN,BANGKA,21566,8338,13228,8196,21424,2021-09-01
3175051002,JAKARTA TIMUR,PASAR REBO,BARU,23886,7676,16210,11491,27701,2021-09-01
3175041004,JAKARTA TIMUR,KRAMAT JATI,BATU AMPAR,47898,19816,28082,15664,43746,2021-09-01
3171071002,JAKARTA PUSAT,TANAH ABANG,BENDUNGAN HILIR,21494,8012,13482,8777,22259,2021-09-01
3175031002,JAKARTA TIMUR,JATINEGARA,BIDARA CINA,36689,15458,21231,12250,33481,2021-09-01
3174101002,JAKARTA SELATAN,PESANGGRAHAN,BINTARO,53098,20059,33039,20837,53876,2021-09-01
3174011005,JAKARTA SELATAN,TEBET,BUKIT DURI,34183,13415,20768,11905,32673,2021-09-01
3171041006,JAKARTA PUSAT,SENEN,BUNGUR,18144,6469,11675,7376,19051,2021-09-01
3175061007,JAKARTA TIMUR,CAKUNG,CAKUNG BARAT,57724,19604,38120,23318,61438,2021-09-01
3175061004,JAKARTA TIMUR,CAKUNG,CAKUNG TIMUR,58287,20230,38057,24999,63056,2021-09-01
3175041007,JAKARTA TIMUR,KRAMAT JATI,CAWANG,32762,12975,19787,11578,31365,2021-09-01
3175101008,JAKARTA TIMUR,CIPAYUNG,CEGER,18932,6681,12251,8011,20262,2021-09-01
3171031006,JAKARTA PUSAT,KEMAYORAN,CEMPAKA BARU,32581,12103,20478,12012,32490,2021-09-01
3171051002,JAKARTA PUSAT,CEMPAKA PUTIH,CEMPAKA PUTIH BARAT,35885,13336,22549,15259,37808,2021-09-01
3171051001,JAKARTA PUSAT,CEMPAKA PUTIH,CEMPAKA PUTIH TIMUR,24292,8701,15591,10257,25848,2021-09-01
3173011001,JAKARTA BARAT,CENGKARENG,CENGKARENG BARAT,66284,23478,42806,27024,69830,2021-09-01
3173011006,JAKARTA BARAT,CENGKARENG,CENGKARENG TIMUR,81027,28081,52946,28712,81658,2021-09-01
3175091002,JAKARTA TIMUR,CIRACAS,CIBUBUR,66364,22273,44091,28583,72674,2021-09-01
3171011002,JAKARTA PUSAT,GAMBIR,CIDENG,15390,5196,10194,6777,16971,2021-09-01
3174091003,JAKARTA SELATAN,JAGAKARSA,CIGANJUR,38497,13950,24547,14600,39147,2021-09-01
3175051003,JAKARTA TIMUR,PASAR REBO,CIJANTUNG,41419,13971,27448,17675,45123,2021-09-01
3171061003,JAKARTA PUSAT,MENTENG,CIKINI,8274,3046,5228,3161,8389,2021-09-01
3174081006,JAKARTA SELATAN,PANCORAN,CIKOKO,10547,3644,6903,4034,10937,2021-09-01
3174061001,JAKARTA SELATAN,CILANDAK,CILANDAK BARAT,51752,18647,33105,20790,53895,2021-09-01
3174041003,JAKARTA SELATAN,PASAR MINGGU,CILANDAK TIMUR,25145,8956,16189,10792,26981,2021-09-01
3175101002,JAKARTA TIMUR,CIPAYUNG,CILANGKAP,27635,9582,18053,11420,29473,2021-09-01
3175041006,JAKARTA TIMUR,KRAMAT JATI,CILILITAN,40181,16286,23895,14469,38364,2021-09-01
3172041001,JAKARTA UTARA,CILINCING,CILINCING,43609,16682,26927,15492,42419,2021-09-01
3175101001,JAKARTA TIMUR,CIPAYUNG,CIPAYUNG,26104,8409,17695,11409,29104,2021-09-01
3174091006,JAKARTA SELATAN,JAGAKARSA,CIPEDAK,38303,12912,25391,15836,41227,2021-09-01
3174061005,JAKARTA SELATAN,CILANDAK,CIPETE SELATAN,26704,10079,16625,11186,27811,2021-09-01
3174071010,JAKARTA SELATAN,KEBAYORAN BARU,CIPETE UTARA,34102,12531,21571,13387,34958,2021-09-01
3175021003,JAKARTA TIMUR,PULO GADUNG,CIPINANG,39306,14636,24670,15299,39969,2021-09-01
3175031007,JAKARTA TIMUR,JATINEGARA,CIPINANG BESAR SELATAN,35212,14233,20979,11774,32753,2021-09-01
3175031008,JAKARTA TIMUR,JATINEGARA,CIPINANG BESAR UTARA,45319,18352,26967,15074,42041,2021-09-01
3175031005,JAKARTA TIMUR,JATINEGARA,CIPINANG CEMPEDAK,32824,13250,19574,12373,31947,2021-09-01
3175081005,JAKARTA TIMUR,MAKASAR,CIPINANG MELAYU,42308,16016,26292,17114,43406,2021-09-01
3175031006,JAKARTA TIMUR,JATINEGARA,CIPINANG MUARA,55243,22244,32999,19568,52567,2021-09-01
3174051003,JAKARTA SELATAN,KEBAYORAN LAMA,CIPULIR,39937,16055,23882,13106,36988,2021-09-01
3175091001,JAKARTA TIMUR,CIRACAS,CIRACAS,64594,21491,43103,26301,69404,2021-09-01
3175041003,JAKARTA TIMUR,KRAMAT JATI,DUKUH,24609,8626,15983,9671,25654,2021-09-01
3175071001,JAKARTA TIMUR,DUREN SAWIT,DUREN SAWIT,61160,24368,36792,22238,59030,2021-09-01
3174081004,JAKARTA SELATAN,PANCORAN,DUREN TIGA,28319,10544,17775,9591,27366,2021-09-01
3173051005,JAKARTA BARAT,KEBON JERUK,DURI KEPA,60138,20762,39376,25366,64742,2021-09-01
3173011002,JAKARTA BARAT,CENGKARENG,DURI KOSAMBI,77923,30413,47510,26449,73959,2021-09-01
3171011006,JAKARTA PUSAT,GAMBIR,DURI PULO,19610,6992,12618,7578,20196,2021-09-01
3173041011,JAKARTA BARAT,TAMBORA,DURI SELATAN,14259,4640,9619,6186,15805,2021-09-01
3173041003,JAKARTA BARAT,TAMBORA,DURI UTARA,19844,6764,13080,8009,21089,2021-09-01
3171081003,JAKARTA PUSAT,JOHAR BARU,GALUR,18243,5702,12541,7484,20025,2021-09-01
3171011001,JAKARTA PUSAT,GAMBIR,GAMBIR,2191,739,1452,942,2394,2021-09-01
3174061004,JAKARTA SELATAN,CILANDAK,GANDARIA SELATAN,22119,8258,13861,8356,22217,2021-09-01
3174071009,JAKARTA SELATAN,KEBAYORAN BARU,GANDARIA UTARA,39922,15032,24890,15443,40333,2021-09-01
3175051001,JAKARTA TIMUR,PASAR REBO,GEDONG,35755,12645,23110,14650,37760,2021-09-01
3171071001,JAKARTA PUSAT,TANAH ABANG,GELORA,3127,1197,1930,1220,3150,2021-09-01
3173031007,JAKARTA BARAT,TAMAN SARI,GLODOK,7837,2380,5457,3880,9337,2021-09-01
3171061004,JAKARTA PUSAT,MENTENG,GONDANGDIA,4100,1499,2601,1971,4572,2021-09-01
3173021001,JAKARTA BARAT,GROGOL PETAMBURAN,GROGOL,16876,6091,10785,6867,17652,2021-09-01
3174051005,JAKARTA SELATAN,KEBAYORAN LAMA,GROGOL SELATAN,44251,17025,27226,15614,42840,2021-09-01
3174051004,JAKARTA SELATAN,KEBAYORAN LAMA,GROGOL UTARA,42494,16132,26362,15207,41569,2021-09-01
3174021007,JAKARTA SELATAN,SETIA BUDI,GUNTUR,3985,1397,2588,1841,4429,2021-09-01
3174071002,JAKARTA SELATAN,KEBAYORAN BARU,GUNUNG,9436,3353,6083,4227,10310,2021-09-01
3171031005,JAKARTA PUSAT,KEMAYORAN,GUNUNG SAHARI SELATAN,19199,7023,12176,7989,20165,2021-09-01
3171021004,JAKARTA PUSAT,SAWAH BESAR,GUNUNG SAHARI UTARA,16650,5254,11396,7966,19362,2021-09-01
3175081004,JAKARTA TIMUR,MAKASAR,HALIM PERDANA KUSUMAH,28363,7908,20455,15854,36309,2021-09-01
3171031003,JAKARTA PUSAT,KEMAYORAN,HARAPAN MULIA,22557,8169,14388,9033,23421,2021-09-01
3174091001,JAKARTA SELATAN,JAGAKARSA,JAGAKARSA,62389,21880,40509,25885,66394,2021-09-01
3175021007,JAKARTA TIMUR,PULO GADUNG,JATI,32757,11949,20808,13083,33891,2021-09-01
3174041002,JAKARTA SELATAN,PASAR MINGGU,JATI PADANG,37502,13857,23645,14930,38575,2021-09-01
3173071004,JAKARTA BARAT,PALMERAH,JATI PULO,28738,9857,18881,11105,29986,2021-09-01
3175061001,JAKARTA TIMUR,CAKUNG,JATINEGARA,84160,31687,52473,32891,85364,2021-09-01
3175021004,JAKARTA TIMUR,PULO GADUNG,JATINEGARA KAUM,24632,8370,16262,9115,25377,2021-09-01
3173021004,JAKARTA BARAT,GROGOL PETAMBURAN,JELAMBAR,30266,10783,19483,13274,32757,2021-09-01
3173021006,JAKARTA BARAT,GROGOL PETAMBURAN,JELAMBAR BARU,38246,13691,24555,16286,40841,2021-09-01
3173041006,JAKARTA BARAT,TAMBORA,JEMBATAN BESI,29314,12010,17304,9223,26527,2021-09-01
3173041008,JAKARTA BARAT,TAMBORA,JEMBATAN LIMA,21021,8150,12871,7243,20114,2021-09-01
3173081005,JAKARTA BARAT,KEMBANGAN,JOGLO,40839,14893,25946,15456,41402,2021-09-01
3171081001,JAKARTA PUSAT,JOHAR BARU,JOHAR BARU,37488,12122,25366,16195,41561,2021-09-01
3173041002,JAKARTA BARAT,TAMBORA,KALI ANYAR,23856,8132,15724,8698,24422,2021-09-01
3172041004,JAKARTA UTARA,CILINCING,KALIBARU,67684,27518,40166,22011,62177,2021-09-01
3174081002,JAKARTA SELATAN,PANCORAN,KALIBATA,41994,17441,24553,13166,37719,2021-09-01
3173061001,JAKARTA BARAT,KALI DERES,KALIDERES,72447,26730,45717,30176,75893,2021-09-01
3175051004,JAKARTA TIMUR,PASAR REBO,KALISARI,43212,14885,28327,18507,46834,2021-09-01
3173061004,JAKARTA BARAT,KALI DERES,KAMAL,53783,20322,33461,18082,51543,2021-09-01
3172011002,JAKARTA UTARA,PENJARINGAN,KAMAL MUARA,12930,3473,9457,6716,16173,2021-09-01
3171071007,JAKARTA PUSAT,TANAH ABANG,KAMPUNG BALI,11358,4480,6878,4060,10938,2021-09-01
3175031001,JAKARTA TIMUR,JATINEGARA,KAMPUNG MELAYU,25717,10548,15169,8688,23857,2021-09-01
3171081002,JAKARTA PUSAT,JOHAR BARU,KAMPUNG RAWA,21237,5781,15456,9086,24542,2021-09-01
3175041002,JAKARTA TIMUR,KRAMAT JATI,KAMPUNG TENGAH,43993,18092,25901,14028,39929,2021-09-01
3173011005,JAKARTA BARAT,CENGKARENG,KAPUK,134466,52284,82182,43261,125443,2021-09-01
3172011003,JAKARTA UTARA,PENJARINGAN,KAPUK MUARA,35781,11296,24485,17656,42141,2021-09-01
3171021002,JAKARTA PUSAT,SAWAH BESAR,KARANG ANYAR,25761,8687,17074,10770,27844,2021-09-01
3174021004,JAKARTA SELATAN,SETIA BUDI,KARET,9623,3639,5984,3889,9873,2021-09-01
3174021003,JAKARTA SELATAN,SETIA BUDI,KARET KUNINGAN,16055,5387,10668,6882,17550,2021-09-01
3174021002,JAKARTA SELATAN,SETIA BUDI,KARET SEMANGGI,2770,957,1813,1342,3155,2021-09-01
3171071003,JAKARTA PUSAT,TANAH ABANG,KARET TENGSIN,19271,7053,12218,7650,19868,2021-09-01
3171021003,JAKARTA PUSAT,SAWAH BESAR,KARTINI,22292,7807,14485,9607,24092,2021-09-01
3175011003,JAKARTA TIMUR,MATRAMAN,KAYU MANIS,25284,10013,15271,8570,23841,2021-09-01
3175021006,JAKARTA TIMUR,PULO GADUNG,KAYU PUTIH,40696,14104,26592,17891,44483,2021-09-01
3173031006,JAKARTA BARAT,TAMAN SARI,KEAGUNGAN,17387,6008,11379,7222,18601,2021-09-01
3174041007,JAKARTA SELATAN,PASAR MINGGU,KEBAGUSAN,44552,17139,27413,16258,43671,2021-09-01
3174051006,JAKARTA SELATAN,KEBAYORAN LAMA,KEBAYORAN LAMA SELATAN,41212,14827,26385,15558,41943,2021-09-01
3174051001,JAKARTA SELATAN,KEBAYORAN LAMA,KEBAYORAN LAMA UTARA,42422,16625,25797,14086,39883,2021-09-01
3174011004,JAKARTA SELATAN,TEBET,KEBON BARU,35165,13007,22158,13303,35461,2021-09-01
3172021005,JAKARTA UTARA,TANJUNG PRIOK,KEBON BAWANG,50952,18445,32507,20386,52893,2021-09-01
3173051001,JAKARTA BARAT,KEBON JERUK,KEBON JERUK,53887,20713,33174,19755,52929,2021-09-01
3171071006,JAKARTA PUSAT,TANAH ABANG,KEBON KACANG,21531,9144,12387,7395,19782,2021-09-01
3171011005,JAKARTA PUSAT,GAMBIR,KEBON KELAPA,10163,3612,6551,4165,10716,2021-09-01
3171031002,JAKARTA PUSAT,KEMAYORAN,KEBON KOSONG,30019,10925,19094,11787,30881,2021-09-01
3175011005,JAKARTA TIMUR,MATRAMAN,KEBON MANGGIS,16490,5960,10530,6670,17200,2021-09-01
3171071005,JAKARTA PUSAT,TANAH ABANG,KEBON MELATI,32206,14391,17815,10162,27977,2021-09-01
3175081003,JAKARTA TIMUR,MAKASAR,KEBON PALA,46614,16941,29673,17407,47080,2021-09-01
3171061005,JAKARTA PUSAT,MENTENG,KEBON SIRIH,12299,4619,7680,4733,12413,2021-09-01
3173011004,JAKARTA BARAT,CENGKARENG,KEDAUNG KALI ANGKE,32612,10686,21926,13893,35819,2021-09-01
3173051007,JAKARTA BARAT,KEBON JERUK,KEDOYA SELATAN,32165,11239,20926,12686,33612,2021-09-01
3173051006,JAKARTA BARAT,KEBON JERUK,KEDOYA UTARA,45740,15018,30722,20370,51092,2021-09-01
3173051004,JAKARTA BARAT,KEBON JERUK,KELAPA DUA,23565,8868,14697,8574,23271,2021-09-01
3175091003,JAKARTA TIMUR,CIRACAS,KELAPA DUA WETAN,46875,15402,31473,19493,50966,2021-09-01
3172061003,JAKARTA UTARA,KELAPA GADING,KELAPA GADING BARAT,35717,11374,24343,17943,42286,2021-09-01
3172061001,JAKARTA UTARA,KELAPA GADING,KELAPA GADING TIMUR,33592,9833,23759,17313,41072,2021-09-01
3173071005,JAKARTA BARAT,PALMERAH,KEMANGGISAN,32139,11641,20498,12427,32925,2021-09-01
3171031001,JAKARTA PUSAT,KEMAYORAN,KEMAYORAN,20708,7316,13392,8646,22038,2021-09-01
3173081006,JAKARTA BARAT,KEMBANGAN,KEMBANGAN SELATAN,27130,9799,17331,11811,29142,2021-09-01
3173081001,JAKARTA BARAT,KEMBANGAN,KEMBANGAN UTARA,54451,19786,34665,21459,56124,2021-09-01
3171041002,JAKARTA PUSAT,SENEN,KENARI,9579,3346,6233,4052,10285,2021-09-01
3173041005,JAKARTA BARAT,TAMBORA,KERENDANG,19973,7034,12939,8000,20939,2021-09-01
3175071003,JAKARTA TIMUR,DUREN SAWIT,KLENDER,69978,28456,41522,22939,64461,2021-09-01
3172031001,JAKARTA UTARA,KOJA,KOJA,28175,10703,17472,10927,28399,2021-09-01
3173071006,JAKARTA BARAT,PALMERAH,KOTA BAMBU SELATAN,21158,7792,13366,7646,21012,2021-09-01
3173071003,JAKARTA BARAT,PALMERAH,KOTA BAMBU UTARA,24995,9365,15630,9174,24804,2021-09-01
3171041004,JAKARTA PUSAT,SENEN,KRAMAT,28835,10979,17856,9900,27756,2021-09-01
3175041001,JAKARTA TIMUR,KRAMAT JATI,KRAMAT JATI,34144,12641,21503,12125,33628,2021-09-01
3174071003,JAKARTA SELATAN,KEBAYORAN BARU,KRAMAT PELA,14413,5033,9380,5932,15312,2021-09-01
3173031002,JAKARTA BARAT,TAMAN SARI,KRUKUT,19244,6750,12494,7630,20124,2021-09-01
3174031005,JAKARTA SELATAN,MAMPANG PRAPATAN,KUNINGAN BARAT,12785,4494,8291,5121,13412,2021-09-01
3174021008,JAKARTA SELATAN,SETIA BUDI,KUNINGAN TIMUR,6008,2158,3850,2527,6377,2021-09-01
3171041005,JAKARTA PUSAT,SENEN,KWITANG,15486,5626,9860,6065,15925,2021-09-01
3172031003,JAKARTA UTARA,KOJA,LAGOA,59065,22904,36161,21593,57754,2021-09-01
3174061002,JAKARTA SELATAN,CILANDAK,LEBAK BULUS,37626,14340,23286,14701,37987,2021-09-01
3174091004,JAKARTA SELATAN,JAGAKARSA,LENTENG AGUNG,53946,20594,33352,18829,52181,2021-09-01
3175101007,JAKARTA TIMUR,CIPAYUNG,LUBANG BUAYA,63547,21450,42097,26520,68617,2021-09-01
3175081001,JAKARTA TIMUR,MAKASAR,MAKASAR,34390,12053,22337,13929,36266,2021-09-01
3175071006,JAKARTA TIMUR,DUREN SAWIT,MALAKA JAYA,30927,11420,19507,13328,32835,2021-09-01
3175071005,JAKARTA TIMUR,DUREN SAWIT,MALAKA SARI,27530,9780,17750,12045,29795,2021-09-01
3174031001,JAKARTA SELATAN,MAMPANG PRAPATAN,MAMPANG PRAPATAN,18159,6697,11462,7236,18698,2021-09-01
3173031005,JAKARTA BARAT,TAMAN SARI,MANGGA BESAR,7707,2378,5329,3600,8929,2021-09-01
3171021005,JAKARTA PUSAT,SAWAH BESAR,MANGGA DUA SELATAN,27442,9602,17840,11518,29358,2021-09-01
3174011007,JAKARTA SELATAN,TEBET,MANGGARAI,28373,9655,18718,10736,29454,2021-09-01
3174011006,JAKARTA SELATAN,TEBET,MANGGARAI SELATAN,23075,8083,14992,9151,24143,2021-09-01
3173031003,JAKARTA BARAT,TAMAN SARI,MAPHAR,16461,5874,10587,6961,17548,2021-09-01
3172041003,JAKARTA UTARA,CILINCING,MARUNDA,28943,10080,18863,9281,28144,2021-09-01
3174071001,JAKARTA SELATAN,KEBAYORAN BARU,MELAWAI,2627,898,1729,1360,3089,2021-09-01
3171061001,JAKARTA PUSAT,MENTENG,MENTENG,25624,9840,15784,9630,25414,2021-09-01
3174021005,JAKARTA SELATAN,SETIA BUDI,MENTENG ATAS,27816,9575,18241,11012,29253,2021-09-01
3174011003,JAKARTA SELATAN,TEBET,MENTENG DALAM,36028,13242,22786,13860,36646,2021-09-01
3173081003,JAKARTA BARAT,KEMBANGAN,MERUYA SELATAN,32130,11784,20346,12515,32861,2021-09-01
3173081002,JAKARTA BARAT,KEMBANGAN,MERUYA UTARA,43752,16223,27529,17782,45311,2021-09-01
3175101004,JAKARTA TIMUR,CIPAYUNG,MUNJUL,23871,8116,15755,10235,25990,2021-09-01
3172051002,JAKARTA UTARA,PADEMANGAN,PADEMANGAN BARAT,74240,28014,46226,28430,74656,2021-09-01
3172051001,JAKARTA UTARA,PADEMANGAN,PADEMANGAN TIMUR,37736,11872,25864,17679,43543,2021-09-01
3175011004,JAKARTA TIMUR,MATRAMAN,PAL MERIAM,19769,7732,12037,7197,19234,2021-09-01
3173071001,JAKARTA BARAT,PALMERAH,PALMERAH,63011,23461,39550,23482,63032,2021-09-01
3174081001,JAKARTA SELATAN,PANCORAN,PANCORAN,19421,7249,12172,7330,19502,2021-09-01
3172021003,JAKARTA UTARA,TANJUNG PRIOK,PAPANGGO,39097,13150,25947,16190,42137,2021-09-01
3171021001,JAKARTA PUSAT,SAWAH BESAR,PASAR BARU,12035,3790,8245,5777,14022,2021-09-01
3174021006,JAKARTA SELATAN,SETIA BUDI,PASAR MANGGIS,26752,9841,16911,10284,27195,2021-09-01
3174041001,JAKARTA SELATAN,PASAR MINGGU,PASAR MINGGU,24821,9113,15708,10110,25818,2021-09-01
3171041003,JAKARTA PUSAT,SENEN,PASEBAN,23533,8741,14792,9053,23845,2021-09-01
3173061005,JAKARTA BARAT,KALI DERES,PEGADUNGAN,75587,25831,49756,32033,81789,2021-09-01
3171061002,JAKARTA PUSAT,MENTENG,PEGANGSAAN,23455,8889,14566,8279,22845,2021-09-01
3172061002,JAKARTA UTARA,KELAPA GADING,PEGANGSAAN DUA,49976,14476,35500,25163,60663,2021-09-01
3172011004,JAKARTA UTARA,PENJARINGAN,PEJAGALAN,74578,26708,47870,31191,79061,2021-09-01
3174041006,JAKARTA SELATAN,PASAR MINGGU,PEJATEN BARAT,37346,14091,23255,14562,37817,2021-09-01
3174041005,JAKARTA SELATAN,PASAR MINGGU,PEJATEN TIMUR,57656,22668,34988,19576,54564,2021-09-01
3175051005,JAKARTA TIMUR,PASAR REBO,PEKAYON,43250,14754,28496,18166,46662,2021-09-01
3173041009,JAKARTA BARAT,TAMBORA,PEKOJAN,23587,7860,15727,10290,26017,2021-09-01
3174031003,JAKARTA SELATAN,MAMPANG PRAPATAN,PELA MAMPANG,43522,15830,27692,17971,45663,2021-09-01
3174081005,JAKARTA SELATAN,PANCORAN,PENGADEGAN,21478,7218,14260,7768,22028,2021-09-01
3175061003,JAKARTA TIMUR,CAKUNG,PENGGILINGAN,99255,40441,58814,33054,91868,2021-09-01
3172011001,JAKARTA UTARA,PENJARINGAN,PENJARINGAN,88308,34850,53458,30728,84186,2021-09-01
3174101001,JAKARTA SELATAN,PESANGGRAHAN,PESANGGRAHAN,27545,9496,18049,11267,29316,2021-09-01
3171071004,JAKARTA PUSAT,TANAH ABANG,PETAMBURAN,33271,14974,18297,10121,28418,2021-09-01
3174071008,JAKARTA SELATAN,KEBAYORAN BARU,PETOGOGAN,11499,4290,7209,4675,11884,2021-09-01
3171011004,JAKARTA PUSAT,GAMBIR,PETOJO SELATAN,14692,5461,9231,5948,15179,2021-09-01
3171011003,JAKARTA PUSAT,GAMBIR,PETOJO UTARA,17458,6368,11090,6549,17639,2021-09-01
3174101004,JAKARTA SELATAN,PESANGGRAHAN,PETUKANGAN SELATAN,37187,13759,23428,14038,37466,2021-09-01
3174101003,JAKARTA SELATAN,PESANGGRAHAN,PETUKANGAN UTARA,53716,21072,32644,19693,52337,2021-09-01
3175081002,JAKARTA TIMUR,MAKASAR,PINANG RANTI,27198,9963,17235,11004,28239,2021-09-01
3173031008,JAKARTA BARAT,TAMAN SARI,PINANGSIA,10729,3433,7296,4701,11997,2021-09-01
3175011001,JAKARTA TIMUR,MATRAMAN,PISANGAN BARU,31776,12321,19455,10679,30134,2021-09-01
3175021002,JAKARTA TIMUR,PULO GADUNG,PISANGAN TIMUR,41011,14393,26618,16225,42843,2021-09-01
3172011005,JAKARTA UTARA,PENJARINGAN,PLUIT,47783,15870,31913,22800,54713,2021-09-01
3175071002,JAKARTA TIMUR,DUREN SAWIT,PONDOK BAMBU,61550,24218,37332,21963,59295,2021-09-01
3175071004,JAKARTA TIMUR,DUREN SAWIT,PONDOK KELAPA,72015,26575,45440,27448,72888,2021-09-01
3175071007,JAKARTA TIMUR,DUREN SAWIT,PONDOK KOPI,35367,14824,20543,12084,32627,2021-09-01
3174061003,JAKARTA SELATAN,CILANDAK,PONDOK LABU,46464,16175,30289,20143,50432,2021-09-01
3174051002,JAKARTA SELATAN,KEBAYORAN LAMA,PONDOK PINANG,56169,20962,35207,21953,57160,2021-09-01
3175101003,JAKARTA TIMUR,CIPAYUNG,PONDOK RANGGON,25574,8944,16630,10240,26870,2021-09-01
3101011003,KAB.ADM.KEP.SERIBU,KEP. SERIBU UTARA,PULAU HARAPAN,2060,338,1722,1007,2729,2021-09-01
3101011002,KAB.ADM.KEP.SERIBU,KEP. SERIBU UTARA,PULAU KELAPA,5528,902,4626,2626,7252,2021-09-01
3101011001,KAB.ADM.KEP.SERIBU,KEP. SERIBU UTARA,PULAU PANGGANG,5450,854,4596,2128,6724,2021-09-01
3101021003,KAB.ADM.KEP.SERIBU,KEP. SERIBU SELATAN,PULAU PARI,2765,320,2445,1399,3844,2021-09-01
3101021002,KAB.ADM.KEP.SERIBU,KEP. SERIBU SELATAN,PULAU TIDUNG,4553,629,3924,2647,6571,2021-09-01
3101021001,KAB.ADM.KEP.SERIBU,KEP. SERIBU SELATAN,PULAU UNTUNG JAWA,1941,322,1619,963,2582,2021-09-01
3174071007,JAKARTA SELATAN,KEBAYORAN BARU,PULO,5835,1969,3866,2806,6672,2021-09-01
3175021001,JAKARTA TIMUR,PULO GADUNG,PULO GADUNG,34422,12771,21651,12936,34587,2021-09-01
3175061005,JAKARTA TIMUR,CAKUNG,PULO GEBANG,97301,36855,60446,35493,95939,2021-09-01
3174041004,JAKARTA SELATAN,PASAR MINGGU,RAGUNAN,39616,13986,25630,16214,41844,2021-09-01
3175091005,JAKARTA TIMUR,CIRACAS,RAMBUTAN,36771,14902,21869,13081,34950,2021-09-01
3172031006,JAKARTA UTARA,KOJA,RAWA BADAK SELATAN,42179,16592,25587,15050,40637,2021-09-01
3172031004,JAKARTA UTARA,KOJA,RAWA BADAK UTARA,34408,13227,21181,12758,33939,2021-09-01
3174071005,JAKARTA SELATAN,KEBAYORAN BARU,RAWA BARAT,5625,1894,3731,2555,6286,2021-09-01
3173011003,JAKARTA BARAT,CENGKARENG,RAWA BUAYA,63799,23367,40432,22445,62877,2021-09-01
3175031004,JAKARTA TIMUR,JATINEGARA,RAWA BUNGA,21434,8544,12890,7774,20664,2021-09-01
3174081003,JAKARTA SELATAN,PANCORAN,RAWA JATI,20509,7447,13062,7652,20714,2021-09-01
3175061002,JAKARTA TIMUR,CAKUNG,RAWA TERATE,24637,8153,16484,10553,27037,2021-09-01
3175021005,JAKARTA TIMUR,PULO GADUNG,RAWAMANGUN,37612,13928,23684,15227,38911,2021-09-01
3171051003,JAKARTA PUSAT,CEMPAKA PUTIH,RAWASARI,21967,8182,13785,9161,22946,2021-09-01
3173041010,JAKARTA BARAT,TAMBORA,ROA MALAKA,3484,1046,2438,1685,4123,2021-09-01
3172041006,JAKARTA UTARA,CILINCING,ROROTAN,41668,14170,27498,15982,43480,2021-09-01
3174071004,JAKARTA SELATAN,KEBAYORAN BARU,SELONG,2842,980,1862,1395,3257,2021-09-01
3173061002,JAKARTA BARAT,KALI DERES,SEMANAN,71354,27131,44223,24303,68526,2021-09-01
3172041007,JAKARTA UTARA,CILINCING,SEMPER BARAT,68587,23031,45556,28992,74548,2021-09-01
3172041005,JAKARTA UTARA,CILINCING,SEMPER TIMUR,36267,12728,23539,13877,37416,2021-09-01
3174071006,JAKARTA SELATAN,KEBAYORAN BARU,SENAYAN,2771,1125,1646,1085,2731,2021-09-01
3171041001,JAKARTA PUSAT,SENEN,SENEN,6804,2338,4466,3002,7468,2021-09-01
3171031004,JAKARTA PUSAT,KEMAYORAN,SERDANG,29668,10800,18868,11501,30369,2021-09-01
3174021001,JAKARTA SELATAN,SETIA BUDI,SETIA BUDI,3023,1123,1900,1270,3170,2021-09-01
3175101005,JAKARTA TIMUR,CIPAYUNG,SETU,20572,7754,12818,7466,20284,2021-09-01
3173071002,JAKARTA BARAT,PALMERAH,SLIPI,16591,5714,10877,6906,17783,2021-09-01
3173081004,JAKARTA BARAT,KEMBANGAN,SRENGSENG,45523,17333,28190,17312,45502,2021-09-01
3174091002,JAKARTA SELATAN,JAGAKARSA,SRENGSENG SAWAH,58196,18948,39248,24264,63512,2021-09-01
3173051003,JAKARTA BARAT,KEBON JERUK,SUKABUMI SELATAN,37033,14502,22531,11288,33819,2021-09-01
3173051002,JAKARTA BARAT,KEBON JERUK,SUKABUMI UTARA,38290,15162,23128,11755,34883,2021-09-01
3172041002,JAKARTA UTARA,CILINCING,SUKAPURA,53949,20009,33940,21460,55400,2021-09-01
3171031007,JAKARTA PUSAT,KEMAYORAN,SUMUR BATU,22717,8359,14358,9249,23607,2021-09-01
3172021004,JAKARTA UTARA,TANJUNG PRIOK,SUNGAI BAMBU,29876,10646,19230,11681,30911,2021-09-01
3172021006,JAKARTA UTARA,TANJUNG PRIOK,SUNTER AGUNG,71805,22414,49391,34133,83524,2021-09-01
3172021002,JAKARTA UTARA,TANJUNG PRIOK,SUNTER JAYA,63031,20406,42625,28924,71549,2021-09-01
3175091004,JAKARTA TIMUR,CIRACAS,SUSUKAN,38257,12846,25411,15205,40616,2021-09-01
3173031001,JAKARTA BARAT,TAMAN SARI,TAMAN SARI,14348,5057,9291,6408,15699,2021-09-01
3173041001,JAKARTA BARAT,TAMBORA,TAMBORA,10204,3726,6478,3742,10220,2021-09-01
3173041004,JAKARTA BARAT,TAMBORA,TANAH SEREAL,26387,7991,18396,11810,30206,2021-09-01
3171081004,JAKARTA PUSAT,JOHAR BARU,TANAH TINGGI,37693,11627,26066,15297,41363,2021-09-01
3173031004,JAKARTA BARAT,TAMAN SARI,TANGKI,13324,4607,8717,5861,14578,2021-09-01
3174091005,JAKARTA SELATAN,JAGAKARSA,TANJUNG BARAT,39770,14209,25561,14692,40253,2021-09-01
3173021005,JAKARTA BARAT,GROGOL PETAMBURAN,TANJUNG DUREN SELATAN,25337,8911,16426,10942,27368,2021-09-01
3173021002,JAKARTA BARAT,GROGOL PETAMBURAN,TANJUNG DUREN UTARA,17010,5666,11344,7432,18776,2021-09-01
3172021001,JAKARTA UTARA,TANJUNG PRIOK,TANJUNG PRIOK,34588,11674,22914,13628,36542,2021-09-01
3174011002,JAKARTA SELATAN,TEBET,TEBET BARAT,21194,7117,14077,9224,23301,2021-09-01
3174011001,JAKARTA SELATAN,TEBET,TEBET TIMUR,18199,6112,12087,7898,19985,2021-09-01
3173061003,JAKARTA BARAT,KALI DERES,TEGAL ALUR,83647,30213,53434,29043,82477,2021-09-01
3174031004,JAKARTA SELATAN,MAMPANG PRAPATAN,TEGAL PARANG,32401,12742,19659,11284,30943,2021-09-01
3173021003,JAKARTA BARAT,GROGOL PETAMBURAN,TOMANG,29605,10312,19293,13093,32386,2021-09-01
3172031005,JAKARTA UTARA,KOJA,TUGU SELATAN,39122,14915,24207,14435,38642,2021-09-01
3172031002,JAKARTA UTARA,KOJA,TUGU UTARA,67670,26473,41197,24769,65966,2021-09-01
3175061006,JAKARTA TIMUR,CAKUNG,UJUNG MENTENG,29934,10053,19881,12596,32477,2021-09-01
3174101005,JAKARTA SELATAN,PESANGGRAHAN,ULUJAMI,40544,16253,24291,13889,38180,2021-09-01
3175011006,JAKARTA TIMUR,MATRAMAN,UTAN KAYU SELATAN,33511,11879,21632,13025,34657,2021-09-01
3175011002,JAKARTA TIMUR,MATRAMAN,UTAN KAYU UTARA,28169,10858,17311,10133,27444,2021-09-01
3171031008,JAKARTA PUSAT,KEMAYORAN,UTAN PANJANG,29208,11014,18194,11261,29455,2021-09-01
3172021007,JAKARTA UTARA,TANJUNG PRIOK,WARAKAS,44401,15260,29141,17479,46620,2021-09-01
3173021007,JAKARTA BARAT,GROGOL PETAMBURAN,WIJAYA KUSUMA,38934,14411,24523,16021,40544,2021-09-01
3172051003,JAKARTA UTARA,PADEMANGAN,ANCOL,23947,9094,14853,9462,24315,2021-09-02
3173041007,JAKARTA BARAT,TAMBORA,ANGKE,29381,10318,19063,10934,29997,2021-09-02
3175041005,JAKARTA TIMUR,KRAMAT JATI,BALE KAMBANG,29074,12411,16663,8194,24857,2021-09-02
3175031003,JAKARTA TIMUR,JATINEGARA,BALI MESTER,9752,3678,6074,3829,9903,2021-09-02
3175101006,JAKARTA TIMUR,CIPAYUNG,BAMBU APUS,26285,9298,16987,10943,27930,2021-09-02
3174031002,JAKARTA SELATAN,MAMPANG PRAPATAN,BANGKA,21566,8333,13233,8214,21447,2021-09-02
3175051002,JAKARTA TIMUR,PASAR REBO,BARU,23886,7625,16261,11632,27893,2021-09-02
3175041004,JAKARTA TIMUR,KRAMAT JATI,BATU AMPAR,47898,19731,28167,16122,44289,2021-09-02
3171071002,JAKARTA PUSAT,TANAH ABANG,BENDUNGAN HILIR,21494,7977,13517,8874,22391,2021-09-02
3175031002,JAKARTA TIMUR,JATINEGARA,BIDARA CINA,36689,15251,21438,12673,34111,2021-09-02
3174101002,JAKARTA SELATAN,PESANGGRAHAN,BINTARO,53098,20051,33047,20895,53942,2021-09-02
3174011005,JAKARTA SELATAN,TEBET,BUKIT DURI,34183,13385,20798,11957,32755,2021-09-02
3171041006,JAKARTA PUSAT,SENEN,BUNGUR,18144,6449,11695,7520,19215,2021-09-02
3175061007,JAKARTA TIMUR,CAKUNG,CAKUNG BARAT,57724,19475,38249,23604,61853,2021-09-02
3175061004,JAKARTA TIMUR,CAKUNG,CAKUNG TIMUR,58287,20103,38184,25643,63827,2021-09-02
3175041007,JAKARTA TIMUR,KRAMAT JATI,CAWANG,32762,12833,19929,11921,31850,2021-09-02
3175101008,JAKARTA TIMUR,CIPAYUNG,CEGER,18932,6652,12280,8141,20421,2021-09-02
3171031006,JAKARTA PUSAT,KEMAYORAN,CEMPAKA BARU,32581,12032,20549,12301,32850,2021-09-02
3171051002,JAKARTA PUSAT,CEMPAKA PUTIH,CEMPAKA PUTIH BARAT,35885,13263,22622,15508,38130,2021-09-02
3171051001,JAKARTA PUSAT,CEMPAKA PUTIH,CEMPAKA PUTIH TIMUR,24292,8668,15624,10421,26045,2021-09-02
3173011001,JAKARTA BARAT,CENGKARENG,CENGKARENG BARAT,66284,23339,42945,27536,70481,2021-09-02
3173011006,JAKARTA BARAT,CENGKARENG,CENGKARENG TIMUR,81027,27976,53051,29587,82638,2021-09-02
3175091002,JAKARTA TIMUR,CIRACAS,CIBUBUR,66364,22051,44313,29047,73360,2021-09-02
3171011002,JAKARTA PUSAT,GAMBIR,CIDENG,15390,5184,10206,6870,17076,2021-09-02
3174091003,JAKARTA SELATAN,JAGAKARSA,CIGANJUR,38497,13943,24554,14632,39186,2021-09-02
3175051003,JAKARTA TIMUR,PASAR REBO,CIJANTUNG,41419,13904,27515,18111,45626,2021-09-02
3171061003,JAKARTA PUSAT,MENTENG,CIKINI,8274,2997,5277,3243,8520,2021-09-02
3174081006,JAKARTA SELATAN,PANCORAN,CIKOKO,10547,3640,6907,4046,10953,2021-09-02
3174061001,JAKARTA SELATAN,CILANDAK,CILANDAK BARAT,51752,18638,33114,20841,53955,2021-09-02
3174041003,JAKARTA SELATAN,PASAR MINGGU,CILANDAK TIMUR,25145,8952,16193,10813,27006,2021-09-02
3175101002,JAKARTA TIMUR,CIPAYUNG,CILANGKAP,27635,9538,18097,11688,29785,2021-09-02
3175041006,JAKARTA TIMUR,KRAMAT JATI,CILILITAN,40181,16214,23967,14800,38767,2021-09-02
3172041001,JAKARTA UTARA,CILINCING,CILINCING,43609,16609,27000,15783,42783,2021-09-02
3175101001,JAKARTA TIMUR,CIPAYUNG,CIPAYUNG,26104,8371,17733,11731,29464,2021-09-02
3174091006,JAKARTA SELATAN,JAGAKARSA,CIPEDAK,38303,12901,25402,15865,41267,2021-09-02
3174061005,JAKARTA SELATAN,CILANDAK,CIPETE SELATAN,26704,10061,16643,11214,27857,2021-09-02
3174071010,JAKARTA SELATAN,KEBAYORAN BARU,CIPETE UTARA,34102,12523,21579,13417,34996,2021-09-02
3175021003,JAKARTA TIMUR,PULO GADUNG,CIPINANG,39306,14550,24756,15584,40340,2021-09-02
3175031007,JAKARTA TIMUR,JATINEGARA,CIPINANG BESAR SELATAN,35212,14136,21076,12055,33131,2021-09-02
3175031008,JAKARTA TIMUR,JATINEGARA,CIPINANG BESAR UTARA,45319,18216,27103,15606,42709,2021-09-02
3175031005,JAKARTA TIMUR,JATINEGARA,CIPINANG CEMPEDAK,32824,13194,19630,12622,32252,2021-09-02
3175081005,JAKARTA TIMUR,MAKASAR,CIPINANG MELAYU,42308,15943,26365,17427,43792,2021-09-02
3175031006,JAKARTA TIMUR,JATINEGARA,CIPINANG MUARA,55243,22125,33118,20081,53199,2021-09-02
3174051003,JAKARTA SELATAN,KEBAYORAN LAMA,CIPULIR,39937,16047,23890,13153,37043,2021-09-02
3175091001,JAKARTA TIMUR,CIRACAS,CIRACAS,64594,21357,43237,26792,70029,2021-09-02
3175041003,JAKARTA TIMUR,KRAMAT JATI,DUKUH,24609,8596,16013,9935,25948,2021-09-02
3175071001,JAKARTA TIMUR,DUREN SAWIT,DUREN SAWIT,61160,24244,36916,22628,59544,2021-09-02
3174081004,JAKARTA SELATAN,PANCORAN,DUREN TIGA,28319,10538,17781,9622,27403,2021-09-02
3173051005,JAKARTA BARAT,KEBON JERUK,DURI KEPA,60138,20671,39467,25785,65252,2021-09-02
3173011002,JAKARTA BARAT,CENGKARENG,DURI KOSAMBI,77923,30283,47640,27250,74890,2021-09-02
3171011006,JAKARTA PUSAT,GAMBIR,DURI PULO,19610,6965,12645,7668,20313,2021-09-02
3173041011,JAKARTA BARAT,TAMBORA,DURI SELATAN,14259,4620,9639,6258,15897,2021-09-02
3173041003,JAKARTA BARAT,TAMBORA,DURI UTARA,19844,6741,13103,8174,21277,2021-09-02
3171081003,JAKARTA PUSAT,JOHAR BARU,GALUR,18243,5679,12564,7653,20217,2021-09-02
3171011001,JAKARTA PUSAT,GAMBIR,GAMBIR,2191,738,1453,951,2404,2021-09-02
3174061004,JAKARTA SELATAN,CILANDAK,GANDARIA SELATAN,22119,8253,13866,8374,22240,2021-09-02
3174071009,JAKARTA SELATAN,KEBAYORAN BARU,GANDARIA UTARA,39922,15026,24896,15497,40393,2021-09-02
3175051001,JAKARTA TIMUR,PASAR REBO,GEDONG,35755,12590,23165,15030,38195,2021-09-02
3171071001,JAKARTA PUSAT,TANAH ABANG,GELORA,3127,1190,1937,1230,3167,2021-09-02
3173031007,JAKARTA BARAT,TAMAN SARI,GLODOK,7837,2377,5460,3921,9381,2021-09-02
3171061004,JAKARTA PUSAT,MENTENG,GONDANGDIA,4100,1495,2605,1988,4593,2021-09-02
3173021001,JAKARTA BARAT,GROGOL PETAMBURAN,GROGOL,16876,6076,10800,6988,17788,2021-09-02
3174051005,JAKARTA SELATAN,KEBAYORAN LAMA,GROGOL SELATAN,44251,17006,27245,15684,42929,2021-09-02
3174051004,JAKARTA SELATAN,KEBAYORAN LAMA,GROGOL UTARA,42494,16105,26389,15303,41692,2021-09-02
3174021007,JAKARTA SELATAN,SETIA BUDI,GUNTUR,3985,1396,2589,1848,4437,2021-09-02
3174071002,JAKARTA SELATAN,KEBAYORAN BARU,GUNUNG,9436,3346,6090,4233,10323,2021-09-02
3171031005,JAKARTA PUSAT,KEMAYORAN,GUNUNG SAHARI SELATAN,19199,6973,12226,8099,20325,2021-09-02
3171021004,JAKARTA PUSAT,SAWAH BESAR,GUNUNG SAHARI UTARA,16650,5216,11434,8131,19565,2021-09-02
3175081004,JAKARTA TIMUR,MAKASAR,HALIM PERDANA KUSUMAH,28363,7878,20485,15966,36451,2021-09-02
3171031003,JAKARTA PUSAT,KEMAYORAN,HARAPAN MULIA,22557,8123,14434,9259,23693,2021-09-02
3174091001,JAKARTA SELATAN,JAGAKARSA,JAGAKARSA,62389,21868,40521,25932,66453,2021-09-02
3175021007,JAKARTA TIMUR,PULO GADUNG,JATI,32757,11889,20868,13405,34273,2021-09-02
3174041002,JAKARTA SELATAN,PASAR MINGGU,JATI PADANG,37502,13853,23649,14968,38617,2021-09-02
3173071004,JAKARTA BARAT,PALMERAH,JATI PULO,28738,9757,18981,11370,30351,2021-09-02
3175061001,JAKARTA TIMUR,CAKUNG,JATINEGARA,84160,31521,52639,33842,86481,2021-09-02
3175021004,JAKARTA TIMUR,PULO GADUNG,JATINEGARA KAUM,24632,8332,16300,9305,25605,2021-09-02
3173021004,JAKARTA BARAT,GROGOL PETAMBURAN,JELAMBAR,30266,10746,19520,13483,33003,2021-09-02
3173021006,JAKARTA BARAT,GROGOL PETAMBURAN,JELAMBAR BARU,38246,13609,24637,16608,41245,2021-09-02
3173041006,JAKARTA BARAT,TAMBORA,JEMBATAN BESI,29314,11946,17368,9486,26854,2021-09-02
3173041008,JAKARTA BARAT,TAMBORA,JEMBATAN LIMA,21021,8119,12902,7446,20348,2021-09-02
3173081005,JAKARTA BARAT,KEMBANGAN,JOGLO,40839,14849,25990,15817,41807,2021-09-02
3171081001,JAKARTA PUSAT,JOHAR BARU,JOHAR BARU,37488,12063,25425,16438,41863,2021-09-02
3173041002,JAKARTA BARAT,TAMBORA,KALI ANYAR,23856,8096,15760,8915,24675,2021-09-02
3172041004,JAKARTA UTARA,CILINCING,KALIBARU,67684,27388,40296,22394,62690,2021-09-02
3174081002,JAKARTA SELATAN,PANCORAN,KALIBATA,41994,17423,24571,13218,37789,2021-09-02
3173061001,JAKARTA BARAT,KALI DERES,KALIDERES,72447,26598,45849,30977,76826,2021-09-02
3175051004,JAKARTA TIMUR,PASAR REBO,KALISARI,43212,14795,28417,18924,47341,2021-09-02
3173061004,JAKARTA BARAT,KALI DERES,KAMAL,53783,20235,33548,18824,52372,2021-09-02
3172011002,JAKARTA UTARA,PENJARINGAN,KAMAL MUARA,12930,3461,9469,6785,16254,2021-09-02
3171071007,JAKARTA PUSAT,TANAH ABANG,KAMPUNG BALI,11358,4465,6893,4125,11018,2021-09-02
3175031001,JAKARTA TIMUR,JATINEGARA,KAMPUNG MELAYU,25717,10491,15226,8913,24139,2021-09-02
3171081002,JAKARTA PUSAT,JOHAR BARU,KAMPUNG RAWA,21237,5760,15477,9197,24674,2021-09-02
3175041002,JAKARTA TIMUR,KRAMAT JATI,KAMPUNG TENGAH,43993,17901,26092,14498,40590,2021-09-02
3173011005,JAKARTA BARAT,CENGKARENG,KAPUK,134466,52063,82403,44711,127114,2021-09-02
3172011003,JAKARTA UTARA,PENJARINGAN,KAPUK MUARA,35781,11235,24546,17917,42463,2021-09-02
3171021002,JAKARTA PUSAT,SAWAH BESAR,KARANG ANYAR,25761,8654,17107,10943,28050,2021-09-02
3174021004,JAKARTA SELATAN,SETIA BUDI,KARET,9623,3638,5985,3900,9885,2021-09-02
3174021003,JAKARTA SELATAN,SETIA BUDI,KARET KUNINGAN,16055,5383,10672,6914,17586,2021-09-02
3174021002,JAKARTA SELATAN,SETIA BUDI,KARET SEMANGGI,2770,957,1813,1344,3157,2021-09-02
3171071003,JAKARTA PUSAT,TANAH ABANG,KARET TENGSIN,19271,7024,12247,7717,19964,2021-09-02
3171021003,JAKARTA PUSAT,SAWAH BESAR,KARTINI,22292,7778,14514,9790,24304,2021-09-02
3175011003,JAKARTA TIMUR,MATRAMAN,KAYU MANIS,25284,9978,15306,8741,24047,2021-09-02
3175021006,JAKARTA TIMUR,PULO GADUNG,KAYU PUTIH,40696,14020,26676,18293,44969,2021-09-02
3173031006,JAKARTA BARAT,TAMAN SARI,KEAGUNGAN,17387,5982,11405,7342,18747,2021-09-02
3174041007,JAKARTA SELATAN,PASAR MINGGU,KEBAGUSAN,44552,17130,27422,16300,43722,2021-09-02
3174051006,JAKARTA SELATAN,KEBAYORAN LAMA,KEBAYORAN LAMA SELATAN,41212,14811,26401,15590,41991,2021-09-02
3174051001,JAKARTA SELATAN,KEBAYORAN LAMA,KEBAYORAN LAMA UTARA,42422,16611,25811,14127,39938,2021-09-02
3174011004,JAKARTA SELATAN,TEBET,KEBON BARU,35165,12986,22179,13350,35529,2021-09-02
3172021005,JAKARTA UTARA,TANJUNG PRIOK,KEBON BAWANG,50952,18365,32587,20650,53237,2021-09-02
3173051001,JAKARTA BARAT,KEBON JERUK,KEBON JERUK,53887,20594,33293,20113,53406,2021-09-02
3171071006,JAKARTA PUSAT,TANAH ABANG,KEBON KACANG,21531,9103,12428,7538,19966,2021-09-02
3171011005,JAKARTA PUSAT,GAMBIR,KEBON KELAPA,10163,3590,6573,4214,10787,2021-09-02
3171031002,JAKARTA PUSAT,KEMAYORAN,KEBON KOSONG,30019,10851,19168,11989,31157,2021-09-02
3175011005,JAKARTA TIMUR,MATRAMAN,KEBON MANGGIS,16490,5940,10550,6804,17354,2021-09-02
3171071005,JAKARTA PUSAT,TANAH ABANG,KEBON MELATI,32206,14295,17911,10336,28247,2021-09-02
3175081003,JAKARTA TIMUR,MAKASAR,KEBON PALA,46614,16890,29724,17683,47407,2021-09-02
3171061005,JAKARTA PUSAT,MENTENG,KEBON SIRIH,12299,4595,7704,4821,12525,2021-09-02
3173011004,JAKARTA BARAT,CENGKARENG,KEDAUNG KALI ANGKE,32612,10653,21959,14139,36098,2021-09-02
3173051007,JAKARTA BARAT,KEBON JERUK,KEDOYA SELATAN,32165,11124,21041,12918,33959,2021-09-02
3173051006,JAKARTA BARAT,KEBON JERUK,KEDOYA UTARA,45740,14938,30802,20671,51473,2021-09-02
3173051004,JAKARTA BARAT,KEBON JERUK,KELAPA DUA,23565,8833,14732,8756,23488,2021-09-02
3175091003,JAKARTA TIMUR,CIRACAS,KELAPA DUA WETAN,46875,15273,31602,20003,51605,2021-09-02
3172061003,JAKARTA UTARA,KELAPA GADING,KELAPA GADING BARAT,35717,11289,24428,18208,42636,2021-09-02
3172061001,JAKARTA UTARA,KELAPA GADING,KELAPA GADING TIMUR,33592,9778,23814,17490,41304,2021-09-02
3173071005,JAKARTA BARAT,PALMERAH,KEMANGGISAN,32139,11563,20576,12712,33288,2021-09-02
3171031001,JAKARTA PUSAT,KEMAYORAN,KEMAYORAN,20708,7225,13483,8761,22244,2021-09-02
3173081006,JAKARTA BARAT,KEMBANGAN,KEMBANGAN SELATAN,27130,9763,17367,12055,29422,2021-09-02
3173081001,JAKARTA BARAT,KEMBANGAN,KEMBANGAN UTARA,54451,19655,34796,22037,56833,2021-09-02
3171041002,JAKARTA PUSAT,SENEN,KENARI,9579,3337,6242,4156,10398,2021-09-02
3173041005,JAKARTA BARAT,TAMBORA,KERENDANG,19973,7006,12967,8110,21077,2021-09-02
3175071003,JAKARTA TIMUR,DUREN SAWIT,KLENDER,69978,28297,41681,23645,65326,2021-09-02
3172031001,JAKARTA UTARA,KOJA,KOJA,28175,10661,17514,11079,28593,2021-09-02
3173071006,JAKARTA BARAT,PALMERAH,KOTA BAMBU SELATAN,21158,7748,13410,7787,21197,2021-09-02
3173071003,JAKARTA BARAT,PALMERAH,KOTA BAMBU UTARA,24995,9313,15682,9353,25035,2021-09-02
3171041004,JAKARTA PUSAT,SENEN,KRAMAT,28835,10913,17922,10082,28004,2021-09-02
3175041001,JAKARTA TIMUR,KRAMAT JATI,KRAMAT JATI,34144,12578,21566,12451,34017,2021-09-02
3174071003,JAKARTA SELATAN,KEBAYORAN BARU,KRAMAT PELA,14413,5032,9381,5951,15332,2021-09-02
3173031002,JAKARTA BARAT,TAMAN SARI,KRUKUT,19244,6735,12509,7720,20229,2021-09-02
3174031005,JAKARTA SELATAN,MAMPANG PRAPATAN,KUNINGAN BARAT,12785,4493,8292,5131,13423,2021-09-02
3174021008,JAKARTA SELATAN,SETIA BUDI,KUNINGAN TIMUR,6008,2151,3857,2535,6392,2021-09-02
3171041005,JAKARTA PUSAT,SENEN,KWITANG,15486,5611,9875,6222,16097,2021-09-02
3172031003,JAKARTA UTARA,KOJA,LAGOA,59065,22789,36276,21919,58195,2021-09-02
3174061002,JAKARTA SELATAN,CILANDAK,LEBAK BULUS,37626,14323,23303,14743,38046,2021-09-02
3174091004,JAKARTA SELATAN,JAGAKARSA,LENTENG AGUNG,53946,20572,33374,18889,52263,2021-09-02
3175101007,JAKARTA TIMUR,CIPAYUNG,LUBANG BUAYA,63547,21360,42187,26904,69091,2021-09-02
3175081001,JAKARTA TIMUR,MAKASAR,MAKASAR,34390,11986,22404,14273,36677,2021-09-02
3175071006,JAKARTA TIMUR,DUREN SAWIT,MALAKA JAYA,30927,11344,19583,13505,33088,2021-09-02
3175071005,JAKARTA TIMUR,DUREN SAWIT,MALAKA SARI,27530,9725,17805,12313,30118,2021-09-02
3174031001,JAKARTA SELATAN,MAMPANG PRAPATAN,MAMPANG PRAPATAN,18159,6684,11475,7263,18738,2021-09-02
3173031005,JAKARTA BARAT,TAMAN SARI,MANGGA BESAR,7707,2372,5335,3638,8973,2021-09-02
3171021005,JAKARTA PUSAT,SAWAH BESAR,MANGGA DUA SELATAN,27442,9538,17904,11701,29605,2021-09-02
3174011007,JAKARTA SELATAN,TEBET,MANGGARAI,28373,9639,18734,10808,29542,2021-09-02
3174011006,JAKARTA SELATAN,TEBET,MANGGARAI SELATAN,23075,8076,14999,9182,24181,2021-09-02
3173031003,JAKARTA BARAT,TAMAN SARI,MAPHAR,16461,5858,10603,7054,17657,2021-09-02
3172041003,JAKARTA UTARA,CILINCING,MARUNDA,28943,10021,18922,9474,28396,2021-09-02
3174071001,JAKARTA SELATAN,KEBAYORAN BARU,MELAWAI,2627,898,1729,1363,3092,2021-09-02
3171061001,JAKARTA PUSAT,MENTENG,MENTENG,25624,9811,15813,9842,25655,2021-09-02
3174021005,JAKARTA SELATAN,SETIA BUDI,MENTENG ATAS,27816,9565,18251,11064,29315,2021-09-02
3174011003,JAKARTA SELATAN,TEBET,MENTENG DALAM,36028,13207,22821,14019,36840,2021-09-02
3173081003,JAKARTA BARAT,KEMBANGAN,MERUYA SELATAN,32130,11712,20418,12852,33270,2021-09-02
3173081002,JAKARTA BARAT,KEMBANGAN,MERUYA UTARA,43752,16171,27581,18415,45996,2021-09-02
3175101004,JAKARTA TIMUR,CIPAYUNG,MUNJUL,23871,8089,15782,10425,26207,2021-09-02
3172051002,JAKARTA UTARA,PADEMANGAN,PADEMANGAN BARAT,74240,27858,46382,29067,75449,2021-09-02
3172051001,JAKARTA UTARA,PADEMANGAN,PADEMANGAN TIMUR,37736,11826,25910,17868,43778,2021-09-02
3175011004,JAKARTA TIMUR,MATRAMAN,PAL MERIAM,19769,7696,12073,7347,19420,2021-09-02
3173071001,JAKARTA BARAT,PALMERAH,PALMERAH,63011,23348,39663,23726,63389,2021-09-02
3174081001,JAKARTA SELATAN,PANCORAN,PANCORAN,19421,7243,12178,7362,19540,2021-09-02
3172021003,JAKARTA UTARA,TANJUNG PRIOK,PAPANGGO,39097,13099,25998,16463,42461,2021-09-02
3171021001,JAKARTA PUSAT,SAWAH BESAR,PASAR BARU,12035,3777,8258,5848,14106,2021-09-02
3174021006,JAKARTA SELATAN,SETIA BUDI,PASAR MANGGIS,26752,9821,16931,10314,27245,2021-09-02
3174041001,JAKARTA SELATAN,PASAR MINGGU,PASAR MINGGU,24821,9097,15724,10134,25858,2021-09-02
3171041003,JAKARTA PUSAT,SENEN,PASEBAN,23533,8703,14830,9154,23984,2021-09-02
3173061005,JAKARTA BARAT,KALI DERES,PEGADUNGAN,75587,25635,49952,33243,83195,2021-09-02
3171061002,JAKARTA PUSAT,MENTENG,PEGANGSAAN,23455,8836,14619,8531,23150,2021-09-02
3172061002,JAKARTA UTARA,KELAPA GADING,PEGANGSAAN DUA,49976,14427,35549,25563,61112,2021-09-02
3172011004,JAKARTA UTARA,PENJARINGAN,PEJAGALAN,74578,26599,47979,31803,79782,2021-09-02
3174041006,JAKARTA SELATAN,PASAR MINGGU,PEJATEN BARAT,37346,14085,23261,14593,37854,2021-09-02
3174041005,JAKARTA SELATAN,PASAR MINGGU,PEJATEN TIMUR,57656,22645,35011,19646,54657,2021-09-02
3175051005,JAKARTA TIMUR,PASAR REBO,PEKAYON,43250,14661,28589,18483,47072,2021-09-02
3173041009,JAKARTA BARAT,TAMBORA,PEKOJAN,23587,7828,15759,10502,26261,2021-09-02
3174031003,JAKARTA SELATAN,MAMPANG PRAPATAN,PELA MAMPANG,43522,15817,27705,18014,45719,2021-09-02
3174081005,JAKARTA SELATAN,PANCORAN,PENGADEGAN,21478,7216,14262,7788,22050,2021-09-02
3175061003,JAKARTA TIMUR,CAKUNG,PENGGILINGAN,99255,40111,59144,33728,92872,2021-09-02
3172011001,JAKARTA UTARA,PENJARINGAN,PENJARINGAN,88308,34715,53593,31528,85121,2021-09-02
3174101001,JAKARTA SELATAN,PESANGGRAHAN,PESANGGRAHAN,27545,9486,18059,11301,29360,2021-09-02
3171071004,JAKARTA PUSAT,TANAH ABANG,PETAMBURAN,33271,14878,18393,10425,28818,2021-09-02
3174071008,JAKARTA SELATAN,KEBAYORAN BARU,PETOGOGAN,11499,4289,7210,4693,11903,2021-09-02
3171011004,JAKARTA PUSAT,GAMBIR,PETOJO SELATAN,14692,5439,9253,6052,15305,2021-09-02
3171011003,JAKARTA PUSAT,GAMBIR,PETOJO UTARA,17458,6346,11112,6725,17837,2021-09-02
3174101004,JAKARTA SELATAN,PESANGGRAHAN,PETUKANGAN SELATAN,37187,13746,23441,14080,37521,2021-09-02
3174101003,JAKARTA SELATAN,PESANGGRAHAN,PETUKANGAN UTARA,53716,21040,32676,19781,52457,2021-09-02
3175081002,JAKARTA TIMUR,MAKASAR,PINANG RANTI,27198,9916,17282,11143,28425,2021-09-02
3173031008,JAKARTA BARAT,TAMAN SARI,PINANGSIA,10729,3406,7323,4757,12080,2021-09-02
3175011001,JAKARTA TIMUR,MATRAMAN,PISANGAN BARU,31776,12254,19522,10953,30475,2021-09-02
3175021002,JAKARTA TIMUR,PULO GADUNG,PISANGAN TIMUR,41011,14317,26694,16610,43304,2021-09-02
3172011005,JAKARTA UTARA,PENJARINGAN,PLUIT,47783,15826,31957,23095,55052,2021-09-02
3175071002,JAKARTA TIMUR,DUREN SAWIT,PONDOK BAMBU,61550,24038,37512,22500,60012,2021-09-02
3175071004,JAKARTA TIMUR,DUREN SAWIT,PONDOK KELAPA,72015,26440,45575,28090,73665,2021-09-02
3175071007,JAKARTA TIMUR,DUREN SAWIT,PONDOK KOPI,35367,14744,20623,12293,32916,2021-09-02
3174061003,JAKARTA SELATAN,CILANDAK,PONDOK LABU,46464,16161,30303,20191,50494,2021-09-02
3174051002,JAKARTA SELATAN,KEBAYORAN LAMA,PONDOK PINANG,56169,20948,35221,22030,57251,2021-09-02
3175101003,JAKARTA TIMUR,CIPAYUNG,PONDOK RANGGON,25574,8915,16659,10708,27367,2021-09-02
3101011003,KAB.ADM.KEP.SERIBU,KEP. SERIBU UTARA,PULAU HARAPAN,2060,337,1723,1016,2739,2021-09-02
3101011002,KAB.ADM.KEP.SERIBU,KEP. SERIBU UTARA,PULAU KELAPA,5528,900,4628,2635,7263,2021-09-02
3101011001,KAB.ADM.KEP.SERIBU,KEP. SERIBU UTARA,PULAU PANGGANG,5450,849,4601,2149,6750,2021-09-02
3101021003,KAB.ADM.KEP.SERIBU,KEP. SERIBU SELATAN,PULAU PARI,2765,320,2445,1419,3864,2021-09-02
3101021002,KAB.ADM.KEP.SERIBU,KEP. SERIBU SELATAN,PULAU TIDUNG,4553,619,3934,2647,6581,2021-09-02
3101021001,KAB.ADM.KEP.SERIBU,KEP. SERIBU SELATAN,PULAU UNTUNG JAWA,1941,322,1619,975,2594,2021-09-02
3174071007,JAKARTA SELATAN,KEBAYORAN BARU,PULO,5835,1967,3868,2813,6681,2021-09-02
3175021001,JAKARTA TIMUR,PULO GADUNG,PULO GADUNG,34422,12672,21750,13299,35049,2021-09-02
3175061005,JAKARTA TIMUR,CAKUNG,PULO GEBANG,97301,36464,60837,36694,97531,2021-09-02
3174041004,JAKARTA SELATAN,PASAR MINGGU,RAGUNAN,39616,13971,25645,16269,41914,2021-09-02
3175091005,JAKARTA TIMUR,CIRACAS,RAMBUTAN,36771,14801,21970,13410,35380,2021-09-02
3172031006,JAKARTA UTARA,KOJA,RAWA BADAK SELATAN,42179,16493,25686,15414,41100,2021-09-02
3172031004,JAKARTA UTARA,KOJA,RAWA BADAK UTARA,34408,13147,21261,13036,34297,2021-09-02
3174071005,JAKARTA SELATAN,KEBAYORAN BARU,RAWA BARAT,5625,1889,3736,2562,6298,2021-09-02
3173011003,JAKARTA BARAT,CENGKARENG,RAWA BUAYA,63799,23189,40610,23213,63823,2021-09-02
3175031004,JAKARTA TIMUR,JATINEGARA,RAWA BUNGA,21434,8495,12939,8012,20951,2021-09-02
3174081003,JAKARTA SELATAN,PANCORAN,RAWA JATI,20509,7434,13075,7685,20760,2021-09-02
3175061002,JAKARTA TIMUR,CAKUNG,RAWA TERATE,24637,8108,16529,11007,27536,2021-09-02
3175021005,JAKARTA TIMUR,PULO GADUNG,RAWAMANGUN,37612,13862,23750,15509,39259,2021-09-02
3171051003,JAKARTA PUSAT,CEMPAKA PUTIH,RAWASARI,21967,8147,13820,9261,23081,2021-09-02
3173041010,JAKARTA BARAT,TAMBORA,ROA MALAKA,3484,1045,2439,1692,4131,2021-09-02
3172041006,JAKARTA UTARA,CILINCING,ROROTAN,41668,14072,27596,16298,43894,2021-09-02
3174071004,JAKARTA SELATAN,KEBAYORAN BARU,SELONG,2842,978,1864,1399,3263,2021-09-02
3173061002,JAKARTA BARAT,KALI DERES,SEMANAN,71354,27022,44332,25149,69481,2021-09-02
3172041007,JAKARTA UTARA,CILINCING,SEMPER BARAT,68587,22924,45663,29541,75204,2021-09-02
3172041005,JAKARTA UTARA,CILINCING,SEMPER TIMUR,36267,12680,23587,14237,37824,2021-09-02
3174071006,JAKARTA SELATAN,KEBAYORAN BARU,SENAYAN,2771,1123,1648,1089,2737,2021-09-02
3171041001,JAKARTA PUSAT,SENEN,SENEN,6804,2334,4470,3023,7493,2021-09-02
3171031004,JAKARTA PUSAT,KEMAYORAN,SERDANG,29668,10734,18934,11686,30620,2021-09-02
3174021001,JAKARTA SELATAN,SETIA BUDI,SETIA BUDI,3023,1122,1901,1276,3177,2021-09-02
3175101005,JAKARTA TIMUR,CIPAYUNG,SETU,20572,7723,12849,7754,20603,2021-09-02
3173071002,JAKARTA BARAT,PALMERAH,SLIPI,16591,5682,10909,7000,17909,2021-09-02
3173081004,JAKARTA BARAT,KEMBANGAN,SRENGSENG,45523,17284,28239,17684,45923,2021-09-02
3174091002,JAKARTA SELATAN,JAGAKARSA,SRENGSENG SAWAH,58196,18939,39257,24321,63578,2021-09-02
3173051003,JAKARTA BARAT,KEBON JERUK,SUKABUMI SELATAN,37033,14434,22599,11646,34245,2021-09-02
3173051002,JAKARTA BARAT,KEBON JERUK,SUKABUMI UTARA,38290,15132,23158,11954,35112,2021-09-02
3172041002,JAKARTA UTARA,CILINCING,SUKAPURA,53949,19906,34043,21838,55881,2021-09-02
3171031007,JAKARTA PUSAT,KEMAYORAN,SUMUR BATU,22717,8319,14398,9411,23809,2021-09-02
3172021004,JAKARTA UTARA,TANJUNG PRIOK,SUNGAI BAMBU,29876,10602,19274,11889,31163,2021-09-02
3172021006,JAKARTA UTARA,TANJUNG PRIOK,SUNTER AGUNG,71805,22286,49519,34692,84211,2021-09-02
3172021002,JAKARTA UTARA,TANJUNG PRIOK,SUNTER JAYA,63031,20311,42720,29388,72108,2021-09-02
3175091004,JAKARTA TIMUR,CIRACAS,SUSUKAN,38257,12766,25491,15540,41031,2021-09-02
3173031001,JAKARTA BARAT,TAMAN SARI,TAMAN SARI,14348,5033,9315,6474,15789,2021-09-02
3173041001,JAKARTA BARAT,TAMBORA,TAMBORA,10204,3708,6496,3814,10310,2021-09-02
3173041004,JAKARTA BARAT,TAMBORA,TANAH SEREAL,26387,7968,18419,11908,30327,2021-09-02
3171081004,JAKARTA PUSAT,JOHAR BARU,TANAH TINGGI,37693,11588,26105,15552,41657,2021-09-02
3173031004,JAKARTA BARAT,TAMAN SARI,TANGKI,13324,4591,8733,5979,14712,2021-09-02
3174091005,JAKARTA SELATAN,JAGAKARSA,TANJUNG BARAT,39770,14182,25588,14751,40339,2021-09-02
3173021005,JAKARTA BARAT,GROGOL PETAMBURAN,TANJUNG DUREN SELATAN,25337,8881,16456,11097,27553,2021-09-02
3173021002,JAKARTA BARAT,GROGOL PETAMBURAN,TANJUNG DUREN UTARA,17010,5653,11357,7573,18930,2021-09-02
3172021001,JAKARTA UTARA,TANJUNG PRIOK,TANJUNG PRIOK,34588,11630,22958,13958,36916,2021-09-02
3174011002,JAKARTA SELATAN,TEBET,TEBET BARAT,21194,7106,14088,9262,23350,2021-09-02
3174011001,JAKARTA SELATAN,TEBET,TEBET TIMUR,18199,6100,12099,7929,20028,2021-09-02
3173061003,JAKARTA BARAT,KALI DERES,TEGAL ALUR,83647,30069,53578,29956,83534,2021-09-02
3174031004,JAKARTA SELATAN,MAMPANG PRAPATAN,TEGAL PARANG,32401,12734,19667,11318,30985,2021-09-02
3173021003,JAKARTA BARAT,GROGOL PETAMBURAN,TOMANG,29605,10275,19330,13269,32599,2021-09-02
3172031005,JAKARTA UTARA,KOJA,TUGU SELATAN,39122,14842,24280,14735,39015,2021-09-02
3172031002,JAKARTA UTARA,KOJA,TUGU UTARA,67670,26371,41299,25125,66424,2021-09-02
3175061006,JAKARTA TIMUR,CAKUNG,UJUNG MENTENG,29934,9993,19941,12824,32765,2021-09-02
3174101005,JAKARTA SELATAN,PESANGGRAHAN,ULUJAMI,40544,16247,24297,13934,38231,2021-09-02
3175011006,JAKARTA TIMUR,MATRAMAN,UTAN KAYU SELATAN,33511,11824,21687,13254,34941,2021-09-02
3175011002,JAKARTA TIMUR,MATRAMAN,UTAN KAYU UTARA,28169,10813,17356,10373,27729,2021-09-02
3171031008,JAKARTA PUSAT,KEMAYORAN,UTAN PANJANG,29208,10959,18249,11546,29795,2021-09-02
3172021007,JAKARTA UTARA,TANJUNG PRIOK,WARAKAS,44401,15128,29273,17732,47005,2021-09-02
3173021007,JAKARTA BARAT,GROGOL PETAMBURAN,WIJAYA KUSUMA,38934,14371,24563,16384,40947,2021-09-02
3172051003,JAKARTA UTARA,PADEMANGAN,ANCOL,23947,9067,14880,9678,24558,2021-09-03
3173041007,JAKARTA BARAT,TAMBORA,ANGKE,29381,10275,19106,11138,30244,2021-09-03
3175041005,JAKARTA TIMUR,KRAMAT JATI,BALE KAMBANG,29074,12345,16729,8480,25209,2021-09-03
3175031003,JAKARTA TIMUR,JATINEGARA,BALI MESTER,9752,3664,6088,3894,9982,2021-09-03
3175101006,JAKARTA TIMUR,CIPAYUNG,BAMBU APUS,26285,9218,17067,11250,28317,2021-09-03
3174031002,JAKARTA SELATAN,MAMPANG PRAPATAN,BANGKA,21566,8328,13238,8237,21475,2021-09-03
3175051002,JAKARTA TIMUR,PASAR REBO,BARU,23886,7578,16308,11794,28102,2021-09-03
3175041004,JAKARTA TIMUR,KRAMAT JATI,BATU AMPAR,47898,19609,28289,16546,44835,2021-09-03
3171071002,JAKARTA PUSAT,TANAH ABANG,BENDUNGAN HILIR,21494,7947,13547,8993,22540,2021-09-03
3175031002,JAKARTA TIMUR,JATINEGARA,BIDARA CINA,36689,15143,21546,13115,34661,2021-09-03
3174101002,JAKARTA SELATAN,PESANGGRAHAN,BINTARO,53098,20033,33065,20963,54028,2021-09-03
3174011005,JAKARTA SELATAN,TEBET,BUKIT DURI,34183,13349,20834,12044,32878,2021-09-03
3171041006,JAKARTA PUSAT,SENEN,BUNGUR,18144,6416,11728,7659,19387,2021-09-03
3175061007,JAKARTA TIMUR,CAKUNG,CAKUNG BARAT,57724,19376,38348,24097,62445,2021-09-03
3175061004,JAKARTA TIMUR,CAKUNG,CAKUNG TIMUR,58287,19957,38330,26142,64472,2021-09-03
3175041007,JAKARTA TIMUR,KRAMAT JATI,CAWANG,32762,12629,20133,12358,32491,2021-09-03
3175101008,JAKARTA TIMUR,CIPAYUNG,CEGER,18932,6595,12337,8323,20660,2021-09-03
3171031006,JAKARTA PUSAT,KEMAYORAN,CEMPAKA BARU,32581,11955,20626,12552,33178,2021-09-03
3171051002,JAKARTA PUSAT,CEMPAKA PUTIH,CEMPAKA PUTIH BARAT,35885,13175,22710,15796,38506,2021-09-03
3171051001,JAKARTA PUSAT,CEMPAKA PUTIH,CEMPAKA PUTIH TIMUR,24292,8595,15697,10665,26362,2021-09-03
3173011001,JAKARTA BARAT,CENGKARENG,CENGKARENG BARAT,66284,23185,43099,28138,71237,2021-09-03
3173011006,JAKARTA BARAT,CENGKARENG,CENGKARENG TIMUR,81027,27891,53136,30575,83711,2021-09-03
3175091002,JAKARTA TIMUR,CIRACAS,CIBUBUR,66364,21911,44453,29554,74007,2021-09-03
3171011002,JAKARTA PUSAT,GAMBIR,CIDENG,15390,5165,10225,7015,17240,2021-09-03
3174091003,JAKARTA SELATAN,JAGAKARSA,CIGANJUR,38497,13922,24575,14673,39248,2021-09-03
3175051003,JAKARTA TIMUR,PASAR REBO,CIJANTUNG,41419,13796,27623,18409,46032,2021-09-03
3171061003,JAKARTA PUSAT,MENTENG,CIKINI,8274,2970,5304,3296,8600,2021-09-03
3174081006,JAKARTA SELATAN,PANCORAN,CIKOKO,10547,3635,6912,4065,10977,2021-09-03
3174061001,JAKARTA SELATAN,CILANDAK,CILANDAK BARAT,51752,18626,33126,20904,54030,2021-09-03
3174041003,JAKARTA SELATAN,PASAR MINGGU,CILANDAK TIMUR,25145,8942,16203,10841,27044,2021-09-03
3175101002,JAKARTA TIMUR,CIPAYUNG,CILANGKAP,27635,9471,18164,12122,30286,2021-09-03
3175041006,JAKARTA TIMUR,KRAMAT JATI,CILILITAN,40181,16114,24067,15213,39280,2021-09-03
3172041001,JAKARTA UTARA,CILINCING,CILINCING,43609,16529,27080,16082,43162,2021-09-03
3175101001,JAKARTA TIMUR,CIPAYUNG,CIPAYUNG,26104,8294,17810,12163,29973,2021-09-03
3174091006,JAKARTA SELATAN,JAGAKARSA,CIPEDAK,38303,12881,25422,15906,41328,2021-09-03
3174061005,JAKARTA SELATAN,CILANDAK,CIPETE SELATAN,26704,10050,16654,11247,27901,2021-09-03
3174071010,JAKARTA SELATAN,KEBAYORAN BARU,CIPETE UTARA,34102,12514,21588,13451,35039,2021-09-03
3175021003,JAKARTA TIMUR,PULO GADUNG,CIPINANG,39306,14439,24867,15962,40829,2021-09-03
3175031007,JAKARTA TIMUR,JATINEGARA,CIPINANG BESAR SELATAN,35212,14068,21144,12305,33449,2021-09-03
3175031008,JAKARTA TIMUR,JATINEGARA,CIPINANG BESAR UTARA,45319,18112,27207,16134,43341,2021-09-03
3175031005,JAKARTA TIMUR,JATINEGARA,CIPINANG CEMPEDAK,32824,13135,19689,13016,32705,2021-09-03
3175081005,JAKARTA TIMUR,MAKASAR,CIPINANG MELAYU,42308,15833,26475,17726,44201,2021-09-03
3175031006,JAKARTA TIMUR,JATINEGARA,CIPINANG MUARA,55243,21979,33264,20678,53942,2021-09-03
3174051003,JAKARTA SELATAN,KEBAYORAN LAMA,CIPULIR,39937,16032,23905,13208,37113,2021-09-03
3175091001,JAKARTA TIMUR,CIRACAS,CIRACAS,64594,21207,43387,27411,70798,2021-09-03
3175041003,JAKARTA TIMUR,KRAMAT JATI,DUKUH,24609,8513,16096,10569,26665,2021-09-03
3175071001,JAKARTA TIMUR,DUREN SAWIT,DUREN SAWIT,61160,24056,37104,23303,60407,2021-09-03
3174081004,JAKARTA SELATAN,PANCORAN,DUREN TIGA,28319,10534,17785,9661,27446,2021-09-03
3173051005,JAKARTA BARAT,KEBON JERUK,DURI KEPA,60138,20587,39551,26303,65854,2021-09-03
3173011002,JAKARTA BARAT,CENGKARENG,DURI KOSAMBI,77923,30076,47847,27963,75810,2021-09-03
3171011006,JAKARTA PUSAT,GAMBIR,DURI PULO,19610,6939,12671,7850,20521,2021-09-03
3173041011,JAKARTA BARAT,TAMBORA,DURI SELATAN,14259,4594,9665,6384,16049,2021-09-03
3173041003,JAKARTA BARAT,TAMBORA,DURI UTARA,19844,6724,13120,8287,21407,2021-09-03
3171081003,JAKARTA PUSAT,JOHAR BARU,GALUR,18243,5648,12595,7816,20411,2021-09-03
3171011001,JAKARTA PUSAT,GAMBIR,GAMBIR,2191,738,1453,992,2445,2021-09-03
3174061004,JAKARTA SELATAN,CILANDAK,GANDARIA SELATAN,22119,8249,13870,8398,22268,2021-09-03
3174071009,JAKARTA SELATAN,KEBAYORAN BARU,GANDARIA UTARA,39922,15013,24909,15542,40451,2021-09-03
3175051001,JAKARTA TIMUR,PASAR REBO,GEDONG,35755,12512,23243,15360,38603,2021-09-03
3171071001,JAKARTA PUSAT,TANAH ABANG,GELORA,3127,1189,1938,1243,3181,2021-09-03
3173031007,JAKARTA BARAT,TAMAN SARI,GLODOK,7837,2360,5477,3974,9451,2021-09-03
3171061004,JAKARTA PUSAT,MENTENG,GONDANGDIA,4100,1486,2614,2001,4615,2021-09-03
3173021001,JAKARTA BARAT,GROGOL PETAMBURAN,GROGOL,16876,6051,10825,7128,17953,2021-09-03
3174051005,JAKARTA SELATAN,KEBAYORAN LAMA,GROGOL SELATAN,44251,16983,27268,15748,43016,2021-09-03
3174051004,JAKARTA SELATAN,KEBAYORAN LAMA,GROGOL UTARA,42494,16087,26407,15418,41825,2021-09-03
3174021007,JAKARTA SELATAN,SETIA BUDI,GUNTUR,3985,1383,2602,1855,4457,2021-09-03
3174071002,JAKARTA SELATAN,KEBAYORAN BARU,GUNUNG,9436,3336,6100,4247,10347,2021-09-03
3171031005,JAKARTA PUSAT,KEMAYORAN,GUNUNG SAHARI SELATAN,19199,6915,12284,8231,20515,2021-09-03
3171021004,JAKARTA PUSAT,SAWAH BESAR,GUNUNG SAHARI UTARA,16650,5187,11463,8329,19792,2021-09-03
3175081004,JAKARTA TIMUR,MAKASAR,HALIM PERDANA KUSUMAH,28363,7818,20545,16080,36625,2021-09-03
3171031003,JAKARTA PUSAT,KEMAYORAN,HARAPAN MULIA,22557,8066,14491,9392,23883,2021-09-03
3174091001,JAKARTA SELATAN,JAGAKARSA,JAGAKARSA,62389,21848,40541,26008,66549,2021-09-03
3175021007,JAKARTA TIMUR,PULO GADUNG,JATI,32757,11807,20950,13686,34636,2021-09-03
3174041002,JAKARTA SELATAN,PASAR MINGGU,JATI PADANG,37502,13841,23661,15016,38677,2021-09-03
3173071004,JAKARTA BARAT,PALMERAH,JATI PULO,28738,9703,19035,11642,30677,2021-09-03
3175061001,JAKARTA TIMUR,CAKUNG,JATINEGARA,84160,31342,52818,34736,87554,2021-09-03
3175021004,JAKARTA TIMUR,PULO GADUNG,JATINEGARA KAUM,24632,8282,16350,9480,25830,2021-09-03
3173021004,JAKARTA BARAT,GROGOL PETAMBURAN,JELAMBAR,30266,10694,19572,13747,33319,2021-09-03
3173021006,JAKARTA BARAT,GROGOL PETAMBURAN,JELAMBAR BARU,38246,13557,24689,16940,41629,2021-09-03
3173041006,JAKARTA BARAT,TAMBORA,JEMBATAN BESI,29314,11843,17471,9719,27190,2021-09-03
3173041008,JAKARTA BARAT,TAMBORA,JEMBATAN LIMA,21021,8082,12939,7620,20559,2021-09-03
3173081005,JAKARTA BARAT,KEMBANGAN,JOGLO,40839,14769,26070,16284,42354,2021-09-03
3171081001,JAKARTA PUSAT,JOHAR BARU,JOHAR BARU,37488,11983,25505,16722,42227,2021-09-03
3173041002,JAKARTA BARAT,TAMBORA,KALI ANYAR,23856,8071,15785,9087,24872,2021-09-03
3172041004,JAKARTA UTARA,CILINCING,KALIBARU,67684,27241,40443,22755,63198,2021-09-03
3174081002,JAKARTA SELATAN,PANCORAN,KALIBATA,41994,17396,24598,13248,37846,2021-09-03
3173061001,JAKARTA BARAT,KALI DERES,KALIDERES,72447,26487,45960,31817,77777,2021-09-03
3175051004,JAKARTA TIMUR,PASAR REBO,KALISARI,43212,14688,28524,19227,47751,2021-09-03
3173061004,JAKARTA BARAT,KALI DERES,KAMAL,53783,20116,33667,19633,53300,2021-09-03
3172011002,JAKARTA UTARA,PENJARINGAN,KAMAL MUARA,12930,3451,9479,6857,16336,2021-09-03
3171071007,JAKARTA PUSAT,TANAH ABANG,KAMPUNG BALI,11358,4449,6909,4195,11104,2021-09-03
3175031001,JAKARTA TIMUR,JATINEGARA,KAMPUNG MELAYU,25717,10437,15280,9228,24508,2021-09-03
3171081002,JAKARTA PUSAT,JOHAR BARU,KAMPUNG RAWA,21237,5732,15505,9370,24875,2021-09-03
3175041002,JAKARTA TIMUR,KRAMAT JATI,KAMPUNG TENGAH,43993,17798,26195,15068,41263,2021-09-03
3173011005,JAKARTA BARAT,CENGKARENG,KAPUK,134466,51883,82583,46304,128887,2021-09-03
3172011003,JAKARTA UTARA,PENJARINGAN,KAPUK MUARA,35781,11116,24665,18178,42843,2021-09-03
3171021002,JAKARTA PUSAT,SAWAH BESAR,KARANG ANYAR,25761,8607,17154,11130,28284,2021-09-03
3174021004,JAKARTA SELATAN,SETIA BUDI,KARET,9623,3631,5992,3919,9911,2021-09-03
3174021003,JAKARTA SELATAN,SETIA BUDI,KARET KUNINGAN,16055,5377,10678,6954,17632,2021-09-03
3174021002,JAKARTA SELATAN,SETIA BUDI,KARET SEMANGGI,2770,953,1817,1349,3166,2021-09-03
3171071003,JAKARTA PUSAT,TANAH ABANG,KARET TENGSIN,19271,7002,12269,7852,20121,2021-09-03
3171021003,JAKARTA PUSAT,SAWAH BESAR,KARTINI,22292,7737,14555,9997,24552,2021-09-03
3175011003,JAKARTA TIMUR,MATRAMAN,KAYU MANIS,25284,9934,15350,8934,24284,2021-09-03
3175021006,JAKARTA TIMUR,PULO GADUNG,KAYU PUTIH,40696,13953,26743,18748,45491,2021-09-03
3173031006,JAKARTA BARAT,TAMAN SARI,KEAGUNGAN,17387,5942,11445,7476,18921,2021-09-03
3174041007,JAKARTA SELATAN,PASAR MINGGU,KEBAGUSAN,44552,17117,27435,16338,43773,2021-09-03
3174051006,JAKARTA SELATAN,KEBAYORAN LAMA,KEBAYORAN LAMA SELATAN,41212,14791,26421,15647,42068,2021-09-03
3174051001,JAKARTA SELATAN,KEBAYORAN LAMA,KEBAYORAN LAMA UTARA,42422,16591,25831,14172,40003,2021-09-03
3174011004,JAKARTA SELATAN,TEBET,KEBON BARU,35165,12965,22200,13404,35604,2021-09-03
3172021005,JAKARTA UTARA,TANJUNG PRIOK,KEBON BAWANG,50952,18241,32711,20985,53696,2021-09-03
3173051001,JAKARTA BARAT,KEBON JERUK,KEBON JERUK,53887,20492,33395,20525,53920,2021-09-03
3171071006,JAKARTA PUSAT,TANAH ABANG,KEBON KACANG,21531,9016,12515,7721,20236,2021-09-03
3171011005,JAKARTA PUSAT,GAMBIR,KEBON KELAPA,10163,3572,6591,4283,10874,2021-09-03
3171031002,JAKARTA PUSAT,KEMAYORAN,KEBON KOSONG,30019,10790,19229,12286,31515,2021-09-03
3175011005,JAKARTA TIMUR,MATRAMAN,KEBON MANGGIS,16490,5901,10589,6938,17527,2021-09-03
3171071005,JAKARTA PUSAT,TANAH ABANG,KEBON MELATI,32206,14206,18000,10646,28646,2021-09-03
3175081003,JAKARTA TIMUR,MAKASAR,KEBON PALA,46614,16794,29820,18157,47977,2021-09-03
3171061005,JAKARTA PUSAT,MENTENG,KEBON SIRIH,12299,4559,7740,4902,12642,2021-09-03
3173011004,JAKARTA BARAT,CENGKARENG,KEDAUNG KALI ANGKE,32612,10613,21999,14466,36465,2021-09-03
3173051007,JAKARTA BARAT,KEBON JERUK,KEDOYA SELATAN,32165,11071,21094,13194,34288,2021-09-03
3173051006,JAKARTA BARAT,KEBON JERUK,KEDOYA UTARA,45740,14868,30872,21072,51944,2021-09-03
3173051004,JAKARTA BARAT,KEBON JERUK,KELAPA DUA,23565,8798,14767,8932,23699,2021-09-03
3175091003,JAKARTA TIMUR,CIRACAS,KELAPA DUA WETAN,46875,15147,31728,20488,52216,2021-09-03
3172061003,JAKARTA UTARA,KELAPA GADING,KELAPA GADING BARAT,35717,11232,24485,18451,42936,2021-09-03
3172061001,JAKARTA UTARA,KELAPA GADING,KELAPA GADING TIMUR,33592,9668,23924,17868,41792,2021-09-03
3173071005,JAKARTA BARAT,PALMERAH,KEMANGGISAN,32139,11447,20692,13107,33799,2021-09-03
3171031001,JAKARTA PUSAT,KEMAYORAN,KEMAYORAN,20708,7141,13567,8985,22552,2021-09-03
3173081006,JAKARTA BARAT,KEMBANGAN,KEMBANGAN SELATAN,27130,9704,17426,12333,29759,2021-09-03
3173081001,JAKARTA BARAT,KEMBANGAN,KEMBANGAN UTARA,54451,19547,34904,22659,57563,2021-09-03
3171041002,JAKARTA PUSAT,SENEN,KENARI,9579,3317,6262,4325,10587,2021-09-03
3173041005,JAKARTA BARAT,TAMBORA,KERENDANG,19973,6981,12992,8248,21240,2021-09-03
3175071003,JAKARTA TIMUR,DUREN SAWIT,KLENDER,69978,28127,41851,24553,66404,2021-09-03
3172031001,JAKARTA UTARA,KOJA,KOJA,28175,10622,17553,11329,28882,2021-09-03
3173071006,JAKARTA BARAT,PALMERAH,KOTA BAMBU SELATAN,21158,7707,13451,7966,21417,2021-09-03
3173071003,JAKARTA BARAT,PALMERAH,KOTA BAMBU UTARA,24995,9245,15750,9558,25308,2021-09-03
3171041004,JAKARTA PUSAT,SENEN,KRAMAT,28835,10840,17995,10283,28278,2021-09-03
3175041001,JAKARTA TIMUR,KRAMAT JATI,KRAMAT JATI,34144,12480,21664,12803,34467,2021-09-03
3174071003,JAKARTA SELATAN,KEBAYORAN BARU,KRAMAT PELA,14413,5029,9384,5970,15354,2021-09-03
3173031002,JAKARTA BARAT,TAMAN SARI,KRUKUT,19244,6699,12545,7930,20475,2021-09-03
3174031005,JAKARTA SELATAN,MAMPANG PRAPATAN,KUNINGAN BARAT,12785,4484,8301,5144,13445,2021-09-03
3174021008,JAKARTA SELATAN,SETIA BUDI,KUNINGAN TIMUR,6008,2149,3859,2550,6409,2021-09-03
3171041005,JAKARTA PUSAT,SENEN,KWITANG,15486,5579,9907,6359,16266,2021-09-03
3172031003,JAKARTA UTARA,KOJA,LAGOA,59065,22697,36368,22205,58573,2021-09-03
3174061002,JAKARTA SELATAN,CILANDAK,LEBAK BULUS,37626,14314,23312,14799,38111,2021-09-03
3174091004,JAKARTA SELATAN,JAGAKARSA,LENTENG AGUNG,53946,20551,33395,18943,52338,2021-09-03
3175101007,JAKARTA TIMUR,CIPAYUNG,LUBANG BUAYA,63547,21244,42303,27359,69662,2021-09-03
3175081001,JAKARTA TIMUR,MAKASAR,MAKASAR,34390,11918,22472,14603,37075,2021-09-03
3175071006,JAKARTA TIMUR,DUREN SAWIT,MALAKA JAYA,30927,11249,19678,13753,33431,2021-09-03
3175071005,JAKARTA TIMUR,DUREN SAWIT,MALAKA SARI,27530,9655,17875,12603,30478,2021-09-03
3174031001,JAKARTA SELATAN,MAMPANG PRAPATAN,MAMPANG PRAPATAN,18159,6678,11481,7282,18763,2021-09-03
3173031005,JAKARTA BARAT,TAMAN SARI,MANGGA BESAR,7707,2346,5361,3716,9077,2021-09-03
3171021005,JAKARTA PUSAT,SAWAH BESAR,MANGGA DUA SELATAN,27442,9480,17962,11959,29921,2021-09-03
3174011007,JAKARTA SELATAN,TEBET,MANGGARAI,28373,9612,18761,10873,29634,2021-09-03
3174011006,JAKARTA SELATAN,TEBET,MANGGARAI SELATAN,23075,8065,15010,9229,24239,2021-09-03
3173031003,JAKARTA BARAT,TAMAN SARI,MAPHAR,16461,5820,10641,7137,17778,2021-09-03
3172041003,JAKARTA UTARA,CILINCING,MARUNDA,28943,9944,18999,9724,28723,2021-09-03
3174071001,JAKARTA SELATAN,KEBAYORAN BARU,MELAWAI,2627,897,1730,1365,3095,2021-09-03
3171061001,JAKARTA PUSAT,MENTENG,MENTENG,25624,9766,15858,10063,25921,2021-09-03
3174021005,JAKARTA SELATAN,SETIA BUDI,MENTENG ATAS,27816,9544,18272,11122,29394,2021-09-03
3174011003,JAKARTA SELATAN,TEBET,MENTENG DALAM,36028,13178,22850,14239,37089,2021-09-03
3173081003,JAKARTA BARAT,KEMBANGAN,MERUYA SELATAN,32130,11632,20498,13331,33829,2021-09-03
3173081002,JAKARTA BARAT,KEMBANGAN,MERUYA UTARA,43752,16075,27677,19138,46815,2021-09-03
3175101004,JAKARTA TIMUR,CIPAYUNG,MUNJUL,23871,8039,15832,10678,26510,2021-09-03
3172051002,JAKARTA UTARA,PADEMANGAN,PADEMANGAN BARAT,74240,27764,46476,29612,76088,2021-09-03
3172051001,JAKARTA UTARA,PADEMANGAN,PADEMANGAN TIMUR,37736,11774,25962,18188,44150,2021-09-03
3175011004,JAKARTA TIMUR,MATRAMAN,PAL MERIAM,19769,7664,12105,7485,19590,2021-09-03
3173071001,JAKARTA BARAT,PALMERAH,PALMERAH,63011,23199,39812,24404,64216,2021-09-03
3174081001,JAKARTA SELATAN,PANCORAN,PANCORAN,19421,7230,12191,7378,19569,2021-09-03
3172021003,JAKARTA UTARA,TANJUNG PRIOK,PAPANGGO,39097,13023,26074,16856,42930,2021-09-03
3171021001,JAKARTA PUSAT,SAWAH BESAR,PASAR BARU,12035,3761,8274,5937,14211,2021-09-03
3174021006,JAKARTA SELATAN,SETIA BUDI,PASAR MANGGIS,26752,9812,16940,10361,27301,2021-09-03
3174041001,JAKARTA SELATAN,PASAR MINGGU,PASAR MINGGU,24821,9081,15740,10176,25916,2021-09-03
3171041003,JAKARTA PUSAT,SENEN,PASEBAN,23533,8663,14870,9258,24128,2021-09-03
3173061005,JAKARTA BARAT,KALI DERES,PEGADUNGAN,75587,25500,50087,34297,84384,2021-09-03
3171061002,JAKARTA PUSAT,MENTENG,PEGANGSAAN,23455,8776,14679,8760,23439,2021-09-03
3172061002,JAKARTA UTARA,KELAPA GADING,PEGANGSAAN DUA,49976,14330,35646,26061,61707,2021-09-03
3172011004,JAKARTA UTARA,PENJARINGAN,PEJAGALAN,74578,26448,48130,32394,80524,2021-09-03
3174041006,JAKARTA SELATAN,PASAR MINGGU,PEJATEN BARAT,37346,14070,23276,14639,37915,2021-09-03
3174041005,JAKARTA SELATAN,PASAR MINGGU,PEJATEN TIMUR,57656,22608,35048,19745,54793,2021-09-03
3175051005,JAKARTA TIMUR,PASAR REBO,PEKAYON,43250,14547,28703,18861,47564,2021-09-03
3173041009,JAKARTA BARAT,TAMBORA,PEKOJAN,23587,7786,15801,10665,26466,2021-09-03
3174031003,JAKARTA SELATAN,MAMPANG PRAPATAN,PELA MAMPANG,43522,15789,27733,18045,45778,2021-09-03
3174081005,JAKARTA SELATAN,PANCORAN,PENGADEGAN,21478,7205,14273,7820,22093,2021-09-03
3175061003,JAKARTA TIMUR,CAKUNG,PENGGILINGAN,99255,39828,59427,34477,93904,2021-09-03
3172011001,JAKARTA UTARA,PENJARINGAN,PENJARINGAN,88308,34454,53854,32535,86389,2021-09-03
3174101001,JAKARTA SELATAN,PESANGGRAHAN,PESANGGRAHAN,27545,9478,18067,11332,29399,2021-09-03
3171071004,JAKARTA PUSAT,TANAH ABANG,PETAMBURAN,33271,14797,18474,10792,29266,2021-09-03
3174071008,JAKARTA SELATAN,KEBAYORAN BARU,PETOGOGAN,11499,4287,7212,4709,11921,2021-09-03
3171011004,JAKARTA PUSAT,GAMBIR,PETOJO SELATAN,14692,5420,9272,6151,15423,2021-09-03
3171011003,JAKARTA PUSAT,GAMBIR,PETOJO UTARA,17458,6319,11139,6927,18066,2021-09-03
3174101004,JAKARTA SELATAN,PESANGGRAHAN,PETUKANGAN SELATAN,37187,13732,23455,14129,37584,2021-09-03
3174101003,JAKARTA SELATAN,PESANGGRAHAN,PETUKANGAN UTARA,53716,21014,32702,19862,52564,2021-09-03
3175081002,JAKARTA TIMUR,MAKASAR,PINANG RANTI,27198,9826,17372,11404,28776,2021-09-03
3173031008,JAKARTA BARAT,TAMAN SARI,PINANGSIA,10729,3378,7351,4819,12170,2021-09-03
3175011001,JAKARTA TIMUR,MATRAMAN,PISANGAN BARU,31776,12191,19585,11302,30887,2021-09-03
3175021002,JAKARTA TIMUR,PULO GADUNG,PISANGAN TIMUR,41011,14199,26812,17309,44121,2021-09-03
3172011005,JAKARTA UTARA,PENJARINGAN,PLUIT,47783,15763,32020,23392,55412,2021-09-03
3175071002,JAKARTA TIMUR,DUREN SAWIT,PONDOK BAMBU,61550,23854,37696,23139,60835,2021-09-03
3175071004,JAKARTA TIMUR,DUREN SAWIT,PONDOK KELAPA,72015,26279,45736,28757,74493,2021-09-03
3175071007,JAKARTA TIMUR,DUREN SAWIT,PONDOK KOPI,35367,14650,20717,12494,33211,2021-09-03
3174061003,JAKARTA SELATAN,CILANDAK,PONDOK LABU,46464,16148,30316,20266,50582,2021-09-03
3174051002,JAKARTA SELATAN,KEBAYORAN LAMA,PONDOK PINANG,56169,20939,35230,22102,57332,2021-09-03
3175101003,JAKARTA TIMUR,CIPAYUNG,PONDOK RANGGON,25574,8861,16713,11044,27757,2021-09-03
3101011003,KAB.ADM.KEP.SERIBU,KEP. SERIBU UTARA,PULAU HARAPAN,2060,337,1723,1026,2749,2021-09-03
3101011002,KAB.ADM.KEP.SERIBU,KEP. SERIBU UTARA,PULAU KELAPA,5528,897,4631,2641,7272,2021-09-03
3101011001,KAB.ADM.KEP.SERIBU,KEP. SERIBU UTARA,PULAU PANGGANG,5450,844,4606,2169,6775,2021-09-03
3101021003,KAB.ADM.KEP.SERIBU,KEP. SERIBU SELATAN,PULAU PARI,2765,320,2445,1441,3886,2021-09-03
3101021002,KAB.ADM.KEP.SERIBU,KEP. SERIBU SELATAN,PULAU TIDUNG,4553,617,3936,2663,6599,2021-09-03
3101021001,KAB.ADM.KEP.SERIBU,KEP. SERIBU SELATAN,PULAU UNTUNG JAWA,1941,319,1622,1000,2622,2021-09-03
3174071007,JAKARTA SELATAN,KEBAYORAN BARU,PULO,5835,1966,3869,2816,6685,2021-09-03
3175021001,JAKARTA TIMUR,PULO GADUNG,PULO GADUNG,34422,12552,21870,13686,35556,2021-09-03
3175061005,JAKARTA TIMUR,CAKUNG,PULO GEBANG,97301,36070,61231,38248,99479,2021-09-03
3174041004,JAKARTA SELATAN,PASAR MINGGU,RAGUNAN,39616,13960,25656,16324,41980,2021-09-03
3175091005,JAKARTA TIMUR,CIRACAS,RAMBUTAN,36771,14669,22102,13766,35868,2021-09-03
3172031006,JAKARTA UTARA,KOJA,RAWA BADAK SELATAN,42179,16395,25784,15687,41471,2021-09-03
3172031004,JAKARTA UTARA,KOJA,RAWA BADAK UTARA,34408,13068,21340,13318,34658,2021-09-03
3174071005,JAKARTA SELATAN,KEBAYORAN BARU,RAWA BARAT,5625,1885,3740,2566,6306,2021-09-03
3173011003,JAKARTA BARAT,CENGKARENG,RAWA BUAYA,63799,23067,40732,23894,64626,2021-09-03
3175031004,JAKARTA TIMUR,JATINEGARA,RAWA BUNGA,21434,8447,12987,8197,21184,2021-09-03
3174081003,JAKARTA SELATAN,PANCORAN,RAWA JATI,20509,7419,13090,7718,20808,2021-09-03
3175061002,JAKARTA TIMUR,CAKUNG,RAWA TERATE,24637,8003,16634,11247,27881,2021-09-03
3175021005,JAKARTA TIMUR,PULO GADUNG,RAWAMANGUN,37612,13775,23837,15754,39591,2021-09-03
3171051003,JAKARTA PUSAT,CEMPAKA PUTIH,RAWASARI,21967,8085,13882,9415,23297,2021-09-03
3173041010,JAKARTA BARAT,TAMBORA,ROA MALAKA,3484,1041,2443,1728,4171,2021-09-03
3172041006,JAKARTA UTARA,CILINCING,ROROTAN,41668,13972,27696,16860,44556,2021-09-03
3174071004,JAKARTA SELATAN,KEBAYORAN BARU,SELONG,2842,978,1864,1404,3268,2021-09-03
3173061002,JAKARTA BARAT,KALI DERES,SEMANAN,71354,26919,44435,25867,70302,2021-09-03
3172041007,JAKARTA UTARA,CILINCING,SEMPER BARAT,68587,22781,45806,30017,75823,2021-09-03
3172041005,JAKARTA UTARA,CILINCING,SEMPER TIMUR,36267,12607,23660,14711,38371,2021-09-03
3174071006,JAKARTA SELATAN,KEBAYORAN BARU,SENAYAN,2771,1121,1650,1091,2741,2021-09-03
3171041001,JAKARTA PUSAT,SENEN,SENEN,6804,2318,4486,3094,7580,2021-09-03
3171031004,JAKARTA PUSAT,KEMAYORAN,SERDANG,29668,10645,19023,12017,31040,2021-09-03
3174021001,JAKARTA SELATAN,SETIA BUDI,SETIA BUDI,3023,1117,1906,1284,3190,2021-09-03
3175101005,JAKARTA TIMUR,CIPAYUNG,SETU,20572,7654,12918,8000,20918,2021-09-03
3173071002,JAKARTA BARAT,PALMERAH,SLIPI,16591,5632,10959,7136,18095,2021-09-03
3173081004,JAKARTA BARAT,KEMBANGAN,SRENGSENG,45523,17208,28315,18035,46350,2021-09-03
3174091002,JAKARTA SELATAN,JAGAKARSA,SRENGSENG SAWAH,58196,18921,39275,24375,63650,2021-09-03
3173051003,JAKARTA BARAT,KEBON JERUK,SUKABUMI SELATAN,37033,14329,22704,11910,34614,2021-09-03
3173051002,JAKARTA BARAT,KEBON JERUK,SUKABUMI UTARA,38290,15055,23235,12293,35528,2021-09-03
3172041002,JAKARTA UTARA,CILINCING,SUKAPURA,53949,19780,34169,22279,56448,2021-09-03
3171031007,JAKARTA PUSAT,KEMAYORAN,SUMUR BATU,22717,8262,14455,9619,24074,2021-09-03
3172021004,JAKARTA UTARA,TANJUNG PRIOK,SUNGAI BAMBU,29876,10545,19331,12151,31482,2021-09-03
3172021006,JAKARTA UTARA,TANJUNG PRIOK,SUNTER AGUNG,71805,22152,49653,35344,84997,2021-09-03
3172021002,JAKARTA UTARA,TANJUNG PRIOK,SUNTER JAYA,63031,20153,42878,30148,73026,2021-09-03
3175091004,JAKARTA TIMUR,CIRACAS,SUSUKAN,38257,12706,25551,15768,41319,2021-09-03
3173031001,JAKARTA BARAT,TAMAN SARI,TAMAN SARI,14348,5003,9345,6550,15895,2021-09-03
3173041001,JAKARTA BARAT,TAMBORA,TAMBORA,10204,3678,6526,3907,10433,2021-09-03
3173041004,JAKARTA BARAT,TAMBORA,TANAH SEREAL,26387,7947,18440,12064,30504,2021-09-03
3171081004,JAKARTA PUSAT,JOHAR BARU,TANAH TINGGI,37693,11513,26180,15917,42097,2021-09-03
3173031004,JAKARTA BARAT,TAMAN SARI,TANGKI,13324,4557,8767,6113,14880,2021-09-03
3174091005,JAKARTA SELATAN,JAGAKARSA,TANJUNG BARAT,39770,14162,25608,14805,40413,2021-09-03
3173021005,JAKARTA BARAT,GROGOL PETAMBURAN,TANJUNG DUREN SELATAN,25337,8843,16494,11329,27823,2021-09-03
3173021002,JAKARTA BARAT,GROGOL PETAMBURAN,TANJUNG DUREN UTARA,17010,5640,11370,7695,19065,2021-09-03
3172021001,JAKARTA UTARA,TANJUNG PRIOK,TANJUNG PRIOK,34588,11569,23019,14316,37335,2021-09-03
3174011002,JAKARTA SELATAN,TEBET,TEBET BARAT,21194,7096,14098,9294,23392,2021-09-03
3174011001,JAKARTA SELATAN,TEBET,TEBET TIMUR,18199,6089,12110,7971,20081,2021-09-03
3173061003,JAKARTA BARAT,KALI DERES,TEGAL ALUR,83647,29881,53766,31245,85011,2021-09-03
3174031004,JAKARTA SELATAN,MAMPANG PRAPATAN,TEGAL PARANG,32401,12727,19674,11352,31026,2021-09-03
3173021003,JAKARTA BARAT,GROGOL PETAMBURAN,TOMANG,29605,10241,19364,13486,32850,2021-09-03
3172031005,JAKARTA UTARA,KOJA,TUGU SELATAN,39122,14753,24369,15100,39469,2021-09-03
3172031002,JAKARTA UTARA,KOJA,TUGU UTARA,67670,26243,41427,25557,66984,2021-09-03
3175061006,JAKARTA TIMUR,CAKUNG,UJUNG MENTENG,29934,9903,20031,13186,33217,2021-09-03
3174101005,JAKARTA SELATAN,PESANGGRAHAN,ULUJAMI,40544,16233,24311,13976,38287,2021-09-03
3175011006,JAKARTA TIMUR,MATRAMAN,UTAN KAYU SELATAN,33511,11764,21747,13499,35246,2021-09-03
3175011002,JAKARTA TIMUR,MATRAMAN,UTAN KAYU UTARA,28169,10762,17407,10651,28058,2021-09-03
3171031008,JAKARTA PUSAT,KEMAYORAN,UTAN PANJANG,29208,10901,18307,11688,29995,2021-09-03
3172021007,JAKARTA UTARA,TANJUNG PRIOK,WARAKAS,44401,14927,29474,18191,47665,2021-09-03
3173021007,JAKARTA BARAT,GROGOL PETAMBURAN,WIJAYA KUSUMA,38934,14304,24630,16698,41328,2021-09-03
3172051003,JAKARTA UTARA,PADEMANGAN,ANCOL,23947,9031,14916,9934,24850,2021-09-04
3173041007,JAKARTA BARAT,TAMBORA,ANGKE,29381,10238,19143,11336,30479,2021-09-04
3175041005,JAKARTA TIMUR,KRAMAT JATI,BALE KAMBANG,29074,12293,16781,8849,25630,2021-09-04
3175031003,JAKARTA TIMUR,JATINEGARA,BALI MESTER,9752,3645,6107,3992,10099,2021-09-04
3175101006,JAKARTA TIMUR,CIPAYUNG,BAMBU APUS,26285,9152,17133,11570,28703,2021-09-04
3174031002,JAKARTA SELATAN,MAMPANG PRAPATAN,BANGKA,21566,8317,13249,8261,21510,2021-09-04
3175051002,JAKARTA TIMUR,PASAR REBO,BARU,23886,7527,16359,11934,28293,2021-09-04
3175041004,JAKARTA TIMUR,KRAMAT JATI,BATU AMPAR,47898,19461,28437,17033,45470,2021-09-04
3171071002,JAKARTA PUSAT,TANAH ABANG,BENDUNGAN HILIR,21494,7921,13573,9123,22696,2021-09-04
3175031002,JAKARTA TIMUR,JATINEGARA,BIDARA CINA,36689,15014,21675,13574,35249,2021-09-04
3174101002,JAKARTA SELATAN,PESANGGRAHAN,BINTARO,53098,20024,33074,21018,54092,2021-09-04
3174011005,JAKARTA SELATAN,TEBET,BUKIT DURI,34183,13330,20853,12137,32990,2021-09-04
3171041006,JAKARTA PUSAT,SENEN,BUNGUR,18144,6370,11774,7791,19565,2021-09-04
3175061007,JAKARTA TIMUR,CAKUNG,CAKUNG BARAT,57724,19283,38441,24505,62946,2021-09-04
3175061004,JAKARTA TIMUR,CAKUNG,CAKUNG TIMUR,58287,19833,38454,26868,65322,2021-09-04
3175041007,JAKARTA TIMUR,KRAMAT JATI,CAWANG,32762,12549,20213,12616,32829,2021-09-04
3175101008,JAKARTA TIMUR,CIPAYUNG,CEGER,18932,6556,12376,8522,20898,2021-09-04
3171031006,JAKARTA PUSAT,KEMAYORAN,CEMPAKA BARU,32581,11879,20702,12912,33614,2021-09-04
3171051002,JAKARTA PUSAT,CEMPAKA PUTIH,CEMPAKA PUTIH BARAT,35885,13111,22774,16161,38935,2021-09-04
3171051001,JAKARTA PUSAT,CEMPAKA PUTIH,CEMPAKA PUTIH TIMUR,24292,8542,15750,10894,26644,2021-09-04
3173011001,JAKARTA BARAT,CENGKARENG,CENGKARENG BARAT,66284,23067,43217,28679,71896,2021-09-04
3173011006,JAKARTA BARAT,CENGKARENG,CENGKARENG TIMUR,81027,27757,53270,31832,85102,2021-09-04
3175091002,JAKARTA TIMUR,CIRACAS,CIBUBUR,66364,21767,44597,30031,74628,2021-09-04
3171011002,JAKARTA PUSAT,GAMBIR,CIDENG,15390,5145,10245,7153,17398,2021-09-04
3174091003,JAKARTA SELATAN,JAGAKARSA,CIGANJUR,38497,13917,24580,14710,39290,2021-09-04
3175051003,JAKARTA TIMUR,PASAR REBO,CIJANTUNG,41419,13688,27731,18702,46433,2021-09-04
3171061003,JAKARTA PUSAT,MENTENG,CIKINI,8274,2919,5355,3363,8718,2021-09-04
3174081006,JAKARTA SELATAN,PANCORAN,CIKOKO,10547,3631,6916,4085,11001,2021-09-04
3174061001,JAKARTA SELATAN,CILANDAK,CILANDAK BARAT,51752,18617,33135,20969,54104,2021-09-04
3174041003,JAKARTA SELATAN,PASAR MINGGU,CILANDAK TIMUR,25145,8937,16208,10857,27065,2021-09-04
3175101002,JAKARTA TIMUR,CIPAYUNG,CILANGKAP,27635,9420,18215,12461,30676,2021-09-04
3175041006,JAKARTA TIMUR,KRAMAT JATI,CILILITAN,40181,16031,24150,15614,39764,2021-09-04
3172041001,JAKARTA UTARA,CILINCING,CILINCING,43609,16444,27165,16394,43559,2021-09-04
3175101001,JAKARTA TIMUR,CIPAYUNG,CIPAYUNG,26104,8219,17885,12683,30568,2021-09-04
3174091006,JAKARTA SELATAN,JAGAKARSA,CIPEDAK,38303,12867,25436,15942,41378,2021-09-04
3174061005,JAKARTA SELATAN,CILANDAK,CIPETE SELATAN,26704,10043,16661,11273,27934,2021-09-04
3174071010,JAKARTA SELATAN,KEBAYORAN BARU,CIPETE UTARA,34102,12503,21599,13475,35074,2021-09-04
3175021003,JAKARTA TIMUR,PULO GADUNG,CIPINANG,39306,14293,25013,16424,41437,2021-09-04
3175031007,JAKARTA TIMUR,JATINEGARA,CIPINANG BESAR SELATAN,35212,13942,21270,12685,33955,2021-09-04
3175031008,JAKARTA TIMUR,JATINEGARA,CIPINANG BESAR UTARA,45319,18013,27306,16614,43920,2021-09-04
3175031005,JAKARTA TIMUR,JATINEGARA,CIPINANG CEMPEDAK,32824,13074,19750,13329,33079,2021-09-04
3175081005,JAKARTA TIMUR,MAKASAR,CIPINANG MELAYU,42308,15748,26560,18067,44627,2021-09-04
3175031006,JAKARTA TIMUR,JATINEGARA,CIPINANG MUARA,55243,21770,33473,21294,54767,2021-09-04
3174051003,JAKARTA SELATAN,KEBAYORAN LAMA,CIPULIR,39937,16011,23926,13259,37185,2021-09-04
3175091001,JAKARTA TIMUR,CIRACAS,CIRACAS,64594,21064,43530,27905,71435,2021-09-04
3175041003,JAKARTA TIMUR,KRAMAT JATI,DUKUH,24609,8462,16147,10763,26910,2021-09-04
3175071001,JAKARTA TIMUR,DUREN SAWIT,DUREN SAWIT,61160,23852,37308,24069,61377,2021-09-04
3174081004,JAKARTA SELATAN,PANCORAN,DUREN TIGA,28319,10513,17806,9701,27507,2021-09-04
3173051005,JAKARTA BARAT,KEBON JERUK,DURI KEPA,60138,20506,39632,26795,66427,2021-09-04
3173011002,JAKARTA BARAT,CENGKARENG,DURI KOSAMBI,77923,29919,48004,28651,76655,2021-09-04
3171011006,JAKARTA PUSAT,GAMBIR,DURI PULO,19610,6910,12700,8026,20726,2021-09-04
3173041011,JAKARTA BARAT,TAMBORA,DURI SELATAN,14259,4582,9677,6492,16169,2021-09-04
3173041003,JAKARTA BARAT,TAMBORA,DURI UTARA,19844,6694,13150,8503,21653,2021-09-04
3171081003,JAKARTA PUSAT,JOHAR BARU,GALUR,18243,5629,12614,7987,20601,2021-09-04
3171011001,JAKARTA PUSAT,GAMBIR,GAMBIR,2191,734,1457,1030,2487,2021-09-04
3174061004,JAKARTA SELATAN,CILANDAK,GANDARIA SELATAN,22119,8243,13876,8409,22285,2021-09-04
3174071009,JAKARTA SELATAN,KEBAYORAN BARU,GANDARIA UTARA,39922,15003,24919,15585,40504,2021-09-04
3175051001,JAKARTA TIMUR,PASAR REBO,GEDONG,35755,12439,23316,15778,39094,2021-09-04
3171071001,JAKARTA PUSAT,TANAH ABANG,GELORA,3127,1184,1943,1267,3210,2021-09-04
3173031007,JAKARTA BARAT,TAMAN SARI,GLODOK,7837,2345,5492,4056,9548,2021-09-04
3171061004,JAKARTA PUSAT,MENTENG,GONDANGDIA,4100,1478,2622,2020,4642,2021-09-04
3173021001,JAKARTA BARAT,GROGOL PETAMBURAN,GROGOL,16876,6023,10853,7234,18087,2021-09-04
3174051005,JAKARTA SELATAN,KEBAYORAN LAMA,GROGOL SELATAN,44251,16958,27293,15822,43115,2021-09-04
3174051004,JAKARTA SELATAN,KEBAYORAN LAMA,GROGOL UTARA,42494,16066,26428,15502,41930,2021-09-04
3174021007,JAKARTA SELATAN,SETIA BUDI,GUNTUR,3985,1380,2605,1871,4476,2021-09-04
3174071002,JAKARTA SELATAN,KEBAYORAN BARU,GUNUNG,9436,3331,6105,4262,10367,2021-09-04
3171031005,JAKARTA PUSAT,KEMAYORAN,GUNUNG SAHARI SELATAN,19199,6886,12313,8392,20705,2021-09-04
3171021004,JAKARTA PUSAT,SAWAH BESAR,GUNUNG SAHARI UTARA,16650,5149,11501,8494,19995,2021-09-04
3175081004,JAKARTA TIMUR,MAKASAR,HALIM PERDANA KUSUMAH,28363,7780,20583,16210,36793,2021-09-04
3171031003,JAKARTA PUSAT,KEMAYORAN,HARAPAN MULIA,22557,8011,14546,9616,24162,2021-09-04
3174091001,JAKARTA SELATAN,JAGAKARSA,JAGAKARSA,62389,21839,40550,26058,66608,2021-09-04
3175021007,JAKARTA TIMUR,PULO GADUNG,JATI,32757,11727,21030,13987,35017,2021-09-04
3174041002,JAKARTA SELATAN,PASAR MINGGU,JATI PADANG,37502,13828,23674,15073,38747,2021-09-04
3173071004,JAKARTA BARAT,PALMERAH,JATI PULO,28738,9622,19116,11951,31067,2021-09-04
3175061001,JAKARTA TIMUR,CAKUNG,JATINEGARA,84160,31102,53058,35766,88824,2021-09-04
3175021004,JAKARTA TIMUR,PULO GADUNG,JATINEGARA KAUM,24632,8248,16384,9670,26054,2021-09-04
3173021004,JAKARTA BARAT,GROGOL PETAMBURAN,JELAMBAR,30266,10637,19629,14035,33664,2021-09-04
3173021006,JAKARTA BARAT,GROGOL PETAMBURAN,JELAMBAR BARU,38246,13488,24758,17276,42034,2021-09-04
3173041006,JAKARTA BARAT,TAMBORA,JEMBATAN BESI,29314,11748,17566,9970,27536,2021-09-04
3173041008,JAKARTA BARAT,TAMBORA,JEMBATAN LIMA,21021,8026,12995,7833,20828,2021-09-04
3173081005,JAKARTA BARAT,KEMBANGAN,JOGLO,40839,14694,26145,16857,43002,2021-09-04
3171081001,JAKARTA PUSAT,JOHAR BARU,JOHAR BARU,37488,11919,25569,17062,42631,2021-09-04
3173041002,JAKARTA BARAT,TAMBORA,KALI ANYAR,23856,8042,15814,9277,25091,2021-09-04
3172041004,JAKARTA UTARA,CILINCING,KALIBARU,67684,27105,40579,23183,63762,2021-09-04
3174081002,JAKARTA SELATAN,PANCORAN,KALIBATA,41994,17370,24624,13306,37930,2021-09-04
3173061001,JAKARTA BARAT,KALI DERES,KALIDERES,72447,26309,46138,32544,78682,2021-09-04
3175051004,JAKARTA TIMUR,PASAR REBO,KALISARI,43212,14607,28605,19519,48124,2021-09-04
3173061004,JAKARTA BARAT,KALI DERES,KAMAL,53783,20033,33750,20165,53915,2021-09-04
3172011002,JAKARTA UTARA,PENJARINGAN,KAMAL MUARA,12930,3446,9484,6942,16426,2021-09-04
3171071007,JAKARTA PUSAT,TANAH ABANG,KAMPUNG BALI,11358,4434,6924,4267,11191,2021-09-04
3175031001,JAKARTA TIMUR,JATINEGARA,KAMPUNG MELAYU,25717,10342,15375,9497,24872,2021-09-04
3171081002,JAKARTA PUSAT,JOHAR BARU,KAMPUNG RAWA,21237,5715,15522,9557,25079,2021-09-04
3175041002,JAKARTA TIMUR,KRAMAT JATI,KAMPUNG TENGAH,43993,17676,26317,15597,41914,2021-09-04
3173011005,JAKARTA BARAT,CENGKARENG,KAPUK,134466,51662,82804,47966,130770,2021-09-04
3172011003,JAKARTA UTARA,PENJARINGAN,KAPUK MUARA,35781,11068,24713,18449,43162,2021-09-04
3171021002,JAKARTA PUSAT,SAWAH BESAR,KARANG ANYAR,25761,8561,17200,11366,28566,2021-09-04
3174021004,JAKARTA SELATAN,SETIA BUDI,KARET,9623,3628,5995,3937,9932,2021-09-04
3174021003,JAKARTA SELATAN,SETIA BUDI,KARET KUNINGAN,16055,5367,10688,6996,17684,2021-09-04
3174021002,JAKARTA SELATAN,SETIA BUDI,KARET SEMANGGI,2770,951,1819,1363,3182,2021-09-04
3171071003,JAKARTA PUSAT,TANAH ABANG,KARET TENGSIN,19271,6988,12283,7939,20222,2021-09-04
3171021003,JAKARTA PUSAT,SAWAH BESAR,KARTINI,22292,7680,14612,10178,24790,2021-09-04
3175011003,JAKARTA TIMUR,MATRAMAN,KAYU MANIS,25284,9882,15402,9165,24567,2021-09-04
3175021006,JAKARTA TIMUR,PULO GADUNG,KAYU PUTIH,40696,13870,26826,19192,46018,2021-09-04
3173031006,JAKARTA BARAT,TAMAN SARI,KEAGUNGAN,17387,5915,11472,7680,19152,2021-09-04
3174041007,JAKARTA SELATAN,PASAR MINGGU,KEBAGUSAN,44552,17100,27452,16383,43835,2021-09-04
3174051006,JAKARTA SELATAN,KEBAYORAN LAMA,KEBAYORAN LAMA SELATAN,41212,14775,26437,15690,42127,2021-09-04
3174051001,JAKARTA SELATAN,KEBAYORAN LAMA,KEBAYORAN LAMA UTARA,42422,16584,25838,14230,40068,2021-09-04
3174011004,JAKARTA SELATAN,TEBET,KEBON BARU,35165,12942,22223,13464,35687,2021-09-04
3172021005,JAKARTA UTARA,TANJUNG PRIOK,KEBON BAWANG,50952,18151,32801,21298,54099,2021-09-04
3173051001,JAKARTA BARAT,KEBON JERUK,KEBON JERUK,53887,20409,33478,20998,54476,2021-09-04
3171071006,JAKARTA PUSAT,TANAH ABANG,KEBON KACANG,21531,8968,12563,7915,20478,2021-09-04
3171011005,JAKARTA PUSAT,GAMBIR,KEBON KELAPA,10163,3557,6606,4383,10989,2021-09-04
3171031002,JAKARTA PUSAT,KEMAYORAN,KEBON KOSONG,30019,10720,19299,12567,31866,2021-09-04
3175011005,JAKARTA TIMUR,MATRAMAN,KEBON MANGGIS,16490,5867,10623,7063,17686,2021-09-04
3171071005,JAKARTA PUSAT,TANAH ABANG,KEBON MELATI,32206,14146,18060,10890,28950,2021-09-04
3175081003,JAKARTA TIMUR,MAKASAR,KEBON PALA,46614,16709,29905,18558,48463,2021-09-04
3171061005,JAKARTA PUSAT,MENTENG,KEBON SIRIH,12299,4534,7765,5031,12796,2021-09-04
3173011004,JAKARTA BARAT,CENGKARENG,KEDAUNG KALI ANGKE,32612,10523,22089,15031,37120,2021-09-04
3173051007,JAKARTA BARAT,KEBON JERUK,KEDOYA SELATAN,32165,11006,21159,13497,34656,2021-09-04
3173051006,JAKARTA BARAT,KEBON JERUK,KEDOYA UTARA,45740,14790,30950,21524,52474,2021-09-04
3173051004,JAKARTA BARAT,KEBON JERUK,KELAPA DUA,23565,8768,14797,9149,23946,2021-09-04
3175091003,JAKARTA TIMUR,CIRACAS,KELAPA DUA WETAN,46875,15014,31861,21018,52879,2021-09-04
3172061003,JAKARTA UTARA,KELAPA GADING,KELAPA GADING BARAT,35717,11175,24542,18744,43286,2021-09-04
3172061001,JAKARTA UTARA,KELAPA GADING,KELAPA GADING TIMUR,33592,9592,24000,18244,42244,2021-09-04
3173071005,JAKARTA BARAT,PALMERAH,KEMANGGISAN,32139,11367,20772,13442,34214,2021-09-04
3171031001,JAKARTA PUSAT,KEMAYORAN,KEMAYORAN,20708,7102,13606,9234,22840,2021-09-04
3173081006,JAKARTA BARAT,KEMBANGAN,KEMBANGAN SELATAN,27130,9672,17458,12559,30017,2021-09-04
3173081001,JAKARTA BARAT,KEMBANGAN,KEMBANGAN UTARA,54451,19446,35005,23431,58436,2021-09-04
3171041002,JAKARTA PUSAT,SENEN,KENARI,9579,3307,6272,4469,10741,2021-09-04
3173041005,JAKARTA BARAT,TAMBORA,KERENDANG,19973,6931,13042,8388,21430,2021-09-04
3175071003,JAKARTA TIMUR,DUREN SAWIT,KLENDER,69978,27963,42015,25581,67596,2021-09-04
3172031001,JAKARTA UTARA,KOJA,KOJA,28175,10573,17602,11525,29127,2021-09-04
3173071006,JAKARTA BARAT,PALMERAH,KOTA BAMBU SELATAN,21158,7667,13491,8255,21746,2021-09-04
3173071003,JAKARTA BARAT,PALMERAH,KOTA BAMBU UTARA,24995,9196,15799,9726,25525,2021-09-04
3171041004,JAKARTA PUSAT,SENEN,KRAMAT,28835,10787,18048,10537,28585,2021-09-04
3175041001,JAKARTA TIMUR,KRAMAT JATI,KRAMAT JATI,34144,12416,21728,13161,34889,2021-09-04
3174071003,JAKARTA SELATAN,KEBAYORAN BARU,KRAMAT PELA,14413,5024,9389,5983,15372,2021-09-04
3173031002,JAKARTA BARAT,TAMAN SARI,KRUKUT,19244,6666,12578,8045,20623,2021-09-04
3174031005,JAKARTA SELATAN,MAMPANG PRAPATAN,KUNINGAN BARAT,12785,4481,8304,5161,13465,2021-09-04
3174021008,JAKARTA SELATAN,SETIA BUDI,KUNINGAN TIMUR,6008,2145,3863,2558,6421,2021-09-04
3171041005,JAKARTA PUSAT,SENEN,KWITANG,15486,5549,9937,6501,16438,2021-09-04
3172031003,JAKARTA UTARA,KOJA,LAGOA,59065,22583,36482,22552,59034,2021-09-04
3174061002,JAKARTA SELATAN,CILANDAK,LEBAK BULUS,37626,14296,23330,14850,38180,2021-09-04
3174091004,JAKARTA SELATAN,JAGAKARSA,LENTENG AGUNG,53946,20539,33407,19000,52407,2021-09-04
3175101007,JAKARTA TIMUR,CIPAYUNG,LUBANG BUAYA,63547,21109,42438,28471,70909,2021-09-04
3175081001,JAKARTA TIMUR,MAKASAR,MAKASAR,34390,11851,22539,15056,37595,2021-09-04
3175071006,JAKARTA TIMUR,DUREN SAWIT,MALAKA JAYA,30927,11169,19758,13993,33751,2021-09-04
3175071005,JAKARTA TIMUR,DUREN SAWIT,MALAKA SARI,27530,9597,17933,12845,30778,2021-09-04
3174031001,JAKARTA SELATAN,MAMPANG PRAPATAN,MAMPANG PRAPATAN,18159,6673,11486,7298,18784,2021-09-04
3173031005,JAKARTA BARAT,TAMAN SARI,MANGGA BESAR,7707,2330,5377,3798,9175,2021-09-04
3171021005,JAKARTA PUSAT,SAWAH BESAR,MANGGA DUA SELATAN,27442,9429,18013,12211,30224,2021-09-04
3174011007,JAKARTA SELATAN,TEBET,MANGGARAI,28373,9580,18793,10939,29732,2021-09-04
3174011006,JAKARTA SELATAN,TEBET,MANGGARAI SELATAN,23075,8049,15026,9275,24301,2021-09-04
3173031003,JAKARTA BARAT,TAMAN SARI,MAPHAR,16461,5807,10654,7212,17866,2021-09-04
3172041003,JAKARTA UTARA,CILINCING,MARUNDA,28943,9885,19058,10039,29097,2021-09-04
3174071001,JAKARTA SELATAN,KEBAYORAN BARU,MELAWAI,2627,897,1730,1368,3098,2021-09-04
3171061001,JAKARTA PUSAT,MENTENG,MENTENG,25624,9721,15903,10288,26191,2021-09-04
3174021005,JAKARTA SELATAN,SETIA BUDI,MENTENG ATAS,27816,9524,18292,11172,29464,2021-09-04
3174011003,JAKARTA SELATAN,TEBET,MENTENG DALAM,36028,13161,22867,14290,37157,2021-09-04
3173081003,JAKARTA BARAT,KEMBANGAN,MERUYA SELATAN,32130,11558,20572,13763,34335,2021-09-04
3173081002,JAKARTA BARAT,KEMBANGAN,MERUYA UTARA,43752,15980,27772,19698,47470,2021-09-04
3175101004,JAKARTA TIMUR,CIPAYUNG,MUNJUL,23871,8009,15862,10947,26809,2021-09-04
3172051002,JAKARTA UTARA,PADEMANGAN,PADEMANGAN BARAT,74240,27655,46585,30082,76667,2021-09-04
3172051001,JAKARTA UTARA,PADEMANGAN,PADEMANGAN TIMUR,37736,11707,26029,18464,44493,2021-09-04
3175011004,JAKARTA TIMUR,MATRAMAN,PAL MERIAM,19769,7628,12141,7663,19804,2021-09-04
3173071001,JAKARTA BARAT,PALMERAH,PALMERAH,63011,23105,39906,24904,64810,2021-09-04
3174081001,JAKARTA SELATAN,PANCORAN,PANCORAN,19421,7222,12199,7398,19597,2021-09-04
3172021003,JAKARTA UTARA,TANJUNG PRIOK,PAPANGGO,39097,12956,26141,17162,43303,2021-09-04
3171021001,JAKARTA PUSAT,SAWAH BESAR,PASAR BARU,12035,3746,8289,6049,14338,2021-09-04
3174021006,JAKARTA SELATAN,SETIA BUDI,PASAR MANGGIS,26752,9781,16971,10406,27377,2021-09-04
3174041001,JAKARTA SELATAN,PASAR MINGGU,PASAR MINGGU,24821,9068,15753,10224,25977,2021-09-04
3171041003,JAKARTA PUSAT,SENEN,PASEBAN,23533,8637,14896,9528,24424,2021-09-04
3173061005,JAKARTA BARAT,KALI DERES,PEGADUNGAN,75587,25383,50204,35120,85324,2021-09-04
3171061002,JAKARTA PUSAT,MENTENG,PEGANGSAAN,23455,8721,14734,8987,23721,2021-09-04
3172061002,JAKARTA UTARA,KELAPA GADING,PEGANGSAAN DUA,49976,14260,35716,26621,62337,2021-09-04
3172011004,JAKARTA UTARA,PENJARINGAN,PEJAGALAN,74578,26314,48264,33086,81350,2021-09-04
3174041006,JAKARTA SELATAN,PASAR MINGGU,PEJATEN BARAT,37346,14054,23292,14678,37970,2021-09-04
3174041005,JAKARTA SELATAN,PASAR MINGGU,PEJATEN TIMUR,57656,22589,35067,19846,54913,2021-09-04
3175051005,JAKARTA TIMUR,PASAR REBO,PEKAYON,43250,14477,28773,19263,48036,2021-09-04
3173041009,JAKARTA BARAT,TAMBORA,PEKOJAN,23587,7751,15836,10847,26683,2021-09-04
3174031003,JAKARTA SELATAN,MAMPANG PRAPATAN,PELA MAMPANG,43522,15771,27751,18100,45851,2021-09-04
3174081005,JAKARTA SELATAN,PANCORAN,PENGADEGAN,21478,7191,14287,7857,22144,2021-09-04
3175061003,JAKARTA TIMUR,CAKUNG,PENGGILINGAN,99255,39611,59644,35868,95512,2021-09-04
3172011001,JAKARTA UTARA,PENJARINGAN,PENJARINGAN,88308,34194,54114,33677,87791,2021-09-04
3174101001,JAKARTA SELATAN,PESANGGRAHAN,PESANGGRAHAN,27545,9466,18079,11358,29437,2021-09-04
3171071004,JAKARTA PUSAT,TANAH ABANG,PETAMBURAN,33271,14701,18570,11136,29706,2021-09-04
3174071008,JAKARTA SELATAN,KEBAYORAN BARU,PETOGOGAN,11499,4281,7218,4723,11941,2021-09-04
3171011004,JAKARTA PUSAT,GAMBIR,PETOJO SELATAN,14692,5403,9289,6282,15571,2021-09-04
3171011003,JAKARTA PUSAT,GAMBIR,PETOJO UTARA,17458,6304,11154,7133,18287,2021-09-04
3174101004,JAKARTA SELATAN,PESANGGRAHAN,PETUKANGAN SELATAN,37187,13718,23469,14166,37635,2021-09-04
3174101003,JAKARTA SELATAN,PESANGGRAHAN,PETUKANGAN UTARA,53716,20988,32728,19964,52692,2021-09-04
3175081002,JAKARTA TIMUR,MAKASAR,PINANG RANTI,27198,9791,17407,11602,29009,2021-09-04
3173031008,JAKARTA BARAT,TAMAN SARI,PINANGSIA,10729,3368,7361,4927,12288,2021-09-04
3175011001,JAKARTA TIMUR,MATRAMAN,PISANGAN BARU,31776,12134,19642,11595,31237,2021-09-04
3175021002,JAKARTA TIMUR,PULO GADUNG,PISANGAN TIMUR,41011,14105,26906,17708,44614,2021-09-04
3172011005,JAKARTA UTARA,PENJARINGAN,PLUIT,47783,15724,32059,23655,55714,2021-09-04
3175071002,JAKARTA TIMUR,DUREN SAWIT,PONDOK BAMBU,61550,23696,37854,23654,61508,2021-09-04
3175071004,JAKARTA TIMUR,DUREN SAWIT,PONDOK KELAPA,72015,26130,45885,29416,75301,2021-09-04
3175071007,JAKARTA TIMUR,DUREN SAWIT,PONDOK KOPI,35367,14555,20812,12686,33498,2021-09-04
3174061003,JAKARTA SELATAN,CILANDAK,PONDOK LABU,46464,16133,30331,20324,50655,2021-09-04
3174051002,JAKARTA SELATAN,KEBAYORAN LAMA,PONDOK PINANG,56169,20927,35242,22179,57421,2021-09-04
3175101003,JAKARTA TIMUR,CIPAYUNG,PONDOK RANGGON,25574,8814,16760,11342,28102,2021-09-04
3101011003,KAB.ADM.KEP.SERIBU,KEP. SERIBU UTARA,PULAU HARAPAN,2060,336,1724,1030,2754,2021-09-04
3101011002,KAB.ADM.KEP.SERIBU,KEP. SERIBU UTARA,PULAU KELAPA,5528,893,4635,2650,7285,2021-09-04
3101011001,KAB.ADM.KEP.SERIBU,KEP. SERIBU UTARA,PULAU PANGGANG,5450,833,4617,2188,6805,2021-09-04
3101021003,KAB.ADM.KEP.SERIBU,KEP. SERIBU SELATAN,PULAU PARI,2765,319,2446,1472,3918,2021-09-04
3101021002,KAB.ADM.KEP.SERIBU,KEP. SERIBU SELATAN,PULAU TIDUNG,4553,615,3938,2683,6621,2021-09-04
3101021001,KAB.ADM.KEP.SERIBU,KEP. SERIBU SELATAN,PULAU UNTUNG JAWA,1941,319,1622,1016,2638,2021-09-04
3174071007,JAKARTA SELATAN,KEBAYORAN BARU,PULO,5835,1962,3873,2830,6703,2021-09-04
3175021001,JAKARTA TIMUR,PULO GADUNG,PULO GADUNG,34422,12449,21973,14103,36076,2021-09-04
3175061005,JAKARTA TIMUR,CAKUNG,PULO GEBANG,97301,35468,61833,39590,101423,2021-09-04
3174041004,JAKARTA SELATAN,PASAR MINGGU,RAGUNAN,39616,13949,25667,16369,42036,2021-09-04
3175091005,JAKARTA TIMUR,CIRACAS,RAMBUTAN,36771,14512,22259,14242,36501,2021-09-04
3172031006,JAKARTA UTARA,KOJA,RAWA BADAK SELATAN,42179,16298,25881,16066,41947,2021-09-04
3172031004,JAKARTA UTARA,KOJA,RAWA BADAK UTARA,34408,12994,21414,13579,34993,2021-09-04
3174071005,JAKARTA SELATAN,KEBAYORAN BARU,RAWA BARAT,5625,1883,3742,2574,6316,2021-09-04
3173011003,JAKARTA BARAT,CENGKARENG,RAWA BUAYA,63799,22897,40902,24691,65593,2021-09-04
3175031004,JAKARTA TIMUR,JATINEGARA,RAWA BUNGA,21434,8414,13020,8383,21403,2021-09-04
3174081003,JAKARTA SELATAN,PANCORAN,RAWA JATI,20509,7405,13104,7770,20874,2021-09-04
3175061002,JAKARTA TIMUR,CAKUNG,RAWA TERATE,24637,7955,16682,11523,28205,2021-09-04
3175021005,JAKARTA TIMUR,PULO GADUNG,RAWAMANGUN,37612,13679,23933,16054,39987,2021-09-04
3171051003,JAKARTA PUSAT,CEMPAKA PUTIH,RAWASARI,21967,8030,13937,9616,23553,2021-09-04
3173041010,JAKARTA BARAT,TAMBORA,ROA MALAKA,3484,1036,2448,1756,4204,2021-09-04
3172041006,JAKARTA UTARA,CILINCING,ROROTAN,41668,13868,27800,17215,45015,2021-09-04
3174071004,JAKARTA SELATAN,KEBAYORAN BARU,SELONG,2842,977,1865,1413,3278,2021-09-04
3173061002,JAKARTA BARAT,KALI DERES,SEMANAN,71354,26805,44549,26546,71095,2021-09-04
3172041007,JAKARTA UTARA,CILINCING,SEMPER BARAT,68587,22623,45964,30705,76669,2021-09-04
3172041005,JAKARTA UTARA,CILINCING,SEMPER TIMUR,36267,12517,23750,15067,38817,2021-09-04
3174071006,JAKARTA SELATAN,KEBAYORAN BARU,SENAYAN,2771,1120,1651,1094,2745,2021-09-04
3171041001,JAKARTA PUSAT,SENEN,SENEN,6804,2313,4491,3112,7603,2021-09-04
3171031004,JAKARTA PUSAT,KEMAYORAN,SERDANG,29668,10578,19090,12418,31508,2021-09-04
3174021001,JAKARTA SELATAN,SETIA BUDI,SETIA BUDI,3023,1115,1908,1293,3201,2021-09-04
3175101005,JAKARTA TIMUR,CIPAYUNG,SETU,20572,7610,12962,8247,21209,2021-09-04
3173071002,JAKARTA BARAT,PALMERAH,SLIPI,16591,5612,10979,7279,18258,2021-09-04
3173081004,JAKARTA BARAT,KEMBANGAN,SRENGSENG,45523,17127,28396,18360,46756,2021-09-04
3174091002,JAKARTA SELATAN,JAGAKARSA,SRENGSENG SAWAH,58196,18907,39289,24426,63715,2021-09-04
3173051003,JAKARTA BARAT,KEBON JERUK,SUKABUMI SELATAN,37033,14266,22767,12207,34974,2021-09-04
3173051002,JAKARTA BARAT,KEBON JERUK,SUKABUMI UTARA,38290,14986,23304,12588,35892,2021-09-04
3172041002,JAKARTA UTARA,CILINCING,SUKAPURA,53949,19687,34262,22759,57021,2021-09-04
3171031007,JAKARTA PUSAT,KEMAYORAN,SUMUR BATU,22717,8222,14495,9804,24299,2021-09-04
3172021004,JAKARTA UTARA,TANJUNG PRIOK,SUNGAI BAMBU,29876,10463,19413,12374,31787,2021-09-04
3172021006,JAKARTA UTARA,TANJUNG PRIOK,SUNTER AGUNG,71805,22004,49801,35985,85786,2021-09-04
3172021002,JAKARTA UTARA,TANJUNG PRIOK,SUNTER JAYA,63031,20034,42997,30773,73770,2021-09-04
3175091004,JAKARTA TIMUR,CIRACAS,SUSUKAN,38257,12653,25604,15947,41551,2021-09-04
3173031001,JAKARTA BARAT,TAMAN SARI,TAMAN SARI,14348,4980,9368,6683,16051,2021-09-04
3173041001,JAKARTA BARAT,TAMBORA,TAMBORA,10204,3663,6541,4017,10558,2021-09-04
3173041004,JAKARTA BARAT,TAMBORA,TANAH SEREAL,26387,7915,18472,12281,30753,2021-09-04
3171081004,JAKARTA PUSAT,JOHAR BARU,TANAH TINGGI,37693,11449,26244,16280,42524,2021-09-04
3173031004,JAKARTA BARAT,TAMAN SARI,TANGKI,13324,4526,8798,6228,15026,2021-09-04
3174091005,JAKARTA SELATAN,JAGAKARSA,TANJUNG BARAT,39770,14123,25647,14876,40523,2021-09-04
3173021005,JAKARTA BARAT,GROGOL PETAMBURAN,TANJUNG DUREN SELATAN,25337,8817,16520,11521,28041,2021-09-04
3173021002,JAKARTA BARAT,GROGOL PETAMBURAN,TANJUNG DUREN UTARA,17010,5618,11392,7883,19275,2021-09-04
3172021001,JAKARTA UTARA,TANJUNG PRIOK,TANJUNG PRIOK,34588,11522,23066,14636,37702,2021-09-04
3174011002,JAKARTA SELATAN,TEBET,TEBET BARAT,21194,7080,14114,9340,23454,2021-09-04
3174011001,JAKARTA SELATAN,TEBET,TEBET TIMUR,18199,6069,12130,8003,20133,2021-09-04
3173061003,JAKARTA BARAT,KALI DERES,TEGAL ALUR,83647,29715,53932,32242,86174,2021-09-04
3174031004,JAKARTA SELATAN,MAMPANG PRAPATAN,TEGAL PARANG,32401,12716,19685,11393,31078,2021-09-04
3173021003,JAKARTA BARAT,GROGOL PETAMBURAN,TOMANG,29605,10216,19389,13744,33133,2021-09-04
3172031005,JAKARTA UTARA,KOJA,TUGU SELATAN,39122,14677,24445,15511,39956,2021-09-04
3172031002,JAKARTA UTARA,KOJA,TUGU UTARA,67670,26133,41537,26049,67586,2021-09-04
3175061006,JAKARTA TIMUR,CAKUNG,UJUNG MENTENG,29934,9759,20175,13824,33999,2021-09-04
3174101005,JAKARTA SELATAN,PESANGGRAHAN,ULUJAMI,40544,16209,24335,14022,38357,2021-09-04
3175011006,JAKARTA TIMUR,MATRAMAN,UTAN KAYU SELATAN,33511,11668,21843,13861,35704,2021-09-04
3175011002,JAKARTA TIMUR,MATRAMAN,UTAN KAYU UTARA,28169,10692,17477,10927,28404,2021-09-04
3171031008,JAKARTA PUSAT,KEMAYORAN,UTAN PANJANG,29208,10825,18383,11953,30336,2021-09-04
3172021007,JAKARTA UTARA,TANJUNG PRIOK,WARAKAS,44401,14799,29602,18509,48111,2021-09-04
3173021007,JAKARTA BARAT,GROGOL PETAMBURAN,WIJAYA KUSUMA,38934,14251,24683,17053,41736,2021-09-04
3172051003,JAKARTA UTARA,PADEMANGAN,ANCOL,23947,9000,14947,10038,24985,2021-09-05
3173041007,JAKARTA BARAT,TAMBORA,ANGKE,29381,10228,19153,11388,30541,2021-09-05
3175041005,JAKARTA TIMUR,KRAMAT JATI,BALE KAMBANG,29074,12274,16800,8875,25675,2021-09-05
3175031003,JAKARTA TIMUR,JATINEGARA,BALI MESTER,9752,3637,6115,4093,10208,2021-09-05
3175101006,JAKARTA TIMUR,CIPAYUNG,BAMBU APUS,26285,9144,17141,11585,28726,2021-09-05
3174031002,JAKARTA SELATAN,MAMPANG PRAPATAN,BANGKA,21566,8316,13250,8265,21515,2021-09-05
3175051002,JAKARTA TIMUR,PASAR REBO,BARU,23886,7518,16368,11962,28330,2021-09-05
3175041004,JAKARTA TIMUR,KRAMAT JATI,BATU AMPAR,47898,19435,28463,17081,45544,2021-09-05
3171071002,JAKARTA PUSAT,TANAH ABANG,BENDUNGAN HILIR,21494,7914,13580,9150,22730,2021-09-05
3175031002,JAKARTA TIMUR,JATINEGARA,BIDARA CINA,36689,15005,21684,13639,35323,2021-09-05
3174101002,JAKARTA SELATAN,PESANGGRAHAN,BINTARO,53098,20020,33078,21049,54127,2021-09-05
3174011005,JAKARTA SELATAN,TEBET,BUKIT DURI,34183,13319,20864,12166,33030,2021-09-05
3171041006,JAKARTA PUSAT,SENEN,BUNGUR,18144,6362,11782,7827,19609,2021-09-05
3175061007,JAKARTA TIMUR,CAKUNG,CAKUNG BARAT,57724,19255,38469,24597,63066,2021-09-05
3175061004,JAKARTA TIMUR,CAKUNG,CAKUNG TIMUR,58287,19784,38503,27068,65571,2021-09-05
3175041007,JAKARTA TIMUR,KRAMAT JATI,CAWANG,32762,12536,20226,12631,32857,2021-09-05
3175101008,JAKARTA TIMUR,CIPAYUNG,CEGER,18932,6548,12384,8539,20923,2021-09-05
3171031006,JAKARTA PUSAT,KEMAYORAN,CEMPAKA BARU,32581,11823,20758,13099,33857,2021-09-05
3171051002,JAKARTA PUSAT,CEMPAKA PUTIH,CEMPAKA PUTIH BARAT,35885,13093,22792,16235,39027,2021-09-05
3171051001,JAKARTA PUSAT,CEMPAKA PUTIH,CEMPAKA PUTIH TIMUR,24292,8524,15768,10993,26761,2021-09-05
3173011001,JAKARTA BARAT,CENGKARENG,CENGKARENG BARAT,66284,23025,43259,28765,72024,2021-09-05
3173011006,JAKARTA BARAT,CENGKARENG,CENGKARENG TIMUR,81027,27543,53484,32429,85913,2021-09-05
3175091002,JAKARTA TIMUR,CIRACAS,CIBUBUR,66364,21735,44629,30176,74805,2021-09-05
3171011002,JAKARTA PUSAT,GAMBIR,CIDENG,15390,5141,10249,7225,17474,2021-09-05
3174091003,JAKARTA SELATAN,JAGAKARSA,CIGANJUR,38497,13907,24590,14730,39320,2021-09-05
3175051003,JAKARTA TIMUR,PASAR REBO,CIJANTUNG,41419,13661,27758,18836,46594,2021-09-05
3171061003,JAKARTA PUSAT,MENTENG,CIKINI,8274,2918,5356,3372,8728,2021-09-05
3174081006,JAKARTA SELATAN,PANCORAN,CIKOKO,10547,3630,6917,4098,11015,2021-09-05
3174061001,JAKARTA SELATAN,CILANDAK,CILANDAK BARAT,51752,18610,33142,20999,54141,2021-09-05
3174041003,JAKARTA SELATAN,PASAR MINGGU,CILANDAK TIMUR,25145,8935,16210,10862,27072,2021-09-05
3175101002,JAKARTA TIMUR,CIPAYUNG,CILANGKAP,27635,9414,18221,12475,30696,2021-09-05
3175041006,JAKARTA TIMUR,KRAMAT JATI,CILILITAN,40181,15996,24185,15651,39836,2021-09-05
3172041001,JAKARTA UTARA,CILINCING,CILINCING,43609,16423,27186,16519,43705,2021-09-05
3175101001,JAKARTA TIMUR,CIPAYUNG,CIPAYUNG,26104,8209,17895,12708,30603,2021-09-05
3174091006,JAKARTA SELATAN,JAGAKARSA,CIPEDAK,38303,12861,25442,15964,41406,2021-09-05
3174061005,JAKARTA SELATAN,CILANDAK,CIPETE SELATAN,26704,10042,16662,11286,27948,2021-09-05
3174071010,JAKARTA SELATAN,KEBAYORAN BARU,CIPETE UTARA,34102,12502,21600,13481,35081,2021-09-05
3175021003,JAKARTA TIMUR,PULO GADUNG,CIPINANG,39306,14278,25028,16470,41498,2021-09-05
3175031007,JAKARTA TIMUR,JATINEGARA,CIPINANG BESAR SELATAN,35212,13926,21286,12746,34032,2021-09-05
3175031008,JAKARTA TIMUR,JATINEGARA,CIPINANG BESAR UTARA,45319,17990,27329,16770,44099,2021-09-05
3175031005,JAKARTA TIMUR,JATINEGARA,CIPINANG CEMPEDAK,32824,13068,19756,13378,33134,2021-09-05
3175081005,JAKARTA TIMUR,MAKASAR,CIPINANG MELAYU,42308,15736,26572,18134,44706,2021-09-05
3175031006,JAKARTA TIMUR,JATINEGARA,CIPINANG MUARA,55243,21697,33546,21670,55216,2021-09-05
3174051003,JAKARTA SELATAN,KEBAYORAN LAMA,CIPULIR,39937,16006,23931,13282,37213,2021-09-05
3175091001,JAKARTA TIMUR,CIRACAS,CIRACAS,64594,21044,43550,27968,71518,2021-09-05
3175041003,JAKARTA TIMUR,KRAMAT JATI,DUKUH,24609,8461,16148,10777,26925,2021-09-05
3175071001,JAKARTA TIMUR,DUREN SAWIT,DUREN SAWIT,61160,23778,37382,24383,61765,2021-09-05
3174081004,JAKARTA SELATAN,PANCORAN,DUREN TIGA,28319,10504,17815,9722,27537,2021-09-05
3173051005,JAKARTA BARAT,KEBON JERUK,DURI KEPA,60138,20272,39866,26949,66815,2021-09-05
3173011002,JAKARTA BARAT,CENGKARENG,DURI KOSAMBI,77923,29872,48051,28827,76878,2021-09-05
3171011006,JAKARTA PUSAT,GAMBIR,DURI PULO,19610,6900,12710,8075,20785,2021-09-05
3173041011,JAKARTA BARAT,TAMBORA,DURI SELATAN,14259,4572,9687,6536,16223,2021-09-05
3173041003,JAKARTA BARAT,TAMBORA,DURI UTARA,19844,6672,13172,8537,21709,2021-09-05
3171081003,JAKARTA PUSAT,JOHAR BARU,GALUR,18243,5621,12622,8012,20634,2021-09-05
3171011001,JAKARTA PUSAT,GAMBIR,GAMBIR,2191,734,1457,1032,2489,2021-09-05
3174061004,JAKARTA SELATAN,CILANDAK,GANDARIA SELATAN,22119,8242,13877,8414,22291,2021-09-05
3174071009,JAKARTA SELATAN,KEBAYORAN BARU,GANDARIA UTARA,39922,15000,24922,15609,40531,2021-09-05
3175051001,JAKARTA TIMUR,PASAR REBO,GEDONG,35755,12411,23344,15864,39208,2021-09-05
3171071001,JAKARTA PUSAT,TANAH ABANG,GELORA,3127,1182,1945,1273,3218,2021-09-05
3173031007,JAKARTA BARAT,TAMAN SARI,GLODOK,7837,2337,5500,4075,9575,2021-09-05
3171061004,JAKARTA PUSAT,MENTENG,GONDANGDIA,4100,1475,2625,2024,4649,2021-09-05
3173021001,JAKARTA BARAT,GROGOL PETAMBURAN,GROGOL,16876,6018,10858,7252,18110,2021-09-05
3174051005,JAKARTA SELATAN,KEBAYORAN LAMA,GROGOL SELATAN,44251,16955,27296,15852,43148,2021-09-05
3174051004,JAKARTA SELATAN,KEBAYORAN LAMA,GROGOL UTARA,42494,16062,26432,15549,41981,2021-09-05
3174021007,JAKARTA SELATAN,SETIA BUDI,GUNTUR,3985,1377,2608,1890,4498,2021-09-05
3174071002,JAKARTA SELATAN,KEBAYORAN BARU,GUNUNG,9436,3330,6106,4267,10373,2021-09-05
3171031005,JAKARTA PUSAT,KEMAYORAN,GUNUNG SAHARI SELATAN,19199,6884,12315,8414,20729,2021-09-05
3171021004,JAKARTA PUSAT,SAWAH BESAR,GUNUNG SAHARI UTARA,16650,5146,11504,8511,20015,2021-09-05
3175081004,JAKARTA TIMUR,MAKASAR,HALIM PERDANA KUSUMAH,28363,7771,20592,16223,36815,2021-09-05
3171031003,JAKARTA PUSAT,KEMAYORAN,HARAPAN MULIA,22557,8008,14549,9637,24186,2021-09-05
3174091001,JAKARTA SELATAN,JAGAKARSA,JAGAKARSA,62389,21834,40555,26082,66637,2021-09-05
3175021007,JAKARTA TIMUR,PULO GADUNG,JATI,32757,11720,21037,14027,35064,2021-09-05
3174041002,JAKARTA SELATAN,PASAR MINGGU,JATI PADANG,37502,13818,23684,15091,38775,2021-09-05
3173071004,JAKARTA BARAT,PALMERAH,JATI PULO,28738,9621,19117,11976,31093,2021-09-05
3175061001,JAKARTA TIMUR,CAKUNG,JATINEGARA,84160,31053,53107,35899,89006,2021-09-05
3175021004,JAKARTA TIMUR,PULO GADUNG,JATINEGARA KAUM,24632,8238,16394,9694,26088,2021-09-05
3173021004,JAKARTA BARAT,GROGOL PETAMBURAN,JELAMBAR,30266,10620,19646,14097,33743,2021-09-05
3173021006,JAKARTA BARAT,GROGOL PETAMBURAN,JELAMBAR BARU,38246,13442,24804,17344,42148,2021-09-05
3173041006,JAKARTA BARAT,TAMBORA,JEMBATAN BESI,29314,11738,17576,10009,27585,2021-09-05
3173041008,JAKARTA BARAT,TAMBORA,JEMBATAN LIMA,21021,8007,13014,7867,20881,2021-09-05
3173081005,JAKARTA BARAT,KEMBANGAN,JOGLO,40839,14664,26175,17113,43288,2021-09-05
3171081001,JAKARTA PUSAT,JOHAR BARU,JOHAR BARU,37488,11901,25587,17115,42702,2021-09-05
3173041002,JAKARTA BARAT,TAMBORA,KALI ANYAR,23856,8036,15820,9301,25121,2021-09-05
3172041004,JAKARTA UTARA,CILINCING,KALIBARU,67684,27062,40622,23338,63960,2021-09-05
3174081002,JAKARTA SELATAN,PANCORAN,KALIBATA,41994,17362,24632,13332,37964,2021-09-05
3173061001,JAKARTA BARAT,KALI DERES,KALIDERES,72447,26230,46217,32857,79074,2021-09-05
3175051004,JAKARTA TIMUR,PASAR REBO,KALISARI,43212,14556,28656,19681,48337,2021-09-05
3173061004,JAKARTA BARAT,KALI DERES,KAMAL,53783,20013,33770,20301,54071,2021-09-05
3172011002,JAKARTA UTARA,PENJARINGAN,KAMAL MUARA,12930,3437,9493,6952,16445,2021-09-05
3171071007,JAKARTA PUSAT,TANAH ABANG,KAMPUNG BALI,11358,4426,6932,4293,11225,2021-09-05
3175031001,JAKARTA TIMUR,JATINEGARA,KAMPUNG MELAYU,25717,10334,15383,9537,24920,2021-09-05
3171081002,JAKARTA PUSAT,JOHAR BARU,KAMPUNG RAWA,21237,5704,15533,9584,25117,2021-09-05
3175041002,JAKARTA TIMUR,KRAMAT JATI,KAMPUNG TENGAH,43993,17654,26339,15636,41975,2021-09-05
3173011005,JAKARTA BARAT,CENGKARENG,KAPUK,134466,51553,82913,48161,131074,2021-09-05
3172011003,JAKARTA UTARA,PENJARINGAN,KAPUK MUARA,35781,11046,24735,18493,43228,2021-09-05
3171021002,JAKARTA PUSAT,SAWAH BESAR,KARANG ANYAR,25761,8545,17216,11405,28621,2021-09-05
3174021004,JAKARTA SELATAN,SETIA BUDI,KARET,9623,3626,5997,3943,9940,2021-09-05
3174021003,JAKARTA SELATAN,SETIA BUDI,KARET KUNINGAN,16055,5361,10694,7016,17710,2021-09-05
3174021002,JAKARTA SELATAN,SETIA BUDI,KARET SEMANGGI,2770,951,1819,1371,3190,2021-09-05
3171071003,JAKARTA PUSAT,TANAH ABANG,KARET TENGSIN,19271,6986,12285,7956,20241,2021-09-05
3171021003,JAKARTA PUSAT,SAWAH BESAR,KARTINI,22292,7671,14621,10205,24826,2021-09-05
3175011003,JAKARTA TIMUR,MATRAMAN,KAYU MANIS,25284,9872,15412,9206,24618,2021-09-05
3175021006,JAKARTA TIMUR,PULO GADUNG,KAYU PUTIH,40696,13855,26841,19242,46083,2021-09-05
3173031006,JAKARTA BARAT,TAMAN SARI,KEAGUNGAN,17387,5896,11491,7716,19207,2021-09-05
3174041007,JAKARTA SELATAN,PASAR MINGGU,KEBAGUSAN,44552,17095,27457,16403,43860,2021-09-05
3174051006,JAKARTA SELATAN,KEBAYORAN LAMA,KEBAYORAN LAMA SELATAN,41212,14773,26439,15711,42150,2021-09-05
3174051001,JAKARTA SELATAN,KEBAYORAN LAMA,KEBAYORAN LAMA UTARA,42422,16580,25842,14251,40093,2021-09-05
3174011004,JAKARTA SELATAN,TEBET,KEBON BARU,35165,12934,22231,13503,35734,2021-09-05
3172021005,JAKARTA UTARA,TANJUNG PRIOK,KEBON BAWANG,50952,18064,32888,21439,54327,2021-09-05
3173051001,JAKARTA BARAT,KEBON JERUK,KEBON JERUK,53887,20379,33508,21193,54701,2021-09-05
3171071006,JAKARTA PUSAT,TANAH ABANG,KEBON KACANG,21531,8943,12588,7965,20553,2021-09-05
3171011005,JAKARTA PUSAT,GAMBIR,KEBON KELAPA,10163,3553,6610,4403,11013,2021-09-05
3171031002,JAKARTA PUSAT,KEMAYORAN,KEBON KOSONG,30019,10712,19307,12607,31914,2021-09-05
3175011005,JAKARTA TIMUR,MATRAMAN,KEBON MANGGIS,16490,5864,10626,7088,17714,2021-09-05
3171071005,JAKARTA PUSAT,TANAH ABANG,KEBON MELATI,32206,14114,18092,11064,29156,2021-09-05
3175081003,JAKARTA TIMUR,MAKASAR,KEBON PALA,46614,16701,29913,18602,48515,2021-09-05
3171061005,JAKARTA PUSAT,MENTENG,KEBON SIRIH,12299,4506,7793,5110,12903,2021-09-05
3173011004,JAKARTA BARAT,CENGKARENG,KEDAUNG KALI ANGKE,32612,10512,22100,15069,37169,2021-09-05
3173051007,JAKARTA BARAT,KEBON JERUK,KEDOYA SELATAN,32165,10977,21188,13558,34746,2021-09-05
3173051006,JAKARTA BARAT,KEBON JERUK,KEDOYA UTARA,45740,14760,30980,21637,52617,2021-09-05
3173051004,JAKARTA BARAT,KEBON JERUK,KELAPA DUA,23565,8761,14804,9179,23983,2021-09-05
3175091003,JAKARTA TIMUR,CIRACAS,KELAPA DUA WETAN,46875,15000,31875,21099,52974,2021-09-05
3172061003,JAKARTA UTARA,KELAPA GADING,KELAPA GADING BARAT,35717,11150,24567,18825,43392,2021-09-05
3172061001,JAKARTA UTARA,KELAPA GADING,KELAPA GADING TIMUR,33592,9585,24007,18305,42312,2021-09-05
3173071005,JAKARTA BARAT,PALMERAH,KEMANGGISAN,32139,11356,20783,13505,34288,2021-09-05
3171031001,JAKARTA PUSAT,KEMAYORAN,KEMAYORAN,20708,7093,13615,9268,22883,2021-09-05
3173081006,JAKARTA BARAT,KEMBANGAN,KEMBANGAN SELATAN,27130,9657,17473,12630,30103,2021-09-05
3173081001,JAKARTA BARAT,KEMBANGAN,KEMBANGAN UTARA,54451,19413,35038,23553,58591,2021-09-05
3171041002,JAKARTA PUSAT,SENEN,KENARI,9579,3302,6277,4493,10770,2021-09-05
3173041005,JAKARTA BARAT,TAMBORA,KERENDANG,19973,6911,13062,8469,21531,2021-09-05
3175071003,JAKARTA TIMUR,DUREN SAWIT,KLENDER,69978,27920,42058,25796,67854,2021-09-05
3172031001,JAKARTA UTARA,KOJA,KOJA,28175,10548,17627,11591,29218,2021-09-05
3173071006,JAKARTA BARAT,PALMERAH,KOTA BAMBU SELATAN,21158,7663,13495,8268,21763,2021-09-05
3173071003,JAKARTA BARAT,PALMERAH,KOTA BAMBU UTARA,24995,9192,15803,9746,25549,2021-09-05
3171041004,JAKARTA PUSAT,SENEN,KRAMAT,28835,10777,18058,10609,28667,2021-09-05
3175041001,JAKARTA TIMUR,KRAMAT JATI,KRAMAT JATI,34144,12410,21734,13221,34955,2021-09-05
3174071003,JAKARTA SELATAN,KEBAYORAN BARU,KRAMAT PELA,14413,5023,9390,5987,15377,2021-09-05
3173031002,JAKARTA BARAT,TAMAN SARI,KRUKUT,19244,6630,12614,8093,20707,2021-09-05
3174031005,JAKARTA SELATAN,MAMPANG PRAPATAN,KUNINGAN BARAT,12785,4481,8304,5169,13473,2021-09-05
3174021008,JAKARTA SELATAN,SETIA BUDI,KUNINGAN TIMUR,6008,2141,3867,2565,6432,2021-09-05
3171041005,JAKARTA PUSAT,SENEN,KWITANG,15486,5546,9940,6548,16488,2021-09-05
3172031003,JAKARTA UTARA,KOJA,LAGOA,59065,22535,36530,22794,59324,2021-09-05
3174061002,JAKARTA SELATAN,CILANDAK,LEBAK BULUS,37626,14292,23334,14879,38213,2021-09-05
3174091004,JAKARTA SELATAN,JAGAKARSA,LENTENG AGUNG,53946,20539,33407,19023,52430,2021-09-05
3175101007,JAKARTA TIMUR,CIPAYUNG,LUBANG BUAYA,63547,21095,42452,28537,70989,2021-09-05
3175081001,JAKARTA TIMUR,MAKASAR,MAKASAR,34390,11846,22544,15093,37637,2021-09-05
3175071006,JAKARTA TIMUR,DUREN SAWIT,MALAKA JAYA,30927,11161,19766,14045,33811,2021-09-05
3175071005,JAKARTA TIMUR,DUREN SAWIT,MALAKA SARI,27530,9592,17938,12897,30835,2021-09-05
3174031001,JAKARTA SELATAN,MAMPANG PRAPATAN,MAMPANG PRAPATAN,18159,6671,11488,7310,18798,2021-09-05
3173031005,JAKARTA BARAT,TAMAN SARI,MANGGA BESAR,7707,2327,5380,3813,9193,2021-09-05
3171021005,JAKARTA PUSAT,SAWAH BESAR,MANGGA DUA SELATAN,27442,9415,18027,12325,30352,2021-09-05
3174011007,JAKARTA SELATAN,TEBET,MANGGARAI,28373,9572,18801,10964,29765,2021-09-05
3174011006,JAKARTA SELATAN,TEBET,MANGGARAI SELATAN,23075,8047,15028,9284,24312,2021-09-05
3173031003,JAKARTA BARAT,TAMAN SARI,MAPHAR,16461,5785,10676,7257,17933,2021-09-05
3172041003,JAKARTA UTARA,CILINCING,MARUNDA,28943,9858,19085,10101,29186,2021-09-05
3174071001,JAKARTA SELATAN,KEBAYORAN BARU,MELAWAI,2627,895,1732,1369,3101,2021-09-05
3171061001,JAKARTA PUSAT,MENTENG,MENTENG,25624,9712,15912,10319,26231,2021-09-05
3174021005,JAKARTA SELATAN,SETIA BUDI,MENTENG ATAS,27816,9517,18299,11194,29493,2021-09-05
3174011003,JAKARTA SELATAN,TEBET,MENTENG DALAM,36028,13154,22874,14307,37181,2021-09-05
3173081003,JAKARTA BARAT,KEMBANGAN,MERUYA SELATAN,32130,11544,20586,13886,34472,2021-09-05
3173081002,JAKARTA BARAT,KEMBANGAN,MERUYA UTARA,43752,15952,27800,19901,47701,2021-09-05
3175101004,JAKARTA TIMUR,CIPAYUNG,MUNJUL,23871,8000,15871,10960,26831,2021-09-05
3172051002,JAKARTA UTARA,PADEMANGAN,PADEMANGAN BARAT,74240,27458,46782,30411,77193,2021-09-05
3172051001,JAKARTA UTARA,PADEMANGAN,PADEMANGAN TIMUR,37736,11660,26076,18564,44640,2021-09-05
3175011004,JAKARTA TIMUR,MATRAMAN,PAL MERIAM,19769,7615,12154,7721,19875,2021-09-05
3173071001,JAKARTA BARAT,PALMERAH,PALMERAH,63011,23074,39937,24989,64926,2021-09-05
3174081001,JAKARTA SELATAN,PANCORAN,PANCORAN,19421,7221,12200,7405,19605,2021-09-05
3172021003,JAKARTA UTARA,TANJUNG PRIOK,PAPANGGO,39097,12925,26172,17252,43424,2021-09-05
3171021001,JAKARTA PUSAT,SAWAH BESAR,PASAR BARU,12035,3744,8291,6079,14370,2021-09-05
3174021006,JAKARTA SELATAN,SETIA BUDI,PASAR MANGGIS,26752,9776,16976,10431,27407,2021-09-05
3174041001,JAKARTA SELATAN,PASAR MINGGU,PASAR MINGGU,24821,9065,15756,10237,25993,2021-09-05
3171041003,JAKARTA PUSAT,SENEN,PASEBAN,23533,8628,14905,9566,24471,2021-09-05
3173061005,JAKARTA BARAT,KALI DERES,PEGADUNGAN,75587,25339,50248,35351,85599,2021-09-05
3171061002,JAKARTA PUSAT,MENTENG,PEGANGSAAN,23455,8690,14765,9091,23856,2021-09-05
3172061002,JAKARTA UTARA,KELAPA GADING,PEGANGSAAN DUA,49976,14242,35734,26675,62409,2021-09-05
3172011004,JAKARTA UTARA,PENJARINGAN,PEJAGALAN,74578,26244,48334,33297,81631,2021-09-05
3174041006,JAKARTA SELATAN,PASAR MINGGU,PEJATEN BARAT,37346,14049,23297,14697,37994,2021-09-05
3174041005,JAKARTA SELATAN,PASAR MINGGU,PEJATEN TIMUR,57656,22579,35077,19881,54958,2021-09-05
3175051005,JAKARTA TIMUR,PASAR REBO,PEKAYON,43250,14457,28793,19354,48147,2021-09-05
3173041009,JAKARTA BARAT,TAMBORA,PEKOJAN,23587,7739,15848,10881,26729,2021-09-05
3174031003,JAKARTA SELATAN,MAMPANG PRAPATAN,PELA MAMPANG,43522,15768,27754,18119,45873,2021-09-05
3174081005,JAKARTA SELATAN,PANCORAN,PENGADEGAN,21478,7186,14292,7867,22159,2021-09-05
3175061003,JAKARTA TIMUR,CAKUNG,PENGGILINGAN,99255,39476,59779,36974,96753,2021-09-05
3172011001,JAKARTA UTARA,PENJARINGAN,PENJARINGAN,88308,34015,54293,34215,88508,2021-09-05
3174101001,JAKARTA SELATAN,PESANGGRAHAN,PESANGGRAHAN,27545,9461,18084,11370,29454,2021-09-05
3171071004,JAKARTA PUSAT,TANAH ABANG,PETAMBURAN,33271,14674,18597,11278,29875,2021-09-05
3174071008,JAKARTA SELATAN,KEBAYORAN BARU,PETOGOGAN,11499,4281,7218,4728,11946,2021-09-05
3171011004,JAKARTA PUSAT,GAMBIR,PETOJO SELATAN,14692,5402,9290,6302,15592,2021-09-05
3171011003,JAKARTA PUSAT,GAMBIR,PETOJO UTARA,17458,6295,11163,7230,18393,2021-09-05
3174101004,JAKARTA SELATAN,PESANGGRAHAN,PETUKANGAN SELATAN,37187,13716,23471,14182,37653,2021-09-05
3174101003,JAKARTA SELATAN,PESANGGRAHAN,PETUKANGAN UTARA,53716,20975,32741,19992,52733,2021-09-05
3175081002,JAKARTA TIMUR,MAKASAR,PINANG RANTI,27198,9784,17414,11608,29022,2021-09-05
3173031008,JAKARTA BARAT,TAMAN SARI,PINANGSIA,10729,3348,7381,4950,12331,2021-09-05
3175011001,JAKARTA TIMUR,MATRAMAN,PISANGAN BARU,31776,12126,19650,11623,31273,2021-09-05
3175021002,JAKARTA TIMUR,PULO GADUNG,PISANGAN TIMUR,41011,14094,26917,17745,44662,2021-09-05
3172011005,JAKARTA UTARA,PENJARINGAN,PLUIT,47783,15696,32087,23733,55820,2021-09-05
3175071002,JAKARTA TIMUR,DUREN SAWIT,PONDOK BAMBU,61550,23658,37892,23810,61702,2021-09-05
3175071004,JAKARTA TIMUR,DUREN SAWIT,PONDOK KELAPA,72015,26104,45911,29621,75532,2021-09-05
3175071007,JAKARTA TIMUR,DUREN SAWIT,PONDOK KOPI,35367,14543,20824,12735,33559,2021-09-05
3174061003,JAKARTA SELATAN,CILANDAK,PONDOK LABU,46464,16126,30338,20350,50688,2021-09-05
3174051002,JAKARTA SELATAN,KEBAYORAN LAMA,PONDOK PINANG,56169,20918,35251,22202,57453,2021-09-05
3175101003,JAKARTA TIMUR,CIPAYUNG,PONDOK RANGGON,25574,8812,16762,11358,28120,2021-09-05
3101011003,KAB.ADM.KEP.SERIBU,KEP. SERIBU UTARA,PULAU HARAPAN,2060,336,1724,1030,2754,2021-09-05
3101011002,KAB.ADM.KEP.SERIBU,KEP. SERIBU UTARA,PULAU KELAPA,5528,893,4635,2650,7285,2021-09-05
3101011001,KAB.ADM.KEP.SERIBU,KEP. SERIBU UTARA,PULAU PANGGANG,5450,833,4617,2189,6806,2021-09-05
3101021003,KAB.ADM.KEP.SERIBU,KEP. SERIBU SELATAN,PULAU PARI,2765,318,2447,1474,3921,2021-09-05
3101021002,KAB.ADM.KEP.SERIBU,KEP. SERIBU SELATAN,PULAU TIDUNG,4553,615,3938,2683,6621,2021-09-05
3101021001,KAB.ADM.KEP.SERIBU,KEP. SERIBU SELATAN,PULAU UNTUNG JAWA,1941,319,1622,1016,2638,2021-09-05
3174071007,JAKARTA SELATAN,KEBAYORAN BARU,PULO,5835,1961,3874,2835,6709,2021-09-05
3175021001,JAKARTA TIMUR,PULO GADUNG,PULO GADUNG,34422,12438,21984,14134,36118,2021-09-05
3175061005,JAKARTA TIMUR,CAKUNG,PULO GEBANG,97301,35429,61872,39800,101672,2021-09-05
3174041004,JAKARTA SELATAN,PASAR MINGGU,RAGUNAN,39616,13940,25676,16387,42063,2021-09-05
3175091005,JAKARTA TIMUR,CIRACAS,RAMBUTAN,36771,14500,22271,14261,36532,2021-09-05
3172031006,JAKARTA UTARA,KOJA,RAWA BADAK SELATAN,42179,16268,25911,16152,42063,2021-09-05
3172031004,JAKARTA UTARA,KOJA,RAWA BADAK UTARA,34408,12963,21445,13615,35060,2021-09-05
3174071005,JAKARTA SELATAN,KEBAYORAN BARU,RAWA BARAT,5625,1883,3742,2579,6321,2021-09-05
3173011003,JAKARTA BARAT,CENGKARENG,RAWA BUAYA,63799,22867,40932,24807,65739,2021-09-05
3175031004,JAKARTA TIMUR,JATINEGARA,RAWA BUNGA,21434,8411,13023,8421,21444,2021-09-05
3174081003,JAKARTA SELATAN,PANCORAN,RAWA JATI,20509,7404,13105,7793,20898,2021-09-05
3175061002,JAKARTA TIMUR,CAKUNG,RAWA TERATE,24637,7939,16698,11554,28252,2021-09-05
3175021005,JAKARTA TIMUR,PULO GADUNG,RAWAMANGUN,37612,13665,23947,16103,40050,2021-09-05
3171051003,JAKARTA PUSAT,CEMPAKA PUTIH,RAWASARI,21967,8021,13946,9663,23609,2021-09-05
3173041010,JAKARTA BARAT,TAMBORA,ROA MALAKA,3484,1035,2449,1772,4221,2021-09-05
3172041006,JAKARTA UTARA,CILINCING,ROROTAN,41668,13854,27814,17266,45080,2021-09-05
3174071004,JAKARTA SELATAN,KEBAYORAN BARU,SELONG,2842,977,1865,1414,3279,2021-09-05
3173061002,JAKARTA BARAT,KALI DERES,SEMANAN,71354,26785,44569,26666,71235,2021-09-05
3172041007,JAKARTA UTARA,CILINCING,SEMPER BARAT,68587,22598,45989,30809,76798,2021-09-05
3172041005,JAKARTA UTARA,CILINCING,SEMPER TIMUR,36267,12502,23765,15109,38874,2021-09-05
3174071006,JAKARTA SELATAN,KEBAYORAN BARU,SENAYAN,2771,1120,1651,1101,2752,2021-09-05
3171041001,JAKARTA PUSAT,SENEN,SENEN,6804,2313,4491,3121,7612,2021-09-05
3171031004,JAKARTA PUSAT,KEMAYORAN,SERDANG,29668,10570,19098,12439,31537,2021-09-05
3174021001,JAKARTA SELATAN,SETIA BUDI,SETIA BUDI,3023,1115,1908,1296,3204,2021-09-05
3175101005,JAKARTA TIMUR,CIPAYUNG,SETU,20572,7605,12967,8260,21227,2021-09-05
3173071002,JAKARTA BARAT,PALMERAH,SLIPI,16591,5604,10987,7293,18280,2021-09-05
3173081004,JAKARTA BARAT,KEMBANGAN,SRENGSENG,45523,17107,28416,18436,46852,2021-09-05
3174091002,JAKARTA SELATAN,JAGAKARSA,SRENGSENG SAWAH,58196,18906,39290,24433,63723,2021-09-05
3173051003,JAKARTA BARAT,KEBON JERUK,SUKABUMI SELATAN,37033,14256,22777,12246,35023,2021-09-05
3173051002,JAKARTA BARAT,KEBON JERUK,SUKABUMI UTARA,38290,14977,23313,12633,35946,2021-09-05
3172041002,JAKARTA UTARA,CILINCING,SUKAPURA,53949,19670,34279,22825,57104,2021-09-05
3171031007,JAKARTA PUSAT,KEMAYORAN,SUMUR BATU,22717,8214,14503,9853,24356,2021-09-05
3172021004,JAKARTA UTARA,TANJUNG PRIOK,SUNGAI BAMBU,29876,10413,19463,12485,31948,2021-09-05
3172021006,JAKARTA UTARA,TANJUNG PRIOK,SUNTER AGUNG,71805,21964,49841,36226,86067,2021-09-05
3172021002,JAKARTA UTARA,TANJUNG PRIOK,SUNTER JAYA,63031,20012,43019,30847,73866,2021-09-05
3175091004,JAKARTA TIMUR,CIRACAS,SUSUKAN,38257,12632,25625,16060,41685,2021-09-05
3173031001,JAKARTA BARAT,TAMAN SARI,TAMAN SARI,14348,4960,9388,6727,16115,2021-09-05
3173041001,JAKARTA BARAT,TAMBORA,TAMBORA,10204,3657,6547,4040,10587,2021-09-05
3173041004,JAKARTA BARAT,TAMBORA,TANAH SEREAL,26387,7899,18488,12328,30816,2021-09-05
3171081004,JAKARTA PUSAT,JOHAR BARU,TANAH TINGGI,37693,11421,26272,16432,42704,2021-09-05
3173031004,JAKARTA BARAT,TAMAN SARI,TANGKI,13324,4500,8824,6259,15083,2021-09-05
3174091005,JAKARTA SELATAN,JAGAKARSA,TANJUNG BARAT,39770,14113,25657,14910,40567,2021-09-05
3173021005,JAKARTA BARAT,GROGOL PETAMBURAN,TANJUNG DUREN SELATAN,25337,8811,16526,11582,28108,2021-09-05
3173021002,JAKARTA BARAT,GROGOL PETAMBURAN,TANJUNG DUREN UTARA,17010,5599,11411,7937,19348,2021-09-05
3172021001,JAKARTA UTARA,TANJUNG PRIOK,TANJUNG PRIOK,34588,11499,23089,14701,37790,2021-09-05
3174011002,JAKARTA SELATAN,TEBET,TEBET BARAT,21194,7077,14117,9353,23470,2021-09-05
3174011001,JAKARTA SELATAN,TEBET,TEBET TIMUR,18199,6069,12130,8026,20156,2021-09-05
3173061003,JAKARTA BARAT,KALI DERES,TEGAL ALUR,83647,29662,53985,32441,86426,2021-09-05
3174031004,JAKARTA SELATAN,MAMPANG PRAPATAN,TEGAL PARANG,32401,12709,19692,11411,31103,2021-09-05
3173021003,JAKARTA BARAT,GROGOL PETAMBURAN,TOMANG,29605,10206,19399,13800,33199,2021-09-05
3172031005,JAKARTA UTARA,KOJA,TUGU SELATAN,39122,14657,24465,15592,40057,2021-09-05
3172031002,JAKARTA UTARA,KOJA,TUGU UTARA,67670,26064,41606,26234,67840,2021-09-05
3175061006,JAKARTA TIMUR,CAKUNG,UJUNG MENTENG,29934,9751,20183,13859,34042,2021-09-05
3174101005,JAKARTA SELATAN,PESANGGRAHAN,ULUJAMI,40544,16204,24340,14030,38370,2021-09-05
3175011006,JAKARTA TIMUR,MATRAMAN,UTAN KAYU SELATAN,33511,11653,21858,13893,35751,2021-09-05
3175011002,JAKARTA TIMUR,MATRAMAN,UTAN KAYU UTARA,28169,10681,17488,10958,28446,2021-09-05
3171031008,JAKARTA PUSAT,KEMAYORAN,UTAN PANJANG,29208,10809,18399,12003,30402,2021-09-05
3172021007,JAKARTA UTARA,TANJUNG PRIOK,WARAKAS,44401,14742,29659,18620,48279,2021-09-05
3173021007,JAKARTA BARAT,GROGOL PETAMBURAN,WIJAYA KUSUMA,38934,14242,24692,17109,41801,2021-09-05
3172051003,JAKARTA UTARA,PADEMANGAN,ANCOL,23947,9000,14947,10038,24985,2021-09-06
3173041007,JAKARTA BARAT,TAMBORA,ANGKE,29381,10228,19153,11388,30541,2021-09-06
3175041005,JAKARTA TIMUR,KRAMAT JATI,BALE KAMBANG,29074,12274,16800,8875,25675,2021-09-06
3175031003,JAKARTA TIMUR,JATINEGARA,BALI MESTER,9752,3637,6115,4093,10208,2021-09-06
3175101006,JAKARTA TIMUR,CIPAYUNG,BAMBU APUS,26285,9144,17141,11585,28726,2021-09-06
3174031002,JAKARTA SELATAN,MAMPANG PRAPATAN,BANGKA,21566,8316,13250,8265,21515,2021-09-06
3175051002,JAKARTA TIMUR,PASAR REBO,BARU,23886,7518,16368,11962,28330,2021-09-06
3175041004,JAKARTA TIMUR,KRAMAT JATI,BATU AMPAR,47898,19435,28463,17081,45544,2021-09-06
3171071002,JAKARTA PUSAT,TANAH ABANG,BENDUNGAN HILIR,21494,7914,13580,9150,22730,2021-09-06
3175031002,JAKARTA TIMUR,JATINEGARA,BIDARA CINA,36689,15005,21684,13639,35323,2021-09-06
3174101002,JAKARTA SELATAN,PESANGGRAHAN,BINTARO,53098,20020,33078,21049,54127,2021-09-06
3174011005,JAKARTA SELATAN,TEBET,BUKIT DURI,34183,13316,20867,12166,33033,2021-09-06
3171041006,JAKARTA PUSAT,SENEN,BUNGUR,18144,6362,11782,7827,19609,2021-09-06
3175061007,JAKARTA TIMUR,CAKUNG,CAKUNG BARAT,57724,19252,38472,24597,63069,2021-09-06
3175061004,JAKARTA TIMUR,CAKUNG,CAKUNG TIMUR,58287,19784,38503,27068,65571,2021-09-06
3175041007,JAKARTA TIMUR,KRAMAT JATI,CAWANG,32762,12536,20226,12631,32857,2021-09-06
3175101008,JAKARTA TIMUR,CIPAYUNG,CEGER,18932,6548,12384,8539,20923,2021-09-06
3171031006,JAKARTA PUSAT,KEMAYORAN,CEMPAKA BARU,32581,11823,20758,13099,33857,2021-09-06
3171051002,JAKARTA PUSAT,CEMPAKA PUTIH,CEMPAKA PUTIH BARAT,35885,13093,22792,16239,39031,2021-09-06
3171051001,JAKARTA PUSAT,CEMPAKA PUTIH,CEMPAKA PUTIH TIMUR,24292,8523,15769,10993,26762,2021-09-06
3173011001,JAKARTA BARAT,CENGKARENG,CENGKARENG BARAT,66284,23025,43259,28766,72025,2021-09-06
3173011006,JAKARTA BARAT,CENGKARENG,CENGKARENG TIMUR,81027,27543,53484,32430,85914,2021-09-06
3175091002,JAKARTA TIMUR,CIRACAS,CIBUBUR,66364,21735,44629,30176,74805,2021-09-06
3171011002,JAKARTA PUSAT,GAMBIR,CIDENG,15390,5141,10249,7225,17474,2021-09-06
3174091003,JAKARTA SELATAN,JAGAKARSA,CIGANJUR,38497,13907,24590,14730,39320,2021-09-06
3175051003,JAKARTA TIMUR,PASAR REBO,CIJANTUNG,41419,13661,27758,18836,46594,2021-09-06
3171061003,JAKARTA PUSAT,MENTENG,CIKINI,8274,2918,5356,3372,8728,2021-09-06
3174081006,JAKARTA SELATAN,PANCORAN,CIKOKO,10547,3630,6917,4098,11015,2021-09-06
3174061001,JAKARTA SELATAN,CILANDAK,CILANDAK BARAT,51752,18610,33142,20999,54141,2021-09-06
3174041003,JAKARTA SELATAN,PASAR MINGGU,CILANDAK TIMUR,25145,8935,16210,10862,27072,2021-09-06
3175101002,JAKARTA TIMUR,CIPAYUNG,CILANGKAP,27635,9414,18221,12475,30696,2021-09-06
3175041006,JAKARTA TIMUR,KRAMAT JATI,CILILITAN,40181,15996,24185,15651,39836,2021-09-06
3172041001,JAKARTA UTARA,CILINCING,CILINCING,43609,16423,27186,16519,43705,2021-09-06
3175101001,JAKARTA TIMUR,CIPAYUNG,CIPAYUNG,26104,8209,17895,12708,30603,2021-09-06
3174091006,JAKARTA SELATAN,JAGAKARSA,CIPEDAK,38303,12861,25442,15964,41406,2021-09-06
3174061005,JAKARTA SELATAN,CILANDAK,CIPETE SELATAN,26704,10042,16662,11286,27948,2021-09-06
3174071010,JAKARTA SELATAN,KEBAYORAN BARU,CIPETE UTARA,34102,12502,21600,13481,35081,2021-09-06
3175021003,JAKARTA TIMUR,PULO GADUNG,CIPINANG,39306,14278,25028,16470,41498,2021-09-06
3175031007,JAKARTA TIMUR,JATINEGARA,CIPINANG BESAR SELATAN,35212,13926,21286,12746,34032,2021-09-06
3175031008,JAKARTA TIMUR,JATINEGARA,CIPINANG BESAR UTARA,45319,17990,27329,16770,44099,2021-09-06
3175031005,JAKARTA TIMUR,JATINEGARA,CIPINANG CEMPEDAK,32824,13068,19756,13378,33134,2021-09-06
3175081005,JAKARTA TIMUR,MAKASAR,CIPINANG MELAYU,42308,15736,26572,18134,44706,2021-09-06
3175031006,JAKARTA TIMUR,JATINEGARA,CIPINANG MUARA,55243,21697,33546,21670,55216,2021-09-06
3174051003,JAKARTA SELATAN,KEBAYORAN LAMA,CIPULIR,39937,16006,23931,13282,37213,2021-09-06
3175091001,JAKARTA TIMUR,CIRACAS,CIRACAS,64594,21044,43550,27969,71519,2021-09-06
3175041003,JAKARTA TIMUR,KRAMAT JATI,DUKUH,24609,8461,16148,10777,26925,2021-09-06
3175071001,JAKARTA TIMUR,DUREN SAWIT,DUREN SAWIT,61160,23776,37384,24383,61767,2021-09-06
3174081004,JAKARTA SELATAN,PANCORAN,DUREN TIGA,28319,10504,17815,9722,27537,2021-09-06
3173051005,JAKARTA BARAT,KEBON JERUK,DURI KEPA,60138,20272,39866,26949,66815,2021-09-06
3173011002,JAKARTA BARAT,CENGKARENG,DURI KOSAMBI,77923,29872,48051,28827,76878,2021-09-06
3171011006,JAKARTA PUSAT,GAMBIR,DURI PULO,19610,6900,12710,8075,20785,2021-09-06
3173041011,JAKARTA BARAT,TAMBORA,DURI SELATAN,14259,4572,9687,6536,16223,2021-09-06
3173041003,JAKARTA BARAT,TAMBORA,DURI UTARA,19844,6672,13172,8538,21710,2021-09-06
3171081003,JAKARTA PUSAT,JOHAR BARU,GALUR,18243,5621,12622,8012,20634,2021-09-06
3171011001,JAKARTA PUSAT,GAMBIR,GAMBIR,2191,734,1457,1032,2489,2021-09-06
3174061004,JAKARTA SELATAN,CILANDAK,GANDARIA SELATAN,22119,8242,13877,8414,22291,2021-09-06
3174071009,JAKARTA SELATAN,KEBAYORAN BARU,GANDARIA UTARA,39922,15000,24922,15609,40531,2021-09-06
3175051001,JAKARTA TIMUR,PASAR REBO,GEDONG,35755,12411,23344,15864,39208,2021-09-06
3171071001,JAKARTA PUSAT,TANAH ABANG,GELORA,3127,1182,1945,1273,3218,2021-09-06
3173031007,JAKARTA BARAT,TAMAN SARI,GLODOK,7837,2337,5500,4075,9575,2021-09-06
3171061004,JAKARTA PUSAT,MENTENG,GONDANGDIA,4100,1475,2625,2024,4649,2021-09-06
3173021001,JAKARTA BARAT,GROGOL PETAMBURAN,GROGOL,16876,6018,10858,7252,18110,2021-09-06
3174051005,JAKARTA SELATAN,KEBAYORAN LAMA,GROGOL SELATAN,44251,16955,27296,15852,43148,2021-09-06
3174051004,JAKARTA SELATAN,KEBAYORAN LAMA,GROGOL UTARA,42494,16062,26432,15549,41981,2021-09-06
3174021007,JAKARTA SELATAN,SETIA BUDI,GUNTUR,3985,1377,2608,1890,4498,2021-09-06
3174071002,JAKARTA SELATAN,KEBAYORAN BARU,GUNUNG,9436,3330,6106,4267,10373,2021-09-06
3171031005,JAKARTA PUSAT,KEMAYORAN,GUNUNG SAHARI SELATAN,19199,6884,12315,8414,20729,2021-09-06
3171021004,JAKARTA PUSAT,SAWAH BESAR,GUNUNG SAHARI UTARA,16650,5145,11505,8511,20016,2021-09-06
3175081004,JAKARTA TIMUR,MAKASAR,HALIM PERDANA KUSUMAH,28363,7771,20592,16223,36815,2021-09-06
3171031003,JAKARTA PUSAT,KEMAYORAN,HARAPAN MULIA,22557,8008,14549,9637,24186,2021-09-06
3174091001,JAKARTA SELATAN,JAGAKARSA,JAGAKARSA,62389,21834,40555,26082,66637,2021-09-06
3175021007,JAKARTA TIMUR,PULO GADUNG,JATI,32757,11720,21037,14027,35064,2021-09-06
3174041002,JAKARTA SELATAN,PASAR MINGGU,JATI PADANG,37502,13818,23684,15091,38775,2021-09-06
3173071004,JAKARTA BARAT,PALMERAH,JATI PULO,28738,9620,19118,11976,31094,2021-09-06
3175061001,JAKARTA TIMUR,CAKUNG,JATINEGARA,84160,31053,53107,35899,89006,2021-09-06
3175021004,JAKARTA TIMUR,PULO GADUNG,JATINEGARA KAUM,24632,8238,16394,9694,26088,2021-09-06
3173021004,JAKARTA BARAT,GROGOL PETAMBURAN,JELAMBAR,30266,10620,19646,14097,33743,2021-09-06
3173021006,JAKARTA BARAT,GROGOL PETAMBURAN,JELAMBAR BARU,38246,13442,24804,17344,42148,2021-09-06
3173041006,JAKARTA BARAT,TAMBORA,JEMBATAN BESI,29314,11738,17576,10009,27585,2021-09-06
3173041008,JAKARTA BARAT,TAMBORA,JEMBATAN LIMA,21021,8007,13014,7869,20883,2021-09-06
3173081005,JAKARTA BARAT,KEMBANGAN,JOGLO,40839,14664,26175,17114,43289,2021-09-06
3171081001,JAKARTA PUSAT,JOHAR BARU,JOHAR BARU,37488,11901,25587,17116,42703,2021-09-06
3173041002,JAKARTA BARAT,TAMBORA,KALI ANYAR,23856,8036,15820,9301,25121,2021-09-06
3172041004,JAKARTA UTARA,CILINCING,KALIBARU,67684,27062,40622,23338,63960,2021-09-06
3174081002,JAKARTA SELATAN,PANCORAN,KALIBATA,41994,17362,24632,13332,37964,2021-09-06
3173061001,JAKARTA BARAT,KALI DERES,KALIDERES,72447,26230,46217,32857,79074,2021-09-06
3175051004,JAKARTA TIMUR,PASAR REBO,KALISARI,43212,14556,28656,19681,48337,2021-09-06
3173061004,JAKARTA BARAT,KALI DERES,KAMAL,53783,20013,33770,20302,54072,2021-09-06
3172011002,JAKARTA UTARA,PENJARINGAN,KAMAL MUARA,12930,3437,9493,6952,16445,2021-09-06
3171071007,JAKARTA PUSAT,TANAH ABANG,KAMPUNG BALI,11358,4426,6932,4293,11225,2021-09-06
3175031001,JAKARTA TIMUR,JATINEGARA,KAMPUNG MELAYU,25717,10334,15383,9537,24920,2021-09-06
3171081002,JAKARTA PUSAT,JOHAR BARU,KAMPUNG RAWA,21237,5704,15533,9584,25117,2021-09-06
3175041002,JAKARTA TIMUR,KRAMAT JATI,KAMPUNG TENGAH,43993,17654,26339,15637,41976,2021-09-06
3173011005,JAKARTA BARAT,CENGKARENG,KAPUK,134466,51553,82913,48161,131074,2021-09-06
3172011003,JAKARTA UTARA,PENJARINGAN,KAPUK MUARA,35781,11046,24735,18493,43228,2021-09-06
3171021002,JAKARTA PUSAT,SAWAH BESAR,KARANG ANYAR,25761,8545,17216,11407,28623,2021-09-06
3174021004,JAKARTA SELATAN,SETIA BUDI,KARET,9623,3626,5997,3943,9940,2021-09-06
3174021003,JAKARTA SELATAN,SETIA BUDI,KARET KUNINGAN,16055,5361,10694,7016,17710,2021-09-06
3174021002,JAKARTA SELATAN,SETIA BUDI,KARET SEMANGGI,2770,951,1819,1371,3190,2021-09-06
3171071003,JAKARTA PUSAT,TANAH ABANG,KARET TENGSIN,19271,6986,12285,7956,20241,2021-09-06
3171021003,JAKARTA PUSAT,SAWAH BESAR,KARTINI,22292,7671,14621,10205,24826,2021-09-06
3175011003,JAKARTA TIMUR,MATRAMAN,KAYU MANIS,25284,9872,15412,9206,24618,2021-09-06
3175021006,JAKARTA TIMUR,PULO GADUNG,KAYU PUTIH,40696,13855,26841,19242,46083,2021-09-06
3173031006,JAKARTA BARAT,TAMAN SARI,KEAGUNGAN,17387,5896,11491,7718,19209,2021-09-06
3174041007,JAKARTA SELATAN,PASAR MINGGU,KEBAGUSAN,44552,17095,27457,16403,43860,2021-09-06
3174051006,JAKARTA SELATAN,KEBAYORAN LAMA,KEBAYORAN LAMA SELATAN,41212,14773,26439,15711,42150,2021-09-06
3174051001,JAKARTA SELATAN,KEBAYORAN LAMA,KEBAYORAN LAMA UTARA,42422,16578,25844,14251,40095,2021-09-06
3174011004,JAKARTA SELATAN,TEBET,KEBON BARU,35165,12934,22231,13503,35734,2021-09-06
3172021005,JAKARTA UTARA,TANJUNG PRIOK,KEBON BAWANG,50952,18064,32888,21439,54327,2021-09-06
3173051001,JAKARTA BARAT,KEBON JERUK,KEBON JERUK,53887,20379,33508,21193,54701,2021-09-06
3171071006,JAKARTA PUSAT,TANAH ABANG,KEBON KACANG,21531,8943,12588,7965,20553,2021-09-06
3171011005,JAKARTA PUSAT,GAMBIR,KEBON KELAPA,10163,3553,6610,4403,11013,2021-09-06
3171031002,JAKARTA PUSAT,KEMAYORAN,KEBON KOSONG,30019,10712,19307,12607,31914,2021-09-06
3175011005,JAKARTA TIMUR,MATRAMAN,KEBON MANGGIS,16490,5864,10626,7088,17714,2021-09-06
3171071005,JAKARTA PUSAT,TANAH ABANG,KEBON MELATI,32206,14114,18092,11064,29156,2021-09-06
3175081003,JAKARTA TIMUR,MAKASAR,KEBON PALA,46614,16701,29913,18603,48516,2021-09-06
3171061005,JAKARTA PUSAT,MENTENG,KEBON SIRIH,12299,4506,7793,5110,12903,2021-09-06
3173011004,JAKARTA BARAT,CENGKARENG,KEDAUNG KALI ANGKE,32612,10512,22100,15069,37169,2021-09-06
3173051007,JAKARTA BARAT,KEBON JERUK,KEDOYA SELATAN,32165,10977,21188,13558,34746,2021-09-06
3173051006,JAKARTA BARAT,KEBON JERUK,KEDOYA UTARA,45740,14760,30980,21637,52617,2021-09-06
3173051004,JAKARTA BARAT,KEBON JERUK,KELAPA DUA,23565,8761,14804,9179,23983,2021-09-06
3175091003,JAKARTA TIMUR,CIRACAS,KELAPA DUA WETAN,46875,15000,31875,21099,52974,2021-09-06
3172061003,JAKARTA UTARA,KELAPA GADING,KELAPA GADING BARAT,35717,11150,24567,18825,43392,2021-09-06
3172061001,JAKARTA UTARA,KELAPA GADING,KELAPA GADING TIMUR,33592,9585,24007,18305,42312,2021-09-06
3173071005,JAKARTA BARAT,PALMERAH,KEMANGGISAN,32139,11356,20783,13505,34288,2021-09-06
3171031001,JAKARTA PUSAT,KEMAYORAN,KEMAYORAN,20708,7093,13615,9268,22883,2021-09-06
3173081006,JAKARTA BARAT,KEMBANGAN,KEMBANGAN SELATAN,27130,9657,17473,12630,30103,2021-09-06
3173081001,JAKARTA BARAT,KEMBANGAN,KEMBANGAN UTARA,54451,19413,35038,23553,58591,2021-09-06
3171041002,JAKARTA PUSAT,SENEN,KENARI,9579,3302,6277,4493,10770,2021-09-06
3173041005,JAKARTA BARAT,TAMBORA,KERENDANG,19973,6911,13062,8469,21531,2021-09-06
3175071003,JAKARTA TIMUR,DUREN SAWIT,KLENDER,69978,27919,42059,25796,67855,2021-09-06
3172031001,JAKARTA UTARA,KOJA,KOJA,28175,10548,17627,11591,29218,2021-09-06
3173071006,JAKARTA BARAT,PALMERAH,KOTA BAMBU SELATAN,21158,7663,13495,8268,21763,2021-09-06
3173071003,JAKARTA BARAT,PALMERAH,KOTA BAMBU UTARA,24995,9192,15803,9746,25549,2021-09-06
3171041004,JAKARTA PUSAT,SENEN,KRAMAT,28835,10777,18058,10609,28667,2021-09-06
3175041001,JAKARTA TIMUR,KRAMAT JATI,KRAMAT JATI,34144,12410,21734,13221,34955,2021-09-06
3174071003,JAKARTA SELATAN,KEBAYORAN BARU,KRAMAT PELA,14413,5023,9390,5987,15377,2021-09-06
3173031002,JAKARTA BARAT,TAMAN SARI,KRUKUT,19244,6630,12614,8093,20707,2021-09-06
3174031005,JAKARTA SELATAN,MAMPANG PRAPATAN,KUNINGAN BARAT,12785,4481,8304,5169,13473,2021-09-06
3174021008,JAKARTA SELATAN,SETIA BUDI,KUNINGAN TIMUR,6008,2141,3867,2565,6432,2021-09-06
3171041005,JAKARTA PUSAT,SENEN,KWITANG,15486,5546,9940,6548,16488,2021-09-06
3172031003,JAKARTA UTARA,KOJA,LAGOA,59065,22535,36530,22794,59324,2021-09-06
3174061002,JAKARTA SELATAN,CILANDAK,LEBAK BULUS,37626,14292,23334,14879,38213,2021-09-06
3174091004,JAKARTA SELATAN,JAGAKARSA,LENTENG AGUNG,53946,20539,33407,19023,52430,2021-09-06
3175101007,JAKARTA TIMUR,CIPAYUNG,LUBANG BUAYA,63547,21095,42452,28537,70989,2021-09-06
3175081001,JAKARTA TIMUR,MAKASAR,MAKASAR,34390,11846,22544,15093,37637,2021-09-06
3175071006,JAKARTA TIMUR,DUREN SAWIT,MALAKA JAYA,30927,11161,19766,14045,33811,2021-09-06
3175071005,JAKARTA TIMUR,DUREN SAWIT,MALAKA SARI,27530,9592,17938,12897,30835,2021-09-06
3174031001,JAKARTA SELATAN,MAMPANG PRAPATAN,MAMPANG PRAPATAN,18159,6671,11488,7310,18798,2021-09-06
3173031005,JAKARTA BARAT,TAMAN SARI,MANGGA BESAR,7707,2327,5380,3813,9193,2021-09-06
3171021005,JAKARTA PUSAT,SAWAH BESAR,MANGGA DUA SELATAN,27442,9415,18027,12326,30353,2021-09-06
3174011007,JAKARTA SELATAN,TEBET,MANGGARAI,28373,9572,18801,10965,29766,2021-09-06
3174011006,JAKARTA SELATAN,TEBET,MANGGARAI SELATAN,23075,8047,15028,9284,24312,2021-09-06
3173031003,JAKARTA BARAT,TAMAN SARI,MAPHAR,16461,5785,10676,7258,17934,2021-09-06
3172041003,JAKARTA UTARA,CILINCING,MARUNDA,28943,9858,19085,10101,29186,2021-09-06
3174071001,JAKARTA SELATAN,KEBAYORAN BARU,MELAWAI,2627,895,1732,1369,3101,2021-09-06
3171061001,JAKARTA PUSAT,MENTENG,MENTENG,25624,9712,15912,10319,26231,2021-09-06
3174021005,JAKARTA SELATAN,SETIA BUDI,MENTENG ATAS,27816,9517,18299,11194,29493,2021-09-06
3174011003,JAKARTA SELATAN,TEBET,MENTENG DALAM,36028,13154,22874,14307,37181,2021-09-06
3173081003,JAKARTA BARAT,KEMBANGAN,MERUYA SELATAN,32130,11544,20586,13886,34472,2021-09-06
3173081002,JAKARTA BARAT,KEMBANGAN,MERUYA UTARA,43752,15952,27800,19901,47701,2021-09-06
3175101004,JAKARTA TIMUR,CIPAYUNG,MUNJUL,23871,8000,15871,10960,26831,2021-09-06
3172051002,JAKARTA UTARA,PADEMANGAN,PADEMANGAN BARAT,74240,27458,46782,30411,77193,2021-09-06
3172051001,JAKARTA UTARA,PADEMANGAN,PADEMANGAN TIMUR,37736,11660,26076,18564,44640,2021-09-06
3175011004,JAKARTA TIMUR,MATRAMAN,PAL MERIAM,19769,7615,12154,7721,19875,2021-09-06
3173071001,JAKARTA BARAT,PALMERAH,PALMERAH,63011,23074,39937,24989,64926,2021-09-06
3174081001,JAKARTA SELATAN,PANCORAN,PANCORAN,19421,7221,12200,7405,19605,2021-09-06
3172021003,JAKARTA UTARA,TANJUNG PRIOK,PAPANGGO,39097,12925,26172,17252,43424,2021-09-06
3171021001,JAKARTA PUSAT,SAWAH BESAR,PASAR BARU,12035,3744,8291,6079,14370,2021-09-06
3174021006,JAKARTA SELATAN,SETIA BUDI,PASAR MANGGIS,26752,9776,16976,10431,27407,2021-09-06
3174041001,JAKARTA SELATAN,PASAR MINGGU,PASAR MINGGU,24821,9065,15756,10237,25993,2021-09-06
3171041003,JAKARTA PUSAT,SENEN,PASEBAN,23533,8628,14905,9567,24472,2021-09-06
3173061005,JAKARTA BARAT,KALI DERES,PEGADUNGAN,75587,25339,50248,35351,85599,2021-09-06
3171061002,JAKARTA PUSAT,MENTENG,PEGANGSAAN,23455,8690,14765,9091,23856,2021-09-06
3172061002,JAKARTA UTARA,KELAPA GADING,PEGANGSAAN DUA,49976,14239,35737,26675,62412,2021-09-06
3172011004,JAKARTA UTARA,PENJARINGAN,PEJAGALAN,74578,26244,48334,33297,81631,2021-09-06
3174041006,JAKARTA SELATAN,PASAR MINGGU,PEJATEN BARAT,37346,14049,23297,14697,37994,2021-09-06
3174041005,JAKARTA SELATAN,PASAR MINGGU,PEJATEN TIMUR,57656,22579,35077,19881,54958,2021-09-06
3175051005,JAKARTA TIMUR,PASAR REBO,PEKAYON,43250,14457,28793,19354,48147,2021-09-06
3173041009,JAKARTA BARAT,TAMBORA,PEKOJAN,23587,7739,15848,10881,26729,2021-09-06
3174031003,JAKARTA SELATAN,MAMPANG PRAPATAN,PELA MAMPANG,43522,15768,27754,18119,45873,2021-09-06
3174081005,JAKARTA SELATAN,PANCORAN,PENGADEGAN,21478,7186,14292,7867,22159,2021-09-06
3175061003,JAKARTA TIMUR,CAKUNG,PENGGILINGAN,99255,39475,59780,36974,96754,2021-09-06
3172011001,JAKARTA UTARA,PENJARINGAN,PENJARINGAN,88308,34015,54293,34215,88508,2021-09-06
3174101001,JAKARTA SELATAN,PESANGGRAHAN,PESANGGRAHAN,27545,9461,18084,11370,29454,2021-09-06
3171071004,JAKARTA PUSAT,TANAH ABANG,PETAMBURAN,33271,14674,18597,11278,29875,2021-09-06
3174071008,JAKARTA SELATAN,KEBAYORAN BARU,PETOGOGAN,11499,4281,7218,4728,11946,2021-09-06
3171011004,JAKARTA PUSAT,GAMBIR,PETOJO SELATAN,14692,5402,9290,6302,15592,2021-09-06
3171011003,JAKARTA PUSAT,GAMBIR,PETOJO UTARA,17458,6295,11163,7230,18393,2021-09-06
3174101004,JAKARTA SELATAN,PESANGGRAHAN,PETUKANGAN SELATAN,37187,13716,23471,14182,37653,2021-09-06
3174101003,JAKARTA SELATAN,PESANGGRAHAN,PETUKANGAN UTARA,53716,20975,32741,19992,52733,2021-09-06
3175081002,JAKARTA TIMUR,MAKASAR,PINANG RANTI,27198,9784,17414,11608,29022,2021-09-06
3173031008,JAKARTA BARAT,TAMAN SARI,PINANGSIA,10729,3348,7381,4950,12331,2021-09-06
3175011001,JAKARTA TIMUR,MATRAMAN,PISANGAN BARU,31776,12126,19650,11623,31273,2021-09-06
3175021002,JAKARTA TIMUR,PULO GADUNG,PISANGAN TIMUR,41011,14094,26917,17745,44662,2021-09-06
3172011005,JAKARTA UTARA,PENJARINGAN,PLUIT,47783,15696,32087,23734,55821,2021-09-06
3175071002,JAKARTA TIMUR,DUREN SAWIT,PONDOK BAMBU,61550,23658,37892,23810,61702,2021-09-06
3175071004,JAKARTA TIMUR,DUREN SAWIT,PONDOK KELAPA,72015,26101,45914,29621,75535,2021-09-06
3175071007,JAKARTA TIMUR,DUREN SAWIT,PONDOK KOPI,35367,14543,20824,12735,33559,2021-09-06
3174061003,JAKARTA SELATAN,CILANDAK,PONDOK LABU,46464,16126,30338,20350,50688,2021-09-06
3174051002,JAKARTA SELATAN,KEBAYORAN LAMA,PONDOK PINANG,56169,20918,35251,22202,57453,2021-09-06
3175101003,JAKARTA TIMUR,CIPAYUNG,PONDOK RANGGON,25574,8812,16762,11358,28120,2021-09-06
3101011003,KAB.ADM.KEP.SERIBU,KEP. SERIBU UTARA,PULAU HARAPAN,2060,336,1724,1030,2754,2021-09-06
3101011002,KAB.ADM.KEP.SERIBU,KEP. SERIBU UTARA,PULAU KELAPA,5528,893,4635,2650,7285,2021-09-06
3101011001,KAB.ADM.KEP.SERIBU,KEP. SERIBU UTARA,PULAU PANGGANG,5450,833,4617,2189,6806,2021-09-06
3101021003,KAB.ADM.KEP.SERIBU,KEP. SERIBU SELATAN,PULAU PARI,2765,318,2447,1474,3921,2021-09-06
3101021002,KAB.ADM.KEP.SERIBU,KEP. SERIBU SELATAN,PULAU TIDUNG,4553,615,3938,2683,6621,2021-09-06
3101021001,KAB.ADM.KEP.SERIBU,KEP. SERIBU SELATAN,PULAU UNTUNG JAWA,1941,319,1622,1016,2638,2021-09-06
3174071007,JAKARTA SELATAN,KEBAYORAN BARU,PULO,5835,1961,3874,2835,6709,2021-09-06
3175021001,JAKARTA TIMUR,PULO GADUNG,PULO GADUNG,34422,12438,21984,14134,36118,2021-09-06
3175061005,JAKARTA TIMUR,CAKUNG,PULO GEBANG,97301,35429,61872,39800,101672,2021-09-06
3174041004,JAKARTA SELATAN,PASAR MINGGU,RAGUNAN,39616,13940,25676,16387,42063,2021-09-06
3175091005,JAKARTA TIMUR,CIRACAS,RAMBUTAN,36771,14500,22271,14262,36533,2021-09-06
3172031006,JAKARTA UTARA,KOJA,RAWA BADAK SELATAN,42179,16268,25911,16152,42063,2021-09-06
3172031004,JAKARTA UTARA,KOJA,RAWA BADAK UTARA,34408,12963,21445,13615,35060,2021-09-06
3174071005,JAKARTA SELATAN,KEBAYORAN BARU,RAWA BARAT,5625,1883,3742,2579,6321,2021-09-06
3173011003,JAKARTA BARAT,CENGKARENG,RAWA BUAYA,63799,22867,40932,24809,65741,2021-09-06
3175031004,JAKARTA TIMUR,JATINEGARA,RAWA BUNGA,21434,8411,13023,8421,21444,2021-09-06
3174081003,JAKARTA SELATAN,PANCORAN,RAWA JATI,20509,7404,13105,7793,20898,2021-09-06
3175061002,JAKARTA TIMUR,CAKUNG,RAWA TERATE,24637,7939,16698,11555,28253,2021-09-06
3175021005,JAKARTA TIMUR,PULO GADUNG,RAWAMANGUN,37612,13665,23947,16103,40050,2021-09-06
3171051003,JAKARTA PUSAT,CEMPAKA PUTIH,RAWASARI,21967,8021,13946,9663,23609,2021-09-06
3173041010,JAKARTA BARAT,TAMBORA,ROA MALAKA,3484,1035,2449,1772,4221,2021-09-06
3172041006,JAKARTA UTARA,CILINCING,ROROTAN,41668,13854,27814,17266,45080,2021-09-06
3174071004,JAKARTA SELATAN,KEBAYORAN BARU,SELONG,2842,977,1865,1414,3279,2021-09-06
3173061002,JAKARTA BARAT,KALI DERES,SEMANAN,71354,26785,44569,26666,71235,2021-09-06
3172041007,JAKARTA UTARA,CILINCING,SEMPER BARAT,68587,22598,45989,30810,76799,2021-09-06
3172041005,JAKARTA UTARA,CILINCING,SEMPER TIMUR,36267,12502,23765,15109,38874,2021-09-06
3174071006,JAKARTA SELATAN,KEBAYORAN BARU,SENAYAN,2771,1120,1651,1101,2752,2021-09-06
3171041001,JAKARTA PUSAT,SENEN,SENEN,6804,2313,4491,3121,7612,2021-09-06
3171031004,JAKARTA PUSAT,KEMAYORAN,SERDANG,29668,10570,19098,12439,31537,2021-09-06
3174021001,JAKARTA SELATAN,SETIA BUDI,SETIA BUDI,3023,1115,1908,1296,3204,2021-09-06
3175101005,JAKARTA TIMUR,CIPAYUNG,SETU,20572,7605,12967,8261,21228,2021-09-06
3173071002,JAKARTA BARAT,PALMERAH,SLIPI,16591,5604,10987,7293,18280,2021-09-06
3173081004,JAKARTA BARAT,KEMBANGAN,SRENGSENG,45523,17107,28416,18436,46852,2021-09-06
3174091002,JAKARTA SELATAN,JAGAKARSA,SRENGSENG SAWAH,58196,18906,39290,24433,63723,2021-09-06
3173051003,JAKARTA BARAT,KEBON JERUK,SUKABUMI SELATAN,37033,14256,22777,12246,35023,2021-09-06
3173051002,JAKARTA BARAT,KEBON JERUK,SUKABUMI UTARA,38290,14977,23313,12633,35946,2021-09-06
3172041002,JAKARTA UTARA,CILINCING,SUKAPURA,53949,19670,34279,22825,57104,2021-09-06
3171031007,JAKARTA PUSAT,KEMAYORAN,SUMUR BATU,22717,8214,14503,9853,24356,2021-09-06
3172021004,JAKARTA UTARA,TANJUNG PRIOK,SUNGAI BAMBU,29876,10413,19463,12485,31948,2021-09-06
3172021006,JAKARTA UTARA,TANJUNG PRIOK,SUNTER AGUNG,71805,21964,49841,36226,86067,2021-09-06
3172021002,JAKARTA UTARA,TANJUNG PRIOK,SUNTER JAYA,63031,20012,43019,30847,73866,2021-09-06
3175091004,JAKARTA TIMUR,CIRACAS,SUSUKAN,38257,12632,25625,16060,41685,2021-09-06
3173031001,JAKARTA BARAT,TAMAN SARI,TAMAN SARI,14348,4960,9388,6730,16118,2021-09-06
3173041001,JAKARTA BARAT,TAMBORA,TAMBORA,10204,3656,6548,4040,10588,2021-09-06
3173041004,JAKARTA BARAT,TAMBORA,TANAH SEREAL,26387,7899,18488,12328,30816,2021-09-06
3171081004,JAKARTA PUSAT,JOHAR BARU,TANAH TINGGI,37693,11421,26272,16432,42704,2021-09-06
3173031004,JAKARTA BARAT,TAMAN SARI,TANGKI,13324,4500,8824,6265,15089,2021-09-06
3174091005,JAKARTA SELATAN,JAGAKARSA,TANJUNG BARAT,39770,14113,25657,14910,40567,2021-09-06
3173021005,JAKARTA BARAT,GROGOL PETAMBURAN,TANJUNG DUREN SELATAN,25337,8811,16526,11582,28108,2021-09-06
3173021002,JAKARTA BARAT,GROGOL PETAMBURAN,TANJUNG DUREN UTARA,17010,5599,11411,7937,19348,2021-09-06
3172021001,JAKARTA UTARA,TANJUNG PRIOK,TANJUNG PRIOK,34588,11499,23089,14701,37790,2021-09-06
3174011002,JAKARTA SELATAN,TEBET,TEBET BARAT,21194,7077,14117,9353,23470,2021-09-06
3174011001,JAKARTA SELATAN,TEBET,TEBET TIMUR,18199,6069,12130,8026,20156,2021-09-06
3173061003,JAKARTA BARAT,KALI DERES,TEGAL ALUR,83647,29662,53985,32442,86427,2021-09-06
3174031004,JAKARTA SELATAN,MAMPANG PRAPATAN,TEGAL PARANG,32401,12709,19692,11411,31103,2021-09-06
3173021003,JAKARTA BARAT,GROGOL PETAMBURAN,TOMANG,29605,10206,19399,13800,33199,2021-09-06
3172031005,JAKARTA UTARA,KOJA,TUGU SELATAN,39122,14657,24465,15592,40057,2021-09-06
3172031002,JAKARTA UTARA,KOJA,TUGU UTARA,67670,26064,41606,26234,67840,2021-09-06
3175061006,JAKARTA TIMUR,CAKUNG,UJUNG MENTENG,29934,9751,20183,13859,34042,2021-09-06
3174101005,JAKARTA SELATAN,PESANGGRAHAN,ULUJAMI,40544,16204,24340,14030,38370,2021-09-06
3175011006,JAKARTA TIMUR,MATRAMAN,UTAN KAYU SELATAN,33511,11653,21858,13894,35752,2021-09-06
3175011002,JAKARTA TIMUR,MATRAMAN,UTAN KAYU UTARA,28169,10681,17488,10958,28446,2021-09-06
3171031008,JAKARTA PUSAT,KEMAYORAN,UTAN PANJANG,29208,10809,18399,12003,30402,2021-09-06
3172021007,JAKARTA UTARA,TANJUNG PRIOK,WARAKAS,44401,14742,29659,18620,48279,2021-09-06
3173021007,JAKARTA BARAT,GROGOL PETAMBURAN,WIJAYA KUSUMA,38934,14242,24692,17109,41801,2021-09-06
3172051003,JAKARTA UTARA,PADEMANGAN,ANCOL,23947,8969,14978,10216,25194,2021-09-07
3173041007,JAKARTA BARAT,TAMBORA,ANGKE,29381,10170,19211,11588,30799,2021-09-07
3175041005,JAKARTA TIMUR,KRAMAT JATI,BALE KAMBANG,29074,12180,16894,9184,26078,2021-09-07
3175031003,JAKARTA TIMUR,JATINEGARA,BALI MESTER,9752,3611,6141,4195,10336,2021-09-07
3175101006,JAKARTA TIMUR,CIPAYUNG,BAMBU APUS,26285,9079,17206,11865,29071,2021-09-07
3174031002,JAKARTA SELATAN,MAMPANG PRAPATAN,BANGKA,21566,8307,13259,8290,21549,2021-09-07
3175051002,JAKARTA TIMUR,PASAR REBO,BARU,23886,7472,16414,12087,28501,2021-09-07
3175041004,JAKARTA TIMUR,KRAMAT JATI,BATU AMPAR,47898,19316,28582,17582,46164,2021-09-07
3171071002,JAKARTA PUSAT,TANAH ABANG,BENDUNGAN HILIR,21494,7871,13623,9293,22916,2021-09-07
3175031002,JAKARTA TIMUR,JATINEGARA,BIDARA CINA,36689,14919,21770,14084,35854,2021-09-07
3174101002,JAKARTA SELATAN,PESANGGRAHAN,BINTARO,53098,20003,33095,21103,54198,2021-09-07
3174011005,JAKARTA SELATAN,TEBET,BUKIT DURI,34183,13296,20887,12268,33155,2021-09-07
3171041006,JAKARTA PUSAT,SENEN,BUNGUR,18144,6334,11810,7969,19779,2021-09-07
3175061007,JAKARTA TIMUR,CAKUNG,CAKUNG BARAT,57724,19147,38577,25264,63841,2021-09-07
3175061004,JAKARTA TIMUR,CAKUNG,CAKUNG TIMUR,58287,19577,38710,27529,66239,2021-09-07
3175041007,JAKARTA TIMUR,KRAMAT JATI,CAWANG,32762,12460,20302,12936,33238,2021-09-07
3175101008,JAKARTA TIMUR,CIPAYUNG,CEGER,18932,6463,12469,8703,21172,2021-09-07
3171031006,JAKARTA PUSAT,KEMAYORAN,CEMPAKA BARU,32581,11753,20828,13363,34191,2021-09-07
3171051002,JAKARTA PUSAT,CEMPAKA PUTIH,CEMPAKA PUTIH BARAT,35885,13022,22863,16524,39387,2021-09-07
3171051001,JAKARTA PUSAT,CEMPAKA PUTIH,CEMPAKA PUTIH TIMUR,24292,8481,15811,11155,26966,2021-09-07
3173011001,JAKARTA BARAT,CENGKARENG,CENGKARENG BARAT,66284,22945,43339,29295,72634,2021-09-07
3173011006,JAKARTA BARAT,CENGKARENG,CENGKARENG TIMUR,81027,27462,53565,32931,86496,2021-09-07
3175091002,JAKARTA TIMUR,CIRACAS,CIBUBUR,66364,21591,44773,30700,75473,2021-09-07
3171011002,JAKARTA PUSAT,GAMBIR,CIDENG,15390,5128,10262,7353,17615,2021-09-07
3174091003,JAKARTA SELATAN,JAGAKARSA,CIGANJUR,38497,13898,24599,14756,39355,2021-09-07
3175051003,JAKARTA TIMUR,PASAR REBO,CIJANTUNG,41419,13597,27822,19316,47138,2021-09-07
3171061003,JAKARTA PUSAT,MENTENG,CIKINI,8274,2911,5363,3465,8828,2021-09-07
3174081006,JAKARTA SELATAN,PANCORAN,CIKOKO,10547,3628,6919,4122,11041,2021-09-07
3174061001,JAKARTA SELATAN,CILANDAK,CILANDAK BARAT,51752,18600,33152,21056,54208,2021-09-07
3174041003,JAKARTA SELATAN,PASAR MINGGU,CILANDAK TIMUR,25145,8932,16213,10886,27099,2021-09-07
3175101002,JAKARTA TIMUR,CIPAYUNG,CILANGKAP,27635,9382,18253,12755,31008,2021-09-07
3175041006,JAKARTA TIMUR,KRAMAT JATI,CILILITAN,40181,15875,24306,16082,40388,2021-09-07
3172041001,JAKARTA UTARA,CILINCING,CILINCING,43609,16309,27300,16916,44216,2021-09-07
3175101001,JAKARTA TIMUR,CIPAYUNG,CIPAYUNG,26104,8161,17943,12961,30904,2021-09-07
3174091006,JAKARTA SELATAN,JAGAKARSA,CIPEDAK,38303,12848,25455,15988,41443,2021-09-07
3174061005,JAKARTA SELATAN,CILANDAK,CIPETE SELATAN,26704,10039,16665,11311,27976,2021-09-07
3174071010,JAKARTA SELATAN,KEBAYORAN BARU,CIPETE UTARA,34102,12496,21606,13514,35120,2021-09-07
3175021003,JAKARTA TIMUR,PULO GADUNG,CIPINANG,39306,14171,25135,16811,41946,2021-09-07
3175031007,JAKARTA TIMUR,JATINEGARA,CIPINANG BESAR SELATAN,35212,13823,21389,13117,34506,2021-09-07
3175031008,JAKARTA TIMUR,JATINEGARA,CIPINANG BESAR UTARA,45319,17794,27525,17364,44889,2021-09-07
3175031005,JAKARTA TIMUR,JATINEGARA,CIPINANG CEMPEDAK,32824,12978,19846,13744,33590,2021-09-07
3175081005,JAKARTA TIMUR,MAKASAR,CIPINANG MELAYU,42308,15657,26651,18531,45182,2021-09-07
3175031006,JAKARTA TIMUR,JATINEGARA,CIPINANG MUARA,55243,21574,33669,22064,55733,2021-09-07
3174051003,JAKARTA SELATAN,KEBAYORAN LAMA,CIPULIR,39937,15987,23950,13332,37282,2021-09-07
3175091001,JAKARTA TIMUR,CIRACAS,CIRACAS,64594,20887,43707,28736,72443,2021-09-07
3175041003,JAKARTA TIMUR,KRAMAT JATI,DUKUH,24609,8415,16194,10924,27118,2021-09-07
3175071001,JAKARTA TIMUR,DUREN SAWIT,DUREN SAWIT,61160,23606,37554,24951,62505,2021-09-07
3174081004,JAKARTA SELATAN,PANCORAN,DUREN TIGA,28319,10488,17831,9765,27596,2021-09-07
3173051005,JAKARTA BARAT,KEBON JERUK,DURI KEPA,60138,20199,39939,27382,67321,2021-09-07
3173011002,JAKARTA BARAT,CENGKARENG,DURI KOSAMBI,77923,29806,48117,29326,77443,2021-09-07
3171011006,JAKARTA PUSAT,GAMBIR,DURI PULO,19610,6875,12735,8214,20949,2021-09-07
3173041011,JAKARTA BARAT,TAMBORA,DURI SELATAN,14259,4547,9712,6657,16369,2021-09-07
3173041003,JAKARTA BARAT,TAMBORA,DURI UTARA,19844,6630,13214,8728,21942,2021-09-07
3171081003,JAKARTA PUSAT,JOHAR BARU,GALUR,18243,5593,12650,8272,20922,2021-09-07
3171011001,JAKARTA PUSAT,GAMBIR,GAMBIR,2191,730,1461,1062,2523,2021-09-07
3174061004,JAKARTA SELATAN,CILANDAK,GANDARIA SELATAN,22119,8237,13882,8432,22314,2021-09-07
3174071009,JAKARTA SELATAN,KEBAYORAN BARU,GANDARIA UTARA,39922,14992,24930,15658,40588,2021-09-07
3175051001,JAKARTA TIMUR,PASAR REBO,GEDONG,35755,12355,23400,16203,39603,2021-09-07
3171071001,JAKARTA PUSAT,TANAH ABANG,GELORA,3127,1180,1947,1282,3229,2021-09-07
3173031007,JAKARTA BARAT,TAMAN SARI,GLODOK,7837,2332,5505,4144,9649,2021-09-07
3171061004,JAKARTA PUSAT,MENTENG,GONDANGDIA,4100,1470,2630,2037,4667,2021-09-07
3173021001,JAKARTA BARAT,GROGOL PETAMBURAN,GROGOL,16876,5986,10890,7405,18295,2021-09-07
3174051005,JAKARTA SELATAN,KEBAYORAN LAMA,GROGOL SELATAN,44251,16935,27316,15912,43228,2021-09-07
3174051004,JAKARTA SELATAN,KEBAYORAN LAMA,GROGOL UTARA,42494,16039,26455,15640,42095,2021-09-07
3174021007,JAKARTA SELATAN,SETIA BUDI,GUNTUR,3985,1374,2611,1895,4506,2021-09-07
3174071002,JAKARTA SELATAN,KEBAYORAN BARU,GUNUNG,9436,3324,6112,4276,10388,2021-09-07
3171031005,JAKARTA PUSAT,KEMAYORAN,GUNUNG SAHARI SELATAN,19199,6836,12363,8581,20944,2021-09-07
3171021004,JAKARTA PUSAT,SAWAH BESAR,GUNUNG SAHARI UTARA,16650,5110,11540,8655,20195,2021-09-07
3175081004,JAKARTA TIMUR,MAKASAR,HALIM PERDANA KUSUMAH,28363,7748,20615,16358,36973,2021-09-07
3171031003,JAKARTA PUSAT,KEMAYORAN,HARAPAN MULIA,22557,7936,14621,9944,24565,2021-09-07
3174091001,JAKARTA SELATAN,JAGAKARSA,JAGAKARSA,62389,21818,40571,26127,66698,2021-09-07
3175021007,JAKARTA TIMUR,PULO GADUNG,JATI,32757,11585,21172,14610,35782,2021-09-07
3174041002,JAKARTA SELATAN,PASAR MINGGU,JATI PADANG,37502,13810,23692,15133,38825,2021-09-07
3173071004,JAKARTA BARAT,PALMERAH,JATI PULO,28738,9559,19179,12282,31461,2021-09-07
3175061001,JAKARTA TIMUR,CAKUNG,JATINEGARA,84160,30747,53413,36848,90261,2021-09-07
3175021004,JAKARTA TIMUR,PULO GADUNG,JATINEGARA KAUM,24632,8187,16445,9867,26312,2021-09-07
3173021004,JAKARTA BARAT,GROGOL PETAMBURAN,JELAMBAR,30266,10569,19697,14323,34020,2021-09-07
3173021006,JAKARTA BARAT,GROGOL PETAMBURAN,JELAMBAR BARU,38246,13283,24963,17721,42684,2021-09-07
3173041006,JAKARTA BARAT,TAMBORA,JEMBATAN BESI,29314,11626,17688,10336,28024,2021-09-07
3173041008,JAKARTA BARAT,TAMBORA,JEMBATAN LIMA,21021,7959,13062,8081,21143,2021-09-07
3173081005,JAKARTA BARAT,KEMBANGAN,JOGLO,40839,14575,26264,17491,43755,2021-09-07
3171081001,JAKARTA PUSAT,JOHAR BARU,JOHAR BARU,37488,11843,25645,17589,43234,2021-09-07
3173041002,JAKARTA BARAT,TAMBORA,KALI ANYAR,23856,8005,15851,9638,25489,2021-09-07
3172041004,JAKARTA UTARA,CILINCING,KALIBARU,67684,26924,40760,23776,64536,2021-09-07
3174081002,JAKARTA SELATAN,PANCORAN,KALIBATA,41994,17352,24642,13389,38031,2021-09-07
3173061001,JAKARTA BARAT,KALI DERES,KALIDERES,72447,26027,46420,33433,79853,2021-09-07
3175051004,JAKARTA TIMUR,PASAR REBO,KALISARI,43212,14489,28723,20170,48893,2021-09-07
3173061004,JAKARTA BARAT,KALI DERES,KAMAL,53783,19960,33823,20819,54642,2021-09-07
3172011002,JAKARTA UTARA,PENJARINGAN,KAMAL MUARA,12930,3427,9503,7050,16553,2021-09-07
3171071007,JAKARTA PUSAT,TANAH ABANG,KAMPUNG BALI,11358,4396,6962,4400,11362,2021-09-07
3175031001,JAKARTA TIMUR,JATINEGARA,KAMPUNG MELAYU,25717,10263,15454,9796,25250,2021-09-07
3171081002,JAKARTA PUSAT,JOHAR BARU,KAMPUNG RAWA,21237,5681,15556,9801,25357,2021-09-07
3175041002,JAKARTA TIMUR,KRAMAT JATI,KAMPUNG TENGAH,43993,17543,26450,16188,42638,2021-09-07
3173011005,JAKARTA BARAT,CENGKARENG,KAPUK,134466,51307,83159,49533,132692,2021-09-07
3172011003,JAKARTA UTARA,PENJARINGAN,KAPUK MUARA,35781,10974,24807,18887,43694,2021-09-07
3171021002,JAKARTA PUSAT,SAWAH BESAR,KARANG ANYAR,25761,8499,17262,11685,28947,2021-09-07
3174021004,JAKARTA SELATAN,SETIA BUDI,KARET,9623,3621,6002,3952,9954,2021-09-07
3174021003,JAKARTA SELATAN,SETIA BUDI,KARET KUNINGAN,16055,5352,10703,7049,17752,2021-09-07
3174021002,JAKARTA SELATAN,SETIA BUDI,KARET SEMANGGI,2770,945,1825,1377,3202,2021-09-07
3171071003,JAKARTA PUSAT,TANAH ABANG,KARET TENGSIN,19271,6933,12338,8095,20433,2021-09-07
3171021003,JAKARTA PUSAT,SAWAH BESAR,KARTINI,22292,7628,14664,10433,25097,2021-09-07
3175011003,JAKARTA TIMUR,MATRAMAN,KAYU MANIS,25284,9806,15478,9470,24948,2021-09-07
3175021006,JAKARTA TIMUR,PULO GADUNG,KAYU PUTIH,40696,13710,26986,19794,46780,2021-09-07
3173031006,JAKARTA BARAT,TAMAN SARI,KEAGUNGAN,17387,5868,11519,7919,19438,2021-09-07
3174041007,JAKARTA SELATAN,PASAR MINGGU,KEBAGUSAN,44552,17082,27470,16438,43908,2021-09-07
3174051006,JAKARTA SELATAN,KEBAYORAN LAMA,KEBAYORAN LAMA SELATAN,41212,14760,26452,15762,42214,2021-09-07
3174051001,JAKARTA SELATAN,KEBAYORAN LAMA,KEBAYORAN LAMA UTARA,42422,16558,25864,14294,40158,2021-09-07
3174011004,JAKARTA SELATAN,TEBET,KEBON BARU,35165,12917,22248,13547,35795,2021-09-07
3172021005,JAKARTA UTARA,TANJUNG PRIOK,KEBON BAWANG,50952,17964,32988,21860,54848,2021-09-07
3173051001,JAKARTA BARAT,KEBON JERUK,KEBON JERUK,53887,20284,33603,21647,55250,2021-09-07
3171071006,JAKARTA PUSAT,TANAH ABANG,KEBON KACANG,21531,8867,12664,8172,20836,2021-09-07
3171011005,JAKARTA PUSAT,GAMBIR,KEBON KELAPA,10163,3541,6622,4505,11127,2021-09-07
3171031002,JAKARTA PUSAT,KEMAYORAN,KEBON KOSONG,30019,10648,19371,12941,32312,2021-09-07
3175011005,JAKARTA TIMUR,MATRAMAN,KEBON MANGGIS,16490,5829,10661,7221,17882,2021-09-07
3171071005,JAKARTA PUSAT,TANAH ABANG,KEBON MELATI,32206,13968,18238,11311,29549,2021-09-07
3175081003,JAKARTA TIMUR,MAKASAR,KEBON PALA,46614,16631,29983,19025,49008,2021-09-07
3171061005,JAKARTA PUSAT,MENTENG,KEBON SIRIH,12299,4473,7826,5232,13058,2021-09-07
3173011004,JAKARTA BARAT,CENGKARENG,KEDAUNG KALI ANGKE,32612,10476,22136,15197,37333,2021-09-07
3173051007,JAKARTA BARAT,KEBON JERUK,KEDOYA SELATAN,32165,10928,21237,13826,35063,2021-09-07
3173051006,JAKARTA BARAT,KEBON JERUK,KEDOYA UTARA,45740,14699,31041,21946,52987,2021-09-07
3173051004,JAKARTA BARAT,KEBON JERUK,KELAPA DUA,23565,8730,14835,9434,24269,2021-09-07
3175091003,JAKARTA TIMUR,CIRACAS,KELAPA DUA WETAN,46875,14911,31964,21593,53557,2021-09-07
3172061003,JAKARTA UTARA,KELAPA GADING,KELAPA GADING BARAT,35717,11094,24623,19062,43685,2021-09-07
3172061001,JAKARTA UTARA,KELAPA GADING,KELAPA GADING TIMUR,33592,9526,24066,18597,42663,2021-09-07
3173071005,JAKARTA BARAT,PALMERAH,KEMANGGISAN,32139,11265,20874,13772,34646,2021-09-07
3171031001,JAKARTA PUSAT,KEMAYORAN,KEMAYORAN,20708,7060,13648,9434,23082,2021-09-07
3173081006,JAKARTA BARAT,KEMBANGAN,KEMBANGAN SELATAN,27130,9618,17512,12776,30288,2021-09-07
3173081001,JAKARTA BARAT,KEMBANGAN,KEMBANGAN UTARA,54451,19279,35172,24111,59283,2021-09-07
3171041002,JAKARTA PUSAT,SENEN,KENARI,9579,3282,6297,4566,10863,2021-09-07
3173041005,JAKARTA BARAT,TAMBORA,KERENDANG,19973,6885,13088,8604,21692,2021-09-07
3175071003,JAKARTA TIMUR,DUREN SAWIT,KLENDER,69978,27570,42408,26616,69024,2021-09-07
3172031001,JAKARTA UTARA,KOJA,KOJA,28175,10524,17651,11781,29432,2021-09-07
3173071006,JAKARTA BARAT,PALMERAH,KOTA BAMBU SELATAN,21158,7617,13541,8474,22015,2021-09-07
3173071003,JAKARTA BARAT,PALMERAH,KOTA BAMBU UTARA,24995,9134,15861,9981,25842,2021-09-07
3171041004,JAKARTA PUSAT,SENEN,KRAMAT,28835,10732,18103,10842,28945,2021-09-07
3175041001,JAKARTA TIMUR,KRAMAT JATI,KRAMAT JATI,34144,12334,21810,13677,35487,2021-09-07
3174071003,JAKARTA SELATAN,KEBAYORAN BARU,KRAMAT PELA,14413,5018,9395,6003,15398,2021-09-07
3173031002,JAKARTA BARAT,TAMAN SARI,KRUKUT,19244,6602,12642,8286,20928,2021-09-07
3174031005,JAKARTA SELATAN,MAMPANG PRAPATAN,KUNINGAN BARAT,12785,4476,8309,5184,13493,2021-09-07
3174021008,JAKARTA SELATAN,SETIA BUDI,KUNINGAN TIMUR,6008,2138,3870,2579,6449,2021-09-07
3171041005,JAKARTA PUSAT,SENEN,KWITANG,15486,5526,9960,6652,16612,2021-09-07
3172031003,JAKARTA UTARA,KOJA,LAGOA,59065,22410,36655,23218,59873,2021-09-07
3174061002,JAKARTA SELATAN,CILANDAK,LEBAK BULUS,37626,14288,23338,14902,38240,2021-09-07
3174091004,JAKARTA SELATAN,JAGAKARSA,LENTENG AGUNG,53946,20518,33428,19071,52499,2021-09-07
3175101007,JAKARTA TIMUR,CIPAYUNG,LUBANG BUAYA,63547,20986,42561,28878,71439,2021-09-07
3175081001,JAKARTA TIMUR,MAKASAR,MAKASAR,34390,11788,22602,15431,38033,2021-09-07
3175071006,JAKARTA TIMUR,DUREN SAWIT,MALAKA JAYA,30927,11061,19866,14278,34144,2021-09-07
3175071005,JAKARTA TIMUR,DUREN SAWIT,MALAKA SARI,27530,9516,18014,13116,31130,2021-09-07
3174031001,JAKARTA SELATAN,MAMPANG PRAPATAN,MAMPANG PRAPATAN,18159,6669,11490,7339,18829,2021-09-07
3173031005,JAKARTA BARAT,TAMAN SARI,MANGGA BESAR,7707,2316,5391,3899,9290,2021-09-07
3171021005,JAKARTA PUSAT,SAWAH BESAR,MANGGA DUA SELATAN,27442,9367,18075,12644,30719,2021-09-07
3174011007,JAKARTA SELATAN,TEBET,MANGGARAI,28373,9558,18815,11039,29854,2021-09-07
3174011006,JAKARTA SELATAN,TEBET,MANGGARAI SELATAN,23075,8037,15038,9441,24479,2021-09-07
3173031003,JAKARTA BARAT,TAMAN SARI,MAPHAR,16461,5752,10709,7383,18092,2021-09-07
3172041003,JAKARTA UTARA,CILINCING,MARUNDA,28943,9797,19146,10372,29518,2021-09-07
3174071001,JAKARTA SELATAN,KEBAYORAN BARU,MELAWAI,2627,894,1733,1371,3104,2021-09-07
3171061001,JAKARTA PUSAT,MENTENG,MENTENG,25624,9660,15964,10587,26551,2021-09-07
3174021005,JAKARTA SELATAN,SETIA BUDI,MENTENG ATAS,27816,9511,18305,11234,29539,2021-09-07
3174011003,JAKARTA SELATAN,TEBET,MENTENG DALAM,36028,13130,22898,14380,37278,2021-09-07
3173081003,JAKARTA BARAT,KEMBANGAN,MERUYA SELATAN,32130,11482,20648,14213,34861,2021-09-07
3173081002,JAKARTA BARAT,KEMBANGAN,MERUYA UTARA,43752,15896,27856,20343,48199,2021-09-07
3175101004,JAKARTA TIMUR,CIPAYUNG,MUNJUL,23871,7971,15900,11229,27129,2021-09-07
3172051002,JAKARTA UTARA,PADEMANGAN,PADEMANGAN BARAT,74240,27301,46939,30997,77936,2021-09-07
3172051001,JAKARTA UTARA,PADEMANGAN,PADEMANGAN TIMUR,37736,11584,26152,18840,44992,2021-09-07
3175011004,JAKARTA TIMUR,MATRAMAN,PAL MERIAM,19769,7557,12212,7941,20153,2021-09-07
3173071001,JAKARTA BARAT,PALMERAH,PALMERAH,63011,22964,40047,25468,65515,2021-09-07
3174081001,JAKARTA SELATAN,PANCORAN,PANCORAN,19421,7215,12206,7423,19629,2021-09-07
3172021003,JAKARTA UTARA,TANJUNG PRIOK,PAPANGGO,39097,12854,26243,17608,43851,2021-09-07
3171021001,JAKARTA PUSAT,SAWAH BESAR,PASAR BARU,12035,3722,8313,6169,14482,2021-09-07
3174021006,JAKARTA SELATAN,SETIA BUDI,PASAR MANGGIS,26752,9766,16986,10467,27453,2021-09-07
3174041001,JAKARTA SELATAN,PASAR MINGGU,PASAR MINGGU,24821,9055,15766,10268,26034,2021-09-07
3171041003,JAKARTA PUSAT,SENEN,PASEBAN,23533,8592,14941,9747,24688,2021-09-07
3173061005,JAKARTA BARAT,KALI DERES,PEGADUNGAN,75587,25240,50347,36077,86424,2021-09-07
3171061002,JAKARTA PUSAT,MENTENG,PEGANGSAAN,23455,8642,14813,9335,24148,2021-09-07
3172061002,JAKARTA UTARA,KELAPA GADING,PEGANGSAAN DUA,49976,14182,35794,27207,63001,2021-09-07
3172011004,JAKARTA UTARA,PENJARINGAN,PEJAGALAN,74578,26134,48444,33931,82375,2021-09-07
3174041006,JAKARTA SELATAN,PASAR MINGGU,PEJATEN BARAT,37346,14028,23318,14731,38049,2021-09-07
3174041005,JAKARTA SELATAN,PASAR MINGGU,PEJATEN TIMUR,57656,22553,35103,19948,55051,2021-09-07
3175051005,JAKARTA TIMUR,PASAR REBO,PEKAYON,43250,14378,28872,19683,48555,2021-09-07
3173041009,JAKARTA BARAT,TAMBORA,PEKOJAN,23587,7698,15889,11062,26951,2021-09-07
3174031003,JAKARTA SELATAN,MAMPANG PRAPATAN,PELA MAMPANG,43522,15758,27764,18168,45932,2021-09-07
3174081005,JAKARTA SELATAN,PANCORAN,PENGADEGAN,21478,7178,14300,7889,22189,2021-09-07
3175061003,JAKARTA TIMUR,CAKUNG,PENGGILINGAN,99255,39044,60211,38223,98434,2021-09-07
3172011001,JAKARTA UTARA,PENJARINGAN,PENJARINGAN,88308,33901,54407,34818,89225,2021-09-07
3174101001,JAKARTA SELATAN,PESANGGRAHAN,PESANGGRAHAN,27545,9449,18096,11388,29484,2021-09-07
3171071004,JAKARTA PUSAT,TANAH ABANG,PETAMBURAN,33271,14524,18747,11594,30341,2021-09-07
3174071008,JAKARTA SELATAN,KEBAYORAN BARU,PETOGOGAN,11499,4279,7220,4740,11960,2021-09-07
3171011004,JAKARTA PUSAT,GAMBIR,PETOJO SELATAN,14692,5391,9301,6461,15762,2021-09-07
3171011003,JAKARTA PUSAT,GAMBIR,PETOJO UTARA,17458,6274,11184,7392,18576,2021-09-07
3174101004,JAKARTA SELATAN,PESANGGRAHAN,PETUKANGAN SELATAN,37187,13702,23485,14224,37709,2021-09-07
3174101003,JAKARTA SELATAN,PESANGGRAHAN,PETUKANGAN UTARA,53716,20953,32763,20067,52830,2021-09-07
3175081002,JAKARTA TIMUR,MAKASAR,PINANG RANTI,27198,9745,17453,11789,29242,2021-09-07
3173031008,JAKARTA BARAT,TAMAN SARI,PINANGSIA,10729,3333,7396,5090,12486,2021-09-07
3175011001,JAKARTA TIMUR,MATRAMAN,PISANGAN BARU,31776,12063,19713,11960,31673,2021-09-07
3175021002,JAKARTA TIMUR,PULO GADUNG,PISANGAN TIMUR,41011,13983,27028,18381,45409,2021-09-07
3172011005,JAKARTA UTARA,PENJARINGAN,PLUIT,47783,15615,32168,24092,56260,2021-09-07
3175071002,JAKARTA TIMUR,DUREN SAWIT,PONDOK BAMBU,61550,23454,38096,24626,62722,2021-09-07
3175071004,JAKARTA TIMUR,DUREN SAWIT,PONDOK KELAPA,72015,25969,46046,30027,76073,2021-09-07
3175071007,JAKARTA TIMUR,DUREN SAWIT,PONDOK KOPI,35367,14352,21015,12986,34001,2021-09-07
3174061003,JAKARTA SELATAN,CILANDAK,PONDOK LABU,46464,16109,30355,20403,50758,2021-09-07
3174051002,JAKARTA SELATAN,KEBAYORAN LAMA,PONDOK PINANG,56169,20898,35271,22274,57545,2021-09-07
3175101003,JAKARTA TIMUR,CIPAYUNG,PONDOK RANGGON,25574,8764,16810,11696,28506,2021-09-07
3101011003,KAB.ADM.KEP.SERIBU,KEP. SERIBU UTARA,PULAU HARAPAN,2060,335,1725,1038,2763,2021-09-07
3101011002,KAB.ADM.KEP.SERIBU,KEP. SERIBU UTARA,PULAU KELAPA,5528,889,4639,2659,7298,2021-09-07
3101011001,KAB.ADM.KEP.SERIBU,KEP. SERIBU UTARA,PULAU PANGGANG,5450,833,4617,2194,6811,2021-09-07
3101021003,KAB.ADM.KEP.SERIBU,KEP. SERIBU SELATAN,PULAU PARI,2765,318,2447,1501,3948,2021-09-07
3101021002,KAB.ADM.KEP.SERIBU,KEP. SERIBU SELATAN,PULAU TIDUNG,4553,611,3942,2709,6651,2021-09-07
3101021001,KAB.ADM.KEP.SERIBU,KEP. SERIBU SELATAN,PULAU UNTUNG JAWA,1941,315,1626,1024,2650,2021-09-07
3174071007,JAKARTA SELATAN,KEBAYORAN BARU,PULO,5835,1960,3875,2841,6716,2021-09-07
3175021001,JAKARTA TIMUR,PULO GADUNG,PULO GADUNG,34422,12365,22057,14425,36482,2021-09-07
3175061005,JAKARTA TIMUR,CAKUNG,PULO GEBANG,97301,35097,62204,40516,102720,2021-09-07
3174041004,JAKARTA SELATAN,PASAR MINGGU,RAGUNAN,39616,13935,25681,16430,42111,2021-09-07
3175091005,JAKARTA TIMUR,CIRACAS,RAMBUTAN,36771,14399,22372,14689,37061,2021-09-07
3172031006,JAKARTA UTARA,KOJA,RAWA BADAK SELATAN,42179,16176,26003,16416,42419,2021-09-07
3172031004,JAKARTA UTARA,KOJA,RAWA BADAK UTARA,34408,12880,21528,13971,35499,2021-09-07
3174071005,JAKARTA SELATAN,KEBAYORAN BARU,RAWA BARAT,5625,1876,3749,2588,6337,2021-09-07
3173011003,JAKARTA BARAT,CENGKARENG,RAWA BUAYA,63799,22802,40997,25297,66294,2021-09-07
3175031004,JAKARTA TIMUR,JATINEGARA,RAWA BUNGA,21434,8361,13073,8710,21783,2021-09-07
3174081003,JAKARTA SELATAN,PANCORAN,RAWA JATI,20509,7386,13123,7835,20958,2021-09-07
3175061002,JAKARTA TIMUR,CAKUNG,RAWA TERATE,24637,7889,16748,11931,28679,2021-09-07
3175021005,JAKARTA TIMUR,PULO GADUNG,RAWAMANGUN,37612,13557,24055,16460,40515,2021-09-07
3171051003,JAKARTA PUSAT,CEMPAKA PUTIH,RAWASARI,21967,7970,13997,9847,23844,2021-09-07
3173041010,JAKARTA BARAT,TAMBORA,ROA MALAKA,3484,1032,2452,1801,4253,2021-09-07
3172041006,JAKARTA UTARA,CILINCING,ROROTAN,41668,13759,27909,17649,45558,2021-09-07
3174071004,JAKARTA SELATAN,KEBAYORAN BARU,SELONG,2842,975,1867,1415,3282,2021-09-07
3173061002,JAKARTA BARAT,KALI DERES,SEMANAN,71354,26675,44679,27449,72128,2021-09-07
3172041007,JAKARTA UTARA,CILINCING,SEMPER BARAT,68587,22469,46118,31431,77549,2021-09-07
3172041005,JAKARTA UTARA,CILINCING,SEMPER TIMUR,36267,12416,23851,15367,39218,2021-09-07
3174071006,JAKARTA SELATAN,KEBAYORAN BARU,SENAYAN,2771,1118,1653,1106,2759,2021-09-07
3171041001,JAKARTA PUSAT,SENEN,SENEN,6804,2297,4507,3186,7693,2021-09-07
3171031004,JAKARTA PUSAT,KEMAYORAN,SERDANG,29668,10501,19167,12803,31970,2021-09-07
3174021001,JAKARTA SELATAN,SETIA BUDI,SETIA BUDI,3023,1111,1912,1296,3208,2021-09-07
3175101005,JAKARTA TIMUR,CIPAYUNG,SETU,20572,7575,12997,8480,21477,2021-09-07
3173071002,JAKARTA BARAT,PALMERAH,SLIPI,16591,5583,11008,7499,18507,2021-09-07
3173081004,JAKARTA BARAT,KEMBANGAN,SRENGSENG,45523,17030,28493,18785,47278,2021-09-07
3174091002,JAKARTA SELATAN,JAGAKARSA,SRENGSENG SAWAH,58196,18885,39311,24490,63801,2021-09-07
3173051003,JAKARTA BARAT,KEBON JERUK,SUKABUMI SELATAN,37033,14199,22834,12597,35431,2021-09-07
3173051002,JAKARTA BARAT,KEBON JERUK,SUKABUMI UTARA,38290,14912,23378,12946,36324,2021-09-07
3172041002,JAKARTA UTARA,CILINCING,SUKAPURA,53949,19561,34388,23353,57741,2021-09-07
3171031007,JAKARTA PUSAT,KEMAYORAN,SUMUR BATU,22717,8168,14549,10071,24620,2021-09-07
3172021004,JAKARTA UTARA,TANJUNG PRIOK,SUNGAI BAMBU,29876,10354,19522,12840,32362,2021-09-07
3172021006,JAKARTA UTARA,TANJUNG PRIOK,SUNTER AGUNG,71805,21797,50008,36894,86902,2021-09-07
3172021002,JAKARTA UTARA,TANJUNG PRIOK,SUNTER JAYA,63031,19913,43118,31587,74705,2021-09-07
3175091004,JAKARTA TIMUR,CIRACAS,SUSUKAN,38257,12576,25681,16481,42162,2021-09-07
3173031001,JAKARTA BARAT,TAMAN SARI,TAMAN SARI,14348,4927,9421,6859,16280,2021-09-07
3173041001,JAKARTA BARAT,TAMBORA,TAMBORA,10204,3643,6561,4134,10695,2021-09-07
3173041004,JAKARTA BARAT,TAMBORA,TANAH SEREAL,26387,7852,18535,12480,31015,2021-09-07
3171081004,JAKARTA PUSAT,JOHAR BARU,TANAH TINGGI,37693,11389,26304,16801,43105,2021-09-07
3173031004,JAKARTA BARAT,TAMAN SARI,TANGKI,13324,4480,8844,6384,15228,2021-09-07
3174091005,JAKARTA SELATAN,JAGAKARSA,TANJUNG BARAT,39770,14094,25676,14973,40649,2021-09-07
3173021005,JAKARTA BARAT,GROGOL PETAMBURAN,TANJUNG DUREN SELATAN,25337,8773,16564,11778,28342,2021-09-07
3173021002,JAKARTA BARAT,GROGOL PETAMBURAN,TANJUNG DUREN UTARA,17010,5577,11433,8092,19525,2021-09-07
3172021001,JAKARTA UTARA,TANJUNG PRIOK,TANJUNG PRIOK,34588,11449,23139,15066,38205,2021-09-07
3174011002,JAKARTA SELATAN,TEBET,TEBET BARAT,21194,7035,14159,9386,23545,2021-09-07
3174011001,JAKARTA SELATAN,TEBET,TEBET TIMUR,18199,6052,12147,8064,20211,2021-09-07
3173061003,JAKARTA BARAT,KALI DERES,TEGAL ALUR,83647,29532,54115,33281,87396,2021-09-07
3174031004,JAKARTA SELATAN,MAMPANG PRAPATAN,TEGAL PARANG,32401,12701,19700,11452,31152,2021-09-07
3173021003,JAKARTA BARAT,GROGOL PETAMBURAN,TOMANG,29605,10154,19451,14127,33578,2021-09-07
3172031005,JAKARTA UTARA,KOJA,TUGU SELATAN,39122,14573,24549,15859,40408,2021-09-07
3172031002,JAKARTA UTARA,KOJA,TUGU UTARA,67670,25892,41778,26731,68509,2021-09-07
3175061006,JAKARTA TIMUR,CAKUNG,UJUNG MENTENG,29934,9700,20234,14174,34408,2021-09-07
3174101005,JAKARTA SELATAN,PESANGGRAHAN,ULUJAMI,40544,16194,24350,14076,38426,2021-09-07
3175011006,JAKARTA TIMUR,MATRAMAN,UTAN KAYU SELATAN,33511,11569,21942,14267,36209,2021-09-07
3175011002,JAKARTA TIMUR,MATRAMAN,UTAN KAYU UTARA,28169,10621,17548,11242,28790,2021-09-07
3171031008,JAKARTA PUSAT,KEMAYORAN,UTAN PANJANG,29208,10721,18487,12376,30863,2021-09-07
3172021007,JAKARTA UTARA,TANJUNG PRIOK,WARAKAS,44401,14666,29735,19004,48739,2021-09-07
3173021007,JAKARTA BARAT,GROGOL PETAMBURAN,WIJAYA KUSUMA,38934,14179,24755,17489,42244,2021-09-07
3172051003,JAKARTA UTARA,PADEMANGAN,ANCOL,23947,8924,15023,10424,25447,2021-09-08
3173041007,JAKARTA BARAT,TAMBORA,ANGKE,29381,10121,19260,11817,31077,2021-09-08
3175041005,JAKARTA TIMUR,KRAMAT JATI,BALE KAMBANG,29074,12086,16988,9518,26506,2021-09-08
3175031003,JAKARTA TIMUR,JATINEGARA,BALI MESTER,9752,3592,6160,4265,10425,2021-09-08
3175101006,JAKARTA TIMUR,CIPAYUNG,BAMBU APUS,26285,9030,17255,12129,29384,2021-09-08
3174031002,JAKARTA SELATAN,MAMPANG PRAPATAN,BANGKA,21566,8295,13271,8314,21585,2021-09-08
3175051002,JAKARTA TIMUR,PASAR REBO,BARU,23886,7421,16465,12262,28727,2021-09-08
3175041004,JAKARTA TIMUR,KRAMAT JATI,BATU AMPAR,47898,19189,28709,18113,46822,2021-09-08
3171071002,JAKARTA PUSAT,TANAH ABANG,BENDUNGAN HILIR,21494,7848,13646,9429,23075,2021-09-08
3175031002,JAKARTA TIMUR,JATINEGARA,BIDARA CINA,36689,14812,21877,14451,36328,2021-09-08
3174101002,JAKARTA SELATAN,PESANGGRAHAN,BINTARO,53098,19974,33124,21177,54301,2021-09-08
3174011005,JAKARTA SELATAN,TEBET,BUKIT DURI,34183,13267,20916,12339,33255,2021-09-08
3171041006,JAKARTA PUSAT,SENEN,BUNGUR,18144,6296,11848,8121,19969,2021-09-08
3175061007,JAKARTA TIMUR,CAKUNG,CAKUNG BARAT,57724,19026,38698,25802,64500,2021-09-08
3175061004,JAKARTA TIMUR,CAKUNG,CAKUNG TIMUR,58287,19307,38980,28242,67222,2021-09-08
3175041007,JAKARTA TIMUR,KRAMAT JATI,CAWANG,32762,12362,20400,13220,33620,2021-09-08
3175101008,JAKARTA TIMUR,CIPAYUNG,CEGER,18932,6426,12506,8845,21351,2021-09-08
3171031006,JAKARTA PUSAT,KEMAYORAN,CEMPAKA BARU,32581,11660,20921,13687,34608,2021-09-08
3171051002,JAKARTA PUSAT,CEMPAKA PUTIH,CEMPAKA PUTIH BARAT,35885,12957,22928,16791,39719,2021-09-08
3171051001,JAKARTA PUSAT,CEMPAKA PUTIH,CEMPAKA PUTIH TIMUR,24292,8435,15857,11302,27159,2021-09-08
3173011001,JAKARTA BARAT,CENGKARENG,CENGKARENG BARAT,66284,22828,43456,30047,73503,2021-09-08
3173011006,JAKARTA BARAT,CENGKARENG,CENGKARENG TIMUR,81027,27326,53701,33705,87406,2021-09-08
3175091002,JAKARTA TIMUR,CIRACAS,CIBUBUR,66364,21433,44931,31188,76119,2021-09-08
3171011002,JAKARTA PUSAT,GAMBIR,CIDENG,15390,5095,10295,7495,17790,2021-09-08
3174091003,JAKARTA SELATAN,JAGAKARSA,CIGANJUR,38497,13884,24613,14796,39409,2021-09-08
3175051003,JAKARTA TIMUR,PASAR REBO,CIJANTUNG,41419,13514,27905,19754,47659,2021-09-08
3171061003,JAKARTA PUSAT,MENTENG,CIKINI,8274,2895,5379,3510,8889,2021-09-08
3174081006,JAKARTA SELATAN,PANCORAN,CIKOKO,10547,3624,6923,4142,11065,2021-09-08
3174061001,JAKARTA SELATAN,CILANDAK,CILANDAK BARAT,51752,18587,33165,21113,54278,2021-09-08
3174041003,JAKARTA SELATAN,PASAR MINGGU,CILANDAK TIMUR,25145,8919,16226,10911,27137,2021-09-08
3175101002,JAKARTA TIMUR,CIPAYUNG,CILANGKAP,27635,9328,18307,12976,31283,2021-09-08
3175041006,JAKARTA TIMUR,KRAMAT JATI,CILILITAN,40181,15774,24407,16467,40874,2021-09-08
3172041001,JAKARTA UTARA,CILINCING,CILINCING,43609,16232,27377,17396,44773,2021-09-08
3175101001,JAKARTA TIMUR,CIPAYUNG,CIPAYUNG,26104,8106,17998,13227,31225,2021-09-08
3174091006,JAKARTA SELATAN,JAGAKARSA,CIPEDAK,38303,12834,25469,16023,41492,2021-09-08
3174061005,JAKARTA SELATAN,CILANDAK,CIPETE SELATAN,26704,10032,16672,11339,28011,2021-09-08
3174071010,JAKARTA SELATAN,KEBAYORAN BARU,CIPETE UTARA,34102,12490,21612,13541,35153,2021-09-08
3175021003,JAKARTA TIMUR,PULO GADUNG,CIPINANG,39306,14069,25237,17203,42440,2021-09-08
3175031007,JAKARTA TIMUR,JATINEGARA,CIPINANG BESAR SELATAN,35212,13687,21525,13573,35098,2021-09-08
3175031008,JAKARTA TIMUR,JATINEGARA,CIPINANG BESAR UTARA,45319,17631,27688,17936,45624,2021-09-08
3175031005,JAKARTA TIMUR,JATINEGARA,CIPINANG CEMPEDAK,32824,12898,19926,14293,34219,2021-09-08
3175081005,JAKARTA TIMUR,MAKASAR,CIPINANG MELAYU,42308,15556,26752,19019,45771,2021-09-08
3175031006,JAKARTA TIMUR,JATINEGARA,CIPINANG MUARA,55243,21273,33970,22931,56901,2021-09-08
3174051003,JAKARTA SELATAN,KEBAYORAN LAMA,CIPULIR,39937,15976,23961,13408,37369,2021-09-08
3175091001,JAKARTA TIMUR,CIRACAS,CIRACAS,64594,20697,43897,29729,73626,2021-09-08
3175041003,JAKARTA TIMUR,KRAMAT JATI,DUKUH,24609,8367,16242,11084,27326,2021-09-08
3175071001,JAKARTA TIMUR,DUREN SAWIT,DUREN SAWIT,61160,23346,37814,25686,63500,2021-09-08
3174081004,JAKARTA SELATAN,PANCORAN,DUREN TIGA,28319,10471,17848,9820,27668,2021-09-08
3173051005,JAKARTA BARAT,KEBON JERUK,DURI KEPA,60138,20102,40036,27996,68032,2021-09-08
3173011002,JAKARTA BARAT,CENGKARENG,DURI KOSAMBI,77923,29700,48223,29968,78191,2021-09-08
3171011006,JAKARTA PUSAT,GAMBIR,DURI PULO,19610,6850,12760,8387,21147,2021-09-08
3173041011,JAKARTA BARAT,TAMBORA,DURI SELATAN,14259,4507,9752,6803,16555,2021-09-08
3173041003,JAKARTA BARAT,TAMBORA,DURI UTARA,19844,6599,13245,8886,22131,2021-09-08
3171081003,JAKARTA PUSAT,JOHAR BARU,GALUR,18243,5572,12671,8408,21079,2021-09-08
3171011001,JAKARTA PUSAT,GAMBIR,GAMBIR,2191,727,1464,1088,2552,2021-09-08
3174061004,JAKARTA SELATAN,CILANDAK,GANDARIA SELATAN,22119,8236,13883,8447,22330,2021-09-08
3174071009,JAKARTA SELATAN,KEBAYORAN BARU,GANDARIA UTARA,39922,14980,24942,15708,40650,2021-09-08
3175051001,JAKARTA TIMUR,PASAR REBO,GEDONG,35755,12282,23473,16600,40073,2021-09-08
3171071001,JAKARTA PUSAT,TANAH ABANG,GELORA,3127,1171,1956,1298,3254,2021-09-08
3173031007,JAKARTA BARAT,TAMAN SARI,GLODOK,7837,2327,5510,4222,9732,2021-09-08
3171061004,JAKARTA PUSAT,MENTENG,GONDANGDIA,4100,1465,2635,2080,4715,2021-09-08
3173021001,JAKARTA BARAT,GROGOL PETAMBURAN,GROGOL,16876,5964,10912,7585,18497,2021-09-08
3174051005,JAKARTA SELATAN,KEBAYORAN LAMA,GROGOL SELATAN,44251,16919,27332,15981,43313,2021-09-08
3174051004,JAKARTA SELATAN,KEBAYORAN LAMA,GROGOL UTARA,42494,16012,26482,15762,42244,2021-09-08
3174021007,JAKARTA SELATAN,SETIA BUDI,GUNTUR,3985,1373,2612,1907,4519,2021-09-08
3174071002,JAKARTA SELATAN,KEBAYORAN BARU,GUNUNG,9436,3322,6114,4287,10401,2021-09-08
3171031005,JAKARTA PUSAT,KEMAYORAN,GUNUNG SAHARI SELATAN,19199,6801,12398,8767,21165,2021-09-08
3171021004,JAKARTA PUSAT,SAWAH BESAR,GUNUNG SAHARI UTARA,16650,5085,11565,8796,20361,2021-09-08
3175081004,JAKARTA TIMUR,MAKASAR,HALIM PERDANA KUSUMAH,28363,7722,20641,16496,37137,2021-09-08
3171031003,JAKARTA PUSAT,KEMAYORAN,HARAPAN MULIA,22557,7890,14667,10143,24810,2021-09-08
3174091001,JAKARTA SELATAN,JAGAKARSA,JAGAKARSA,62389,21798,40591,26179,66770,2021-09-08
3175021007,JAKARTA TIMUR,PULO GADUNG,JATI,32757,11444,21313,15165,36478,2021-09-08
3174041002,JAKARTA SELATAN,PASAR MINGGU,JATI PADANG,37502,13796,23706,15194,38900,2021-09-08
3173071004,JAKARTA BARAT,PALMERAH,JATI PULO,28738,9517,19221,12559,31780,2021-09-08
3175061001,JAKARTA TIMUR,CAKUNG,JATINEGARA,84160,30433,53727,37904,91631,2021-09-08
3175021004,JAKARTA TIMUR,PULO GADUNG,JATINEGARA KAUM,24632,8097,16535,10244,26779,2021-09-08
3173021004,JAKARTA BARAT,GROGOL PETAMBURAN,JELAMBAR,30266,10530,19736,14558,34294,2021-09-08
3173021006,JAKARTA BARAT,GROGOL PETAMBURAN,JELAMBAR BARU,38246,13149,25097,18222,43319,2021-09-08
3173041006,JAKARTA BARAT,TAMBORA,JEMBATAN BESI,29314,11547,17767,10663,28430,2021-09-08
3173041008,JAKARTA BARAT,TAMBORA,JEMBATAN LIMA,21021,7906,13115,8285,21400,2021-09-08
3173081005,JAKARTA BARAT,KEMBANGAN,JOGLO,40839,14475,26364,17880,44244,2021-09-08
3171081001,JAKARTA PUSAT,JOHAR BARU,JOHAR BARU,37488,11799,25689,17941,43630,2021-09-08
3173041002,JAKARTA BARAT,TAMBORA,KALI ANYAR,23856,7957,15899,9992,25891,2021-09-08
3172041004,JAKARTA UTARA,CILINCING,KALIBARU,67684,26816,40868,24232,65100,2021-09-08
3174081002,JAKARTA SELATAN,PANCORAN,KALIBATA,41994,17338,24656,13454,38110,2021-09-08
3173061001,JAKARTA BARAT,KALI DERES,KALIDERES,72447,25903,46544,33934,80478,2021-09-08
3175051004,JAKARTA TIMUR,PASAR REBO,KALISARI,43212,14384,28828,20723,49551,2021-09-08
3173061004,JAKARTA BARAT,KALI DERES,KAMAL,53783,19876,33907,21492,55399,2021-09-08
3172011002,JAKARTA UTARA,PENJARINGAN,KAMAL MUARA,12930,3407,9523,7136,16659,2021-09-08
3171071007,JAKARTA PUSAT,TANAH ABANG,KAMPUNG BALI,11358,4364,6994,4511,11505,2021-09-08
3175031001,JAKARTA TIMUR,JATINEGARA,KAMPUNG MELAYU,25717,10192,15525,10139,25664,2021-09-08
3171081002,JAKARTA PUSAT,JOHAR BARU,KAMPUNG RAWA,21237,5664,15573,10039,25612,2021-09-08
3175041002,JAKARTA TIMUR,KRAMAT JATI,KAMPUNG TENGAH,43993,17437,26556,16736,43292,2021-09-08
3173011005,JAKARTA BARAT,CENGKARENG,KAPUK,134466,50871,83595,51123,134718,2021-09-08
3172011003,JAKARTA UTARA,PENJARINGAN,KAPUK MUARA,35781,10895,24886,19235,44121,2021-09-08
3171021002,JAKARTA PUSAT,SAWAH BESAR,KARANG ANYAR,25761,8457,17304,11919,29223,2021-09-08
3174021004,JAKARTA SELATAN,SETIA BUDI,KARET,9623,3611,6012,3969,9981,2021-09-08
3174021003,JAKARTA SELATAN,SETIA BUDI,KARET KUNINGAN,16055,5342,10713,7095,17808,2021-09-08
3174021002,JAKARTA SELATAN,SETIA BUDI,KARET SEMANGGI,2770,943,1827,1388,3215,2021-09-08
3171071003,JAKARTA PUSAT,TANAH ABANG,KARET TENGSIN,19271,6788,12483,8231,20714,2021-09-08
3171021003,JAKARTA PUSAT,SAWAH BESAR,KARTINI,22292,7593,14699,10639,25338,2021-09-08
3175011003,JAKARTA TIMUR,MATRAMAN,KAYU MANIS,25284,9739,15545,9885,25430,2021-09-08
3175021006,JAKARTA TIMUR,PULO GADUNG,KAYU PUTIH,40696,13615,27081,20140,47221,2021-09-08
3173031006,JAKARTA BARAT,TAMAN SARI,KEAGUNGAN,17387,5837,11550,8133,19683,2021-09-08
3174041007,JAKARTA SELATAN,PASAR MINGGU,KEBAGUSAN,44552,17058,27494,16480,43974,2021-09-08
3174051006,JAKARTA SELATAN,KEBAYORAN LAMA,KEBAYORAN LAMA SELATAN,41212,14746,26466,15831,42297,2021-09-08
3174051001,JAKARTA SELATAN,KEBAYORAN LAMA,KEBAYORAN LAMA UTARA,42422,16541,25881,14357,40238,2021-09-08
3174011004,JAKARTA SELATAN,TEBET,KEBON BARU,35165,12895,22270,13610,35880,2021-09-08
3172021005,JAKARTA UTARA,TANJUNG PRIOK,KEBON BAWANG,50952,17851,33101,22268,55369,2021-09-08
3173051001,JAKARTA BARAT,KEBON JERUK,KEBON JERUK,53887,20163,33724,22418,56142,2021-09-08
3171071006,JAKARTA PUSAT,TANAH ABANG,KEBON KACANG,21531,8755,12776,8508,21284,2021-09-08
3171011005,JAKARTA PUSAT,GAMBIR,KEBON KELAPA,10163,3525,6638,4617,11255,2021-09-08
3171031002,JAKARTA PUSAT,KEMAYORAN,KEBON KOSONG,30019,10575,19444,13297,32741,2021-09-08
3175011005,JAKARTA TIMUR,MATRAMAN,KEBON MANGGIS,16490,5778,10712,7377,18089,2021-09-08
3171071005,JAKARTA PUSAT,TANAH ABANG,KEBON MELATI,32206,13813,18393,11558,29951,2021-09-08
3175081003,JAKARTA TIMUR,MAKASAR,KEBON PALA,46614,16539,30075,19571,49646,2021-09-08
3171061005,JAKARTA PUSAT,MENTENG,KEBON SIRIH,12299,4454,7845,5295,13140,2021-09-08
3173011004,JAKARTA BARAT,CENGKARENG,KEDAUNG KALI ANGKE,32612,10442,22170,15392,37562,2021-09-08
3173051007,JAKARTA BARAT,KEBON JERUK,KEDOYA SELATAN,32165,10866,21299,14228,35527,2021-09-08
3173051006,JAKARTA BARAT,KEBON JERUK,KEDOYA UTARA,45740,14634,31106,22442,53548,2021-09-08
3173051004,JAKARTA BARAT,KEBON JERUK,KELAPA DUA,23565,8697,14868,9691,24559,2021-09-08
3175091003,JAKARTA TIMUR,CIRACAS,KELAPA DUA WETAN,46875,14787,32088,22029,54117,2021-09-08
3172061003,JAKARTA UTARA,KELAPA GADING,KELAPA GADING BARAT,35717,11043,24674,19370,44044,2021-09-08
3172061001,JAKARTA UTARA,KELAPA GADING,KELAPA GADING TIMUR,33592,9472,24120,18877,42997,2021-09-08
3173071005,JAKARTA BARAT,PALMERAH,KEMANGGISAN,32139,11173,20966,14067,35033,2021-09-08
3171031001,JAKARTA PUSAT,KEMAYORAN,KEMAYORAN,20708,7010,13698,9624,23322,2021-09-08
3173081006,JAKARTA BARAT,KEMBANGAN,KEMBANGAN SELATAN,27130,9545,17585,13017,30602,2021-09-08
3173081001,JAKARTA BARAT,KEMBANGAN,KEMBANGAN UTARA,54451,19096,35355,24601,59956,2021-09-08
3171041002,JAKARTA PUSAT,SENEN,KENARI,9579,3265,6314,4633,10947,2021-09-08
3173041005,JAKARTA BARAT,TAMBORA,KERENDANG,19973,6848,13125,8745,21870,2021-09-08
3175071003,JAKARTA TIMUR,DUREN SAWIT,KLENDER,69978,27207,42771,27738,70509,2021-09-08
3172031001,JAKARTA UTARA,KOJA,KOJA,28175,10481,17694,12012,29706,2021-09-08
3173071006,JAKARTA BARAT,PALMERAH,KOTA BAMBU SELATAN,21158,7540,13618,8654,22272,2021-09-08
3173071003,JAKARTA BARAT,PALMERAH,KOTA BAMBU UTARA,24995,9107,15888,10162,26050,2021-09-08
3171041004,JAKARTA PUSAT,SENEN,KRAMAT,28835,10678,18157,11087,29244,2021-09-08
3175041001,JAKARTA TIMUR,KRAMAT JATI,KRAMAT JATI,34144,12271,21873,14117,35990,2021-09-08
3174071003,JAKARTA SELATAN,KEBAYORAN BARU,KRAMAT PELA,14413,5009,9404,6015,15419,2021-09-08
3173031002,JAKARTA BARAT,TAMAN SARI,KRUKUT,19244,6569,12675,8514,21189,2021-09-08
3174031005,JAKARTA SELATAN,MAMPANG PRAPATAN,KUNINGAN BARAT,12785,4471,8314,5192,13506,2021-09-08
3174021008,JAKARTA SELATAN,SETIA BUDI,KUNINGAN TIMUR,6008,2138,3870,2590,6460,2021-09-08
3171041005,JAKARTA PUSAT,SENEN,KWITANG,15486,5502,9984,6759,16743,2021-09-08
3172031003,JAKARTA UTARA,KOJA,LAGOA,59065,22252,36813,23638,60451,2021-09-08
3174061002,JAKARTA SELATAN,CILANDAK,LEBAK BULUS,37626,14280,23346,14947,38293,2021-09-08
3174091004,JAKARTA SELATAN,JAGAKARSA,LENTENG AGUNG,53946,20493,33453,19141,52594,2021-09-08
3175101007,JAKARTA TIMUR,CIPAYUNG,LUBANG BUAYA,63547,20855,42692,29766,72458,2021-09-08
3175081001,JAKARTA TIMUR,MAKASAR,MAKASAR,34390,11716,22674,15929,38603,2021-09-08
3175071006,JAKARTA TIMUR,DUREN SAWIT,MALAKA JAYA,30927,10973,19954,14493,34447,2021-09-08
3175071005,JAKARTA TIMUR,DUREN SAWIT,MALAKA SARI,27530,9418,18112,13343,31455,2021-09-08
3174031001,JAKARTA SELATAN,MAMPANG PRAPATAN,MAMPANG PRAPATAN,18159,6664,11495,7361,18856,2021-09-08
3173031005,JAKARTA BARAT,TAMAN SARI,MANGGA BESAR,7707,2311,5396,3972,9368,2021-09-08
3171021005,JAKARTA PUSAT,SAWAH BESAR,MANGGA DUA SELATAN,27442,9284,18158,12928,31086,2021-09-08
3174011007,JAKARTA SELATAN,TEBET,MANGGARAI,28373,9528,18845,11116,29961,2021-09-08
3174011006,JAKARTA SELATAN,TEBET,MANGGARAI SELATAN,23075,8019,15056,9501,24557,2021-09-08
3173031003,JAKARTA BARAT,TAMAN SARI,MAPHAR,16461,5723,10738,7559,18297,2021-09-08
3172041003,JAKARTA UTARA,CILINCING,MARUNDA,28943,9734,19209,10653,29862,2021-09-08
3174071001,JAKARTA SELATAN,KEBAYORAN BARU,MELAWAI,2627,893,1734,1375,3109,2021-09-08
3171061001,JAKARTA PUSAT,MENTENG,MENTENG,25624,9610,16014,10911,26925,2021-09-08
3174021005,JAKARTA SELATAN,SETIA BUDI,MENTENG ATAS,27816,9492,18324,11304,29628,2021-09-08
3174011003,JAKARTA SELATAN,TEBET,MENTENG DALAM,36028,13108,22920,14431,37351,2021-09-08
3173081003,JAKARTA BARAT,KEMBANGAN,MERUYA SELATAN,32130,11375,20755,14653,35408,2021-09-08
3173081002,JAKARTA BARAT,KEMBANGAN,MERUYA UTARA,43752,15811,27941,20779,48720,2021-09-08
3175101004,JAKARTA TIMUR,CIPAYUNG,MUNJUL,23871,7929,15942,11463,27405,2021-09-08
3172051002,JAKARTA UTARA,PADEMANGAN,PADEMANGAN BARAT,74240,27164,47076,31532,78608,2021-09-08
3172051001,JAKARTA UTARA,PADEMANGAN,PADEMANGAN TIMUR,37736,11520,26216,19171,45387,2021-09-08
3175011004,JAKARTA TIMUR,MATRAMAN,PAL MERIAM,19769,7505,12264,8193,20457,2021-09-08
3173071001,JAKARTA BARAT,PALMERAH,PALMERAH,63011,22857,40154,25936,66090,2021-09-08
3174081001,JAKARTA SELATAN,PANCORAN,PANCORAN,19421,7200,12221,7447,19668,2021-09-08
3172021003,JAKARTA UTARA,TANJUNG PRIOK,PAPANGGO,39097,12785,26312,17931,44243,2021-09-08
3171021001,JAKARTA PUSAT,SAWAH BESAR,PASAR BARU,12035,3709,8326,6320,14646,2021-09-08
3174021006,JAKARTA SELATAN,SETIA BUDI,PASAR MANGGIS,26752,9757,16995,10545,27540,2021-09-08
3174041001,JAKARTA SELATAN,PASAR MINGGU,PASAR MINGGU,24821,9044,15777,10301,26078,2021-09-08
3171041003,JAKARTA PUSAT,SENEN,PASEBAN,23533,8550,14983,10034,25017,2021-09-08
3173061005,JAKARTA BARAT,KALI DERES,PEGADUNGAN,75587,25130,50457,37011,87468,2021-09-08
3171061002,JAKARTA PUSAT,MENTENG,PEGANGSAAN,23455,8570,14885,9562,24447,2021-09-08
3172061002,JAKARTA UTARA,KELAPA GADING,PEGANGSAAN DUA,49976,14075,35901,27661,63562,2021-09-08
3172011004,JAKARTA UTARA,PENJARINGAN,PEJAGALAN,74578,25912,48666,34978,83644,2021-09-08
3174041006,JAKARTA SELATAN,PASAR MINGGU,PEJATEN BARAT,37346,14021,23325,14782,38107,2021-09-08
3174041005,JAKARTA SELATAN,PASAR MINGGU,PEJATEN TIMUR,57656,22542,35114,20024,55138,2021-09-08
3175051005,JAKARTA TIMUR,PASAR REBO,PEKAYON,43250,14289,28961,20092,49053,2021-09-08
3173041009,JAKARTA BARAT,TAMBORA,PEKOJAN,23587,7662,15925,11238,27163,2021-09-08
3174031003,JAKARTA SELATAN,MAMPANG PRAPATAN,PELA MAMPANG,43522,15738,27784,18244,46028,2021-09-08
3174081005,JAKARTA SELATAN,PANCORAN,PENGADEGAN,21478,7170,14308,7918,22226,2021-09-08
3175061003,JAKARTA TIMUR,CAKUNG,PENGGILINGAN,99255,38541,60714,39920,100634,2021-09-08
3172011001,JAKARTA UTARA,PENJARINGAN,PENJARINGAN,88308,33697,54611,35760,90371,2021-09-08
3174101001,JAKARTA SELATAN,PESANGGRAHAN,PESANGGRAHAN,27545,9440,18105,11420,29525,2021-09-08
3171071004,JAKARTA PUSAT,TANAH ABANG,PETAMBURAN,33271,14437,18834,11932,30766,2021-09-08
3174071008,JAKARTA SELATAN,KEBAYORAN BARU,PETOGOGAN,11499,4276,7223,4756,11979,2021-09-08
3171011004,JAKARTA PUSAT,GAMBIR,PETOJO SELATAN,14692,5373,9319,6564,15883,2021-09-08
3171011003,JAKARTA PUSAT,GAMBIR,PETOJO UTARA,17458,6252,11206,7602,18808,2021-09-08
3174101004,JAKARTA SELATAN,PESANGGRAHAN,PETUKANGAN SELATAN,37187,13679,23508,14269,37777,2021-09-08
3174101003,JAKARTA SELATAN,PESANGGRAHAN,PETUKANGAN UTARA,53716,20924,32792,20173,52965,2021-09-08
3175081002,JAKARTA TIMUR,MAKASAR,PINANG RANTI,27198,9702,17496,12021,29517,2021-09-08
3173031008,JAKARTA BARAT,TAMAN SARI,PINANGSIA,10729,3322,7407,5210,12617,2021-09-08
3175011001,JAKARTA TIMUR,MATRAMAN,PISANGAN BARU,31776,11993,19783,12444,32227,2021-09-08
3175021002,JAKARTA TIMUR,PULO GADUNG,PISANGAN TIMUR,41011,13863,27148,19028,46176,2021-09-08
3172011005,JAKARTA UTARA,PENJARINGAN,PLUIT,47783,15498,32285,24493,56778,2021-09-08
3175071002,JAKARTA TIMUR,DUREN SAWIT,PONDOK BAMBU,61550,23243,38307,25656,63963,2021-09-08
3175071004,JAKARTA TIMUR,DUREN SAWIT,PONDOK KELAPA,72015,25794,46221,30912,77133,2021-09-08
3175071007,JAKARTA TIMUR,DUREN SAWIT,PONDOK KOPI,35367,14099,21268,13229,34497,2021-09-08
3174061003,JAKARTA SELATAN,CILANDAK,PONDOK LABU,46464,16097,30367,20449,50816,2021-09-08
3174051002,JAKARTA SELATAN,KEBAYORAN LAMA,PONDOK PINANG,56169,20876,35293,22371,57664,2021-09-08
3175101003,JAKARTA TIMUR,CIPAYUNG,PONDOK RANGGON,25574,8709,16865,11949,28814,2021-09-08
3101011003,KAB.ADM.KEP.SERIBU,KEP. SERIBU UTARA,PULAU HARAPAN,2060,335,1725,1040,2765,2021-09-08
3101011002,KAB.ADM.KEP.SERIBU,KEP. SERIBU UTARA,PULAU KELAPA,5528,888,4640,2661,7301,2021-09-08
3101011001,KAB.ADM.KEP.SERIBU,KEP. SERIBU UTARA,PULAU PANGGANG,5450,833,4617,2197,6814,2021-09-08
3101021003,KAB.ADM.KEP.SERIBU,KEP. SERIBU SELATAN,PULAU PARI,2765,318,2447,1508,3955,2021-09-08
3101021002,KAB.ADM.KEP.SERIBU,KEP. SERIBU SELATAN,PULAU TIDUNG,4553,609,3944,2712,6656,2021-09-08
3101021001,KAB.ADM.KEP.SERIBU,KEP. SERIBU SELATAN,PULAU UNTUNG JAWA,1941,313,1628,1029,2657,2021-09-08
3174071007,JAKARTA SELATAN,KEBAYORAN BARU,PULO,5835,1958,3877,2852,6729,2021-09-08
3175021001,JAKARTA TIMUR,PULO GADUNG,PULO GADUNG,34422,12234,22188,15043,37231,2021-09-08
3175061005,JAKARTA TIMUR,CAKUNG,PULO GEBANG,97301,34715,62586,41364,103950,2021-09-08
3174041004,JAKARTA SELATAN,PASAR MINGGU,RAGUNAN,39616,13926,25690,16467,42157,2021-09-08
3175091005,JAKARTA TIMUR,CIRACAS,RAMBUTAN,36771,14273,22498,15074,37572,2021-09-08
3172031006,JAKARTA UTARA,KOJA,RAWA BADAK SELATAN,42179,16025,26154,16778,42932,2021-09-08
3172031004,JAKARTA UTARA,KOJA,RAWA BADAK UTARA,34408,12775,21633,14336,35969,2021-09-08
3174071005,JAKARTA SELATAN,KEBAYORAN BARU,RAWA BARAT,5625,1872,3753,2599,6352,2021-09-08
3173011003,JAKARTA BARAT,CENGKARENG,RAWA BUAYA,63799,22718,41081,25802,66883,2021-09-08
3175031004,JAKARTA TIMUR,JATINEGARA,RAWA BUNGA,21434,8316,13118,8917,22035,2021-09-08
3174081003,JAKARTA SELATAN,PANCORAN,RAWA JATI,20509,7373,13136,7880,21016,2021-09-08
3175061002,JAKARTA TIMUR,CAKUNG,RAWA TERATE,24637,7785,16852,12245,29097,2021-09-08
3175021005,JAKARTA TIMUR,PULO GADUNG,RAWAMANGUN,37612,13403,24209,17030,41239,2021-09-08
3171051003,JAKARTA PUSAT,CEMPAKA PUTIH,RAWASARI,21967,7929,14038,10045,24083,2021-09-08
3173041010,JAKARTA BARAT,TAMBORA,ROA MALAKA,3484,1029,2455,1826,4281,2021-09-08
3172041006,JAKARTA UTARA,CILINCING,ROROTAN,41668,13688,27980,17910,45890,2021-09-08
3174071004,JAKARTA SELATAN,KEBAYORAN BARU,SELONG,2842,974,1868,1418,3286,2021-09-08
3173061002,JAKARTA BARAT,KALI DERES,SEMANAN,71354,26519,44835,28438,73273,2021-09-08
3172041007,JAKARTA UTARA,CILINCING,SEMPER BARAT,68587,22317,46270,32097,78367,2021-09-08
3172041005,JAKARTA UTARA,CILINCING,SEMPER TIMUR,36267,12359,23908,15748,39656,2021-09-08
3174071006,JAKARTA SELATAN,KEBAYORAN BARU,SENAYAN,2771,1117,1654,1120,2774,2021-09-08
3171041001,JAKARTA PUSAT,SENEN,SENEN,6804,2286,4518,3232,7750,2021-09-08
3171031004,JAKARTA PUSAT,KEMAYORAN,SERDANG,29668,10419,19249,13178,32427,2021-09-08
3174021001,JAKARTA SELATAN,SETIA BUDI,SETIA BUDI,3023,1106,1917,1305,3222,2021-09-08
3175101005,JAKARTA TIMUR,CIPAYUNG,SETU,20572,7543,13029,8690,21719,2021-09-08
3173071002,JAKARTA BARAT,PALMERAH,SLIPI,16591,5552,11039,7646,18685,2021-09-08
3173081004,JAKARTA BARAT,KEMBANGAN,SRENGSENG,45523,16954,28569,19193,47762,2021-09-08
3174091002,JAKARTA SELATAN,JAGAKARSA,SRENGSENG SAWAH,58196,18854,39342,24555,63897,2021-09-08
3173051003,JAKARTA BARAT,KEBON JERUK,SUKABUMI SELATAN,37033,14139,22894,13030,35924,2021-09-08
3173051002,JAKARTA BARAT,KEBON JERUK,SUKABUMI UTARA,38290,14811,23479,13292,36771,2021-09-08
3172041002,JAKARTA UTARA,CILINCING,SUKAPURA,53949,19465,34484,23783,58267,2021-09-08
3171031007,JAKARTA PUSAT,KEMAYORAN,SUMUR BATU,22717,8105,14612,10331,24943,2021-09-08
3172021004,JAKARTA UTARA,TANJUNG PRIOK,SUNGAI BAMBU,29876,10287,19589,13446,33035,2021-09-08
3172021006,JAKARTA UTARA,TANJUNG PRIOK,SUNTER AGUNG,71805,21665,50140,37477,87617,2021-09-08
3172021002,JAKARTA UTARA,TANJUNG PRIOK,SUNTER JAYA,63031,19793,43238,32301,75539,2021-09-08
3175091004,JAKARTA TIMUR,CIRACAS,SUSUKAN,38257,12463,25794,16994,42788,2021-09-08
3173031001,JAKARTA BARAT,TAMAN SARI,TAMAN SARI,14348,4892,9456,7006,16462,2021-09-08
3173041001,JAKARTA BARAT,TAMBORA,TAMBORA,10204,3616,6588,4248,10836,2021-09-08
3173041004,JAKARTA BARAT,TAMBORA,TANAH SEREAL,26387,7816,18571,12671,31242,2021-09-08
3171081004,JAKARTA PUSAT,JOHAR BARU,TANAH TINGGI,37693,11330,26363,17189,43552,2021-09-08
3173031004,JAKARTA BARAT,TAMAN SARI,TANGKI,13324,4465,8859,6492,15351,2021-09-08
3174091005,JAKARTA SELATAN,JAGAKARSA,TANJUNG BARAT,39770,14061,25709,15059,40768,2021-09-08
3173021005,JAKARTA BARAT,GROGOL PETAMBURAN,TANJUNG DUREN SELATAN,25337,8736,16601,12015,28616,2021-09-08
3173021002,JAKARTA BARAT,GROGOL PETAMBURAN,TANJUNG DUREN UTARA,17010,5558,11452,8258,19710,2021-09-08
3172021001,JAKARTA UTARA,TANJUNG PRIOK,TANJUNG PRIOK,34588,11379,23209,15436,38645,2021-09-08
3174011002,JAKARTA SELATAN,TEBET,TEBET BARAT,21194,7021,14173,9435,23608,2021-09-08
3174011001,JAKARTA SELATAN,TEBET,TEBET TIMUR,18199,6037,12162,8109,20271,2021-09-08
3173061003,JAKARTA BARAT,KALI DERES,TEGAL ALUR,83647,29363,54284,34406,88690,2021-09-08
3174031004,JAKARTA SELATAN,MAMPANG PRAPATAN,TEGAL PARANG,32401,12678,19723,11487,31210,2021-09-08
3173021003,JAKARTA BARAT,GROGOL PETAMBURAN,TOMANG,29605,10117,19488,14414,33902,2021-09-08
3172031005,JAKARTA UTARA,KOJA,TUGU SELATAN,39122,14467,24655,16204,40859,2021-09-08
3172031002,JAKARTA UTARA,KOJA,TUGU UTARA,67670,25600,42070,27407,69477,2021-09-08
3175061006,JAKARTA TIMUR,CAKUNG,UJUNG MENTENG,29934,9653,20281,14478,34759,2021-09-08
3174101005,JAKARTA SELATAN,PESANGGRAHAN,ULUJAMI,40544,16180,24364,14137,38501,2021-09-08
3175011006,JAKARTA TIMUR,MATRAMAN,UTAN KAYU SELATAN,33511,11482,22029,14704,36733,2021-09-08
3175011002,JAKARTA TIMUR,MATRAMAN,UTAN KAYU UTARA,28169,10560,17609,11620,29229,2021-09-08
3171031008,JAKARTA PUSAT,KEMAYORAN,UTAN PANJANG,29208,10608,18600,12707,31307,2021-09-08
3172021007,JAKARTA UTARA,TANJUNG PRIOK,WARAKAS,44401,14551,29850,19530,49380,2021-09-08
3173021007,JAKARTA BARAT,GROGOL PETAMBURAN,WIJAYA KUSUMA,38934,14126,24808,17814,42622,2021-09-08
3172051003,JAKARTA UTARA,PADEMANGAN,ANCOL,23947,8928,15019,10610,25629,2021-09-09
3173041007,JAKARTA BARAT,TAMBORA,ANGKE,29381,10071,19310,11988,31298,2021-09-09
3175041005,JAKARTA TIMUR,KRAMAT JATI,BALE KAMBANG,29074,12022,17052,9882,26934,2021-09-09
3175031003,JAKARTA TIMUR,JATINEGARA,BALI MESTER,9752,3573,6179,4332,10511,2021-09-09
3175101006,JAKARTA TIMUR,CIPAYUNG,BAMBU APUS,26285,9008,17277,12264,29541,2021-09-09
3174031002,JAKARTA SELATAN,MAMPANG PRAPATAN,BANGKA,21566,8291,13275,8339,21614,2021-09-09
3175051002,JAKARTA TIMUR,PASAR REBO,BARU,23886,7390,16496,12414,28910,2021-09-09
3175041004,JAKARTA TIMUR,KRAMAT JATI,BATU AMPAR,47898,19081,28817,18542,47359,2021-09-09
3171071002,JAKARTA PUSAT,TANAH ABANG,BENDUNGAN HILIR,21494,7806,13688,9559,23247,2021-09-09
3175031002,JAKARTA TIMUR,JATINEGARA,BIDARA CINA,36689,14754,21935,14693,36628,2021-09-09
3174101002,JAKARTA SELATAN,PESANGGRAHAN,BINTARO,53098,19962,33136,21237,54373,2021-09-09
3174011005,JAKARTA SELATAN,TEBET,BUKIT DURI,34183,13242,20941,12426,33367,2021-09-09
3171041006,JAKARTA PUSAT,SENEN,BUNGUR,18144,6259,11885,8249,20134,2021-09-09
3175061007,JAKARTA TIMUR,CAKUNG,CAKUNG BARAT,57724,18940,38784,26221,65005,2021-09-09
3175061004,JAKARTA TIMUR,CAKUNG,CAKUNG TIMUR,58287,19143,39144,28523,67667,2021-09-09
3175041007,JAKARTA TIMUR,KRAMAT JATI,CAWANG,32762,12302,20460,13451,33911,2021-09-09
3175101008,JAKARTA TIMUR,CIPAYUNG,CEGER,18932,6415,12517,8919,21436,2021-09-09
3171031006,JAKARTA PUSAT,KEMAYORAN,CEMPAKA BARU,32581,11611,20970,13875,34845,2021-09-09
3171051002,JAKARTA PUSAT,CEMPAKA PUTIH,CEMPAKA PUTIH BARAT,35885,12888,22997,16962,39959,2021-09-09
3171051001,JAKARTA PUSAT,CEMPAKA PUTIH,CEMPAKA PUTIH TIMUR,24292,8389,15903,11431,27334,2021-09-09
3173011001,JAKARTA BARAT,CENGKARENG,CENGKARENG BARAT,66284,22753,43531,30559,74090,2021-09-09
3173011006,JAKARTA BARAT,CENGKARENG,CENGKARENG TIMUR,81027,27222,53805,34765,88570,2021-09-09
3175091002,JAKARTA TIMUR,CIRACAS,CIBUBUR,66364,21288,45076,31873,76949,2021-09-09
3171011002,JAKARTA PUSAT,GAMBIR,CIDENG,15390,5082,10308,7595,17903,2021-09-09
3174091003,JAKARTA SELATAN,JAGAKARSA,CIGANJUR,38497,13873,24624,14837,39461,2021-09-09
3175051003,JAKARTA TIMUR,PASAR REBO,CIJANTUNG,41419,13471,27948,20058,48006,2021-09-09
3171061003,JAKARTA PUSAT,MENTENG,CIKINI,8274,2851,5423,3581,9004,2021-09-09
3174081006,JAKARTA SELATAN,PANCORAN,CIKOKO,10547,3620,6927,4163,11090,2021-09-09
3174061001,JAKARTA SELATAN,CILANDAK,CILANDAK BARAT,51752,18577,33175,21186,54361,2021-09-09
3174041003,JAKARTA SELATAN,PASAR MINGGU,CILANDAK TIMUR,25145,8910,16235,10943,27178,2021-09-09
3175101002,JAKARTA TIMUR,CIPAYUNG,CILANGKAP,27635,9296,18339,13139,31478,2021-09-09
3175041006,JAKARTA TIMUR,KRAMAT JATI,CILILITAN,40181,15668,24513,16849,41362,2021-09-09
3172041001,JAKARTA UTARA,CILINCING,CILINCING,43609,16185,27424,17790,45214,2021-09-09
3175101001,JAKARTA TIMUR,CIPAYUNG,CIPAYUNG,26104,8084,18020,13330,31350,2021-09-09
3174091006,JAKARTA SELATAN,JAGAKARSA,CIPEDAK,38303,12831,25472,16054,41526,2021-09-09
3174061005,JAKARTA SELATAN,CILANDAK,CIPETE SELATAN,26704,10027,16677,11358,28035,2021-09-09
3174071010,JAKARTA SELATAN,KEBAYORAN BARU,CIPETE UTARA,34102,12482,21620,13593,35213,2021-09-09
3175021003,JAKARTA TIMUR,PULO GADUNG,CIPINANG,39306,13992,25314,17497,42811,2021-09-09
3175031007,JAKARTA TIMUR,JATINEGARA,CIPINANG BESAR SELATAN,35212,13613,21599,13811,35410,2021-09-09
3175031008,JAKARTA TIMUR,JATINEGARA,CIPINANG BESAR UTARA,45319,17493,27826,18327,46153,2021-09-09
3175031005,JAKARTA TIMUR,JATINEGARA,CIPINANG CEMPEDAK,32824,12821,20003,14506,34509,2021-09-09
3175081005,JAKARTA TIMUR,MAKASAR,CIPINANG MELAYU,42308,15487,26821,19297,46118,2021-09-09
3175031006,JAKARTA TIMUR,JATINEGARA,CIPINANG MUARA,55243,21147,34096,23318,57414,2021-09-09
3174051003,JAKARTA SELATAN,KEBAYORAN LAMA,CIPULIR,39937,15967,23970,13465,37435,2021-09-09
3175091001,JAKARTA TIMUR,CIRACAS,CIRACAS,64594,20580,44014,30371,74385,2021-09-09
3175041003,JAKARTA TIMUR,KRAMAT JATI,DUKUH,24609,8337,16272,11150,27422,2021-09-09
3175071001,JAKARTA TIMUR,DUREN SAWIT,DUREN SAWIT,61160,23181,37979,26322,64301,2021-09-09
3174081004,JAKARTA SELATAN,PANCORAN,DUREN TIGA,28319,10464,17855,9863,27718,2021-09-09
3173051005,JAKARTA BARAT,KEBON JERUK,DURI KEPA,60138,20057,40081,28510,68591,2021-09-09
3173011002,JAKARTA BARAT,CENGKARENG,DURI KOSAMBI,77923,29623,48300,30473,78773,2021-09-09
3171011006,JAKARTA PUSAT,GAMBIR,DURI PULO,19610,6829,12781,8516,21297,2021-09-09
3173041011,JAKARTA BARAT,TAMBORA,DURI SELATAN,14259,4484,9775,6911,16686,2021-09-09
3173041003,JAKARTA BARAT,TAMBORA,DURI UTARA,19844,6560,13284,9045,22329,2021-09-09
3171081003,JAKARTA PUSAT,JOHAR BARU,GALUR,18243,5557,12686,8490,21176,2021-09-09
3171011001,JAKARTA PUSAT,GAMBIR,GAMBIR,2191,726,1465,1098,2563,2021-09-09
3174061004,JAKARTA SELATAN,CILANDAK,GANDARIA SELATAN,22119,8229,13890,8468,22358,2021-09-09
3174071009,JAKARTA SELATAN,KEBAYORAN BARU,GANDARIA UTARA,39922,14969,24953,15756,40709,2021-09-09
3175051001,JAKARTA TIMUR,PASAR REBO,GEDONG,35755,12227,23528,16861,40389,2021-09-09
3171071001,JAKARTA PUSAT,TANAH ABANG,GELORA,3127,1168,1959,1307,3266,2021-09-09
3173031007,JAKARTA BARAT,TAMAN SARI,GLODOK,7837,2319,5518,4289,9807,2021-09-09
3171061004,JAKARTA PUSAT,MENTENG,GONDANGDIA,4100,1461,2639,2098,4737,2021-09-09
3173021001,JAKARTA BARAT,GROGOL PETAMBURAN,GROGOL,16876,5939,10937,7725,18662,2021-09-09
3174051005,JAKARTA SELATAN,KEBAYORAN LAMA,GROGOL SELATAN,44251,16913,27338,16049,43387,2021-09-09
3174051004,JAKARTA SELATAN,KEBAYORAN LAMA,GROGOL UTARA,42494,15990,26504,15864,42368,2021-09-09
3174021007,JAKARTA SELATAN,SETIA BUDI,GUNTUR,3985,1366,2619,1914,4533,2021-09-09
3174071002,JAKARTA SELATAN,KEBAYORAN BARU,GUNUNG,9436,3321,6115,4302,10417,2021-09-09
3171031005,JAKARTA PUSAT,KEMAYORAN,GUNUNG SAHARI SELATAN,19199,6762,12437,8914,21351,2021-09-09
3171021004,JAKARTA PUSAT,SAWAH BESAR,GUNUNG SAHARI UTARA,16650,5064,11586,8903,20489,2021-09-09
3175081004,JAKARTA TIMUR,MAKASAR,HALIM PERDANA KUSUMAH,28363,7683,20680,16642,37322,2021-09-09
3171031003,JAKARTA PUSAT,KEMAYORAN,HARAPAN MULIA,22557,7849,14708,10389,25097,2021-09-09
3174091001,JAKARTA SELATAN,JAGAKARSA,JAGAKARSA,62389,21777,40612,26239,66851,2021-09-09
3175021007,JAKARTA TIMUR,PULO GADUNG,JATI,32757,11389,21368,15404,36772,2021-09-09
3174041002,JAKARTA SELATAN,PASAR MINGGU,JATI PADANG,37502,13786,23716,15243,38959,2021-09-09
3173071004,JAKARTA BARAT,PALMERAH,JATI PULO,28738,9462,19276,12827,32103,2021-09-09
3175061001,JAKARTA TIMUR,CAKUNG,JATINEGARA,84160,30233,53927,38940,92867,2021-09-09
3175021004,JAKARTA TIMUR,PULO GADUNG,JATINEGARA KAUM,24632,8072,16560,10435,26995,2021-09-09
3173021004,JAKARTA BARAT,GROGOL PETAMBURAN,JELAMBAR,30266,10487,19779,14741,34520,2021-09-09
3173021006,JAKARTA BARAT,GROGOL PETAMBURAN,JELAMBAR BARU,38246,13011,25235,18569,43804,2021-09-09
3173041006,JAKARTA BARAT,TAMBORA,JEMBATAN BESI,29314,11510,17804,10867,28671,2021-09-09
3173041008,JAKARTA BARAT,TAMBORA,JEMBATAN LIMA,21021,7875,13146,8411,21557,2021-09-09
3173081005,JAKARTA BARAT,KEMBANGAN,JOGLO,40839,14375,26464,18094,44558,2021-09-09
3171081001,JAKARTA PUSAT,JOHAR BARU,JOHAR BARU,37488,11746,25742,18171,43913,2021-09-09
3173041002,JAKARTA BARAT,TAMBORA,KALI ANYAR,23856,7922,15934,10311,26245,2021-09-09
3172041004,JAKARTA UTARA,CILINCING,KALIBARU,67684,26675,41009,24707,65716,2021-09-09
3174081002,JAKARTA SELATAN,PANCORAN,KALIBATA,41994,17325,24669,13510,38179,2021-09-09
3173061001,JAKARTA BARAT,KALI DERES,KALIDERES,72447,25776,46671,34225,80896,2021-09-09
3175051004,JAKARTA TIMUR,PASAR REBO,KALISARI,43212,14342,28870,20993,49863,2021-09-09
3173061004,JAKARTA BARAT,KALI DERES,KAMAL,53783,19821,33962,21948,55910,2021-09-09
3172011002,JAKARTA UTARA,PENJARINGAN,KAMAL MUARA,12930,3402,9528,7205,16733,2021-09-09
3171071007,JAKARTA PUSAT,TANAH ABANG,KAMPUNG BALI,11358,4327,7031,4573,11604,2021-09-09
3175031001,JAKARTA TIMUR,JATINEGARA,KAMPUNG MELAYU,25717,10118,15599,10388,25987,2021-09-09
3171081002,JAKARTA PUSAT,JOHAR BARU,KAMPUNG RAWA,21237,5644,15593,10268,25861,2021-09-09
3175041002,JAKARTA TIMUR,KRAMAT JATI,KAMPUNG TENGAH,43993,17335,26658,17069,43727,2021-09-09
3173011005,JAKARTA BARAT,CENGKARENG,KAPUK,134466,50722,83744,52275,136019,2021-09-09
3172011003,JAKARTA UTARA,PENJARINGAN,KAPUK MUARA,35781,10850,24931,19465,44396,2021-09-09
3171021002,JAKARTA PUSAT,SAWAH BESAR,KARANG ANYAR,25761,8428,17333,12102,29435,2021-09-09
3174021004,JAKARTA SELATAN,SETIA BUDI,KARET,9623,3603,6020,3995,10015,2021-09-09
3174021003,JAKARTA SELATAN,SETIA BUDI,KARET KUNINGAN,16055,5337,10718,7135,17853,2021-09-09
3174021002,JAKARTA SELATAN,SETIA BUDI,KARET SEMANGGI,2770,942,1828,1394,3222,2021-09-09
3171071003,JAKARTA PUSAT,TANAH ABANG,KARET TENGSIN,19271,6692,12579,8359,20938,2021-09-09
3171021003,JAKARTA PUSAT,SAWAH BESAR,KARTINI,22292,7560,14732,10801,25533,2021-09-09
3175011003,JAKARTA TIMUR,MATRAMAN,KAYU MANIS,25284,9697,15587,10141,25728,2021-09-09
3175021006,JAKARTA TIMUR,PULO GADUNG,KAYU PUTIH,40696,13567,27129,20431,47560,2021-09-09
3173031006,JAKARTA BARAT,TAMAN SARI,KEAGUNGAN,17387,5804,11583,8255,19838,2021-09-09
3174041007,JAKARTA SELATAN,PASAR MINGGU,KEBAGUSAN,44552,17048,27504,16527,44031,2021-09-09
3174051006,JAKARTA SELATAN,KEBAYORAN LAMA,KEBAYORAN LAMA SELATAN,41212,14739,26473,15890,42363,2021-09-09
3174051001,JAKARTA SELATAN,KEBAYORAN LAMA,KEBAYORAN LAMA UTARA,42422,16533,25889,14416,40305,2021-09-09
3174011004,JAKARTA SELATAN,TEBET,KEBON BARU,35165,12872,22293,13673,35966,2021-09-09
3172021005,JAKARTA UTARA,TANJUNG PRIOK,KEBON BAWANG,50952,17780,33172,22583,55755,2021-09-09
3173051001,JAKARTA BARAT,KEBON JERUK,KEBON JERUK,53887,20086,33801,22765,56566,2021-09-09
3171071006,JAKARTA PUSAT,TANAH ABANG,KEBON KACANG,21531,8660,12871,8673,21544,2021-09-09
3171011005,JAKARTA PUSAT,GAMBIR,KEBON KELAPA,10163,3516,6647,4715,11362,2021-09-09
3171031002,JAKARTA PUSAT,KEMAYORAN,KEBON KOSONG,30019,10537,19482,13577,33059,2021-09-09
3175011005,JAKARTA TIMUR,MATRAMAN,KEBON MANGGIS,16490,5757,10733,7463,18196,2021-09-09
3171071005,JAKARTA PUSAT,TANAH ABANG,KEBON MELATI,32206,13600,18606,11744,30350,2021-09-09
3175081003,JAKARTA TIMUR,MAKASAR,KEBON PALA,46614,16462,30152,19993,50145,2021-09-09
3171061005,JAKARTA PUSAT,MENTENG,KEBON SIRIH,12299,4428,7871,5375,13246,2021-09-09
3173011004,JAKARTA BARAT,CENGKARENG,KEDAUNG KALI ANGKE,32612,10409,22203,15495,37698,2021-09-09
3173051007,JAKARTA BARAT,KEBON JERUK,KEDOYA SELATAN,32165,10811,21354,14483,35837,2021-09-09
3173051006,JAKARTA BARAT,KEBON JERUK,KEDOYA UTARA,45740,14595,31145,22742,53887,2021-09-09
3173051004,JAKARTA BARAT,KEBON JERUK,KELAPA DUA,23565,8670,14895,9917,24812,2021-09-09
3175091003,JAKARTA TIMUR,CIRACAS,KELAPA DUA WETAN,46875,14690,32185,22509,54694,2021-09-09
3172061003,JAKARTA UTARA,KELAPA GADING,KELAPA GADING BARAT,35717,10993,24724,19572,44296,2021-09-09
3172061001,JAKARTA UTARA,KELAPA GADING,KELAPA GADING TIMUR,33592,9413,24179,19145,43324,2021-09-09
3173071005,JAKARTA BARAT,PALMERAH,KEMANGGISAN,32139,11135,21004,14298,35302,2021-09-09
3171031001,JAKARTA PUSAT,KEMAYORAN,KEMAYORAN,20708,6946,13762,9839,23601,2021-09-09
3173081006,JAKARTA BARAT,KEMBANGAN,KEMBANGAN SELATAN,27130,9505,17625,13143,30768,2021-09-09
3173081001,JAKARTA BARAT,KEMBANGAN,KEMBANGAN UTARA,54451,18928,35523,24919,60442,2021-09-09
3171041002,JAKARTA PUSAT,SENEN,KENARI,9579,3252,6327,4710,11037,2021-09-09
3173041005,JAKARTA BARAT,TAMBORA,KERENDANG,19973,6823,13150,8835,21985,2021-09-09
3175071003,JAKARTA TIMUR,DUREN SAWIT,KLENDER,69978,27046,42932,28318,71250,2021-09-09
3172031001,JAKARTA UTARA,KOJA,KOJA,28175,10430,17745,12276,30021,2021-09-09
3173071006,JAKARTA BARAT,PALMERAH,KOTA BAMBU SELATAN,21158,7502,13656,8852,22508,2021-09-09
3173071003,JAKARTA BARAT,PALMERAH,KOTA BAMBU UTARA,24995,9047,15948,10299,26247,2021-09-09
3171041004,JAKARTA PUSAT,SENEN,KRAMAT,28835,10621,18214,11300,29514,2021-09-09
3175041001,JAKARTA TIMUR,KRAMAT JATI,KRAMAT JATI,34144,12213,21931,14481,36412,2021-09-09
3174071003,JAKARTA SELATAN,KEBAYORAN BARU,KRAMAT PELA,14413,5004,9409,6039,15448,2021-09-09
3173031002,JAKARTA BARAT,TAMAN SARI,KRUKUT,19244,6536,12708,8684,21392,2021-09-09
3174031005,JAKARTA SELATAN,MAMPANG PRAPATAN,KUNINGAN BARAT,12785,4469,8316,5213,13529,2021-09-09
3174021008,JAKARTA SELATAN,SETIA BUDI,KUNINGAN TIMUR,6008,2135,3873,2596,6469,2021-09-09
3171041005,JAKARTA PUSAT,SENEN,KWITANG,15486,5489,9997,6833,16830,2021-09-09
3172031003,JAKARTA UTARA,KOJA,LAGOA,59065,22157,36908,24114,61022,2021-09-09
3174061002,JAKARTA SELATAN,CILANDAK,LEBAK BULUS,37626,14273,23353,15001,38354,2021-09-09
3174091004,JAKARTA SELATAN,JAGAKARSA,LENTENG AGUNG,53946,20472,33474,19205,52679,2021-09-09
3175101007,JAKARTA TIMUR,CIPAYUNG,LUBANG BUAYA,63547,20767,42780,29961,72741,2021-09-09
3175081001,JAKARTA TIMUR,MAKASAR,MAKASAR,34390,11645,22745,16247,38992,2021-09-09
3175071006,JAKARTA TIMUR,DUREN SAWIT,MALAKA JAYA,30927,10896,20031,14702,34733,2021-09-09
3175071005,JAKARTA TIMUR,DUREN SAWIT,MALAKA SARI,27530,9354,18176,13542,31718,2021-09-09
3174031001,JAKARTA SELATAN,MAMPANG PRAPATAN,MAMPANG PRAPATAN,18159,6657,11502,7384,18886,2021-09-09
3173031005,JAKARTA BARAT,TAMAN SARI,MANGGA BESAR,7707,2303,5404,4012,9416,2021-09-09
3171021005,JAKARTA PUSAT,SAWAH BESAR,MANGGA DUA SELATAN,27442,9227,18215,13082,31297,2021-09-09
3174011007,JAKARTA SELATAN,TEBET,MANGGARAI,28373,9507,18866,11176,30042,2021-09-09
3174011006,JAKARTA SELATAN,TEBET,MANGGARAI SELATAN,23075,7998,15077,9539,24616,2021-09-09
3173031003,JAKARTA BARAT,TAMAN SARI,MAPHAR,16461,5694,10767,7727,18494,2021-09-09
3172041003,JAKARTA UTARA,CILINCING,MARUNDA,28943,9669,19274,10959,30233,2021-09-09
3174071001,JAKARTA SELATAN,KEBAYORAN BARU,MELAWAI,2627,893,1734,1375,3109,2021-09-09
3171061001,JAKARTA PUSAT,MENTENG,MENTENG,25624,9567,16057,11094,27151,2021-09-09
3174021005,JAKARTA SELATAN,SETIA BUDI,MENTENG ATAS,27816,9472,18344,11337,29681,2021-09-09
3174011003,JAKARTA SELATAN,TEBET,MENTENG DALAM,36028,13094,22934,14515,37449,2021-09-09
3173081003,JAKARTA BARAT,KEMBANGAN,MERUYA SELATAN,32130,11275,20855,14868,35723,2021-09-09
3173081002,JAKARTA BARAT,KEMBANGAN,MERUYA UTARA,43752,15592,28160,21005,49165,2021-09-09
3175101004,JAKARTA TIMUR,CIPAYUNG,MUNJUL,23871,7898,15973,11688,27661,2021-09-09
3172051002,JAKARTA UTARA,PADEMANGAN,PADEMANGAN BARAT,74240,27103,47137,31955,79092,2021-09-09
3172051001,JAKARTA UTARA,PADEMANGAN,PADEMANGAN TIMUR,37736,11488,26248,19391,45639,2021-09-09
3175011004,JAKARTA TIMUR,MATRAMAN,PAL MERIAM,19769,7473,12296,8426,20722,2021-09-09
3173071001,JAKARTA BARAT,PALMERAH,PALMERAH,63011,22737,40274,26390,66664,2021-09-09
3174081001,JAKARTA SELATAN,PANCORAN,PANCORAN,19421,7194,12227,7473,19700,2021-09-09
3172021003,JAKARTA UTARA,TANJUNG PRIOK,PAPANGGO,39097,12730,26367,18232,44599,2021-09-09
3171021001,JAKARTA PUSAT,SAWAH BESAR,PASAR BARU,12035,3695,8340,6414,14754,2021-09-09
3174021006,JAKARTA SELATAN,SETIA BUDI,PASAR MANGGIS,26752,9737,17015,10587,27602,2021-09-09
3174041001,JAKARTA SELATAN,PASAR MINGGU,PASAR MINGGU,24821,9035,15786,10335,26121,2021-09-09
3171041003,JAKARTA PUSAT,SENEN,PASEBAN,23533,8519,15014,10149,25163,2021-09-09
3173061005,JAKARTA BARAT,KALI DERES,PEGADUNGAN,75587,25024,50563,37497,88060,2021-09-09
3171061002,JAKARTA PUSAT,MENTENG,PEGANGSAAN,23455,8536,14919,9717,24636,2021-09-09
3172061002,JAKARTA UTARA,KELAPA GADING,PEGANGSAAN DUA,49976,13991,35985,28012,63997,2021-09-09
3172011004,JAKARTA UTARA,PENJARINGAN,PEJAGALAN,74578,25760,48818,35750,84568,2021-09-09
3174041006,JAKARTA SELATAN,PASAR MINGGU,PEJATEN BARAT,37346,14014,23332,14828,38160,2021-09-09
3174041005,JAKARTA SELATAN,PASAR MINGGU,PEJATEN TIMUR,57656,22511,35145,20110,55255,2021-09-09
3175051005,JAKARTA TIMUR,PASAR REBO,PEKAYON,43250,14214,29036,20403,49439,2021-09-09
3173041009,JAKARTA BARAT,TAMBORA,PEKOJAN,23587,7639,15948,11379,27327,2021-09-09
3174031003,JAKARTA SELATAN,MAMPANG PRAPATAN,PELA MAMPANG,43522,15728,27794,18318,46112,2021-09-09
3174081005,JAKARTA SELATAN,PANCORAN,PENGADEGAN,21478,7165,14313,7950,22263,2021-09-09
3175061003,JAKARTA TIMUR,CAKUNG,PENGGILINGAN,99255,38263,60992,40587,101579,2021-09-09
3172011001,JAKARTA UTARA,PENJARINGAN,PENJARINGAN,88308,33600,54708,36336,91044,2021-09-09
3174101001,JAKARTA SELATAN,PESANGGRAHAN,PESANGGRAHAN,27545,9432,18113,11442,29555,2021-09-09
3171071004,JAKARTA PUSAT,TANAH ABANG,PETAMBURAN,33271,14304,18967,12179,31146,2021-09-09
3174071008,JAKARTA SELATAN,KEBAYORAN BARU,PETOGOGAN,11499,4275,7224,4767,11991,2021-09-09
3171011004,JAKARTA PUSAT,GAMBIR,PETOJO SELATAN,14692,5360,9332,6632,15964,2021-09-09
3171011003,JAKARTA PUSAT,GAMBIR,PETOJO UTARA,17458,6225,11233,7735,18968,2021-09-09
3174101004,JAKARTA SELATAN,PESANGGRAHAN,PETUKANGAN SELATAN,37187,13676,23511,14329,37840,2021-09-09
3174101003,JAKARTA SELATAN,PESANGGRAHAN,PETUKANGAN UTARA,53716,20905,32811,20272,53083,2021-09-09
3175081002,JAKARTA TIMUR,MAKASAR,PINANG RANTI,27198,9671,17527,12188,29715,2021-09-09
3173031008,JAKARTA BARAT,TAMAN SARI,PINANGSIA,10729,3316,7413,5308,12721,2021-09-09
3175011001,JAKARTA TIMUR,MATRAMAN,PISANGAN BARU,31776,11937,19839,12728,32567,2021-09-09
3175021002,JAKARTA TIMUR,PULO GADUNG,PISANGAN TIMUR,41011,13793,27218,19475,46693,2021-09-09
3172011005,JAKARTA UTARA,PENJARINGAN,PLUIT,47783,15426,32357,24811,57168,2021-09-09
3175071002,JAKARTA TIMUR,DUREN SAWIT,PONDOK BAMBU,61550,23070,38480,26354,64834,2021-09-09
3175071004,JAKARTA TIMUR,DUREN SAWIT,PONDOK KELAPA,72015,25656,46359,31458,77817,2021-09-09
3175071007,JAKARTA TIMUR,DUREN SAWIT,PONDOK KOPI,35367,13868,21499,13431,34930,2021-09-09
3174061003,JAKARTA SELATAN,CILANDAK,PONDOK LABU,46464,16083,30381,20525,50906,2021-09-09
3174051002,JAKARTA SELATAN,KEBAYORAN LAMA,PONDOK PINANG,56169,20861,35308,22437,57745,2021-09-09
3175101003,JAKARTA TIMUR,CIPAYUNG,PONDOK RANGGON,25574,8672,16902,12265,29167,2021-09-09
3101011003,KAB.ADM.KEP.SERIBU,KEP. SERIBU UTARA,PULAU HARAPAN,2060,335,1725,1043,2768,2021-09-09
3101011002,KAB.ADM.KEP.SERIBU,KEP. SERIBU UTARA,PULAU KELAPA,5528,885,4643,2668,7311,2021-09-09
3101011001,KAB.ADM.KEP.SERIBU,KEP. SERIBU UTARA,PULAU PANGGANG,5450,828,4622,2212,6834,2021-09-09
3101021003,KAB.ADM.KEP.SERIBU,KEP. SERIBU SELATAN,PULAU PARI,2765,317,2448,1508,3956,2021-09-09
3101021002,KAB.ADM.KEP.SERIBU,KEP. SERIBU SELATAN,PULAU TIDUNG,4553,604,3949,2721,6670,2021-09-09
3101021001,KAB.ADM.KEP.SERIBU,KEP. SERIBU SELATAN,PULAU UNTUNG JAWA,1941,312,1629,1049,2678,2021-09-09
3174071007,JAKARTA SELATAN,KEBAYORAN BARU,PULO,5835,1956,3879,2860,6739,2021-09-09
3175021001,JAKARTA TIMUR,PULO GADUNG,PULO GADUNG,34422,12181,22241,15346,37587,2021-09-09
3175061005,JAKARTA TIMUR,CAKUNG,PULO GEBANG,97301,34391,62910,41940,104850,2021-09-09
3174041004,JAKARTA SELATAN,PASAR MINGGU,RAGUNAN,39616,13919,25697,16525,42222,2021-09-09
3175091005,JAKARTA TIMUR,CIRACAS,RAMBUTAN,36771,14181,22590,15275,37865,2021-09-09
3172031006,JAKARTA UTARA,KOJA,RAWA BADAK SELATAN,42179,15945,26234,17036,43270,2021-09-09
3172031004,JAKARTA UTARA,KOJA,RAWA BADAK UTARA,34408,12703,21705,14569,36274,2021-09-09
3174071005,JAKARTA SELATAN,KEBAYORAN BARU,RAWA BARAT,5625,1871,3754,2604,6358,2021-09-09
3173011003,JAKARTA BARAT,CENGKARENG,RAWA BUAYA,63799,22632,41167,26139,67306,2021-09-09
3175031004,JAKARTA TIMUR,JATINEGARA,RAWA BUNGA,21434,8279,13155,9066,22221,2021-09-09
3174081003,JAKARTA SELATAN,PANCORAN,RAWA JATI,20509,7352,13157,7926,21083,2021-09-09
3175061002,JAKARTA TIMUR,CAKUNG,RAWA TERATE,24637,7764,16873,12406,29279,2021-09-09
3175021005,JAKARTA TIMUR,PULO GADUNG,RAWAMANGUN,37612,13346,24266,17287,41553,2021-09-09
3171051003,JAKARTA PUSAT,CEMPAKA PUTIH,RAWASARI,21967,7883,14084,10228,24312,2021-09-09
3173041010,JAKARTA BARAT,TAMBORA,ROA MALAKA,3484,1024,2460,1847,4307,2021-09-09
3172041006,JAKARTA UTARA,CILINCING,ROROTAN,41668,13589,28079,18344,46423,2021-09-09
3174071004,JAKARTA SELATAN,KEBAYORAN BARU,SELONG,2842,971,1871,1421,3292,2021-09-09
3173061002,JAKARTA BARAT,KALI DERES,SEMANAN,71354,26415,44939,29143,74082,2021-09-09
3172041007,JAKARTA UTARA,CILINCING,SEMPER BARAT,68587,22227,46360,32654,79014,2021-09-09
3172041005,JAKARTA UTARA,CILINCING,SEMPER TIMUR,36267,12288,23979,16099,40078,2021-09-09
3174071006,JAKARTA SELATAN,KEBAYORAN BARU,SENAYAN,2771,1115,1656,1126,2782,2021-09-09
3171041001,JAKARTA PUSAT,SENEN,SENEN,6804,2265,4539,3289,7828,2021-09-09
3171031004,JAKARTA PUSAT,KEMAYORAN,SERDANG,29668,10340,19328,13489,32817,2021-09-09
3174021001,JAKARTA SELATAN,SETIA BUDI,SETIA BUDI,3023,1105,1918,1309,3227,2021-09-09
3175101005,JAKARTA TIMUR,CIPAYUNG,SETU,20572,7520,13052,8880,21932,2021-09-09
3173071002,JAKARTA BARAT,PALMERAH,SLIPI,16591,5529,11062,7765,18827,2021-09-09
3173081004,JAKARTA BARAT,KEMBANGAN,SRENGSENG,45523,16863,28660,19478,48138,2021-09-09
3174091002,JAKARTA SELATAN,JAGAKARSA,SRENGSENG SAWAH,58196,18844,39352,24636,63988,2021-09-09
3173051003,JAKARTA BARAT,KEBON JERUK,SUKABUMI SELATAN,37033,13703,23330,13454,36784,2021-09-09
3173051002,JAKARTA BARAT,KEBON JERUK,SUKABUMI UTARA,38290,14731,23559,13659,37218,2021-09-09
3172041002,JAKARTA UTARA,CILINCING,SUKAPURA,53949,19370,34579,24256,58835,2021-09-09
3171031007,JAKARTA PUSAT,KEMAYORAN,SUMUR BATU,22717,8073,14644,10459,25103,2021-09-09
3172021004,JAKARTA UTARA,TANJUNG PRIOK,SUNGAI BAMBU,29876,10238,19638,13721,33359,2021-09-09
3172021006,JAKARTA UTARA,TANJUNG PRIOK,SUNTER AGUNG,71805,21552,50253,38042,88295,2021-09-09
3172021002,JAKARTA UTARA,TANJUNG PRIOK,SUNTER JAYA,63031,19660,43371,33147,76518,2021-09-09
3175091004,JAKARTA TIMUR,CIRACAS,SUSUKAN,38257,12379,25878,17452,43330,2021-09-09
3173031001,JAKARTA BARAT,TAMAN SARI,TAMAN SARI,14348,4868,9480,7130,16610,2021-09-09
3173041001,JAKARTA BARAT,TAMBORA,TAMBORA,10204,3599,6605,4335,10940,2021-09-09
3173041004,JAKARTA BARAT,TAMBORA,TANAH SEREAL,26387,7790,18597,12804,31401,2021-09-09
3171081004,JAKARTA PUSAT,JOHAR BARU,TANAH TINGGI,37693,11299,26394,17489,43883,2021-09-09
3173031004,JAKARTA BARAT,TAMAN SARI,TANGKI,13324,4450,8874,6565,15439,2021-09-09
3174091005,JAKARTA SELATAN,JAGAKARSA,TANJUNG BARAT,39770,14041,25729,15141,40870,2021-09-09
3173021005,JAKARTA BARAT,GROGOL PETAMBURAN,TANJUNG DUREN SELATAN,25337,8711,16626,12165,28791,2021-09-09
3173021002,JAKARTA BARAT,GROGOL PETAMBURAN,TANJUNG DUREN UTARA,17010,5534,11476,8370,19846,2021-09-09
3172021001,JAKARTA UTARA,TANJUNG PRIOK,TANJUNG PRIOK,34588,11330,23258,15749,39007,2021-09-09
3174011002,JAKARTA SELATAN,TEBET,TEBET BARAT,21194,7014,14180,9477,23657,2021-09-09
3174011001,JAKARTA SELATAN,TEBET,TEBET TIMUR,18199,6029,12170,8142,20312,2021-09-09
3173061003,JAKARTA BARAT,KALI DERES,TEGAL ALUR,83647,29235,54412,35368,89780,2021-09-09
3174031004,JAKARTA SELATAN,MAMPANG PRAPATAN,TEGAL PARANG,32401,12677,19724,11522,31246,2021-09-09
3173021003,JAKARTA BARAT,GROGOL PETAMBURAN,TOMANG,29605,10076,19529,14637,34166,2021-09-09
3172031005,JAKARTA UTARA,KOJA,TUGU SELATAN,39122,14407,24715,16511,41226,2021-09-09
3172031002,JAKARTA UTARA,KOJA,TUGU UTARA,67670,25464,42206,28004,70210,2021-09-09
3175061006,JAKARTA TIMUR,CAKUNG,UJUNG MENTENG,29934,9607,20327,14693,35020,2021-09-09
3174101005,JAKARTA SELATAN,PESANGGRAHAN,ULUJAMI,40544,16164,24380,14179,38559,2021-09-09
3175011006,JAKARTA TIMUR,MATRAMAN,UTAN KAYU SELATAN,33511,11413,22098,15029,37127,2021-09-09
3175011002,JAKARTA TIMUR,MATRAMAN,UTAN KAYU UTARA,28169,10497,17672,11888,29560,2021-09-09
3171031008,JAKARTA PUSAT,KEMAYORAN,UTAN PANJANG,29208,10487,18721,12868,31589,2021-09-09
3172021007,JAKARTA UTARA,TANJUNG PRIOK,WARAKAS,44401,14478,29923,19936,49859,2021-09-09
3173021007,JAKARTA BARAT,GROGOL PETAMBURAN,WIJAYA KUSUMA,38934,14072,24862,18004,42866,2021-09-09
3172051003,JAKARTA UTARA,PADEMANGAN,ANCOL,23947,8879,15068,10780,25848,2021-09-10
3173041007,JAKARTA BARAT,TAMBORA,ANGKE,29381,10034,19347,12231,31578,2021-09-10
3175041005,JAKARTA TIMUR,KRAMAT JATI,BALE KAMBANG,29074,11928,17146,10227,27373,2021-09-10
3175031003,JAKARTA TIMUR,JATINEGARA,BALI MESTER,9752,3561,6191,4422,10613,2021-09-10
3175101006,JAKARTA TIMUR,CIPAYUNG,BAMBU APUS,26285,8946,17339,12437,29776,2021-09-10
3174031002,JAKARTA SELATAN,MAMPANG PRAPATAN,BANGKA,21566,8283,13283,8366,21649,2021-09-10
3175051002,JAKARTA TIMUR,PASAR REBO,BARU,23886,7347,16539,12577,29116,2021-09-10
3175041004,JAKARTA TIMUR,KRAMAT JATI,BATU AMPAR,47898,19001,28897,18939,47836,2021-09-10
3171071002,JAKARTA PUSAT,TANAH ABANG,BENDUNGAN HILIR,21494,7765,13729,9688,23417,2021-09-10
3175031002,JAKARTA TIMUR,JATINEGARA,BIDARA CINA,36689,14669,22020,14912,36932,2021-09-10
3174101002,JAKARTA SELATAN,PESANGGRAHAN,BINTARO,53098,19953,33145,21330,54475,2021-09-10
3174011005,JAKARTA SELATAN,TEBET,BUKIT DURI,34183,13203,20980,12489,33469,2021-09-10
3171041006,JAKARTA PUSAT,SENEN,BUNGUR,18144,6222,11922,8364,20286,2021-09-10
3175061007,JAKARTA TIMUR,CAKUNG,CAKUNG BARAT,57724,18844,38880,26746,65626,2021-09-10
3175061004,JAKARTA TIMUR,CAKUNG,CAKUNG TIMUR,58287,19085,39202,28774,67976,2021-09-10
3175041007,JAKARTA TIMUR,KRAMAT JATI,CAWANG,32762,12228,20534,13650,34184,2021-09-10
3175101008,JAKARTA TIMUR,CIPAYUNG,CEGER,18932,6393,12539,9034,21573,2021-09-10
3171031006,JAKARTA PUSAT,KEMAYORAN,CEMPAKA BARU,32581,11526,21055,14231,35286,2021-09-10
3171051002,JAKARTA PUSAT,CEMPAKA PUTIH,CEMPAKA PUTIH BARAT,35885,12810,23075,17187,40262,2021-09-10
3171051001,JAKARTA PUSAT,CEMPAKA PUTIH,CEMPAKA PUTIH TIMUR,24292,8336,15956,11749,27705,2021-09-10
3173011001,JAKARTA BARAT,CENGKARENG,CENGKARENG BARAT,66284,22690,43594,31442,75036,2021-09-10
3173011006,JAKARTA BARAT,CENGKARENG,CENGKARENG TIMUR,81027,27088,53939,36174,90113,2021-09-10
3175091002,JAKARTA TIMUR,CIRACAS,CIBUBUR,66364,21134,45230,32445,77675,2021-09-10
3171011002,JAKARTA PUSAT,GAMBIR,CIDENG,15390,5061,10329,7700,18029,2021-09-10
3174091003,JAKARTA SELATAN,JAGAKARSA,CIGANJUR,38497,13863,24634,14898,39532,2021-09-10
3175051003,JAKARTA TIMUR,PASAR REBO,CIJANTUNG,41419,13384,28035,20378,48413,2021-09-10
3171061003,JAKARTA PUSAT,MENTENG,CIKINI,8274,2800,5474,3673,9147,2021-09-10
3174081006,JAKARTA SELATAN,PANCORAN,CIKOKO,10547,3615,6932,4185,11117,2021-09-10
3174061001,JAKARTA SELATAN,CILANDAK,CILANDAK BARAT,51752,18567,33185,21275,54460,2021-09-10
3174041003,JAKARTA SELATAN,PASAR MINGGU,CILANDAK TIMUR,25145,8905,16240,10974,27214,2021-09-10
3175101002,JAKARTA TIMUR,CIPAYUNG,CILANGKAP,27635,9244,18391,13323,31714,2021-09-10
3175041006,JAKARTA TIMUR,KRAMAT JATI,CILILITAN,40181,15544,24637,17207,41844,2021-09-10
3172041001,JAKARTA UTARA,CILINCING,CILINCING,43609,16114,27495,18107,45602,2021-09-10
3175101001,JAKARTA TIMUR,CIPAYUNG,CIPAYUNG,26104,8039,18065,13626,31691,2021-09-10
3174091006,JAKARTA SELATAN,JAGAKARSA,CIPEDAK,38303,12816,25487,16100,41587,2021-09-10
3174061005,JAKARTA SELATAN,CILANDAK,CIPETE SELATAN,26704,10017,16687,11395,28082,2021-09-10
3174071010,JAKARTA SELATAN,KEBAYORAN BARU,CIPETE UTARA,34102,12476,21626,13627,35253,2021-09-10
3175021003,JAKARTA TIMUR,PULO GADUNG,CIPINANG,39306,13889,25417,17803,43220,2021-09-10
3175031007,JAKARTA TIMUR,JATINEGARA,CIPINANG BESAR SELATAN,35212,13549,21663,14103,35766,2021-09-10
3175031008,JAKARTA TIMUR,JATINEGARA,CIPINANG BESAR UTARA,45319,17360,27959,18730,46689,2021-09-10
3175031005,JAKARTA TIMUR,JATINEGARA,CIPINANG CEMPEDAK,32824,12752,20072,14682,34754,2021-09-10
3175081005,JAKARTA TIMUR,MAKASAR,CIPINANG MELAYU,42308,15435,26873,19528,46401,2021-09-10
3175031006,JAKARTA TIMUR,JATINEGARA,CIPINANG MUARA,55243,21020,34223,23697,57920,2021-09-10
3174051003,JAKARTA SELATAN,KEBAYORAN LAMA,CIPULIR,39937,15948,23989,13550,37539,2021-09-10
3175091001,JAKARTA TIMUR,CIRACAS,CIRACAS,64594,20403,44191,31022,75213,2021-09-10
3175041003,JAKARTA TIMUR,KRAMAT JATI,DUKUH,24609,8265,16344,11230,27574,2021-09-10
3175071001,JAKARTA TIMUR,DUREN SAWIT,DUREN SAWIT,61160,23039,38121,26780,64901,2021-09-10
3174081004,JAKARTA SELATAN,PANCORAN,DUREN TIGA,28319,10453,17866,9929,27795,2021-09-10
3173051005,JAKARTA BARAT,KEBON JERUK,DURI KEPA,60138,19956,40182,29114,69296,2021-09-10
3173011002,JAKARTA BARAT,CENGKARENG,DURI KOSAMBI,77923,29497,48426,31444,79870,2021-09-10
3171011006,JAKARTA PUSAT,GAMBIR,DURI PULO,19610,6796,12814,8684,21498,2021-09-10
3173041011,JAKARTA BARAT,TAMBORA,DURI SELATAN,14259,4460,9799,7004,16803,2021-09-10
3173041003,JAKARTA BARAT,TAMBORA,DURI UTARA,19844,6537,13307,9150,22457,2021-09-10
3171081003,JAKARTA PUSAT,JOHAR BARU,GALUR,18243,5528,12715,8636,21351,2021-09-10
3171011001,JAKARTA PUSAT,GAMBIR,GAMBIR,2191,724,1467,1114,2581,2021-09-10
3174061004,JAKARTA SELATAN,CILANDAK,GANDARIA SELATAN,22119,8226,13893,8493,22386,2021-09-10
3174071009,JAKARTA SELATAN,KEBAYORAN BARU,GANDARIA UTARA,39922,14949,24973,15821,40794,2021-09-10
3175051001,JAKARTA TIMUR,PASAR REBO,GEDONG,35755,12150,23605,17140,40745,2021-09-10
3171071001,JAKARTA PUSAT,TANAH ABANG,GELORA,3127,1165,1962,1317,3279,2021-09-10
3173031007,JAKARTA BARAT,TAMAN SARI,GLODOK,7837,2305,5532,4349,9881,2021-09-10
3171061004,JAKARTA PUSAT,MENTENG,GONDANGDIA,4100,1455,2645,2119,4764,2021-09-10
3173021001,JAKARTA BARAT,GROGOL PETAMBURAN,GROGOL,16876,5910,10966,7845,18811,2021-09-10
3174051005,JAKARTA SELATAN,KEBAYORAN LAMA,GROGOL SELATAN,44251,16899,27352,16118,43470,2021-09-10
3174051004,JAKARTA SELATAN,KEBAYORAN LAMA,GROGOL UTARA,42494,15958,26536,15992,42528,2021-09-10
3174021007,JAKARTA SELATAN,SETIA BUDI,GUNTUR,3985,1364,2621,1924,4545,2021-09-10
3174071002,JAKARTA SELATAN,KEBAYORAN BARU,GUNUNG,9436,3320,6116,4316,10432,2021-09-10
3171031005,JAKARTA PUSAT,KEMAYORAN,GUNUNG SAHARI SELATAN,19199,6710,12489,9163,21652,2021-09-10
3171021004,JAKARTA PUSAT,SAWAH BESAR,GUNUNG SAHARI UTARA,16650,5028,11622,9052,20674,2021-09-10
3175081004,JAKARTA TIMUR,MAKASAR,HALIM PERDANA KUSUMAH,28363,7649,20714,16854,37568,2021-09-10
3171031003,JAKARTA PUSAT,KEMAYORAN,HARAPAN MULIA,22557,7798,14759,10615,25374,2021-09-10
3174091001,JAKARTA SELATAN,JAGAKARSA,JAGAKARSA,62389,21749,40640,26318,66958,2021-09-10
3175021007,JAKARTA TIMUR,PULO GADUNG,JATI,32757,11295,21462,15678,37140,2021-09-10
3174041002,JAKARTA SELATAN,PASAR MINGGU,JATI PADANG,37502,13775,23727,15303,39030,2021-09-10
3173071004,JAKARTA BARAT,PALMERAH,JATI PULO,28738,9412,19326,13110,32436,2021-09-10
3175061001,JAKARTA TIMUR,CAKUNG,JATINEGARA,84160,29861,54299,39675,93974,2021-09-10
3175021004,JAKARTA TIMUR,PULO GADUNG,JATINEGARA KAUM,24632,8004,16628,10640,27268,2021-09-10
3173021004,JAKARTA BARAT,GROGOL PETAMBURAN,JELAMBAR,30266,10438,19828,14936,34764,2021-09-10
3173021006,JAKARTA BARAT,GROGOL PETAMBURAN,JELAMBAR BARU,38246,12972,25274,18868,44142,2021-09-10
3173041006,JAKARTA BARAT,TAMBORA,JEMBATAN BESI,29314,11469,17845,11056,28901,2021-09-10
3173041008,JAKARTA BARAT,TAMBORA,JEMBATAN LIMA,21021,7838,13183,8555,21738,2021-09-10
3173081005,JAKARTA BARAT,KEMBANGAN,JOGLO,40839,14303,26536,18512,45048,2021-09-10
3171081001,JAKARTA PUSAT,JOHAR BARU,JOHAR BARU,37488,11665,25823,18496,44319,2021-09-10
3173041002,JAKARTA BARAT,TAMBORA,KALI ANYAR,23856,7894,15962,10570,26532,2021-09-10
3172041004,JAKARTA UTARA,CILINCING,KALIBARU,67684,26561,41123,25162,66285,2021-09-10
3174081002,JAKARTA SELATAN,PANCORAN,KALIBATA,41994,17309,24685,13590,38275,2021-09-10
3173061001,JAKARTA BARAT,KALI DERES,KALIDERES,72447,25685,46762,34749,81511,2021-09-10
3175051004,JAKARTA TIMUR,PASAR REBO,KALISARI,43212,14251,28961,21326,50287,2021-09-10
3173061004,JAKARTA BARAT,KALI DERES,KAMAL,53783,19728,34055,22738,56793,2021-09-10
3172011002,JAKARTA UTARA,PENJARINGAN,KAMAL MUARA,12930,3388,9542,7267,16809,2021-09-10
3171071007,JAKARTA PUSAT,TANAH ABANG,KAMPUNG BALI,11358,4300,7058,4638,11696,2021-09-10
3175031001,JAKARTA TIMUR,JATINEGARA,KAMPUNG MELAYU,25717,10043,15674,10548,26222,2021-09-10
3171081002,JAKARTA PUSAT,JOHAR BARU,KAMPUNG RAWA,21237,5613,15624,10499,26123,2021-09-10
3175041002,JAKARTA TIMUR,KRAMAT JATI,KAMPUNG TENGAH,43993,17240,26753,17318,44071,2021-09-10
3173011005,JAKARTA BARAT,CENGKARENG,KAPUK,134466,50512,83954,53478,137432,2021-09-10
3172011003,JAKARTA UTARA,PENJARINGAN,KAPUK MUARA,35781,10799,24982,19826,44808,2021-09-10
3171021002,JAKARTA PUSAT,SAWAH BESAR,KARANG ANYAR,25761,8369,17392,12317,29709,2021-09-10
3174021004,JAKARTA SELATAN,SETIA BUDI,KARET,9623,3596,6027,4017,10044,2021-09-10
3174021003,JAKARTA SELATAN,SETIA BUDI,KARET KUNINGAN,16055,5328,10727,7172,17899,2021-09-10
3174021002,JAKARTA SELATAN,SETIA BUDI,KARET SEMANGGI,2770,940,1830,1401,3231,2021-09-10
3171071003,JAKARTA PUSAT,TANAH ABANG,KARET TENGSIN,19271,6599,12672,8517,21189,2021-09-10
3171021003,JAKARTA PUSAT,SAWAH BESAR,KARTINI,22292,7503,14789,11004,25793,2021-09-10
3175011003,JAKARTA TIMUR,MATRAMAN,KAYU MANIS,25284,9634,15650,10329,25979,2021-09-10
3175021006,JAKARTA TIMUR,PULO GADUNG,KAYU PUTIH,40696,13487,27209,20706,47915,2021-09-10
3173031006,JAKARTA BARAT,TAMAN SARI,KEAGUNGAN,17387,5779,11608,8384,19992,2021-09-10
3174041007,JAKARTA SELATAN,PASAR MINGGU,KEBAGUSAN,44552,17037,27515,16580,44095,2021-09-10
3174051006,JAKARTA SELATAN,KEBAYORAN LAMA,KEBAYORAN LAMA SELATAN,41212,14723,26489,15958,42447,2021-09-10
3174051001,JAKARTA SELATAN,KEBAYORAN LAMA,KEBAYORAN LAMA UTARA,42422,16515,25907,14504,40411,2021-09-10
3174011004,JAKARTA SELATAN,TEBET,KEBON BARU,35165,12852,22313,13758,36071,2021-09-10
3172021005,JAKARTA UTARA,TANJUNG PRIOK,KEBON BAWANG,50952,17696,33256,23095,56351,2021-09-10
3173051001,JAKARTA BARAT,KEBON JERUK,KEBON JERUK,53887,19978,33909,23127,57036,2021-09-10
3171071006,JAKARTA PUSAT,TANAH ABANG,KEBON KACANG,21531,8508,13023,8815,21838,2021-09-10
3171011005,JAKARTA PUSAT,GAMBIR,KEBON KELAPA,10163,3507,6656,4797,11453,2021-09-10
3171031002,JAKARTA PUSAT,KEMAYORAN,KEBON KOSONG,30019,10463,19556,13820,33376,2021-09-10
3175011005,JAKARTA TIMUR,MATRAMAN,KEBON MANGGIS,16490,5726,10764,7599,18363,2021-09-10
3171071005,JAKARTA PUSAT,TANAH ABANG,KEBON MELATI,32206,13437,18769,11961,30730,2021-09-10
3175081003,JAKARTA TIMUR,MAKASAR,KEBON PALA,46614,16357,30257,20672,50929,2021-09-10
3171061005,JAKARTA PUSAT,MENTENG,KEBON SIRIH,12299,4410,7889,5477,13366,2021-09-10
3173011004,JAKARTA BARAT,CENGKARENG,KEDAUNG KALI ANGKE,32612,10368,22244,15913,38157,2021-09-10
3173051007,JAKARTA BARAT,KEBON JERUK,KEDOYA SELATAN,32165,10751,21414,14749,36163,2021-09-10
3173051006,JAKARTA BARAT,KEBON JERUK,KEDOYA UTARA,45740,14521,31219,23116,54335,2021-09-10
3173051004,JAKARTA BARAT,KEBON JERUK,KELAPA DUA,23565,8636,14929,10137,25066,2021-09-10
3175091003,JAKARTA TIMUR,CIRACAS,KELAPA DUA WETAN,46875,14596,32279,22880,55159,2021-09-10
3172061003,JAKARTA UTARA,KELAPA GADING,KELAPA GADING BARAT,35717,10890,24827,19846,44673,2021-09-10
3172061001,JAKARTA UTARA,KELAPA GADING,KELAPA GADING TIMUR,33592,9363,24229,19420,43649,2021-09-10
3173071005,JAKARTA BARAT,PALMERAH,KEMANGGISAN,32139,11067,21072,14571,35643,2021-09-10
3171031001,JAKARTA PUSAT,KEMAYORAN,KEMAYORAN,20708,6898,13810,10060,23870,2021-09-10
3173081006,JAKARTA BARAT,KEMBANGAN,KEMBANGAN SELATAN,27130,9462,17668,13421,31089,2021-09-10
3173081001,JAKARTA BARAT,KEMBANGAN,KEMBANGAN UTARA,54451,18770,35681,25465,61146,2021-09-10
3171041002,JAKARTA PUSAT,SENEN,KENARI,9579,3189,6390,4882,11272,2021-09-10
3173041005,JAKARTA BARAT,TAMBORA,KERENDANG,19973,6780,13193,8953,22146,2021-09-10
3175071003,JAKARTA TIMUR,DUREN SAWIT,KLENDER,69978,26863,43115,28887,72002,2021-09-10
3172031001,JAKARTA UTARA,KOJA,KOJA,28175,10379,17796,12535,30331,2021-09-10
3173071006,JAKARTA BARAT,PALMERAH,KOTA BAMBU SELATAN,21158,7434,13724,9023,22747,2021-09-10
3173071003,JAKARTA BARAT,PALMERAH,KOTA BAMBU UTARA,24995,8983,16012,10442,26454,2021-09-10
3171041004,JAKARTA PUSAT,SENEN,KRAMAT,28835,10542,18293,11517,29810,2021-09-10
3175041001,JAKARTA TIMUR,KRAMAT JATI,KRAMAT JATI,34144,12156,21988,14790,36778,2021-09-10
3174071003,JAKARTA SELATAN,KEBAYORAN BARU,KRAMAT PELA,14413,5000,9413,6056,15469,2021-09-10
3173031002,JAKARTA BARAT,TAMAN SARI,KRUKUT,19244,6484,12760,8950,21710,2021-09-10
3174031005,JAKARTA SELATAN,MAMPANG PRAPATAN,KUNINGAN BARAT,12785,4464,8321,5234,13555,2021-09-10
3174021008,JAKARTA SELATAN,SETIA BUDI,KUNINGAN TIMUR,6008,2130,3878,2609,6487,2021-09-10
3171041005,JAKARTA PUSAT,SENEN,KWITANG,15486,5462,10024,7024,17048,2021-09-10
3172031003,JAKARTA UTARA,KOJA,LAGOA,59065,22054,37011,24520,61531,2021-09-10
3174061002,JAKARTA SELATAN,CILANDAK,LEBAK BULUS,37626,14261,23365,15057,38422,2021-09-10
3174091004,JAKARTA SELATAN,JAGAKARSA,LENTENG AGUNG,53946,20442,33504,19301,52805,2021-09-10
3175101007,JAKARTA TIMUR,CIPAYUNG,LUBANG BUAYA,63547,20653,42894,30468,73362,2021-09-10
3175081001,JAKARTA TIMUR,MAKASAR,MAKASAR,34390,11589,22801,16464,39265,2021-09-10
3175071006,JAKARTA TIMUR,DUREN SAWIT,MALAKA JAYA,30927,10808,20119,14895,35014,2021-09-10
3175071005,JAKARTA TIMUR,DUREN SAWIT,MALAKA SARI,27530,9273,18257,13807,32064,2021-09-10
3174031001,JAKARTA SELATAN,MAMPANG PRAPATAN,MAMPANG PRAPATAN,18159,6650,11509,7414,18923,2021-09-10
3173031005,JAKARTA BARAT,TAMAN SARI,MANGGA BESAR,7707,2293,5414,4096,9510,2021-09-10
3171021005,JAKARTA PUSAT,SAWAH BESAR,MANGGA DUA SELATAN,27442,9186,18256,13325,31581,2021-09-10
3174011007,JAKARTA SELATAN,TEBET,MANGGARAI,28373,9482,18891,11247,30138,2021-09-10
3174011006,JAKARTA SELATAN,TEBET,MANGGARAI SELATAN,23075,7977,15098,9585,24683,2021-09-10
3173031003,JAKARTA BARAT,TAMAN SARI,MAPHAR,16461,5665,10796,7897,18693,2021-09-10
3172041003,JAKARTA UTARA,CILINCING,MARUNDA,28943,9604,19339,11544,30883,2021-09-10
3174071001,JAKARTA SELATAN,KEBAYORAN BARU,MELAWAI,2627,890,1737,1381,3118,2021-09-10
3171061001,JAKARTA PUSAT,MENTENG,MENTENG,25624,9518,16106,11265,27371,2021-09-10
3174021005,JAKARTA SELATAN,SETIA BUDI,MENTENG ATAS,27816,9457,18359,11394,29753,2021-09-10
3174011003,JAKARTA SELATAN,TEBET,MENTENG DALAM,36028,13072,22956,14581,37537,2021-09-10
3173081003,JAKARTA BARAT,KEMBANGAN,MERUYA SELATAN,32130,11217,20913,15114,36027,2021-09-10
3173081002,JAKARTA BARAT,KEMBANGAN,MERUYA UTARA,43752,15453,28299,21314,49613,2021-09-10
3175101004,JAKARTA TIMUR,CIPAYUNG,MUNJUL,23871,7849,16022,11859,27881,2021-09-10
3172051002,JAKARTA UTARA,PADEMANGAN,PADEMANGAN BARAT,74240,26890,47350,32528,79878,2021-09-10
3172051001,JAKARTA UTARA,PADEMANGAN,PADEMANGAN TIMUR,37736,11410,26326,19768,46094,2021-09-10
3175011004,JAKARTA TIMUR,MATRAMAN,PAL MERIAM,19769,7434,12335,8591,20926,2021-09-10
3173071001,JAKARTA BARAT,PALMERAH,PALMERAH,63011,22622,40389,26902,67291,2021-09-10
3174081001,JAKARTA SELATAN,PANCORAN,PANCORAN,19421,7186,12235,7497,19732,2021-09-10
3172021003,JAKARTA UTARA,TANJUNG PRIOK,PAPANGGO,39097,12668,26429,18592,45021,2021-09-10
3171021001,JAKARTA PUSAT,SAWAH BESAR,PASAR BARU,12035,3683,8352,6540,14892,2021-09-10
3174021006,JAKARTA SELATAN,SETIA BUDI,PASAR MANGGIS,26752,9723,17029,10639,27668,2021-09-10
3174041001,JAKARTA SELATAN,PASAR MINGGU,PASAR MINGGU,24821,9025,15796,10368,26164,2021-09-10
3171041003,JAKARTA PUSAT,SENEN,PASEBAN,23533,8486,15047,10312,25359,2021-09-10
3173061005,JAKARTA BARAT,KALI DERES,PEGADUNGAN,75587,24930,50657,38189,88846,2021-09-10
3171061002,JAKARTA PUSAT,MENTENG,PEGANGSAAN,23455,8467,14988,9900,24888,2021-09-10
3172061002,JAKARTA UTARA,KELAPA GADING,PEGANGSAAN DUA,49976,13923,36053,28471,64524,2021-09-10
3172011004,JAKARTA UTARA,PENJARINGAN,PEJAGALAN,74578,25593,48985,36504,85489,2021-09-10
3174041006,JAKARTA SELATAN,PASAR MINGGU,PEJATEN BARAT,37346,13997,23349,14879,38228,2021-09-10
3174041005,JAKARTA SELATAN,PASAR MINGGU,PEJATEN TIMUR,57656,22481,35175,20219,55394,2021-09-10
3175051005,JAKARTA TIMUR,PASAR REBO,PEKAYON,43250,14134,29116,20723,49839,2021-09-10
3173041009,JAKARTA BARAT,TAMBORA,PEKOJAN,23587,7608,15979,11522,27501,2021-09-10
3174031003,JAKARTA SELATAN,MAMPANG PRAPATAN,PELA MAMPANG,43522,15719,27803,18370,46173,2021-09-10
3174081005,JAKARTA SELATAN,PANCORAN,PENGADEGAN,21478,7154,14324,7987,22311,2021-09-10
3175061003,JAKARTA TIMUR,CAKUNG,PENGGILINGAN,99255,37905,61350,41773,103123,2021-09-10
3172011001,JAKARTA UTARA,PENJARINGAN,PENJARINGAN,88308,33481,54827,37088,91915,2021-09-10
3174101001,JAKARTA SELATAN,PESANGGRAHAN,PESANGGRAHAN,27545,9423,18122,11468,29590,2021-09-10
3171071004,JAKARTA PUSAT,TANAH ABANG,PETAMBURAN,33271,14167,19104,12375,31479,2021-09-10
3174071008,JAKARTA SELATAN,KEBAYORAN BARU,PETOGOGAN,11499,4272,7227,4779,12006,2021-09-10
3171011004,JAKARTA PUSAT,GAMBIR,PETOJO SELATAN,14692,5334,9358,6720,16078,2021-09-10
3171011003,JAKARTA PUSAT,GAMBIR,PETOJO UTARA,17458,6189,11269,7851,19120,2021-09-10
3174101004,JAKARTA SELATAN,PESANGGRAHAN,PETUKANGAN SELATAN,37187,13664,23523,14376,37899,2021-09-10
3174101003,JAKARTA SELATAN,PESANGGRAHAN,PETUKANGAN UTARA,53716,20891,32825,20390,53215,2021-09-10
3175081002,JAKARTA TIMUR,MAKASAR,PINANG RANTI,27198,9616,17582,12401,29983,2021-09-10
3173031008,JAKARTA BARAT,TAMAN SARI,PINANGSIA,10729,3293,7436,5382,12818,2021-09-10
3175011001,JAKARTA TIMUR,MATRAMAN,PISANGAN BARU,31776,11860,19916,12974,32890,2021-09-10
3175021002,JAKARTA TIMUR,PULO GADUNG,PISANGAN TIMUR,41011,13695,27316,19854,47170,2021-09-10
3172011005,JAKARTA UTARA,PENJARINGAN,PLUIT,47783,15344,32439,25151,57590,2021-09-10
3175071002,JAKARTA TIMUR,DUREN SAWIT,PONDOK BAMBU,61550,22899,38651,27037,65688,2021-09-10
3175071004,JAKARTA TIMUR,DUREN SAWIT,PONDOK KELAPA,72015,25525,46490,32090,78580,2021-09-10
3175071007,JAKARTA TIMUR,DUREN SAWIT,PONDOK KOPI,35367,13685,21682,13663,35345,2021-09-10
3174061003,JAKARTA SELATAN,CILANDAK,PONDOK LABU,46464,16070,30394,20607,51001,2021-09-10
3174051002,JAKARTA SELATAN,KEBAYORAN LAMA,PONDOK PINANG,56169,20847,35322,22522,57844,2021-09-10
3175101003,JAKARTA TIMUR,CIPAYUNG,PONDOK RANGGON,25574,8614,16960,12489,29449,2021-09-10
3101011003,KAB.ADM.KEP.SERIBU,KEP. SERIBU UTARA,PULAU HARAPAN,2060,333,1727,1047,2774,2021-09-10
3101011002,KAB.ADM.KEP.SERIBU,KEP. SERIBU UTARA,PULAU KELAPA,5528,884,4644,2676,7320,2021-09-10
3101011001,KAB.ADM.KEP.SERIBU,KEP. SERIBU UTARA,PULAU PANGGANG,5450,826,4624,2227,6851,2021-09-10
3101021003,KAB.ADM.KEP.SERIBU,KEP. SERIBU SELATAN,PULAU PARI,2765,317,2448,1522,3970,2021-09-10
3101021002,KAB.ADM.KEP.SERIBU,KEP. SERIBU SELATAN,PULAU TIDUNG,4553,603,3950,2727,6677,2021-09-10
3101021001,KAB.ADM.KEP.SERIBU,KEP. SERIBU SELATAN,PULAU UNTUNG JAWA,1941,311,1630,1070,2700,2021-09-10
3174071007,JAKARTA SELATAN,KEBAYORAN BARU,PULO,5835,1955,3880,2866,6746,2021-09-10
3175021001,JAKARTA TIMUR,PULO GADUNG,PULO GADUNG,34422,12062,22360,15637,37997,2021-09-10
3175061005,JAKARTA TIMUR,CAKUNG,PULO GEBANG,97301,34061,63240,42609,105849,2021-09-10
3174041004,JAKARTA SELATAN,PASAR MINGGU,RAGUNAN,39616,13914,25702,16566,42268,2021-09-10
3175091005,JAKARTA TIMUR,CIRACAS,RAMBUTAN,36771,14066,22705,15661,38366,2021-09-10
3172031006,JAKARTA UTARA,KOJA,RAWA BADAK SELATAN,42179,15796,26383,17281,43664,2021-09-10
3172031004,JAKARTA UTARA,KOJA,RAWA BADAK UTARA,34408,12647,21761,15024,36785,2021-09-10
3174071005,JAKARTA SELATAN,KEBAYORAN BARU,RAWA BARAT,5625,1866,3759,2615,6374,2021-09-10
3173011003,JAKARTA BARAT,CENGKARENG,RAWA BUAYA,63799,22548,41251,27155,68406,2021-09-10
3175031004,JAKARTA TIMUR,JATINEGARA,RAWA BUNGA,21434,8244,13190,9237,22427,2021-09-10
3174081003,JAKARTA SELATAN,PANCORAN,RAWA JATI,20509,7346,13163,7973,21136,2021-09-10
3175061002,JAKARTA TIMUR,CAKUNG,RAWA TERATE,24637,7603,17034,12525,29559,2021-09-10
3175021005,JAKARTA TIMUR,PULO GADUNG,RAWAMANGUN,37612,13246,24366,17599,41965,2021-09-10
3171051003,JAKARTA PUSAT,CEMPAKA PUTIH,RAWASARI,21967,7841,14126,10402,24528,2021-09-10
3173041010,JAKARTA BARAT,TAMBORA,ROA MALAKA,3484,1024,2460,1876,4336,2021-09-10
3172041006,JAKARTA UTARA,CILINCING,ROROTAN,41668,13523,28145,18805,46950,2021-09-10
3174071004,JAKARTA SELATAN,KEBAYORAN BARU,SELONG,2842,970,1872,1422,3294,2021-09-10
3173061002,JAKARTA BARAT,KALI DERES,SEMANAN,71354,26247,45107,30090,75197,2021-09-10
3172041007,JAKARTA UTARA,CILINCING,SEMPER BARAT,68587,22117,46470,33273,79743,2021-09-10
3172041005,JAKARTA UTARA,CILINCING,SEMPER TIMUR,36267,12219,24048,16379,40427,2021-09-10
3174071006,JAKARTA SELATAN,KEBAYORAN BARU,SENAYAN,2771,1114,1657,1130,2787,2021-09-10
3171041001,JAKARTA PUSAT,SENEN,SENEN,6804,2254,4550,3338,7888,2021-09-10
3171031004,JAKARTA PUSAT,KEMAYORAN,SERDANG,29668,10259,19409,13792,33201,2021-09-10
3174021001,JAKARTA SELATAN,SETIA BUDI,SETIA BUDI,3023,1104,1919,1313,3232,2021-09-10
3175101005,JAKARTA TIMUR,CIPAYUNG,SETU,20572,7481,13091,9030,22121,2021-09-10
3173071002,JAKARTA BARAT,PALMERAH,SLIPI,16591,5505,11086,7935,19021,2021-09-10
3173081004,JAKARTA BARAT,KEMBANGAN,SRENGSENG,45523,16759,28764,19933,48697,2021-09-10
3174091002,JAKARTA SELATAN,JAGAKARSA,SRENGSENG SAWAH,58196,18824,39372,24775,64147,2021-09-10
3173051003,JAKARTA BARAT,KEBON JERUK,SUKABUMI SELATAN,37033,13647,23386,13847,37233,2021-09-10
3173051002,JAKARTA BARAT,KEBON JERUK,SUKABUMI UTARA,38290,14612,23678,14079,37757,2021-09-10
3172041002,JAKARTA UTARA,CILINCING,SUKAPURA,53949,19262,34687,24777,59464,2021-09-10
3171031007,JAKARTA PUSAT,KEMAYORAN,SUMUR BATU,22717,7998,14719,10679,25398,2021-09-10
3172021004,JAKARTA UTARA,TANJUNG PRIOK,SUNGAI BAMBU,29876,10191,19685,14019,33704,2021-09-10
3172021006,JAKARTA UTARA,TANJUNG PRIOK,SUNTER AGUNG,71805,21427,50378,38740,89118,2021-09-10
3172021002,JAKARTA UTARA,TANJUNG PRIOK,SUNTER JAYA,63031,19530,43501,33752,77253,2021-09-10
3175091004,JAKARTA TIMUR,CIRACAS,SUSUKAN,38257,12303,25954,17853,43807,2021-09-10
3173031001,JAKARTA BARAT,TAMAN SARI,TAMAN SARI,14348,4849,9499,7261,16760,2021-09-10
3173041001,JAKARTA BARAT,TAMBORA,TAMBORA,10204,3590,6614,4399,11013,2021-09-10
3173041004,JAKARTA BARAT,TAMBORA,TANAH SEREAL,26387,7758,18629,12998,31627,2021-09-10
3171081004,JAKARTA PUSAT,JOHAR BARU,TANAH TINGGI,37693,11239,26454,17765,44219,2021-09-10
3173031004,JAKARTA BARAT,TAMAN SARI,TANGKI,13324,4429,8895,6649,15544,2021-09-10
3174091005,JAKARTA SELATAN,JAGAKARSA,TANJUNG BARAT,39770,14017,25753,15214,40967,2021-09-10
3173021005,JAKARTA BARAT,GROGOL PETAMBURAN,TANJUNG DUREN SELATAN,25337,8686,16651,12367,29018,2021-09-10
3173021002,JAKARTA BARAT,GROGOL PETAMBURAN,TANJUNG DUREN UTARA,17010,5520,11490,8514,20004,2021-09-10
3172021001,JAKARTA UTARA,TANJUNG PRIOK,TANJUNG PRIOK,34588,11274,23314,16121,39435,2021-09-10
3174011002,JAKARTA SELATAN,TEBET,TEBET BARAT,21194,7005,14189,9533,23722,2021-09-10
3174011001,JAKARTA SELATAN,TEBET,TEBET TIMUR,18199,6018,12181,8176,20357,2021-09-10
3173061003,JAKARTA BARAT,KALI DERES,TEGAL ALUR,83647,29087,54560,36103,90663,2021-09-10
3174031004,JAKARTA SELATAN,MAMPANG PRAPATAN,TEGAL PARANG,32401,12669,19732,11573,31305,2021-09-10
3173021003,JAKARTA BARAT,GROGOL PETAMBURAN,TOMANG,29605,10026,19579,14867,34446,2021-09-10
3172031005,JAKARTA UTARA,KOJA,TUGU SELATAN,39122,14349,24773,16883,41656,2021-09-10
3172031002,JAKARTA UTARA,KOJA,TUGU UTARA,67670,25346,42324,28485,70809,2021-09-10
3175061006,JAKARTA TIMUR,CAKUNG,UJUNG MENTENG,29934,9578,20356,14935,35291,2021-09-10
3174101005,JAKARTA SELATAN,PESANGGRAHAN,ULUJAMI,40544,16155,24389,14245,38634,2021-09-10
3175011006,JAKARTA TIMUR,MATRAMAN,UTAN KAYU SELATAN,33511,11322,22189,15415,37604,2021-09-10
3175011002,JAKARTA TIMUR,MATRAMAN,UTAN KAYU UTARA,28169,10442,17727,12157,29884,2021-09-10
3171031008,JAKARTA PUSAT,KEMAYORAN,UTAN PANJANG,29208,10422,18786,13083,31869,2021-09-10
3172021007,JAKARTA UTARA,TANJUNG PRIOK,WARAKAS,44401,14403,29998,20409,50407,2021-09-10
3173021007,JAKARTA BARAT,GROGOL PETAMBURAN,WIJAYA KUSUMA,38934,14045,24889,18189,43078,2021-09-10
3172051003,JAKARTA UTARA,PADEMANGAN,ANCOL,23947,8838,15109,10991,26100,2021-09-12
3173041007,JAKARTA BARAT,TAMBORA,ANGKE,29381,9973,19408,12578,31986,2021-09-12
3175041005,JAKARTA TIMUR,KRAMAT JATI,BALE KAMBANG,29074,11840,17234,10517,27751,2021-09-12
3175031003,JAKARTA TIMUR,JATINEGARA,BALI MESTER,9752,3537,6215,4517,10732,2021-09-12
3175101006,JAKARTA TIMUR,CIPAYUNG,BAMBU APUS,26285,8899,17386,12646,30032,2021-09-12
3174031002,JAKARTA SELATAN,MAMPANG PRAPATAN,BANGKA,21566,8266,13300,8406,21706,2021-09-12
3175051002,JAKARTA TIMUR,PASAR REBO,BARU,23886,7302,16584,12764,29348,2021-09-12
3175041004,JAKARTA TIMUR,KRAMAT JATI,BATU AMPAR,47898,18858,29040,19472,48512,2021-09-12
3171071002,JAKARTA PUSAT,TANAH ABANG,BENDUNGAN HILIR,21494,7706,13788,9867,23655,2021-09-12
3175031002,JAKARTA TIMUR,JATINEGARA,BIDARA CINA,36689,14540,22149,15293,37442,2021-09-12
3174101002,JAKARTA SELATAN,PESANGGRAHAN,BINTARO,53098,19938,33160,21407,54567,2021-09-12
3174011005,JAKARTA SELATAN,TEBET,BUKIT DURI,34183,13164,21019,12577,33596,2021-09-12
3171041006,JAKARTA PUSAT,SENEN,BUNGUR,18144,6188,11956,8547,20503,2021-09-12
3175061007,JAKARTA TIMUR,CAKUNG,CAKUNG BARAT,57724,18643,39081,27526,66607,2021-09-12
3175061004,JAKARTA TIMUR,CAKUNG,CAKUNG TIMUR,58287,18940,39347,29114,68461,2021-09-12
3175041007,JAKARTA TIMUR,KRAMAT JATI,CAWANG,32762,12149,20613,13960,34573,2021-09-12
3175101008,JAKARTA TIMUR,CIPAYUNG,CEGER,18932,6363,12569,9157,21726,2021-09-12
3171031006,JAKARTA PUSAT,KEMAYORAN,CEMPAKA BARU,32581,11448,21133,14512,35645,2021-09-12
3171051002,JAKARTA PUSAT,CEMPAKA PUTIH,CEMPAKA PUTIH BARAT,35885,12693,23192,17523,40715,2021-09-12
3171051001,JAKARTA PUSAT,CEMPAKA PUTIH,CEMPAKA PUTIH TIMUR,24292,8263,16029,11966,27995,2021-09-12
3173011001,JAKARTA BARAT,CENGKARENG,CENGKARENG BARAT,66284,22566,43718,32266,75984,2021-09-12
3173011006,JAKARTA BARAT,CENGKARENG,CENGKARENG TIMUR,81027,27006,54021,37079,91100,2021-09-12
3175091002,JAKARTA TIMUR,CIRACAS,CIBUBUR,66364,20945,45419,33242,78661,2021-09-12
3171011002,JAKARTA PUSAT,GAMBIR,CIDENG,15390,5039,10351,7852,18203,2021-09-12
3174091003,JAKARTA SELATAN,JAGAKARSA,CIGANJUR,38497,13843,24654,14965,39619,2021-09-12
3175051003,JAKARTA TIMUR,PASAR REBO,CIJANTUNG,41419,13278,28141,20780,48921,2021-09-12
3171061003,JAKARTA PUSAT,MENTENG,CIKINI,8274,2746,5528,3739,9267,2021-09-12
3174081006,JAKARTA SELATAN,PANCORAN,CIKOKO,10547,3606,6941,4217,11158,2021-09-12
3174061001,JAKARTA SELATAN,CILANDAK,CILANDAK BARAT,51752,18551,33201,21377,54578,2021-09-12
3174041003,JAKARTA SELATAN,PASAR MINGGU,CILANDAK TIMUR,25145,8897,16248,11003,27251,2021-09-12
3175101002,JAKARTA TIMUR,CIPAYUNG,CILANGKAP,27635,9200,18435,13543,31978,2021-09-12
3175041006,JAKARTA TIMUR,KRAMAT JATI,CILILITAN,40181,15389,24792,17588,42380,2021-09-12
3172041001,JAKARTA UTARA,CILINCING,CILINCING,43609,16028,27581,18386,45967,2021-09-12
3175101001,JAKARTA TIMUR,CIPAYUNG,CIPAYUNG,26104,7987,18117,13849,31966,2021-09-12
3174091006,JAKARTA SELATAN,JAGAKARSA,CIPEDAK,38303,12800,25503,16135,41638,2021-09-12
3174061005,JAKARTA SELATAN,CILANDAK,CIPETE SELATAN,26704,10009,16695,11437,28132,2021-09-12
3174071010,JAKARTA SELATAN,KEBAYORAN BARU,CIPETE UTARA,34102,12463,21639,13678,35317,2021-09-12
3175021003,JAKARTA TIMUR,PULO GADUNG,CIPINANG,39306,13770,25536,18157,43693,2021-09-12
3175031007,JAKARTA TIMUR,JATINEGARA,CIPINANG BESAR SELATAN,35212,13484,21728,14378,36106,2021-09-12
3175031008,JAKARTA TIMUR,JATINEGARA,CIPINANG BESAR UTARA,45319,17246,28073,19088,47161,2021-09-12
3175031005,JAKARTA TIMUR,JATINEGARA,CIPINANG CEMPEDAK,32824,12688,20136,14922,35058,2021-09-12
3175081005,JAKARTA TIMUR,MAKASAR,CIPINANG MELAYU,42308,15306,27002,20013,47015,2021-09-12
3175031006,JAKARTA TIMUR,JATINEGARA,CIPINANG MUARA,55243,20848,34395,24192,58587,2021-09-12
3174051003,JAKARTA SELATAN,KEBAYORAN LAMA,CIPULIR,39937,15925,24012,13615,37627,2021-09-12
3175091001,JAKARTA TIMUR,CIRACAS,CIRACAS,64594,20270,44324,31607,75931,2021-09-12
3175041003,JAKARTA TIMUR,KRAMAT JATI,DUKUH,24609,8213,16396,11453,27849,2021-09-12
3175071001,JAKARTA TIMUR,DUREN SAWIT,DUREN SAWIT,61160,22866,38294,27366,65660,2021-09-12
3174081004,JAKARTA SELATAN,PANCORAN,DUREN TIGA,28319,10437,17882,9994,27876,2021-09-12
3173051005,JAKARTA BARAT,KEBON JERUK,DURI KEPA,60138,19863,40275,29921,70196,2021-09-12
3173011002,JAKARTA BARAT,CENGKARENG,DURI KOSAMBI,77923,29339,48584,32906,81490,2021-09-12
3171011006,JAKARTA PUSAT,GAMBIR,DURI PULO,19610,6765,12845,8938,21783,2021-09-12
3173041011,JAKARTA BARAT,TAMBORA,DURI SELATAN,14259,4433,9826,7241,17067,2021-09-12
3173041003,JAKARTA BARAT,TAMBORA,DURI UTARA,19844,6494,13350,9417,22767,2021-09-12
3171081003,JAKARTA PUSAT,JOHAR BARU,GALUR,18243,5489,12754,8883,21637,2021-09-12
3171011001,JAKARTA PUSAT,GAMBIR,GAMBIR,2191,720,1471,1131,2602,2021-09-12
3174061004,JAKARTA SELATAN,CILANDAK,GANDARIA SELATAN,22119,8224,13895,8528,22423,2021-09-12
3174071009,JAKARTA SELATAN,KEBAYORAN BARU,GANDARIA UTARA,39922,14939,24983,15896,40879,2021-09-12
3175051001,JAKARTA TIMUR,PASAR REBO,GEDONG,35755,12059,23696,17440,41136,2021-09-12
3171071001,JAKARTA PUSAT,TANAH ABANG,GELORA,3127,1157,1970,1352,3322,2021-09-12
3173031007,JAKARTA BARAT,TAMAN SARI,GLODOK,7837,2294,5543,4439,9982,2021-09-12
3171061004,JAKARTA PUSAT,MENTENG,GONDANGDIA,4100,1451,2649,2160,4809,2021-09-12
3173021001,JAKARTA BARAT,GROGOL PETAMBURAN,GROGOL,16876,5874,11002,8041,19043,2021-09-12
3174051005,JAKARTA SELATAN,KEBAYORAN LAMA,GROGOL SELATAN,44251,16880,27371,16227,43598,2021-09-12
3174051004,JAKARTA SELATAN,KEBAYORAN LAMA,GROGOL UTARA,42494,15924,26570,16126,42696,2021-09-12
3174021007,JAKARTA SELATAN,SETIA BUDI,GUNTUR,3985,1362,2623,1935,4558,2021-09-12
3174071002,JAKARTA SELATAN,KEBAYORAN BARU,GUNUNG,9436,3319,6117,4329,10446,2021-09-12
3171031005,JAKARTA PUSAT,KEMAYORAN,GUNUNG SAHARI SELATAN,19199,6658,12541,9349,21890,2021-09-12
3171021004,JAKARTA PUSAT,SAWAH BESAR,GUNUNG SAHARI UTARA,16650,4985,11665,9213,20878,2021-09-12
3175081004,JAKARTA TIMUR,MAKASAR,HALIM PERDANA KUSUMAH,28363,7625,20738,17070,37808,2021-09-12
3171031003,JAKARTA PUSAT,KEMAYORAN,HARAPAN MULIA,22557,7713,14844,10864,25708,2021-09-12
3174091001,JAKARTA SELATAN,JAGAKARSA,JAGAKARSA,62389,21721,40668,26395,67063,2021-09-12
3175021007,JAKARTA TIMUR,PULO GADUNG,JATI,32757,11192,21565,16014,37579,2021-09-12
3174041002,JAKARTA SELATAN,PASAR MINGGU,JATI PADANG,37502,13765,23737,15361,39098,2021-09-12
3173071004,JAKARTA BARAT,PALMERAH,JATI PULO,28738,9364,19374,13420,32794,2021-09-12
3175061001,JAKARTA TIMUR,CAKUNG,JATINEGARA,84160,29653,54507,40245,94752,2021-09-12
3175021004,JAKARTA TIMUR,PULO GADUNG,JATINEGARA KAUM,24632,7946,16686,10865,27551,2021-09-12
3173021004,JAKARTA BARAT,GROGOL PETAMBURAN,JELAMBAR,30266,10364,19902,15251,35153,2021-09-12
3173021006,JAKARTA BARAT,GROGOL PETAMBURAN,JELAMBAR BARU,38246,12908,25338,19294,44632,2021-09-12
3173041006,JAKARTA BARAT,TAMBORA,JEMBATAN BESI,29314,11425,17889,11326,29215,2021-09-12
3173041008,JAKARTA BARAT,TAMBORA,JEMBATAN LIMA,21021,7781,13240,8789,22029,2021-09-12
3173081005,JAKARTA BARAT,KEMBANGAN,JOGLO,40839,14110,26729,19052,45781,2021-09-12
3171081001,JAKARTA PUSAT,JOHAR BARU,JOHAR BARU,37488,11536,25952,18993,44945,2021-09-12
3173041002,JAKARTA BARAT,TAMBORA,KALI ANYAR,23856,7856,16000,10881,26881,2021-09-12
3172041004,JAKARTA UTARA,CILINCING,KALIBARU,67684,26442,41242,25498,66740,2021-09-12
3174081002,JAKARTA SELATAN,PANCORAN,KALIBATA,41994,17276,24718,13689,38407,2021-09-12
3173061001,JAKARTA BARAT,KALI DERES,KALIDERES,72447,25559,46888,35463,82351,2021-09-12
3175051004,JAKARTA TIMUR,PASAR REBO,KALISARI,43212,14146,29066,21780,50846,2021-09-12
3173061004,JAKARTA BARAT,KALI DERES,KAMAL,53783,19659,34124,23343,57467,2021-09-12
3172011002,JAKARTA UTARA,PENJARINGAN,KAMAL MUARA,12930,3378,9552,7403,16955,2021-09-12
3171071007,JAKARTA PUSAT,TANAH ABANG,KAMPUNG BALI,11358,4262,7096,4733,11829,2021-09-12
3175031001,JAKARTA TIMUR,JATINEGARA,KAMPUNG MELAYU,25717,9996,15721,10797,26518,2021-09-12
3171081002,JAKARTA PUSAT,JOHAR BARU,KAMPUNG RAWA,21237,5578,15659,10735,26394,2021-09-12
3175041002,JAKARTA TIMUR,KRAMAT JATI,KAMPUNG TENGAH,43993,17139,26854,17676,44530,2021-09-12
3173011005,JAKARTA BARAT,CENGKARENG,KAPUK,134466,50138,84328,55298,139626,2021-09-12
3172011003,JAKARTA UTARA,PENJARINGAN,KAPUK MUARA,35781,10718,25063,20191,45254,2021-09-12
3171021002,JAKARTA PUSAT,SAWAH BESAR,KARANG ANYAR,25761,8312,17449,12623,30072,2021-09-12
3174021004,JAKARTA SELATAN,SETIA BUDI,KARET,9623,3585,6038,4039,10077,2021-09-12
3174021003,JAKARTA SELATAN,SETIA BUDI,KARET KUNINGAN,16055,5316,10739,7220,17959,2021-09-12
3174021002,JAKARTA SELATAN,SETIA BUDI,KARET SEMANGGI,2770,939,1831,1409,3240,2021-09-12
3171071003,JAKARTA PUSAT,TANAH ABANG,KARET TENGSIN,19271,6451,12820,8704,21524,2021-09-12
3171021003,JAKARTA PUSAT,SAWAH BESAR,KARTINI,22292,7450,14842,11239,26081,2021-09-12
3175011003,JAKARTA TIMUR,MATRAMAN,KAYU MANIS,25284,9546,15738,10565,26303,2021-09-12
3175021006,JAKARTA TIMUR,PULO GADUNG,KAYU PUTIH,40696,13399,27297,21010,48307,2021-09-12
3173031006,JAKARTA BARAT,TAMAN SARI,KEAGUNGAN,17387,5751,11636,8570,20206,2021-09-12
3174041007,JAKARTA SELATAN,PASAR MINGGU,KEBAGUSAN,44552,17012,27540,16650,44190,2021-09-12
3174051006,JAKARTA SELATAN,KEBAYORAN LAMA,KEBAYORAN LAMA SELATAN,41212,14710,26502,16048,42550,2021-09-12
3174051001,JAKARTA SELATAN,KEBAYORAN LAMA,KEBAYORAN LAMA UTARA,42422,16500,25922,14582,40504,2021-09-12
3174011004,JAKARTA SELATAN,TEBET,KEBON BARU,35165,12819,22346,13823,36169,2021-09-12
3172021005,JAKARTA UTARA,TANJUNG PRIOK,KEBON BAWANG,50952,17580,33372,23725,57097,2021-09-12
3173051001,JAKARTA BARAT,KEBON JERUK,KEBON JERUK,53887,19873,34014,23656,57670,2021-09-12
3171071006,JAKARTA PUSAT,TANAH ABANG,KEBON KACANG,21531,8441,13090,8968,22058,2021-09-12
3171011005,JAKARTA PUSAT,GAMBIR,KEBON KELAPA,10163,3492,6671,4895,11566,2021-09-12
3171031002,JAKARTA PUSAT,KEMAYORAN,KEBON KOSONG,30019,10399,19620,14211,33831,2021-09-12
3175011005,JAKARTA TIMUR,MATRAMAN,KEBON MANGGIS,16490,5683,10807,7732,18539,2021-09-12
3171071005,JAKARTA PUSAT,TANAH ABANG,KEBON MELATI,32206,13301,18905,12213,31118,2021-09-12
3175081003,JAKARTA TIMUR,MAKASAR,KEBON PALA,46614,16286,30328,21250,51578,2021-09-12
3171061005,JAKARTA PUSAT,MENTENG,KEBON SIRIH,12299,4367,7932,5631,13563,2021-09-12
3173011004,JAKARTA BARAT,CENGKARENG,KEDAUNG KALI ANGKE,32612,10301,22311,16686,38997,2021-09-12
3173051007,JAKARTA BARAT,KEBON JERUK,KEDOYA SELATAN,32165,10684,21481,15158,36639,2021-09-12
3173051006,JAKARTA BARAT,KEBON JERUK,KEDOYA UTARA,45740,14458,31282,23575,54857,2021-09-12
3173051004,JAKARTA BARAT,KEBON JERUK,KELAPA DUA,23565,8593,14972,10696,25668,2021-09-12
3175091003,JAKARTA TIMUR,CIRACAS,KELAPA DUA WETAN,46875,14503,32372,23404,55776,2021-09-12
3172061003,JAKARTA UTARA,KELAPA GADING,KELAPA GADING BARAT,35717,10837,24880,20105,44985,2021-09-12
3172061001,JAKARTA UTARA,KELAPA GADING,KELAPA GADING TIMUR,33592,9301,24291,19737,44028,2021-09-12
3173071005,JAKARTA BARAT,PALMERAH,KEMANGGISAN,32139,11015,21124,14887,36011,2021-09-12
3171031001,JAKARTA PUSAT,KEMAYORAN,KEMAYORAN,20708,6851,13857,10311,24168,2021-09-12
3173081006,JAKARTA BARAT,KEMBANGAN,KEMBANGAN SELATAN,27130,9417,17713,13680,31393,2021-09-12
3173081001,JAKARTA BARAT,KEMBANGAN,KEMBANGAN UTARA,54451,18612,35839,26204,62043,2021-09-12
3171041002,JAKARTA PUSAT,SENEN,KENARI,9579,3165,6414,4974,11388,2021-09-12
3173041005,JAKARTA BARAT,TAMBORA,KERENDANG,19973,6740,13233,9180,22413,2021-09-12
3175071003,JAKARTA TIMUR,DUREN SAWIT,KLENDER,69978,26581,43397,29664,73061,2021-09-12
3172031001,JAKARTA UTARA,KOJA,KOJA,28175,10276,17899,12808,30707,2021-09-12
3173071006,JAKARTA BARAT,PALMERAH,KOTA BAMBU SELATAN,21158,7384,13774,9225,22999,2021-09-12
3173071003,JAKARTA BARAT,PALMERAH,KOTA BAMBU UTARA,24995,8922,16073,10658,26731,2021-09-12
3171041004,JAKARTA PUSAT,SENEN,KRAMAT,28835,10419,18416,11823,30239,2021-09-12
3175041001,JAKARTA TIMUR,KRAMAT JATI,KRAMAT JATI,34144,12107,22037,15285,37322,2021-09-12
3174071003,JAKARTA SELATAN,KEBAYORAN BARU,KRAMAT PELA,14413,4997,9416,6077,15493,2021-09-12
3173031002,JAKARTA BARAT,TAMAN SARI,KRUKUT,19244,6444,12800,9166,21966,2021-09-12
3174031005,JAKARTA SELATAN,MAMPANG PRAPATAN,KUNINGAN BARAT,12785,4458,8327,5255,13582,2021-09-12
3174021008,JAKARTA SELATAN,SETIA BUDI,KUNINGAN TIMUR,6008,2125,3883,2622,6505,2021-09-12
3171041005,JAKARTA PUSAT,SENEN,KWITANG,15486,5423,10063,7236,17299,2021-09-12
3172031003,JAKARTA UTARA,KOJA,LAGOA,59065,21847,37218,24921,62139,2021-09-12
3174061002,JAKARTA SELATAN,CILANDAK,LEBAK BULUS,37626,14247,23379,15120,38499,2021-09-12
3174091004,JAKARTA SELATAN,JAGAKARSA,LENTENG AGUNG,53946,20406,33540,19394,52934,2021-09-12
3175101007,JAKARTA TIMUR,CIPAYUNG,LUBANG BUAYA,63547,20561,42986,31167,74153,2021-09-12
3175081001,JAKARTA TIMUR,MAKASAR,MAKASAR,34390,11527,22863,16652,39515,2021-09-12
3175071006,JAKARTA TIMUR,DUREN SAWIT,MALAKA JAYA,30927,10739,20188,15150,35338,2021-09-12
3175071005,JAKARTA TIMUR,DUREN SAWIT,MALAKA SARI,27530,9212,18318,14047,32365,2021-09-12
3174031001,JAKARTA SELATAN,MAMPANG PRAPATAN,MAMPANG PRAPATAN,18159,6648,11511,7449,18960,2021-09-12
3173031005,JAKARTA BARAT,TAMAN SARI,MANGGA BESAR,7707,2273,5434,4192,9626,2021-09-12
3171021005,JAKARTA PUSAT,SAWAH BESAR,MANGGA DUA SELATAN,27442,9122,18320,13633,31953,2021-09-12
3174011007,JAKARTA SELATAN,TEBET,MANGGARAI,28373,9454,18919,11325,30244,2021-09-12
3174011006,JAKARTA SELATAN,TEBET,MANGGARAI SELATAN,23075,7946,15129,9655,24784,2021-09-12
3173031003,JAKARTA BARAT,TAMAN SARI,MAPHAR,16461,5617,10844,8134,18978,2021-09-12
3172041003,JAKARTA UTARA,CILINCING,MARUNDA,28943,9532,19411,11894,31305,2021-09-12
3174071001,JAKARTA SELATAN,KEBAYORAN BARU,MELAWAI,2627,889,1738,1384,3122,2021-09-12
3171061001,JAKARTA PUSAT,MENTENG,MENTENG,25624,9353,16271,11449,27720,2021-09-12
3174021005,JAKARTA SELATAN,SETIA BUDI,MENTENG ATAS,27816,9441,18375,11478,29853,2021-09-12
3174011003,JAKARTA SELATAN,TEBET,MENTENG DALAM,36028,13045,22983,14673,37656,2021-09-12
3173081003,JAKARTA BARAT,KEMBANGAN,MERUYA SELATAN,32130,11170,20960,15465,36425,2021-09-12
3173081002,JAKARTA BARAT,KEMBANGAN,MERUYA UTARA,43752,15339,28413,21775,50188,2021-09-12
3175101004,JAKARTA TIMUR,CIPAYUNG,MUNJUL,23871,7796,16075,11998,28073,2021-09-12
3172051002,JAKARTA UTARA,PADEMANGAN,PADEMANGAN BARAT,74240,26762,47478,33116,80594,2021-09-12
3172051001,JAKARTA UTARA,PADEMANGAN,PADEMANGAN TIMUR,37736,11338,26398,20205,46603,2021-09-12
3175011004,JAKARTA TIMUR,MATRAMAN,PAL MERIAM,19769,7371,12398,8780,21178,2021-09-12
3173071001,JAKARTA BARAT,PALMERAH,PALMERAH,63011,22457,40554,27479,68033,2021-09-12
3174081001,JAKARTA SELATAN,PANCORAN,PANCORAN,19421,7176,12245,7543,19788,2021-09-12
3172021003,JAKARTA UTARA,TANJUNG PRIOK,PAPANGGO,39097,12583,26514,19091,45605,2021-09-12
3171021001,JAKARTA PUSAT,SAWAH BESAR,PASAR BARU,12035,3662,8373,6675,15048,2021-09-12
3174021006,JAKARTA SELATAN,SETIA BUDI,PASAR MANGGIS,26752,9695,17057,10699,27756,2021-09-12
3174041001,JAKARTA SELATAN,PASAR MINGGU,PASAR MINGGU,24821,9014,15807,10409,26216,2021-09-12
3171041003,JAKARTA PUSAT,SENEN,PASEBAN,23533,8419,15114,10515,25629,2021-09-12
3173061005,JAKARTA BARAT,KALI DERES,PEGADUNGAN,75587,24786,50801,39041,89842,2021-09-12
3171061002,JAKARTA PUSAT,MENTENG,PEGANGSAAN,23455,8394,15061,10071,25132,2021-09-12
3172061002,JAKARTA UTARA,KELAPA GADING,PEGANGSAAN DUA,49976,13820,36156,28983,65139,2021-09-12
3172011004,JAKARTA UTARA,PENJARINGAN,PEJAGALAN,74578,25416,49162,37356,86518,2021-09-12
3174041006,JAKARTA SELATAN,PASAR MINGGU,PEJATEN BARAT,37346,13978,23368,14945,38313,2021-09-12
3174041005,JAKARTA SELATAN,PASAR MINGGU,PEJATEN TIMUR,57656,22432,35224,20350,55574,2021-09-12
3175051005,JAKARTA TIMUR,PASAR REBO,PEKAYON,43250,14069,29181,21108,50289,2021-09-12
3173041009,JAKARTA BARAT,TAMBORA,PEKOJAN,23587,7566,16021,11760,27781,2021-09-12
3174031003,JAKARTA SELATAN,MAMPANG PRAPATAN,PELA MAMPANG,43522,15695,27827,18448,46275,2021-09-12
3174081005,JAKARTA SELATAN,PANCORAN,PENGADEGAN,21478,7139,14339,8037,22376,2021-09-12
3175061003,JAKARTA TIMUR,CAKUNG,PENGGILINGAN,99255,37534,61721,42751,104472,2021-09-12
3172011001,JAKARTA UTARA,PENJARINGAN,PENJARINGAN,88308,33220,55088,38111,93199,2021-09-12
3174101001,JAKARTA SELATAN,PESANGGRAHAN,PESANGGRAHAN,27545,9413,18132,11507,29639,2021-09-12
3171071004,JAKARTA PUSAT,TANAH ABANG,PETAMBURAN,33271,13941,19330,12632,31962,2021-09-12
3174071008,JAKARTA SELATAN,KEBAYORAN BARU,PETOGOGAN,11499,4271,7228,4794,12022,2021-09-12
3171011004,JAKARTA PUSAT,GAMBIR,PETOJO SELATAN,14692,5311,9381,6859,16240,2021-09-12
3171011003,JAKARTA PUSAT,GAMBIR,PETOJO UTARA,17458,6175,11283,8037,19320,2021-09-12
3174101004,JAKARTA SELATAN,PESANGGRAHAN,PETUKANGAN SELATAN,37187,13652,23535,14427,37962,2021-09-12
3174101003,JAKARTA SELATAN,PESANGGRAHAN,PETUKANGAN UTARA,53716,20861,32855,20544,53399,2021-09-12
3175081002,JAKARTA TIMUR,MAKASAR,PINANG RANTI,27198,9565,17633,12782,30415,2021-09-12
3173031008,JAKARTA BARAT,TAMAN SARI,PINANGSIA,10729,3276,7453,5538,12991,2021-09-12
3175011001,JAKARTA TIMUR,MATRAMAN,PISANGAN BARU,31776,11769,20007,13218,33225,2021-09-12
3175021002,JAKARTA TIMUR,PULO GADUNG,PISANGAN TIMUR,41011,13602,27409,20191,47600,2021-09-12
3172011005,JAKARTA UTARA,PENJARINGAN,PLUIT,47783,15269,32514,25514,58028,2021-09-12
3175071002,JAKARTA TIMUR,DUREN SAWIT,PONDOK BAMBU,61550,22776,38774,27574,66348,2021-09-12
3175071004,JAKARTA TIMUR,DUREN SAWIT,PONDOK KELAPA,72015,25378,46637,32796,79433,2021-09-12
3175071007,JAKARTA TIMUR,DUREN SAWIT,PONDOK KOPI,35367,13533,21834,13930,35764,2021-09-12
3174061003,JAKARTA SELATAN,CILANDAK,PONDOK LABU,46464,16057,30407,20693,51100,2021-09-12
3174051002,JAKARTA SELATAN,KEBAYORAN LAMA,PONDOK PINANG,56169,20821,35348,22626,57974,2021-09-12
3175101003,JAKARTA TIMUR,CIPAYUNG,PONDOK RANGGON,25574,8573,17001,12679,29680,2021-09-12
3101011003,KAB.ADM.KEP.SERIBU,KEP. SERIBU UTARA,PULAU HARAPAN,2060,333,1727,1049,2776,2021-09-12
3101011002,KAB.ADM.KEP.SERIBU,KEP. SERIBU UTARA,PULAU KELAPA,5528,882,4646,2691,7337,2021-09-12
3101011001,KAB.ADM.KEP.SERIBU,KEP. SERIBU UTARA,PULAU PANGGANG,5450,823,4627,2262,6889,2021-09-12
3101021003,KAB.ADM.KEP.SERIBU,KEP. SERIBU SELATAN,PULAU PARI,2765,312,2453,1626,4079,2021-09-12
3101021002,KAB.ADM.KEP.SERIBU,KEP. SERIBU SELATAN,PULAU TIDUNG,4553,600,3953,2763,6716,2021-09-12
3101021001,KAB.ADM.KEP.SERIBU,KEP. SERIBU SELATAN,PULAU UNTUNG JAWA,1941,309,1632,1098,2730,2021-09-12
3174071007,JAKARTA SELATAN,KEBAYORAN BARU,PULO,5835,1955,3880,2878,6758,2021-09-12
3175021001,JAKARTA TIMUR,PULO GADUNG,PULO GADUNG,34422,11995,22427,15880,38307,2021-09-12
3175061005,JAKARTA TIMUR,CAKUNG,PULO GEBANG,97301,33636,63665,43583,107248,2021-09-12
3174041004,JAKARTA SELATAN,PASAR MINGGU,RAGUNAN,39616,13896,25720,16620,42340,2021-09-12
3175091005,JAKARTA TIMUR,CIRACAS,RAMBUTAN,36771,13903,22868,16005,38873,2021-09-12
3172031006,JAKARTA UTARA,KOJA,RAWA BADAK SELATAN,42179,15525,26654,17836,44490,2021-09-12
3172031004,JAKARTA UTARA,KOJA,RAWA BADAK UTARA,34408,12474,21934,15464,37398,2021-09-12
3174071005,JAKARTA SELATAN,KEBAYORAN BARU,RAWA BARAT,5625,1864,3761,2627,6388,2021-09-12
3173011003,JAKARTA BARAT,CENGKARENG,RAWA BUAYA,63799,22412,41387,28414,69801,2021-09-12
3175031004,JAKARTA TIMUR,JATINEGARA,RAWA BUNGA,21434,8206,13228,9408,22636,2021-09-12
3174081003,JAKARTA SELATAN,PANCORAN,RAWA JATI,20509,7333,13176,8043,21219,2021-09-12
3175061002,JAKARTA TIMUR,CAKUNG,RAWA TERATE,24637,7572,17065,12677,29742,2021-09-12
3175021005,JAKARTA TIMUR,PULO GADUNG,RAWAMANGUN,37612,13125,24487,17937,42424,2021-09-12
3171051003,JAKARTA PUSAT,CEMPAKA PUTIH,RAWASARI,21967,7782,14185,10562,24747,2021-09-12
3173041010,JAKARTA BARAT,TAMBORA,ROA MALAKA,3484,1021,2463,1906,4369,2021-09-12
3172041006,JAKARTA UTARA,CILINCING,ROROTAN,41668,13426,28242,19205,47447,2021-09-12
3174071004,JAKARTA SELATAN,KEBAYORAN BARU,SELONG,2842,970,1872,1428,3300,2021-09-12
3173061002,JAKARTA BARAT,KALI DERES,SEMANAN,71354,25883,45471,31361,76832,2021-09-12
3172041007,JAKARTA UTARA,CILINCING,SEMPER BARAT,68587,21940,46647,34089,80736,2021-09-12
3172041005,JAKARTA UTARA,CILINCING,SEMPER TIMUR,36267,12145,24122,16844,40966,2021-09-12
3174071006,JAKARTA SELATAN,KEBAYORAN BARU,SENAYAN,2771,1113,1658,1133,2791,2021-09-12
3171041001,JAKARTA PUSAT,SENEN,SENEN,6804,2228,4576,3484,8060,2021-09-12
3171031004,JAKARTA PUSAT,KEMAYORAN,SERDANG,29668,10167,19501,14088,33589,2021-09-12
3174021001,JAKARTA SELATAN,SETIA BUDI,SETIA BUDI,3023,1101,1922,1323,3245,2021-09-12
3175101005,JAKARTA TIMUR,CIPAYUNG,SETU,20572,7436,13136,9219,22355,2021-09-12
3173071002,JAKARTA BARAT,PALMERAH,SLIPI,16591,5471,11120,8082,19202,2021-09-12
3173081004,JAKARTA BARAT,KEMBANGAN,SRENGSENG,45523,16631,28892,20419,49311,2021-09-12
3174091002,JAKARTA SELATAN,JAGAKARSA,SRENGSENG SAWAH,58196,18797,39399,24861,64260,2021-09-12
3173051003,JAKARTA BARAT,KEBON JERUK,SUKABUMI SELATAN,37033,13588,23445,14311,37756,2021-09-12
3173051002,JAKARTA BARAT,KEBON JERUK,SUKABUMI UTARA,38290,14493,23797,14530,38327,2021-09-12
3172041002,JAKARTA UTARA,CILINCING,SUKAPURA,53949,19108,34841,25304,60145,2021-09-12
3171031007,JAKARTA PUSAT,KEMAYORAN,SUMUR BATU,22717,7948,14769,10952,25721,2021-09-12
3172021004,JAKARTA UTARA,TANJUNG PRIOK,SUNGAI BAMBU,29876,10115,19761,14455,34216,2021-09-12
3172021006,JAKARTA UTARA,TANJUNG PRIOK,SUNTER AGUNG,71805,21240,50565,39481,90046,2021-09-12
3172021002,JAKARTA UTARA,TANJUNG PRIOK,SUNTER JAYA,63031,19380,43651,34370,78021,2021-09-12
3175091004,JAKARTA TIMUR,CIRACAS,SUSUKAN,38257,12227,26030,18256,44286,2021-09-12
3173031001,JAKARTA BARAT,TAMAN SARI,TAMAN SARI,14348,4814,9534,7407,16941,2021-09-12
3173041001,JAKARTA BARAT,TAMBORA,TAMBORA,10204,3571,6633,4497,11130,2021-09-12
3173041004,JAKARTA BARAT,TAMBORA,TANAH SEREAL,26387,7718,18669,13261,31930,2021-09-12
3171081004,JAKARTA PUSAT,JOHAR BARU,TANAH TINGGI,37693,11156,26537,18346,44883,2021-09-12
3173031004,JAKARTA BARAT,TAMAN SARI,TANGKI,13324,4353,8971,6849,15820,2021-09-12
3174091005,JAKARTA SELATAN,JAGAKARSA,TANJUNG BARAT,39770,13988,25782,15290,41072,2021-09-12
3173021005,JAKARTA BARAT,GROGOL PETAMBURAN,TANJUNG DUREN SELATAN,25337,8656,16681,12660,29341,2021-09-12
3173021002,JAKARTA BARAT,GROGOL PETAMBURAN,TANJUNG DUREN UTARA,17010,5494,11516,8708,20224,2021-09-12
3172021001,JAKARTA UTARA,TANJUNG PRIOK,TANJUNG PRIOK,34588,11193,23395,16471,39866,2021-09-12
3174011002,JAKARTA SELATAN,TEBET,TEBET BARAT,21194,6993,14201,9599,23800,2021-09-12
3174011001,JAKARTA SELATAN,TEBET,TEBET TIMUR,18199,6000,12199,8239,20438,2021-09-12
3173061003,JAKARTA BARAT,KALI DERES,TEGAL ALUR,83647,28943,54704,37131,91835,2021-09-12
3174031004,JAKARTA SELATAN,MAMPANG PRAPATAN,TEGAL PARANG,32401,12636,19765,11691,31456,2021-09-12
3173021003,JAKARTA BARAT,GROGOL PETAMBURAN,TOMANG,29605,9971,19634,15183,34817,2021-09-12
3172031005,JAKARTA UTARA,KOJA,TUGU SELATAN,39122,13673,25449,17351,42800,2021-09-12
3172031002,JAKARTA UTARA,KOJA,TUGU UTARA,67670,25042,42628,29101,71729,2021-09-12
3175061006,JAKARTA TIMUR,CAKUNG,UJUNG MENTENG,29934,9503,20431,15230,35661,2021-09-12
3174101005,JAKARTA SELATAN,PESANGGRAHAN,ULUJAMI,40544,16143,24401,14308,38709,2021-09-12
3175011006,JAKARTA TIMUR,MATRAMAN,UTAN KAYU SELATAN,33511,11194,22317,15866,38183,2021-09-12
3175011002,JAKARTA TIMUR,MATRAMAN,UTAN KAYU UTARA,28169,10361,17808,12447,30255,2021-09-12
3171031008,JAKARTA PUSAT,KEMAYORAN,UTAN PANJANG,29208,10378,18830,13292,32122,2021-09-12
3172021007,JAKARTA UTARA,TANJUNG PRIOK,WARAKAS,44401,14274,30127,21016,51143,2021-09-12
3173021007,JAKARTA BARAT,GROGOL PETAMBURAN,WIJAYA KUSUMA,38934,13985,24949,18494,43443,2021-09-12
3172051003,JAKARTA UTARA,PADEMANGAN,ANCOL,23947,8836,15111,10997,26108,2021-09-13
3173041007,JAKARTA BARAT,TAMBORA,ANGKE,29381,9966,19415,12611,32026,2021-09-13
3175041005,JAKARTA TIMUR,KRAMAT JATI,BALE KAMBANG,29074,11835,17239,10524,27763,2021-09-13
3175031003,JAKARTA TIMUR,JATINEGARA,BALI MESTER,9752,3537,6215,4522,10737,2021-09-13
3175101006,JAKARTA TIMUR,CIPAYUNG,BAMBU APUS,26285,8898,17387,12654,30041,2021-09-13
3174031002,JAKARTA SELATAN,MAMPANG PRAPATAN,BANGKA,21566,8266,13300,8409,21709,2021-09-13
3175051002,JAKARTA TIMUR,PASAR REBO,BARU,23886,7293,16593,12777,29370,2021-09-13
3175041004,JAKARTA TIMUR,KRAMAT JATI,BATU AMPAR,47898,18845,29053,19493,48546,2021-09-13
3171071002,JAKARTA PUSAT,TANAH ABANG,BENDUNGAN HILIR,21494,7704,13790,9884,23674,2021-09-13
3175031002,JAKARTA TIMUR,JATINEGARA,BIDARA CINA,36689,14534,22155,15304,37459,2021-09-13
3174101002,JAKARTA SELATAN,PESANGGRAHAN,BINTARO,53098,19936,33162,21418,54580,2021-09-13
3174011005,JAKARTA SELATAN,TEBET,BUKIT DURI,34183,13160,21023,12588,33611,2021-09-13
3171041006,JAKARTA PUSAT,SENEN,BUNGUR,18144,6186,11958,8550,20508,2021-09-13
3175061007,JAKARTA TIMUR,CAKUNG,CAKUNG BARAT,57724,18605,39119,27596,66715,2021-09-13
3175061004,JAKARTA TIMUR,CAKUNG,CAKUNG TIMUR,58287,18921,39366,29169,68535,2021-09-13
3175041007,JAKARTA TIMUR,KRAMAT JATI,CAWANG,32762,12138,20624,13976,34600,2021-09-13
3175101008,JAKARTA TIMUR,CIPAYUNG,CEGER,18932,6360,12572,9168,21740,2021-09-13
3171031006,JAKARTA PUSAT,KEMAYORAN,CEMPAKA BARU,32581,11447,21134,14524,35658,2021-09-13
3171051002,JAKARTA PUSAT,CEMPAKA PUTIH,CEMPAKA PUTIH BARAT,35885,12693,23192,17542,40734,2021-09-13
3171051001,JAKARTA PUSAT,CEMPAKA PUTIH,CEMPAKA PUTIH TIMUR,24292,8258,16034,11981,28015,2021-09-13
3173011001,JAKARTA BARAT,CENGKARENG,CENGKARENG BARAT,66284,22553,43731,32300,76031,2021-09-13
3173011006,JAKARTA BARAT,CENGKARENG,CENGKARENG TIMUR,81027,26989,54038,37194,91232,2021-09-13
3175091002,JAKARTA TIMUR,CIRACAS,CIBUBUR,66364,20932,45432,33276,78708,2021-09-13
3171011002,JAKARTA PUSAT,GAMBIR,CIDENG,15390,5036,10354,7862,18216,2021-09-13
3174091003,JAKARTA SELATAN,JAGAKARSA,CIGANJUR,38497,13841,24656,14974,39630,2021-09-13
3175051003,JAKARTA TIMUR,PASAR REBO,CIJANTUNG,41419,13244,28175,20868,49043,2021-09-13
3171061003,JAKARTA PUSAT,MENTENG,CIKINI,8274,2744,5530,3747,9277,2021-09-13
3174081006,JAKARTA SELATAN,PANCORAN,CIKOKO,10547,3603,6944,4219,11163,2021-09-13
3174061001,JAKARTA SELATAN,CILANDAK,CILANDAK BARAT,51752,18549,33203,21391,54594,2021-09-13
3174041003,JAKARTA SELATAN,PASAR MINGGU,CILANDAK TIMUR,25145,8897,16248,11012,27260,2021-09-13
3175101002,JAKARTA TIMUR,CIPAYUNG,CILANGKAP,27635,9197,18438,13556,31994,2021-09-13
3175041006,JAKARTA TIMUR,KRAMAT JATI,CILILITAN,40181,15384,24797,17606,42403,2021-09-13
3172041001,JAKARTA UTARA,CILINCING,CILINCING,43609,16024,27585,18399,45984,2021-09-13
3175101001,JAKARTA TIMUR,CIPAYUNG,CIPAYUNG,26104,7985,18119,13858,31977,2021-09-13
3174091006,JAKARTA SELATAN,JAGAKARSA,CIPEDAK,38303,12799,25504,16143,41647,2021-09-13
3174061005,JAKARTA SELATAN,CILANDAK,CIPETE SELATAN,26704,10007,16697,11449,28146,2021-09-13
3174071010,JAKARTA SELATAN,KEBAYORAN BARU,CIPETE UTARA,34102,12460,21642,13692,35334,2021-09-13
3175021003,JAKARTA TIMUR,PULO GADUNG,CIPINANG,39306,13755,25551,18190,43741,2021-09-13
3175031007,JAKARTA TIMUR,JATINEGARA,CIPINANG BESAR SELATAN,35212,13417,21795,14430,36225,2021-09-13
3175031008,JAKARTA TIMUR,JATINEGARA,CIPINANG BESAR UTARA,45319,17238,28081,19103,47184,2021-09-13
3175031005,JAKARTA TIMUR,JATINEGARA,CIPINANG CEMPEDAK,32824,12681,20143,14934,35077,2021-09-13
3175081005,JAKARTA TIMUR,MAKASAR,CIPINANG MELAYU,42308,15295,27013,20026,47039,2021-09-13
3175031006,JAKARTA TIMUR,JATINEGARA,CIPINANG MUARA,55243,20842,34401,24227,58628,2021-09-13
3174051003,JAKARTA SELATAN,KEBAYORAN LAMA,CIPULIR,39937,15923,24014,13626,37640,2021-09-13
3175091001,JAKARTA TIMUR,CIRACAS,CIRACAS,64594,20195,44399,31764,76163,2021-09-13
3175041003,JAKARTA TIMUR,KRAMAT JATI,DUKUH,24609,8205,16404,11459,27863,2021-09-13
3175071001,JAKARTA TIMUR,DUREN SAWIT,DUREN SAWIT,61160,22860,38300,27391,65691,2021-09-13
3174081004,JAKARTA SELATAN,PANCORAN,DUREN TIGA,28319,10437,17882,10006,27888,2021-09-13
3173051005,JAKARTA BARAT,KEBON JERUK,DURI KEPA,60138,19854,40284,29997,70281,2021-09-13
3173011002,JAKARTA BARAT,CENGKARENG,DURI KOSAMBI,77923,29327,48596,32957,81553,2021-09-13
3171011006,JAKARTA PUSAT,GAMBIR,DURI PULO,19610,6762,12848,8943,21791,2021-09-13
3173041011,JAKARTA BARAT,TAMBORA,DURI SELATAN,14259,4430,9829,7252,17081,2021-09-13
3173041003,JAKARTA BARAT,TAMBORA,DURI UTARA,19844,6489,13355,9438,22793,2021-09-13
3171081003,JAKARTA PUSAT,JOHAR BARU,GALUR,18243,5482,12761,8922,21683,2021-09-13
3171011001,JAKARTA PUSAT,GAMBIR,GAMBIR,2191,720,1471,1133,2604,2021-09-13
3174061004,JAKARTA SELATAN,CILANDAK,GANDARIA SELATAN,22119,8224,13895,8533,22428,2021-09-13
3174071009,JAKARTA SELATAN,KEBAYORAN BARU,GANDARIA UTARA,39922,14936,24986,15910,40896,2021-09-13
3175051001,JAKARTA TIMUR,PASAR REBO,GEDONG,35755,12053,23702,17455,41157,2021-09-13
3171071001,JAKARTA PUSAT,TANAH ABANG,GELORA,3127,1155,1972,1357,3329,2021-09-13
3173031007,JAKARTA BARAT,TAMAN SARI,GLODOK,7837,2292,5545,4450,9995,2021-09-13
3171061004,JAKARTA PUSAT,MENTENG,GONDANGDIA,4100,1451,2649,2163,4812,2021-09-13
3173021001,JAKARTA BARAT,GROGOL PETAMBURAN,GROGOL,16876,5870,11006,8058,19064,2021-09-13
3174051005,JAKARTA SELATAN,KEBAYORAN LAMA,GROGOL SELATAN,44251,16877,27374,16237,43611,2021-09-13
3174051004,JAKARTA SELATAN,KEBAYORAN LAMA,GROGOL UTARA,42494,15918,26576,16143,42719,2021-09-13
3174021007,JAKARTA SELATAN,SETIA BUDI,GUNTUR,3985,1362,2623,1938,4561,2021-09-13
3174071002,JAKARTA SELATAN,KEBAYORAN BARU,GUNUNG,9436,3319,6117,4329,10446,2021-09-13
3171031005,JAKARTA PUSAT,KEMAYORAN,GUNUNG SAHARI SELATAN,19199,6650,12549,9359,21908,2021-09-13
3171021004,JAKARTA PUSAT,SAWAH BESAR,GUNUNG SAHARI UTARA,16650,4982,11668,9219,20887,2021-09-13
3175081004,JAKARTA TIMUR,MAKASAR,HALIM PERDANA KUSUMAH,28363,7624,20739,17078,37817,2021-09-13
3171031003,JAKARTA PUSAT,KEMAYORAN,HARAPAN MULIA,22557,7713,14844,10871,25715,2021-09-13
3174091001,JAKARTA SELATAN,JAGAKARSA,JAGAKARSA,62389,21715,40674,26412,67086,2021-09-13
3175021007,JAKARTA TIMUR,PULO GADUNG,JATI,32757,11181,21576,16039,37615,2021-09-13
3174041002,JAKARTA SELATAN,PASAR MINGGU,JATI PADANG,37502,13761,23741,15376,39117,2021-09-13
3173071004,JAKARTA BARAT,PALMERAH,JATI PULO,28738,9360,19378,13437,32815,2021-09-13
3175061001,JAKARTA TIMUR,CAKUNG,JATINEGARA,84160,29638,54522,40298,94820,2021-09-13
3175021004,JAKARTA TIMUR,PULO GADUNG,JATINEGARA KAUM,24632,7946,16686,10873,27559,2021-09-13
3173021004,JAKARTA BARAT,GROGOL PETAMBURAN,JELAMBAR,30266,10363,19903,15279,35182,2021-09-13
3173021006,JAKARTA BARAT,GROGOL PETAMBURAN,JELAMBAR BARU,38246,12900,25346,19321,44667,2021-09-13
3173041006,JAKARTA BARAT,TAMBORA,JEMBATAN BESI,29314,11418,17896,11350,29246,2021-09-13
3173041008,JAKARTA BARAT,TAMBORA,JEMBATAN LIMA,21021,7781,13240,8802,22042,2021-09-13
3173081005,JAKARTA BARAT,KEMBANGAN,JOGLO,40839,14107,26732,19086,45818,2021-09-13
3171081001,JAKARTA PUSAT,JOHAR BARU,JOHAR BARU,37488,11528,25960,19072,45032,2021-09-13
3173041002,JAKARTA BARAT,TAMBORA,KALI ANYAR,23856,7853,16003,10894,26897,2021-09-13
3172041004,JAKARTA UTARA,CILINCING,KALIBARU,67684,26440,41244,25510,66754,2021-09-13
3174081002,JAKARTA SELATAN,PANCORAN,KALIBATA,41994,17274,24720,13697,38417,2021-09-13
3173061001,JAKARTA BARAT,KALI DERES,KALIDERES,72447,25548,46899,35509,82408,2021-09-13
3175051004,JAKARTA TIMUR,PASAR REBO,KALISARI,43212,14077,29135,21954,51089,2021-09-13
3173061004,JAKARTA BARAT,KALI DERES,KAMAL,53783,19656,34127,23360,57487,2021-09-13
3172011002,JAKARTA UTARA,PENJARINGAN,KAMAL MUARA,12930,3378,9552,7408,16960,2021-09-13
3171071007,JAKARTA PUSAT,TANAH ABANG,KAMPUNG BALI,11358,4258,7100,4734,11834,2021-09-13
3175031001,JAKARTA TIMUR,JATINEGARA,KAMPUNG MELAYU,25717,9993,15724,10802,26526,2021-09-13
3171081002,JAKARTA PUSAT,JOHAR BARU,KAMPUNG RAWA,21237,5571,15666,10781,26447,2021-09-13
3175041002,JAKARTA TIMUR,KRAMAT JATI,KAMPUNG TENGAH,43993,17133,26860,17686,44546,2021-09-13
3173011005,JAKARTA BARAT,CENGKARENG,KAPUK,134466,49965,84501,56118,140619,2021-09-13
3172011003,JAKARTA UTARA,PENJARINGAN,KAPUK MUARA,35781,10714,25067,20206,45273,2021-09-13
3171021002,JAKARTA PUSAT,SAWAH BESAR,KARANG ANYAR,25761,8307,17454,12638,30092,2021-09-13
3174021004,JAKARTA SELATAN,SETIA BUDI,KARET,9623,3581,6042,4042,10084,2021-09-13
3174021003,JAKARTA SELATAN,SETIA BUDI,KARET KUNINGAN,16055,5314,10741,7221,17962,2021-09-13
3174021002,JAKARTA SELATAN,SETIA BUDI,KARET SEMANGGI,2770,939,1831,1410,3241,2021-09-13
3171071003,JAKARTA PUSAT,TANAH ABANG,KARET TENGSIN,19271,6447,12824,8712,21536,2021-09-13
3171021003,JAKARTA PUSAT,SAWAH BESAR,KARTINI,22292,7449,14843,11247,26090,2021-09-13
3175011003,JAKARTA TIMUR,MATRAMAN,KAYU MANIS,25284,9544,15740,10579,26319,2021-09-13
3175021006,JAKARTA TIMUR,PULO GADUNG,KAYU PUTIH,40696,13377,27319,21048,48367,2021-09-13
3173031006,JAKARTA BARAT,TAMAN SARI,KEAGUNGAN,17387,5750,11637,8590,20227,2021-09-13
3174041007,JAKARTA SELATAN,PASAR MINGGU,KEBAGUSAN,44552,17010,27542,16661,44203,2021-09-13
3174051006,JAKARTA SELATAN,KEBAYORAN LAMA,KEBAYORAN LAMA SELATAN,41212,14707,26505,16049,42554,2021-09-13
3174051001,JAKARTA SELATAN,KEBAYORAN LAMA,KEBAYORAN LAMA UTARA,42422,16492,25930,14602,40532,2021-09-13
3174011004,JAKARTA SELATAN,TEBET,KEBON BARU,35165,12815,22350,13839,36189,2021-09-13
3172021005,JAKARTA UTARA,TANJUNG PRIOK,KEBON BAWANG,50952,17576,33376,23754,57130,2021-09-13
3173051001,JAKARTA BARAT,KEBON JERUK,KEBON JERUK,53887,19858,34029,23703,57732,2021-09-13
3171071006,JAKARTA PUSAT,TANAH ABANG,KEBON KACANG,21531,8436,13095,8983,22078,2021-09-13
3171011005,JAKARTA PUSAT,GAMBIR,KEBON KELAPA,10163,3492,6671,4906,11577,2021-09-13
3171031002,JAKARTA PUSAT,KEMAYORAN,KEBON KOSONG,30019,10390,19629,14225,33854,2021-09-13
3175011005,JAKARTA TIMUR,MATRAMAN,KEBON MANGGIS,16490,5680,10810,7748,18558,2021-09-13
3171071005,JAKARTA PUSAT,TANAH ABANG,KEBON MELATI,32206,13288,18918,12245,31163,2021-09-13
3175081003,JAKARTA TIMUR,MAKASAR,KEBON PALA,46614,16278,30336,21267,51603,2021-09-13
3171061005,JAKARTA PUSAT,MENTENG,KEBON SIRIH,12299,4362,7937,5637,13574,2021-09-13
3173011004,JAKARTA BARAT,CENGKARENG,KEDAUNG KALI ANGKE,32612,10287,22325,16739,39064,2021-09-13
3173051007,JAKARTA BARAT,KEBON JERUK,KEDOYA SELATAN,32165,10675,21490,15181,36671,2021-09-13
3173051006,JAKARTA BARAT,KEBON JERUK,KEDOYA UTARA,45740,14451,31289,23611,54900,2021-09-13
3173051004,JAKARTA BARAT,KEBON JERUK,KELAPA DUA,23565,8586,14979,10702,25681,2021-09-13
3175091003,JAKARTA TIMUR,CIRACAS,KELAPA DUA WETAN,46875,14492,32383,23442,55825,2021-09-13
3172061003,JAKARTA UTARA,KELAPA GADING,KELAPA GADING BARAT,35717,10792,24925,20163,45088,2021-09-13
3172061001,JAKARTA UTARA,KELAPA GADING,KELAPA GADING TIMUR,33592,9300,24292,19747,44039,2021-09-13
3173071005,JAKARTA BARAT,PALMERAH,KEMANGGISAN,32139,11013,21126,14921,36047,2021-09-13
3171031001,JAKARTA PUSAT,KEMAYORAN,KEMAYORAN,20708,6849,13859,10319,24178,2021-09-13
3173081006,JAKARTA BARAT,KEMBANGAN,KEMBANGAN SELATAN,27130,9351,17779,13781,31560,2021-09-13
3173081001,JAKARTA BARAT,KEMBANGAN,KEMBANGAN UTARA,54451,18599,35852,26241,62093,2021-09-13
3171041002,JAKARTA PUSAT,SENEN,KENARI,9579,3164,6415,4974,11389,2021-09-13
3173041005,JAKARTA BARAT,TAMBORA,KERENDANG,19973,6738,13235,9193,22428,2021-09-13
3175071003,JAKARTA TIMUR,DUREN SAWIT,KLENDER,69978,26566,43412,29692,73104,2021-09-13
3172031001,JAKARTA UTARA,KOJA,KOJA,28175,10270,17905,12818,30723,2021-09-13
3173071006,JAKARTA BARAT,PALMERAH,KOTA BAMBU SELATAN,21158,7377,13781,9232,23013,2021-09-13
3173071003,JAKARTA BARAT,PALMERAH,KOTA BAMBU UTARA,24995,8922,16073,10660,26733,2021-09-13
3171041004,JAKARTA PUSAT,SENEN,KRAMAT,28835,10415,18420,11840,30260,2021-09-13
3175041001,JAKARTA TIMUR,KRAMAT JATI,KRAMAT JATI,34144,12103,22041,15292,37333,2021-09-13
3174071003,JAKARTA SELATAN,KEBAYORAN BARU,KRAMAT PELA,14413,4995,9418,6080,15498,2021-09-13
3173031002,JAKARTA BARAT,TAMAN SARI,KRUKUT,19244,6440,12804,9174,21978,2021-09-13
3174031005,JAKARTA SELATAN,MAMPANG PRAPATAN,KUNINGAN BARAT,12785,4456,8329,5257,13586,2021-09-13
3174021008,JAKARTA SELATAN,SETIA BUDI,KUNINGAN TIMUR,6008,2125,3883,2630,6513,2021-09-13
3171041005,JAKARTA PUSAT,SENEN,KWITANG,15486,5422,10064,7240,17304,2021-09-13
3172031003,JAKARTA UTARA,KOJA,LAGOA,59065,21839,37226,24956,62182,2021-09-13
3174061002,JAKARTA SELATAN,CILANDAK,LEBAK BULUS,37626,14245,23381,15136,38517,2021-09-13
3174091004,JAKARTA SELATAN,JAGAKARSA,LENTENG AGUNG,53946,20401,33545,19407,52952,2021-09-13
3175101007,JAKARTA TIMUR,CIPAYUNG,LUBANG BUAYA,63547,20551,42996,31184,74180,2021-09-13
3175081001,JAKARTA TIMUR,MAKASAR,MAKASAR,34390,11523,22867,16665,39532,2021-09-13
3175071006,JAKARTA TIMUR,DUREN SAWIT,MALAKA JAYA,30927,10735,20192,15165,35357,2021-09-13
3175071005,JAKARTA TIMUR,DUREN SAWIT,MALAKA SARI,27530,9210,18320,14053,32373,2021-09-13
3174031001,JAKARTA SELATAN,MAMPANG PRAPATAN,MAMPANG PRAPATAN,18159,6648,11511,7452,18963,2021-09-13
3173031005,JAKARTA BARAT,TAMAN SARI,MANGGA BESAR,7707,2271,5436,4199,9635,2021-09-13
3171021005,JAKARTA PUSAT,SAWAH BESAR,MANGGA DUA SELATAN,27442,9117,18325,13641,31966,2021-09-13
3174011007,JAKARTA SELATAN,TEBET,MANGGARAI,28373,9450,18923,11335,30258,2021-09-13
3174011006,JAKARTA SELATAN,TEBET,MANGGARAI SELATAN,23075,7936,15139,9661,24800,2021-09-13
3173031003,JAKARTA BARAT,TAMAN SARI,MAPHAR,16461,5603,10858,8159,19017,2021-09-13
3172041003,JAKARTA UTARA,CILINCING,MARUNDA,28943,9532,19411,11912,31323,2021-09-13
3174071001,JAKARTA SELATAN,KEBAYORAN BARU,MELAWAI,2627,889,1738,1385,3123,2021-09-13
3171061001,JAKARTA PUSAT,MENTENG,MENTENG,25624,9318,16306,11504,27810,2021-09-13
3174021005,JAKARTA SELATAN,SETIA BUDI,MENTENG ATAS,27816,9436,18380,11487,29867,2021-09-13
3174011003,JAKARTA SELATAN,TEBET,MENTENG DALAM,36028,13043,22985,14690,37675,2021-09-13
3173081003,JAKARTA BARAT,KEMBANGAN,MERUYA SELATAN,32130,11168,20962,15529,36491,2021-09-13
3173081002,JAKARTA BARAT,KEMBANGAN,MERUYA UTARA,43752,15323,28429,21830,50259,2021-09-13
3175101004,JAKARTA TIMUR,CIPAYUNG,MUNJUL,23871,7793,16078,12007,28085,2021-09-13
3172051002,JAKARTA UTARA,PADEMANGAN,PADEMANGAN BARAT,74240,26754,47486,33143,80629,2021-09-13
3172051001,JAKARTA UTARA,PADEMANGAN,PADEMANGAN TIMUR,37736,11330,26406,20212,46618,2021-09-13
3175011004,JAKARTA TIMUR,MATRAMAN,PAL MERIAM,19769,7369,12400,8786,21186,2021-09-13
3173071001,JAKARTA BARAT,PALMERAH,PALMERAH,63011,22452,40559,27509,68068,2021-09-13
3174081001,JAKARTA SELATAN,PANCORAN,PANCORAN,19421,7171,12250,7548,19798,2021-09-13
3172021003,JAKARTA UTARA,TANJUNG PRIOK,PAPANGGO,39097,12581,26516,19126,45642,2021-09-13
3171021001,JAKARTA PUSAT,SAWAH BESAR,PASAR BARU,12035,3661,8374,6682,15056,2021-09-13
3174021006,JAKARTA SELATAN,SETIA BUDI,PASAR MANGGIS,26752,9691,17061,10712,27773,2021-09-13
3174041001,JAKARTA SELATAN,PASAR MINGGU,PASAR MINGGU,24821,9010,15811,10413,26224,2021-09-13
3171041003,JAKARTA PUSAT,SENEN,PASEBAN,23533,8417,15116,10529,25645,2021-09-13
3173061005,JAKARTA BARAT,KALI DERES,PEGADUNGAN,75587,24782,50805,39079,89884,2021-09-13
3171061002,JAKARTA PUSAT,MENTENG,PEGANGSAAN,23455,8366,15089,10113,25202,2021-09-13
3172061002,JAKARTA UTARA,KELAPA GADING,PEGANGSAAN DUA,49976,13814,36162,28995,65157,2021-09-13
3172011004,JAKARTA UTARA,PENJARINGAN,PEJAGALAN,74578,25356,49222,37509,86731,2021-09-13
3174041006,JAKARTA SELATAN,PASAR MINGGU,PEJATEN BARAT,37346,13976,23370,14960,38330,2021-09-13
3174041005,JAKARTA SELATAN,PASAR MINGGU,PEJATEN TIMUR,57656,22427,35229,20369,55598,2021-09-13
3175051005,JAKARTA TIMUR,PASAR REBO,PEKAYON,43250,14037,29213,21191,50404,2021-09-13
3173041009,JAKARTA BARAT,TAMBORA,PEKOJAN,23587,7561,16026,11775,27801,2021-09-13
3174031003,JAKARTA SELATAN,MAMPANG PRAPATAN,PELA MAMPANG,43522,15694,27828,18457,46285,2021-09-13
3174081005,JAKARTA SELATAN,PANCORAN,PENGADEGAN,21478,7138,14340,8045,22385,2021-09-13
3175061003,JAKARTA TIMUR,CAKUNG,PENGGILINGAN,99255,37514,61741,42803,104544,2021-09-13
3172011001,JAKARTA UTARA,PENJARINGAN,PENJARINGAN,88308,33166,55142,38351,93493,2021-09-13
3174101001,JAKARTA SELATAN,PESANGGRAHAN,PESANGGRAHAN,27545,9412,18133,11513,29646,2021-09-13
3171071004,JAKARTA PUSAT,TANAH ABANG,PETAMBURAN,33271,13843,19428,12699,32127,2021-09-13
3174071008,JAKARTA SELATAN,KEBAYORAN BARU,PETOGOGAN,11499,4271,7228,4796,12024,2021-09-13
3171011004,JAKARTA PUSAT,GAMBIR,PETOJO SELATAN,14692,5311,9381,6868,16249,2021-09-13
3171011003,JAKARTA PUSAT,GAMBIR,PETOJO UTARA,17458,6174,11284,8045,19329,2021-09-13
3174101004,JAKARTA SELATAN,PESANGGRAHAN,PETUKANGAN SELATAN,37187,13647,23540,14434,37974,2021-09-13
3174101003,JAKARTA SELATAN,PESANGGRAHAN,PETUKANGAN UTARA,53716,20858,32858,20563,53421,2021-09-13
3175081002,JAKARTA TIMUR,MAKASAR,PINANG RANTI,27198,9561,17637,12791,30428,2021-09-13
3173031008,JAKARTA BARAT,TAMAN SARI,PINANGSIA,10729,3274,7455,5545,13000,2021-09-13
3175011001,JAKARTA TIMUR,MATRAMAN,PISANGAN BARU,31776,11765,20011,13227,33238,2021-09-13
3175021002,JAKARTA TIMUR,PULO GADUNG,PISANGAN TIMUR,41011,13595,27416,20206,47622,2021-09-13
3172011005,JAKARTA UTARA,PENJARINGAN,PLUIT,47783,15264,32519,25556,58075,2021-09-13
3175071002,JAKARTA TIMUR,DUREN SAWIT,PONDOK BAMBU,61550,22764,38786,27590,66376,2021-09-13
3175071004,JAKARTA TIMUR,DUREN SAWIT,PONDOK KELAPA,72015,25372,46643,32815,79458,2021-09-13
3175071007,JAKARTA TIMUR,DUREN SAWIT,PONDOK KOPI,35367,13529,21838,13941,35779,2021-09-13
3174061003,JAKARTA SELATAN,CILANDAK,PONDOK LABU,46464,16056,30408,20702,51110,2021-09-13
3174051002,JAKARTA SELATAN,KEBAYORAN LAMA,PONDOK PINANG,56169,20819,35350,22645,57995,2021-09-13
3175101003,JAKARTA TIMUR,CIPAYUNG,PONDOK RANGGON,25574,8531,17043,12691,29734,2021-09-13
3101011003,KAB.ADM.KEP.SERIBU,KEP. SERIBU UTARA,PULAU HARAPAN,2060,333,1727,1049,2776,2021-09-13
3101011002,KAB.ADM.KEP.SERIBU,KEP. SERIBU UTARA,PULAU KELAPA,5528,882,4646,2691,7337,2021-09-13
3101011001,KAB.ADM.KEP.SERIBU,KEP. SERIBU UTARA,PULAU PANGGANG,5450,822,4628,2270,6898,2021-09-13
3101021003,KAB.ADM.KEP.SERIBU,KEP. SERIBU SELATAN,PULAU PARI,2765,312,2453,1660,4113,2021-09-13
3101021002,KAB.ADM.KEP.SERIBU,KEP. SERIBU SELATAN,PULAU TIDUNG,4553,600,3953,2763,6716,2021-09-13
3101021001,KAB.ADM.KEP.SERIBU,KEP. SERIBU SELATAN,PULAU UNTUNG JAWA,1941,309,1632,1099,2731,2021-09-13
3174071007,JAKARTA SELATAN,KEBAYORAN BARU,PULO,5835,1955,3880,2882,6762,2021-09-13
3175021001,JAKARTA TIMUR,PULO GADUNG,PULO GADUNG,34422,11986,22436,15908,38344,2021-09-13
3175061005,JAKARTA TIMUR,CAKUNG,PULO GEBANG,97301,33612,63689,43635,107324,2021-09-13
3174041004,JAKARTA SELATAN,PASAR MINGGU,RAGUNAN,39616,13895,25721,16629,42350,2021-09-13
3175091005,JAKARTA TIMUR,CIRACAS,RAMBUTAN,36771,13877,22894,16042,38936,2021-09-13
3172031006,JAKARTA UTARA,KOJA,RAWA BADAK SELATAN,42179,15523,26656,17860,44516,2021-09-13
3172031004,JAKARTA UTARA,KOJA,RAWA BADAK UTARA,34408,12472,21936,15474,37410,2021-09-13
3174071005,JAKARTA SELATAN,KEBAYORAN BARU,RAWA BARAT,5625,1864,3761,2629,6390,2021-09-13
3173011003,JAKARTA BARAT,CENGKARENG,RAWA BUAYA,63799,22386,41413,28458,69871,2021-09-13
3175031004,JAKARTA TIMUR,JATINEGARA,RAWA BUNGA,21434,8206,13228,9409,22637,2021-09-13
3174081003,JAKARTA SELATAN,PANCORAN,RAWA JATI,20509,7332,13177,8050,21227,2021-09-13
3175061002,JAKARTA TIMUR,CAKUNG,RAWA TERATE,24637,7557,17080,12708,29788,2021-09-13
3175021005,JAKARTA TIMUR,PULO GADUNG,RAWAMANGUN,37612,13100,24512,17968,42480,2021-09-13
3171051003,JAKARTA PUSAT,CEMPAKA PUTIH,RAWASARI,21967,7780,14187,10574,24761,2021-09-13
3173041010,JAKARTA BARAT,TAMBORA,ROA MALAKA,3484,1021,2463,1907,4370,2021-09-13
3172041006,JAKARTA UTARA,CILINCING,ROROTAN,41668,13423,28245,19212,47457,2021-09-13
3174071004,JAKARTA SELATAN,KEBAYORAN BARU,SELONG,2842,969,1873,1430,3303,2021-09-13
3173061002,JAKARTA BARAT,KALI DERES,SEMANAN,71354,25843,45511,31714,77225,2021-09-13
3172041007,JAKARTA UTARA,CILINCING,SEMPER BARAT,68587,21929,46658,34142,80800,2021-09-13
3172041005,JAKARTA UTARA,CILINCING,SEMPER TIMUR,36267,12143,24124,16853,40977,2021-09-13
3174071006,JAKARTA SELATAN,KEBAYORAN BARU,SENAYAN,2771,1113,1658,1133,2791,2021-09-13
3171041001,JAKARTA PUSAT,SENEN,SENEN,6804,2222,4582,3489,8071,2021-09-13
3171031004,JAKARTA PUSAT,KEMAYORAN,SERDANG,29668,10161,19507,14101,33608,2021-09-13
3174021001,JAKARTA SELATAN,SETIA BUDI,SETIA BUDI,3023,1100,1923,1325,3248,2021-09-13
3175101005,JAKARTA TIMUR,CIPAYUNG,SETU,20572,7432,13140,9223,22363,2021-09-13
3173071002,JAKARTA BARAT,PALMERAH,SLIPI,16591,5470,11121,8093,19214,2021-09-13
3173081004,JAKARTA BARAT,KEMBANGAN,SRENGSENG,45523,16625,28898,20455,49353,2021-09-13
3174091002,JAKARTA SELATAN,JAGAKARSA,SRENGSENG SAWAH,58196,18793,39403,24870,64273,2021-09-13
3173051003,JAKARTA BARAT,KEBON JERUK,SUKABUMI SELATAN,37033,13583,23450,14319,37769,2021-09-13
3173051002,JAKARTA BARAT,KEBON JERUK,SUKABUMI UTARA,38290,14490,23800,14542,38342,2021-09-13
3172041002,JAKARTA UTARA,CILINCING,SUKAPURA,53949,19106,34843,25331,60174,2021-09-13
3171031007,JAKARTA PUSAT,KEMAYORAN,SUMUR BATU,22717,7947,14770,10962,25732,2021-09-13
3172021004,JAKARTA UTARA,TANJUNG PRIOK,SUNGAI BAMBU,29876,10111,19765,14470,34235,2021-09-13
3172021006,JAKARTA UTARA,TANJUNG PRIOK,SUNTER AGUNG,71805,21234,50571,39509,90080,2021-09-13
3172021002,JAKARTA UTARA,TANJUNG PRIOK,SUNTER JAYA,63031,19373,43658,34392,78050,2021-09-13
3175091004,JAKARTA TIMUR,CIRACAS,SUSUKAN,38257,12204,26053,18349,44402,2021-09-13
3173031001,JAKARTA BARAT,TAMAN SARI,TAMAN SARI,14348,4799,9549,7428,16977,2021-09-13
3173041001,JAKARTA BARAT,TAMBORA,TAMBORA,10204,3568,6636,4503,11139,2021-09-13
3173041004,JAKARTA BARAT,TAMBORA,TANAH SEREAL,26387,7711,18676,13285,31961,2021-09-13
3171081004,JAKARTA PUSAT,JOHAR BARU,TANAH TINGGI,37693,11146,26547,18396,44943,2021-09-13
3173031004,JAKARTA BARAT,TAMAN SARI,TANGKI,13324,4312,9012,6866,15878,2021-09-13
3174091005,JAKARTA SELATAN,JAGAKARSA,TANJUNG BARAT,39770,13981,25789,15307,41096,2021-09-13
3173021005,JAKARTA BARAT,GROGOL PETAMBURAN,TANJUNG DUREN SELATAN,25337,8654,16683,12707,29390,2021-09-13
3173021002,JAKARTA BARAT,GROGOL PETAMBURAN,TANJUNG DUREN UTARA,17010,5487,11523,8745,20268,2021-09-13
3172021001,JAKARTA UTARA,TANJUNG PRIOK,TANJUNG PRIOK,34588,11192,23396,16493,39889,2021-09-13
3174011002,JAKARTA SELATAN,TEBET,TEBET BARAT,21194,6990,14204,9608,23812,2021-09-13
3174011001,JAKARTA SELATAN,TEBET,TEBET TIMUR,18199,6000,12199,8248,20447,2021-09-13
3173061003,JAKARTA BARAT,KALI DERES,TEGAL ALUR,83647,28933,54714,37168,91882,2021-09-13
3174031004,JAKARTA SELATAN,MAMPANG PRAPATAN,TEGAL PARANG,32401,12634,19767,11700,31467,2021-09-13
3173021003,JAKARTA BARAT,GROGOL PETAMBURAN,TOMANG,29605,9966,19639,15202,34841,2021-09-13
3172031005,JAKARTA UTARA,KOJA,TUGU SELATAN,39122,13671,25451,17477,42928,2021-09-13
3172031002,JAKARTA UTARA,KOJA,TUGU UTARA,67670,25035,42635,29130,71765,2021-09-13
3175061006,JAKARTA TIMUR,CAKUNG,UJUNG MENTENG,29934,9499,20435,15239,35674,2021-09-13
3174101005,JAKARTA SELATAN,PESANGGRAHAN,ULUJAMI,40544,16138,24406,14319,38725,2021-09-13
3175011006,JAKARTA TIMUR,MATRAMAN,UTAN KAYU SELATAN,33511,11185,22326,15890,38216,2021-09-13
3175011002,JAKARTA TIMUR,MATRAMAN,UTAN KAYU UTARA,28169,10360,17809,12464,30273,2021-09-13
3171031008,JAKARTA PUSAT,KEMAYORAN,UTAN PANJANG,29208,10375,18833,13308,32141,2021-09-13
3172021007,JAKARTA UTARA,TANJUNG PRIOK,WARAKAS,44401,14257,30144,21082,51226,2021-09-13
3173021007,JAKARTA BARAT,GROGOL PETAMBURAN,WIJAYA KUSUMA,38934,13972,24962,18514,43476,2021-09-13
3172051003,JAKARTA UTARA,PADEMANGAN,ANCOL,23947,8801,15146,11175,26321,2021-09-14
3173041007,JAKARTA BARAT,TAMBORA,ANGKE,29381,9933,19448,13157,32605,2021-09-14
3175041005,JAKARTA TIMUR,KRAMAT JATI,BALE KAMBANG,29074,11745,17329,10656,27985,2021-09-14
3175031003,JAKARTA TIMUR,JATINEGARA,BALI MESTER,9752,3529,6223,4585,10808,2021-09-14
3175101006,JAKARTA TIMUR,CIPAYUNG,BAMBU APUS,26285,8857,17428,12846,30274,2021-09-14
3174031002,JAKARTA SELATAN,MAMPANG PRAPATAN,BANGKA,21566,8259,13307,8437,21744,2021-09-14
3175051002,JAKARTA TIMUR,PASAR REBO,BARU,23886,7273,16613,12965,29578,2021-09-14
3175041004,JAKARTA TIMUR,KRAMAT JATI,BATU AMPAR,47898,18761,29137,19823,48960,2021-09-14
3171071002,JAKARTA PUSAT,TANAH ABANG,BENDUNGAN HILIR,21494,7669,13825,10037,23862,2021-09-14
3175031002,JAKARTA TIMUR,JATINEGARA,BIDARA CINA,36689,14503,22186,15534,37720,2021-09-14
3174101002,JAKARTA SELATAN,PESANGGRAHAN,BINTARO,53098,19928,33170,21465,54635,2021-09-14
3174011005,JAKARTA SELATAN,TEBET,BUKIT DURI,34183,13127,21056,12653,33709,2021-09-14
3171041006,JAKARTA PUSAT,SENEN,BUNGUR,18144,6165,11979,8689,20668,2021-09-14
3175061007,JAKARTA TIMUR,CAKUNG,CAKUNG BARAT,57724,18535,39189,28521,67710,2021-09-14
3175061004,JAKARTA TIMUR,CAKUNG,CAKUNG TIMUR,58287,18842,39445,29631,69076,2021-09-14
3175041007,JAKARTA TIMUR,KRAMAT JATI,CAWANG,32762,12080,20682,14171,34853,2021-09-14
3175101008,JAKARTA TIMUR,CIPAYUNG,CEGER,18932,6327,12605,9348,21953,2021-09-14
3171031006,JAKARTA PUSAT,KEMAYORAN,CEMPAKA BARU,32581,11377,21204,14806,36010,2021-09-14
3171051002,JAKARTA PUSAT,CEMPAKA PUTIH,CEMPAKA PUTIH BARAT,35885,12618,23267,17766,41033,2021-09-14
3171051001,JAKARTA PUSAT,CEMPAKA PUTIH,CEMPAKA PUTIH TIMUR,24292,8219,16073,12226,28299,2021-09-14
3173011001,JAKARTA BARAT,CENGKARENG,CENGKARENG BARAT,66284,22450,43834,33359,77193,2021-09-14
3173011006,JAKARTA BARAT,CENGKARENG,CENGKARENG TIMUR,81027,26793,54234,37886,92120,2021-09-14
3175091002,JAKARTA TIMUR,CIRACAS,CIBUBUR,66364,20766,45598,33851,79449,2021-09-14
3171011002,JAKARTA PUSAT,GAMBIR,CIDENG,15390,5022,10368,7957,18325,2021-09-14
3174091003,JAKARTA SELATAN,JAGAKARSA,CIGANJUR,38497,13831,24666,15012,39678,2021-09-14
3175051003,JAKARTA TIMUR,PASAR REBO,CIJANTUNG,41419,13187,28232,21157,49389,2021-09-14
3171061003,JAKARTA PUSAT,MENTENG,CIKINI,8274,2733,5541,3797,9338,2021-09-14
3174081006,JAKARTA SELATAN,PANCORAN,CIKOKO,10547,3597,6950,4229,11179,2021-09-14
3174061001,JAKARTA SELATAN,CILANDAK,CILANDAK BARAT,51752,18540,33212,21453,54665,2021-09-14
3174041003,JAKARTA SELATAN,PASAR MINGGU,CILANDAK TIMUR,25145,8893,16252,11026,27278,2021-09-14
3175101002,JAKARTA TIMUR,CIPAYUNG,CILANGKAP,27635,9145,18490,13723,32213,2021-09-14
3175041006,JAKARTA TIMUR,KRAMAT JATI,CILILITAN,40181,15284,24897,17853,42750,2021-09-14
3172041001,JAKARTA UTARA,CILINCING,CILINCING,43609,15914,27695,18800,46495,2021-09-14
3175101001,JAKARTA TIMUR,CIPAYUNG,CIPAYUNG,26104,7945,18159,14003,32162,2021-09-14
3174091006,JAKARTA SELATAN,JAGAKARSA,CIPEDAK,38303,12794,25509,16172,41681,2021-09-14
3174061005,JAKARTA SELATAN,CILANDAK,CIPETE SELATAN,26704,10005,16699,11470,28169,2021-09-14
3174071010,JAKARTA SELATAN,KEBAYORAN BARU,CIPETE UTARA,34102,12459,21643,13716,35359,2021-09-14
3175021003,JAKARTA TIMUR,PULO GADUNG,CIPINANG,39306,13678,25628,18427,44055,2021-09-14
3175031007,JAKARTA TIMUR,JATINEGARA,CIPINANG BESAR SELATAN,35212,13284,21928,14785,36713,2021-09-14
3175031008,JAKARTA TIMUR,JATINEGARA,CIPINANG BESAR UTARA,45319,17096,28223,19420,47643,2021-09-14
3175031005,JAKARTA TIMUR,JATINEGARA,CIPINANG CEMPEDAK,32824,12637,20187,15135,35322,2021-09-14
3175081005,JAKARTA TIMUR,MAKASAR,CIPINANG MELAYU,42308,15256,27052,20355,47407,2021-09-14
3175031006,JAKARTA TIMUR,JATINEGARA,CIPINANG MUARA,55243,20733,34510,24586,59096,2021-09-14
3174051003,JAKARTA SELATAN,KEBAYORAN LAMA,CIPULIR,39937,15914,24023,13666,37689,2021-09-14
3175091001,JAKARTA TIMUR,CIRACAS,CIRACAS,64594,20097,44497,32275,76772,2021-09-14
3175041003,JAKARTA TIMUR,KRAMAT JATI,DUKUH,24609,8178,16431,11742,28173,2021-09-14
3175071001,JAKARTA TIMUR,DUREN SAWIT,DUREN SAWIT,61160,22736,38424,27839,66263,2021-09-14
3174081004,JAKARTA SELATAN,PANCORAN,DUREN TIGA,28319,10429,17890,10035,27925,2021-09-14
3173051005,JAKARTA BARAT,KEBON JERUK,DURI KEPA,60138,19789,40349,30475,70824,2021-09-14
3173011002,JAKARTA BARAT,CENGKARENG,DURI KOSAMBI,77923,29172,48751,33586,82337,2021-09-14
3171011006,JAKARTA PUSAT,GAMBIR,DURI PULO,19610,6722,12888,9107,21995,2021-09-14
3173041011,JAKARTA BARAT,TAMBORA,DURI SELATAN,14259,4418,9841,7334,17175,2021-09-14
3173041003,JAKARTA BARAT,TAMBORA,DURI UTARA,19844,6457,13387,9523,22910,2021-09-14
3171081003,JAKARTA PUSAT,JOHAR BARU,GALUR,18243,5454,12789,9091,21880,2021-09-14
3171011001,JAKARTA PUSAT,GAMBIR,GAMBIR,2191,719,1472,1144,2616,2021-09-14
3174061004,JAKARTA SELATAN,CILANDAK,GANDARIA SELATAN,22119,8221,13898,8553,22451,2021-09-14
3174071009,JAKARTA SELATAN,KEBAYORAN BARU,GANDARIA UTARA,39922,14929,24993,15958,40951,2021-09-14
3175051001,JAKARTA TIMUR,PASAR REBO,GEDONG,35755,11997,23758,17694,41452,2021-09-14
3171071001,JAKARTA PUSAT,TANAH ABANG,GELORA,3127,1151,1976,1367,3343,2021-09-14
3173031007,JAKARTA BARAT,TAMAN SARI,GLODOK,7837,2286,5551,4509,10060,2021-09-14
3171061004,JAKARTA PUSAT,MENTENG,GONDANGDIA,4100,1445,2655,2192,4847,2021-09-14
3173021001,JAKARTA BARAT,GROGOL PETAMBURAN,GROGOL,16876,5844,11032,8218,19250,2021-09-14
3174051005,JAKARTA SELATAN,KEBAYORAN LAMA,GROGOL SELATAN,44251,16865,27386,16320,43706,2021-09-14
3174051004,JAKARTA SELATAN,KEBAYORAN LAMA,GROGOL UTARA,42494,15893,26601,16234,42835,2021-09-14
3174021007,JAKARTA SELATAN,SETIA BUDI,GUNTUR,3985,1361,2624,1944,4568,2021-09-14
3174071002,JAKARTA SELATAN,KEBAYORAN BARU,GUNUNG,9436,3315,6121,4342,10463,2021-09-14
3171031005,JAKARTA PUSAT,KEMAYORAN,GUNUNG SAHARI SELATAN,19199,6613,12586,9587,22173,2021-09-14
3171021004,JAKARTA PUSAT,SAWAH BESAR,GUNUNG SAHARI UTARA,16650,4958,11692,9360,21052,2021-09-14
3175081004,JAKARTA TIMUR,MAKASAR,HALIM PERDANA KUSUMAH,28363,7599,20764,17357,38121,2021-09-14
3171031003,JAKARTA PUSAT,KEMAYORAN,HARAPAN MULIA,22557,7666,14891,11059,25950,2021-09-14
3174091001,JAKARTA SELATAN,JAGAKARSA,JAGAKARSA,62389,21701,40688,26468,67156,2021-09-14
3175021007,JAKARTA TIMUR,PULO GADUNG,JATI,32757,11134,21623,16269,37892,2021-09-14
3174041002,JAKARTA SELATAN,PASAR MINGGU,JATI PADANG,37502,13757,23745,15411,39156,2021-09-14
3173071004,JAKARTA BARAT,PALMERAH,JATI PULO,28738,9310,19428,13648,33076,2021-09-14
3175061001,JAKARTA TIMUR,CAKUNG,JATINEGARA,84160,29388,54772,40706,95478,2021-09-14
3175021004,JAKARTA TIMUR,PULO GADUNG,JATINEGARA KAUM,24632,7910,16722,11028,27750,2021-09-14
3173021004,JAKARTA BARAT,GROGOL PETAMBURAN,JELAMBAR,30266,10307,19959,15497,35456,2021-09-14
3173021006,JAKARTA BARAT,GROGOL PETAMBURAN,JELAMBAR BARU,38246,12843,25403,19617,45020,2021-09-14
3173041006,JAKARTA BARAT,TAMBORA,JEMBATAN BESI,29314,11392,17922,11537,29459,2021-09-14
3173041008,JAKARTA BARAT,TAMBORA,JEMBATAN LIMA,21021,7743,13278,9009,22287,2021-09-14
3173081005,JAKARTA BARAT,KEMBANGAN,JOGLO,40839,14033,26806,19311,46117,2021-09-14
3171081001,JAKARTA PUSAT,JOHAR BARU,JOHAR BARU,37488,11468,26020,19479,45499,2021-09-14
3173041002,JAKARTA BARAT,TAMBORA,KALI ANYAR,23856,7811,16045,11122,27167,2021-09-14
3172041004,JAKARTA UTARA,CILINCING,KALIBARU,67684,26337,41347,25909,67256,2021-09-14
3174081002,JAKARTA SELATAN,PANCORAN,KALIBATA,41994,17262,24732,13737,38469,2021-09-14
3173061001,JAKARTA BARAT,KALI DERES,KALIDERES,72447,25411,47036,36161,83197,2021-09-14
3175051004,JAKARTA TIMUR,PASAR REBO,KALISARI,43212,14014,29198,22256,51454,2021-09-14
3173061004,JAKARTA BARAT,KALI DERES,KAMAL,53783,19596,34187,23752,57939,2021-09-14
3172011002,JAKARTA UTARA,PENJARINGAN,KAMAL MUARA,12930,3371,9559,7578,17137,2021-09-14
3171071007,JAKARTA PUSAT,TANAH ABANG,KAMPUNG BALI,11358,4216,7142,4816,11958,2021-09-14
3175031001,JAKARTA TIMUR,JATINEGARA,KAMPUNG MELAYU,25717,9945,15772,10953,26725,2021-09-14
3171081002,JAKARTA PUSAT,JOHAR BARU,KAMPUNG RAWA,21237,5552,15685,10996,26681,2021-09-14
3175041002,JAKARTA TIMUR,KRAMAT JATI,KAMPUNG TENGAH,43993,17076,26917,17927,44844,2021-09-14
3173011005,JAKARTA BARAT,CENGKARENG,KAPUK,134466,49656,84810,57412,142222,2021-09-14
3172011003,JAKARTA UTARA,PENJARINGAN,KAPUK MUARA,35781,10669,25112,20444,45556,2021-09-14
3171021002,JAKARTA PUSAT,SAWAH BESAR,KARANG ANYAR,25761,8257,17504,12920,30424,2021-09-14
3174021004,JAKARTA SELATAN,SETIA BUDI,KARET,9623,3576,6047,4061,10108,2021-09-14
3174021003,JAKARTA SELATAN,SETIA BUDI,KARET KUNINGAN,16055,5311,10744,7239,17983,2021-09-14
3174021002,JAKARTA SELATAN,SETIA BUDI,KARET SEMANGGI,2770,938,1832,1417,3249,2021-09-14
3171071003,JAKARTA PUSAT,TANAH ABANG,KARET TENGSIN,19271,6419,12852,8854,21706,2021-09-14
3171021003,JAKARTA PUSAT,SAWAH BESAR,KARTINI,22292,7400,14892,11462,26354,2021-09-14
3175011003,JAKARTA TIMUR,MATRAMAN,KAYU MANIS,25284,9477,15807,10739,26546,2021-09-14
3175021006,JAKARTA TIMUR,PULO GADUNG,KAYU PUTIH,40696,13325,27371,21306,48677,2021-09-14
3173031006,JAKARTA BARAT,TAMAN SARI,KEAGUNGAN,17387,5727,11660,8706,20366,2021-09-14
3174041007,JAKARTA SELATAN,PASAR MINGGU,KEBAGUSAN,44552,16999,27553,16703,44256,2021-09-14
3174051006,JAKARTA SELATAN,KEBAYORAN LAMA,KEBAYORAN LAMA SELATAN,41212,14695,26517,16109,42626,2021-09-14
3174051001,JAKARTA SELATAN,KEBAYORAN LAMA,KEBAYORAN LAMA UTARA,42422,16486,25936,14644,40580,2021-09-14
3174011004,JAKARTA SELATAN,TEBET,KEBON BARU,35165,12796,22369,13907,36276,2021-09-14
3172021005,JAKARTA UTARA,TANJUNG PRIOK,KEBON BAWANG,50952,17516,33436,24326,57762,2021-09-14
3173051001,JAKARTA BARAT,KEBON JERUK,KEBON JERUK,53887,19782,34105,24151,58256,2021-09-14
3171071006,JAKARTA PUSAT,TANAH ABANG,KEBON KACANG,21531,8408,13123,9077,22200,2021-09-14
3171011005,JAKARTA PUSAT,GAMBIR,KEBON KELAPA,10163,3472,6691,4982,11673,2021-09-14
3171031002,JAKARTA PUSAT,KEMAYORAN,KEBON KOSONG,30019,10342,19677,14546,34223,2021-09-14
3175011005,JAKARTA TIMUR,MATRAMAN,KEBON MANGGIS,16490,5649,10841,7871,18712,2021-09-14
3171071005,JAKARTA PUSAT,TANAH ABANG,KEBON MELATI,32206,13228,18978,12422,31400,2021-09-14
3175081003,JAKARTA TIMUR,MAKASAR,KEBON PALA,46614,16221,30393,21533,51926,2021-09-14
3171061005,JAKARTA PUSAT,MENTENG,KEBON SIRIH,12299,4326,7973,5701,13674,2021-09-14
3173011004,JAKARTA BARAT,CENGKARENG,KEDAUNG KALI ANGKE,32612,10221,22391,16846,39237,2021-09-14
3173051007,JAKARTA BARAT,KEBON JERUK,KEDOYA SELATAN,32165,10638,21527,15477,37004,2021-09-14
3173051006,JAKARTA BARAT,KEBON JERUK,KEDOYA UTARA,45740,14417,31323,23990,55313,2021-09-14
3173051004,JAKARTA BARAT,KEBON JERUK,KELAPA DUA,23565,8560,15005,10952,25957,2021-09-14
3175091003,JAKARTA TIMUR,CIRACAS,KELAPA DUA WETAN,46875,14405,32470,23905,56375,2021-09-14
3172061003,JAKARTA UTARA,KELAPA GADING,KELAPA GADING BARAT,35717,10749,24968,20546,45514,2021-09-14
3172061001,JAKARTA UTARA,KELAPA GADING,KELAPA GADING TIMUR,33592,9259,24333,20031,44364,2021-09-14
3173071005,JAKARTA BARAT,PALMERAH,KEMANGGISAN,32139,10904,21235,15175,36410,2021-09-14
3171031001,JAKARTA PUSAT,KEMAYORAN,KEMAYORAN,20708,6811,13897,10481,24378,2021-09-14
3173081006,JAKARTA BARAT,KEMBANGAN,KEMBANGAN SELATAN,27130,9327,17803,13889,31692,2021-09-14
3173081001,JAKARTA BARAT,KEMBANGAN,KEMBANGAN UTARA,54451,18483,35968,26592,62560,2021-09-14
3171041002,JAKARTA PUSAT,SENEN,KENARI,9579,3149,6430,5018,11448,2021-09-14
3173041005,JAKARTA BARAT,TAMBORA,KERENDANG,19973,6712,13261,9316,22577,2021-09-14
3175071003,JAKARTA TIMUR,DUREN SAWIT,KLENDER,69978,26419,43559,30191,73750,2021-09-14
3172031001,JAKARTA UTARA,KOJA,KOJA,28175,10205,17970,13129,31099,2021-09-14
3173071006,JAKARTA BARAT,PALMERAH,KOTA BAMBU SELATAN,21158,7301,13857,9431,23288,2021-09-14
3173071003,JAKARTA BARAT,PALMERAH,KOTA BAMBU UTARA,24995,8871,16124,10870,26994,2021-09-14
3171041004,JAKARTA PUSAT,SENEN,KRAMAT,28835,10350,18485,12048,30533,2021-09-14
3175041001,JAKARTA TIMUR,KRAMAT JATI,KRAMAT JATI,34144,12045,22099,15517,37616,2021-09-14
3174071003,JAKARTA SELATAN,KEBAYORAN BARU,KRAMAT PELA,14413,4995,9418,6095,15513,2021-09-14
3173031002,JAKARTA BARAT,TAMAN SARI,KRUKUT,19244,6417,12827,9377,22204,2021-09-14
3174031005,JAKARTA SELATAN,MAMPANG PRAPATAN,KUNINGAN BARAT,12785,4454,8331,5269,13600,2021-09-14
3174021008,JAKARTA SELATAN,SETIA BUDI,KUNINGAN TIMUR,6008,2122,3886,2637,6523,2021-09-14
3171041005,JAKARTA PUSAT,SENEN,KWITANG,15486,5404,10082,7399,17481,2021-09-14
3172031003,JAKARTA UTARA,KOJA,LAGOA,59065,21713,37352,25342,62694,2021-09-14
3174061002,JAKARTA SELATAN,CILANDAK,LEBAK BULUS,37626,14240,23386,15178,38564,2021-09-14
3174091004,JAKARTA SELATAN,JAGAKARSA,LENTENG AGUNG,53946,20390,33556,19466,53022,2021-09-14
3175101007,JAKARTA TIMUR,CIPAYUNG,LUBANG BUAYA,63547,20483,43064,31515,74579,2021-09-14
3175081001,JAKARTA TIMUR,MAKASAR,MAKASAR,34390,11484,22906,16974,39880,2021-09-14
3175071006,JAKARTA TIMUR,DUREN SAWIT,MALAKA JAYA,30927,10689,20238,15387,35625,2021-09-14
3175071005,JAKARTA TIMUR,DUREN SAWIT,MALAKA SARI,27530,9168,18362,14238,32600,2021-09-14
3174031001,JAKARTA SELATAN,MAMPANG PRAPATAN,MAMPANG PRAPATAN,18159,6645,11514,7470,18984,2021-09-14
3173031005,JAKARTA BARAT,TAMAN SARI,MANGGA BESAR,7707,2260,5447,4276,9723,2021-09-14
3171021005,JAKARTA PUSAT,SAWAH BESAR,MANGGA DUA SELATAN,27442,9055,18387,13899,32286,2021-09-14
3174011007,JAKARTA SELATAN,TEBET,MANGGARAI,28373,9429,18944,11401,30345,2021-09-14
3174011006,JAKARTA SELATAN,TEBET,MANGGARAI SELATAN,23075,7921,15154,9696,24850,2021-09-14
3173031003,JAKARTA BARAT,TAMAN SARI,MAPHAR,16461,5578,10883,8299,19182,2021-09-14
3172041003,JAKARTA UTARA,CILINCING,MARUNDA,28943,9474,19469,12258,31727,2021-09-14
3174071001,JAKARTA SELATAN,KEBAYORAN BARU,MELAWAI,2627,889,1738,1386,3124,2021-09-14
3171061001,JAKARTA PUSAT,MENTENG,MENTENG,25624,9283,16341,11630,27971,2021-09-14
3174021005,JAKARTA SELATAN,SETIA BUDI,MENTENG ATAS,27816,9425,18391,11544,29935,2021-09-14
3174011003,JAKARTA SELATAN,TEBET,MENTENG DALAM,36028,13027,23001,14746,37747,2021-09-14
3173081003,JAKARTA BARAT,KEMBANGAN,MERUYA SELATAN,32130,11078,21052,15685,36737,2021-09-14
3173081002,JAKARTA BARAT,KEMBANGAN,MERUYA UTARA,43752,15243,28509,22108,50617,2021-09-14
3175101004,JAKARTA TIMUR,CIPAYUNG,MUNJUL,23871,7760,16111,12113,28224,2021-09-14
3172051002,JAKARTA UTARA,PADEMANGAN,PADEMANGAN BARAT,74240,26632,47608,33797,81405,2021-09-14
3172051001,JAKARTA UTARA,PADEMANGAN,PADEMANGAN TIMUR,37736,11281,26455,20579,47034,2021-09-14
3175011004,JAKARTA TIMUR,MATRAMAN,PAL MERIAM,19769,7338,12431,8925,21356,2021-09-14
3173071001,JAKARTA BARAT,PALMERAH,PALMERAH,63011,22345,40666,28043,68709,2021-09-14
3174081001,JAKARTA SELATAN,PANCORAN,PANCORAN,19421,7169,12252,7558,19810,2021-09-14
3172021003,JAKARTA UTARA,TANJUNG PRIOK,PAPANGGO,39097,12546,26551,19410,45961,2021-09-14
3171021001,JAKARTA PUSAT,SAWAH BESAR,PASAR BARU,12035,3649,8386,6775,15161,2021-09-14
3174021006,JAKARTA SELATAN,SETIA BUDI,PASAR MANGGIS,26752,9680,17072,10763,27835,2021-09-14
3174041001,JAKARTA SELATAN,PASAR MINGGU,PASAR MINGGU,24821,9000,15821,10435,26256,2021-09-14
3171041003,JAKARTA PUSAT,SENEN,PASEBAN,23533,8382,15151,10758,25909,2021-09-14
3173061005,JAKARTA BARAT,KALI DERES,PEGADUNGAN,75587,24666,50921,39777,90698,2021-09-14
3171061002,JAKARTA PUSAT,MENTENG,PEGANGSAAN,23455,8319,15136,10268,25404,2021-09-14
3172061002,JAKARTA UTARA,KELAPA GADING,PEGANGSAAN DUA,49976,13745,36231,29397,65628,2021-09-14
3172011004,JAKARTA UTARA,PENJARINGAN,PEJAGALAN,74578,25197,49381,38172,87553,2021-09-14
3174041006,JAKARTA SELATAN,PASAR MINGGU,PEJATEN BARAT,37346,13975,23371,14989,38360,2021-09-14
3174041005,JAKARTA SELATAN,PASAR MINGGU,PEJATEN TIMUR,57656,22419,35237,20427,55664,2021-09-14
3175051005,JAKARTA TIMUR,PASAR REBO,PEKAYON,43250,13943,29307,21532,50839,2021-09-14
3173041009,JAKARTA BARAT,TAMBORA,PEKOJAN,23587,7525,16062,11999,28061,2021-09-14
3174031003,JAKARTA SELATAN,MAMPANG PRAPATAN,PELA MAMPANG,43522,15683,27839,18506,46345,2021-09-14
3174081005,JAKARTA SELATAN,PANCORAN,PENGADEGAN,21478,7129,14349,8087,22436,2021-09-14
3175061003,JAKARTA TIMUR,CAKUNG,PENGGILINGAN,99255,37205,62050,43264,105314,2021-09-14
3172011001,JAKARTA UTARA,PENJARINGAN,PENJARINGAN,88308,33019,55289,38900,94189,2021-09-14
3174101001,JAKARTA SELATAN,PESANGGRAHAN,PESANGGRAHAN,27545,9409,18136,11533,29669,2021-09-14
3171071004,JAKARTA PUSAT,TANAH ABANG,PETAMBURAN,33271,13697,19574,12899,32473,2021-09-14
3174071008,JAKARTA SELATAN,KEBAYORAN BARU,PETOGOGAN,11499,4268,7231,4810,12041,2021-09-14
3171011004,JAKARTA PUSAT,GAMBIR,PETOJO SELATAN,14692,5294,9398,6977,16375,2021-09-14
3171011003,JAKARTA PUSAT,GAMBIR,PETOJO UTARA,17458,6158,11300,8130,19430,2021-09-14
3174101004,JAKARTA SELATAN,PESANGGRAHAN,PETUKANGAN SELATAN,37187,13637,23550,14471,38021,2021-09-14
3174101003,JAKARTA SELATAN,PESANGGRAHAN,PETUKANGAN UTARA,53716,20850,32866,20619,53485,2021-09-14
3175081002,JAKARTA TIMUR,MAKASAR,PINANG RANTI,27198,9522,17676,12899,30575,2021-09-14
3173031008,JAKARTA BARAT,TAMAN SARI,PINANGSIA,10729,3260,7469,5631,13100,2021-09-14
3175011001,JAKARTA TIMUR,MATRAMAN,PISANGAN BARU,31776,11692,20084,13413,33497,2021-09-14
3175021002,JAKARTA TIMUR,PULO GADUNG,PISANGAN TIMUR,41011,13535,27476,20449,47925,2021-09-14
3172011005,JAKARTA UTARA,PENJARINGAN,PLUIT,47783,15182,32601,25872,58473,2021-09-14
3175071002,JAKARTA TIMUR,DUREN SAWIT,PONDOK BAMBU,61550,22635,38915,28276,67191,2021-09-14
3175071004,JAKARTA TIMUR,DUREN SAWIT,PONDOK KELAPA,72015,25305,46710,32995,79705,2021-09-14
3175071007,JAKARTA TIMUR,DUREN SAWIT,PONDOK KOPI,35367,13396,21971,14154,36125,2021-09-14
3174061003,JAKARTA SELATAN,CILANDAK,PONDOK LABU,46464,16051,30413,20752,51165,2021-09-14
3174051002,JAKARTA SELATAN,KEBAYORAN LAMA,PONDOK PINANG,56169,20813,35356,22691,58047,2021-09-14
3175101003,JAKARTA TIMUR,CIPAYUNG,PONDOK RANGGON,25574,8500,17074,12892,29966,2021-09-14
3101011003,KAB.ADM.KEP.SERIBU,KEP. SERIBU UTARA,PULAU HARAPAN,2060,332,1728,1054,2782,2021-09-14
3101011002,KAB.ADM.KEP.SERIBU,KEP. SERIBU UTARA,PULAU KELAPA,5528,879,4649,2736,7385,2021-09-14
3101011001,KAB.ADM.KEP.SERIBU,KEP. SERIBU UTARA,PULAU PANGGANG,5450,822,4628,2288,6916,2021-09-14
3101021003,KAB.ADM.KEP.SERIBU,KEP. SERIBU SELATAN,PULAU PARI,2765,311,2454,1744,4198,2021-09-14
3101021002,KAB.ADM.KEP.SERIBU,KEP. SERIBU SELATAN,PULAU TIDUNG,4553,600,3953,2772,6725,2021-09-14
3101021001,KAB.ADM.KEP.SERIBU,KEP. SERIBU SELATAN,PULAU UNTUNG JAWA,1941,299,1642,1181,2823,2021-09-14
3174071007,JAKARTA SELATAN,KEBAYORAN BARU,PULO,5835,1954,3881,2897,6778,2021-09-14
3175021001,JAKARTA TIMUR,PULO GADUNG,PULO GADUNG,34422,11939,22483,16080,38563,2021-09-14
3175061005,JAKARTA TIMUR,CAKUNG,PULO GEBANG,97301,33399,63902,44653,108555,2021-09-14
3174041004,JAKARTA SELATAN,PASAR MINGGU,RAGUNAN,39616,13881,25735,16678,42413,2021-09-14
3175091005,JAKARTA TIMUR,CIRACAS,RAMBUTAN,36771,13818,22953,16279,39232,2021-09-14
3172031006,JAKARTA UTARA,KOJA,RAWA BADAK SELATAN,42179,15437,26742,18217,44959,2021-09-14
3172031004,JAKARTA UTARA,KOJA,RAWA BADAK UTARA,34408,12402,22006,15884,37890,2021-09-14
3174071005,JAKARTA SELATAN,KEBAYORAN BARU,RAWA BARAT,5625,1862,3763,2634,6397,2021-09-14
3173011003,JAKARTA BARAT,CENGKARENG,RAWA BUAYA,63799,22209,41590,28829,70419,2021-09-14
3175031004,JAKARTA TIMUR,JATINEGARA,RAWA BUNGA,21434,8157,13277,9596,22873,2021-09-14
3174081003,JAKARTA SELATAN,PANCORAN,RAWA JATI,20509,7325,13184,8075,21259,2021-09-14
3175061002,JAKARTA TIMUR,CAKUNG,RAWA TERATE,24637,7524,17113,12809,29922,2021-09-14
3175021005,JAKARTA TIMUR,PULO GADUNG,RAWAMANGUN,37612,13053,24559,18244,42803,2021-09-14
3171051003,JAKARTA PUSAT,CEMPAKA PUTIH,RAWASARI,21967,7746,14221,10698,24919,2021-09-14
3173041010,JAKARTA BARAT,TAMBORA,ROA MALAKA,3484,1020,2464,1936,4400,2021-09-14
3172041006,JAKARTA UTARA,CILINCING,ROROTAN,41668,13324,28344,19613,47957,2021-09-14
3174071004,JAKARTA SELATAN,KEBAYORAN BARU,SELONG,2842,968,1874,1430,3304,2021-09-14
3173061002,JAKARTA BARAT,KALI DERES,SEMANAN,71354,25669,45685,32284,77969,2021-09-14
3172041007,JAKARTA UTARA,CILINCING,SEMPER BARAT,68587,21794,46793,34789,81582,2021-09-14
3172041005,JAKARTA UTARA,CILINCING,SEMPER TIMUR,36267,12090,24177,17119,41296,2021-09-14
3174071006,JAKARTA SELATAN,KEBAYORAN BARU,SENAYAN,2771,1112,1659,1134,2793,2021-09-14
3171041001,JAKARTA PUSAT,SENEN,SENEN,6804,2206,4598,3529,8127,2021-09-14
3171031004,JAKARTA PUSAT,KEMAYORAN,SERDANG,29668,10100,19568,14391,33959,2021-09-14
3174021001,JAKARTA SELATAN,SETIA BUDI,SETIA BUDI,3023,1100,1923,1330,3253,2021-09-14
3175101005,JAKARTA TIMUR,CIPAYUNG,SETU,20572,7373,13199,9436,22635,2021-09-14
3173071002,JAKARTA BARAT,PALMERAH,SLIPI,16591,5452,11139,8255,19394,2021-09-14
3173081004,JAKARTA BARAT,KEMBANGAN,SRENGSENG,45523,16580,28943,20755,49698,2021-09-14
3174091002,JAKARTA SELATAN,JAGAKARSA,SRENGSENG SAWAH,58196,18781,39415,24941,64356,2021-09-14
3173051003,JAKARTA BARAT,KEBON JERUK,SUKABUMI SELATAN,37033,13551,23482,14796,38278,2021-09-14
3173051002,JAKARTA BARAT,KEBON JERUK,SUKABUMI UTARA,38290,14452,23838,14885,38723,2021-09-14
3172041002,JAKARTA UTARA,CILINCING,SUKAPURA,53949,19010,34939,25891,60830,2021-09-14
3171031007,JAKARTA PUSAT,KEMAYORAN,SUMUR BATU,22717,7907,14810,11204,26014,2021-09-14
3172021004,JAKARTA UTARA,TANJUNG PRIOK,SUNGAI BAMBU,29876,10086,19790,14894,34684,2021-09-14
3172021006,JAKARTA UTARA,TANJUNG PRIOK,SUNTER AGUNG,71805,21134,50671,40188,90859,2021-09-14
3172021002,JAKARTA UTARA,TANJUNG PRIOK,SUNTER JAYA,63031,19248,43783,34959,78742,2021-09-14
3175091004,JAKARTA TIMUR,CIRACAS,SUSUKAN,38257,12112,26145,18797,44942,2021-09-14
3173031001,JAKARTA BARAT,TAMAN SARI,TAMAN SARI,14348,4781,9567,7538,17105,2021-09-14
3173041001,JAKARTA BARAT,TAMBORA,TAMBORA,10204,3550,6654,4603,11257,2021-09-14
3173041004,JAKARTA BARAT,TAMBORA,TANAH SEREAL,26387,7688,18699,13453,32152,2021-09-14
3171081004,JAKARTA PUSAT,JOHAR BARU,TANAH TINGGI,37693,11080,26613,18895,45508,2021-09-14
3173031004,JAKARTA BARAT,TAMAN SARI,TANGKI,13324,4285,9039,6940,15979,2021-09-14
3174091005,JAKARTA SELATAN,JAGAKARSA,TANJUNG BARAT,39770,13966,25804,15349,41153,2021-09-14
3173021005,JAKARTA BARAT,GROGOL PETAMBURAN,TANJUNG DUREN SELATAN,25337,8626,16711,12842,29553,2021-09-14
3173021002,JAKARTA BARAT,GROGOL PETAMBURAN,TANJUNG DUREN UTARA,17010,5472,11538,8901,20439,2021-09-14
3172021001,JAKARTA UTARA,TANJUNG PRIOK,TANJUNG PRIOK,34588,11165,23423,16845,40268,2021-09-14
3174011002,JAKARTA SELATAN,TEBET,TEBET BARAT,21194,6978,14216,9649,23865,2021-09-14
3174011001,JAKARTA SELATAN,TEBET,TEBET TIMUR,18199,5994,12205,8287,20492,2021-09-14
3173061003,JAKARTA BARAT,KALI DERES,TEGAL ALUR,83647,28812,54835,38053,92888,2021-09-14
3174031004,JAKARTA SELATAN,MAMPANG PRAPATAN,TEGAL PARANG,32401,12626,19775,11738,31513,2021-09-14
3173021003,JAKARTA BARAT,GROGOL PETAMBURAN,TOMANG,29605,9909,19696,15402,35098,2021-09-14
3172031005,JAKARTA UTARA,KOJA,TUGU SELATAN,39122,13596,25526,17857,43383,2021-09-14
3172031002,JAKARTA UTARA,KOJA,TUGU UTARA,67670,24896,42774,29544,72318,2021-09-14
3175061006,JAKARTA TIMUR,CAKUNG,UJUNG MENTENG,29934,9367,20567,15695,36262,2021-09-14
3174101005,JAKARTA SELATAN,PESANGGRAHAN,ULUJAMI,40544,16127,24417,14377,38794,2021-09-14
3175011006,JAKARTA TIMUR,MATRAMAN,UTAN KAYU SELATAN,33511,11107,22404,16254,38658,2021-09-14
3175011002,JAKARTA TIMUR,MATRAMAN,UTAN KAYU UTARA,28169,10308,17861,12697,30558,2021-09-14
3171031008,JAKARTA PUSAT,KEMAYORAN,UTAN PANJANG,29208,10294,18914,13513,32427,2021-09-14
3172021007,JAKARTA UTARA,TANJUNG PRIOK,WARAKAS,44401,14176,30225,21588,51813,2021-09-14
3173021007,JAKARTA BARAT,GROGOL PETAMBURAN,WIJAYA KUSUMA,38934,13888,25046,18744,43790,2021-09-14
3172051003,JAKARTA UTARA,PADEMANGAN,ANCOL,23947,8785,15162,11357,26519,2021-09-15
3173041007,JAKARTA BARAT,TAMBORA,ANGKE,29381,9896,19485,13612,33097,2021-09-15
3175041005,JAKARTA TIMUR,KRAMAT JATI,BALE KAMBANG,29074,11698,17376,10844,28220,2021-09-15
3175031003,JAKARTA TIMUR,JATINEGARA,BALI MESTER,9752,3521,6231,4623,10854,2021-09-15
3175101006,JAKARTA TIMUR,CIPAYUNG,BAMBU APUS,26285,8812,17473,12976,30449,2021-09-15
3174031002,JAKARTA SELATAN,MAMPANG PRAPATAN,BANGKA,21566,8258,13308,8456,21764,2021-09-15
3175051002,JAKARTA TIMUR,PASAR REBO,BARU,23886,7254,16632,13031,29663,2021-09-15
3175041004,JAKARTA TIMUR,KRAMAT JATI,BATU AMPAR,47898,18696,29202,20037,49239,2021-09-15
3171071002,JAKARTA PUSAT,TANAH ABANG,BENDUNGAN HILIR,21494,7643,13851,10128,23979,2021-09-15
3175031002,JAKARTA TIMUR,JATINEGARA,BIDARA CINA,36689,14462,22227,15655,37882,2021-09-15
3174101002,JAKARTA SELATAN,PESANGGRAHAN,BINTARO,53098,19923,33175,21507,54682,2021-09-15
3174011005,JAKARTA SELATAN,TEBET,BUKIT DURI,34183,13117,21066,12706,33772,2021-09-15
3171041006,JAKARTA PUSAT,SENEN,BUNGUR,18144,6149,11995,8863,20858,2021-09-15
3175061007,JAKARTA TIMUR,CAKUNG,CAKUNG BARAT,57724,18489,39235,29085,68320,2021-09-15
3175061004,JAKARTA TIMUR,CAKUNG,CAKUNG TIMUR,58287,18750,39537,29918,69455,2021-09-15
3175041007,JAKARTA TIMUR,KRAMAT JATI,CAWANG,32762,12054,20708,14306,35014,2021-09-15
3175101008,JAKARTA TIMUR,CIPAYUNG,CEGER,18932,6298,12634,9438,22072,2021-09-15
3171031006,JAKARTA PUSAT,KEMAYORAN,CEMPAKA BARU,32581,11331,21250,15056,36306,2021-09-15
3171051002,JAKARTA PUSAT,CEMPAKA PUTIH,CEMPAKA PUTIH BARAT,35885,12568,23317,17932,41249,2021-09-15
3171051001,JAKARTA PUSAT,CEMPAKA PUTIH,CEMPAKA PUTIH TIMUR,24292,8191,16101,12313,28414,2021-09-15
3173011001,JAKARTA BARAT,CENGKARENG,CENGKARENG BARAT,66284,22322,43962,33654,77616,2021-09-15
3173011006,JAKARTA BARAT,CENGKARENG,CENGKARENG TIMUR,81027,26644,54383,38955,93338,2021-09-15
3175091002,JAKARTA TIMUR,CIRACAS,CIBUBUR,66364,20649,45715,34255,79970,2021-09-15
3171011002,JAKARTA PUSAT,GAMBIR,CIDENG,15390,5008,10382,8031,18413,2021-09-15
3174091003,JAKARTA SELATAN,JAGAKARSA,CIGANJUR,38497,13826,24671,15040,39711,2021-09-15
3175051003,JAKARTA TIMUR,PASAR REBO,CIJANTUNG,41419,13131,28288,21330,49618,2021-09-15
3171061003,JAKARTA PUSAT,MENTENG,CIKINI,8274,2729,5545,3814,9359,2021-09-15
3174081006,JAKARTA SELATAN,PANCORAN,CIKOKO,10547,3594,6953,4242,11195,2021-09-15
3174061001,JAKARTA SELATAN,CILANDAK,CILANDAK BARAT,51752,18534,33218,21496,54714,2021-09-15
3174041003,JAKARTA SELATAN,PASAR MINGGU,CILANDAK TIMUR,25145,8888,16257,11040,27297,2021-09-15
3175101002,JAKARTA TIMUR,CIPAYUNG,CILANGKAP,27635,9107,18528,13844,32372,2021-09-15
3175041006,JAKARTA TIMUR,KRAMAT JATI,CILILITAN,40181,15251,24930,17964,42894,2021-09-15
3172041001,JAKARTA UTARA,CILINCING,CILINCING,43609,15842,27767,19134,46901,2021-09-15
3175101001,JAKARTA TIMUR,CIPAYUNG,CIPAYUNG,26104,7914,18190,14094,32284,2021-09-15
3174091006,JAKARTA SELATAN,JAGAKARSA,CIPEDAK,38303,12789,25514,16204,41718,2021-09-15
3174061005,JAKARTA SELATAN,CILANDAK,CIPETE SELATAN,26704,10001,16703,11495,28198,2021-09-15
3174071010,JAKARTA SELATAN,KEBAYORAN BARU,CIPETE UTARA,34102,12457,21645,13748,35393,2021-09-15
3175021003,JAKARTA TIMUR,PULO GADUNG,CIPINANG,39306,13561,25745,18692,44437,2021-09-15
3175031007,JAKARTA TIMUR,JATINEGARA,CIPINANG BESAR SELATAN,35212,13250,21962,14941,36903,2021-09-15
3175031008,JAKARTA TIMUR,JATINEGARA,CIPINANG BESAR UTARA,45319,17022,28297,19613,47910,2021-09-15
3175031005,JAKARTA TIMUR,JATINEGARA,CIPINANG CEMPEDAK,32824,12602,20222,15258,35480,2021-09-15
3175081005,JAKARTA TIMUR,MAKASAR,CIPINANG MELAYU,42308,15219,27089,20592,47681,2021-09-15
3175031006,JAKARTA TIMUR,JATINEGARA,CIPINANG MUARA,55243,20674,34569,24838,59407,2021-09-15
3174051003,JAKARTA SELATAN,KEBAYORAN LAMA,CIPULIR,39937,15911,24026,13717,37743,2021-09-15
3175091001,JAKARTA TIMUR,CIRACAS,CIRACAS,64594,19998,44596,32654,77250,2021-09-15
3175041003,JAKARTA TIMUR,KRAMAT JATI,DUKUH,24609,8146,16463,11985,28448,2021-09-15
3175071001,JAKARTA TIMUR,DUREN SAWIT,DUREN SAWIT,61160,22632,38528,28265,66793,2021-09-15
3174081004,JAKARTA SELATAN,PANCORAN,DUREN TIGA,28319,10425,17894,10053,27947,2021-09-15
3173051005,JAKARTA BARAT,KEBON JERUK,DURI KEPA,60138,19751,40387,31000,71387,2021-09-15
3173011002,JAKARTA BARAT,CENGKARENG,DURI KOSAMBI,77923,29096,48827,34006,82833,2021-09-15
3171011006,JAKARTA PUSAT,GAMBIR,DURI PULO,19610,6696,12914,9254,22168,2021-09-15
3173041011,JAKARTA BARAT,TAMBORA,DURI SELATAN,14259,4398,9861,7404,17265,2021-09-15
3173041003,JAKARTA BARAT,TAMBORA,DURI UTARA,19844,6421,13423,9635,23058,2021-09-15
3171081003,JAKARTA PUSAT,JOHAR BARU,GALUR,18243,5440,12803,9206,22009,2021-09-15
3171011001,JAKARTA PUSAT,GAMBIR,GAMBIR,2191,717,1474,1151,2625,2021-09-15
3174061004,JAKARTA SELATAN,CILANDAK,GANDARIA SELATAN,22119,8218,13901,8564,22465,2021-09-15
3174071009,JAKARTA SELATAN,KEBAYORAN BARU,GANDARIA UTARA,39922,14924,24998,15999,40997,2021-09-15
3175051001,JAKARTA TIMUR,PASAR REBO,GEDONG,35755,11972,23783,17887,41670,2021-09-15
3171071001,JAKARTA PUSAT,TANAH ABANG,GELORA,3127,1149,1978,1396,3374,2021-09-15
3173031007,JAKARTA BARAT,TAMAN SARI,GLODOK,7837,2282,5555,4602,10157,2021-09-15
3171061004,JAKARTA PUSAT,MENTENG,GONDANGDIA,4100,1445,2655,2197,4852,2021-09-15
3173021001,JAKARTA BARAT,GROGOL PETAMBURAN,GROGOL,16876,5829,11047,8316,19363,2021-09-15
3174051005,JAKARTA SELATAN,KEBAYORAN LAMA,GROGOL SELATAN,44251,16857,27394,16377,43771,2021-09-15
3174051004,JAKARTA SELATAN,KEBAYORAN LAMA,GROGOL UTARA,42494,15881,26613,16340,42953,2021-09-15
3174021007,JAKARTA SELATAN,SETIA BUDI,GUNTUR,3985,1360,2625,1956,4581,2021-09-15
3174071002,JAKARTA SELATAN,KEBAYORAN BARU,GUNUNG,9436,3315,6121,4351,10472,2021-09-15
3171031005,JAKARTA PUSAT,KEMAYORAN,GUNUNG SAHARI SELATAN,19199,6589,12610,9748,22358,2021-09-15
3171021004,JAKARTA PUSAT,SAWAH BESAR,GUNUNG SAHARI UTARA,16650,4947,11703,9489,21192,2021-09-15
3175081004,JAKARTA TIMUR,MAKASAR,HALIM PERDANA KUSUMAH,28363,7580,20783,17581,38364,2021-09-15
3171031003,JAKARTA PUSAT,KEMAYORAN,HARAPAN MULIA,22557,7637,14920,11182,26102,2021-09-15
3174091001,JAKARTA SELATAN,JAGAKARSA,JAGAKARSA,62389,21692,40697,26510,67207,2021-09-15
3175021007,JAKARTA TIMUR,PULO GADUNG,JATI,32757,11095,21662,16467,38129,2021-09-15
3174041002,JAKARTA SELATAN,PASAR MINGGU,JATI PADANG,37502,13750,23752,15451,39203,2021-09-15
3173071004,JAKARTA BARAT,PALMERAH,JATI PULO,28738,9284,19454,13872,33326,2021-09-15
3175061001,JAKARTA TIMUR,CAKUNG,JATINEGARA,84160,29269,54891,41017,95908,2021-09-15
3175021004,JAKARTA TIMUR,PULO GADUNG,JATINEGARA KAUM,24632,7834,16798,11370,28168,2021-09-15
3173021004,JAKARTA BARAT,GROGOL PETAMBURAN,JELAMBAR,30266,10281,19985,15646,35631,2021-09-15
3173021006,JAKARTA BARAT,GROGOL PETAMBURAN,JELAMBAR BARU,38246,12820,25426,19886,45312,2021-09-15
3173041006,JAKARTA BARAT,TAMBORA,JEMBATAN BESI,29314,11370,17944,11686,29630,2021-09-15
3173041008,JAKARTA BARAT,TAMBORA,JEMBATAN LIMA,21021,7703,13318,9137,22455,2021-09-15
3173081005,JAKARTA BARAT,KEMBANGAN,JOGLO,40839,13996,26843,19604,46447,2021-09-15
3171081001,JAKARTA PUSAT,JOHAR BARU,JOHAR BARU,37488,11420,26068,19739,45807,2021-09-15
3173041002,JAKARTA BARAT,TAMBORA,KALI ANYAR,23856,7791,16065,11284,27349,2021-09-15
3172041004,JAKARTA UTARA,CILINCING,KALIBARU,67684,26280,41404,26172,67576,2021-09-15
3174081002,JAKARTA SELATAN,PANCORAN,KALIBATA,41994,17255,24739,13785,38524,2021-09-15
3173061001,JAKARTA BARAT,KALI DERES,KALIDERES,72447,25324,47123,36641,83764,2021-09-15
3175051004,JAKARTA TIMUR,PASAR REBO,KALISARI,43212,13954,29258,22490,51748,2021-09-15
3173061004,JAKARTA BARAT,KALI DERES,KAMAL,53783,19552,34231,24081,58312,2021-09-15
3172011002,JAKARTA UTARA,PENJARINGAN,KAMAL MUARA,12930,3368,9562,7618,17180,2021-09-15
3171071007,JAKARTA PUSAT,TANAH ABANG,KAMPUNG BALI,11358,4200,7158,4878,12036,2021-09-15
3175031001,JAKARTA TIMUR,JATINEGARA,KAMPUNG MELAYU,25717,9915,15802,11050,26852,2021-09-15
3171081002,JAKARTA PUSAT,JOHAR BARU,KAMPUNG RAWA,21237,5536,15701,11167,26868,2021-09-15
3175041002,JAKARTA TIMUR,KRAMAT JATI,KAMPUNG TENGAH,43993,16986,27007,18195,45202,2021-09-15
3173011005,JAKARTA BARAT,CENGKARENG,KAPUK,134466,49484,84982,58412,143394,2021-09-15
3172011003,JAKARTA UTARA,PENJARINGAN,KAPUK MUARA,35781,10628,25153,20593,45746,2021-09-15
3171021002,JAKARTA PUSAT,SAWAH BESAR,KARANG ANYAR,25761,8230,17531,13135,30666,2021-09-15
3174021004,JAKARTA SELATAN,SETIA BUDI,KARET,9623,3572,6051,4072,10123,2021-09-15
3174021003,JAKARTA SELATAN,SETIA BUDI,KARET KUNINGAN,16055,5307,10748,7261,18009,2021-09-15
3174021002,JAKARTA SELATAN,SETIA BUDI,KARET SEMANGGI,2770,936,1834,1418,3252,2021-09-15
3171071003,JAKARTA PUSAT,TANAH ABANG,KARET TENGSIN,19271,6391,12880,8943,21823,2021-09-15
3171021003,JAKARTA PUSAT,SAWAH BESAR,KARTINI,22292,7379,14913,11636,26549,2021-09-15
3175011003,JAKARTA TIMUR,MATRAMAN,KAYU MANIS,25284,9434,15850,10861,26711,2021-09-15
3175021006,JAKARTA TIMUR,PULO GADUNG,KAYU PUTIH,40696,13290,27406,21498,48904,2021-09-15
3173031006,JAKARTA BARAT,TAMAN SARI,KEAGUNGAN,17387,5719,11668,8815,20483,2021-09-15
3174041007,JAKARTA SELATAN,PASAR MINGGU,KEBAGUSAN,44552,16985,27567,16732,44299,2021-09-15
3174051006,JAKARTA SELATAN,KEBAYORAN LAMA,KEBAYORAN LAMA SELATAN,41212,14684,26528,16153,42681,2021-09-15
3174051001,JAKARTA SELATAN,KEBAYORAN LAMA,KEBAYORAN LAMA UTARA,42422,16477,25945,14701,40646,2021-09-15
3174011004,JAKARTA SELATAN,TEBET,KEBON BARU,35165,12770,22395,13951,36346,2021-09-15
3172021005,JAKARTA UTARA,TANJUNG PRIOK,KEBON BAWANG,50952,17466,33486,24774,58260,2021-09-15
3173051001,JAKARTA BARAT,KEBON JERUK,KEBON JERUK,53887,19726,34161,24496,58657,2021-09-15
3171071006,JAKARTA PUSAT,TANAH ABANG,KEBON KACANG,21531,8376,13155,9158,22313,2021-09-15
3171011005,JAKARTA PUSAT,GAMBIR,KEBON KELAPA,10163,3464,6699,5038,11737,2021-09-15
3171031002,JAKARTA PUSAT,KEMAYORAN,KEBON KOSONG,30019,10313,19706,14743,34449,2021-09-15
3175011005,JAKARTA TIMUR,MATRAMAN,KEBON MANGGIS,16490,5624,10866,7908,18774,2021-09-15
3171071005,JAKARTA PUSAT,TANAH ABANG,KEBON MELATI,32206,13091,19115,12542,31657,2021-09-15
3175081003,JAKARTA TIMUR,MAKASAR,KEBON PALA,46614,16183,30431,21747,52178,2021-09-15
3171061005,JAKARTA PUSAT,MENTENG,KEBON SIRIH,12299,4320,7979,5724,13703,2021-09-15
3173011004,JAKARTA BARAT,CENGKARENG,KEDAUNG KALI ANGKE,32612,10172,22440,16937,39377,2021-09-15
3173051007,JAKARTA BARAT,KEBON JERUK,KEDOYA SELATAN,32165,10615,21550,15718,37268,2021-09-15
3173051006,JAKARTA BARAT,KEBON JERUK,KEDOYA UTARA,45740,14378,31362,24300,55662,2021-09-15
3173051004,JAKARTA BARAT,KEBON JERUK,KELAPA DUA,23565,8545,15020,11186,26206,2021-09-15
3175091003,JAKARTA TIMUR,CIRACAS,KELAPA DUA WETAN,46875,14345,32530,24135,56665,2021-09-15
3172061003,JAKARTA UTARA,KELAPA GADING,KELAPA GADING BARAT,35717,10724,24993,20763,45756,2021-09-15
3172061001,JAKARTA UTARA,KELAPA GADING,KELAPA GADING TIMUR,33592,9232,24360,20282,44642,2021-09-15
3173071005,JAKARTA BARAT,PALMERAH,KEMANGGISAN,32139,10861,21278,15350,36628,2021-09-15
3171031001,JAKARTA PUSAT,KEMAYORAN,KEMAYORAN,20708,6794,13914,10613,24527,2021-09-15
3173081006,JAKARTA BARAT,KEMBANGAN,KEMBANGAN SELATAN,27130,9273,17857,14027,31884,2021-09-15
3173081001,JAKARTA BARAT,KEMBANGAN,KEMBANGAN UTARA,54451,18416,36035,26948,62983,2021-09-15
3171041002,JAKARTA PUSAT,SENEN,KENARI,9579,3143,6436,5058,11494,2021-09-15
3173041005,JAKARTA BARAT,TAMBORA,KERENDANG,19973,6670,13303,9417,22720,2021-09-15
3175071003,JAKARTA TIMUR,DUREN SAWIT,KLENDER,69978,26318,43660,30561,74221,2021-09-15
3172031001,JAKARTA UTARA,KOJA,KOJA,28175,10179,17996,13385,31381,2021-09-15
3173071006,JAKARTA BARAT,PALMERAH,KOTA BAMBU SELATAN,21158,7272,13886,9570,23456,2021-09-15
3173071003,JAKARTA BARAT,PALMERAH,KOTA BAMBU UTARA,24995,8833,16162,10996,27158,2021-09-15
3171041004,JAKARTA PUSAT,SENEN,KRAMAT,28835,10327,18508,12160,30668,2021-09-15
3175041001,JAKARTA TIMUR,KRAMAT JATI,KRAMAT JATI,34144,12006,22138,15631,37769,2021-09-15
3174071003,JAKARTA SELATAN,KEBAYORAN BARU,KRAMAT PELA,14413,4992,9421,6111,15532,2021-09-15
3173031002,JAKARTA BARAT,TAMAN SARI,KRUKUT,19244,6378,12866,9482,22348,2021-09-15
3174031005,JAKARTA SELATAN,MAMPANG PRAPATAN,KUNINGAN BARAT,12785,4450,8335,5282,13617,2021-09-15
3174021008,JAKARTA SELATAN,SETIA BUDI,KUNINGAN TIMUR,6008,2121,3887,2646,6533,2021-09-15
3171041005,JAKARTA PUSAT,SENEN,KWITANG,15486,5390,10096,7474,17570,2021-09-15
3172031003,JAKARTA UTARA,KOJA,LAGOA,59065,21642,37423,25712,63135,2021-09-15
3174061002,JAKARTA SELATAN,CILANDAK,LEBAK BULUS,37626,14237,23389,15218,38607,2021-09-15
3174091004,JAKARTA SELATAN,JAGAKARSA,LENTENG AGUNG,53946,20374,33572,19524,53096,2021-09-15
3175101007,JAKARTA TIMUR,CIPAYUNG,LUBANG BUAYA,63547,20345,43202,31723,74925,2021-09-15
3175081001,JAKARTA TIMUR,MAKASAR,MAKASAR,34390,11441,22949,17205,40154,2021-09-15
3175071006,JAKARTA TIMUR,DUREN SAWIT,MALAKA JAYA,30927,10639,20288,15533,35821,2021-09-15
3175071005,JAKARTA TIMUR,DUREN SAWIT,MALAKA SARI,27530,9115,18415,14419,32834,2021-09-15
3174031001,JAKARTA SELATAN,MAMPANG PRAPATAN,MAMPANG PRAPATAN,18159,6639,11520,7491,19011,2021-09-15
3173031005,JAKARTA BARAT,TAMAN SARI,MANGGA BESAR,7707,2258,5449,4334,9783,2021-09-15
3171021005,JAKARTA PUSAT,SAWAH BESAR,MANGGA DUA SELATAN,27442,9031,18411,14054,32465,2021-09-15
3174011007,JAKARTA SELATAN,TEBET,MANGGARAI,28373,9423,18950,11432,30382,2021-09-15
3174011006,JAKARTA SELATAN,TEBET,MANGGARAI SELATAN,23075,7911,15164,9728,24892,2021-09-15
3173031003,JAKARTA BARAT,TAMAN SARI,MAPHAR,16461,5566,10895,8357,19252,2021-09-15
3172041003,JAKARTA UTARA,CILINCING,MARUNDA,28943,9426,19517,12577,32094,2021-09-15
3174071001,JAKARTA SELATAN,KEBAYORAN BARU,MELAWAI,2627,887,1740,1390,3130,2021-09-15
3171061001,JAKARTA PUSAT,MENTENG,MENTENG,25624,9262,16362,11706,28068,2021-09-15
3174021005,JAKARTA SELATAN,SETIA BUDI,MENTENG ATAS,27816,9419,18397,11570,29967,2021-09-15
3174011003,JAKARTA SELATAN,TEBET,MENTENG DALAM,36028,13023,23005,14789,37794,2021-09-15
3173081003,JAKARTA BARAT,KEMBANGAN,MERUYA SELATAN,32130,11059,21071,15823,36894,2021-09-15
3173081002,JAKARTA BARAT,KEMBANGAN,MERUYA UTARA,43752,15206,28546,22365,50911,2021-09-15
3175101004,JAKARTA TIMUR,CIPAYUNG,MUNJUL,23871,7727,16144,12238,28382,2021-09-15
3172051002,JAKARTA UTARA,PADEMANGAN,PADEMANGAN BARAT,74240,26581,47659,34397,82056,2021-09-15
3172051001,JAKARTA UTARA,PADEMANGAN,PADEMANGAN TIMUR,37736,11247,26489,20855,47344,2021-09-15
3175011004,JAKARTA TIMUR,MATRAMAN,PAL MERIAM,19769,7307,12462,9001,21463,2021-09-15
3173071001,JAKARTA BARAT,PALMERAH,PALMERAH,63011,22228,40783,28439,69222,2021-09-15
3174081001,JAKARTA SELATAN,PANCORAN,PANCORAN,19421,7166,12255,7570,19825,2021-09-15
3172021003,JAKARTA UTARA,TANJUNG PRIOK,PAPANGGO,39097,12515,26582,19668,46250,2021-09-15
3171021001,JAKARTA PUSAT,SAWAH BESAR,PASAR BARU,12035,3638,8397,6871,15268,2021-09-15
3174021006,JAKARTA SELATAN,SETIA BUDI,PASAR MANGGIS,26752,9668,17084,10805,27889,2021-09-15
3174041001,JAKARTA SELATAN,PASAR MINGGU,PASAR MINGGU,24821,8992,15829,10458,26287,2021-09-15
3171041003,JAKARTA PUSAT,SENEN,PASEBAN,23533,8368,15165,10827,25992,2021-09-15
3173061005,JAKARTA BARAT,KALI DERES,PEGADUNGAN,75587,24548,51039,40281,91320,2021-09-15
3171061002,JAKARTA PUSAT,MENTENG,PEGANGSAAN,23455,8289,15166,10350,25516,2021-09-15
3172061002,JAKARTA UTARA,KELAPA GADING,PEGANGSAAN DUA,49976,13698,36278,29705,65983,2021-09-15
3172011004,JAKARTA UTARA,PENJARINGAN,PEJAGALAN,74578,25088,49490,38650,88140,2021-09-15
3174041006,JAKARTA SELATAN,PASAR MINGGU,PEJATEN BARAT,37346,13967,23379,15020,38399,2021-09-15
3174041005,JAKARTA SELATAN,PASAR MINGGU,PEJATEN TIMUR,57656,22400,35256,20487,55743,2021-09-15
3175051005,JAKARTA TIMUR,PASAR REBO,PEKAYON,43250,13890,29360,21756,51116,2021-09-15
3173041009,JAKARTA BARAT,TAMBORA,PEKOJAN,23587,7491,16096,12127,28223,2021-09-15
3174031003,JAKARTA SELATAN,MAMPANG PRAPATAN,PELA MAMPANG,43522,15681,27841,18548,46389,2021-09-15
3174081005,JAKARTA SELATAN,PANCORAN,PENGADEGAN,21478,7124,14354,8108,22462,2021-09-15
3175061003,JAKARTA TIMUR,CAKUNG,PENGGILINGAN,99255,36877,62378,43813,106191,2021-09-15
3172011001,JAKARTA UTARA,PENJARINGAN,PENJARINGAN,88308,32948,55360,39285,94645,2021-09-15
3174101001,JAKARTA SELATAN,PESANGGRAHAN,PESANGGRAHAN,27545,9405,18140,11555,29695,2021-09-15
3171071004,JAKARTA PUSAT,TANAH ABANG,PETAMBURAN,33271,13593,19678,13028,32706,2021-09-15
3174071008,JAKARTA SELATAN,KEBAYORAN BARU,PETOGOGAN,11499,4263,7236,4821,12057,2021-09-15
3171011004,JAKARTA PUSAT,GAMBIR,PETOJO SELATAN,14692,5284,9408,7074,16482,2021-09-15
3171011003,JAKARTA PUSAT,GAMBIR,PETOJO UTARA,17458,6141,11317,8240,19557,2021-09-15
3174101004,JAKARTA SELATAN,PESANGGRAHAN,PETUKANGAN SELATAN,37187,13628,23559,14516,38075,2021-09-15
3174101003,JAKARTA SELATAN,PESANGGRAHAN,PETUKANGAN UTARA,53716,20842,32874,20680,53554,2021-09-15
3175081002,JAKARTA TIMUR,MAKASAR,PINANG RANTI,27198,9494,17704,13071,30775,2021-09-15
3173031008,JAKARTA BARAT,TAMAN SARI,PINANGSIA,10729,3254,7475,5685,13160,2021-09-15
3175011001,JAKARTA TIMUR,MATRAMAN,PISANGAN BARU,31776,11646,20130,13541,33671,2021-09-15
3175021002,JAKARTA TIMUR,PULO GADUNG,PISANGAN TIMUR,41011,13504,27507,20647,48154,2021-09-15
3172011005,JAKARTA UTARA,PENJARINGAN,PLUIT,47783,15143,32640,26138,58778,2021-09-15
3175071002,JAKARTA TIMUR,DUREN SAWIT,PONDOK BAMBU,61550,22534,39016,28757,67773,2021-09-15
3175071004,JAKARTA TIMUR,DUREN SAWIT,PONDOK KELAPA,72015,25213,46802,33710,80512,2021-09-15
3175071007,JAKARTA TIMUR,DUREN SAWIT,PONDOK KOPI,35367,13270,22097,14316,36413,2021-09-15
3174061003,JAKARTA SELATAN,CILANDAK,PONDOK LABU,46464,16043,30421,20790,51211,2021-09-15
3174051002,JAKARTA SELATAN,KEBAYORAN LAMA,PONDOK PINANG,56169,20808,35361,22745,58106,2021-09-15
3175101003,JAKARTA TIMUR,CIPAYUNG,PONDOK RANGGON,25574,8479,17095,12985,30080,2021-09-15
3101011003,KAB.ADM.KEP.SERIBU,KEP. SERIBU UTARA,PULAU HARAPAN,2060,329,1731,1070,2801,2021-09-15
3101011002,KAB.ADM.KEP.SERIBU,KEP. SERIBU UTARA,PULAU KELAPA,5528,879,4649,2765,7414,2021-09-15
3101011001,KAB.ADM.KEP.SERIBU,KEP. SERIBU UTARA,PULAU PANGGANG,5450,820,4630,2339,6969,2021-09-15
3101021003,KAB.ADM.KEP.SERIBU,KEP. SERIBU SELATAN,PULAU PARI,2765,310,2455,1851,4306,2021-09-15
3101021002,KAB.ADM.KEP.SERIBU,KEP. SERIBU SELATAN,PULAU TIDUNG,4553,598,3955,2778,6733,2021-09-15
3101021001,KAB.ADM.KEP.SERIBU,KEP. SERIBU SELATAN,PULAU UNTUNG JAWA,1941,299,1642,1196,2838,2021-09-15
3174071007,JAKARTA SELATAN,KEBAYORAN BARU,PULO,5835,1954,3881,2906,6787,2021-09-15
3175021001,JAKARTA TIMUR,PULO GADUNG,PULO GADUNG,34422,11908,22514,16279,38793,2021-09-15
3175061005,JAKARTA TIMUR,CAKUNG,PULO GEBANG,97301,33256,64045,45278,109323,2021-09-15
3174041004,JAKARTA SELATAN,PASAR MINGGU,RAGUNAN,39616,13874,25742,16721,42463,2021-09-15
3175091005,JAKARTA TIMUR,CIRACAS,RAMBUTAN,36771,13770,23001,16444,39445,2021-09-15
3172031006,JAKARTA UTARA,KOJA,RAWA BADAK SELATAN,42179,15400,26779,18531,45310,2021-09-15
3172031004,JAKARTA UTARA,KOJA,RAWA BADAK UTARA,34408,12353,22055,16079,38134,2021-09-15
3174071005,JAKARTA SELATAN,KEBAYORAN BARU,RAWA BARAT,5625,1862,3763,2637,6400,2021-09-15
3173011003,JAKARTA BARAT,CENGKARENG,RAWA BUAYA,63799,22097,41702,29034,70736,2021-09-15
3175031004,JAKARTA TIMUR,JATINEGARA,RAWA BUNGA,21434,8136,13298,9699,22997,2021-09-15
3174081003,JAKARTA SELATAN,PANCORAN,RAWA JATI,20509,7321,13188,8103,21291,2021-09-15
3175061002,JAKARTA TIMUR,CAKUNG,RAWA TERATE,24637,7436,17201,12872,30073,2021-09-15
3175021005,JAKARTA TIMUR,PULO GADUNG,RAWAMANGUN,37612,13013,24599,18428,43027,2021-09-15
3171051003,JAKARTA PUSAT,CEMPAKA PUTIH,RAWASARI,21967,7725,14242,10797,25039,2021-09-15
3173041010,JAKARTA BARAT,TAMBORA,ROA MALAKA,3484,1018,2466,1949,4415,2021-09-15
3172041006,JAKARTA UTARA,CILINCING,ROROTAN,41668,13277,28391,19915,48306,2021-09-15
3174071004,JAKARTA SELATAN,KEBAYORAN BARU,SELONG,2842,968,1874,1435,3309,2021-09-15
3173061002,JAKARTA BARAT,KALI DERES,SEMANAN,71354,25564,45790,32950,78740,2021-09-15
3172041007,JAKARTA UTARA,CILINCING,SEMPER BARAT,68587,21732,46855,35314,82169,2021-09-15
3172041005,JAKARTA UTARA,CILINCING,SEMPER TIMUR,36267,12045,24222,17662,41884,2021-09-15
3174071006,JAKARTA SELATAN,KEBAYORAN BARU,SENAYAN,2771,1111,1660,1139,2799,2021-09-15
3171041001,JAKARTA PUSAT,SENEN,SENEN,6804,2201,4603,3558,8161,2021-09-15
3171031004,JAKARTA PUSAT,KEMAYORAN,SERDANG,29668,10039,19629,14587,34216,2021-09-15
3174021001,JAKARTA SELATAN,SETIA BUDI,SETIA BUDI,3023,1100,1923,1335,3258,2021-09-15
3175101005,JAKARTA TIMUR,CIPAYUNG,SETU,20572,7339,13233,9568,22801,2021-09-15
3173071002,JAKARTA BARAT,PALMERAH,SLIPI,16591,5435,11156,8346,19502,2021-09-15
3173081004,JAKARTA BARAT,KEMBANGAN,SRENGSENG,45523,16552,28971,21107,50078,2021-09-15
3174091002,JAKARTA SELATAN,JAGAKARSA,SRENGSENG SAWAH,58196,18767,39429,25008,64437,2021-09-15
3173051003,JAKARTA BARAT,KEBON JERUK,SUKABUMI SELATAN,37033,13527,23506,15124,38630,2021-09-15
3173051002,JAKARTA BARAT,KEBON JERUK,SUKABUMI UTARA,38290,14433,23857,15154,39011,2021-09-15
3172041002,JAKARTA UTARA,CILINCING,SUKAPURA,53949,18938,35011,26278,61289,2021-09-15
3171031007,JAKARTA PUSAT,KEMAYORAN,SUMUR BATU,22717,7878,14839,11409,26248,2021-09-15
3172021004,JAKARTA UTARA,TANJUNG PRIOK,SUNGAI BAMBU,29876,10032,19844,15044,34888,2021-09-15
3172021006,JAKARTA UTARA,TANJUNG PRIOK,SUNTER AGUNG,71805,21047,50758,40560,91318,2021-09-15
3172021002,JAKARTA UTARA,TANJUNG PRIOK,SUNTER JAYA,63031,19156,43875,35211,79086,2021-09-15
3175091004,JAKARTA TIMUR,CIRACAS,SUSUKAN,38257,12056,26201,19015,45216,2021-09-15
3173031001,JAKARTA BARAT,TAMAN SARI,TAMAN SARI,14348,4769,9579,7643,17222,2021-09-15
3173041001,JAKARTA BARAT,TAMBORA,TAMBORA,10204,3539,6665,4676,11341,2021-09-15
3173041004,JAKARTA BARAT,TAMBORA,TANAH SEREAL,26387,7660,18727,13590,32317,2021-09-15
3171081004,JAKARTA PUSAT,JOHAR BARU,TANAH TINGGI,37693,11035,26658,19212,45870,2021-09-15
3173031004,JAKARTA BARAT,TAMAN SARI,TANGKI,13324,4270,9054,7025,16079,2021-09-15
3174091005,JAKARTA SELATAN,JAGAKARSA,TANJUNG BARAT,39770,13947,25823,15392,41215,2021-09-15
3173021005,JAKARTA BARAT,GROGOL PETAMBURAN,TANJUNG DUREN SELATAN,25337,8611,16726,13013,29739,2021-09-15
3173021002,JAKARTA BARAT,GROGOL PETAMBURAN,TANJUNG DUREN UTARA,17010,5459,11551,9066,20617,2021-09-15
3172021001,JAKARTA UTARA,TANJUNG PRIOK,TANJUNG PRIOK,34588,11144,23444,17103,40547,2021-09-15
3174011002,JAKARTA SELATAN,TEBET,TEBET BARAT,21194,6970,14224,9664,23888,2021-09-15
3174011001,JAKARTA SELATAN,TEBET,TEBET TIMUR,18199,5987,12212,8311,20523,2021-09-15
3173061003,JAKARTA BARAT,KALI DERES,TEGAL ALUR,83647,28719,54928,38797,93725,2021-09-15
3174031004,JAKARTA SELATAN,MAMPANG PRAPATAN,TEGAL PARANG,32401,12618,19783,11758,31541,2021-09-15
3173021003,JAKARTA BARAT,GROGOL PETAMBURAN,TOMANG,29605,9894,19711,15536,35247,2021-09-15
3172031005,JAKARTA UTARA,KOJA,TUGU SELATAN,39122,13553,25569,18156,43725,2021-09-15
3172031002,JAKARTA UTARA,KOJA,TUGU UTARA,67670,24792,42878,29997,72875,2021-09-15
3175061006,JAKARTA TIMUR,CAKUNG,UJUNG MENTENG,29934,9339,20595,15874,36469,2021-09-15
3174101005,JAKARTA SELATAN,PESANGGRAHAN,ULUJAMI,40544,16121,24423,14405,38828,2021-09-15
3175011006,JAKARTA TIMUR,MATRAMAN,UTAN KAYU SELATAN,33511,11063,22448,16441,38889,2021-09-15
3175011002,JAKARTA TIMUR,MATRAMAN,UTAN KAYU UTARA,28169,10266,17903,12830,30733,2021-09-15
3171031008,JAKARTA PUSAT,KEMAYORAN,UTAN PANJANG,29208,10262,18946,13721,32667,2021-09-15
3172021007,JAKARTA UTARA,TANJUNG PRIOK,WARAKAS,44401,14126,30275,21969,52244,2021-09-15
3173021007,JAKARTA BARAT,GROGOL PETAMBURAN,WIJAYA KUSUMA,38934,13854,25080,18940,44020,2021-09-15
3172051003,JAKARTA UTARA,PADEMANGAN,ANCOL,23947,8757,15190,11520,26710,2021-09-16
3173041007,JAKARTA BARAT,TAMBORA,ANGKE,29381,9839,19542,14062,33604,2021-09-16
3175041005,JAKARTA TIMUR,KRAMAT JATI,BALE KAMBANG,29074,11610,17464,11195,28659,2021-09-16
3175031003,JAKARTA TIMUR,JATINEGARA,BALI MESTER,9752,3507,6245,4702,10947,2021-09-16
3175101006,JAKARTA TIMUR,CIPAYUNG,BAMBU APUS,26285,8751,17534,13176,30710,2021-09-16
3174031002,JAKARTA SELATAN,MAMPANG PRAPATAN,BANGKA,21566,8252,13314,8487,21801,2021-09-16
3175051002,JAKARTA TIMUR,PASAR REBO,BARU,23886,7211,16675,13149,29824,2021-09-16
3175041004,JAKARTA TIMUR,KRAMAT JATI,BATU AMPAR,47898,18620,29278,20348,49626,2021-09-16
3171071002,JAKARTA PUSAT,TANAH ABANG,BENDUNGAN HILIR,21494,7597,13897,10325,24222,2021-09-16
3175031002,JAKARTA TIMUR,JATINEGARA,BIDARA CINA,36689,14392,22297,15866,38163,2021-09-16
3174101002,JAKARTA SELATAN,PESANGGRAHAN,BINTARO,53098,19911,33187,21570,54757,2021-09-16
3174011005,JAKARTA SELATAN,TEBET,BUKIT DURI,34183,13106,21077,12775,33852,2021-09-16
3171041006,JAKARTA PUSAT,SENEN,BUNGUR,18144,6130,12014,9051,21065,2021-09-16
3175061007,JAKARTA TIMUR,CAKUNG,CAKUNG BARAT,57724,18416,39308,29424,68732,2021-09-16
3175061004,JAKARTA TIMUR,CAKUNG,CAKUNG TIMUR,58287,18524,39763,30375,70138,2021-09-16
3175041007,JAKARTA TIMUR,KRAMAT JATI,CAWANG,32762,12006,20756,14492,35248,2021-09-16
3175101008,JAKARTA TIMUR,CIPAYUNG,CEGER,18932,6232,12700,9543,22243,2021-09-16
3171031006,JAKARTA PUSAT,KEMAYORAN,CEMPAKA BARU,32581,11285,21296,15183,36479,2021-09-16
3171051002,JAKARTA PUSAT,CEMPAKA PUTIH,CEMPAKA PUTIH BARAT,35885,12512,23373,18117,41490,2021-09-16
3171051001,JAKARTA PUSAT,CEMPAKA PUTIH,CEMPAKA PUTIH TIMUR,24292,8153,16139,12465,28604,2021-09-16
3173011001,JAKARTA BARAT,CENGKARENG,CENGKARENG BARAT,66284,22186,44098,34014,78112,2021-09-16
3173011006,JAKARTA BARAT,CENGKARENG,CENGKARENG TIMUR,81027,26504,54523,39628,94151,2021-09-16
3175091002,JAKARTA TIMUR,CIRACAS,CIBUBUR,66364,20476,45888,34923,80811,2021-09-16
3171011002,JAKARTA PUSAT,GAMBIR,CIDENG,15390,4991,10399,8122,18521,2021-09-16
3174091003,JAKARTA SELATAN,JAGAKARSA,CIGANJUR,38497,13822,24675,15087,39762,2021-09-16
3175051003,JAKARTA TIMUR,PASAR REBO,CIJANTUNG,41419,13065,28354,21572,49926,2021-09-16
3171061003,JAKARTA PUSAT,MENTENG,CIKINI,8274,2724,5550,3845,9395,2021-09-16
3174081006,JAKARTA SELATAN,PANCORAN,CIKOKO,10547,3592,6955,4253,11208,2021-09-16
3174061001,JAKARTA SELATAN,CILANDAK,CILANDAK BARAT,51752,18528,33224,21540,54764,2021-09-16
3174041003,JAKARTA SELATAN,PASAR MINGGU,CILANDAK TIMUR,25145,8884,16261,11065,27326,2021-09-16
3175101002,JAKARTA TIMUR,CIPAYUNG,CILANGKAP,27635,9075,18560,14019,32579,2021-09-16
3175041006,JAKARTA TIMUR,KRAMAT JATI,CILILITAN,40181,15140,25041,18187,43228,2021-09-16
3172041001,JAKARTA UTARA,CILINCING,CILINCING,43609,15765,27844,19535,47379,2021-09-16
3175101001,JAKARTA TIMUR,CIPAYUNG,CIPAYUNG,26104,7884,18220,14247,32467,2021-09-16
3174091006,JAKARTA SELATAN,JAGAKARSA,CIPEDAK,38303,12783,25520,16237,41757,2021-09-16
3174061005,JAKARTA SELATAN,CILANDAK,CIPETE SELATAN,26704,9997,16707,11526,28233,2021-09-16
3174071010,JAKARTA SELATAN,KEBAYORAN BARU,CIPETE UTARA,34102,12451,21651,13781,35432,2021-09-16
3175021003,JAKARTA TIMUR,PULO GADUNG,CIPINANG,39306,13411,25895,19004,44899,2021-09-16
3175031007,JAKARTA TIMUR,JATINEGARA,CIPINANG BESAR SELATAN,35212,13159,22053,15159,37212,2021-09-16
3175031008,JAKARTA TIMUR,JATINEGARA,CIPINANG BESAR UTARA,45319,16967,28352,19894,48246,2021-09-16
3175031005,JAKARTA TIMUR,JATINEGARA,CIPINANG CEMPEDAK,32824,12552,20272,15420,35692,2021-09-16
3175081005,JAKARTA TIMUR,MAKASAR,CIPINANG MELAYU,42308,15159,27149,20962,48111,2021-09-16
3175031006,JAKARTA TIMUR,JATINEGARA,CIPINANG MUARA,55243,20569,34674,25195,59869,2021-09-16
3174051003,JAKARTA SELATAN,KEBAYORAN LAMA,CIPULIR,39937,15897,24040,13776,37816,2021-09-16
3175091001,JAKARTA TIMUR,CIRACAS,CIRACAS,64594,19880,44714,33137,77851,2021-09-16
3175041003,JAKARTA TIMUR,KRAMAT JATI,DUKUH,24609,8102,16507,12310,28817,2021-09-16
3175071001,JAKARTA TIMUR,DUREN SAWIT,DUREN SAWIT,61160,22493,38667,28767,67434,2021-09-16
3174081004,JAKARTA SELATAN,PANCORAN,DUREN TIGA,28319,10418,17901,10092,27993,2021-09-16
3173051005,JAKARTA BARAT,KEBON JERUK,DURI KEPA,60138,19594,40544,31456,72000,2021-09-16
3173011002,JAKARTA BARAT,CENGKARENG,DURI KOSAMBI,77923,28887,49036,34685,83721,2021-09-16
3171011006,JAKARTA PUSAT,GAMBIR,DURI PULO,19610,6648,12962,9432,22394,2021-09-16
3173041011,JAKARTA BARAT,TAMBORA,DURI SELATAN,14259,4374,9885,7535,17420,2021-09-16
3173041003,JAKARTA BARAT,TAMBORA,DURI UTARA,19844,6374,13470,9772,23242,2021-09-16
3171081003,JAKARTA PUSAT,JOHAR BARU,GALUR,18243,5431,12812,9358,22170,2021-09-16
3171011001,JAKARTA PUSAT,GAMBIR,GAMBIR,2191,712,1479,1163,2642,2021-09-16
3174061004,JAKARTA SELATAN,CILANDAK,GANDARIA SELATAN,22119,8214,13905,8586,22491,2021-09-16
3174071009,JAKARTA SELATAN,KEBAYORAN BARU,GANDARIA UTARA,39922,14920,25002,16051,41053,2021-09-16
3175051001,JAKARTA TIMUR,PASAR REBO,GEDONG,35755,11922,23833,18052,41885,2021-09-16
3171071001,JAKARTA PUSAT,TANAH ABANG,GELORA,3127,1142,1985,1404,3389,2021-09-16
3173031007,JAKARTA BARAT,TAMAN SARI,GLODOK,7837,2270,5567,4639,10206,2021-09-16
3171061004,JAKARTA PUSAT,MENTENG,GONDANGDIA,4100,1439,2661,2209,4870,2021-09-16
3173021001,JAKARTA BARAT,GROGOL PETAMBURAN,GROGOL,16876,5814,11062,8414,19476,2021-09-16
3174051005,JAKARTA SELATAN,KEBAYORAN LAMA,GROGOL SELATAN,44251,16843,27408,16441,43849,2021-09-16
3174051004,JAKARTA SELATAN,KEBAYORAN LAMA,GROGOL UTARA,42494,15865,26629,16472,43101,2021-09-16
3174021007,JAKARTA SELATAN,SETIA BUDI,GUNTUR,3985,1358,2627,1966,4593,2021-09-16
3174071002,JAKARTA SELATAN,KEBAYORAN BARU,GUNUNG,9436,3313,6123,4367,10490,2021-09-16
3171031005,JAKARTA PUSAT,KEMAYORAN,GUNUNG SAHARI SELATAN,19199,6553,12646,9844,22490,2021-09-16
3171021004,JAKARTA PUSAT,SAWAH BESAR,GUNUNG SAHARI UTARA,16650,4931,11719,9590,21309,2021-09-16
3175081004,JAKARTA TIMUR,MAKASAR,HALIM PERDANA KUSUMAH,28363,7559,20804,17791,38595,2021-09-16
3171031003,JAKARTA PUSAT,KEMAYORAN,HARAPAN MULIA,22557,7602,14955,11262,26217,2021-09-16
3174091001,JAKARTA SELATAN,JAGAKARSA,JAGAKARSA,62389,21686,40703,26568,67271,2021-09-16
3175021007,JAKARTA TIMUR,PULO GADUNG,JATI,32757,11051,21706,16644,38350,2021-09-16
3174041002,JAKARTA SELATAN,PASAR MINGGU,JATI PADANG,37502,13741,23761,15493,39254,2021-09-16
3173071004,JAKARTA BARAT,PALMERAH,JATI PULO,28738,9240,19498,14086,33584,2021-09-16
3175061001,JAKARTA TIMUR,CAKUNG,JATINEGARA,84160,29118,55042,41459,96501,2021-09-16
3175021004,JAKARTA TIMUR,PULO GADUNG,JATINEGARA KAUM,24632,7792,16840,11537,28377,2021-09-16
3173021004,JAKARTA BARAT,GROGOL PETAMBURAN,JELAMBAR,30266,10219,20047,15813,35860,2021-09-16
3173021006,JAKARTA BARAT,GROGOL PETAMBURAN,JELAMBAR BARU,38246,12760,25486,20119,45605,2021-09-16
3173041006,JAKARTA BARAT,TAMBORA,JEMBATAN BESI,29314,11050,18264,12317,30581,2021-09-16
3173041008,JAKARTA BARAT,TAMBORA,JEMBATAN LIMA,21021,7661,13360,9309,22669,2021-09-16
3173081005,JAKARTA BARAT,KEMBANGAN,JOGLO,40839,13961,26878,19894,46772,2021-09-16
3171081001,JAKARTA PUSAT,JOHAR BARU,JOHAR BARU,37488,11384,26104,20083,46187,2021-09-16
3173041002,JAKARTA BARAT,TAMBORA,KALI ANYAR,23856,7744,16112,11450,27562,2021-09-16
3172041004,JAKARTA UTARA,CILINCING,KALIBARU,67684,26168,41516,26423,67939,2021-09-16
3174081002,JAKARTA SELATAN,PANCORAN,KALIBATA,41994,17242,24752,13848,38600,2021-09-16
3173061001,JAKARTA BARAT,KALI DERES,KALIDERES,72447,25206,47241,37076,84317,2021-09-16
3175051004,JAKARTA TIMUR,PASAR REBO,KALISARI,43212,13890,29322,22655,51977,2021-09-16
3173061004,JAKARTA BARAT,KALI DERES,KAMAL,53783,19450,34333,24511,58844,2021-09-16
3172011002,JAKARTA UTARA,PENJARINGAN,KAMAL MUARA,12930,3362,9568,7678,17246,2021-09-16
3171071007,JAKARTA PUSAT,TANAH ABANG,KAMPUNG BALI,11358,4164,7194,4954,12148,2021-09-16
3175031001,JAKARTA TIMUR,JATINEGARA,KAMPUNG MELAYU,25717,9870,15847,11204,27051,2021-09-16
3171081002,JAKARTA PUSAT,JOHAR BARU,KAMPUNG RAWA,21237,5524,15713,11326,27039,2021-09-16
3175041002,JAKARTA TIMUR,KRAMAT JATI,KAMPUNG TENGAH,43993,16870,27123,18667,45790,2021-09-16
3173011005,JAKARTA BARAT,CENGKARENG,KAPUK,134466,49216,85250,59706,144956,2021-09-16
3172011003,JAKARTA UTARA,PENJARINGAN,KAPUK MUARA,35781,10596,25185,20795,45980,2021-09-16
3171021002,JAKARTA PUSAT,SAWAH BESAR,KARANG ANYAR,25761,8195,17566,13340,30906,2021-09-16
3174021004,JAKARTA SELATAN,SETIA BUDI,KARET,9623,3568,6055,4091,10146,2021-09-16
3174021003,JAKARTA SELATAN,SETIA BUDI,KARET KUNINGAN,16055,5300,10755,7293,18048,2021-09-16
3174021002,JAKARTA SELATAN,SETIA BUDI,KARET SEMANGGI,2770,935,1835,1420,3255,2021-09-16
3171071003,JAKARTA PUSAT,TANAH ABANG,KARET TENGSIN,19271,6352,12919,9055,21974,2021-09-16
3171021003,JAKARTA PUSAT,SAWAH BESAR,KARTINI,22292,7358,14934,11792,26726,2021-09-16
3175011003,JAKARTA TIMUR,MATRAMAN,KAYU MANIS,25284,9381,15903,11031,26934,2021-09-16
3175021006,JAKARTA TIMUR,PULO GADUNG,KAYU PUTIH,40696,13234,27462,21708,49170,2021-09-16
3173031006,JAKARTA BARAT,TAMAN SARI,KEAGUNGAN,17387,5675,11712,8895,20607,2021-09-16
3174041007,JAKARTA SELATAN,PASAR MINGGU,KEBAGUSAN,44552,16973,27579,16765,44344,2021-09-16
3174051006,JAKARTA SELATAN,KEBAYORAN LAMA,KEBAYORAN LAMA SELATAN,41212,14676,26536,16205,42741,2021-09-16
3174051001,JAKARTA SELATAN,KEBAYORAN LAMA,KEBAYORAN LAMA UTARA,42422,16471,25951,14748,40699,2021-09-16
3174011004,JAKARTA SELATAN,TEBET,KEBON BARU,35165,12746,22419,14011,36430,2021-09-16
3172021005,JAKARTA UTARA,TANJUNG PRIOK,KEBON BAWANG,50952,17361,33591,25191,58782,2021-09-16
3173051001,JAKARTA BARAT,KEBON JERUK,KEBON JERUK,53887,19600,34287,24912,59199,2021-09-16
3171071006,JAKARTA PUSAT,TANAH ABANG,KEBON KACANG,21531,8351,13180,9257,22437,2021-09-16
3171011005,JAKARTA PUSAT,GAMBIR,KEBON KELAPA,10163,3458,6705,5118,11823,2021-09-16
3171031002,JAKARTA PUSAT,KEMAYORAN,KEBON KOSONG,30019,10263,19756,14879,34635,2021-09-16
3175011005,JAKARTA TIMUR,MATRAMAN,KEBON MANGGIS,16490,5598,10892,8017,18909,2021-09-16
3171071005,JAKARTA PUSAT,TANAH ABANG,KEBON MELATI,32206,13014,19192,12692,31884,2021-09-16
3175081003,JAKARTA TIMUR,MAKASAR,KEBON PALA,46614,16129,30485,22050,52535,2021-09-16
3171061005,JAKARTA PUSAT,MENTENG,KEBON SIRIH,12299,4308,7991,5767,13758,2021-09-16
3173011004,JAKARTA BARAT,CENGKARENG,KEDAUNG KALI ANGKE,32612,10086,22526,17359,39885,2021-09-16
3173051007,JAKARTA BARAT,KEBON JERUK,KEDOYA SELATAN,32165,10569,21596,16017,37613,2021-09-16
3173051006,JAKARTA BARAT,KEBON JERUK,KEDOYA UTARA,45740,14293,31447,24674,56121,2021-09-16
3173051004,JAKARTA BARAT,KEBON JERUK,KELAPA DUA,23565,8508,15057,11409,26466,2021-09-16
3175091003,JAKARTA TIMUR,CIRACAS,KELAPA DUA WETAN,46875,14233,32642,24555,57197,2021-09-16
3172061003,JAKARTA UTARA,KELAPA GADING,KELAPA GADING BARAT,35717,10695,25022,21013,46035,2021-09-16
3172061001,JAKARTA UTARA,KELAPA GADING,KELAPA GADING TIMUR,33592,9211,24381,20498,44879,2021-09-16
3173071005,JAKARTA BARAT,PALMERAH,KEMANGGISAN,32139,10796,21343,15603,36946,2021-09-16
3171031001,JAKARTA PUSAT,KEMAYORAN,KEMAYORAN,20708,6760,13948,10715,24663,2021-09-16
3173081006,JAKARTA BARAT,KEMBANGAN,KEMBANGAN SELATAN,27130,9244,17886,14151,32037,2021-09-16
3173081001,JAKARTA BARAT,KEMBANGAN,KEMBANGAN UTARA,54451,18330,36121,27443,63564,2021-09-16
3171041002,JAKARTA PUSAT,SENEN,KENARI,9579,3118,6461,5102,11563,2021-09-16
3173041005,JAKARTA BARAT,TAMBORA,KERENDANG,19973,6616,13357,9606,22963,2021-09-16
3175071003,JAKARTA TIMUR,DUREN SAWIT,KLENDER,69978,26173,43805,31065,74870,2021-09-16
3172031001,JAKARTA UTARA,KOJA,KOJA,28175,10153,18022,13615,31637,2021-09-16
3173071006,JAKARTA BARAT,PALMERAH,KOTA BAMBU SELATAN,21158,7202,13956,9765,23721,2021-09-16
3173071003,JAKARTA BARAT,PALMERAH,KOTA BAMBU UTARA,24995,8791,16204,11231,27435,2021-09-16
3171041004,JAKARTA PUSAT,SENEN,KRAMAT,28835,10293,18542,12339,30881,2021-09-16
3175041001,JAKARTA TIMUR,KRAMAT JATI,KRAMAT JATI,34144,11955,22189,15911,38100,2021-09-16
3174071003,JAKARTA SELATAN,KEBAYORAN BARU,KRAMAT PELA,14413,4989,9424,6124,15548,2021-09-16
3173031002,JAKARTA BARAT,TAMAN SARI,KRUKUT,19244,6340,12904,9579,22483,2021-09-16
3174031005,JAKARTA SELATAN,MAMPANG PRAPATAN,KUNINGAN BARAT,12785,4445,8340,5297,13637,2021-09-16
3174021008,JAKARTA SELATAN,SETIA BUDI,KUNINGAN TIMUR,6008,2118,3890,2662,6552,2021-09-16
3171041005,JAKARTA PUSAT,SENEN,KWITANG,15486,5375,10111,7544,17655,2021-09-16
3172031003,JAKARTA UTARA,KOJA,LAGOA,59065,21555,37510,26196,63706,2021-09-16
3174061002,JAKARTA SELATAN,CILANDAK,LEBAK BULUS,37626,14234,23392,15265,38657,2021-09-16
3174091004,JAKARTA SELATAN,JAGAKARSA,LENTENG AGUNG,53946,20351,33595,19581,53176,2021-09-16
3175101007,JAKARTA TIMUR,CIPAYUNG,LUBANG BUAYA,63547,20287,43260,32826,76086,2021-09-16
3175081001,JAKARTA TIMUR,MAKASAR,MAKASAR,34390,11365,23025,17514,40539,2021-09-16
3175071006,JAKARTA TIMUR,DUREN SAWIT,MALAKA JAYA,30927,10554,20373,15781,36154,2021-09-16
3175071005,JAKARTA TIMUR,DUREN SAWIT,MALAKA SARI,27530,9046,18484,14622,33106,2021-09-16
3174031001,JAKARTA SELATAN,MAMPANG PRAPATAN,MAMPANG PRAPATAN,18159,6637,11522,7517,19039,2021-09-16
3173031005,JAKARTA BARAT,TAMAN SARI,MANGGA BESAR,7707,2249,5458,4379,9837,2021-09-16
3171021005,JAKARTA PUSAT,SAWAH BESAR,MANGGA DUA SELATAN,27442,8991,18451,14224,32675,2021-09-16
3174011007,JAKARTA SELATAN,TEBET,MANGGARAI,28373,9399,18974,11489,30463,2021-09-16
3174011006,JAKARTA SELATAN,TEBET,MANGGARAI SELATAN,23075,7901,15174,9761,24935,2021-09-16
3173031003,JAKARTA BARAT,TAMAN SARI,MAPHAR,16461,5548,10913,8425,19338,2021-09-16
3172041003,JAKARTA UTARA,CILINCING,MARUNDA,28943,9375,19568,12916,32484,2021-09-16
3174071001,JAKARTA SELATAN,KEBAYORAN BARU,MELAWAI,2627,886,1741,1391,3132,2021-09-16
3171061001,JAKARTA PUSAT,MENTENG,MENTENG,25624,9217,16407,11819,28226,2021-09-16
3174021005,JAKARTA SELATAN,SETIA BUDI,MENTENG ATAS,27816,9408,18408,11614,30022,2021-09-16
3174011003,JAKARTA SELATAN,TEBET,MENTENG DALAM,36028,13010,23018,14847,37865,2021-09-16
3173081003,JAKARTA BARAT,KEMBANGAN,MERUYA SELATAN,32130,11040,21090,16006,37096,2021-09-16
3173081002,JAKARTA BARAT,KEMBANGAN,MERUYA UTARA,43752,15164,28588,22572,51160,2021-09-16
3175101004,JAKARTA TIMUR,CIPAYUNG,MUNJUL,23871,7696,16175,12409,28584,2021-09-16
3172051002,JAKARTA UTARA,PADEMANGAN,PADEMANGAN BARAT,74240,26467,47773,34991,82764,2021-09-16
3172051001,JAKARTA UTARA,PADEMANGAN,PADEMANGAN TIMUR,37736,11198,26538,21110,47648,2021-09-16
3175011004,JAKARTA TIMUR,MATRAMAN,PAL MERIAM,19769,7286,12483,9137,21620,2021-09-16
3173071001,JAKARTA BARAT,PALMERAH,PALMERAH,63011,22109,40902,28992,69894,2021-09-16
3174081001,JAKARTA SELATAN,PANCORAN,PANCORAN,19421,7158,12263,7611,19874,2021-09-16
3172021003,JAKARTA UTARA,TANJUNG PRIOK,PAPANGGO,39097,12458,26639,20011,46650,2021-09-16
3171021001,JAKARTA PUSAT,SAWAH BESAR,PASAR BARU,12035,3613,8422,6965,15387,2021-09-16
3174021006,JAKARTA SELATAN,SETIA BUDI,PASAR MANGGIS,26752,9657,17095,10846,27941,2021-09-16
3174041001,JAKARTA SELATAN,PASAR MINGGU,PASAR MINGGU,24821,8985,15836,10490,26326,2021-09-16
3171041003,JAKARTA PUSAT,SENEN,PASEBAN,23533,8333,15200,10972,26172,2021-09-16
3173061005,JAKARTA BARAT,KALI DERES,PEGADUNGAN,75587,24434,51153,40742,91895,2021-09-16
3171061002,JAKARTA PUSAT,MENTENG,PEGANGSAAN,23455,8249,15206,10459,25665,2021-09-16
3172061002,JAKARTA UTARA,KELAPA GADING,PEGANGSAAN DUA,49976,13663,36313,30076,66389,2021-09-16
3172011004,JAKARTA UTARA,PENJARINGAN,PEJAGALAN,74578,24965,49613,39142,88755,2021-09-16
3174041006,JAKARTA SELATAN,PASAR MINGGU,PEJATEN BARAT,37346,13960,23386,15050,38436,2021-09-16
3174041005,JAKARTA SELATAN,PASAR MINGGU,PEJATEN TIMUR,57656,22387,35269,20562,55831,2021-09-16
3175051005,JAKARTA TIMUR,PASAR REBO,PEKAYON,43250,13818,29432,22035,51467,2021-09-16
3173041009,JAKARTA BARAT,TAMBORA,PEKOJAN,23587,7456,16131,12284,28415,2021-09-16
3174031003,JAKARTA SELATAN,MAMPANG PRAPATAN,PELA MAMPANG,43522,15668,27854,18597,46451,2021-09-16
3174081005,JAKARTA SELATAN,PANCORAN,PENGADEGAN,21478,7117,14361,8146,22507,2021-09-16
3175061003,JAKARTA TIMUR,CAKUNG,PENGGILINGAN,99255,36622,62633,44339,106972,2021-09-16
3172011001,JAKARTA UTARA,PENJARINGAN,PENJARINGAN,88308,32843,55465,39759,95224,2021-09-16
3174101001,JAKARTA SELATAN,PESANGGRAHAN,PESANGGRAHAN,27545,9405,18140,11592,29732,2021-09-16
3171071004,JAKARTA PUSAT,TANAH ABANG,PETAMBURAN,33271,13447,19824,13217,33041,2021-09-16
3174071008,JAKARTA SELATAN,KEBAYORAN BARU,PETOGOGAN,11499,4258,7241,4842,12083,2021-09-16
3171011004,JAKARTA PUSAT,GAMBIR,PETOJO SELATAN,14692,5275,9417,7176,16593,2021-09-16
3171011003,JAKARTA PUSAT,GAMBIR,PETOJO UTARA,17458,6125,11333,8356,19689,2021-09-16
3174101004,JAKARTA SELATAN,PESANGGRAHAN,PETUKANGAN SELATAN,37187,13623,23564,14551,38115,2021-09-16
3174101003,JAKARTA SELATAN,PESANGGRAHAN,PETUKANGAN UTARA,53716,20827,32889,20743,53632,2021-09-16
3175081002,JAKARTA TIMUR,MAKASAR,PINANG RANTI,27198,9465,17733,13269,31002,2021-09-16
3173031008,JAKARTA BARAT,TAMAN SARI,PINANGSIA,10729,3215,7514,5779,13293,2021-09-16
3175011001,JAKARTA TIMUR,MATRAMAN,PISANGAN BARU,31776,11571,20205,13755,33960,2021-09-16
3175021002,JAKARTA TIMUR,PULO GADUNG,PISANGAN TIMUR,41011,13450,27561,20912,48473,2021-09-16
3172011005,JAKARTA UTARA,PENJARINGAN,PLUIT,47783,15085,32698,26465,59163,2021-09-16
3175071002,JAKARTA TIMUR,DUREN SAWIT,PONDOK BAMBU,61550,22443,39107,29288,68395,2021-09-16
3175071004,JAKARTA TIMUR,DUREN SAWIT,PONDOK KELAPA,72015,25130,46885,34625,81510,2021-09-16
3175071007,JAKARTA TIMUR,DUREN SAWIT,PONDOK KOPI,35367,13134,22233,15012,37245,2021-09-16
3174061003,JAKARTA SELATAN,CILANDAK,PONDOK LABU,46464,16037,30427,20852,51279,2021-09-16
3174051002,JAKARTA SELATAN,KEBAYORAN LAMA,PONDOK PINANG,56169,20806,35363,22831,58194,2021-09-16
3175101003,JAKARTA TIMUR,CIPAYUNG,PONDOK RANGGON,25574,8454,17120,13128,30248,2021-09-16
3101011003,KAB.ADM.KEP.SERIBU,KEP. SERIBU UTARA,PULAU HARAPAN,2060,328,1732,1085,2817,2021-09-16
3101011002,KAB.ADM.KEP.SERIBU,KEP. SERIBU UTARA,PULAU KELAPA,5528,875,4653,2825,7478,2021-09-16
3101011001,KAB.ADM.KEP.SERIBU,KEP. SERIBU UTARA,PULAU PANGGANG,5450,820,4630,2351,6981,2021-09-16
3101021003,KAB.ADM.KEP.SERIBU,KEP. SERIBU SELATAN,PULAU PARI,2765,310,2455,1928,4383,2021-09-16
3101021002,KAB.ADM.KEP.SERIBU,KEP. SERIBU SELATAN,PULAU TIDUNG,4553,596,3957,2812,6769,2021-09-16
3101021001,KAB.ADM.KEP.SERIBU,KEP. SERIBU SELATAN,PULAU UNTUNG JAWA,1941,290,1651,1348,2999,2021-09-16
3174071007,JAKARTA SELATAN,KEBAYORAN BARU,PULO,5835,1954,3881,2913,6794,2021-09-16
3175021001,JAKARTA TIMUR,PULO GADUNG,PULO GADUNG,34422,11854,22568,16520,39088,2021-09-16
3175061005,JAKARTA TIMUR,CAKUNG,PULO GEBANG,97301,33059,64242,45751,109993,2021-09-16
3174041004,JAKARTA SELATAN,PASAR MINGGU,RAGUNAN,39616,13868,25748,16771,42519,2021-09-16
3175091005,JAKARTA TIMUR,CIRACAS,RAMBUTAN,36771,13700,23071,16671,39742,2021-09-16
3172031006,JAKARTA UTARA,KOJA,RAWA BADAK SELATAN,42179,15338,26841,18879,45720,2021-09-16
3172031004,JAKARTA UTARA,KOJA,RAWA BADAK UTARA,34408,12316,22092,16289,38381,2021-09-16
3174071005,JAKARTA SELATAN,KEBAYORAN BARU,RAWA BARAT,5625,1861,3764,2644,6408,2021-09-16
3173011003,JAKARTA BARAT,CENGKARENG,RAWA BUAYA,63799,21770,42029,29434,71463,2021-09-16
3175031004,JAKARTA TIMUR,JATINEGARA,RAWA BUNGA,21434,8107,13327,9832,23159,2021-09-16
3174081003,JAKARTA SELATAN,PANCORAN,RAWA JATI,20509,7313,13196,8128,21324,2021-09-16
3175061002,JAKARTA TIMUR,CAKUNG,RAWA TERATE,24637,7420,17217,12981,30198,2021-09-16
3175021005,JAKARTA TIMUR,PULO GADUNG,RAWAMANGUN,37612,12954,24658,18652,43310,2021-09-16
3171051003,JAKARTA PUSAT,CEMPAKA PUTIH,RAWASARI,21967,7703,14264,10915,25179,2021-09-16
3173041010,JAKARTA BARAT,TAMBORA,ROA MALAKA,3484,1015,2469,1967,4436,2021-09-16
3172041006,JAKARTA UTARA,CILINCING,ROROTAN,41668,13192,28476,20390,48866,2021-09-16
3174071004,JAKARTA SELATAN,KEBAYORAN BARU,SELONG,2842,966,1876,1438,3314,2021-09-16
3173061002,JAKARTA BARAT,KALI DERES,SEMANAN,71354,25447,45907,33603,79510,2021-09-16
3172041007,JAKARTA UTARA,CILINCING,SEMPER BARAT,68587,21636,46951,35904,82855,2021-09-16
3172041005,JAKARTA UTARA,CILINCING,SEMPER TIMUR,36267,11959,24308,17970,42278,2021-09-16
3174071006,JAKARTA SELATAN,KEBAYORAN BARU,SENAYAN,2771,1110,1661,1140,2801,2021-09-16
3171041001,JAKARTA PUSAT,SENEN,SENEN,6804,2194,4610,3589,8199,2021-09-16
3171031004,JAKARTA PUSAT,KEMAYORAN,SERDANG,29668,9959,19709,14806,34515,2021-09-16
3174021001,JAKARTA SELATAN,SETIA BUDI,SETIA BUDI,3023,1099,1924,1343,3267,2021-09-16
3175101005,JAKARTA TIMUR,CIPAYUNG,SETU,20572,7312,13260,9748,23008,2021-09-16
3173071002,JAKARTA BARAT,PALMERAH,SLIPI,16591,5409,11182,8454,19636,2021-09-16
3173081004,JAKARTA BARAT,KEMBANGAN,SRENGSENG,45523,16513,29010,21572,50582,2021-09-16
3174091002,JAKARTA SELATAN,JAGAKARSA,SRENGSENG SAWAH,58196,18745,39451,25078,64529,2021-09-16
3173051003,JAKARTA BARAT,KEBON JERUK,SUKABUMI SELATAN,37033,13502,23531,15440,38971,2021-09-16
3173051002,JAKARTA BARAT,KEBON JERUK,SUKABUMI UTARA,38290,14375,23915,15420,39335,2021-09-16
3172041002,JAKARTA UTARA,CILINCING,SUKAPURA,53949,18868,35081,26703,61784,2021-09-16
3171031007,JAKARTA PUSAT,KEMAYORAN,SUMUR BATU,22717,7854,14863,11499,26362,2021-09-16
3172021004,JAKARTA UTARA,TANJUNG PRIOK,SUNGAI BAMBU,29876,9976,19900,15191,35091,2021-09-16
3172021006,JAKARTA UTARA,TANJUNG PRIOK,SUNTER AGUNG,71805,20929,50876,41083,91959,2021-09-16
3172021002,JAKARTA UTARA,TANJUNG PRIOK,SUNTER JAYA,63031,19025,44006,35519,79525,2021-09-16
3175091004,JAKARTA TIMUR,CIRACAS,SUSUKAN,38257,12007,26250,19404,45654,2021-09-16
3173031001,JAKARTA BARAT,TAMAN SARI,TAMAN SARI,14348,4756,9592,7733,17325,2021-09-16
3173041001,JAKARTA BARAT,TAMBORA,TAMBORA,10204,3519,6685,4723,11408,2021-09-16
3173041004,JAKARTA BARAT,TAMBORA,TANAH SEREAL,26387,7622,18765,13773,32538,2021-09-16
3171081004,JAKARTA PUSAT,JOHAR BARU,TANAH TINGGI,37693,11002,26691,19547,46238,2021-09-16
3173031004,JAKARTA BARAT,TAMAN SARI,TANGKI,13324,4257,9067,7097,16164,2021-09-16
3174091005,JAKARTA SELATAN,JAGAKARSA,TANJUNG BARAT,39770,13922,25848,15451,41299,2021-09-16
3173021005,JAKARTA BARAT,GROGOL PETAMBURAN,TANJUNG DUREN SELATAN,25337,8581,16756,13137,29893,2021-09-16
3173021002,JAKARTA BARAT,GROGOL PETAMBURAN,TANJUNG DUREN UTARA,17010,5431,11579,9124,20703,2021-09-16
3172021001,JAKARTA UTARA,TANJUNG PRIOK,TANJUNG PRIOK,34588,11102,23486,17335,40821,2021-09-16
3174011002,JAKARTA SELATAN,TEBET,TEBET BARAT,21194,6963,14231,9704,23935,2021-09-16
3174011001,JAKARTA SELATAN,TEBET,TEBET TIMUR,18199,5977,12222,8360,20582,2021-09-16
3173061003,JAKARTA BARAT,KALI DERES,TEGAL ALUR,83647,28570,55077,39853,94930,2021-09-16
3174031004,JAKARTA SELATAN,MAMPANG PRAPATAN,TEGAL PARANG,32401,12609,19792,11796,31588,2021-09-16
3173021003,JAKARTA BARAT,GROGOL PETAMBURAN,TOMANG,29605,9860,19745,15680,35425,2021-09-16
3172031005,JAKARTA UTARA,KOJA,TUGU SELATAN,39122,13510,25612,18517,44129,2021-09-16
3172031002,JAKARTA UTARA,KOJA,TUGU UTARA,67670,24687,42983,30636,73619,2021-09-16
3175061006,JAKARTA TIMUR,CAKUNG,UJUNG MENTENG,29934,9288,20646,16020,36666,2021-09-16
3174101005,JAKARTA SELATAN,PESANGGRAHAN,ULUJAMI,40544,16108,24436,14445,38881,2021-09-16
3175011006,JAKARTA TIMUR,MATRAMAN,UTAN KAYU SELATAN,33511,11012,22499,16658,39157,2021-09-16
3175011002,JAKARTA TIMUR,MATRAMAN,UTAN KAYU UTARA,28169,10217,17952,13029,30981,2021-09-16
3171031008,JAKARTA PUSAT,KEMAYORAN,UTAN PANJANG,29208,10215,18993,13874,32867,2021-09-16
3172021007,JAKARTA UTARA,TANJUNG PRIOK,WARAKAS,44401,14068,30333,22373,52706,2021-09-16
3173021007,JAKARTA BARAT,GROGOL PETAMBURAN,WIJAYA KUSUMA,38934,13788,25146,19248,44394,2021-09-16
3172051003,JAKARTA UTARA,PADEMANGAN,ANCOL,23947,8707,15240,11683,26923,2021-09-17
3173041007,JAKARTA BARAT,TAMBORA,ANGKE,29381,9792,19589,14265,33854,2021-09-17
3175041005,JAKARTA TIMUR,KRAMAT JATI,BALE KAMBANG,29074,11526,17548,11296,28844,2021-09-17
3175031003,JAKARTA TIMUR,JATINEGARA,BALI MESTER,9752,3496,6256,4738,10994,2021-09-17
3175101006,JAKARTA TIMUR,CIPAYUNG,BAMBU APUS,26285,8686,17599,13314,30913,2021-09-17
3174031002,JAKARTA SELATAN,MAMPANG PRAPATAN,BANGKA,21566,8251,13315,8501,21816,2021-09-17
3175051002,JAKARTA TIMUR,PASAR REBO,BARU,23886,7195,16691,13297,29988,2021-09-17
3175041004,JAKARTA TIMUR,KRAMAT JATI,BATU AMPAR,47898,18543,29355,20560,49915,2021-09-17
3171071002,JAKARTA PUSAT,TANAH ABANG,BENDUNGAN HILIR,21494,7577,13917,10364,24281,2021-09-17
3175031002,JAKARTA TIMUR,JATINEGARA,BIDARA CINA,36689,14349,22340,16034,38374,2021-09-17
3174101002,JAKARTA SELATAN,PESANGGRAHAN,BINTARO,53098,19901,33197,21606,54803,2021-09-17
3174011005,JAKARTA SELATAN,TEBET,BUKIT DURI,34183,13088,21095,12809,33904,2021-09-17
3171041006,JAKARTA PUSAT,SENEN,BUNGUR,18144,6105,12039,9158,21197,2021-09-17
3175061007,JAKARTA TIMUR,CAKUNG,CAKUNG BARAT,57724,18318,39406,29884,69290,2021-09-17
3175061004,JAKARTA TIMUR,CAKUNG,CAKUNG TIMUR,58287,18419,39868,30602,70470,2021-09-17
3175041007,JAKARTA TIMUR,KRAMAT JATI,CAWANG,32762,11962,20800,14656,35456,2021-09-17
3175101008,JAKARTA TIMUR,CIPAYUNG,CEGER,18932,6191,12741,9691,22432,2021-09-17
3171031006,JAKARTA PUSAT,KEMAYORAN,CEMPAKA BARU,32581,11215,21366,15345,36711,2021-09-17
3171051002,JAKARTA PUSAT,CEMPAKA PUTIH,CEMPAKA PUTIH BARAT,35885,12454,23431,18279,41710,2021-09-17
3171051001,JAKARTA PUSAT,CEMPAKA PUTIH,CEMPAKA PUTIH TIMUR,24292,8109,16183,12607,28790,2021-09-17
3173011001,JAKARTA BARAT,CENGKARENG,CENGKARENG BARAT,66284,22002,44282,34248,78530,2021-09-17
3173011006,JAKARTA BARAT,CENGKARENG,CENGKARENG TIMUR,81027,26362,54665,40011,94676,2021-09-17
3175091002,JAKARTA TIMUR,CIRACAS,CIBUBUR,66364,20408,45956,35074,81030,2021-09-17
3171011002,JAKARTA PUSAT,GAMBIR,CIDENG,15390,4966,10424,8163,18587,2021-09-17
3174091003,JAKARTA SELATAN,JAGAKARSA,CIGANJUR,38497,13810,24687,15111,39798,2021-09-17
3175051003,JAKARTA TIMUR,PASAR REBO,CIJANTUNG,41419,13003,28416,21727,50143,2021-09-17
3171061003,JAKARTA PUSAT,MENTENG,CIKINI,8274,2545,5729,3864,9593,2021-09-17
3174081006,JAKARTA SELATAN,PANCORAN,CIKOKO,10547,3587,6960,4262,11222,2021-09-17
3174061001,JAKARTA SELATAN,CILANDAK,CILANDAK BARAT,51752,18523,33229,21570,54799,2021-09-17
3174041003,JAKARTA SELATAN,PASAR MINGGU,CILANDAK TIMUR,25145,8881,16264,11079,27343,2021-09-17
3175101002,JAKARTA TIMUR,CIPAYUNG,CILANGKAP,27635,9045,18590,14165,32755,2021-09-17
3175041006,JAKARTA TIMUR,KRAMAT JATI,CILILITAN,40181,15001,25180,18401,43581,2021-09-17
3172041001,JAKARTA UTARA,CILINCING,CILINCING,43609,15677,27932,19766,47698,2021-09-17
3175101001,JAKARTA TIMUR,CIPAYUNG,CIPAYUNG,26104,7850,18254,14420,32674,2021-09-17
3174091006,JAKARTA SELATAN,JAGAKARSA,CIPEDAK,38303,12779,25524,16250,41774,2021-09-17
3174061005,JAKARTA SELATAN,CILANDAK,CIPETE SELATAN,26704,9994,16710,11540,28250,2021-09-17
3174071010,JAKARTA SELATAN,KEBAYORAN BARU,CIPETE UTARA,34102,12447,21655,13798,35453,2021-09-17
3175021003,JAKARTA TIMUR,PULO GADUNG,CIPINANG,39306,13312,25994,19238,45232,2021-09-17
3175031007,JAKARTA TIMUR,JATINEGARA,CIPINANG BESAR SELATAN,35212,13106,22106,15344,37450,2021-09-17
3175031008,JAKARTA TIMUR,JATINEGARA,CIPINANG BESAR UTARA,45319,16870,28449,20088,48537,2021-09-17
3175031005,JAKARTA TIMUR,JATINEGARA,CIPINANG CEMPEDAK,32824,12511,20313,15563,35876,2021-09-17
3175081005,JAKARTA TIMUR,MAKASAR,CIPINANG MELAYU,42308,15080,27228,21170,48398,2021-09-17
3175031006,JAKARTA TIMUR,JATINEGARA,CIPINANG MUARA,55243,20485,34758,25434,60192,2021-09-17
3174051003,JAKARTA SELATAN,KEBAYORAN LAMA,CIPULIR,39937,15891,24046,13813,37859,2021-09-17
3175091001,JAKARTA TIMUR,CIRACAS,CIRACAS,64594,19798,44796,33447,78243,2021-09-17
3175041003,JAKARTA TIMUR,KRAMAT JATI,DUKUH,24609,8047,16562,12379,28941,2021-09-17
3175071001,JAKARTA TIMUR,DUREN SAWIT,DUREN SAWIT,61160,22394,38766,29044,67810,2021-09-17
3174081004,JAKARTA SELATAN,PANCORAN,DUREN TIGA,28319,10408,17911,10118,28029,2021-09-17
3173051005,JAKARTA BARAT,KEBON JERUK,DURI KEPA,60138,19497,40641,31632,72273,2021-09-17
3173011002,JAKARTA BARAT,CENGKARENG,DURI KOSAMBI,77923,28473,49450,35318,84768,2021-09-17
3171011006,JAKARTA PUSAT,GAMBIR,DURI PULO,19610,6605,13005,9542,22547,2021-09-17
3173041011,JAKARTA BARAT,TAMBORA,DURI SELATAN,14259,4352,9907,7588,17495,2021-09-17
3173041003,JAKARTA BARAT,TAMBORA,DURI UTARA,19844,6344,13500,9949,23449,2021-09-17
3171081003,JAKARTA PUSAT,JOHAR BARU,GALUR,18243,5419,12824,9546,22370,2021-09-17
3171011001,JAKARTA PUSAT,GAMBIR,GAMBIR,2191,711,1480,1168,2648,2021-09-17
3174061004,JAKARTA SELATAN,CILANDAK,GANDARIA SELATAN,22119,8209,13910,8597,22507,2021-09-17
3174071009,JAKARTA SELATAN,KEBAYORAN BARU,GANDARIA UTARA,39922,14911,25011,16078,41089,2021-09-17
3175051001,JAKARTA TIMUR,PASAR REBO,GEDONG,35755,11879,23876,18183,42059,2021-09-17
3171071001,JAKARTA PUSAT,TANAH ABANG,GELORA,3127,1136,1991,1410,3401,2021-09-17
3173031007,JAKARTA BARAT,TAMAN SARI,GLODOK,7837,2243,5594,4663,10257,2021-09-17
3171061004,JAKARTA PUSAT,MENTENG,GONDANGDIA,4100,1435,2665,2214,4879,2021-09-17
3173021001,JAKARTA BARAT,GROGOL PETAMBURAN,GROGOL,16876,5800,11076,8463,19539,2021-09-17
3174051005,JAKARTA SELATAN,KEBAYORAN LAMA,GROGOL SELATAN,44251,16837,27414,16495,43909,2021-09-17
3174051004,JAKARTA SELATAN,KEBAYORAN LAMA,GROGOL UTARA,42494,15853,26641,16530,43171,2021-09-17
3174021007,JAKARTA SELATAN,SETIA BUDI,GUNTUR,3985,1357,2628,1974,4602,2021-09-17
3174071002,JAKARTA SELATAN,KEBAYORAN BARU,GUNUNG,9436,3311,6125,4376,10501,2021-09-17
3171031005,JAKARTA PUSAT,KEMAYORAN,GUNUNG SAHARI SELATAN,19199,6487,12712,9916,22628,2021-09-17
3171021004,JAKARTA PUSAT,SAWAH BESAR,GUNUNG SAHARI UTARA,16650,4911,11739,9646,21385,2021-09-17
3175081004,JAKARTA TIMUR,MAKASAR,HALIM PERDANA KUSUMAH,28363,7511,20852,17928,38780,2021-09-17
3171031003,JAKARTA PUSAT,KEMAYORAN,HARAPAN MULIA,22557,7569,14988,11320,26308,2021-09-17
3174091001,JAKARTA SELATAN,JAGAKARSA,JAGAKARSA,62389,21669,40720,26599,67319,2021-09-17
3175021007,JAKARTA TIMUR,PULO GADUNG,JATI,32757,11001,21756,16824,38580,2021-09-17
3174041002,JAKARTA SELATAN,PASAR MINGGU,JATI PADANG,37502,13738,23764,15511,39275,2021-09-17
3173071004,JAKARTA BARAT,PALMERAH,JATI PULO,28738,9179,19559,14145,33704,2021-09-17
3175061001,JAKARTA TIMUR,CAKUNG,JATINEGARA,84160,28836,55324,41994,97318,2021-09-17
3175021004,JAKARTA TIMUR,PULO GADUNG,JATINEGARA KAUM,24632,7747,16885,11713,28598,2021-09-17
3173021004,JAKARTA BARAT,GROGOL PETAMBURAN,JELAMBAR,30266,10194,20072,15947,36019,2021-09-17
3173021006,JAKARTA BARAT,GROGOL PETAMBURAN,JELAMBAR BARU,38246,12706,25540,20254,45794,2021-09-17
3173041006,JAKARTA BARAT,TAMBORA,JEMBATAN BESI,29314,10988,18326,12466,30792,2021-09-17
3173041008,JAKARTA BARAT,TAMBORA,JEMBATAN LIMA,21021,7635,13386,9379,22765,2021-09-17
3173081005,JAKARTA BARAT,KEMBANGAN,JOGLO,40839,13915,26924,20106,47030,2021-09-17
3171081001,JAKARTA PUSAT,JOHAR BARU,JOHAR BARU,37488,11333,26155,20262,46417,2021-09-17
3173041002,JAKARTA BARAT,TAMBORA,KALI ANYAR,23856,7719,16137,11533,27670,2021-09-17
3172041004,JAKARTA UTARA,CILINCING,KALIBARU,67684,26060,41624,26889,68513,2021-09-17
3174081002,JAKARTA SELATAN,PANCORAN,KALIBATA,41994,17230,24764,13875,38639,2021-09-17
3173061001,JAKARTA BARAT,KALI DERES,KALIDERES,72447,25082,47365,37331,84696,2021-09-17
3175051004,JAKARTA TIMUR,PASAR REBO,KALISARI,43212,13833,29379,22786,52165,2021-09-17
3173061004,JAKARTA BARAT,KALI DERES,KAMAL,53783,19340,34443,24908,59351,2021-09-17
3172011002,JAKARTA UTARA,PENJARINGAN,KAMAL MUARA,12930,3344,9586,7724,17310,2021-09-17
3171071007,JAKARTA PUSAT,TANAH ABANG,KAMPUNG BALI,11358,4137,7221,5005,12226,2021-09-17
3175031001,JAKARTA TIMUR,JATINEGARA,KAMPUNG MELAYU,25717,9827,15890,11312,27202,2021-09-17
3171081002,JAKARTA PUSAT,JOHAR BARU,KAMPUNG RAWA,21237,5507,15730,11495,27225,2021-09-17
3175041002,JAKARTA TIMUR,KRAMAT JATI,KAMPUNG TENGAH,43993,16765,27228,19004,46232,2021-09-17
3173011005,JAKARTA BARAT,CENGKARENG,KAPUK,134466,48927,85539,60650,146189,2021-09-17
3172011003,JAKARTA UTARA,PENJARINGAN,KAPUK MUARA,35781,10567,25214,20901,46115,2021-09-17
3171021002,JAKARTA PUSAT,SAWAH BESAR,KARANG ANYAR,25761,8142,17619,13451,31070,2021-09-17
3174021004,JAKARTA SELATAN,SETIA BUDI,KARET,9623,3564,6059,4093,10152,2021-09-17
3174021003,JAKARTA SELATAN,SETIA BUDI,KARET KUNINGAN,16055,5296,10759,7303,18062,2021-09-17
3174021002,JAKARTA SELATAN,SETIA BUDI,KARET SEMANGGI,2770,934,1836,1422,3258,2021-09-17
3171071003,JAKARTA PUSAT,TANAH ABANG,KARET TENGSIN,19271,6313,12958,9131,22089,2021-09-17
3171021003,JAKARTA PUSAT,SAWAH BESAR,KARTINI,22292,7329,14963,11938,26901,2021-09-17
3175011003,JAKARTA TIMUR,MATRAMAN,KAYU MANIS,25284,9333,15951,11168,27119,2021-09-17
3175021006,JAKARTA TIMUR,PULO GADUNG,KAYU PUTIH,40696,13168,27528,21890,49418,2021-09-17
3173031006,JAKARTA BARAT,TAMAN SARI,KEAGUNGAN,17387,5630,11757,8943,20700,2021-09-17
3174041007,JAKARTA SELATAN,PASAR MINGGU,KEBAGUSAN,44552,16963,27589,16790,44379,2021-09-17
3174051006,JAKARTA SELATAN,KEBAYORAN LAMA,KEBAYORAN LAMA SELATAN,41212,14670,26542,16248,42790,2021-09-17
3174051001,JAKARTA SELATAN,KEBAYORAN LAMA,KEBAYORAN LAMA UTARA,42422,16465,25957,14781,40738,2021-09-17
3174011004,JAKARTA SELATAN,TEBET,KEBON BARU,35165,12733,22432,14045,36477,2021-09-17
3172021005,JAKARTA UTARA,TANJUNG PRIOK,KEBON BAWANG,50952,17264,33688,25582,59270,2021-09-17
3173051001,JAKARTA BARAT,KEBON JERUK,KEBON JERUK,53887,19343,34544,25215,59759,2021-09-17
3171071006,JAKARTA PUSAT,TANAH ABANG,KEBON KACANG,21531,8330,13201,9281,22482,2021-09-17
3171011005,JAKARTA PUSAT,GAMBIR,KEBON KELAPA,10163,3445,6718,5149,11867,2021-09-17
3171031002,JAKARTA PUSAT,KEMAYORAN,KEBON KOSONG,30019,10223,19796,14966,34762,2021-09-17
3175011005,JAKARTA TIMUR,MATRAMAN,KEBON MANGGIS,16490,5551,10939,8113,19052,2021-09-17
3171071005,JAKARTA PUSAT,TANAH ABANG,KEBON MELATI,32206,12940,19266,12735,32001,2021-09-17
3175081003,JAKARTA TIMUR,MAKASAR,KEBON PALA,46614,15929,30685,22294,52979,2021-09-17
3171061005,JAKARTA PUSAT,MENTENG,KEBON SIRIH,12299,4298,8001,5793,13794,2021-09-17
3173011004,JAKARTA BARAT,CENGKARENG,KEDAUNG KALI ANGKE,32612,10024,22588,17424,40012,2021-09-17
3173051007,JAKARTA BARAT,KEBON JERUK,KEDOYA SELATAN,32165,10494,21671,16199,37870,2021-09-17
3173051006,JAKARTA BARAT,KEBON JERUK,KEDOYA UTARA,45740,14220,31520,24956,56476,2021-09-17
3173051004,JAKARTA BARAT,KEBON JERUK,KELAPA DUA,23565,8431,15134,11473,26607,2021-09-17
3175091003,JAKARTA TIMUR,CIRACAS,KELAPA DUA WETAN,46875,14167,32708,24750,57458,2021-09-17
3172061003,JAKARTA UTARA,KELAPA GADING,KELAPA GADING BARAT,35717,10642,25075,21142,46217,2021-09-17
3172061001,JAKARTA UTARA,KELAPA GADING,KELAPA GADING TIMUR,33592,9163,24429,20684,45113,2021-09-17
3173071005,JAKARTA BARAT,PALMERAH,KEMANGGISAN,32139,10712,21427,15720,37147,2021-09-17
3171031001,JAKARTA PUSAT,KEMAYORAN,KEMAYORAN,20708,6729,13979,10774,24753,2021-09-17
3173081006,JAKARTA BARAT,KEMBANGAN,KEMBANGAN SELATAN,27130,9186,17944,14313,32257,2021-09-17
3173081001,JAKARTA BARAT,KEMBANGAN,KEMBANGAN UTARA,54451,18264,36187,27729,63916,2021-09-17
3171041002,JAKARTA PUSAT,SENEN,KENARI,9579,3105,6474,5126,11600,2021-09-17
3173041005,JAKARTA BARAT,TAMBORA,KERENDANG,19973,6587,13386,9712,23098,2021-09-17
3175071003,JAKARTA TIMUR,DUREN SAWIT,KLENDER,69978,26020,43958,31484,75442,2021-09-17
3172031001,JAKARTA UTARA,KOJA,KOJA,28175,10088,18087,13827,31914,2021-09-17
3173071006,JAKARTA BARAT,PALMERAH,KOTA BAMBU SELATAN,21158,7167,13991,9819,23810,2021-09-17
3173071003,JAKARTA BARAT,PALMERAH,KOTA BAMBU UTARA,24995,8756,16239,11419,27658,2021-09-17
3171041004,JAKARTA PUSAT,SENEN,KRAMAT,28835,10255,18580,12454,31034,2021-09-17
3175041001,JAKARTA TIMUR,KRAMAT JATI,KRAMAT JATI,34144,11900,22244,16044,38288,2021-09-17
3174071003,JAKARTA SELATAN,KEBAYORAN BARU,KRAMAT PELA,14413,4982,9431,6138,15569,2021-09-17
3173031002,JAKARTA BARAT,TAMAN SARI,KRUKUT,19244,6314,12930,9621,22551,2021-09-17
3174031005,JAKARTA SELATAN,MAMPANG PRAPATAN,KUNINGAN BARAT,12785,4444,8341,5304,13645,2021-09-17
3174021008,JAKARTA SELATAN,SETIA BUDI,KUNINGAN TIMUR,6008,2113,3895,2670,6565,2021-09-17
3171041005,JAKARTA PUSAT,SENEN,KWITANG,15486,5358,10128,7615,17743,2021-09-17
3172031003,JAKARTA UTARA,KOJA,LAGOA,59065,21419,37646,26667,64313,2021-09-17
3174061002,JAKARTA SELATAN,CILANDAK,LEBAK BULUS,37626,14227,23399,15281,38680,2021-09-17
3174091004,JAKARTA SELATAN,JAGAKARSA,LENTENG AGUNG,53946,20336,33610,19753,53363,2021-09-17
3175101007,JAKARTA TIMUR,CIPAYUNG,LUBANG BUAYA,63547,20106,43441,33095,76536,2021-09-17
3175081001,JAKARTA TIMUR,MAKASAR,MAKASAR,34390,11243,23147,17740,40887,2021-09-17
3175071006,JAKARTA TIMUR,DUREN SAWIT,MALAKA JAYA,30927,10500,20427,15931,36358,2021-09-17
3175071005,JAKARTA TIMUR,DUREN SAWIT,MALAKA SARI,27530,8984,18546,14736,33282,2021-09-17
3174031001,JAKARTA SELATAN,MAMPANG PRAPATAN,MAMPANG PRAPATAN,18159,6634,11525,7533,19058,2021-09-17
3173031005,JAKARTA BARAT,TAMAN SARI,MANGGA BESAR,7707,2237,5470,4398,9868,2021-09-17
3171021005,JAKARTA PUSAT,SAWAH BESAR,MANGGA DUA SELATAN,27442,8939,18503,14271,32774,2021-09-17
3174011007,JAKARTA SELATAN,TEBET,MANGGARAI,28373,9380,18993,11521,30514,2021-09-17
3174011006,JAKARTA SELATAN,TEBET,MANGGARAI SELATAN,23075,7899,15176,9772,24948,2021-09-17
3173031003,JAKARTA BARAT,TAMAN SARI,MAPHAR,16461,5534,10927,8479,19406,2021-09-17
3172041003,JAKARTA UTARA,CILINCING,MARUNDA,28943,9315,19628,13187,32815,2021-09-17
3174071001,JAKARTA SELATAN,KEBAYORAN BARU,MELAWAI,2627,885,1742,1393,3135,2021-09-17
3171061001,JAKARTA PUSAT,MENTENG,MENTENG,25624,9166,16458,11864,28322,2021-09-17
3174021005,JAKARTA SELATAN,SETIA BUDI,MENTENG ATAS,27816,9394,18422,11639,30061,2021-09-17
3174011003,JAKARTA SELATAN,TEBET,MENTENG DALAM,36028,13007,23021,14883,37904,2021-09-17
3173081003,JAKARTA BARAT,KEMBANGAN,MERUYA SELATAN,32130,11005,21125,16163,37288,2021-09-17
3173081002,JAKARTA BARAT,KEMBANGAN,MERUYA UTARA,43752,15095,28657,22749,51406,2021-09-17
3175101004,JAKARTA TIMUR,CIPAYUNG,MUNJUL,23871,7658,16213,12560,28773,2021-09-17
3172051002,JAKARTA UTARA,PADEMANGAN,PADEMANGAN BARAT,74240,26363,47877,35512,83389,2021-09-17
3172051001,JAKARTA UTARA,PADEMANGAN,PADEMANGAN TIMUR,37736,11159,26577,21299,47876,2021-09-17
3175011004,JAKARTA TIMUR,MATRAMAN,PAL MERIAM,19769,7249,12520,9216,21736,2021-09-17
3173071001,JAKARTA BARAT,PALMERAH,PALMERAH,63011,22002,41009,29203,70212,2021-09-17
3174081001,JAKARTA SELATAN,PANCORAN,PANCORAN,19421,7155,12266,7626,19892,2021-09-17
3172021003,JAKARTA UTARA,TANJUNG PRIOK,PAPANGGO,39097,12393,26704,20181,46885,2021-09-17
3171021001,JAKARTA PUSAT,SAWAH BESAR,PASAR BARU,12035,3595,8440,7015,15455,2021-09-17
3174021006,JAKARTA SELATAN,SETIA BUDI,PASAR MANGGIS,26752,9649,17103,10867,27970,2021-09-17
3174041001,JAKARTA SELATAN,PASAR MINGGU,PASAR MINGGU,24821,8972,15849,10504,26353,2021-09-17
3171041003,JAKARTA PUSAT,SENEN,PASEBAN,23533,8293,15240,11074,26314,2021-09-17
3173061005,JAKARTA BARAT,KALI DERES,PEGADUNGAN,75587,24297,51290,41188,92478,2021-09-17
3171061002,JAKARTA PUSAT,MENTENG,PEGANGSAAN,23455,8202,15253,10556,25809,2021-09-17
3172061002,JAKARTA UTARA,KELAPA GADING,PEGANGSAAN DUA,49976,13601,36375,30472,66847,2021-09-17
3172011004,JAKARTA UTARA,PENJARINGAN,PEJAGALAN,74578,24849,49729,39500,89229,2021-09-17
3174041006,JAKARTA SELATAN,PASAR MINGGU,PEJATEN BARAT,37346,13953,23393,15080,38473,2021-09-17
3174041005,JAKARTA SELATAN,PASAR MINGGU,PEJATEN TIMUR,57656,22369,35287,20608,55895,2021-09-17
3175051005,JAKARTA TIMUR,PASAR REBO,PEKAYON,43250,13752,29498,22259,51757,2021-09-17
3173041009,JAKARTA BARAT,TAMBORA,PEKOJAN,23587,7429,16158,12409,28567,2021-09-17
3174031003,JAKARTA SELATAN,MAMPANG PRAPATAN,PELA MAMPANG,43522,15662,27860,18620,46480,2021-09-17
3174081005,JAKARTA SELATAN,PANCORAN,PENGADEGAN,21478,7113,14365,8173,22538,2021-09-17
3175061003,JAKARTA TIMUR,CAKUNG,PENGGILINGAN,99255,36413,62842,44787,107629,2021-09-17
3172011001,JAKARTA UTARA,PENJARINGAN,PENJARINGAN,88308,32732,55576,40077,95653,2021-09-17
3174101001,JAKARTA SELATAN,PESANGGRAHAN,PESANGGRAHAN,27545,9398,18147,11607,29754,2021-09-17
3171071004,JAKARTA PUSAT,TANAH ABANG,PETAMBURAN,33271,13353,19918,13346,33264,2021-09-17
3174071008,JAKARTA SELATAN,KEBAYORAN BARU,PETOGOGAN,11499,4258,7241,4851,12092,2021-09-17
3171011004,JAKARTA PUSAT,GAMBIR,PETOJO SELATAN,14692,5237,9455,7276,16731,2021-09-17
3171011003,JAKARTA PUSAT,GAMBIR,PETOJO UTARA,17458,6096,11362,8400,19762,2021-09-17
3174101004,JAKARTA SELATAN,PESANGGRAHAN,PETUKANGAN SELATAN,37187,13618,23569,14573,38142,2021-09-17
3174101003,JAKARTA SELATAN,PESANGGRAHAN,PETUKANGAN UTARA,53716,20813,32903,20785,53688,2021-09-17
3175081002,JAKARTA TIMUR,MAKASAR,PINANG RANTI,27198,9423,17775,13413,31188,2021-09-17
3173031008,JAKARTA BARAT,TAMAN SARI,PINANGSIA,10729,3206,7523,5803,13326,2021-09-17
3175011001,JAKARTA TIMUR,MATRAMAN,PISANGAN BARU,31776,11499,20277,13956,34233,2021-09-17
3175021002,JAKARTA TIMUR,PULO GADUNG,PISANGAN TIMUR,41011,13399,27612,21143,48755,2021-09-17
3172011005,JAKARTA UTARA,PENJARINGAN,PLUIT,47783,15027,32756,26748,59504,2021-09-17
3175071002,JAKARTA TIMUR,DUREN SAWIT,PONDOK BAMBU,61550,22330,39220,29551,68771,2021-09-17
3175071004,JAKARTA TIMUR,DUREN SAWIT,PONDOK KELAPA,72015,25018,46997,35194,82191,2021-09-17
3175071007,JAKARTA TIMUR,DUREN SAWIT,PONDOK KOPI,35367,12969,22398,15702,38100,2021-09-17
3174061003,JAKARTA SELATAN,CILANDAK,PONDOK LABU,46464,16030,30434,20878,51312,2021-09-17
3174051002,JAKARTA SELATAN,KEBAYORAN LAMA,PONDOK PINANG,56169,20799,35370,22877,58247,2021-09-17
3175101003,JAKARTA TIMUR,CIPAYUNG,PONDOK RANGGON,25574,8408,17166,13313,30479,2021-09-17
3101011003,KAB.ADM.KEP.SERIBU,KEP. SERIBU UTARA,PULAU HARAPAN,2060,328,1732,1085,2817,2021-09-17
3101011002,KAB.ADM.KEP.SERIBU,KEP. SERIBU UTARA,PULAU KELAPA,5528,873,4655,2889,7544,2021-09-17
3101011001,KAB.ADM.KEP.SERIBU,KEP. SERIBU UTARA,PULAU PANGGANG,5450,816,4634,2391,7025,2021-09-17
3101021003,KAB.ADM.KEP.SERIBU,KEP. SERIBU SELATAN,PULAU PARI,2765,303,2462,1961,4423,2021-09-17
3101021002,KAB.ADM.KEP.SERIBU,KEP. SERIBU SELATAN,PULAU TIDUNG,4553,594,3959,2869,6828,2021-09-17
3101021001,KAB.ADM.KEP.SERIBU,KEP. SERIBU SELATAN,PULAU UNTUNG JAWA,1941,285,1656,1370,3026,2021-09-17
3174071007,JAKARTA SELATAN,KEBAYORAN BARU,PULO,5835,1954,3881,2919,6800,2021-09-17
3175021001,JAKARTA TIMUR,PULO GADUNG,PULO GADUNG,34422,11801,22621,16687,39308,2021-09-17
3175061005,JAKARTA TIMUR,CAKUNG,PULO GEBANG,97301,32867,64434,46363,110797,2021-09-17
3174041004,JAKARTA SELATAN,PASAR MINGGU,RAGUNAN,39616,13859,25757,16798,42555,2021-09-17
3175091005,JAKARTA TIMUR,CIRACAS,RAMBUTAN,36771,13619,23152,16803,39955,2021-09-17
3172031006,JAKARTA UTARA,KOJA,RAWA BADAK SELATAN,42179,15155,27024,19353,46377,2021-09-17
3172031004,JAKARTA UTARA,KOJA,RAWA BADAK UTARA,34408,12276,22132,16554,38686,2021-09-17
3174071005,JAKARTA SELATAN,KEBAYORAN BARU,RAWA BARAT,5625,1857,3768,2651,6419,2021-09-17
3173011003,JAKARTA BARAT,CENGKARENG,RAWA BUAYA,63799,21511,42288,29766,72054,2021-09-17
3175031004,JAKARTA TIMUR,JATINEGARA,RAWA BUNGA,21434,8082,13352,9922,23274,2021-09-17
3174081003,JAKARTA SELATAN,PANCORAN,RAWA JATI,20509,7304,13205,8152,21357,2021-09-17
3175061002,JAKARTA TIMUR,CAKUNG,RAWA TERATE,24637,7399,17238,13061,30299,2021-09-17
3175021005,JAKARTA TIMUR,PULO GADUNG,RAWAMANGUN,37612,12905,24707,18789,43496,2021-09-17
3171051003,JAKARTA PUSAT,CEMPAKA PUTIH,RAWASARI,21967,7673,14294,11034,25328,2021-09-17
3173041010,JAKARTA BARAT,TAMBORA,ROA MALAKA,3484,1013,2471,1982,4453,2021-09-17
3172041006,JAKARTA UTARA,CILINCING,ROROTAN,41668,13081,28587,20989,49576,2021-09-17
3174071004,JAKARTA SELATAN,KEBAYORAN BARU,SELONG,2842,966,1876,1439,3315,2021-09-17
3173061002,JAKARTA BARAT,KALI DERES,SEMANAN,71354,25267,46087,34082,80169,2021-09-17
3172041007,JAKARTA UTARA,CILINCING,SEMPER BARAT,68587,21503,47084,36724,83808,2021-09-17
3172041005,JAKARTA UTARA,CILINCING,SEMPER TIMUR,36267,11890,24377,18266,42643,2021-09-17
3174071006,JAKARTA SELATAN,KEBAYORAN BARU,SENAYAN,2771,1109,1662,1144,2806,2021-09-17
3171041001,JAKARTA PUSAT,SENEN,SENEN,6804,2191,4613,3605,8218,2021-09-17
3171031004,JAKARTA PUSAT,KEMAYORAN,SERDANG,29668,9892,19776,14927,34703,2021-09-17
3174021001,JAKARTA SELATAN,SETIA BUDI,SETIA BUDI,3023,1099,1924,1345,3269,2021-09-17
3175101005,JAKARTA TIMUR,CIPAYUNG,SETU,20572,7273,13299,9879,23178,2021-09-17
3173071002,JAKARTA BARAT,PALMERAH,SLIPI,16591,5394,11197,8531,19728,2021-09-17
3173081004,JAKARTA BARAT,KEMBANGAN,SRENGSENG,45523,16462,29061,21965,51026,2021-09-17
3174091002,JAKARTA SELATAN,JAGAKARSA,SRENGSENG SAWAH,58196,18731,39465,25111,64576,2021-09-17
3173051003,JAKARTA BARAT,KEBON JERUK,SUKABUMI SELATAN,37033,13460,23573,15808,39381,2021-09-17
3173051002,JAKARTA BARAT,KEBON JERUK,SUKABUMI UTARA,38290,14294,23996,15523,39519,2021-09-17
3172041002,JAKARTA UTARA,CILINCING,SUKAPURA,53949,18782,35167,27049,62216,2021-09-17
3171031007,JAKARTA PUSAT,KEMAYORAN,SUMUR BATU,22717,7806,14911,11566,26477,2021-09-17
3172021004,JAKARTA UTARA,TANJUNG PRIOK,SUNGAI BAMBU,29876,9923,19953,15293,35246,2021-09-17
3172021006,JAKARTA UTARA,TANJUNG PRIOK,SUNTER AGUNG,71805,20834,50971,41365,92336,2021-09-17
3172021002,JAKARTA UTARA,TANJUNG PRIOK,SUNTER JAYA,63031,18886,44145,35709,79854,2021-09-17
3175091004,JAKARTA TIMUR,CIRACAS,SUSUKAN,38257,11907,26350,19839,46189,2021-09-17
3173031001,JAKARTA BARAT,TAMAN SARI,TAMAN SARI,14348,4733,9615,7747,17362,2021-09-17
3173041001,JAKARTA BARAT,TAMBORA,TAMBORA,10204,3503,6701,4791,11492,2021-09-17
3173041004,JAKARTA BARAT,TAMBORA,TANAH SEREAL,26387,7602,18785,13873,32658,2021-09-17
3171081004,JAKARTA PUSAT,JOHAR BARU,TANAH TINGGI,37693,10981,26712,19721,46433,2021-09-17
3173031004,JAKARTA BARAT,TAMAN SARI,TANGKI,13324,4239,9085,7133,16218,2021-09-17
3174091005,JAKARTA SELATAN,JAGAKARSA,TANJUNG BARAT,39770,13898,25872,15489,41361,2021-09-17
3173021005,JAKARTA BARAT,GROGOL PETAMBURAN,TANJUNG DUREN SELATAN,25337,8554,16783,13238,30021,2021-09-17
3173021002,JAKARTA BARAT,GROGOL PETAMBURAN,TANJUNG DUREN UTARA,17010,5420,11590,9182,20772,2021-09-17
3172021001,JAKARTA UTARA,TANJUNG PRIOK,TANJUNG PRIOK,34588,11073,23515,17626,41141,2021-09-17
3174011002,JAKARTA SELATAN,TEBET,TEBET BARAT,21194,6956,14238,9730,23968,2021-09-17
3174011001,JAKARTA SELATAN,TEBET,TEBET TIMUR,18199,5968,12231,8378,20609,2021-09-17
3173061003,JAKARTA BARAT,KALI DERES,TEGAL ALUR,83647,28376,55271,40671,95942,2021-09-17
3174031004,JAKARTA SELATAN,MAMPANG PRAPATAN,TEGAL PARANG,32401,12600,19801,11818,31619,2021-09-17
3173021003,JAKARTA BARAT,GROGOL PETAMBURAN,TOMANG,29605,9839,19766,15761,35527,2021-09-17
3172031005,JAKARTA UTARA,KOJA,TUGU SELATAN,39122,13328,25794,18665,44459,2021-09-17
3172031002,JAKARTA UTARA,KOJA,TUGU UTARA,67670,24579,43091,31195,74286,2021-09-17
3175061006,JAKARTA TIMUR,CAKUNG,UJUNG MENTENG,29934,9245,20689,16163,36852,2021-09-17
3174101005,JAKARTA SELATAN,PESANGGRAHAN,ULUJAMI,40544,16099,24445,14465,38910,2021-09-17
3175011006,JAKARTA TIMUR,MATRAMAN,UTAN KAYU SELATAN,33511,10956,22555,16811,39366,2021-09-17
3175011002,JAKARTA TIMUR,MATRAMAN,UTAN KAYU UTARA,28169,10169,18000,13169,31169,2021-09-17
3171031008,JAKARTA PUSAT,KEMAYORAN,UTAN PANJANG,29208,10143,19065,14043,33108,2021-09-17
3172021007,JAKARTA UTARA,TANJUNG PRIOK,WARAKAS,44401,14016,30385,22637,53022,2021-09-17
3173021007,JAKARTA BARAT,GROGOL PETAMBURAN,WIJAYA KUSUMA,38934,13724,25210,19504,44714,2021-09-17
3172051003,JAKARTA UTARA,PADEMANGAN,ANCOL,23947,8664,15283,11751,27034,2021-09-18
3173041007,JAKARTA BARAT,TAMBORA,ANGKE,29381,9761,19620,14383,34003,2021-09-18
3175041005,JAKARTA TIMUR,KRAMAT JATI,BALE KAMBANG,29074,11448,17626,11401,29027,2021-09-18
3175031003,JAKARTA TIMUR,JATINEGARA,BALI MESTER,9752,3477,6275,4757,11032,2021-09-18
3175101006,JAKARTA TIMUR,CIPAYUNG,BAMBU APUS,26285,8650,17635,13406,31041,2021-09-18
3174031002,JAKARTA SELATAN,MAMPANG PRAPATAN,BANGKA,21566,8245,13321,8506,21827,2021-09-18
3175051002,JAKARTA TIMUR,PASAR REBO,BARU,23886,7177,16709,13393,30102,2021-09-18
3175041004,JAKARTA TIMUR,KRAMAT JATI,BATU AMPAR,47898,18489,29409,20658,50067,2021-09-18
3171071002,JAKARTA PUSAT,TANAH ABANG,BENDUNGAN HILIR,21494,7571,13923,10396,24319,2021-09-18
3175031002,JAKARTA TIMUR,JATINEGARA,BIDARA CINA,36689,14315,22374,16140,38514,2021-09-18
3174101002,JAKARTA SELATAN,PESANGGRAHAN,BINTARO,53098,19895,33203,21616,54819,2021-09-18
3174011005,JAKARTA SELATAN,TEBET,BUKIT DURI,34183,13072,21111,12831,33942,2021-09-18
3171041006,JAKARTA PUSAT,SENEN,BUNGUR,18144,6091,12053,9206,21259,2021-09-18
3175061007,JAKARTA TIMUR,CAKUNG,CAKUNG BARAT,57724,18224,39500,30122,69622,2021-09-18
3175061004,JAKARTA TIMUR,CAKUNG,CAKUNG TIMUR,58287,18354,39933,30713,70646,2021-09-18
3175041007,JAKARTA TIMUR,KRAMAT JATI,CAWANG,32762,11930,20832,14770,35602,2021-09-18
3175101008,JAKARTA TIMUR,CIPAYUNG,CEGER,18932,6167,12765,9735,22500,2021-09-18
3171031006,JAKARTA PUSAT,KEMAYORAN,CEMPAKA BARU,32581,11169,21412,15414,36826,2021-09-18
3171051002,JAKARTA PUSAT,CEMPAKA PUTIH,CEMPAKA PUTIH BARAT,35885,12390,23495,18355,41850,2021-09-18
3171051001,JAKARTA PUSAT,CEMPAKA PUTIH,CEMPAKA PUTIH TIMUR,24292,8076,16216,12690,28906,2021-09-18
3173011001,JAKARTA BARAT,CENGKARENG,CENGKARENG BARAT,66284,21902,44382,34355,78737,2021-09-18
3173011006,JAKARTA BARAT,CENGKARENG,CENGKARENG TIMUR,81027,26215,54812,40365,95177,2021-09-18
3175091002,JAKARTA TIMUR,CIRACAS,CIBUBUR,66364,20345,46019,35164,81183,2021-09-18
3171011002,JAKARTA PUSAT,GAMBIR,CIDENG,15390,4962,10428,8190,18618,2021-09-18
3174091003,JAKARTA SELATAN,JAGAKARSA,CIGANJUR,38497,13807,24690,15119,39809,2021-09-18
3175051003,JAKARTA TIMUR,PASAR REBO,CIJANTUNG,41419,12950,28469,21788,50257,2021-09-18
3171061003,JAKARTA PUSAT,MENTENG,CIKINI,8274,2519,5755,3870,9625,2021-09-18
3174081006,JAKARTA SELATAN,PANCORAN,CIKOKO,10547,3586,6961,4273,11234,2021-09-18
3174061001,JAKARTA SELATAN,CILANDAK,CILANDAK BARAT,51752,18517,33235,21596,54831,2021-09-18
3174041003,JAKARTA SELATAN,PASAR MINGGU,CILANDAK TIMUR,25145,8879,16266,11089,27355,2021-09-18
3175101002,JAKARTA TIMUR,CIPAYUNG,CILANGKAP,27635,9018,18617,14204,32821,2021-09-18
3175041006,JAKARTA TIMUR,KRAMAT JATI,CILILITAN,40181,14774,25407,18484,43891,2021-09-18
3172041001,JAKARTA UTARA,CILINCING,CILINCING,43609,15568,28041,19857,47898,2021-09-18
3175101001,JAKARTA TIMUR,CIPAYUNG,CIPAYUNG,26104,7819,18285,14500,32785,2021-09-18
3174091006,JAKARTA SELATAN,JAGAKARSA,CIPEDAK,38303,12777,25526,16266,41792,2021-09-18
3174061005,JAKARTA SELATAN,CILANDAK,CIPETE SELATAN,26704,9994,16710,11544,28254,2021-09-18
3174071010,JAKARTA SELATAN,KEBAYORAN BARU,CIPETE UTARA,34102,12444,21658,13805,35463,2021-09-18
3175021003,JAKARTA TIMUR,PULO GADUNG,CIPINANG,39306,13252,26054,19313,45367,2021-09-18
3175031007,JAKARTA TIMUR,JATINEGARA,CIPINANG BESAR SELATAN,35212,13039,22173,15456,37629,2021-09-18
3175031008,JAKARTA TIMUR,JATINEGARA,CIPINANG BESAR UTARA,45319,16829,28490,20196,48686,2021-09-18
3175031005,JAKARTA TIMUR,JATINEGARA,CIPINANG CEMPEDAK,32824,12483,20341,15617,35958,2021-09-18
3175081005,JAKARTA TIMUR,MAKASAR,CIPINANG MELAYU,42308,15014,27294,21251,48545,2021-09-18
3175031006,JAKARTA TIMUR,JATINEGARA,CIPINANG MUARA,55243,20404,34839,25569,60408,2021-09-18
3174051003,JAKARTA SELATAN,KEBAYORAN LAMA,CIPULIR,39937,15882,24055,13833,37888,2021-09-18
3175091001,JAKARTA TIMUR,CIRACAS,CIRACAS,64594,19647,44947,33582,78529,2021-09-18
3175041003,JAKARTA TIMUR,KRAMAT JATI,DUKUH,24609,7971,16638,12408,29046,2021-09-18
3175071001,JAKARTA TIMUR,DUREN SAWIT,DUREN SAWIT,61160,22282,38878,29138,68016,2021-09-18
3174081004,JAKARTA SELATAN,PANCORAN,DUREN TIGA,28319,10398,17921,10138,28059,2021-09-18
3173051005,JAKARTA BARAT,KEBON JERUK,DURI KEPA,60138,19461,40677,31752,72429,2021-09-18
3173011002,JAKARTA BARAT,CENGKARENG,DURI KOSAMBI,77923,28333,49590,35798,85388,2021-09-18
3171011006,JAKARTA PUSAT,GAMBIR,DURI PULO,19610,6586,13024,9585,22609,2021-09-18
3173041011,JAKARTA BARAT,TAMBORA,DURI SELATAN,14259,4343,9916,7632,17548,2021-09-18
3173041003,JAKARTA BARAT,TAMBORA,DURI UTARA,19844,6318,13526,9990,23516,2021-09-18
3171081003,JAKARTA PUSAT,JOHAR BARU,GALUR,18243,5406,12837,9629,22466,2021-09-18
3171011001,JAKARTA PUSAT,GAMBIR,GAMBIR,2191,711,1480,1176,2656,2021-09-18
3174061004,JAKARTA SELATAN,CILANDAK,GANDARIA SELATAN,22119,8205,13914,8607,22521,2021-09-18
3174071009,JAKARTA SELATAN,KEBAYORAN BARU,GANDARIA UTARA,39922,14907,25015,16096,41111,2021-09-18
3175051001,JAKARTA TIMUR,PASAR REBO,GEDONG,35755,11836,23919,18250,42169,2021-09-18
3171071001,JAKARTA PUSAT,TANAH ABANG,GELORA,3127,1132,1995,1414,3409,2021-09-18
3173031007,JAKARTA BARAT,TAMAN SARI,GLODOK,7837,2239,5598,4680,10278,2021-09-18
3171061004,JAKARTA PUSAT,MENTENG,GONDANGDIA,4100,1433,2667,2223,4890,2021-09-18
3173021001,JAKARTA BARAT,GROGOL PETAMBURAN,GROGOL,16876,5786,11090,8506,19596,2021-09-18
3174051005,JAKARTA SELATAN,KEBAYORAN LAMA,GROGOL SELATAN,44251,16830,27421,16524,43945,2021-09-18
3174051004,JAKARTA SELATAN,KEBAYORAN LAMA,GROGOL UTARA,42494,15849,26645,16565,43210,2021-09-18
3174021007,JAKARTA SELATAN,SETIA BUDI,GUNTUR,3985,1356,2629,1976,4605,2021-09-18
3174071002,JAKARTA SELATAN,KEBAYORAN BARU,GUNUNG,9436,3309,6127,4381,10508,2021-09-18
3171031005,JAKARTA PUSAT,KEMAYORAN,GUNUNG SAHARI SELATAN,19199,6470,12729,9954,22683,2021-09-18
3171021004,JAKARTA PUSAT,SAWAH BESAR,GUNUNG SAHARI UTARA,16650,4898,11752,9686,21438,2021-09-18
3175081004,JAKARTA TIMUR,MAKASAR,HALIM PERDANA KUSUMAH,28363,7473,20890,17996,38886,2021-09-18
3171031003,JAKARTA PUSAT,KEMAYORAN,HARAPAN MULIA,22557,7526,15031,11350,26381,2021-09-18
3174091001,JAKARTA SELATAN,JAGAKARSA,JAGAKARSA,62389,21661,40728,26621,67349,2021-09-18
3175021007,JAKARTA TIMUR,PULO GADUNG,JATI,32757,10966,21791,16917,38708,2021-09-18
3174041002,JAKARTA SELATAN,PASAR MINGGU,JATI PADANG,37502,13734,23768,15531,39299,2021-09-18
3173071004,JAKARTA BARAT,PALMERAH,JATI PULO,28738,9167,19571,14278,33849,2021-09-18
3175061001,JAKARTA TIMUR,CAKUNG,JATINEGARA,84160,28691,55469,42100,97569,2021-09-18
3175021004,JAKARTA TIMUR,PULO GADUNG,JATINEGARA KAUM,24632,7712,16920,11772,28692,2021-09-18
3173021004,JAKARTA BARAT,GROGOL PETAMBURAN,JELAMBAR,30266,10145,20121,16025,36146,2021-09-18
3173021006,JAKARTA BARAT,GROGOL PETAMBURAN,JELAMBAR BARU,38246,12654,25592,20342,45934,2021-09-18
3173041006,JAKARTA BARAT,TAMBORA,JEMBATAN BESI,29314,10966,18348,12523,30871,2021-09-18
3173041008,JAKARTA BARAT,TAMBORA,JEMBATAN LIMA,21021,7586,13435,9420,22855,2021-09-18
3173081005,JAKARTA BARAT,KEMBANGAN,JOGLO,40839,13870,26969,20178,47147,2021-09-18
3171081001,JAKARTA PUSAT,JOHAR BARU,JOHAR BARU,37488,11281,26207,20362,46569,2021-09-18
3173041002,JAKARTA BARAT,TAMBORA,KALI ANYAR,23856,7695,16161,11586,27747,2021-09-18
3172041004,JAKARTA UTARA,CILINCING,KALIBARU,67684,25950,41734,27038,68772,2021-09-18
3174081002,JAKARTA SELATAN,PANCORAN,KALIBATA,41994,17221,24773,13898,38671,2021-09-18
3173061001,JAKARTA BARAT,KALI DERES,KALIDERES,72447,25014,47433,37451,84884,2021-09-18
3175051004,JAKARTA TIMUR,PASAR REBO,KALISARI,43212,13775,29437,22840,52277,2021-09-18
3173061004,JAKARTA BARAT,KALI DERES,KAMAL,53783,19232,34551,25166,59717,2021-09-18
3172011002,JAKARTA UTARA,PENJARINGAN,KAMAL MUARA,12930,3320,9610,7744,17354,2021-09-18
3171071007,JAKARTA PUSAT,TANAH ABANG,KAMPUNG BALI,11358,4121,7237,5044,12281,2021-09-18
3175031001,JAKARTA TIMUR,JATINEGARA,KAMPUNG MELAYU,25717,9797,15920,11376,27296,2021-09-18
3171081002,JAKARTA PUSAT,JOHAR BARU,KAMPUNG RAWA,21237,5491,15746,11557,27303,2021-09-18
3175041002,JAKARTA TIMUR,KRAMAT JATI,KAMPUNG TENGAH,43993,16694,27299,19106,46405,2021-09-18
3173011005,JAKARTA BARAT,CENGKARENG,KAPUK,134466,48656,85810,60982,146792,2021-09-18
3172011003,JAKARTA UTARA,PENJARINGAN,KAPUK MUARA,35781,10537,25244,20976,46220,2021-09-18
3171021002,JAKARTA PUSAT,SAWAH BESAR,KARANG ANYAR,25761,8117,17644,13543,31187,2021-09-18
3174021004,JAKARTA SELATAN,SETIA BUDI,KARET,9623,3561,6062,4099,10161,2021-09-18
3174021003,JAKARTA SELATAN,SETIA BUDI,KARET KUNINGAN,16055,5295,10760,7311,18071,2021-09-18
3174021002,JAKARTA SELATAN,SETIA BUDI,KARET SEMANGGI,2770,934,1836,1423,3259,2021-09-18
3171071003,JAKARTA PUSAT,TANAH ABANG,KARET TENGSIN,19271,6292,12979,9184,22163,2021-09-18
3171021003,JAKARTA PUSAT,SAWAH BESAR,KARTINI,22292,7310,14982,11991,26973,2021-09-18
3175011003,JAKARTA TIMUR,MATRAMAN,KAYU MANIS,25284,9278,16006,11252,27258,2021-09-18
3175021006,JAKARTA TIMUR,PULO GADUNG,KAYU PUTIH,40696,13124,27572,22001,49573,2021-09-18
3173031006,JAKARTA BARAT,TAMAN SARI,KEAGUNGAN,17387,5619,11768,8958,20726,2021-09-18
3174041007,JAKARTA SELATAN,PASAR MINGGU,KEBAGUSAN,44552,16960,27592,16803,44395,2021-09-18
3174051006,JAKARTA SELATAN,KEBAYORAN LAMA,KEBAYORAN LAMA SELATAN,41212,14663,26549,16281,42830,2021-09-18
3174051001,JAKARTA SELATAN,KEBAYORAN LAMA,KEBAYORAN LAMA UTARA,42422,16461,25961,14800,40761,2021-09-18
3174011004,JAKARTA SELATAN,TEBET,KEBON BARU,35165,12720,22445,14062,36507,2021-09-18
3172021005,JAKARTA UTARA,TANJUNG PRIOK,KEBON BAWANG,50952,17192,33760,25692,59452,2021-09-18
3173051001,JAKARTA BARAT,KEBON JERUK,KEBON JERUK,53887,19309,34578,25413,59991,2021-09-18
3171071006,JAKARTA PUSAT,TANAH ABANG,KEBON KACANG,21531,8319,13212,9306,22518,2021-09-18
3171011005,JAKARTA PUSAT,GAMBIR,KEBON KELAPA,10163,3441,6722,5171,11893,2021-09-18
3171031002,JAKARTA PUSAT,KEMAYORAN,KEBON KOSONG,30019,10177,19842,15025,34867,2021-09-18
3175011005,JAKARTA TIMUR,MATRAMAN,KEBON MANGGIS,16490,5518,10972,8165,19137,2021-09-18
3171071005,JAKARTA PUSAT,TANAH ABANG,KEBON MELATI,32206,12925,19281,12775,32056,2021-09-18
3175081003,JAKARTA TIMUR,MAKASAR,KEBON PALA,46614,15873,30741,22409,53150,2021-09-18
3171061005,JAKARTA PUSAT,MENTENG,KEBON SIRIH,12299,4291,8008,5805,13813,2021-09-18
3173011004,JAKARTA BARAT,CENGKARENG,KEDAUNG KALI ANGKE,32612,9993,22619,17465,40084,2021-09-18
3173051007,JAKARTA BARAT,KEBON JERUK,KEDOYA SELATAN,32165,10468,21697,16273,37970,2021-09-18
3173051006,JAKARTA BARAT,KEBON JERUK,KEDOYA UTARA,45740,14188,31552,25113,56665,2021-09-18
3173051004,JAKARTA BARAT,KEBON JERUK,KELAPA DUA,23565,8413,15152,11515,26667,2021-09-18
3175091003,JAKARTA TIMUR,CIRACAS,KELAPA DUA WETAN,46875,14111,32764,24886,57650,2021-09-18
3172061003,JAKARTA UTARA,KELAPA GADING,KELAPA GADING BARAT,35717,10614,25103,21216,46319,2021-09-18
3172061001,JAKARTA UTARA,KELAPA GADING,KELAPA GADING TIMUR,33592,9124,24468,20804,45272,2021-09-18
3173071005,JAKARTA BARAT,PALMERAH,KEMANGGISAN,32139,10687,21452,15817,37269,2021-09-18
3171031001,JAKARTA PUSAT,KEMAYORAN,KEMAYORAN,20708,6698,14010,10802,24812,2021-09-18
3173081006,JAKARTA BARAT,KEMBANGAN,KEMBANGAN SELATAN,27130,9170,17960,14347,32307,2021-09-18
3173081001,JAKARTA BARAT,KEMBANGAN,KEMBANGAN UTARA,54451,18194,36257,27850,64107,2021-09-18
3171041002,JAKARTA PUSAT,SENEN,KENARI,9579,3101,6478,5134,11612,2021-09-18
3173041005,JAKARTA BARAT,TAMBORA,KERENDANG,19973,6562,13411,9743,23154,2021-09-18
3175071003,JAKARTA TIMUR,DUREN SAWIT,KLENDER,69978,25841,44137,31614,75751,2021-09-18
3172031001,JAKARTA UTARA,KOJA,KOJA,28175,10008,18167,13869,32036,2021-09-18
3173071006,JAKARTA BARAT,PALMERAH,KOTA BAMBU SELATAN,21158,7153,14005,9886,23891,2021-09-18
3173071003,JAKARTA BARAT,PALMERAH,KOTA BAMBU UTARA,24995,8709,16286,11543,27829,2021-09-18
3171041004,JAKARTA PUSAT,SENEN,KRAMAT,28835,10216,18619,12545,31164,2021-09-18
3175041001,JAKARTA TIMUR,KRAMAT JATI,KRAMAT JATI,34144,11860,22284,16109,38393,2021-09-18
3174071003,JAKARTA SELATAN,KEBAYORAN BARU,KRAMAT PELA,14413,4977,9436,6147,15583,2021-09-18
3173031002,JAKARTA BARAT,TAMAN SARI,KRUKUT,19244,6300,12944,9651,22595,2021-09-18
3174031005,JAKARTA SELATAN,MAMPANG PRAPATAN,KUNINGAN BARAT,12785,4442,8343,5309,13652,2021-09-18
3174021008,JAKARTA SELATAN,SETIA BUDI,KUNINGAN TIMUR,6008,2112,3896,2676,6572,2021-09-18
3171041005,JAKARTA PUSAT,SENEN,KWITANG,15486,5343,10143,7653,17796,2021-09-18
3172031003,JAKARTA UTARA,KOJA,LAGOA,59065,21327,37738,26979,64717,2021-09-18
3174061002,JAKARTA SELATAN,CILANDAK,LEBAK BULUS,37626,14226,23400,15292,38692,2021-09-18
3174091004,JAKARTA SELATAN,JAGAKARSA,LENTENG AGUNG,53946,20324,33622,19775,53397,2021-09-18
3175101007,JAKARTA TIMUR,CIPAYUNG,LUBANG BUAYA,63547,19934,43613,33265,76878,2021-09-18
3175081001,JAKARTA TIMUR,MAKASAR,MAKASAR,34390,11206,23184,17805,40989,2021-09-18
3175071006,JAKARTA TIMUR,DUREN SAWIT,MALAKA JAYA,30927,10466,20461,15990,36451,2021-09-18
3175071005,JAKARTA TIMUR,DUREN SAWIT,MALAKA SARI,27530,8940,18590,14780,33370,2021-09-18
3174031001,JAKARTA SELATAN,MAMPANG PRAPATAN,MAMPANG PRAPATAN,18159,6629,11530,7548,19078,2021-09-18
3173031005,JAKARTA BARAT,TAMAN SARI,MANGGA BESAR,7707,2217,5490,4411,9901,2021-09-18
3171021005,JAKARTA PUSAT,SAWAH BESAR,MANGGA DUA SELATAN,27442,8915,18527,14320,32847,2021-09-18
3174011007,JAKARTA SELATAN,TEBET,MANGGARAI,28373,9367,19006,11542,30548,2021-09-18
3174011006,JAKARTA SELATAN,TEBET,MANGGARAI SELATAN,23075,7897,15178,9784,24962,2021-09-18
3173031003,JAKARTA BARAT,TAMAN SARI,MAPHAR,16461,5526,10935,8501,19436,2021-09-18
3172041003,JAKARTA UTARA,CILINCING,MARUNDA,28943,9240,19703,13357,33060,2021-09-18
3174071001,JAKARTA SELATAN,KEBAYORAN BARU,MELAWAI,2627,885,1742,1396,3138,2021-09-18
3171061001,JAKARTA PUSAT,MENTENG,MENTENG,25624,9151,16473,11895,28368,2021-09-18
3174021005,JAKARTA SELATAN,SETIA BUDI,MENTENG ATAS,27816,9385,18431,11663,30094,2021-09-18
3174011003,JAKARTA SELATAN,TEBET,MENTENG DALAM,36028,12991,23037,14904,37941,2021-09-18
3173081003,JAKARTA BARAT,KEMBANGAN,MERUYA SELATAN,32130,10940,21190,16211,37401,2021-09-18
3173081002,JAKARTA BARAT,KEMBANGAN,MERUYA UTARA,43752,15056,28696,22829,51525,2021-09-18
3175101004,JAKARTA TIMUR,CIPAYUNG,MUNJUL,23871,7638,16233,12602,28835,2021-09-18
3172051002,JAKARTA UTARA,PADEMANGAN,PADEMANGAN BARAT,74240,26299,47941,35702,83643,2021-09-18
3172051001,JAKARTA UTARA,PADEMANGAN,PADEMANGAN TIMUR,37736,11121,26615,21439,48054,2021-09-18
3175011004,JAKARTA TIMUR,MATRAMAN,PAL MERIAM,19769,7203,12566,9274,21840,2021-09-18
3173071001,JAKARTA BARAT,PALMERAH,PALMERAH,63011,21953,41058,29346,70404,2021-09-18
3174081001,JAKARTA SELATAN,PANCORAN,PANCORAN,19421,7152,12269,7633,19902,2021-09-18
3172021003,JAKARTA UTARA,TANJUNG PRIOK,PAPANGGO,39097,12349,26748,20344,47092,2021-09-18
3171021001,JAKARTA PUSAT,SAWAH BESAR,PASAR BARU,12035,3590,8445,7046,15491,2021-09-18
3174021006,JAKARTA SELATAN,SETIA BUDI,PASAR MANGGIS,26752,9640,17112,10878,27990,2021-09-18
3174041001,JAKARTA SELATAN,PASAR MINGGU,PASAR MINGGU,24821,8965,15856,10516,26372,2021-09-18
3171041003,JAKARTA PUSAT,SENEN,PASEBAN,23533,8271,15262,11122,26384,2021-09-18
3173061005,JAKARTA BARAT,KALI DERES,PEGADUNGAN,75587,24195,51392,41316,92708,2021-09-18
3171061002,JAKARTA PUSAT,MENTENG,PEGANGSAAN,23455,8169,15286,10614,25900,2021-09-18
3172061002,JAKARTA UTARA,KELAPA GADING,PEGANGSAAN DUA,49976,13540,36436,30672,67108,2021-09-18
3172011004,JAKARTA UTARA,PENJARINGAN,PEJAGALAN,74578,24728,49850,39627,89477,2021-09-18
3174041006,JAKARTA SELATAN,PASAR MINGGU,PEJATEN BARAT,37346,13945,23401,15092,38493,2021-09-18
3174041005,JAKARTA SELATAN,PASAR MINGGU,PEJATEN TIMUR,57656,22350,35306,20636,55942,2021-09-18
3175051005,JAKARTA TIMUR,PASAR REBO,PEKAYON,43250,13701,29549,22386,51935,2021-09-18
3173041009,JAKARTA BARAT,TAMBORA,PEKOJAN,23587,7406,16181,12510,28691,2021-09-18
3174031003,JAKARTA SELATAN,MAMPANG PRAPATAN,PELA MAMPANG,43522,15660,27862,18652,46514,2021-09-18
3174081005,JAKARTA SELATAN,PANCORAN,PENGADEGAN,21478,7110,14368,8195,22563,2021-09-18
3175061003,JAKARTA TIMUR,CAKUNG,PENGGILINGAN,99255,36227,63028,45036,108064,2021-09-18
3172011001,JAKARTA UTARA,PENJARINGAN,PENJARINGAN,88308,32680,55628,40215,95843,2021-09-18
3174101001,JAKARTA SELATAN,PESANGGRAHAN,PESANGGRAHAN,27545,9397,18148,11619,29767,2021-09-18
3171071004,JAKARTA PUSAT,TANAH ABANG,PETAMBURAN,33271,13281,19990,13410,33400,2021-09-18
3174071008,JAKARTA SELATAN,KEBAYORAN BARU,PETOGOGAN,11499,4257,7242,4856,12098,2021-09-18
3171011004,JAKARTA PUSAT,GAMBIR,PETOJO SELATAN,14692,5230,9462,7343,16805,2021-09-18
3171011003,JAKARTA PUSAT,GAMBIR,PETOJO UTARA,17458,6090,11368,8424,19792,2021-09-18
3174101004,JAKARTA SELATAN,PESANGGRAHAN,PETUKANGAN SELATAN,37187,13610,23577,14588,38165,2021-09-18
3174101003,JAKARTA SELATAN,PESANGGRAHAN,PETUKANGAN UTARA,53716,20802,32914,20813,53727,2021-09-18
3175081002,JAKARTA TIMUR,MAKASAR,PINANG RANTI,27198,9399,17799,13447,31246,2021-09-18
3173031008,JAKARTA BARAT,TAMAN SARI,PINANGSIA,10729,3201,7528,5823,13351,2021-09-18
3175011001,JAKARTA TIMUR,MATRAMAN,PISANGAN BARU,31776,11417,20359,14047,34406,2021-09-18
3175021002,JAKARTA TIMUR,PULO GADUNG,PISANGAN TIMUR,41011,13357,27654,21313,48967,2021-09-18
3172011005,JAKARTA UTARA,PENJARINGAN,PLUIT,47783,14978,32805,26842,59647,2021-09-18
3175071002,JAKARTA TIMUR,DUREN SAWIT,PONDOK BAMBU,61550,22247,39303,29642,68945,2021-09-18
3175071004,JAKARTA TIMUR,DUREN SAWIT,PONDOK KELAPA,72015,24960,47055,35332,82387,2021-09-18
3175071007,JAKARTA TIMUR,DUREN SAWIT,PONDOK KOPI,35367,12874,22493,16166,38659,2021-09-18
3174061003,JAKARTA SELATAN,CILANDAK,PONDOK LABU,46464,16029,30435,20893,51328,2021-09-18
3174051002,JAKARTA SELATAN,KEBAYORAN LAMA,PONDOK PINANG,56169,20794,35375,22907,58282,2021-09-18
3175101003,JAKARTA TIMUR,CIPAYUNG,PONDOK RANGGON,25574,8390,17184,13348,30532,2021-09-18
3101011003,KAB.ADM.KEP.SERIBU,KEP. SERIBU UTARA,PULAU HARAPAN,2060,327,1733,1086,2819,2021-09-18
3101011002,KAB.ADM.KEP.SERIBU,KEP. SERIBU UTARA,PULAU KELAPA,5528,871,4657,2953,7610,2021-09-18
3101011001,KAB.ADM.KEP.SERIBU,KEP. SERIBU UTARA,PULAU PANGGANG,5450,808,4642,2473,7115,2021-09-18
3101021003,KAB.ADM.KEP.SERIBU,KEP. SERIBU SELATAN,PULAU PARI,2765,302,2463,1976,4439,2021-09-18
3101021002,KAB.ADM.KEP.SERIBU,KEP. SERIBU SELATAN,PULAU TIDUNG,4553,592,3961,2911,6872,2021-09-18
3101021001,KAB.ADM.KEP.SERIBU,KEP. SERIBU SELATAN,PULAU UNTUNG JAWA,1941,283,1658,1382,3040,2021-09-18
3174071007,JAKARTA SELATAN,KEBAYORAN BARU,PULO,5835,1951,3884,2922,6806,2021-09-18
3175021001,JAKARTA TIMUR,PULO GADUNG,PULO GADUNG,34422,11770,22652,16785,39437,2021-09-18
3175061005,JAKARTA TIMUR,CAKUNG,PULO GEBANG,97301,32598,64703,46717,111420,2021-09-18
3174041004,JAKARTA SELATAN,PASAR MINGGU,RAGUNAN,39616,13854,25762,16818,42580,2021-09-18
3175091005,JAKARTA TIMUR,CIRACAS,RAMBUTAN,36771,13522,23249,16868,40117,2021-09-18
3172031006,JAKARTA UTARA,KOJA,RAWA BADAK SELATAN,42179,15111,27068,19575,46643,2021-09-18
3172031004,JAKARTA UTARA,KOJA,RAWA BADAK UTARA,34408,12190,22218,16620,38838,2021-09-18
3174071005,JAKARTA SELATAN,KEBAYORAN BARU,RAWA BARAT,5625,1856,3769,2658,6427,2021-09-18
3173011003,JAKARTA BARAT,CENGKARENG,RAWA BUAYA,63799,21399,42400,29938,72338,2021-09-18
3175031004,JAKARTA TIMUR,JATINEGARA,RAWA BUNGA,21434,8033,13401,9961,23362,2021-09-18
3174081003,JAKARTA SELATAN,PANCORAN,RAWA JATI,20509,7299,13210,8169,21379,2021-09-18
3175061002,JAKARTA TIMUR,CAKUNG,RAWA TERATE,24637,7377,17260,13109,30369,2021-09-18
3175021005,JAKARTA TIMUR,PULO GADUNG,RAWAMANGUN,37612,12855,24757,18893,43650,2021-09-18
3171051003,JAKARTA PUSAT,CEMPAKA PUTIH,RAWASARI,21967,7652,14315,11096,25411,2021-09-18
3173041010,JAKARTA BARAT,TAMBORA,ROA MALAKA,3484,1012,2472,1993,4465,2021-09-18
3172041006,JAKARTA UTARA,CILINCING,ROROTAN,41668,12984,28684,21259,49943,2021-09-18
3174071004,JAKARTA SELATAN,KEBAYORAN BARU,SELONG,2842,966,1876,1439,3315,2021-09-18
3173061002,JAKARTA BARAT,KALI DERES,SEMANAN,71354,25207,46147,34216,80363,2021-09-18
3172041007,JAKARTA UTARA,CILINCING,SEMPER BARAT,68587,21335,47252,37068,84320,2021-09-18
3172041005,JAKARTA UTARA,CILINCING,SEMPER TIMUR,36267,11812,24455,18376,42831,2021-09-18
3174071006,JAKARTA SELATAN,KEBAYORAN BARU,SENAYAN,2771,1109,1662,1144,2806,2021-09-18
3171041001,JAKARTA PUSAT,SENEN,SENEN,6804,2185,4619,3617,8236,2021-09-18
3171031004,JAKARTA PUSAT,KEMAYORAN,SERDANG,29668,9812,19856,14985,34841,2021-09-18
3174021001,JAKARTA SELATAN,SETIA BUDI,SETIA BUDI,3023,1099,1924,1349,3273,2021-09-18
3175101005,JAKARTA TIMUR,CIPAYUNG,SETU,20572,7253,13319,9912,23231,2021-09-18
3173071002,JAKARTA BARAT,PALMERAH,SLIPI,16591,5367,11224,8605,19829,2021-09-18
3173081004,JAKARTA BARAT,KEMBANGAN,SRENGSENG,45523,16338,29185,22048,51233,2021-09-18
3174091002,JAKARTA SELATAN,JAGAKARSA,SRENGSENG SAWAH,58196,18717,39479,25170,64649,2021-09-18
3173051003,JAKARTA BARAT,KEBON JERUK,SUKABUMI SELATAN,37033,13443,23590,15960,39550,2021-09-18
3173051002,JAKARTA BARAT,KEBON JERUK,SUKABUMI UTARA,38290,14274,24016,15589,39605,2021-09-18
3172041002,JAKARTA UTARA,CILINCING,SUKAPURA,53949,18692,35257,27197,62454,2021-09-18
3171031007,JAKARTA PUSAT,KEMAYORAN,SUMUR BATU,22717,7749,14968,11603,26571,2021-09-18
3172021004,JAKARTA UTARA,TANJUNG PRIOK,SUNGAI BAMBU,29876,9868,20008,15413,35421,2021-09-18
3172021006,JAKARTA UTARA,TANJUNG PRIOK,SUNTER AGUNG,71805,20772,51033,41567,92600,2021-09-18
3172021002,JAKARTA UTARA,TANJUNG PRIOK,SUNTER JAYA,63031,18761,44270,35860,80130,2021-09-18
3175091004,JAKARTA TIMUR,CIRACAS,SUSUKAN,38257,11869,26388,19921,46309,2021-09-18
3173031001,JAKARTA BARAT,TAMAN SARI,TAMAN SARI,14348,4727,9621,7775,17396,2021-09-18
3173041001,JAKARTA BARAT,TAMBORA,TAMBORA,10204,3493,6711,4850,11561,2021-09-18
3173041004,JAKARTA BARAT,TAMBORA,TANAH SEREAL,26387,7581,18806,13950,32756,2021-09-18
3171081004,JAKARTA PUSAT,JOHAR BARU,TANAH TINGGI,37693,10961,26732,19825,46557,2021-09-18
3173031004,JAKARTA BARAT,TAMAN SARI,TANGKI,13324,4235,9089,7164,16253,2021-09-18
3174091005,JAKARTA SELATAN,JAGAKARSA,TANJUNG BARAT,39770,13883,25887,15513,41400,2021-09-18
3173021005,JAKARTA BARAT,GROGOL PETAMBURAN,TANJUNG DUREN SELATAN,25337,8521,16816,13295,30111,2021-09-18
3173021002,JAKARTA BARAT,GROGOL PETAMBURAN,TANJUNG DUREN UTARA,17010,5405,11605,9226,20831,2021-09-18
3172021001,JAKARTA UTARA,TANJUNG PRIOK,TANJUNG PRIOK,34588,11037,23551,17740,41291,2021-09-18
3174011002,JAKARTA SELATAN,TEBET,TEBET BARAT,21194,6950,14244,9747,23991,2021-09-18
3174011001,JAKARTA SELATAN,TEBET,TEBET TIMUR,18199,5960,12239,8391,20630,2021-09-18
3173061003,JAKARTA BARAT,KALI DERES,TEGAL ALUR,83647,28248,55399,41110,96509,2021-09-18
3174031004,JAKARTA SELATAN,MAMPANG PRAPATAN,TEGAL PARANG,32401,12598,19803,11836,31639,2021-09-18
3173021003,JAKARTA BARAT,GROGOL PETAMBURAN,TOMANG,29605,9819,19786,15815,35601,2021-09-18
3172031005,JAKARTA UTARA,KOJA,TUGU SELATAN,39122,13189,25933,18823,44756,2021-09-18
3172031002,JAKARTA UTARA,KOJA,TUGU UTARA,67670,24481,43189,31327,74516,2021-09-18
3175061006,JAKARTA TIMUR,CAKUNG,UJUNG MENTENG,29934,9219,20715,16222,36937,2021-09-18
3174101005,JAKARTA SELATAN,PESANGGRAHAN,ULUJAMI,40544,16093,24451,14481,38932,2021-09-18
3175011006,JAKARTA TIMUR,MATRAMAN,UTAN KAYU SELATAN,33511,10910,22601,16896,39497,2021-09-18
3175011002,JAKARTA TIMUR,MATRAMAN,UTAN KAYU UTARA,28169,10136,18033,13240,31273,2021-09-18
3171031008,JAKARTA PUSAT,KEMAYORAN,UTAN PANJANG,29208,10039,19169,14197,33366,2021-09-18
3172021007,JAKARTA UTARA,TANJUNG PRIOK,WARAKAS,44401,13955,30446,22808,53254,2021-09-18
3173021007,JAKARTA BARAT,GROGOL PETAMBURAN,WIJAYA KUSUMA,38934,13694,25240,19591,44831,2021-09-18
3172051003,JAKARTA UTARA,PADEMANGAN,ANCOL,23947,8656,15291,11862,27153,2021-09-19
3173041007,JAKARTA BARAT,TAMBORA,ANGKE,29381,9747,19634,14513,34147,2021-09-19
3175041005,JAKARTA TIMUR,KRAMAT JATI,BALE KAMBANG,29074,11365,17709,11733,29442,2021-09-19
3175031003,JAKARTA TIMUR,JATINEGARA,BALI MESTER,9752,3475,6277,4786,11063,2021-09-19
3175101006,JAKARTA TIMUR,CIPAYUNG,BAMBU APUS,26285,8645,17640,13502,31142,2021-09-19
3174031002,JAKARTA SELATAN,MAMPANG PRAPATAN,BANGKA,21566,8242,13324,8527,21851,2021-09-19
3175051002,JAKARTA TIMUR,PASAR REBO,BARU,23886,7175,16711,13430,30141,2021-09-19
3175041004,JAKARTA TIMUR,KRAMAT JATI,BATU AMPAR,47898,18470,29428,20841,50269,2021-09-19
3171071002,JAKARTA PUSAT,TANAH ABANG,BENDUNGAN HILIR,21494,7566,13928,10510,24438,2021-09-19
3175031002,JAKARTA TIMUR,JATINEGARA,BIDARA CINA,36689,14308,22381,16228,38609,2021-09-19
3174101002,JAKARTA SELATAN,PESANGGRAHAN,BINTARO,53098,19893,33205,21650,54855,2021-09-19
3174011005,JAKARTA SELATAN,TEBET,BUKIT DURI,34183,13066,21117,12861,33978,2021-09-19
3171041006,JAKARTA PUSAT,SENEN,BUNGUR,18144,6077,12067,9250,21317,2021-09-19
3175061007,JAKARTA TIMUR,CAKUNG,CAKUNG BARAT,57724,18179,39545,30324,69869,2021-09-19
3175061004,JAKARTA TIMUR,CAKUNG,CAKUNG TIMUR,58287,18317,39970,30807,70777,2021-09-19
3175041007,JAKARTA TIMUR,KRAMAT JATI,CAWANG,32762,11923,20839,14863,35702,2021-09-19
3175101008,JAKARTA TIMUR,CIPAYUNG,CEGER,18932,6160,12772,9752,22524,2021-09-19
3171031006,JAKARTA PUSAT,KEMAYORAN,CEMPAKA BARU,32581,11164,21417,15510,36927,2021-09-19
3171051002,JAKARTA PUSAT,CEMPAKA PUTIH,CEMPAKA PUTIH BARAT,35885,12269,23616,18478,42094,2021-09-19
3171051001,JAKARTA PUSAT,CEMPAKA PUTIH,CEMPAKA PUTIH TIMUR,24292,8074,16218,12780,28998,2021-09-19
3173011001,JAKARTA BARAT,CENGKARENG,CENGKARENG BARAT,66284,21893,44391,34540,78931,2021-09-19
3173011006,JAKARTA BARAT,CENGKARENG,CENGKARENG TIMUR,81027,26182,54845,40748,95593,2021-09-19
3175091002,JAKARTA TIMUR,CIRACAS,CIBUBUR,66364,20328,46036,35553,81589,2021-09-19
3171011002,JAKARTA PUSAT,GAMBIR,CIDENG,15390,4952,10438,8270,18708,2021-09-19
3174091003,JAKARTA SELATAN,JAGAKARSA,CIGANJUR,38497,13805,24692,15143,39835,2021-09-19
3175051003,JAKARTA TIMUR,PASAR REBO,CIJANTUNG,41419,12944,28475,21884,50359,2021-09-19
3171061003,JAKARTA PUSAT,MENTENG,CIKINI,8274,2519,5755,3971,9726,2021-09-19
3174081006,JAKARTA SELATAN,PANCORAN,CIKOKO,10547,3585,6962,4281,11243,2021-09-19
3174061001,JAKARTA SELATAN,CILANDAK,CILANDAK BARAT,51752,18514,33238,21636,54874,2021-09-19
3174041003,JAKARTA SELATAN,PASAR MINGGU,CILANDAK TIMUR,25145,8878,16267,11103,27370,2021-09-19
3175101002,JAKARTA TIMUR,CIPAYUNG,CILANGKAP,27635,9004,18631,14255,32886,2021-09-19
3175041006,JAKARTA TIMUR,KRAMAT JATI,CILILITAN,40181,14761,25420,18649,44069,2021-09-19
3172041001,JAKARTA UTARA,CILINCING,CILINCING,43609,15474,28135,20093,48228,2021-09-19
3175101001,JAKARTA TIMUR,CIPAYUNG,CIPAYUNG,26104,7807,18297,14569,32866,2021-09-19
3174091006,JAKARTA SELATAN,JAGAKARSA,CIPEDAK,38303,12775,25528,16276,41804,2021-09-19
3174061005,JAKARTA SELATAN,CILANDAK,CIPETE SELATAN,26704,9993,16711,11572,28283,2021-09-19
3174071010,JAKARTA SELATAN,KEBAYORAN BARU,CIPETE UTARA,34102,12444,21658,13817,35475,2021-09-19
3175021003,JAKARTA TIMUR,PULO GADUNG,CIPINANG,39306,13238,26068,19454,45522,2021-09-19
3175031007,JAKARTA TIMUR,JATINEGARA,CIPINANG BESAR SELATAN,35212,13013,22199,15570,37769,2021-09-19
3175031008,JAKARTA TIMUR,JATINEGARA,CIPINANG BESAR UTARA,45319,16810,28509,20330,48839,2021-09-19
3175031005,JAKARTA TIMUR,JATINEGARA,CIPINANG CEMPEDAK,32824,12474,20350,15681,36031,2021-09-19
3175081005,JAKARTA TIMUR,MAKASAR,CIPINANG MELAYU,42308,15001,27307,21344,48651,2021-09-19
3175031006,JAKARTA TIMUR,JATINEGARA,CIPINANG MUARA,55243,20311,34932,25754,60686,2021-09-19
3174051003,JAKARTA SELATAN,KEBAYORAN LAMA,CIPULIR,39937,15881,24056,13877,37933,2021-09-19
3175091001,JAKARTA TIMUR,CIRACAS,CIRACAS,64594,19638,44956,33836,78792,2021-09-19
3175041003,JAKARTA TIMUR,KRAMAT JATI,DUKUH,24609,7969,16640,12452,29092,2021-09-19
3175071001,JAKARTA TIMUR,DUREN SAWIT,DUREN SAWIT,61160,22208,38952,29361,68313,2021-09-19
3174081004,JAKARTA SELATAN,PANCORAN,DUREN TIGA,28319,10394,17925,10155,28080,2021-09-19
3173051005,JAKARTA BARAT,KEBON JERUK,DURI KEPA,60138,19442,40696,32173,72869,2021-09-19
3173011002,JAKARTA BARAT,CENGKARENG,DURI KOSAMBI,77923,28323,49600,36052,85652,2021-09-19
3171011006,JAKARTA PUSAT,GAMBIR,DURI PULO,19610,6582,13028,9679,22707,2021-09-19
3173041011,JAKARTA BARAT,TAMBORA,DURI SELATAN,14259,4335,9924,7693,17617,2021-09-19
3173041003,JAKARTA BARAT,TAMBORA,DURI UTARA,19844,6296,13548,10072,23620,2021-09-19
3171081003,JAKARTA PUSAT,JOHAR BARU,GALUR,18243,5406,12837,9679,22516,2021-09-19
3171011001,JAKARTA PUSAT,GAMBIR,GAMBIR,2191,711,1480,1184,2664,2021-09-19
3174061004,JAKARTA SELATAN,CILANDAK,GANDARIA SELATAN,22119,8204,13915,8615,22530,2021-09-19
3174071009,JAKARTA SELATAN,KEBAYORAN BARU,GANDARIA UTARA,39922,14906,25016,16129,41145,2021-09-19
3175051001,JAKARTA TIMUR,PASAR REBO,GEDONG,35755,11834,23921,18338,42259,2021-09-19
3171071001,JAKARTA PUSAT,TANAH ABANG,GELORA,3127,1131,1996,1431,3427,2021-09-19
3173031007,JAKARTA BARAT,TAMAN SARI,GLODOK,7837,2237,5600,4712,10312,2021-09-19
3171061004,JAKARTA PUSAT,MENTENG,GONDANGDIA,4100,1433,2667,2239,4906,2021-09-19
3173021001,JAKARTA BARAT,GROGOL PETAMBURAN,GROGOL,16876,5777,11099,8597,19696,2021-09-19
3174051005,JAKARTA SELATAN,KEBAYORAN LAMA,GROGOL SELATAN,44251,16828,27423,16573,43996,2021-09-19
3174051004,JAKARTA SELATAN,KEBAYORAN LAMA,GROGOL UTARA,42494,15846,26648,16651,43299,2021-09-19
3174021007,JAKARTA SELATAN,SETIA BUDI,GUNTUR,3985,1356,2629,1988,4617,2021-09-19
3174071002,JAKARTA SELATAN,KEBAYORAN BARU,GUNUNG,9436,3309,6127,4389,10516,2021-09-19
3171031005,JAKARTA PUSAT,KEMAYORAN,GUNUNG SAHARI SELATAN,19199,6461,12738,9999,22737,2021-09-19
3171021004,JAKARTA PUSAT,SAWAH BESAR,GUNUNG SAHARI UTARA,16650,4892,11758,9772,21530,2021-09-19
3175081004,JAKARTA TIMUR,MAKASAR,HALIM PERDANA KUSUMAH,28363,7468,20895,18053,38948,2021-09-19
3171031003,JAKARTA PUSAT,KEMAYORAN,HARAPAN MULIA,22557,7518,15039,11400,26439,2021-09-19
3174091001,JAKARTA SELATAN,JAGAKARSA,JAGAKARSA,62389,21653,40736,26672,67408,2021-09-19
3175021007,JAKARTA TIMUR,PULO GADUNG,JATI,32757,10955,21802,17052,38854,2021-09-19
3174041002,JAKARTA SELATAN,PASAR MINGGU,JATI PADANG,37502,13733,23769,15554,39323,2021-09-19
3173071004,JAKARTA BARAT,PALMERAH,JATI PULO,28738,9159,19579,14430,34009,2021-09-19
3175061001,JAKARTA TIMUR,CAKUNG,JATINEGARA,84160,28640,55520,42301,97821,2021-09-19
3175021004,JAKARTA TIMUR,PULO GADUNG,JATINEGARA KAUM,24632,7704,16928,11877,28805,2021-09-19
3173021004,JAKARTA BARAT,GROGOL PETAMBURAN,JELAMBAR,30266,10136,20130,16110,36240,2021-09-19
3173021006,JAKARTA BARAT,GROGOL PETAMBURAN,JELAMBAR BARU,38246,12641,25605,20486,46091,2021-09-19
3173041006,JAKARTA BARAT,TAMBORA,JEMBATAN BESI,29314,10951,18363,12633,30996,2021-09-19
3173041008,JAKARTA BARAT,TAMBORA,JEMBATAN LIMA,21021,7574,13447,9592,23039,2021-09-19
3173081005,JAKARTA BARAT,KEMBANGAN,JOGLO,40839,13863,26976,20278,47254,2021-09-19
3171081001,JAKARTA PUSAT,JOHAR BARU,JOHAR BARU,37488,11270,26218,20455,46673,2021-09-19
3173041002,JAKARTA BARAT,TAMBORA,KALI ANYAR,23856,7677,16179,11714,27893,2021-09-19
3172041004,JAKARTA UTARA,CILINCING,KALIBARU,67684,25912,41772,27283,69055,2021-09-19
3174081002,JAKARTA SELATAN,PANCORAN,KALIBATA,41994,17220,24774,13936,38710,2021-09-19
3173061001,JAKARTA BARAT,KALI DERES,KALIDERES,72447,25001,47446,37646,85092,2021-09-19
3175051004,JAKARTA TIMUR,PASAR REBO,KALISARI,43212,13769,29443,22911,52354,2021-09-19
3173061004,JAKARTA BARAT,KALI DERES,KAMAL,53783,19226,34557,25242,59799,2021-09-19
3172011002,JAKARTA UTARA,PENJARINGAN,KAMAL MUARA,12930,3318,9612,7774,17386,2021-09-19
3171071007,JAKARTA PUSAT,TANAH ABANG,KAMPUNG BALI,11358,4120,7238,5070,12308,2021-09-19
3175031001,JAKARTA TIMUR,JATINEGARA,KAMPUNG MELAYU,25717,9795,15922,11509,27431,2021-09-19
3171081002,JAKARTA PUSAT,JOHAR BARU,KAMPUNG RAWA,21237,5489,15748,11599,27347,2021-09-19
3175041002,JAKARTA TIMUR,KRAMAT JATI,KAMPUNG TENGAH,43993,16683,27310,19324,46634,2021-09-19
3173011005,JAKARTA BARAT,CENGKARENG,KAPUK,134466,48422,86044,62157,148201,2021-09-19
3172011003,JAKARTA UTARA,PENJARINGAN,KAPUK MUARA,35781,10533,25248,21085,46333,2021-09-19
3171021002,JAKARTA PUSAT,SAWAH BESAR,KARANG ANYAR,25761,8113,17648,13693,31341,2021-09-19
3174021004,JAKARTA SELATAN,SETIA BUDI,KARET,9623,3559,6064,4107,10171,2021-09-19
3174021003,JAKARTA SELATAN,SETIA BUDI,KARET KUNINGAN,16055,5293,10762,7330,18092,2021-09-19
3174021002,JAKARTA SELATAN,SETIA BUDI,KARET SEMANGGI,2770,933,1837,1424,3261,2021-09-19
3171071003,JAKARTA PUSAT,TANAH ABANG,KARET TENGSIN,19271,6285,12986,9277,22263,2021-09-19
3171021003,JAKARTA PUSAT,SAWAH BESAR,KARTINI,22292,7304,14988,12045,27033,2021-09-19
3175011003,JAKARTA TIMUR,MATRAMAN,KAYU MANIS,25284,9239,16045,11392,27437,2021-09-19
3175021006,JAKARTA TIMUR,PULO GADUNG,KAYU PUTIH,40696,13118,27578,22139,49717,2021-09-19
3173031006,JAKARTA BARAT,TAMAN SARI,KEAGUNGAN,17387,5613,11774,9015,20789,2021-09-19
3174041007,JAKARTA SELATAN,PASAR MINGGU,KEBAGUSAN,44552,16956,27596,16840,44436,2021-09-19
3174051006,JAKARTA SELATAN,KEBAYORAN LAMA,KEBAYORAN LAMA SELATAN,41212,14660,26552,16307,42859,2021-09-19
3174051001,JAKARTA SELATAN,KEBAYORAN LAMA,KEBAYORAN LAMA UTARA,42422,16460,25962,14843,40805,2021-09-19
3174011004,JAKARTA SELATAN,TEBET,KEBON BARU,35165,12715,22450,14102,36552,2021-09-19
3172021005,JAKARTA UTARA,TANJUNG PRIOK,KEBON BAWANG,50952,17164,33788,26042,59830,2021-09-19
3173051001,JAKARTA BARAT,KEBON JERUK,KEBON JERUK,53887,19270,34617,25700,60317,2021-09-19
3171071006,JAKARTA PUSAT,TANAH ABANG,KEBON KACANG,21531,8315,13216,9393,22609,2021-09-19
3171011005,JAKARTA PUSAT,GAMBIR,KEBON KELAPA,10163,3438,6725,5253,11978,2021-09-19
3171031002,JAKARTA PUSAT,KEMAYORAN,KEBON KOSONG,30019,10168,19851,15126,34977,2021-09-19
3175011005,JAKARTA TIMUR,MATRAMAN,KEBON MANGGIS,16490,5516,10974,8210,19184,2021-09-19
3171071005,JAKARTA PUSAT,TANAH ABANG,KEBON MELATI,32206,12913,19293,12912,32205,2021-09-19
3175081003,JAKARTA TIMUR,MAKASAR,KEBON PALA,46614,15851,30763,22563,53326,2021-09-19
3171061005,JAKARTA PUSAT,MENTENG,KEBON SIRIH,12299,4290,8009,5833,13842,2021-09-19
3173011004,JAKARTA BARAT,CENGKARENG,KEDAUNG KALI ANGKE,32612,9987,22625,17531,40156,2021-09-19
3173051007,JAKARTA BARAT,KEBON JERUK,KEDOYA SELATAN,32165,10436,21729,16390,38119,2021-09-19
3173051006,JAKARTA BARAT,KEBON JERUK,KEDOYA UTARA,45740,14159,31581,25261,56842,2021-09-19
3173051004,JAKARTA BARAT,KEBON JERUK,KELAPA DUA,23565,8405,15160,11546,26706,2021-09-19
3175091003,JAKARTA TIMUR,CIRACAS,KELAPA DUA WETAN,46875,14097,32778,25047,57825,2021-09-19
3172061003,JAKARTA UTARA,KELAPA GADING,KELAPA GADING BARAT,35717,10602,25115,21308,46423,2021-09-19
3172061001,JAKARTA UTARA,KELAPA GADING,KELAPA GADING TIMUR,33592,9102,24490,20964,45454,2021-09-19
3173071005,JAKARTA BARAT,PALMERAH,KEMANGGISAN,32139,10682,21457,16049,37506,2021-09-19
3171031001,JAKARTA PUSAT,KEMAYORAN,KEMAYORAN,20708,6689,14019,10842,24861,2021-09-19
3173081006,JAKARTA BARAT,KEMBANGAN,KEMBANGAN SELATAN,27130,9169,17961,14445,32406,2021-09-19
3173081001,JAKARTA BARAT,KEMBANGAN,KEMBANGAN UTARA,54451,18184,36267,28160,64427,2021-09-19
3171041002,JAKARTA PUSAT,SENEN,KENARI,9579,3101,6478,5158,11636,2021-09-19
3173041005,JAKARTA BARAT,TAMBORA,KERENDANG,19973,6550,13423,9858,23281,2021-09-19
3175071003,JAKARTA TIMUR,DUREN SAWIT,KLENDER,69978,25722,44256,31913,76169,2021-09-19
3172031001,JAKARTA UTARA,KOJA,KOJA,28175,10000,18175,13973,32148,2021-09-19
3173071006,JAKARTA BARAT,PALMERAH,KOTA BAMBU SELATAN,21158,7151,14007,10017,24024,2021-09-19
3173071003,JAKARTA BARAT,PALMERAH,KOTA BAMBU UTARA,24995,8704,16291,11644,27935,2021-09-19
3171041004,JAKARTA PUSAT,SENEN,KRAMAT,28835,10207,18628,12644,31272,2021-09-19
3175041001,JAKARTA TIMUR,KRAMAT JATI,KRAMAT JATI,34144,11856,22288,16242,38530,2021-09-19
3174071003,JAKARTA SELATAN,KEBAYORAN BARU,KRAMAT PELA,14413,4977,9436,6158,15594,2021-09-19
3173031002,JAKARTA BARAT,TAMAN SARI,KRUKUT,19244,6294,12950,9684,22634,2021-09-19
3174031005,JAKARTA SELATAN,MAMPANG PRAPATAN,KUNINGAN BARAT,12785,4439,8346,5317,13663,2021-09-19
3174021008,JAKARTA SELATAN,SETIA BUDI,KUNINGAN TIMUR,6008,2112,3896,2682,6578,2021-09-19
3171041005,JAKARTA PUSAT,SENEN,KWITANG,15486,5340,10146,7696,17842,2021-09-19
3172031003,JAKARTA UTARA,KOJA,LAGOA,59065,21311,37754,27153,64907,2021-09-19
3174061002,JAKARTA SELATAN,CILANDAK,LEBAK BULUS,37626,14223,23403,15331,38734,2021-09-19
3174091004,JAKARTA SELATAN,JAGAKARSA,LENTENG AGUNG,53946,20323,33623,19823,53446,2021-09-19
3175101007,JAKARTA TIMUR,CIPAYUNG,LUBANG BUAYA,63547,19889,43658,33415,77073,2021-09-19
3175081001,JAKARTA TIMUR,MAKASAR,MAKASAR,34390,11197,23193,17860,41053,2021-09-19
3175071006,JAKARTA TIMUR,DUREN SAWIT,MALAKA JAYA,30927,10450,20477,16084,36561,2021-09-19
3175071005,JAKARTA TIMUR,DUREN SAWIT,MALAKA SARI,27530,8932,18598,14846,33444,2021-09-19
3174031001,JAKARTA SELATAN,MAMPANG PRAPATAN,MAMPANG PRAPATAN,18159,6628,11531,7556,19087,2021-09-19
3173031005,JAKARTA BARAT,TAMAN SARI,MANGGA BESAR,7707,2217,5490,4436,9926,2021-09-19
3171021005,JAKARTA PUSAT,SAWAH BESAR,MANGGA DUA SELATAN,27442,8899,18543,14440,32983,2021-09-19
3174011007,JAKARTA SELATAN,TEBET,MANGGARAI,28373,9361,19012,11575,30587,2021-09-19
3174011006,JAKARTA SELATAN,TEBET,MANGGARAI SELATAN,23075,7893,15182,9816,24998,2021-09-19
3173031003,JAKARTA BARAT,TAMAN SARI,MAPHAR,16461,5520,10941,8553,19494,2021-09-19
3172041003,JAKARTA UTARA,CILINCING,MARUNDA,28943,9219,19724,13472,33196,2021-09-19
3174071001,JAKARTA SELATAN,KEBAYORAN BARU,MELAWAI,2627,884,1743,1399,3142,2021-09-19
3171061001,JAKARTA PUSAT,MENTENG,MENTENG,25624,9148,16476,12019,28495,2021-09-19
3174021005,JAKARTA SELATAN,SETIA BUDI,MENTENG ATAS,27816,9385,18431,11705,30136,2021-09-19
3174011003,JAKARTA SELATAN,TEBET,MENTENG DALAM,36028,12987,23041,14946,37987,2021-09-19
3173081003,JAKARTA BARAT,KEMBANGAN,MERUYA SELATAN,32130,10937,21193,16290,37483,2021-09-19
3173081002,JAKARTA BARAT,KEMBANGAN,MERUYA UTARA,43752,15047,28705,23039,51744,2021-09-19
3175101004,JAKARTA TIMUR,CIPAYUNG,MUNJUL,23871,7631,16240,12661,28901,2021-09-19
3172051002,JAKARTA UTARA,PADEMANGAN,PADEMANGAN BARAT,74240,26278,47962,35939,83901,2021-09-19
3172051001,JAKARTA UTARA,PADEMANGAN,PADEMANGAN TIMUR,37736,11100,26636,21608,48244,2021-09-19
3175011004,JAKARTA TIMUR,MATRAMAN,PAL MERIAM,19769,7189,12580,9336,21916,2021-09-19
3173071001,JAKARTA BARAT,PALMERAH,PALMERAH,63011,21938,41073,29867,70940,2021-09-19
3174081001,JAKARTA SELATAN,PANCORAN,PANCORAN,19421,7151,12270,7642,19912,2021-09-19
3172021003,JAKARTA UTARA,TANJUNG PRIOK,PAPANGGO,39097,12327,26770,20592,47362,2021-09-19
3171021001,JAKARTA PUSAT,SAWAH BESAR,PASAR BARU,12035,3590,8445,7108,15553,2021-09-19
3174021006,JAKARTA SELATAN,SETIA BUDI,PASAR MANGGIS,26752,9636,17116,10913,28029,2021-09-19
3174041001,JAKARTA SELATAN,PASAR MINGGU,PASAR MINGGU,24821,8964,15857,10541,26398,2021-09-19
3171041003,JAKARTA PUSAT,SENEN,PASEBAN,23533,8219,15314,11262,26576,2021-09-19
3173061005,JAKARTA BARAT,KALI DERES,PEGADUNGAN,75587,24185,51402,41435,92837,2021-09-19
3171061002,JAKARTA PUSAT,MENTENG,PEGANGSAAN,23455,8168,15287,10680,25967,2021-09-19
3172061002,JAKARTA UTARA,KELAPA GADING,PEGANGSAAN DUA,49976,13521,36455,30941,67396,2021-09-19
3172011004,JAKARTA UTARA,PENJARINGAN,PEJAGALAN,74578,24722,49856,39919,89775,2021-09-19
3174041006,JAKARTA SELATAN,PASAR MINGGU,PEJATEN BARAT,37346,13942,23404,15122,38526,2021-09-19
3174041005,JAKARTA SELATAN,PASAR MINGGU,PEJATEN TIMUR,57656,22348,35308,20699,56007,2021-09-19
3175051005,JAKARTA TIMUR,PASAR REBO,PEKAYON,43250,13684,29566,22484,52050,2021-09-19
3173041009,JAKARTA BARAT,TAMBORA,PEKOJAN,23587,7394,16193,12574,28767,2021-09-19
3174031003,JAKARTA SELATAN,MAMPANG PRAPATAN,PELA MAMPANG,43522,15656,27866,18695,46561,2021-09-19
3174081005,JAKARTA SELATAN,PANCORAN,PENGADEGAN,21478,7109,14369,8213,22582,2021-09-19
3175061003,JAKARTA TIMUR,CAKUNG,PENGGILINGAN,99255,36200,63055,45281,108336,2021-09-19
3172011001,JAKARTA UTARA,PENJARINGAN,PENJARINGAN,88308,32617,55691,40437,96128,2021-09-19
3174101001,JAKARTA SELATAN,PESANGGRAHAN,PESANGGRAHAN,27545,9396,18149,11640,29789,2021-09-19
3171071004,JAKARTA PUSAT,TANAH ABANG,PETAMBURAN,33271,13235,20036,13524,33560,2021-09-19
3174071008,JAKARTA SELATAN,KEBAYORAN BARU,PETOGOGAN,11499,4255,7244,4876,12120,2021-09-19
3171011004,JAKARTA PUSAT,GAMBIR,PETOJO SELATAN,14692,5226,9466,7394,16860,2021-09-19
3171011003,JAKARTA PUSAT,GAMBIR,PETOJO UTARA,17458,6085,11373,8531,19904,2021-09-19
3174101004,JAKARTA SELATAN,PESANGGRAHAN,PETUKANGAN SELATAN,37187,13606,23581,14612,38193,2021-09-19
3174101003,JAKARTA SELATAN,PESANGGRAHAN,PETUKANGAN UTARA,53716,20799,32917,20855,53772,2021-09-19
3175081002,JAKARTA TIMUR,MAKASAR,PINANG RANTI,27198,9389,17809,13509,31318,2021-09-19
3173031008,JAKARTA BARAT,TAMAN SARI,PINANGSIA,10729,3199,7530,5862,13392,2021-09-19
3175011001,JAKARTA TIMUR,MATRAMAN,PISANGAN BARU,31776,11411,20365,14176,34541,2021-09-19
3175021002,JAKARTA TIMUR,PULO GADUNG,PISANGAN TIMUR,41011,13340,27671,21461,49132,2021-09-19
3172011005,JAKARTA UTARA,PENJARINGAN,PLUIT,47783,14972,32811,27035,59846,2021-09-19
3175071002,JAKARTA TIMUR,DUREN SAWIT,PONDOK BAMBU,61550,22209,39341,29740,69081,2021-09-19
3175071004,JAKARTA TIMUR,DUREN SAWIT,PONDOK KELAPA,72015,24929,47086,35970,83056,2021-09-19
3175071007,JAKARTA TIMUR,DUREN SAWIT,PONDOK KOPI,35367,12723,22644,16491,39135,2021-09-19
3174061003,JAKARTA SELATAN,CILANDAK,PONDOK LABU,46464,16026,30438,20924,51362,2021-09-19
3174051002,JAKARTA SELATAN,KEBAYORAN LAMA,PONDOK PINANG,56169,20790,35379,22955,58334,2021-09-19
3175101003,JAKARTA TIMUR,CIPAYUNG,PONDOK RANGGON,25574,8388,17186,13385,30571,2021-09-19
3101011003,KAB.ADM.KEP.SERIBU,KEP. SERIBU UTARA,PULAU HARAPAN,2060,327,1733,1088,2821,2021-09-19
3101011002,KAB.ADM.KEP.SERIBU,KEP. SERIBU UTARA,PULAU KELAPA,5528,871,4657,2961,7618,2021-09-19
3101011001,KAB.ADM.KEP.SERIBU,KEP. SERIBU UTARA,PULAU PANGGANG,5450,807,4643,2519,7162,2021-09-19
3101021003,KAB.ADM.KEP.SERIBU,KEP. SERIBU SELATAN,PULAU PARI,2765,301,2464,2049,4513,2021-09-19
3101021002,KAB.ADM.KEP.SERIBU,KEP. SERIBU SELATAN,PULAU TIDUNG,4553,591,3962,2929,6891,2021-09-19
3101021001,KAB.ADM.KEP.SERIBU,KEP. SERIBU SELATAN,PULAU UNTUNG JAWA,1941,283,1658,1391,3049,2021-09-19
3174071007,JAKARTA SELATAN,KEBAYORAN BARU,PULO,5835,1949,3886,2926,6812,2021-09-19
3175021001,JAKARTA TIMUR,PULO GADUNG,PULO GADUNG,34422,11757,22665,16944,39609,2021-09-19
3175061005,JAKARTA TIMUR,CAKUNG,PULO GEBANG,97301,32566,64735,46974,111709,2021-09-19
3174041004,JAKARTA SELATAN,PASAR MINGGU,RAGUNAN,39616,13849,25767,16840,42607,2021-09-19
3175091005,JAKARTA TIMUR,CIRACAS,RAMBUTAN,36771,13515,23256,16998,40254,2021-09-19
3172031006,JAKARTA UTARA,KOJA,RAWA BADAK SELATAN,42179,15106,27073,19652,46725,2021-09-19
3172031004,JAKARTA UTARA,KOJA,RAWA BADAK UTARA,34408,12182,22226,16688,38914,2021-09-19
3174071005,JAKARTA SELATAN,KEBAYORAN BARU,RAWA BARAT,5625,1856,3769,2669,6438,2021-09-19
3173011003,JAKARTA BARAT,CENGKARENG,RAWA BUAYA,63799,21379,42420,30253,72673,2021-09-19
3175031004,JAKARTA TIMUR,JATINEGARA,RAWA BUNGA,21434,8030,13404,10015,23419,2021-09-19
3174081003,JAKARTA SELATAN,PANCORAN,RAWA JATI,20509,7296,13213,8194,21407,2021-09-19
3175061002,JAKARTA TIMUR,CAKUNG,RAWA TERATE,24637,7369,17268,13173,30441,2021-09-19
3175021005,JAKARTA TIMUR,PULO GADUNG,RAWAMANGUN,37612,12836,24776,19104,43880,2021-09-19
3171051003,JAKARTA PUSAT,CEMPAKA PUTIH,RAWASARI,21967,7645,14322,11152,25474,2021-09-19
3173041010,JAKARTA BARAT,TAMBORA,ROA MALAKA,3484,1012,2472,1997,4469,2021-09-19
3172041006,JAKARTA UTARA,CILINCING,ROROTAN,41668,12957,28711,21482,50193,2021-09-19
3174071004,JAKARTA SELATAN,KEBAYORAN BARU,SELONG,2842,966,1876,1439,3315,2021-09-19
3173061002,JAKARTA BARAT,KALI DERES,SEMANAN,71354,25167,46187,34468,80655,2021-09-19
3172041007,JAKARTA UTARA,CILINCING,SEMPER BARAT,68587,21301,47286,37299,84585,2021-09-19
3172041005,JAKARTA UTARA,CILINCING,SEMPER TIMUR,36267,11800,24467,18509,42976,2021-09-19
3174071006,JAKARTA SELATAN,KEBAYORAN BARU,SENAYAN,2771,1109,1662,1145,2807,2021-09-19
3171041001,JAKARTA PUSAT,SENEN,SENEN,6804,2182,4622,3645,8267,2021-09-19
3171031004,JAKARTA PUSAT,KEMAYORAN,SERDANG,29668,9808,19860,15102,34962,2021-09-19
3174021001,JAKARTA SELATAN,SETIA BUDI,SETIA BUDI,3023,1097,1926,1352,3278,2021-09-19
3175101005,JAKARTA TIMUR,CIPAYUNG,SETU,20572,7247,13325,9959,23284,2021-09-19
3173071002,JAKARTA BARAT,PALMERAH,SLIPI,16591,5362,11229,8630,19859,2021-09-19
3173081004,JAKARTA BARAT,KEMBANGAN,SRENGSENG,45523,16332,29191,22215,51406,2021-09-19
3174091002,JAKARTA SELATAN,JAGAKARSA,SRENGSENG SAWAH,58196,18716,39480,25198,64678,2021-09-19
3173051003,JAKARTA BARAT,KEBON JERUK,SUKABUMI SELATAN,37033,13432,23601,16000,39601,2021-09-19
3173051002,JAKARTA BARAT,KEBON JERUK,SUKABUMI UTARA,38290,14266,24024,15816,39840,2021-09-19
3172041002,JAKARTA UTARA,CILINCING,SUKAPURA,53949,18675,35274,27357,62631,2021-09-19
3171031007,JAKARTA PUSAT,KEMAYORAN,SUMUR BATU,22717,7743,14974,11686,26660,2021-09-19
3172021004,JAKARTA UTARA,TANJUNG PRIOK,SUNGAI BAMBU,29876,9848,20028,15545,35573,2021-09-19
3172021006,JAKARTA UTARA,TANJUNG PRIOK,SUNTER AGUNG,71805,20730,51075,41900,92975,2021-09-19
3172021002,JAKARTA UTARA,TANJUNG PRIOK,SUNTER JAYA,63031,18750,44281,36064,80345,2021-09-19
3175091004,JAKARTA TIMUR,CIRACAS,SUSUKAN,38257,11856,26401,20353,46754,2021-09-19
3173031001,JAKARTA BARAT,TAMAN SARI,TAMAN SARI,14348,4724,9624,7834,17458,2021-09-19
3173041001,JAKARTA BARAT,TAMBORA,TAMBORA,10204,3490,6714,4941,11655,2021-09-19
3173041004,JAKARTA BARAT,TAMBORA,TANAH SEREAL,26387,7569,18818,14080,32898,2021-09-19
3171081004,JAKARTA PUSAT,JOHAR BARU,TANAH TINGGI,37693,10953,26740,19898,46638,2021-09-19
3173031004,JAKARTA BARAT,TAMAN SARI,TANGKI,13324,4233,9091,7204,16295,2021-09-19
3174091005,JAKARTA SELATAN,JAGAKARSA,TANJUNG BARAT,39770,13882,25888,15550,41438,2021-09-19
3173021005,JAKARTA BARAT,GROGOL PETAMBURAN,TANJUNG DUREN SELATAN,25337,8510,16827,13422,30249,2021-09-19
3173021002,JAKARTA BARAT,GROGOL PETAMBURAN,TANJUNG DUREN UTARA,17010,5401,11609,9304,20913,2021-09-19
3172021001,JAKARTA UTARA,TANJUNG PRIOK,TANJUNG PRIOK,34588,11016,23572,17922,41494,2021-09-19
3174011002,JAKARTA SELATAN,TEBET,TEBET BARAT,21194,6949,14245,9772,24017,2021-09-19
3174011001,JAKARTA SELATAN,TEBET,TEBET TIMUR,18199,5959,12240,8414,20654,2021-09-19
3173061003,JAKARTA BARAT,KALI DERES,TEGAL ALUR,83647,28240,55407,41211,96618,2021-09-19
3174031004,JAKARTA SELATAN,MAMPANG PRAPATAN,TEGAL PARANG,32401,12593,19808,11862,31670,2021-09-19
3173021003,JAKARTA BARAT,GROGOL PETAMBURAN,TOMANG,29605,9807,19798,15906,35704,2021-09-19
3172031005,JAKARTA UTARA,KOJA,TUGU SELATAN,39122,13178,25944,18892,44836,2021-09-19
3172031002,JAKARTA UTARA,KOJA,TUGU UTARA,67670,24407,43263,31473,74736,2021-09-19
3175061006,JAKARTA TIMUR,CAKUNG,UJUNG MENTENG,29934,9206,20728,16282,37010,2021-09-19
3174101005,JAKARTA SELATAN,PESANGGRAHAN,ULUJAMI,40544,16090,24454,14509,38963,2021-09-19
3175011006,JAKARTA TIMUR,MATRAMAN,UTAN KAYU SELATAN,33511,10905,22606,17022,39628,2021-09-19
3175011002,JAKARTA TIMUR,MATRAMAN,UTAN KAYU UTARA,28169,10124,18045,13329,31374,2021-09-19
3171031008,JAKARTA PUSAT,KEMAYORAN,UTAN PANJANG,29208,9946,19262,14321,33583,2021-09-19
3172021007,JAKARTA UTARA,TANJUNG PRIOK,WARAKAS,44401,13904,30497,23114,53611,2021-09-19
3173021007,JAKARTA BARAT,GROGOL PETAMBURAN,WIJAYA KUSUMA,38934,13685,25249,19728,44977,2021-09-19
3172051003,JAKARTA UTARA,PADEMANGAN,ANCOL,23947,8652,15295,11875,27170,2021-09-20
3173041007,JAKARTA BARAT,TAMBORA,ANGKE,29381,9722,19659,14536,34195,2021-09-20
3175041005,JAKARTA TIMUR,KRAMAT JATI,BALE KAMBANG,29074,11210,17864,12020,29884,2021-09-20
3175031003,JAKARTA TIMUR,JATINEGARA,BALI MESTER,9752,3474,6278,4796,11074,2021-09-20
3175101006,JAKARTA TIMUR,CIPAYUNG,BAMBU APUS,26285,8644,17641,13513,31154,2021-09-20
3174031002,JAKARTA SELATAN,MAMPANG PRAPATAN,BANGKA,21566,8241,13325,8532,21857,2021-09-20
3175051002,JAKARTA TIMUR,PASAR REBO,BARU,23886,7170,16716,13445,30161,2021-09-20
3175041004,JAKARTA TIMUR,KRAMAT JATI,BATU AMPAR,47898,18449,29449,20875,50324,2021-09-20
3171071002,JAKARTA PUSAT,TANAH ABANG,BENDUNGAN HILIR,21494,7562,13932,10520,24452,2021-09-20
3175031002,JAKARTA TIMUR,JATINEGARA,BIDARA CINA,36689,14293,22396,16239,38635,2021-09-20
3174101002,JAKARTA SELATAN,PESANGGRAHAN,BINTARO,53098,19890,33208,21672,54880,2021-09-20
3174011005,JAKARTA SELATAN,TEBET,BUKIT DURI,34183,13061,21122,12880,34002,2021-09-20
3171041006,JAKARTA PUSAT,SENEN,BUNGUR,18144,6071,12073,9253,21326,2021-09-20
3175061007,JAKARTA TIMUR,CAKUNG,CAKUNG BARAT,57724,18146,39578,30399,69977,2021-09-20
3175061004,JAKARTA TIMUR,CAKUNG,CAKUNG TIMUR,58287,18285,40002,30857,70859,2021-09-20
3175041007,JAKARTA TIMUR,KRAMAT JATI,CAWANG,32762,11918,20844,14879,35723,2021-09-20
3175101008,JAKARTA TIMUR,CIPAYUNG,CEGER,18932,6156,12776,9760,22536,2021-09-20
3171031006,JAKARTA PUSAT,KEMAYORAN,CEMPAKA BARU,32581,11150,21431,15535,36966,2021-09-20
3171051002,JAKARTA PUSAT,CEMPAKA PUTIH,CEMPAKA PUTIH BARAT,35885,12262,23623,18490,42113,2021-09-20
3171051001,JAKARTA PUSAT,CEMPAKA PUTIH,CEMPAKA PUTIH TIMUR,24292,8069,16223,12791,29014,2021-09-20
3173011001,JAKARTA BARAT,CENGKARENG,CENGKARENG BARAT,66284,21871,44413,34570,78983,2021-09-20
3173011006,JAKARTA BARAT,CENGKARENG,CENGKARENG TIMUR,81027,26156,54871,40809,95680,2021-09-20
3175091002,JAKARTA TIMUR,CIRACAS,CIBUBUR,66364,20249,46115,35714,81829,2021-09-20
3171011002,JAKARTA PUSAT,GAMBIR,CIDENG,15390,4941,10449,8303,18752,2021-09-20
3174091003,JAKARTA SELATAN,JAGAKARSA,CIGANJUR,38497,13803,24694,15157,39851,2021-09-20
3175051003,JAKARTA TIMUR,PASAR REBO,CIJANTUNG,41419,12930,28489,21916,50405,2021-09-20
3171061003,JAKARTA PUSAT,MENTENG,CIKINI,8274,2512,5762,3992,9754,2021-09-20
3174081006,JAKARTA SELATAN,PANCORAN,CIKOKO,10547,3582,6965,4285,11250,2021-09-20
3174061001,JAKARTA SELATAN,CILANDAK,CILANDAK BARAT,51752,18510,33242,21646,54888,2021-09-20
3174041003,JAKARTA SELATAN,PASAR MINGGU,CILANDAK TIMUR,25145,8878,16267,11112,27379,2021-09-20
3175101002,JAKARTA TIMUR,CIPAYUNG,CILANGKAP,27635,9000,18635,14263,32898,2021-09-20
3175041006,JAKARTA TIMUR,KRAMAT JATI,CILILITAN,40181,14748,25433,18675,44108,2021-09-20
3172041001,JAKARTA UTARA,CILINCING,CILINCING,43609,15373,28236,20157,48393,2021-09-20
3175101001,JAKARTA TIMUR,CIPAYUNG,CIPAYUNG,26104,7801,18303,14592,32895,2021-09-20
3174091006,JAKARTA SELATAN,JAGAKARSA,CIPEDAK,38303,12774,25529,16282,41811,2021-09-20
3174061005,JAKARTA SELATAN,CILANDAK,CIPETE SELATAN,26704,9992,16712,11579,28291,2021-09-20
3174071010,JAKARTA SELATAN,KEBAYORAN BARU,CIPETE UTARA,34102,12439,21663,13827,35490,2021-09-20
3175021003,JAKARTA TIMUR,PULO GADUNG,CIPINANG,39306,13227,26079,19475,45554,2021-09-20
3175031007,JAKARTA TIMUR,JATINEGARA,CIPINANG BESAR SELATAN,35212,12992,22220,15605,37825,2021-09-20
3175031008,JAKARTA TIMUR,JATINEGARA,CIPINANG BESAR UTARA,45319,16795,28524,20348,48872,2021-09-20
3175031005,JAKARTA TIMUR,JATINEGARA,CIPINANG CEMPEDAK,32824,12463,20361,15706,36067,2021-09-20
3175081005,JAKARTA TIMUR,MAKASAR,CIPINANG MELAYU,42308,14984,27324,21366,48690,2021-09-20
3175031006,JAKARTA TIMUR,JATINEGARA,CIPINANG MUARA,55243,20151,35092,25986,61078,2021-09-20
3174051003,JAKARTA SELATAN,KEBAYORAN LAMA,CIPULIR,39937,15880,24057,13892,37949,2021-09-20
3175091001,JAKARTA TIMUR,CIRACAS,CIRACAS,64594,19580,45014,33965,78979,2021-09-20
3175041003,JAKARTA TIMUR,KRAMAT JATI,DUKUH,24609,7962,16647,12459,29106,2021-09-20
3175071001,JAKARTA TIMUR,DUREN SAWIT,DUREN SAWIT,61160,22200,38960,29394,68354,2021-09-20
3174081004,JAKARTA SELATAN,PANCORAN,DUREN TIGA,28319,10389,17930,10164,28094,2021-09-20
3173051005,JAKARTA BARAT,KEBON JERUK,DURI KEPA,60138,19410,40728,32213,72941,2021-09-20
3173011002,JAKARTA BARAT,CENGKARENG,DURI KOSAMBI,77923,28296,49627,36140,85767,2021-09-20
3171011006,JAKARTA PUSAT,GAMBIR,DURI PULO,19610,6578,13032,9711,22743,2021-09-20
3173041011,JAKARTA BARAT,TAMBORA,DURI SELATAN,14259,4323,9936,7709,17645,2021-09-20
3173041003,JAKARTA BARAT,TAMBORA,DURI UTARA,19844,6283,13561,10088,23649,2021-09-20
3171081003,JAKARTA PUSAT,JOHAR BARU,GALUR,18243,5402,12841,9685,22526,2021-09-20
3171011001,JAKARTA PUSAT,GAMBIR,GAMBIR,2191,709,1482,1184,2666,2021-09-20
3174061004,JAKARTA SELATAN,CILANDAK,GANDARIA SELATAN,22119,8203,13916,8628,22544,2021-09-20
3174071009,JAKARTA SELATAN,KEBAYORAN BARU,GANDARIA UTARA,39922,14905,25017,16141,41158,2021-09-20
3175051001,JAKARTA TIMUR,PASAR REBO,GEDONG,35755,11811,23944,18365,42309,2021-09-20
3171071001,JAKARTA PUSAT,TANAH ABANG,GELORA,3127,1129,1998,1432,3430,2021-09-20
3173031007,JAKARTA BARAT,TAMAN SARI,GLODOK,7837,2236,5601,4717,10318,2021-09-20
3171061004,JAKARTA PUSAT,MENTENG,GONDANGDIA,4100,1429,2671,2249,4920,2021-09-20
3173021001,JAKARTA BARAT,GROGOL PETAMBURAN,GROGOL,16876,5768,11108,8611,19719,2021-09-20
3174051005,JAKARTA SELATAN,KEBAYORAN LAMA,GROGOL SELATAN,44251,16820,27431,16600,44031,2021-09-20
3174051004,JAKARTA SELATAN,KEBAYORAN LAMA,GROGOL UTARA,42494,15841,26653,16676,43329,2021-09-20
3174021007,JAKARTA SELATAN,SETIA BUDI,GUNTUR,3985,1355,2630,1992,4622,2021-09-20
3174071002,JAKARTA SELATAN,KEBAYORAN BARU,GUNUNG,9436,3309,6127,4393,10520,2021-09-20
3171031005,JAKARTA PUSAT,KEMAYORAN,GUNUNG SAHARI SELATAN,19199,6453,12746,10009,22755,2021-09-20
3171021004,JAKARTA PUSAT,SAWAH BESAR,GUNUNG SAHARI UTARA,16650,4885,11765,9780,21545,2021-09-20
3175081004,JAKARTA TIMUR,MAKASAR,HALIM PERDANA KUSUMAH,28363,7461,20902,18061,38963,2021-09-20
3171031003,JAKARTA PUSAT,KEMAYORAN,HARAPAN MULIA,22557,7515,15042,11422,26464,2021-09-20
3174091001,JAKARTA SELATAN,JAGAKARSA,JAGAKARSA,62389,21645,40744,26697,67441,2021-09-20
3175021007,JAKARTA TIMUR,PULO GADUNG,JATI,32757,10941,21816,17109,38925,2021-09-20
3174041002,JAKARTA SELATAN,PASAR MINGGU,JATI PADANG,37502,13727,23775,15561,39336,2021-09-20
3173071004,JAKARTA BARAT,PALMERAH,JATI PULO,28738,9154,19584,14436,34020,2021-09-20
3175061001,JAKARTA TIMUR,CAKUNG,JATINEGARA,84160,28613,55547,42357,97904,2021-09-20
3175021004,JAKARTA TIMUR,PULO GADUNG,JATINEGARA KAUM,24632,7690,16942,11896,28838,2021-09-20
3173021004,JAKARTA BARAT,GROGOL PETAMBURAN,JELAMBAR,30266,10118,20148,16134,36282,2021-09-20
3173021006,JAKARTA BARAT,GROGOL PETAMBURAN,JELAMBAR BARU,38246,12624,25622,20509,46131,2021-09-20
3173041006,JAKARTA BARAT,TAMBORA,JEMBATAN BESI,29314,10926,18388,12673,31061,2021-09-20
3173041008,JAKARTA BARAT,TAMBORA,JEMBATAN LIMA,21021,7561,13460,9608,23068,2021-09-20
3173081005,JAKARTA BARAT,KEMBANGAN,JOGLO,40839,13857,26982,20305,47287,2021-09-20
3171081001,JAKARTA PUSAT,JOHAR BARU,JOHAR BARU,37488,11264,26224,20479,46703,2021-09-20
3173041002,JAKARTA BARAT,TAMBORA,KALI ANYAR,23856,7661,16195,11735,27930,2021-09-20
3172041004,JAKARTA UTARA,CILINCING,KALIBARU,67684,25904,41780,27329,69109,2021-09-20
3174081002,JAKARTA SELATAN,PANCORAN,KALIBATA,41994,17217,24777,13948,38725,2021-09-20
3173061001,JAKARTA BARAT,KALI DERES,KALIDERES,72447,24976,47471,37700,85171,2021-09-20
3175051004,JAKARTA TIMUR,PASAR REBO,KALISARI,43212,13765,29447,22933,52380,2021-09-20
3173061004,JAKARTA BARAT,KALI DERES,KAMAL,53783,19216,34567,25262,59829,2021-09-20
3172011002,JAKARTA UTARA,PENJARINGAN,KAMAL MUARA,12930,3315,9615,7779,17394,2021-09-20
3171071007,JAKARTA PUSAT,TANAH ABANG,KAMPUNG BALI,11358,4119,7239,5073,12312,2021-09-20
3175031001,JAKARTA TIMUR,JATINEGARA,KAMPUNG MELAYU,25717,9792,15925,11521,27446,2021-09-20
3171081002,JAKARTA PUSAT,JOHAR BARU,KAMPUNG RAWA,21237,5487,15750,11613,27363,2021-09-20
3175041002,JAKARTA TIMUR,KRAMAT JATI,KAMPUNG TENGAH,43993,16667,27326,19343,46669,2021-09-20
3173011005,JAKARTA BARAT,CENGKARENG,KAPUK,134466,48275,86191,62510,148701,2021-09-20
3172011003,JAKARTA UTARA,PENJARINGAN,KAPUK MUARA,35781,10523,25258,21098,46356,2021-09-20
3171021002,JAKARTA PUSAT,SAWAH BESAR,KARANG ANYAR,25761,8106,17655,13724,31379,2021-09-20
3174021004,JAKARTA SELATAN,SETIA BUDI,KARET,9623,3558,6065,4114,10179,2021-09-20
3174021003,JAKARTA SELATAN,SETIA BUDI,KARET KUNINGAN,16055,5284,10771,7334,18105,2021-09-20
3174021002,JAKARTA SELATAN,SETIA BUDI,KARET SEMANGGI,2770,933,1837,1425,3262,2021-09-20
3171071003,JAKARTA PUSAT,TANAH ABANG,KARET TENGSIN,19271,6284,12987,9294,22281,2021-09-20
3171021003,JAKARTA PUSAT,SAWAH BESAR,KARTINI,22292,7296,14996,12067,27063,2021-09-20
3175011003,JAKARTA TIMUR,MATRAMAN,KAYU MANIS,25284,9159,16125,11475,27600,2021-09-20
3175021006,JAKARTA TIMUR,PULO GADUNG,KAYU PUTIH,40696,13091,27605,22177,49782,2021-09-20
3173031006,JAKARTA BARAT,TAMAN SARI,KEAGUNGAN,17387,5587,11800,9041,20841,2021-09-20
3174041007,JAKARTA SELATAN,PASAR MINGGU,KEBAGUSAN,44552,16951,27601,16845,44446,2021-09-20
3174051006,JAKARTA SELATAN,KEBAYORAN LAMA,KEBAYORAN LAMA SELATAN,41212,14657,26555,16318,42873,2021-09-20
3174051001,JAKARTA SELATAN,KEBAYORAN LAMA,KEBAYORAN LAMA UTARA,42422,16458,25964,14868,40832,2021-09-20
3174011004,JAKARTA SELATAN,TEBET,KEBON BARU,35165,12709,22456,14118,36574,2021-09-20
3172021005,JAKARTA UTARA,TANJUNG PRIOK,KEBON BAWANG,50952,17152,33800,26068,59868,2021-09-20
3173051001,JAKARTA BARAT,KEBON JERUK,KEBON JERUK,53887,19262,34625,25750,60375,2021-09-20
3171071006,JAKARTA PUSAT,TANAH ABANG,KEBON KACANG,21531,8305,13226,9407,22633,2021-09-20
3171011005,JAKARTA PUSAT,GAMBIR,KEBON KELAPA,10163,3435,6728,5264,11992,2021-09-20
3171031002,JAKARTA PUSAT,KEMAYORAN,KEBON KOSONG,30019,10133,19886,15186,35072,2021-09-20
3175011005,JAKARTA TIMUR,MATRAMAN,KEBON MANGGIS,16490,5509,10981,8219,19200,2021-09-20
3171071005,JAKARTA PUSAT,TANAH ABANG,KEBON MELATI,32206,12873,19333,12949,32282,2021-09-20
3175081003,JAKARTA TIMUR,MAKASAR,KEBON PALA,46614,15840,30774,22596,53370,2021-09-20
3171061005,JAKARTA PUSAT,MENTENG,KEBON SIRIH,12299,4287,8012,5842,13854,2021-09-20
3173011004,JAKARTA BARAT,CENGKARENG,KEDAUNG KALI ANGKE,32612,9965,22647,17552,40199,2021-09-20
3173051007,JAKARTA BARAT,KEBON JERUK,KEDOYA SELATAN,32165,10426,21739,16429,38168,2021-09-20
3173051006,JAKARTA BARAT,KEBON JERUK,KEDOYA UTARA,45740,14135,31605,25314,56919,2021-09-20
3173051004,JAKARTA BARAT,KEBON JERUK,KELAPA DUA,23565,8403,15162,11559,26721,2021-09-20
3175091003,JAKARTA TIMUR,CIRACAS,KELAPA DUA WETAN,46875,14084,32791,25074,57865,2021-09-20
3172061003,JAKARTA UTARA,KELAPA GADING,KELAPA GADING BARAT,35717,10593,25124,21337,46461,2021-09-20
3172061001,JAKARTA UTARA,KELAPA GADING,KELAPA GADING TIMUR,33592,9066,24526,20989,45515,2021-09-20
3173071005,JAKARTA BARAT,PALMERAH,KEMANGGISAN,32139,10666,21473,16078,37551,2021-09-20
3171031001,JAKARTA PUSAT,KEMAYORAN,KEMAYORAN,20708,6687,14021,10854,24875,2021-09-20
3173081006,JAKARTA BARAT,KEMBANGAN,KEMBANGAN SELATAN,27130,9161,17969,14464,32433,2021-09-20
3173081001,JAKARTA BARAT,KEMBANGAN,KEMBANGAN UTARA,54451,18171,36280,28186,64466,2021-09-20
3171041002,JAKARTA PUSAT,SENEN,KENARI,9579,3101,6478,5167,11645,2021-09-20
3173041005,JAKARTA BARAT,TAMBORA,KERENDANG,19973,6529,13444,9882,23326,2021-09-20
3175071003,JAKARTA TIMUR,DUREN SAWIT,KLENDER,69978,25535,44443,32081,76524,2021-09-20
3172031001,JAKARTA UTARA,KOJA,KOJA,28175,9990,18185,13990,32175,2021-09-20
3173071006,JAKARTA BARAT,PALMERAH,KOTA BAMBU SELATAN,21158,7143,14015,10024,24039,2021-09-20
3173071003,JAKARTA BARAT,PALMERAH,KOTA BAMBU UTARA,24995,8697,16298,11654,27952,2021-09-20
3171041004,JAKARTA PUSAT,SENEN,KRAMAT,28835,10197,18638,12696,31334,2021-09-20
3175041001,JAKARTA TIMUR,KRAMAT JATI,KRAMAT JATI,34144,11830,22314,16280,38594,2021-09-20
3174071003,JAKARTA SELATAN,KEBAYORAN BARU,KRAMAT PELA,14413,4973,9440,6162,15602,2021-09-20
3173031002,JAKARTA BARAT,TAMAN SARI,KRUKUT,19244,6285,12959,9711,22670,2021-09-20
3174031005,JAKARTA SELATAN,MAMPANG PRAPATAN,KUNINGAN BARAT,12785,4434,8351,5320,13671,2021-09-20
3174021008,JAKARTA SELATAN,SETIA BUDI,KUNINGAN TIMUR,6008,2112,3896,2685,6581,2021-09-20
3171041005,JAKARTA PUSAT,SENEN,KWITANG,15486,5335,10151,7705,17856,2021-09-20
3172031003,JAKARTA UTARA,KOJA,LAGOA,59065,21199,37866,27306,65172,2021-09-20
3174061002,JAKARTA SELATAN,CILANDAK,LEBAK BULUS,37626,14221,23405,15345,38750,2021-09-20
3174091004,JAKARTA SELATAN,JAGAKARSA,LENTENG AGUNG,53946,20308,33638,19841,53479,2021-09-20
3175101007,JAKARTA TIMUR,CIPAYUNG,LUBANG BUAYA,63547,19882,43665,33444,77109,2021-09-20
3175081001,JAKARTA TIMUR,MAKASAR,MAKASAR,34390,11188,23202,17879,41081,2021-09-20
3175071006,JAKARTA TIMUR,DUREN SAWIT,MALAKA JAYA,30927,10437,20490,16095,36585,2021-09-20
3175071005,JAKARTA TIMUR,DUREN SAWIT,MALAKA SARI,27530,8926,18604,14854,33458,2021-09-20
3174031001,JAKARTA SELATAN,MAMPANG PRAPATAN,MAMPANG PRAPATAN,18159,6627,11532,7568,19100,2021-09-20
3173031005,JAKARTA BARAT,TAMAN SARI,MANGGA BESAR,7707,2211,5496,4439,9935,2021-09-20
3171021005,JAKARTA PUSAT,SAWAH BESAR,MANGGA DUA SELATAN,27442,8885,18557,14453,33010,2021-09-20
3174011007,JAKARTA SELATAN,TEBET,MANGGARAI,28373,9352,19021,11585,30606,2021-09-20
3174011006,JAKARTA SELATAN,TEBET,MANGGARAI SELATAN,23075,7891,15184,9829,25013,2021-09-20
3173031003,JAKARTA BARAT,TAMAN SARI,MAPHAR,16461,5469,10992,8578,19570,2021-09-20
3172041003,JAKARTA UTARA,CILINCING,MARUNDA,28943,9216,19727,13477,33204,2021-09-20
3174071001,JAKARTA SELATAN,KEBAYORAN BARU,MELAWAI,2627,884,1743,1399,3142,2021-09-20
3171061001,JAKARTA PUSAT,MENTENG,MENTENG,25624,8996,16628,12070,28698,2021-09-20
3174021005,JAKARTA SELATAN,SETIA BUDI,MENTENG ATAS,27816,9373,18443,11716,30159,2021-09-20
3174011003,JAKARTA SELATAN,TEBET,MENTENG DALAM,36028,12987,23041,14965,38006,2021-09-20
3173081003,JAKARTA BARAT,KEMBANGAN,MERUYA SELATAN,32130,10934,21196,16347,37543,2021-09-20
3173081002,JAKARTA BARAT,KEMBANGAN,MERUYA UTARA,43752,15042,28710,23089,51799,2021-09-20
3175101004,JAKARTA TIMUR,CIPAYUNG,MUNJUL,23871,7552,16319,12693,29012,2021-09-20
3172051002,JAKARTA UTARA,PADEMANGAN,PADEMANGAN BARAT,74240,26256,47984,35976,83960,2021-09-20
3172051001,JAKARTA UTARA,PADEMANGAN,PADEMANGAN TIMUR,37736,11090,26646,21626,48272,2021-09-20
3175011004,JAKARTA TIMUR,MATRAMAN,PAL MERIAM,19769,7183,12586,9363,21949,2021-09-20
3173071001,JAKARTA BARAT,PALMERAH,PALMERAH,63011,21896,41115,29959,71074,2021-09-20
3174081001,JAKARTA SELATAN,PANCORAN,PANCORAN,19421,7151,12270,7649,19919,2021-09-20
3172021003,JAKARTA UTARA,TANJUNG PRIOK,PAPANGGO,39097,12297,26800,20632,47432,2021-09-20
3171021001,JAKARTA PUSAT,SAWAH BESAR,PASAR BARU,12035,3582,8453,7115,15568,2021-09-20
3174021006,JAKARTA SELATAN,SETIA BUDI,PASAR MANGGIS,26752,9631,17121,10929,28050,2021-09-20
3174041001,JAKARTA SELATAN,PASAR MINGGU,PASAR MINGGU,24821,8962,15859,10552,26411,2021-09-20
3171041003,JAKARTA PUSAT,SENEN,PASEBAN,23533,8210,15323,11279,26602,2021-09-20
3173061005,JAKARTA BARAT,KALI DERES,PEGADUNGAN,75587,24174,51413,41480,92893,2021-09-20
3171061002,JAKARTA PUSAT,MENTENG,PEGANGSAAN,23455,8149,15306,10731,26037,2021-09-20
3172061002,JAKARTA UTARA,KELAPA GADING,PEGANGSAAN DUA,49976,13488,36488,30978,67466,2021-09-20
3172011004,JAKARTA UTARA,PENJARINGAN,PEJAGALAN,74578,24699,49879,39963,89842,2021-09-20
3174041006,JAKARTA SELATAN,PASAR MINGGU,PEJATEN BARAT,37346,13938,23408,15138,38546,2021-09-20
3174041005,JAKARTA SELATAN,PASAR MINGGU,PEJATEN TIMUR,57656,22334,35322,20724,56046,2021-09-20
3175051005,JAKARTA TIMUR,PASAR REBO,PEKAYON,43250,13668,29582,22540,52122,2021-09-20
3173041009,JAKARTA BARAT,TAMBORA,PEKOJAN,23587,7385,16202,12594,28796,2021-09-20
3174031003,JAKARTA SELATAN,MAMPANG PRAPATAN,PELA MAMPANG,43522,15652,27870,18710,46580,2021-09-20
3174081005,JAKARTA SELATAN,PANCORAN,PENGADEGAN,21478,7107,14371,8222,22593,2021-09-20
3175061003,JAKARTA TIMUR,CAKUNG,PENGGILINGAN,99255,36163,63092,45345,108437,2021-09-20
3172011001,JAKARTA UTARA,PENJARINGAN,PENJARINGAN,88308,32452,55856,40545,96401,2021-09-20
3174101001,JAKARTA SELATAN,PESANGGRAHAN,PESANGGRAHAN,27545,9394,18151,11646,29797,2021-09-20
3171071004,JAKARTA PUSAT,TANAH ABANG,PETAMBURAN,33271,13210,20061,13553,33614,2021-09-20
3174071008,JAKARTA SELATAN,KEBAYORAN BARU,PETOGOGAN,11499,4253,7246,4880,12126,2021-09-20
3171011004,JAKARTA PUSAT,GAMBIR,PETOJO SELATAN,14692,5224,9468,7415,16883,2021-09-20
3171011003,JAKARTA PUSAT,GAMBIR,PETOJO UTARA,17458,6072,11386,8616,20002,2021-09-20
3174101004,JAKARTA SELATAN,PESANGGRAHAN,PETUKANGAN SELATAN,37187,13602,23585,14624,38209,2021-09-20
3174101003,JAKARTA SELATAN,PESANGGRAHAN,PETUKANGAN UTARA,53716,20796,32920,20877,53797,2021-09-20
3175081002,JAKARTA TIMUR,MAKASAR,PINANG RANTI,27198,9383,17815,13518,31333,2021-09-20
3173031008,JAKARTA BARAT,TAMAN SARI,PINANGSIA,10729,3193,7536,5873,13409,2021-09-20
3175011001,JAKARTA TIMUR,MATRAMAN,PISANGAN BARU,31776,11400,20376,14211,34587,2021-09-20
3175021002,JAKARTA TIMUR,PULO GADUNG,PISANGAN TIMUR,41011,13318,27693,21495,49188,2021-09-20
3172011005,JAKARTA UTARA,PENJARINGAN,PLUIT,47783,14967,32816,27063,59879,2021-09-20
3175071002,JAKARTA TIMUR,DUREN SAWIT,PONDOK BAMBU,61550,22168,39382,29778,69160,2021-09-20
3175071004,JAKARTA TIMUR,DUREN SAWIT,PONDOK KELAPA,72015,24917,47098,36010,83108,2021-09-20
3175071007,JAKARTA TIMUR,DUREN SAWIT,PONDOK KOPI,35367,12722,22645,16503,39148,2021-09-20
3174061003,JAKARTA SELATAN,CILANDAK,PONDOK LABU,46464,16024,30440,20939,51379,2021-09-20
3174051002,JAKARTA SELATAN,KEBAYORAN LAMA,PONDOK PINANG,56169,20784,35385,22979,58364,2021-09-20
3175101003,JAKARTA TIMUR,CIPAYUNG,PONDOK RANGGON,25574,8378,17196,13396,30592,2021-09-20
3101011003,KAB.ADM.KEP.SERIBU,KEP. SERIBU UTARA,PULAU HARAPAN,2060,327,1733,1088,2821,2021-09-20
3101011002,KAB.ADM.KEP.SERIBU,KEP. SERIBU UTARA,PULAU KELAPA,5528,871,4657,2962,7619,2021-09-20
3101011001,KAB.ADM.KEP.SERIBU,KEP. SERIBU UTARA,PULAU PANGGANG,5450,806,4644,2537,7181,2021-09-20
3101021003,KAB.ADM.KEP.SERIBU,KEP. SERIBU SELATAN,PULAU PARI,2765,301,2464,2050,4514,2021-09-20
3101021002,KAB.ADM.KEP.SERIBU,KEP. SERIBU SELATAN,PULAU TIDUNG,4553,591,3962,2942,6904,2021-09-20
3101021001,KAB.ADM.KEP.SERIBU,KEP. SERIBU SELATAN,PULAU UNTUNG JAWA,1941,283,1658,1391,3049,2021-09-20
3174071007,JAKARTA SELATAN,KEBAYORAN BARU,PULO,5835,1948,3887,2934,6821,2021-09-20
3175021001,JAKARTA TIMUR,PULO GADUNG,PULO GADUNG,34422,11707,22715,17011,39726,2021-09-20
3175061005,JAKARTA TIMUR,CAKUNG,PULO GEBANG,97301,32523,64778,47079,111857,2021-09-20
3174041004,JAKARTA SELATAN,PASAR MINGGU,RAGUNAN,39616,13844,25772,16850,42622,2021-09-20
3175091005,JAKARTA TIMUR,CIRACAS,RAMBUTAN,36771,13503,23268,17026,40294,2021-09-20
3172031006,JAKARTA UTARA,KOJA,RAWA BADAK SELATAN,42179,15099,27080,19683,46763,2021-09-20
3172031004,JAKARTA UTARA,KOJA,RAWA BADAK UTARA,34408,12170,22238,16700,38938,2021-09-20
3174071005,JAKARTA SELATAN,KEBAYORAN BARU,RAWA BARAT,5625,1856,3769,2675,6444,2021-09-20
3173011003,JAKARTA BARAT,CENGKARENG,RAWA BUAYA,63799,21203,42596,30536,73132,2021-09-20
3175031004,JAKARTA TIMUR,JATINEGARA,RAWA BUNGA,21434,8021,13413,10022,23435,2021-09-20
3174081003,JAKARTA SELATAN,PANCORAN,RAWA JATI,20509,7294,13215,8207,21422,2021-09-20
3175061002,JAKARTA TIMUR,CAKUNG,RAWA TERATE,24637,7355,17282,13212,30494,2021-09-20
3175021005,JAKARTA TIMUR,PULO GADUNG,RAWAMANGUN,37612,12781,24831,19150,43981,2021-09-20
3171051003,JAKARTA PUSAT,CEMPAKA PUTIH,RAWASARI,21967,7638,14329,11166,25495,2021-09-20
3173041010,JAKARTA BARAT,TAMBORA,ROA MALAKA,3484,1007,2477,2003,4480,2021-09-20
3172041006,JAKARTA UTARA,CILINCING,ROROTAN,41668,12949,28719,21495,50214,2021-09-20
3174071004,JAKARTA SELATAN,KEBAYORAN BARU,SELONG,2842,965,1877,1439,3316,2021-09-20
3173061002,JAKARTA BARAT,KALI DERES,SEMANAN,71354,25035,46319,34709,81028,2021-09-20
3172041007,JAKARTA UTARA,CILINCING,SEMPER BARAT,68587,21279,47308,37319,84627,2021-09-20
3172041005,JAKARTA UTARA,CILINCING,SEMPER TIMUR,36267,11793,24474,18530,43004,2021-09-20
3174071006,JAKARTA SELATAN,KEBAYORAN BARU,SENAYAN,2771,1109,1662,1146,2808,2021-09-20
3171041001,JAKARTA PUSAT,SENEN,SENEN,6804,2175,4629,3649,8278,2021-09-20
3171031004,JAKARTA PUSAT,KEMAYORAN,SERDANG,29668,9800,19868,15121,34989,2021-09-20
3174021001,JAKARTA SELATAN,SETIA BUDI,SETIA BUDI,3023,1097,1926,1352,3278,2021-09-20
3175101005,JAKARTA TIMUR,CIPAYUNG,SETU,20572,7241,13331,9966,23297,2021-09-20
3173071002,JAKARTA BARAT,PALMERAH,SLIPI,16591,5360,11231,8635,19866,2021-09-20
3173081004,JAKARTA BARAT,KEMBANGAN,SRENGSENG,45523,16323,29200,22243,51443,2021-09-20
3174091002,JAKARTA SELATAN,JAGAKARSA,SRENGSENG SAWAH,58196,18710,39486,25207,64693,2021-09-20
3173051003,JAKARTA BARAT,KEBON JERUK,SUKABUMI SELATAN,37033,13430,23603,16012,39615,2021-09-20
3173051002,JAKARTA BARAT,KEBON JERUK,SUKABUMI UTARA,38290,14256,24034,15847,39881,2021-09-20
3172041002,JAKARTA UTARA,CILINCING,SUKAPURA,53949,18666,35283,27386,62669,2021-09-20
3171031007,JAKARTA PUSAT,KEMAYORAN,SUMUR BATU,22717,7739,14978,11697,26675,2021-09-20
3172021004,JAKARTA UTARA,TANJUNG PRIOK,SUNGAI BAMBU,29876,9818,20058,15591,35649,2021-09-20
3172021006,JAKARTA UTARA,TANJUNG PRIOK,SUNTER AGUNG,71805,20715,51090,41938,93028,2021-09-20
3172021002,JAKARTA UTARA,TANJUNG PRIOK,SUNTER JAYA,63031,18734,44297,36105,80402,2021-09-20
3175091004,JAKARTA TIMUR,CIRACAS,SUSUKAN,38257,11845,26412,20385,46797,2021-09-20
3173031001,JAKARTA BARAT,TAMAN SARI,TAMAN SARI,14348,4530,9818,7862,17680,2021-09-20
3173041001,JAKARTA BARAT,TAMBORA,TAMBORA,10204,3483,6721,4949,11670,2021-09-20
3173041004,JAKARTA BARAT,TAMBORA,TANAH SEREAL,26387,7559,18828,14114,32942,2021-09-20
3171081004,JAKARTA PUSAT,JOHAR BARU,TANAH TINGGI,37693,10947,26746,19931,46677,2021-09-20
3173031004,JAKARTA BARAT,TAMAN SARI,TANGKI,13324,4209,9115,7219,16334,2021-09-20
3174091005,JAKARTA SELATAN,JAGAKARSA,TANJUNG BARAT,39770,13872,25898,15565,41463,2021-09-20
3173021005,JAKARTA BARAT,GROGOL PETAMBURAN,TANJUNG DUREN SELATAN,25337,8501,16836,13440,30276,2021-09-20
3173021002,JAKARTA BARAT,GROGOL PETAMBURAN,TANJUNG DUREN UTARA,17010,5397,11613,9327,20940,2021-09-20
3172021001,JAKARTA UTARA,TANJUNG PRIOK,TANJUNG PRIOK,34588,11002,23586,17939,41525,2021-09-20
3174011002,JAKARTA SELATAN,TEBET,TEBET BARAT,21194,6944,14250,9786,24036,2021-09-20
3174011001,JAKARTA SELATAN,TEBET,TEBET TIMUR,18199,5955,12244,8426,20670,2021-09-20
3173061003,JAKARTA BARAT,KALI DERES,TEGAL ALUR,83647,28219,55428,41278,96706,2021-09-20
3174031004,JAKARTA SELATAN,MAMPANG PRAPATAN,TEGAL PARANG,32401,12586,19815,11876,31691,2021-09-20
3173021003,JAKARTA BARAT,GROGOL PETAMBURAN,TOMANG,29605,9800,19805,15941,35746,2021-09-20
3172031005,JAKARTA UTARA,KOJA,TUGU SELATAN,39122,13163,25959,18917,44876,2021-09-20
3172031002,JAKARTA UTARA,KOJA,TUGU UTARA,67670,24383,43287,31512,74799,2021-09-20
3175061006,JAKARTA TIMUR,CAKUNG,UJUNG MENTENG,29934,9186,20748,16317,37065,2021-09-20
3174101005,JAKARTA SELATAN,PESANGGRAHAN,ULUJAMI,40544,16088,24456,14520,38976,2021-09-20
3175011006,JAKARTA TIMUR,MATRAMAN,UTAN KAYU SELATAN,33511,10884,22627,17054,39681,2021-09-20
3175011002,JAKARTA TIMUR,MATRAMAN,UTAN KAYU UTARA,28169,10107,18062,13375,31437,2021-09-20
3171031008,JAKARTA PUSAT,KEMAYORAN,UTAN PANJANG,29208,9890,19318,14342,33660,2021-09-20
3172021007,JAKARTA UTARA,TANJUNG PRIOK,WARAKAS,44401,13773,30628,23270,53898,2021-09-20
3173021007,JAKARTA BARAT,GROGOL PETAMBURAN,WIJAYA KUSUMA,38934,13659,25275,19756,45031,2021-09-20
3172051003,JAKARTA UTARA,PADEMANGAN,ANCOL,23947,8606,15341,11891,27232,2021-09-21
3173041007,JAKARTA BARAT,TAMBORA,ANGKE,29381,9698,19683,14544,34227,2021-09-21
3175041005,JAKARTA TIMUR,KRAMAT JATI,BALE KAMBANG,29074,11172,17902,12027,29929,2021-09-21
3175031003,JAKARTA TIMUR,JATINEGARA,BALI MESTER,9752,3472,6280,4799,11079,2021-09-21
3175101006,JAKARTA TIMUR,CIPAYUNG,BAMBU APUS,26285,8615,17670,13516,31186,2021-09-21
3174031002,JAKARTA SELATAN,MAMPANG PRAPATAN,BANGKA,21566,8237,13329,8533,21862,2021-09-21
3175051002,JAKARTA TIMUR,PASAR REBO,BARU,23886,7156,16730,13455,30185,2021-09-21
3175041004,JAKARTA TIMUR,KRAMAT JATI,BATU AMPAR,47898,18405,29493,20891,50384,2021-09-21
3171071002,JAKARTA PUSAT,TANAH ABANG,BENDUNGAN HILIR,21494,7541,13953,10531,24484,2021-09-21
3175031002,JAKARTA TIMUR,JATINEGARA,BIDARA CINA,36689,14247,22442,16249,38691,2021-09-21
3174101002,JAKARTA SELATAN,PESANGGRAHAN,BINTARO,53098,19887,33211,21678,54889,2021-09-21
3174011005,JAKARTA SELATAN,TEBET,BUKIT DURI,34183,13044,21139,12881,34020,2021-09-21
3171041006,JAKARTA PUSAT,SENEN,BUNGUR,18144,6056,12088,9256,21344,2021-09-21
3175061007,JAKARTA TIMUR,CAKUNG,CAKUNG BARAT,57724,18100,39624,30423,70047,2021-09-21
3175061004,JAKARTA TIMUR,CAKUNG,CAKUNG TIMUR,58287,18244,40043,30865,70908,2021-09-21
3175041007,JAKARTA TIMUR,KRAMAT JATI,CAWANG,32762,11896,20866,14892,35758,2021-09-21
3175101008,JAKARTA TIMUR,CIPAYUNG,CEGER,18932,6137,12795,9769,22564,2021-09-21
3171031006,JAKARTA PUSAT,KEMAYORAN,CEMPAKA BARU,32581,11109,21472,15551,37023,2021-09-21
3171051002,JAKARTA PUSAT,CEMPAKA PUTIH,CEMPAKA PUTIH BARAT,35885,12231,23654,18499,42153,2021-09-21
3171051001,JAKARTA PUSAT,CEMPAKA PUTIH,CEMPAKA PUTIH TIMUR,24292,8048,16244,12794,29038,2021-09-21
3173011001,JAKARTA BARAT,CENGKARENG,CENGKARENG BARAT,66284,21761,44523,34605,79128,2021-09-21
3173011006,JAKARTA BARAT,CENGKARENG,CENGKARENG TIMUR,81027,26053,54974,40840,95814,2021-09-21
3175091002,JAKARTA TIMUR,CIRACAS,CIBUBUR,66364,20193,46171,35748,81919,2021-09-21
3171011002,JAKARTA PUSAT,GAMBIR,CIDENG,15390,4935,10455,8310,18765,2021-09-21
3174091003,JAKARTA SELATAN,JAGAKARSA,CIGANJUR,38497,13797,24700,15164,39864,2021-09-21
3175051003,JAKARTA TIMUR,PASAR REBO,CIJANTUNG,41419,12902,28517,21932,50449,2021-09-21
3171061003,JAKARTA PUSAT,MENTENG,CIKINI,8274,2506,5768,3993,9761,2021-09-21
3174081006,JAKARTA SELATAN,PANCORAN,CIKOKO,10547,3579,6968,4286,11254,2021-09-21
3174061001,JAKARTA SELATAN,CILANDAK,CILANDAK BARAT,51752,18501,33251,21649,54900,2021-09-21
3174041003,JAKARTA SELATAN,PASAR MINGGU,CILANDAK TIMUR,25145,8876,16269,11115,27384,2021-09-21
3175101002,JAKARTA TIMUR,CIPAYUNG,CILANGKAP,27635,8983,18652,14275,32927,2021-09-21
3175041006,JAKARTA TIMUR,KRAMAT JATI,CILILITAN,40181,14683,25498,18698,44196,2021-09-21
3172041001,JAKARTA UTARA,CILINCING,CILINCING,43609,15328,28281,20175,48456,2021-09-21
3175101001,JAKARTA TIMUR,CIPAYUNG,CIPAYUNG,26104,7788,18316,14603,32919,2021-09-21
3174091006,JAKARTA SELATAN,JAGAKARSA,CIPEDAK,38303,12772,25531,16283,41814,2021-09-21
3174061005,JAKARTA SELATAN,CILANDAK,CIPETE SELATAN,26704,9991,16713,11581,28294,2021-09-21
3174071010,JAKARTA SELATAN,KEBAYORAN BARU,CIPETE UTARA,34102,12435,21667,13833,35500,2021-09-21
3175021003,JAKARTA TIMUR,PULO GADUNG,CIPINANG,39306,13181,26125,19483,45608,2021-09-21
3175031007,JAKARTA TIMUR,JATINEGARA,CIPINANG BESAR SELATAN,35212,12952,22260,15620,37880,2021-09-21
3175031008,JAKARTA TIMUR,JATINEGARA,CIPINANG BESAR UTARA,45319,16681,28638,20356,48994,2021-09-21
3175031005,JAKARTA TIMUR,JATINEGARA,CIPINANG CEMPEDAK,32824,12441,20383,15721,36104,2021-09-21
3175081005,JAKARTA TIMUR,MAKASAR,CIPINANG MELAYU,42308,14958,27350,21381,48731,2021-09-21
3175031006,JAKARTA TIMUR,JATINEGARA,CIPINANG MUARA,55243,20110,35133,26002,61135,2021-09-21
3174051003,JAKARTA SELATAN,KEBAYORAN LAMA,CIPULIR,39937,15874,24063,13892,37955,2021-09-21
3175091001,JAKARTA TIMUR,CIRACAS,CIRACAS,64594,19511,45083,33990,79073,2021-09-21
3175041003,JAKARTA TIMUR,KRAMAT JATI,DUKUH,24609,7817,16792,12475,29267,2021-09-21
3175071001,JAKARTA TIMUR,DUREN SAWIT,DUREN SAWIT,61160,22128,39032,29404,68436,2021-09-21
3174081004,JAKARTA SELATAN,PANCORAN,DUREN TIGA,28319,10385,17934,10167,28101,2021-09-21
3173051005,JAKARTA BARAT,KEBON JERUK,DURI KEPA,60138,19372,40766,32248,73014,2021-09-21
3173011002,JAKARTA BARAT,CENGKARENG,DURI KOSAMBI,77923,28126,49797,36185,85982,2021-09-21
3171011006,JAKARTA PUSAT,GAMBIR,DURI PULO,19610,6569,13041,9715,22756,2021-09-21
3173041011,JAKARTA BARAT,TAMBORA,DURI SELATAN,14259,4319,9940,7711,17651,2021-09-21
3173041003,JAKARTA BARAT,TAMBORA,DURI UTARA,19844,6268,13576,10101,23677,2021-09-21
3171081003,JAKARTA PUSAT,JOHAR BARU,GALUR,18243,5399,12844,9691,22535,2021-09-21
3171011001,JAKARTA PUSAT,GAMBIR,GAMBIR,2191,707,1484,1184,2668,2021-09-21
3174061004,JAKARTA SELATAN,CILANDAK,GANDARIA SELATAN,22119,8202,13917,8632,22549,2021-09-21
3174071009,JAKARTA SELATAN,KEBAYORAN BARU,GANDARIA UTARA,39922,14895,25027,16146,41173,2021-09-21
3175051001,JAKARTA TIMUR,PASAR REBO,GEDONG,35755,11780,23975,18378,42353,2021-09-21
3171071001,JAKARTA PUSAT,TANAH ABANG,GELORA,3127,1129,1998,1437,3435,2021-09-21
3173031007,JAKARTA BARAT,TAMAN SARI,GLODOK,7837,2226,5611,4718,10329,2021-09-21
3171061004,JAKARTA PUSAT,MENTENG,GONDANGDIA,4100,1427,2673,2249,4922,2021-09-21
3173021001,JAKARTA BARAT,GROGOL PETAMBURAN,GROGOL,16876,5751,11125,8616,19741,2021-09-21
3174051005,JAKARTA SELATAN,KEBAYORAN LAMA,GROGOL SELATAN,44251,16816,27435,16602,44037,2021-09-21
3174051004,JAKARTA SELATAN,KEBAYORAN LAMA,GROGOL UTARA,42494,15835,26659,16688,43347,2021-09-21
3174021007,JAKARTA SELATAN,SETIA BUDI,GUNTUR,3985,1354,2631,1993,4624,2021-09-21
3174071002,JAKARTA SELATAN,KEBAYORAN BARU,GUNUNG,9436,3307,6129,4393,10522,2021-09-21
3171031005,JAKARTA PUSAT,KEMAYORAN,GUNUNG SAHARI SELATAN,19199,6444,12755,10014,22769,2021-09-21
3171021004,JAKARTA PUSAT,SAWAH BESAR,GUNUNG SAHARI UTARA,16650,4881,11769,9787,21556,2021-09-21
3175081004,JAKARTA TIMUR,MAKASAR,HALIM PERDANA KUSUMAH,28363,7444,20919,18073,38992,2021-09-21
3171031003,JAKARTA PUSAT,KEMAYORAN,HARAPAN MULIA,22557,7504,15053,11425,26478,2021-09-21
3174091001,JAKARTA SELATAN,JAGAKARSA,JAGAKARSA,62389,21638,40751,26699,67450,2021-09-21
3175021007,JAKARTA TIMUR,PULO GADUNG,JATI,32757,10914,21843,17123,38966,2021-09-21
3174041002,JAKARTA SELATAN,PASAR MINGGU,JATI PADANG,37502,13720,23782,15561,39343,2021-09-21
3173071004,JAKARTA BARAT,PALMERAH,JATI PULO,28738,9141,19597,14451,34048,2021-09-21
3175061001,JAKARTA TIMUR,CAKUNG,JATINEGARA,84160,28526,55634,42382,98016,2021-09-21
3175021004,JAKARTA TIMUR,PULO GADUNG,JATINEGARA KAUM,24632,7650,16982,11909,28891,2021-09-21
3173021004,JAKARTA BARAT,GROGOL PETAMBURAN,JELAMBAR,30266,10076,20190,16143,36333,2021-09-21
3173021006,JAKARTA BARAT,GROGOL PETAMBURAN,JELAMBAR BARU,38246,12564,25682,20517,46199,2021-09-21
3173041006,JAKARTA BARAT,TAMBORA,JEMBATAN BESI,29314,10895,18419,12678,31097,2021-09-21
3173041008,JAKARTA BARAT,TAMBORA,JEMBATAN LIMA,21021,7548,13473,9612,23085,2021-09-21
3173081005,JAKARTA BARAT,KEMBANGAN,JOGLO,40839,13843,26996,20315,47311,2021-09-21
3171081001,JAKARTA PUSAT,JOHAR BARU,JOHAR BARU,37488,11244,26244,20494,46738,2021-09-21
3173041002,JAKARTA BARAT,TAMBORA,KALI ANYAR,23856,7640,16216,11745,27961,2021-09-21
3172041004,JAKARTA UTARA,CILINCING,KALIBARU,67684,25778,41906,27354,69260,2021-09-21
3174081002,JAKARTA SELATAN,PANCORAN,KALIBATA,41994,17213,24781,13948,38729,2021-09-21
3173061001,JAKARTA BARAT,KALI DERES,KALIDERES,72447,24859,47588,37720,85308,2021-09-21
3175051004,JAKARTA TIMUR,PASAR REBO,KALISARI,43212,13740,29472,22955,52427,2021-09-21
3173061004,JAKARTA BARAT,KALI DERES,KAMAL,53783,19121,34662,25292,59954,2021-09-21
3172011002,JAKARTA UTARA,PENJARINGAN,KAMAL MUARA,12930,3296,9634,7788,17422,2021-09-21
3171071007,JAKARTA PUSAT,TANAH ABANG,KAMPUNG BALI,11358,4107,7251,5076,12327,2021-09-21
3175031001,JAKARTA TIMUR,JATINEGARA,KAMPUNG MELAYU,25717,9773,15944,11527,27471,2021-09-21
3171081002,JAKARTA PUSAT,JOHAR BARU,KAMPUNG RAWA,21237,5476,15761,11622,27383,2021-09-21
3175041002,JAKARTA TIMUR,KRAMAT JATI,KAMPUNG TENGAH,43993,16545,27448,19364,46812,2021-09-21
3173011005,JAKARTA BARAT,CENGKARENG,KAPUK,134466,48084,86382,62571,148953,2021-09-21
3172011003,JAKARTA UTARA,PENJARINGAN,KAPUK MUARA,35781,10497,25284,21115,46399,2021-09-21
3171021002,JAKARTA PUSAT,SAWAH BESAR,KARANG ANYAR,25761,8056,17705,13729,31434,2021-09-21
3174021004,JAKARTA SELATAN,SETIA BUDI,KARET,9623,3554,6069,4116,10185,2021-09-21
3174021003,JAKARTA SELATAN,SETIA BUDI,KARET KUNINGAN,16055,5278,10777,7336,18113,2021-09-21
3174021002,JAKARTA SELATAN,SETIA BUDI,KARET SEMANGGI,2770,932,1838,1425,3263,2021-09-21
3171071003,JAKARTA PUSAT,TANAH ABANG,KARET TENGSIN,19271,6262,13009,9319,22328,2021-09-21
3171021003,JAKARTA PUSAT,SAWAH BESAR,KARTINI,22292,7284,15008,12074,27082,2021-09-21
3175011003,JAKARTA TIMUR,MATRAMAN,KAYU MANIS,25284,9103,16181,11480,27661,2021-09-21
3175021006,JAKARTA TIMUR,PULO GADUNG,KAYU PUTIH,40696,13060,27636,22188,49824,2021-09-21
3173031006,JAKARTA BARAT,TAMAN SARI,KEAGUNGAN,17387,5567,11820,9046,20866,2021-09-21
3174041007,JAKARTA SELATAN,PASAR MINGGU,KEBAGUSAN,44552,16943,27609,16846,44455,2021-09-21
3174051006,JAKARTA SELATAN,KEBAYORAN LAMA,KEBAYORAN LAMA SELATAN,41212,14653,26559,16321,42880,2021-09-21
3174051001,JAKARTA SELATAN,KEBAYORAN LAMA,KEBAYORAN LAMA UTARA,42422,16454,25968,14872,40840,2021-09-21
3174011004,JAKARTA SELATAN,TEBET,KEBON BARU,35165,12692,22473,14119,36592,2021-09-21
3172021005,JAKARTA UTARA,TANJUNG PRIOK,KEBON BAWANG,50952,17093,33859,26085,59944,2021-09-21
3173051001,JAKARTA BARAT,KEBON JERUK,KEBON JERUK,53887,19169,34718,25770,60488,2021-09-21
3171071006,JAKARTA PUSAT,TANAH ABANG,KEBON KACANG,21531,8297,13234,9414,22648,2021-09-21
3171011005,JAKARTA PUSAT,GAMBIR,KEBON KELAPA,10163,3424,6739,5272,12011,2021-09-21
3171031002,JAKARTA PUSAT,KEMAYORAN,KEBON KOSONG,30019,10114,19905,15195,35100,2021-09-21
3175011005,JAKARTA TIMUR,MATRAMAN,KEBON MANGGIS,16490,5476,11014,8228,19242,2021-09-21
3171071005,JAKARTA PUSAT,TANAH ABANG,KEBON MELATI,32206,12848,19358,12958,32316,2021-09-21
3175081003,JAKARTA TIMUR,MAKASAR,KEBON PALA,46614,15808,30806,22614,53420,2021-09-21
3171061005,JAKARTA PUSAT,MENTENG,KEBON SIRIH,12299,4270,8029,5846,13875,2021-09-21
3173011004,JAKARTA BARAT,CENGKARENG,KEDAUNG KALI ANGKE,32612,9930,22682,17578,40260,2021-09-21
3173051007,JAKARTA BARAT,KEBON JERUK,KEDOYA SELATAN,32165,10359,21806,16450,38256,2021-09-21
3173051006,JAKARTA BARAT,KEBON JERUK,KEDOYA UTARA,45740,14107,31633,25330,56963,2021-09-21
3173051004,JAKARTA BARAT,KEBON JERUK,KELAPA DUA,23565,8353,15212,11563,26775,2021-09-21
3175091003,JAKARTA TIMUR,CIRACAS,KELAPA DUA WETAN,46875,14051,32824,25086,57910,2021-09-21
3172061003,JAKARTA UTARA,KELAPA GADING,KELAPA GADING BARAT,35717,10573,25144,21349,46493,2021-09-21
3172061001,JAKARTA UTARA,KELAPA GADING,KELAPA GADING TIMUR,33592,9045,24547,20995,45542,2021-09-21
3173071005,JAKARTA BARAT,PALMERAH,KEMANGGISAN,32139,10650,21489,16091,37580,2021-09-21
3171031001,JAKARTA PUSAT,KEMAYORAN,KEMAYORAN,20708,6675,14033,10857,24890,2021-09-21
3173081006,JAKARTA BARAT,KEMBANGAN,KEMBANGAN SELATAN,27130,9145,17985,14469,32454,2021-09-21
3173081001,JAKARTA BARAT,KEMBANGAN,KEMBANGAN UTARA,54451,18114,36337,28203,64540,2021-09-21
3171041002,JAKARTA PUSAT,SENEN,KENARI,9579,3096,6483,5170,11653,2021-09-21
3173041005,JAKARTA BARAT,TAMBORA,KERENDANG,19973,6518,13455,9884,23339,2021-09-21
3175071003,JAKARTA TIMUR,DUREN SAWIT,KLENDER,69978,25479,44499,32105,76604,2021-09-21
3172031001,JAKARTA UTARA,KOJA,KOJA,28175,9935,18240,14006,32246,2021-09-21
3173071006,JAKARTA BARAT,PALMERAH,KOTA BAMBU SELATAN,21158,7131,14027,10037,24064,2021-09-21
3173071003,JAKARTA BARAT,PALMERAH,KOTA BAMBU UTARA,24995,8654,16341,11662,28003,2021-09-21
3171041004,JAKARTA PUSAT,SENEN,KRAMAT,28835,10166,18669,12706,31375,2021-09-21
3175041001,JAKARTA TIMUR,KRAMAT JATI,KRAMAT JATI,34144,11789,22355,16307,38662,2021-09-21
3174071003,JAKARTA SELATAN,KEBAYORAN BARU,KRAMAT PELA,14413,4973,9440,6162,15602,2021-09-21
3173031002,JAKARTA BARAT,TAMAN SARI,KRUKUT,19244,6262,12982,9721,22703,2021-09-21
3174031005,JAKARTA SELATAN,MAMPANG PRAPATAN,KUNINGAN BARAT,12785,4434,8351,5323,13674,2021-09-21
3174021008,JAKARTA SELATAN,SETIA BUDI,KUNINGAN TIMUR,6008,2109,3899,2685,6584,2021-09-21
3171041005,JAKARTA PUSAT,SENEN,KWITANG,15486,5325,10161,7708,17869,2021-09-21
3172031003,JAKARTA UTARA,KOJA,LAGOA,59065,21130,37935,27341,65276,2021-09-21
3174061002,JAKARTA SELATAN,CILANDAK,LEBAK BULUS,37626,14217,23409,15345,38754,2021-09-21
3174091004,JAKARTA SELATAN,JAGAKARSA,LENTENG AGUNG,53946,20304,33642,19844,53486,2021-09-21
3175101007,JAKARTA TIMUR,CIPAYUNG,LUBANG BUAYA,63547,19856,43691,33459,77150,2021-09-21
3175081001,JAKARTA TIMUR,MAKASAR,MAKASAR,34390,11168,23222,17888,41110,2021-09-21
3175071006,JAKARTA TIMUR,DUREN SAWIT,MALAKA JAYA,30927,10412,20515,16103,36618,2021-09-21
3175071005,JAKARTA TIMUR,DUREN SAWIT,MALAKA SARI,27530,8890,18640,14855,33495,2021-09-21
3174031001,JAKARTA SELATAN,MAMPANG PRAPATAN,MAMPANG PRAPATAN,18159,6623,11536,7569,19105,2021-09-21
3173031005,JAKARTA BARAT,TAMAN SARI,MANGGA BESAR,7707,2204,5503,4439,9942,2021-09-21
3171021005,JAKARTA PUSAT,SAWAH BESAR,MANGGA DUA SELATAN,27442,8822,18620,14467,33087,2021-09-21
3174011007,JAKARTA SELATAN,TEBET,MANGGARAI,28373,9308,19065,11591,30656,2021-09-21
3174011006,JAKARTA SELATAN,TEBET,MANGGARAI SELATAN,23075,7883,15192,9832,25024,2021-09-21
3173031003,JAKARTA BARAT,TAMAN SARI,MAPHAR,16461,5454,11007,8581,19588,2021-09-21
3172041003,JAKARTA UTARA,CILINCING,MARUNDA,28943,9191,19752,13490,33242,2021-09-21
3174071001,JAKARTA SELATAN,KEBAYORAN BARU,MELAWAI,2627,884,1743,1399,3142,2021-09-21
3171061001,JAKARTA PUSAT,MENTENG,MENTENG,25624,8977,16647,12077,28724,2021-09-21
3174021005,JAKARTA SELATAN,SETIA BUDI,MENTENG ATAS,27816,9365,18451,11718,30169,2021-09-21
3174011003,JAKARTA SELATAN,TEBET,MENTENG DALAM,36028,12981,23047,14966,38013,2021-09-21
3173081003,JAKARTA BARAT,KEMBANGAN,MERUYA SELATAN,32130,10879,21251,16355,37606,2021-09-21
3173081002,JAKARTA BARAT,KEMBANGAN,MERUYA UTARA,43752,14998,28754,23109,51863,2021-09-21
3175101004,JAKARTA TIMUR,CIPAYUNG,MUNJUL,23871,7531,16340,12708,29048,2021-09-21
3172051002,JAKARTA UTARA,PADEMANGAN,PADEMANGAN BARAT,74240,26230,48010,36007,84017,2021-09-21
3172051001,JAKARTA UTARA,PADEMANGAN,PADEMANGAN TIMUR,37736,11067,26669,21638,48307,2021-09-21
3175011004,JAKARTA TIMUR,MATRAMAN,PAL MERIAM,19769,7142,12627,9369,21996,2021-09-21
3173071001,JAKARTA BARAT,PALMERAH,PALMERAH,63011,21867,41144,29977,71121,2021-09-21
3174081001,JAKARTA SELATAN,PANCORAN,PANCORAN,19421,7150,12271,7650,19921,2021-09-21
3172021003,JAKARTA UTARA,TANJUNG PRIOK,PAPANGGO,39097,12263,26834,20638,47472,2021-09-21
3171021001,JAKARTA PUSAT,SAWAH BESAR,PASAR BARU,12035,3577,8458,7116,15574,2021-09-21
3174021006,JAKARTA SELATAN,SETIA BUDI,PASAR MANGGIS,26752,9626,17126,10931,28057,2021-09-21
3174041001,JAKARTA SELATAN,PASAR MINGGU,PASAR MINGGU,24821,8958,15863,10557,26420,2021-09-21
3171041003,JAKARTA PUSAT,SENEN,PASEBAN,23533,8201,15332,11291,26623,2021-09-21
3173061005,JAKARTA BARAT,KALI DERES,PEGADUNGAN,75587,24089,51498,41502,93000,2021-09-21
3171061002,JAKARTA PUSAT,MENTENG,PEGANGSAAN,23455,8100,15355,10739,26094,2021-09-21
3172061002,JAKARTA UTARA,KELAPA GADING,PEGANGSAAN DUA,49976,13463,36513,30986,67499,2021-09-21
3172011004,JAKARTA UTARA,PENJARINGAN,PEJAGALAN,74578,24600,49978,39997,89975,2021-09-21
3174041006,JAKARTA SELATAN,PASAR MINGGU,PEJATEN BARAT,37346,13932,23414,15138,38552,2021-09-21
3174041005,JAKARTA SELATAN,PASAR MINGGU,PEJATEN TIMUR,57656,22329,35327,20732,56059,2021-09-21
3175051005,JAKARTA TIMUR,PASAR REBO,PEKAYON,43250,13631,29619,22562,52181,2021-09-21
3173041009,JAKARTA BARAT,TAMBORA,PEKOJAN,23587,7364,16223,12605,28828,2021-09-21
3174031003,JAKARTA SELATAN,MAMPANG PRAPATAN,PELA MAMPANG,43522,15647,27875,18711,46586,2021-09-21
3174081005,JAKARTA SELATAN,PANCORAN,PENGADEGAN,21478,7102,14376,8223,22599,2021-09-21
3175061003,JAKARTA TIMUR,CAKUNG,PENGGILINGAN,99255,35980,63275,45393,108668,2021-09-21
3172011001,JAKARTA UTARA,PENJARINGAN,PENJARINGAN,88308,32362,55946,40565,96511,2021-09-21
3174101001,JAKARTA SELATAN,PESANGGRAHAN,PESANGGRAHAN,27545,9388,18157,11646,29803,2021-09-21
3171071004,JAKARTA PUSAT,TANAH ABANG,PETAMBURAN,33271,13189,20082,13566,33648,2021-09-21
3174071008,JAKARTA SELATAN,KEBAYORAN BARU,PETOGOGAN,11499,4251,7248,4881,12129,2021-09-21
3171011004,JAKARTA PUSAT,GAMBIR,PETOJO SELATAN,14692,5211,9481,7432,16913,2021-09-21
3171011003,JAKARTA PUSAT,GAMBIR,PETOJO UTARA,17458,6062,11396,8628,20024,2021-09-21
3174101004,JAKARTA SELATAN,PESANGGRAHAN,PETUKANGAN SELATAN,37187,13597,23590,14627,38217,2021-09-21
3174101003,JAKARTA SELATAN,PESANGGRAHAN,PETUKANGAN UTARA,53716,20792,32924,20882,53806,2021-09-21
3175081002,JAKARTA TIMUR,MAKASAR,PINANG RANTI,27198,9354,17844,13526,31370,2021-09-21
3173031008,JAKARTA BARAT,TAMAN SARI,PINANGSIA,10729,3185,7544,5876,13420,2021-09-21
3175011001,JAKARTA TIMUR,MATRAMAN,PISANGAN BARU,31776,11339,20437,14220,34657,2021-09-21
3175021002,JAKARTA TIMUR,PULO GADUNG,PISANGAN TIMUR,41011,13265,27746,21532,49278,2021-09-21
3172011005,JAKARTA UTARA,PENJARINGAN,PLUIT,47783,14877,32906,27090,59996,2021-09-21
3175071002,JAKARTA TIMUR,DUREN SAWIT,PONDOK BAMBU,61550,22099,39451,29799,69250,2021-09-21
3175071004,JAKARTA TIMUR,DUREN SAWIT,PONDOK KELAPA,72015,24747,47268,36037,83305,2021-09-21
3175071007,JAKARTA TIMUR,DUREN SAWIT,PONDOK KOPI,35367,12593,22774,16515,39289,2021-09-21
3174061003,JAKARTA SELATAN,CILANDAK,PONDOK LABU,46464,16019,30445,20944,51389,2021-09-21
3174051002,JAKARTA SELATAN,KEBAYORAN LAMA,PONDOK PINANG,56169,20778,35391,22982,58373,2021-09-21
3175101003,JAKARTA TIMUR,CIPAYUNG,PONDOK RANGGON,25574,8369,17205,13406,30611,2021-09-21
3101011003,KAB.ADM.KEP.SERIBU,KEP. SERIBU UTARA,PULAU HARAPAN,2060,325,1735,1089,2824,2021-09-21
3101011002,KAB.ADM.KEP.SERIBU,KEP. SERIBU UTARA,PULAU KELAPA,5528,868,4660,2969,7629,2021-09-21
3101011001,KAB.ADM.KEP.SERIBU,KEP. SERIBU UTARA,PULAU PANGGANG,5450,804,4646,2573,7219,2021-09-21
3101021003,KAB.ADM.KEP.SERIBU,KEP. SERIBU SELATAN,PULAU PARI,2765,301,2464,2052,4516,2021-09-21
3101021002,KAB.ADM.KEP.SERIBU,KEP. SERIBU SELATAN,PULAU TIDUNG,4553,589,3964,2944,6908,2021-09-21
3101021001,KAB.ADM.KEP.SERIBU,KEP. SERIBU SELATAN,PULAU UNTUNG JAWA,1941,283,1658,1392,3050,2021-09-21
3174071007,JAKARTA SELATAN,KEBAYORAN BARU,PULO,5835,1948,3887,2934,6821,2021-09-21
3175021001,JAKARTA TIMUR,PULO GADUNG,PULO GADUNG,34422,11661,22761,17020,39781,2021-09-21
3175061005,JAKARTA TIMUR,CAKUNG,PULO GEBANG,97301,32427,64874,47116,111990,2021-09-21
3174041004,JAKARTA SELATAN,PASAR MINGGU,RAGUNAN,39616,13838,25778,16852,42630,2021-09-21
3175091005,JAKARTA TIMUR,CIRACAS,RAMBUTAN,36771,13439,23332,17038,40370,2021-09-21
3172031006,JAKARTA UTARA,KOJA,RAWA BADAK SELATAN,42179,14954,27225,19688,46913,2021-09-21
3172031004,JAKARTA UTARA,KOJA,RAWA BADAK UTARA,34408,12135,22273,16713,38986,2021-09-21
3174071005,JAKARTA SELATAN,KEBAYORAN BARU,RAWA BARAT,5625,1856,3769,2675,6444,2021-09-21
3173011003,JAKARTA BARAT,CENGKARENG,RAWA BUAYA,63799,21048,42751,30597,73348,2021-09-21
3175031004,JAKARTA TIMUR,JATINEGARA,RAWA BUNGA,21434,7998,13436,10031,23467,2021-09-21
3174081003,JAKARTA SELATAN,PANCORAN,RAWA JATI,20509,7288,13221,8208,21429,2021-09-21
3175061002,JAKARTA TIMUR,CAKUNG,RAWA TERATE,24637,7322,17315,13225,30540,2021-09-21
3175021005,JAKARTA TIMUR,PULO GADUNG,RAWAMANGUN,37612,12749,24863,19178,44041,2021-09-21
3171051003,JAKARTA PUSAT,CEMPAKA PUTIH,RAWASARI,21967,7609,14358,11170,25528,2021-09-21
3173041010,JAKARTA BARAT,TAMBORA,ROA MALAKA,3484,1007,2477,2004,4481,2021-09-21
3172041006,JAKARTA UTARA,CILINCING,ROROTAN,41668,12816,28852,21514,50366,2021-09-21
3174071004,JAKARTA SELATAN,KEBAYORAN BARU,SELONG,2842,965,1877,1439,3316,2021-09-21
3173061002,JAKARTA BARAT,KALI DERES,SEMANAN,71354,24921,46433,34728,81161,2021-09-21
3172041007,JAKARTA UTARA,CILINCING,SEMPER BARAT,68587,21182,47405,37340,84745,2021-09-21
3172041005,JAKARTA UTARA,CILINCING,SEMPER TIMUR,36267,11739,24528,18543,43071,2021-09-21
3174071006,JAKARTA SELATAN,KEBAYORAN BARU,SENAYAN,2771,1109,1662,1146,2808,2021-09-21
3171041001,JAKARTA PUSAT,SENEN,SENEN,6804,2170,4634,3654,8288,2021-09-21
3171031004,JAKARTA PUSAT,KEMAYORAN,SERDANG,29668,9751,19917,15134,35051,2021-09-21
3174021001,JAKARTA SELATAN,SETIA BUDI,SETIA BUDI,3023,1097,1926,1352,3278,2021-09-21
3175101005,JAKARTA TIMUR,CIPAYUNG,SETU,20572,7215,13357,9972,23329,2021-09-21
3173071002,JAKARTA BARAT,PALMERAH,SLIPI,16591,5347,11244,8657,19901,2021-09-21
3173081004,JAKARTA BARAT,KEMBANGAN,SRENGSENG,45523,16270,29253,22251,51504,2021-09-21
3174091002,JAKARTA SELATAN,JAGAKARSA,SRENGSENG SAWAH,58196,18702,39494,25213,64707,2021-09-21
3173051003,JAKARTA BARAT,KEBON JERUK,SUKABUMI SELATAN,37033,13403,23630,16031,39661,2021-09-21
3173051002,JAKARTA BARAT,KEBON JERUK,SUKABUMI UTARA,38290,14199,24091,15855,39946,2021-09-21
3172041002,JAKARTA UTARA,CILINCING,SUKAPURA,53949,18602,35347,27399,62746,2021-09-21
3171031007,JAKARTA PUSAT,KEMAYORAN,SUMUR BATU,22717,7704,15013,11712,26725,2021-09-21
3172021004,JAKARTA UTARA,TANJUNG PRIOK,SUNGAI BAMBU,29876,9761,20115,15601,35716,2021-09-21
3172021006,JAKARTA UTARA,TANJUNG PRIOK,SUNTER AGUNG,71805,20659,51146,41956,93102,2021-09-21
3172021002,JAKARTA UTARA,TANJUNG PRIOK,SUNTER JAYA,63031,18686,44345,36126,80471,2021-09-21
3175091004,JAKARTA TIMUR,CIRACAS,SUSUKAN,38257,11812,26445,20396,46841,2021-09-21
3173031001,JAKARTA BARAT,TAMAN SARI,TAMAN SARI,14348,4516,9832,7870,17702,2021-09-21
3173041001,JAKARTA BARAT,TAMBORA,TAMBORA,10204,3479,6725,4951,11676,2021-09-21
3173041004,JAKARTA BARAT,TAMBORA,TANAH SEREAL,26387,7535,18852,14123,32975,2021-09-21
3171081004,JAKARTA PUSAT,JOHAR BARU,TANAH TINGGI,37693,10934,26759,19940,46699,2021-09-21
3173031004,JAKARTA BARAT,TAMAN SARI,TANGKI,13324,4192,9132,7228,16360,2021-09-21
3174091005,JAKARTA SELATAN,JAGAKARSA,TANJUNG BARAT,39770,13851,25919,15573,41492,2021-09-21
3173021005,JAKARTA BARAT,GROGOL PETAMBURAN,TANJUNG DUREN SELATAN,25337,8480,16857,13454,30311,2021-09-21
3173021002,JAKARTA BARAT,GROGOL PETAMBURAN,TANJUNG DUREN UTARA,17010,5351,11659,9339,20998,2021-09-21
3172021001,JAKARTA UTARA,TANJUNG PRIOK,TANJUNG PRIOK,34588,10987,23601,17957,41558,2021-09-21
3174011002,JAKARTA SELATAN,TEBET,TEBET BARAT,21194,6941,14253,9786,24039,2021-09-21
3174011001,JAKARTA SELATAN,TEBET,TEBET TIMUR,18199,5951,12248,8426,20674,2021-09-21
3173061003,JAKARTA BARAT,KALI DERES,TEGAL ALUR,83647,28079,55568,41313,96881,2021-09-21
3174031004,JAKARTA SELATAN,MAMPANG PRAPATAN,TEGAL PARANG,32401,12584,19817,11880,31697,2021-09-21
3173021003,JAKARTA BARAT,GROGOL PETAMBURAN,TOMANG,29605,9747,19858,15947,35805,2021-09-21
3172031005,JAKARTA UTARA,KOJA,TUGU SELATAN,39122,13085,26037,18923,44960,2021-09-21
3172031002,JAKARTA UTARA,KOJA,TUGU UTARA,67670,24190,43480,31531,75011,2021-09-21
3175061006,JAKARTA TIMUR,CAKUNG,UJUNG MENTENG,29934,9155,20779,16336,37115,2021-09-21
3174101005,JAKARTA SELATAN,PESANGGRAHAN,ULUJAMI,40544,16085,24459,14522,38981,2021-09-21
3175011006,JAKARTA TIMUR,MATRAMAN,UTAN KAYU SELATAN,33511,10833,22678,17067,39745,2021-09-21
3175011002,JAKARTA TIMUR,MATRAMAN,UTAN KAYU UTARA,28169,10067,18102,13388,31490,2021-09-21
3171031008,JAKARTA PUSAT,KEMAYORAN,UTAN PANJANG,29208,9874,19334,14351,33685,2021-09-21
3172021007,JAKARTA UTARA,TANJUNG PRIOK,WARAKAS,44401,13710,30691,23283,53974,2021-09-21
3173021007,JAKARTA BARAT,GROGOL PETAMBURAN,WIJAYA KUSUMA,38934,13570,25364,19774,45138,2021-09-21
3172051003,JAKARTA UTARA,PADEMANGAN,ANCOL,23947,7076,16871,12886,29757,2021-09-22
3173041007,JAKARTA BARAT,TAMBORA,ANGKE,29381,8033,21348,15762,37110,2021-09-22
3175041005,JAKARTA TIMUR,KRAMAT JATI,BALE KAMBANG,29074,9331,19743,13638,33381,2021-09-22
3175031003,JAKARTA TIMUR,JATINEGARA,BALI MESTER,9752,2717,7035,5398,12433,2021-09-22
3175101006,JAKARTA TIMUR,CIPAYUNG,BAMBU APUS,26285,6973,19312,14848,34160,2021-09-22
3174031002,JAKARTA SELATAN,MAMPANG PRAPATAN,BANGKA,21566,6378,15188,11656,26844,2021-09-22
3175051002,JAKARTA TIMUR,PASAR REBO,BARU,23886,5251,18635,15087,33722,2021-09-22
3175041004,JAKARTA TIMUR,KRAMAT JATI,BATU AMPAR,47898,15174,32724,23480,56204,2021-09-22
3171071002,JAKARTA PUSAT,TANAH ABANG,BENDUNGAN HILIR,21494,5666,15828,12204,28032,2021-09-22
3175031002,JAKARTA TIMUR,JATINEGARA,BIDARA CINA,36689,11454,25235,18318,43553,2021-09-22
3174101002,JAKARTA SELATAN,PESANGGRAHAN,BINTARO,53098,13986,39112,31180,70292,2021-09-22
3174011005,JAKARTA SELATAN,TEBET,BUKIT DURI,34183,9496,24687,18329,43016,2021-09-22
3171041006,JAKARTA PUSAT,SENEN,BUNGUR,18144,4907,13237,10108,23345,2021-09-22
3175061007,JAKARTA TIMUR,CAKUNG,CAKUNG BARAT,57724,14982,42742,32600,75342,2021-09-22
3175061004,JAKARTA TIMUR,CAKUNG,CAKUNG TIMUR,58287,14902,43385,33242,76627,2021-09-22
3175041007,JAKARTA TIMUR,KRAMAT JATI,CAWANG,32762,9341,23421,16932,40353,2021-09-22
3175101008,JAKARTA TIMUR,CIPAYUNG,CEGER,18932,4952,13980,10716,24696,2021-09-22
3171031006,JAKARTA PUSAT,KEMAYORAN,CEMPAKA BARU,32581,8961,23620,17131,40751,2021-09-22
3171051002,JAKARTA PUSAT,CEMPAKA PUTIH,CEMPAKA PUTIH BARAT,35885,9951,25934,20215,46149,2021-09-22
3171051001,JAKARTA PUSAT,CEMPAKA PUTIH,CEMPAKA PUTIH TIMUR,24292,6296,17996,14293,32289,2021-09-22
3173011001,JAKARTA BARAT,CENGKARENG,CENGKARENG BARAT,66284,17754,48530,37683,86213,2021-09-22
3173011006,JAKARTA BARAT,CENGKARENG,CENGKARENG TIMUR,81027,21189,59838,44445,104283,2021-09-22
3175091002,JAKARTA TIMUR,CIRACAS,CIBUBUR,66364,15503,50861,39538,90399,2021-09-22
3171011002,JAKARTA PUSAT,GAMBIR,CIDENG,15390,3744,11646,9390,21036,2021-09-22
3174091003,JAKARTA SELATAN,JAGAKARSA,CIGANJUR,38497,9801,28696,21681,50377,2021-09-22
3175051003,JAKARTA TIMUR,PASAR REBO,CIJANTUNG,41419,10171,31248,24160,55408,2021-09-22
3171061003,JAKARTA PUSAT,MENTENG,CIKINI,8274,1919,6355,4472,10827,2021-09-22
3174081006,JAKARTA SELATAN,PANCORAN,CIKOKO,10547,2480,8067,6208,14275,2021-09-22
3174061001,JAKARTA SELATAN,CILANDAK,CILANDAK BARAT,51752,12832,38920,30884,69804,2021-09-22
3174041003,JAKARTA SELATAN,PASAR MINGGU,CILANDAK TIMUR,25145,6219,18926,14956,33882,2021-09-22
3175101002,JAKARTA TIMUR,CIPAYUNG,CILANGKAP,27635,6904,20731,16005,36736,2021-09-22
3175041006,JAKARTA TIMUR,KRAMAT JATI,CILILITAN,40181,11807,28374,20926,49300,2021-09-22
3172041001,JAKARTA UTARA,CILINCING,CILINCING,43609,13114,30495,21631,52126,2021-09-22
3175101001,JAKARTA TIMUR,CIPAYUNG,CIPAYUNG,26104,6060,20044,16018,36062,2021-09-22
3174091006,JAKARTA SELATAN,JAGAKARSA,CIPEDAK,38303,9191,29112,22770,51882,2021-09-22
3174061005,JAKARTA SELATAN,CILANDAK,CIPETE SELATAN,26704,6908,19796,15668,35464,2021-09-22
3174071010,JAKARTA SELATAN,KEBAYORAN BARU,CIPETE UTARA,34102,8665,25437,19031,44468,2021-09-22
3175021003,JAKARTA TIMUR,PULO GADUNG,CIPINANG,39306,10192,29114,21916,51030,2021-09-22
3175031007,JAKARTA TIMUR,JATINEGARA,CIPINANG BESAR SELATAN,35212,10663,24549,17228,41777,2021-09-22
3175031008,JAKARTA TIMUR,JATINEGARA,CIPINANG BESAR UTARA,45319,14090,31229,22179,53408,2021-09-22
3175031005,JAKARTA TIMUR,JATINEGARA,CIPINANG CEMPEDAK,32824,9717,23107,17778,40885,2021-09-22
3175081005,JAKARTA TIMUR,MAKASAR,CIPINANG MELAYU,42308,11231,31077,24223,55300,2021-09-22
3175031006,JAKARTA TIMUR,JATINEGARA,CIPINANG MUARA,55243,15912,39331,29167,68498,2021-09-22
3174051003,JAKARTA SELATAN,KEBAYORAN LAMA,CIPULIR,39937,10993,28944,21152,50096,2021-09-22
3175091001,JAKARTA TIMUR,CIRACAS,CIRACAS,64594,15698,48896,37078,85974,2021-09-22
3175041003,JAKARTA TIMUR,KRAMAT JATI,DUKUH,24609,6266,18343,13852,32195,2021-09-22
3175071001,JAKARTA TIMUR,DUREN SAWIT,DUREN SAWIT,61160,17542,43618,32885,76503,2021-09-22
3174081004,JAKARTA SELATAN,PANCORAN,DUREN TIGA,28319,7642,20677,14003,34680,2021-09-22
3173051005,JAKARTA BARAT,KEBON JERUK,DURI KEPA,60138,15191,44947,35750,80697,2021-09-22
3173011002,JAKARTA BARAT,CENGKARENG,DURI KOSAMBI,77923,23063,54860,40353,95213,2021-09-22
3171011006,JAKARTA PUSAT,GAMBIR,DURI PULO,19610,5376,14234,10648,24882,2021-09-22
3173041011,JAKARTA BARAT,TAMBORA,DURI SELATAN,14259,3401,10858,8434,19292,2021-09-22
3173041003,JAKARTA BARAT,TAMBORA,DURI UTARA,19844,5042,14802,10991,25793,2021-09-22
3171081003,JAKARTA PUSAT,JOHAR BARU,GALUR,18243,4485,13758,10355,24113,2021-09-22
3171011001,JAKARTA PUSAT,GAMBIR,GAMBIR,2191,580,1611,1307,2918,2021-09-22
3174061004,JAKARTA SELATAN,CILANDAK,GANDARIA SELATAN,22119,5836,16283,12576,28859,2021-09-22
3174071009,JAKARTA SELATAN,KEBAYORAN BARU,GANDARIA UTARA,39922,10783,29139,22330,51469,2021-09-22
3175051001,JAKARTA TIMUR,PASAR REBO,GEDONG,35755,9231,26524,20532,47056,2021-09-22
3171071001,JAKARTA PUSAT,TANAH ABANG,GELORA,3127,803,2324,1718,4042,2021-09-22
3173031007,JAKARTA BARAT,TAMAN SARI,GLODOK,7837,1645,6192,5226,11418,2021-09-22
3171061004,JAKARTA PUSAT,MENTENG,GONDANGDIA,4100,1072,3028,2598,5626,2021-09-22
3173021001,JAKARTA BARAT,GROGOL PETAMBURAN,GROGOL,16876,4324,12552,9701,22253,2021-09-22
3174051005,JAKARTA SELATAN,KEBAYORAN LAMA,GROGOL SELATAN,44251,12391,31860,24248,56108,2021-09-22
3174051004,JAKARTA SELATAN,KEBAYORAN LAMA,GROGOL UTARA,42494,11522,30972,23592,54564,2021-09-22
3174021007,JAKARTA SELATAN,SETIA BUDI,GUNTUR,3985,967,3018,2511,5529,2021-09-22
3174071002,JAKARTA SELATAN,KEBAYORAN BARU,GUNUNG,9436,2368,7068,5706,12774,2021-09-22
3171031005,JAKARTA PUSAT,KEMAYORAN,GUNUNG SAHARI SELATAN,19199,5138,14061,10975,25036,2021-09-22
3171021004,JAKARTA PUSAT,SAWAH BESAR,GUNUNG SAHARI UTARA,16650,3744,12906,10732,23638,2021-09-22
3175081004,JAKARTA TIMUR,MAKASAR,HALIM PERDANA KUSUMAH,28363,4909,23454,20329,43783,2021-09-22
3171031003,JAKARTA PUSAT,KEMAYORAN,HARAPAN MULIA,22557,6103,16454,12414,28868,2021-09-22
3174091001,JAKARTA SELATAN,JAGAKARSA,JAGAKARSA,62389,15706,46683,36527,83210,2021-09-22
3175021007,JAKARTA TIMUR,PULO GADUNG,JATI,32757,8254,24503,19352,43855,2021-09-22
3174041002,JAKARTA SELATAN,PASAR MINGGU,JATI PADANG,37502,10360,27142,21213,48355,2021-09-22
3173071004,JAKARTA BARAT,PALMERAH,JATI PULO,28738,7367,21371,15695,37066,2021-09-22
3175061001,JAKARTA TIMUR,CAKUNG,JATINEGARA,84160,23433,60727,45775,106502,2021-09-22
3175021004,JAKARTA TIMUR,PULO GADUNG,JATINEGARA KAUM,24632,6174,18458,13202,31660,2021-09-22
3173021004,JAKARTA BARAT,GROGOL PETAMBURAN,JELAMBAR,30266,7518,22748,18059,40807,2021-09-22
3173021006,JAKARTA BARAT,GROGOL PETAMBURAN,JELAMBAR BARU,38246,9649,28597,22716,51313,2021-09-22
3173041006,JAKARTA BARAT,TAMBORA,JEMBATAN BESI,29314,9202,20112,13787,33899,2021-09-22
3173041008,JAKARTA BARAT,TAMBORA,JEMBATAN LIMA,21021,6339,14682,10520,25202,2021-09-22
3173081005,JAKARTA BARAT,KEMBANGAN,JOGLO,40839,10784,30055,23097,53152,2021-09-22
3171081001,JAKARTA PUSAT,JOHAR BARU,JOHAR BARU,37488,8946,28542,22244,50786,2021-09-22
3173041002,JAKARTA BARAT,TAMBORA,KALI ANYAR,23856,6300,17556,12679,30235,2021-09-22
3172041004,JAKARTA UTARA,CILINCING,KALIBARU,67684,23278,44406,29124,73530,2021-09-22
3174081002,JAKARTA SELATAN,PANCORAN,KALIBATA,41994,12801,29193,19639,48832,2021-09-22
3173061001,JAKARTA BARAT,KALI DERES,KALIDERES,72447,19637,52810,41783,94593,2021-09-22
3175051004,JAKARTA TIMUR,PASAR REBO,KALISARI,43212,10601,32611,25436,58047,2021-09-22
3173061004,JAKARTA BARAT,KALI DERES,KAMAL,53783,16479,37304,27374,64678,2021-09-22
3172011002,JAKARTA UTARA,PENJARINGAN,KAMAL MUARA,12930,2616,10314,8349,18663,2021-09-22
3171071007,JAKARTA PUSAT,TANAH ABANG,KAMPUNG BALI,11358,3253,8105,5652,13757,2021-09-22
3175031001,JAKARTA TIMUR,JATINEGARA,KAMPUNG MELAYU,25717,8379,17338,12611,29949,2021-09-22
3171081002,JAKARTA PUSAT,JOHAR BARU,KAMPUNG RAWA,21237,4436,16801,12420,29221,2021-09-22
3175041002,JAKARTA TIMUR,KRAMAT JATI,KAMPUNG TENGAH,43993,13919,30074,21706,51780,2021-09-22
3173011005,JAKARTA BARAT,CENGKARENG,KAPUK,134466,41394,93072,67007,160079,2021-09-22
3172011003,JAKARTA UTARA,PENJARINGAN,KAPUK MUARA,35781,8392,27389,22799,50188,2021-09-22
3171021002,JAKARTA PUSAT,SAWAH BESAR,KARANG ANYAR,25761,6394,19367,14884,34251,2021-09-22
3174021004,JAKARTA SELATAN,SETIA BUDI,KARET,9623,2375,7248,5540,12788,2021-09-22
3174021003,JAKARTA SELATAN,SETIA BUDI,KARET KUNINGAN,16055,3972,12083,9518,21601,2021-09-22
3174021002,JAKARTA SELATAN,SETIA BUDI,KARET SEMANGGI,2770,660,2110,1761,3871,2021-09-22
3171071003,JAKARTA PUSAT,TANAH ABANG,KARET TENGSIN,19271,4937,14334,10505,24839,2021-09-22
3171021003,JAKARTA PUSAT,SAWAH BESAR,KARTINI,22292,5680,16612,13202,29814,2021-09-22
3175011003,JAKARTA TIMUR,MATRAMAN,KAYU MANIS,25284,7244,18040,12869,30909,2021-09-22
3175021006,JAKARTA TIMUR,PULO GADUNG,KAYU PUTIH,40696,9983,30713,24730,55443,2021-09-22
3173031006,JAKARTA BARAT,TAMAN SARI,KEAGUNGAN,17387,4465,12922,9798,22720,2021-09-22
3174041007,JAKARTA SELATAN,PASAR MINGGU,KEBAGUSAN,44552,12866,31686,24076,55762,2021-09-22
3174051006,JAKARTA SELATAN,KEBAYORAN LAMA,KEBAYORAN LAMA SELATAN,41212,10406,30806,24028,54834,2021-09-22
3174051001,JAKARTA SELATAN,KEBAYORAN LAMA,KEBAYORAN LAMA UTARA,42422,11776,30646,23289,53935,2021-09-22
3174011004,JAKARTA SELATAN,TEBET,KEBON BARU,35165,9245,25920,19719,45639,2021-09-22
3172021005,JAKARTA UTARA,TANJUNG PRIOK,KEBON BAWANG,50952,13423,37529,28542,66071,2021-09-22
3173051001,JAKARTA BARAT,KEBON JERUK,KEBON JERUK,53887,15671,38216,28718,66934,2021-09-22
3171071006,JAKARTA PUSAT,TANAH ABANG,KEBON KACANG,21531,6608,14923,10679,25602,2021-09-22
3171011005,JAKARTA PUSAT,GAMBIR,KEBON KELAPA,10163,2667,7496,5828,13324,2021-09-22
3171031002,JAKARTA PUSAT,KEMAYORAN,KEBON KOSONG,30019,8395,21624,16382,38006,2021-09-22
3175011005,JAKARTA TIMUR,MATRAMAN,KEBON MANGGIS,16490,4215,12275,9266,21541,2021-09-22
3171071005,JAKARTA PUSAT,TANAH ABANG,KEBON MELATI,32206,10640,21566,14482,36048,2021-09-22
3175081003,JAKARTA TIMUR,MAKASAR,KEBON PALA,46614,12353,34261,25726,59987,2021-09-22
3171061005,JAKARTA PUSAT,MENTENG,KEBON SIRIH,12299,3399,8900,6447,15347,2021-09-22
3173011004,JAKARTA BARAT,CENGKARENG,KEDAUNG KALI ANGKE,32612,8171,24441,18879,43320,2021-09-22
3173051007,JAKARTA BARAT,KEBON JERUK,KEDOYA SELATAN,32165,8318,23847,18168,42015,2021-09-22
3173051006,JAKARTA BARAT,KEBON JERUK,KEDOYA UTARA,45740,11156,34584,27597,62181,2021-09-22
3173051004,JAKARTA BARAT,KEBON JERUK,KELAPA DUA,23565,6757,16808,12898,29706,2021-09-22
3175091003,JAKARTA TIMUR,CIRACAS,KELAPA DUA WETAN,46875,10789,36086,27787,63873,2021-09-22
3172061003,JAKARTA UTARA,KELAPA GADING,KELAPA GADING BARAT,35717,7597,28120,23852,51972,2021-09-22
3172061001,JAKARTA UTARA,KELAPA GADING,KELAPA GADING TIMUR,33592,6413,27179,23450,50629,2021-09-22
3173071005,JAKARTA BARAT,PALMERAH,KEMANGGISAN,32139,8198,23941,18100,42041,2021-09-22
3171031001,JAKARTA PUSAT,KEMAYORAN,KEMAYORAN,20708,5452,15256,11728,26984,2021-09-22
3173081006,JAKARTA BARAT,KEMBANGAN,KEMBANGAN SELATAN,27130,7145,19985,16165,36150,2021-09-22
3173081001,JAKARTA BARAT,KEMBANGAN,KEMBANGAN UTARA,54451,14914,39537,30714,70251,2021-09-22
3171041002,JAKARTA PUSAT,SENEN,KENARI,9579,2359,7220,5704,12924,2021-09-22
3173041005,JAKARTA BARAT,TAMBORA,KERENDANG,19973,5426,14547,10674,25221,2021-09-22
3175071003,JAKARTA TIMUR,DUREN SAWIT,KLENDER,69978,21084,48894,35539,84433,2021-09-22
3172031001,JAKARTA UTARA,KOJA,KOJA,28175,8426,19749,14947,34696,2021-09-22
3173071006,JAKARTA BARAT,PALMERAH,KOTA BAMBU SELATAN,21158,5797,15361,11069,26430,2021-09-22
3173071003,JAKARTA BARAT,PALMERAH,KOTA BAMBU UTARA,24995,7030,17965,12859,30824,2021-09-22
3171041004,JAKARTA PUSAT,SENEN,KRAMAT,28835,8432,20403,14051,34454,2021-09-22
3175041001,JAKARTA TIMUR,KRAMAT JATI,KRAMAT JATI,34144,9622,24522,18206,42728,2021-09-22
3174071003,JAKARTA SELATAN,KEBAYORAN BARU,KRAMAT PELA,14413,3532,10881,8520,19401,2021-09-22
3173031002,JAKARTA BARAT,TAMAN SARI,KRUKUT,19244,5059,14185,10599,24784,2021-09-22
3174031005,JAKARTA SELATAN,MAMPANG PRAPATAN,KUNINGAN BARAT,12785,3249,9536,7315,16851,2021-09-22
3174021008,JAKARTA SELATAN,SETIA BUDI,KUNINGAN TIMUR,6008,1570,4438,3528,7966,2021-09-22
3171041005,JAKARTA PUSAT,SENEN,KWITANG,15486,4373,11113,8356,19469,2021-09-22
3172031003,JAKARTA UTARA,KOJA,LAGOA,59065,17914,41151,29561,70712,2021-09-22
3174061002,JAKARTA SELATAN,CILANDAK,LEBAK BULUS,37626,9929,27697,21856,49553,2021-09-22
3174091004,JAKARTA SELATAN,JAGAKARSA,LENTENG AGUNG,53946,14769,39177,29486,68663,2021-09-22
3175101007,JAKARTA TIMUR,CIPAYUNG,LUBANG BUAYA,63547,15701,47846,36854,84700,2021-09-22
3175081001,JAKARTA TIMUR,MAKASAR,MAKASAR,34390,8948,25442,20019,45461,2021-09-22
3175071006,JAKARTA TIMUR,DUREN SAWIT,MALAKA JAYA,30927,7780,23147,18050,41197,2021-09-22
3175071005,JAKARTA TIMUR,DUREN SAWIT,MALAKA SARI,27530,6473,21057,16693,37750,2021-09-22
3174031001,JAKARTA SELATAN,MAMPANG PRAPATAN,MAMPANG PRAPATAN,18159,5031,13128,10035,23163,2021-09-22
3173031005,JAKARTA BARAT,TAMAN SARI,MANGGA BESAR,7707,1666,6041,4893,10934,2021-09-22
3171021005,JAKARTA PUSAT,SAWAH BESAR,MANGGA DUA SELATAN,27442,7037,20405,15781,36186,2021-09-22
3174011007,JAKARTA SELATAN,TEBET,MANGGARAI,28373,6864,21509,15960,37469,2021-09-22
3174011006,JAKARTA SELATAN,TEBET,MANGGARAI SELATAN,23075,5613,17462,13474,30936,2021-09-22
3173031003,JAKARTA BARAT,TAMAN SARI,MAPHAR,16461,4182,12279,9497,21776,2021-09-22
3172041003,JAKARTA UTARA,CILINCING,MARUNDA,28943,8194,20749,14160,34909,2021-09-22
3174071001,JAKARTA SELATAN,KEBAYORAN BARU,MELAWAI,2627,601,2026,1745,3771,2021-09-22
3171061001,JAKARTA PUSAT,MENTENG,MENTENG,25624,7347,18277,13367,31644,2021-09-22
3174021005,JAKARTA SELATAN,SETIA BUDI,MENTENG ATAS,27816,6826,20990,15954,36944,2021-09-22
3174011003,JAKARTA SELATAN,TEBET,MENTENG DALAM,36028,9517,26511,20314,46825,2021-09-22
3173081003,JAKARTA BARAT,KEMBANGAN,MERUYA SELATAN,32130,8698,23432,18093,41525,2021-09-22
3173081002,JAKARTA BARAT,KEMBANGAN,MERUYA UTARA,43752,11738,32014,25722,57736,2021-09-22
3175101004,JAKARTA TIMUR,CIPAYUNG,MUNJUL,23871,5997,17874,13999,31873,2021-09-22
3172051002,JAKARTA UTARA,PADEMANGAN,PADEMANGAN BARAT,74240,22028,52212,38856,91068,2021-09-22
3172051001,JAKARTA UTARA,PADEMANGAN,PADEMANGAN TIMUR,37736,8546,29190,23644,52834,2021-09-22
3175011004,JAKARTA TIMUR,MATRAMAN,PAL MERIAM,19769,5671,14098,10501,24599,2021-09-22
3173071001,JAKARTA BARAT,PALMERAH,PALMERAH,63011,17858,45153,33369,78522,2021-09-22
3174081001,JAKARTA SELATAN,PANCORAN,PANCORAN,19421,5535,13886,10216,24102,2021-09-22
3172021003,JAKARTA UTARA,TANJUNG PRIOK,PAPANGGO,39097,10086,29011,22162,51173,2021-09-22
3171021001,JAKARTA PUSAT,SAWAH BESAR,PASAR BARU,12035,2822,9213,7725,16938,2021-09-22
3174021006,JAKARTA SELATAN,SETIA BUDI,PASAR MANGGIS,26752,7101,19651,15051,34702,2021-09-22
3174041001,JAKARTA SELATAN,PASAR MINGGU,PASAR MINGGU,24821,6356,18465,14483,32948,2021-09-22
3171041003,JAKARTA PUSAT,SENEN,PASEBAN,23533,6519,17014,12614,29628,2021-09-22
3173061005,JAKARTA BARAT,KALI DERES,PEGADUNGAN,75587,19345,56242,45420,101662,2021-09-22
3171061002,JAKARTA PUSAT,MENTENG,PEGANGSAAN,23455,6670,16785,11875,28660,2021-09-22
3172061002,JAKARTA UTARA,KELAPA GADING,PEGANGSAAN DUA,49976,10083,39893,33949,73842,2021-09-22
3172011004,JAKARTA UTARA,PENJARINGAN,PEJAGALAN,74578,19861,54717,43595,98312,2021-09-22
3174041006,JAKARTA SELATAN,PASAR MINGGU,PEJATEN BARAT,37346,10405,26941,21042,47983,2021-09-22
3174041005,JAKARTA SELATAN,PASAR MINGGU,PEJATEN TIMUR,57656,17017,40639,30384,71023,2021-09-22
3175051005,JAKARTA TIMUR,PASAR REBO,PEKAYON,43250,10663,32587,25011,57598,2021-09-22
3173041009,JAKARTA BARAT,TAMBORA,PEKOJAN,23587,5902,17685,13735,31420,2021-09-22
3174031003,JAKARTA SELATAN,MAMPANG PRAPATAN,PELA MAMPANG,43522,11820,31702,24633,56335,2021-09-22
3174081005,JAKARTA SELATAN,PANCORAN,PENGADEGAN,21478,5189,16289,11806,28095,2021-09-22
3175061003,JAKARTA TIMUR,CAKUNG,PENGGILINGAN,99255,30231,69024,49499,118523,2021-09-22
3172011001,JAKARTA UTARA,PENJARINGAN,PENJARINGAN,88308,28113,60195,43293,103488,2021-09-22
3174101001,JAKARTA SELATAN,PESANGGRAHAN,PESANGGRAHAN,27545,6417,21128,16870,37998,2021-09-22
3171071004,JAKARTA PUSAT,TANAH ABANG,PETAMBURAN,33271,11057,22214,15075,37289,2021-09-22
3174071008,JAKARTA SELATAN,KEBAYORAN BARU,PETOGOGAN,11499,3007,8492,6456,14948,2021-09-22
3171011004,JAKARTA PUSAT,GAMBIR,PETOJO SELATAN,14692,4226,10466,8279,18745,2021-09-22
3171011003,JAKARTA PUSAT,GAMBIR,PETOJO UTARA,17458,4782,12676,9605,22281,2021-09-22
3174101004,JAKARTA SELATAN,PESANGGRAHAN,PETUKANGAN SELATAN,37187,10055,27132,21455,48587,2021-09-22
3174101003,JAKARTA SELATAN,PESANGGRAHAN,PETUKANGAN UTARA,53716,15108,38608,29767,68375,2021-09-22
3175081002,JAKARTA TIMUR,MAKASAR,PINANG RANTI,27198,7550,19648,15031,34679,2021-09-22
3173031008,JAKARTA BARAT,TAMAN SARI,PINANGSIA,10729,2511,8218,6370,14588,2021-09-22
3175011001,JAKARTA TIMUR,MATRAMAN,PISANGAN BARU,31776,9174,22602,15828,38430,2021-09-22
3175021002,JAKARTA TIMUR,PULO GADUNG,PISANGAN TIMUR,41011,10449,30562,23836,54398,2021-09-22
3172011005,JAKARTA UTARA,PENJARINGAN,PLUIT,47783,11609,36174,29858,66032,2021-09-22
3175071002,JAKARTA TIMUR,DUREN SAWIT,PONDOK BAMBU,61550,17573,43977,33362,77339,2021-09-22
3175071004,JAKARTA TIMUR,DUREN SAWIT,PONDOK KELAPA,72015,18646,53369,41047,94416,2021-09-22
3175071007,JAKARTA TIMUR,DUREN SAWIT,PONDOK KOPI,35367,9901,25466,18406,43872,2021-09-22
3174061003,JAKARTA SELATAN,CILANDAK,PONDOK LABU,46464,10903,35561,28178,63739,2021-09-22
3174051002,JAKARTA SELATAN,KEBAYORAN LAMA,PONDOK PINANG,56169,14269,41900,32590,74490,2021-09-22
3175101003,JAKARTA TIMUR,CIPAYUNG,PONDOK RANGGON,25574,6705,18869,14671,33540,2021-09-22
3101011003,KAB.ADM.KEP.SERIBU,KEP. SERIBU UTARA,PULAU HARAPAN,2060,287,1773,1138,2911,2021-09-22
3101011002,KAB.ADM.KEP.SERIBU,KEP. SERIBU UTARA,PULAU KELAPA,5528,752,4776,3202,7978,2021-09-22
3101011001,KAB.ADM.KEP.SERIBU,KEP. SERIBU UTARA,PULAU PANGGANG,5450,662,4788,2764,7552,2021-09-22
3101021003,KAB.ADM.KEP.SERIBU,KEP. SERIBU SELATAN,PULAU PARI,2765,252,2513,2096,4609,2021-09-22
3101021002,KAB.ADM.KEP.SERIBU,KEP. SERIBU SELATAN,PULAU TIDUNG,4553,499,4054,3054,7108,2021-09-22
3101021001,KAB.ADM.KEP.SERIBU,KEP. SERIBU SELATAN,PULAU UNTUNG JAWA,1941,234,1707,1454,3161,2021-09-22
3174071007,JAKARTA SELATAN,KEBAYORAN BARU,PULO,5835,1287,4548,3818,8366,2021-09-22
3175021001,JAKARTA TIMUR,PULO GADUNG,PULO GADUNG,34422,9431,24991,18827,43818,2021-09-22
3175061005,JAKARTA TIMUR,CAKUNG,PULO GEBANG,97301,25270,72031,52222,124253,2021-09-22
3174041004,JAKARTA SELATAN,PASAR MINGGU,RAGUNAN,39616,10064,29552,23336,52888,2021-09-22
3175091005,JAKARTA TIMUR,CIRACAS,RAMBUTAN,36771,11073,25698,18859,44557,2021-09-22
3172031006,JAKARTA UTARA,KOJA,RAWA BADAK SELATAN,42179,12793,29386,20990,50376,2021-09-22
3172031004,JAKARTA UTARA,KOJA,RAWA BADAK UTARA,34408,10161,24247,18066,42313,2021-09-22
3174071005,JAKARTA SELATAN,KEBAYORAN BARU,RAWA BARAT,5625,1272,4353,3538,7891,2021-09-22
3173011003,JAKARTA BARAT,CENGKARENG,RAWA BUAYA,63799,17515,46284,33418,79702,2021-09-22
3175031004,JAKARTA TIMUR,JATINEGARA,RAWA BUNGA,21434,6603,14831,10988,25819,2021-09-22
3174081003,JAKARTA SELATAN,PANCORAN,RAWA JATI,20509,5166,15343,10834,26177,2021-09-22
3175061002,JAKARTA TIMUR,CAKUNG,RAWA TERATE,24637,5829,18808,14170,32978,2021-09-22
3175021005,JAKARTA TIMUR,PULO GADUNG,RAWAMANGUN,37612,9857,27755,21429,49184,2021-09-22
3171051003,JAKARTA PUSAT,CEMPAKA PUTIH,RAWASARI,21967,5873,16094,12451,28545,2021-09-22
3173041010,JAKARTA BARAT,TAMBORA,ROA MALAKA,3484,736,2748,2257,5005,2021-09-22
3172041006,JAKARTA UTARA,CILINCING,ROROTAN,41668,10989,30679,22923,53602,2021-09-22
3174071004,JAKARTA SELATAN,KEBAYORAN BARU,SELONG,2842,648,2194,1849,4043,2021-09-22
3173061002,JAKARTA BARAT,KALI DERES,SEMANAN,71354,20472,50882,38114,88996,2021-09-22
3172041007,JAKARTA UTARA,CILINCING,SEMPER BARAT,68587,17461,51126,39805,90931,2021-09-22
3172041005,JAKARTA UTARA,CILINCING,SEMPER TIMUR,36267,9842,26425,19855,46280,2021-09-22
3174071006,JAKARTA SELATAN,KEBAYORAN BARU,SENAYAN,2771,785,1986,1538,3524,2021-09-22
3171041001,JAKARTA PUSAT,SENEN,SENEN,6804,1794,5010,3959,8969,2021-09-22
3171031004,JAKARTA PUSAT,KEMAYORAN,SERDANG,29668,7847,21821,16578,38399,2021-09-22
3174021001,JAKARTA SELATAN,SETIA BUDI,SETIA BUDI,3023,794,2229,1758,3987,2021-09-22
3175101005,JAKARTA TIMUR,CIPAYUNG,SETU,20572,5719,14853,11155,26008,2021-09-22
3173071002,JAKARTA BARAT,PALMERAH,SLIPI,16591,4023,12568,9685,22253,2021-09-22
3173081004,JAKARTA BARAT,KEMBANGAN,SRENGSENG,45523,13011,32512,25145,57657,2021-09-22
3174091002,JAKARTA SELATAN,JAGAKARSA,SRENGSENG SAWAH,58196,13266,44930,35804,80734,2021-09-22
3173051003,JAKARTA BARAT,KEBON JERUK,SUKABUMI SELATAN,37033,11032,26001,18464,44465,2021-09-22
3173051002,JAKARTA BARAT,KEBON JERUK,SUKABUMI UTARA,38290,11732,26558,18419,44977,2021-09-22
3172041002,JAKARTA UTARA,CILINCING,SUKAPURA,53949,15599,38350,29507,67857,2021-09-22
3171031007,JAKARTA PUSAT,KEMAYORAN,SUMUR BATU,22717,6020,16697,12944,29641,2021-09-22
3172021004,JAKARTA UTARA,TANJUNG PRIOK,SUNGAI BAMBU,29876,7839,22037,16887,38924,2021-09-22
3172021006,JAKARTA UTARA,TANJUNG PRIOK,SUNTER AGUNG,71805,15935,55870,45615,101485,2021-09-22
3172021002,JAKARTA UTARA,TANJUNG PRIOK,SUNTER JAYA,63031,14998,48033,38994,87027,2021-09-22
3175091004,JAKARTA TIMUR,CIRACAS,SUSUKAN,38257,9496,28761,22192,50953,2021-09-22
3173031001,JAKARTA BARAT,TAMAN SARI,TAMAN SARI,14348,3460,10888,8677,19565,2021-09-22
3173041001,JAKARTA BARAT,TAMBORA,TAMBORA,10204,2848,7356,5427,12783,2021-09-22
3173041004,JAKARTA BARAT,TAMBORA,TANAH SEREAL,26387,5947,20440,15329,35769,2021-09-22
3171081004,JAKARTA PUSAT,JOHAR BARU,TANAH TINGGI,37693,8902,28791,21584,50375,2021-09-22
3173031004,JAKARTA BARAT,TAMAN SARI,TANGKI,13324,3251,10073,7914,17987,2021-09-22
3174091005,JAKARTA SELATAN,JAGAKARSA,TANJUNG BARAT,39770,10189,29581,22591,52172,2021-09-22
3173021005,JAKARTA BARAT,GROGOL PETAMBURAN,TANJUNG DUREN SELATAN,25337,6391,18946,15193,34139,2021-09-22
3173021002,JAKARTA BARAT,GROGOL PETAMBURAN,TANJUNG DUREN UTARA,17010,3929,13081,10553,23634,2021-09-22
3172021001,JAKARTA UTARA,TANJUNG PRIOK,TANJUNG PRIOK,34588,9028,25560,19187,44747,2021-09-22
3174011002,JAKARTA SELATAN,TEBET,TEBET BARAT,21194,4657,16537,13279,29816,2021-09-22
3174011001,JAKARTA SELATAN,TEBET,TEBET TIMUR,18199,3908,14291,11708,25999,2021-09-22
3173061003,JAKARTA BARAT,KALI DERES,TEGAL ALUR,83647,23519,60128,44861,104989,2021-09-22
3174031004,JAKARTA SELATAN,MAMPANG PRAPATAN,TEGAL PARANG,32401,9693,22708,16130,38838,2021-09-22
3173021003,JAKARTA BARAT,GROGOL PETAMBURAN,TOMANG,29605,7155,22450,17833,40283,2021-09-22
3172031005,JAKARTA UTARA,KOJA,TUGU SELATAN,39122,11105,28017,20218,48235,2021-09-22
3172031002,JAKARTA UTARA,KOJA,TUGU UTARA,67670,20346,47324,34187,81511,2021-09-22
3175061006,JAKARTA TIMUR,CAKUNG,UJUNG MENTENG,29934,6851,23083,17936,41019,2021-09-22
3174101005,JAKARTA SELATAN,PESANGGRAHAN,ULUJAMI,40544,12125,28419,21735,50154,2021-09-22
3175011006,JAKARTA TIMUR,MATRAMAN,UTAN KAYU SELATAN,33511,8548,24963,18858,43821,2021-09-22
3175011002,JAKARTA TIMUR,MATRAMAN,UTAN KAYU UTARA,28169,7850,20319,15144,35463,2021-09-22
3171031008,JAKARTA PUSAT,KEMAYORAN,UTAN PANJANG,29208,8217,20991,15643,36634,2021-09-22
3172021007,JAKARTA UTARA,TANJUNG PRIOK,WARAKAS,44401,10975,33426,25003,58429,2021-09-22
3173021007,JAKARTA BARAT,GROGOL PETAMBURAN,WIJAYA KUSUMA,38934,10825,28109,21918,50027,2021-09-22
3172051003,JAKARTA UTARA,PADEMANGAN,ANCOL,23947,7024,16923,12911,29834,2021-09-23
3173041007,JAKARTA BARAT,TAMBORA,ANGKE,29381,7985,21396,15810,37206,2021-09-23
3175041005,JAKARTA TIMUR,KRAMAT JATI,BALE KAMBANG,29074,9295,19779,13658,33437,2021-09-23
3175031003,JAKARTA TIMUR,JATINEGARA,BALI MESTER,9752,2693,7059,5410,12469,2021-09-23
3175101006,JAKARTA TIMUR,CIPAYUNG,BAMBU APUS,26285,6949,19336,14871,34207,2021-09-23
3174031002,JAKARTA SELATAN,MAMPANG PRAPATAN,BANGKA,21566,6336,15230,11671,26901,2021-09-23
3175051002,JAKARTA TIMUR,PASAR REBO,BARU,23886,5203,18683,15117,33800,2021-09-23
3175041004,JAKARTA TIMUR,KRAMAT JATI,BATU AMPAR,47898,15053,32845,23540,56385,2021-09-23
3171071002,JAKARTA PUSAT,TANAH ABANG,BENDUNGAN HILIR,21494,5651,15843,12218,28061,2021-09-23
3175031002,JAKARTA TIMUR,JATINEGARA,BIDARA CINA,36689,11358,25331,18345,43676,2021-09-23
3174101002,JAKARTA SELATAN,PESANGGRAHAN,BINTARO,53098,13915,39183,31243,70426,2021-09-23
3174011005,JAKARTA SELATAN,TEBET,BUKIT DURI,34183,9428,24755,18365,43120,2021-09-23
3171041006,JAKARTA PUSAT,SENEN,BUNGUR,18144,4887,13257,10148,23405,2021-09-23
3175061007,JAKARTA TIMUR,CAKUNG,CAKUNG BARAT,57724,14896,42828,32656,75484,2021-09-23
3175061004,JAKARTA TIMUR,CAKUNG,CAKUNG TIMUR,58287,14846,43441,33267,76708,2021-09-23
3175041007,JAKARTA TIMUR,KRAMAT JATI,CAWANG,32762,9289,23473,16962,40435,2021-09-23
3175101008,JAKARTA TIMUR,CIPAYUNG,CEGER,18932,4923,14009,10761,24770,2021-09-23
3171031006,JAKARTA PUSAT,KEMAYORAN,CEMPAKA BARU,32581,8904,23677,17170,40847,2021-09-23
3171051002,JAKARTA PUSAT,CEMPAKA PUTIH,CEMPAKA PUTIH BARAT,35885,9896,25989,20234,46223,2021-09-23
3171051001,JAKARTA PUSAT,CEMPAKA PUTIH,CEMPAKA PUTIH TIMUR,24292,6276,18016,14311,32327,2021-09-23
3173011001,JAKARTA BARAT,CENGKARENG,CENGKARENG BARAT,66284,17632,48652,37782,86434,2021-09-23
3173011006,JAKARTA BARAT,CENGKARENG,CENGKARENG TIMUR,81027,21048,59979,44748,104727,2021-09-23
3175091002,JAKARTA TIMUR,CIRACAS,CIBUBUR,66364,15453,50911,39576,90487,2021-09-23
3171011002,JAKARTA PUSAT,GAMBIR,CIDENG,15390,3736,11654,9401,21055,2021-09-23
3174091003,JAKARTA SELATAN,JAGAKARSA,CIGANJUR,38497,9726,28771,21762,50533,2021-09-23
3175051003,JAKARTA TIMUR,PASAR REBO,CIJANTUNG,41419,10099,31320,24196,55516,2021-09-23
3171061003,JAKARTA PUSAT,MENTENG,CIKINI,8274,1915,6359,4479,10838,2021-09-23
3174081006,JAKARTA SELATAN,PANCORAN,CIKOKO,10547,2463,8084,6225,14309,2021-09-23
3174061001,JAKARTA SELATAN,CILANDAK,CILANDAK BARAT,51752,12759,38993,30908,69901,2021-09-23
3174041003,JAKARTA SELATAN,PASAR MINGGU,CILANDAK TIMUR,25145,6196,18949,14976,33925,2021-09-23
3175101002,JAKARTA TIMUR,CIPAYUNG,CILANGKAP,27635,6865,20770,16029,36799,2021-09-23
3175041006,JAKARTA TIMUR,KRAMAT JATI,CILILITAN,40181,11739,28442,20956,49398,2021-09-23
3172041001,JAKARTA UTARA,CILINCING,CILINCING,43609,13005,30604,21667,52271,2021-09-23
3175101001,JAKARTA TIMUR,CIPAYUNG,CIPAYUNG,26104,6017,20087,16035,36122,2021-09-23
3174091006,JAKARTA SELATAN,JAGAKARSA,CIPEDAK,38303,9136,29167,22797,51964,2021-09-23
3174061005,JAKARTA SELATAN,CILANDAK,CIPETE SELATAN,26704,6846,19858,15687,35545,2021-09-23
3174071010,JAKARTA SELATAN,KEBAYORAN BARU,CIPETE UTARA,34102,8616,25486,19060,44546,2021-09-23
3175021003,JAKARTA TIMUR,PULO GADUNG,CIPINANG,39306,10121,29185,21944,51129,2021-09-23
3175031007,JAKARTA TIMUR,JATINEGARA,CIPINANG BESAR SELATAN,35212,10572,24640,17264,41904,2021-09-23
3175031008,JAKARTA TIMUR,JATINEGARA,CIPINANG BESAR UTARA,45319,13969,31350,22218,53568,2021-09-23
3175031005,JAKARTA TIMUR,JATINEGARA,CIPINANG CEMPEDAK,32824,9647,23177,17794,40971,2021-09-23
3175081005,JAKARTA TIMUR,MAKASAR,CIPINANG MELAYU,42308,11176,31132,24260,55392,2021-09-23
3175031006,JAKARTA TIMUR,JATINEGARA,CIPINANG MUARA,55243,15604,39639,29295,68934,2021-09-23
3174051003,JAKARTA SELATAN,KEBAYORAN LAMA,CIPULIR,39937,10821,29116,21172,50288,2021-09-23
3175091001,JAKARTA TIMUR,CIRACAS,CIRACAS,64594,15599,48995,37134,86129,2021-09-23
3175041003,JAKARTA TIMUR,KRAMAT JATI,DUKUH,24609,6195,18414,13915,32329,2021-09-23
3175071001,JAKARTA TIMUR,DUREN SAWIT,DUREN SAWIT,61160,17400,43760,32933,76693,2021-09-23
3174081004,JAKARTA SELATAN,PANCORAN,DUREN TIGA,28319,7429,20890,14040,34930,2021-09-23
3173051005,JAKARTA BARAT,KEBON JERUK,DURI KEPA,60138,15131,45007,35795,80802,2021-09-23
3173011002,JAKARTA BARAT,CENGKARENG,DURI KOSAMBI,77923,22898,55025,40482,95507,2021-09-23
3171011006,JAKARTA PUSAT,GAMBIR,DURI PULO,19610,5366,14244,10661,24905,2021-09-23
3173041011,JAKARTA BARAT,TAMBORA,DURI SELATAN,14259,3389,10870,8447,19317,2021-09-23
3173041003,JAKARTA BARAT,TAMBORA,DURI UTARA,19844,5008,14836,11032,25868,2021-09-23
3171081003,JAKARTA PUSAT,JOHAR BARU,GALUR,18243,4474,13769,10369,24138,2021-09-23
3171011001,JAKARTA PUSAT,GAMBIR,GAMBIR,2191,573,1618,1307,2925,2021-09-23
3174061004,JAKARTA SELATAN,CILANDAK,GANDARIA SELATAN,22119,5805,16314,12589,28903,2021-09-23
3174071009,JAKARTA SELATAN,KEBAYORAN BARU,GANDARIA UTARA,39922,10705,29217,22358,51575,2021-09-23
3175051001,JAKARTA TIMUR,PASAR REBO,GEDONG,35755,9183,26572,20566,47138,2021-09-23
3171071001,JAKARTA PUSAT,TANAH ABANG,GELORA,3127,795,2332,1722,4054,2021-09-23
3173031007,JAKARTA BARAT,TAMAN SARI,GLODOK,7837,1640,6197,5232,11429,2021-09-23
3171061004,JAKARTA PUSAT,MENTENG,GONDANGDIA,4100,1067,3033,2599,5632,2021-09-23
3173021001,JAKARTA BARAT,GROGOL PETAMBURAN,GROGOL,16876,4299,12577,9715,22292,2021-09-23
3174051005,JAKARTA SELATAN,KEBAYORAN LAMA,GROGOL SELATAN,44251,12250,32001,24279,56280,2021-09-23
3174051004,JAKARTA SELATAN,KEBAYORAN LAMA,GROGOL UTARA,42494,11481,31013,23615,54628,2021-09-23
3174021007,JAKARTA SELATAN,SETIA BUDI,GUNTUR,3985,963,3022,2517,5539,2021-09-23
3174071002,JAKARTA SELATAN,KEBAYORAN BARU,GUNUNG,9436,2285,7151,5757,12908,2021-09-23
3171031005,JAKARTA PUSAT,KEMAYORAN,GUNUNG SAHARI SELATAN,19199,5091,14108,10999,25107,2021-09-23
3171021004,JAKARTA PUSAT,SAWAH BESAR,GUNUNG SAHARI UTARA,16650,3734,12916,10740,23656,2021-09-23
3175081004,JAKARTA TIMUR,MAKASAR,HALIM PERDANA KUSUMAH,28363,4883,23480,20349,43829,2021-09-23
3171031003,JAKARTA PUSAT,KEMAYORAN,HARAPAN MULIA,22557,6059,16498,12433,28931,2021-09-23
3174091001,JAKARTA SELATAN,JAGAKARSA,JAGAKARSA,62389,15590,46799,36570,83369,2021-09-23
3175021007,JAKARTA TIMUR,PULO GADUNG,JATI,32757,8206,24551,19376,43927,2021-09-23
3174041002,JAKARTA SELATAN,PASAR MINGGU,JATI PADANG,37502,10289,27213,21280,48493,2021-09-23
3173071004,JAKARTA BARAT,PALMERAH,JATI PULO,28738,7346,21392,15706,37098,2021-09-23
3175061001,JAKARTA TIMUR,CAKUNG,JATINEGARA,84160,23235,60925,45903,106828,2021-09-23
3175021004,JAKARTA TIMUR,PULO GADUNG,JATINEGARA KAUM,24632,6114,18518,13241,31759,2021-09-23
3173021004,JAKARTA BARAT,GROGOL PETAMBURAN,JELAMBAR,30266,7445,22821,18107,40928,2021-09-23
3173021006,JAKARTA BARAT,GROGOL PETAMBURAN,JELAMBAR BARU,38246,9583,28663,22760,51423,2021-09-23
3173041006,JAKARTA BARAT,TAMBORA,JEMBATAN BESI,29314,9174,20140,13812,33952,2021-09-23
3173041008,JAKARTA BARAT,TAMBORA,JEMBATAN LIMA,21021,6314,14707,10534,25241,2021-09-23
3173081005,JAKARTA BARAT,KEMBANGAN,JOGLO,40839,10687,30152,23118,53270,2021-09-23
3171081001,JAKARTA PUSAT,JOHAR BARU,JOHAR BARU,37488,8887,28601,22261,50862,2021-09-23
3173041002,JAKARTA BARAT,TAMBORA,KALI ANYAR,23856,6275,17581,12692,30273,2021-09-23
3172041004,JAKARTA UTARA,CILINCING,KALIBARU,67684,23175,44509,29223,73732,2021-09-23
3174081002,JAKARTA SELATAN,PANCORAN,KALIBATA,41994,12718,29276,19679,48955,2021-09-23
3173061001,JAKARTA BARAT,KALI DERES,KALIDERES,72447,19495,52952,41866,94818,2021-09-23
3175051004,JAKARTA TIMUR,PASAR REBO,KALISARI,43212,10534,32678,25476,58154,2021-09-23
3173061004,JAKARTA BARAT,KALI DERES,KAMAL,53783,16387,37396,27572,64968,2021-09-23
3172011002,JAKARTA UTARA,PENJARINGAN,KAMAL MUARA,12930,2605,10325,8369,18694,2021-09-23
3171071007,JAKARTA PUSAT,TANAH ABANG,KAMPUNG BALI,11358,3239,8119,5662,13781,2021-09-23
3175031001,JAKARTA TIMUR,JATINEGARA,KAMPUNG MELAYU,25717,8322,17395,12635,30030,2021-09-23
3171081002,JAKARTA PUSAT,JOHAR BARU,KAMPUNG RAWA,21237,4411,16826,12433,29259,2021-09-23
3175041002,JAKARTA TIMUR,KRAMAT JATI,KAMPUNG TENGAH,43993,13865,30128,21753,51881,2021-09-23
3173011005,JAKARTA BARAT,CENGKARENG,KAPUK,134466,41084,93382,67576,160958,2021-09-23
3172011003,JAKARTA UTARA,PENJARINGAN,KAPUK MUARA,35781,8355,27426,22839,50265,2021-09-23
3171021002,JAKARTA PUSAT,SAWAH BESAR,KARANG ANYAR,25761,6367,19394,14910,34304,2021-09-23
3174021004,JAKARTA SELATAN,SETIA BUDI,KARET,9623,2366,7257,5543,12800,2021-09-23
3174021003,JAKARTA SELATAN,SETIA BUDI,KARET KUNINGAN,16055,3962,12093,9531,21624,2021-09-23
3174021002,JAKARTA SELATAN,SETIA BUDI,KARET SEMANGGI,2770,656,2114,1763,3877,2021-09-23
3171071003,JAKARTA PUSAT,TANAH ABANG,KARET TENGSIN,19271,4901,14370,10517,24887,2021-09-23
3171021003,JAKARTA PUSAT,SAWAH BESAR,KARTINI,22292,5641,16651,13240,29891,2021-09-23
3175011003,JAKARTA TIMUR,MATRAMAN,KAYU MANIS,25284,7202,18082,12900,30982,2021-09-23
3175021006,JAKARTA TIMUR,PULO GADUNG,KAYU PUTIH,40696,9948,30748,24770,55518,2021-09-23
3173031006,JAKARTA BARAT,TAMAN SARI,KEAGUNGAN,17387,4451,12936,9811,22747,2021-09-23
3174041007,JAKARTA SELATAN,PASAR MINGGU,KEBAGUSAN,44552,12721,31831,24110,55941,2021-09-23
3174051006,JAKARTA SELATAN,KEBAYORAN LAMA,KEBAYORAN LAMA SELATAN,41212,10311,30901,24081,54982,2021-09-23
3174051001,JAKARTA SELATAN,KEBAYORAN LAMA,KEBAYORAN LAMA UTARA,42422,11734,30688,23321,54009,2021-09-23
3174011004,JAKARTA SELATAN,TEBET,KEBON BARU,35165,9080,26085,19750,45835,2021-09-23
3172021005,JAKARTA UTARA,TANJUNG PRIOK,KEBON BAWANG,50952,13316,37636,28608,66244,2021-09-23
3173051001,JAKARTA BARAT,KEBON JERUK,KEBON JERUK,53887,15612,38275,28745,67020,2021-09-23
3171071006,JAKARTA PUSAT,TANAH ABANG,KEBON KACANG,21531,6567,14964,10711,25675,2021-09-23
3171011005,JAKARTA PUSAT,GAMBIR,KEBON KELAPA,10163,2657,7506,5836,13342,2021-09-23
3171031002,JAKARTA PUSAT,KEMAYORAN,KEBON KOSONG,30019,8368,21651,16408,38059,2021-09-23
3175011005,JAKARTA TIMUR,MATRAMAN,KEBON MANGGIS,16490,4186,12304,9299,21603,2021-09-23
3171071005,JAKARTA PUSAT,TANAH ABANG,KEBON MELATI,32206,10580,21626,14503,36129,2021-09-23
3175081003,JAKARTA TIMUR,MAKASAR,KEBON PALA,46614,12292,34322,25777,60099,2021-09-23
3171061005,JAKARTA PUSAT,MENTENG,KEBON SIRIH,12299,3387,8912,6453,15365,2021-09-23
3173011004,JAKARTA BARAT,CENGKARENG,KEDAUNG KALI ANGKE,32612,8118,24494,18927,43421,2021-09-23
3173051007,JAKARTA BARAT,KEBON JERUK,KEDOYA SELATAN,32165,8290,23875,18209,42084,2021-09-23
3173051006,JAKARTA BARAT,KEBON JERUK,KEDOYA UTARA,45740,11083,34657,27652,62309,2021-09-23
3173051004,JAKARTA BARAT,KEBON JERUK,KELAPA DUA,23565,6734,16831,12917,29748,2021-09-23
3175091003,JAKARTA TIMUR,CIRACAS,KELAPA DUA WETAN,46875,10687,36188,27850,64038,2021-09-23
3172061003,JAKARTA UTARA,KELAPA GADING,KELAPA GADING BARAT,35717,7570,28147,23896,52043,2021-09-23
3172061001,JAKARTA UTARA,KELAPA GADING,KELAPA GADING TIMUR,33592,6385,27207,23483,50690,2021-09-23
3173071005,JAKARTA BARAT,PALMERAH,KEMANGGISAN,32139,8169,23970,18128,42098,2021-09-23
3171031001,JAKARTA PUSAT,KEMAYORAN,KEMAYORAN,20708,5430,15278,11738,27016,2021-09-23
3173081006,JAKARTA BARAT,KEMBANGAN,KEMBANGAN SELATAN,27130,7121,20009,16184,36193,2021-09-23
3173081001,JAKARTA BARAT,KEMBANGAN,KEMBANGAN UTARA,54451,14840,39611,30744,70355,2021-09-23
3171041002,JAKARTA PUSAT,SENEN,KENARI,9579,2353,7226,5712,12938,2021-09-23
3173041005,JAKARTA BARAT,TAMBORA,KERENDANG,19973,5404,14569,10688,25257,2021-09-23
3175071003,JAKARTA TIMUR,DUREN SAWIT,KLENDER,69978,20953,49025,35594,84619,2021-09-23
3172031001,JAKARTA UTARA,KOJA,KOJA,28175,8380,19795,14966,34761,2021-09-23
3173071006,JAKARTA BARAT,PALMERAH,KOTA BAMBU SELATAN,21158,5785,15373,11090,26463,2021-09-23
3173071003,JAKARTA BARAT,PALMERAH,KOTA BAMBU UTARA,24995,6989,18006,12867,30873,2021-09-23
3171041004,JAKARTA PUSAT,SENEN,KRAMAT,28835,8383,20452,14076,34528,2021-09-23
3175041001,JAKARTA TIMUR,KRAMAT JATI,KRAMAT JATI,34144,9568,24576,18237,42813,2021-09-23
3174071003,JAKARTA SELATAN,KEBAYORAN BARU,KRAMAT PELA,14413,3514,10899,8527,19426,2021-09-23
3173031002,JAKARTA BARAT,TAMAN SARI,KRUKUT,19244,5020,14224,10608,24832,2021-09-23
3174031005,JAKARTA SELATAN,MAMPANG PRAPATAN,KUNINGAN BARAT,12785,3205,9580,7327,16907,2021-09-23
3174021008,JAKARTA SELATAN,SETIA BUDI,KUNINGAN TIMUR,6008,1562,4446,3537,7983,2021-09-23
3171041005,JAKARTA PUSAT,SENEN,KWITANG,15486,4353,11133,8385,19518,2021-09-23
3172031003,JAKARTA UTARA,KOJA,LAGOA,59065,17765,41300,29623,70923,2021-09-23
3174061002,JAKARTA SELATAN,CILANDAK,LEBAK BULUS,37626,9854,27772,21873,49645,2021-09-23
3174091004,JAKARTA SELATAN,JAGAKARSA,LENTENG AGUNG,53946,14643,39303,29534,68837,2021-09-23
3175101007,JAKARTA TIMUR,CIPAYUNG,LUBANG BUAYA,63547,15648,47899,36908,84807,2021-09-23
3175081001,JAKARTA TIMUR,MAKASAR,MAKASAR,34390,8880,25510,20046,45556,2021-09-23
3175071006,JAKARTA TIMUR,DUREN SAWIT,MALAKA JAYA,30927,7720,23207,18074,41281,2021-09-23
3175071005,JAKARTA TIMUR,DUREN SAWIT,MALAKA SARI,27530,6429,21101,16713,37814,2021-09-23
3174031001,JAKARTA SELATAN,MAMPANG PRAPATAN,MAMPANG PRAPATAN,18159,5004,13155,10053,23208,2021-09-23
3173031005,JAKARTA BARAT,TAMAN SARI,MANGGA BESAR,7707,1657,6050,4902,10952,2021-09-23
3171021005,JAKARTA PUSAT,SAWAH BESAR,MANGGA DUA SELATAN,27442,7005,20437,15804,36241,2021-09-23
3174011007,JAKARTA SELATAN,TEBET,MANGGARAI,28373,6815,21558,15973,37531,2021-09-23
3174011006,JAKARTA SELATAN,TEBET,MANGGARAI SELATAN,23075,5575,17500,13500,31000,2021-09-23
3173031003,JAKARTA BARAT,TAMAN SARI,MAPHAR,16461,4165,12296,9516,21812,2021-09-23
3172041003,JAKARTA UTARA,CILINCING,MARUNDA,28943,8128,20815,14210,35025,2021-09-23
3174071001,JAKARTA SELATAN,KEBAYORAN BARU,MELAWAI,2627,600,2027,1747,3774,2021-09-23
3171061001,JAKARTA PUSAT,MENTENG,MENTENG,25624,7327,18297,13379,31676,2021-09-23
3174021005,JAKARTA SELATAN,SETIA BUDI,MENTENG ATAS,27816,6784,21032,15967,36999,2021-09-23
3174011003,JAKARTA SELATAN,TEBET,MENTENG DALAM,36028,9441,26587,20360,46947,2021-09-23
3173081003,JAKARTA BARAT,KEMBANGAN,MERUYA SELATAN,32130,8637,23493,18108,41601,2021-09-23
3173081002,JAKARTA BARAT,KEMBANGAN,MERUYA UTARA,43752,11691,32061,25740,57801,2021-09-23
3175101004,JAKARTA TIMUR,CIPAYUNG,MUNJUL,23871,5967,17904,14017,31921,2021-09-23
3172051002,JAKARTA UTARA,PADEMANGAN,PADEMANGAN BARAT,74240,21950,52290,38933,91223,2021-09-23
3172051001,JAKARTA UTARA,PADEMANGAN,PADEMANGAN TIMUR,37736,8515,29221,23681,52902,2021-09-23
3175011004,JAKARTA TIMUR,MATRAMAN,PAL MERIAM,19769,5639,14130,10534,24664,2021-09-23
3173071001,JAKARTA BARAT,PALMERAH,PALMERAH,63011,17799,45212,33404,78616,2021-09-23
3174081001,JAKARTA SELATAN,PANCORAN,PANCORAN,19421,5500,13921,10232,24153,2021-09-23
3172021003,JAKARTA UTARA,TANJUNG PRIOK,PAPANGGO,39097,10027,29070,22229,51299,2021-09-23
3171021001,JAKARTA PUSAT,SAWAH BESAR,PASAR BARU,12035,2810,9225,7729,16954,2021-09-23
3174021006,JAKARTA SELATAN,SETIA BUDI,PASAR MANGGIS,26752,7062,19690,15069,34759,2021-09-23
3174041001,JAKARTA SELATAN,PASAR MINGGU,PASAR MINGGU,24821,6312,18509,14515,33024,2021-09-23
3171041003,JAKARTA PUSAT,SENEN,PASEBAN,23533,6487,17046,12705,29751,2021-09-23
3173061005,JAKARTA BARAT,KALI DERES,PEGADUNGAN,75587,19218,56369,45560,101929,2021-09-23
3171061002,JAKARTA PUSAT,MENTENG,PEGANGSAAN,23455,6633,16822,11884,28706,2021-09-23
3172061002,JAKARTA UTARA,KELAPA GADING,PEGANGSAAN DUA,49976,10042,39934,33997,73931,2021-09-23
3172011004,JAKARTA UTARA,PENJARINGAN,PEJAGALAN,74578,19744,54834,43662,98496,2021-09-23
3174041006,JAKARTA SELATAN,PASAR MINGGU,PEJATEN BARAT,37346,10328,27018,21069,48087,2021-09-23
3174041005,JAKARTA SELATAN,PASAR MINGGU,PEJATEN TIMUR,57656,16943,40713,30454,71167,2021-09-23
3175051005,JAKARTA TIMUR,PASAR REBO,PEKAYON,43250,10580,32670,25068,57738,2021-09-23
3173041009,JAKARTA BARAT,TAMBORA,PEKOJAN,23587,5880,17707,13752,31459,2021-09-23
3174031003,JAKARTA SELATAN,MAMPANG PRAPATAN,PELA MAMPANG,43522,11764,31758,24664,56422,2021-09-23
3174081005,JAKARTA SELATAN,PANCORAN,PENGADEGAN,21478,5136,16342,11842,28184,2021-09-23
3175061003,JAKARTA TIMUR,CAKUNG,PENGGILINGAN,99255,30054,69201,49578,118779,2021-09-23
3172011001,JAKARTA UTARA,PENJARINGAN,PENJARINGAN,88308,27998,60310,43411,103721,2021-09-23
3174101001,JAKARTA SELATAN,PESANGGRAHAN,PESANGGRAHAN,27545,6386,21159,16899,38058,2021-09-23
3171071004,JAKARTA PUSAT,TANAH ABANG,PETAMBURAN,33271,11006,22265,15096,37361,2021-09-23
3174071008,JAKARTA SELATAN,KEBAYORAN BARU,PETOGOGAN,11499,2986,8513,6466,14979,2021-09-23
3171011004,JAKARTA PUSAT,GAMBIR,PETOJO SELATAN,14692,4212,10480,8286,18766,2021-09-23
3171011003,JAKARTA PUSAT,GAMBIR,PETOJO UTARA,17458,4769,12689,9612,22301,2021-09-23
3174101004,JAKARTA SELATAN,PESANGGRAHAN,PETUKANGAN SELATAN,37187,10014,27173,21497,48670,2021-09-23
3174101003,JAKARTA SELATAN,PESANGGRAHAN,PETUKANGAN UTARA,53716,15043,38673,29803,68476,2021-09-23
3175081002,JAKARTA TIMUR,MAKASAR,PINANG RANTI,27198,7493,19705,15063,34768,2021-09-23
3173031008,JAKARTA BARAT,TAMAN SARI,PINANGSIA,10729,2493,8236,6383,14619,2021-09-23
3175011001,JAKARTA TIMUR,MATRAMAN,PISANGAN BARU,31776,9005,22771,15905,38676,2021-09-23
3175021002,JAKARTA TIMUR,PULO GADUNG,PISANGAN TIMUR,41011,10382,30629,23865,54494,2021-09-23
3172011005,JAKARTA UTARA,PENJARINGAN,PLUIT,47783,11494,36289,29918,66207,2021-09-23
3175071002,JAKARTA TIMUR,DUREN SAWIT,PONDOK BAMBU,61550,17429,44121,33435,77556,2021-09-23
3175071004,JAKARTA TIMUR,DUREN SAWIT,PONDOK KELAPA,72015,18504,53511,41133,94644,2021-09-23
3175071007,JAKARTA TIMUR,DUREN SAWIT,PONDOK KOPI,35367,9752,25615,18423,44038,2021-09-23
3174061003,JAKARTA SELATAN,CILANDAK,PONDOK LABU,46464,10827,35637,28207,63844,2021-09-23
3174051002,JAKARTA SELATAN,KEBAYORAN LAMA,PONDOK PINANG,56169,14209,41960,32646,74606,2021-09-23
3175101003,JAKARTA TIMUR,CIPAYUNG,PONDOK RANGGON,25574,6680,18894,14703,33597,2021-09-23
3101011003,KAB.ADM.KEP.SERIBU,KEP. SERIBU UTARA,PULAU HARAPAN,2060,285,1775,1144,2919,2021-09-23
3101011002,KAB.ADM.KEP.SERIBU,KEP. SERIBU UTARA,PULAU KELAPA,5528,746,4782,3211,7993,2021-09-23
3101011001,KAB.ADM.KEP.SERIBU,KEP. SERIBU UTARA,PULAU PANGGANG,5450,654,4796,2857,7653,2021-09-23
3101021003,KAB.ADM.KEP.SERIBU,KEP. SERIBU SELATAN,PULAU PARI,2765,252,2513,2098,4611,2021-09-23
3101021002,KAB.ADM.KEP.SERIBU,KEP. SERIBU SELATAN,PULAU TIDUNG,4553,497,4056,3062,7118,2021-09-23
3101021001,KAB.ADM.KEP.SERIBU,KEP. SERIBU SELATAN,PULAU UNTUNG JAWA,1941,233,1708,1457,3165,2021-09-23
3174071007,JAKARTA SELATAN,KEBAYORAN BARU,PULO,5835,1280,4555,3820,8375,2021-09-23
3175021001,JAKARTA TIMUR,PULO GADUNG,PULO GADUNG,34422,9383,25039,18870,43909,2021-09-23
3175061005,JAKARTA TIMUR,CAKUNG,PULO GEBANG,97301,25105,72196,52316,124512,2021-09-23
3174041004,JAKARTA SELATAN,PASAR MINGGU,RAGUNAN,39616,9986,29630,23373,53003,2021-09-23
3175091005,JAKARTA TIMUR,CIRACAS,RAMBUTAN,36771,11015,25756,18887,44643,2021-09-23
3172031006,JAKARTA UTARA,KOJA,RAWA BADAK SELATAN,42179,12624,29555,21170,50725,2021-09-23
3172031004,JAKARTA UTARA,KOJA,RAWA BADAK UTARA,34408,10107,24301,18101,42402,2021-09-23
3174071005,JAKARTA SELATAN,KEBAYORAN BARU,RAWA BARAT,5625,1269,4356,3541,7897,2021-09-23
3173011003,JAKARTA BARAT,CENGKARENG,RAWA BUAYA,63799,17314,46485,33557,80042,2021-09-23
3175031004,JAKARTA TIMUR,JATINEGARA,RAWA BUNGA,21434,6554,14880,11002,25882,2021-09-23
3174081003,JAKARTA SELATAN,PANCORAN,RAWA JATI,20509,5135,15374,10908,26282,2021-09-23
3175061002,JAKARTA TIMUR,CAKUNG,RAWA TERATE,24637,5804,18833,14207,33040,2021-09-23
3175021005,JAKARTA TIMUR,PULO GADUNG,RAWAMANGUN,37612,9826,27786,21462,49248,2021-09-23
3171051003,JAKARTA PUSAT,CEMPAKA PUTIH,RAWASARI,21967,5836,16131,12464,28595,2021-09-23
3173041010,JAKARTA BARAT,TAMBORA,ROA MALAKA,3484,735,2749,2260,5009,2021-09-23
3172041006,JAKARTA UTARA,CILINCING,ROROTAN,41668,10892,30776,22948,53724,2021-09-23
3174071004,JAKARTA SELATAN,KEBAYORAN BARU,SELONG,2842,645,2197,1850,4047,2021-09-23
3173061002,JAKARTA BARAT,KALI DERES,SEMANAN,71354,20320,51034,38373,89407,2021-09-23
3172041007,JAKARTA UTARA,CILINCING,SEMPER BARAT,68587,17328,51259,39858,91117,2021-09-23
3172041005,JAKARTA UTARA,CILINCING,SEMPER TIMUR,36267,9767,26500,19892,46392,2021-09-23
3174071006,JAKARTA SELATAN,KEBAYORAN BARU,SENAYAN,2771,783,1988,1538,3526,2021-09-23
3171041001,JAKARTA PUSAT,SENEN,SENEN,6804,1782,5022,3966,8988,2021-09-23
3171031004,JAKARTA PUSAT,KEMAYORAN,SERDANG,29668,7808,21860,16606,38466,2021-09-23
3174021001,JAKARTA SELATAN,SETIA BUDI,SETIA BUDI,3023,793,2230,1759,3989,2021-09-23
3175101005,JAKARTA TIMUR,CIPAYUNG,SETU,20572,5691,14881,11178,26059,2021-09-23
3173071002,JAKARTA BARAT,PALMERAH,SLIPI,16591,4001,12590,9695,22285,2021-09-23
3173081004,JAKARTA BARAT,KEMBANGAN,SRENGSENG,45523,12929,32594,25181,57775,2021-09-23
3174091002,JAKARTA SELATAN,JAGAKARSA,SRENGSENG SAWAH,58196,13105,45091,35853,80944,2021-09-23
3173051003,JAKARTA BARAT,KEBON JERUK,SUKABUMI SELATAN,37033,10954,26079,18540,44619,2021-09-23
3173051002,JAKARTA BARAT,KEBON JERUK,SUKABUMI UTARA,38290,11706,26584,18445,45029,2021-09-23
3172041002,JAKARTA UTARA,CILINCING,SUKAPURA,53949,15489,38460,29534,67994,2021-09-23
3171031007,JAKARTA PUSAT,KEMAYORAN,SUMUR BATU,22717,5975,16742,12957,29699,2021-09-23
3172021004,JAKARTA UTARA,TANJUNG PRIOK,SUNGAI BAMBU,29876,7798,22078,16925,39003,2021-09-23
3172021006,JAKARTA UTARA,TANJUNG PRIOK,SUNTER AGUNG,71805,15873,55932,45707,101639,2021-09-23
3172021002,JAKARTA UTARA,TANJUNG PRIOK,SUNTER JAYA,63031,14876,48155,39043,87198,2021-09-23
3175091004,JAKARTA TIMUR,CIRACAS,SUSUKAN,38257,9460,28797,22225,51022,2021-09-23
3173031001,JAKARTA BARAT,TAMAN SARI,TAMAN SARI,14348,3457,10891,8683,19574,2021-09-23
3173041001,JAKARTA BARAT,TAMBORA,TAMBORA,10204,2836,7368,5437,12805,2021-09-23
3173041004,JAKARTA BARAT,TAMBORA,TANAH SEREAL,26387,5925,20462,15365,35827,2021-09-23
3171081004,JAKARTA PUSAT,JOHAR BARU,TANAH TINGGI,37693,8828,28865,21625,50490,2021-09-23
3173031004,JAKARTA BARAT,TAMAN SARI,TANGKI,13324,3241,10083,7927,18010,2021-09-23
3174091005,JAKARTA SELATAN,JAGAKARSA,TANJUNG BARAT,39770,10070,29700,22625,52325,2021-09-23
3173021005,JAKARTA BARAT,GROGOL PETAMBURAN,TANJUNG DUREN SELATAN,25337,6323,19014,15220,34234,2021-09-23
3173021002,JAKARTA BARAT,GROGOL PETAMBURAN,TANJUNG DUREN UTARA,17010,3916,13094,10576,23670,2021-09-23
3172021001,JAKARTA UTARA,TANJUNG PRIOK,TANJUNG PRIOK,34588,8983,25605,19252,44857,2021-09-23
3174011002,JAKARTA SELATAN,TEBET,TEBET BARAT,21194,4619,16575,13297,29872,2021-09-23
3174011001,JAKARTA SELATAN,TEBET,TEBET TIMUR,18199,3874,14325,11722,26047,2021-09-23
3173061003,JAKARTA BARAT,KALI DERES,TEGAL ALUR,83647,23354,60293,45325,105618,2021-09-23
3174031004,JAKARTA SELATAN,MAMPANG PRAPATAN,TEGAL PARANG,32401,9651,22750,16155,38905,2021-09-23
3173021003,JAKARTA BARAT,GROGOL PETAMBURAN,TOMANG,29605,7091,22514,17856,40370,2021-09-23
3172031005,JAKARTA UTARA,KOJA,TUGU SELATAN,39122,11062,28060,20285,48345,2021-09-23
3172031002,JAKARTA UTARA,KOJA,TUGU UTARA,67670,20203,47467,34286,81753,2021-09-23
3175061006,JAKARTA TIMUR,CAKUNG,UJUNG MENTENG,29934,6802,23132,17961,41093,2021-09-23
3174101005,JAKARTA SELATAN,PESANGGRAHAN,ULUJAMI,40544,12017,28527,21760,50287,2021-09-23
3175011006,JAKARTA TIMUR,MATRAMAN,UTAN KAYU SELATAN,33511,8470,25041,18883,43924,2021-09-23
3175011002,JAKARTA TIMUR,MATRAMAN,UTAN KAYU UTARA,28169,7797,20372,15185,35557,2021-09-23
3171031008,JAKARTA PUSAT,KEMAYORAN,UTAN PANJANG,29208,8178,21030,15667,36697,2021-09-23
3172021007,JAKARTA UTARA,TANJUNG PRIOK,WARAKAS,44401,10917,33484,25069,58553,2021-09-23
3173021007,JAKARTA BARAT,GROGOL PETAMBURAN,WIJAYA KUSUMA,38934,10779,28155,21973,50128,2021-09-23
3172051003,JAKARTA UTARA,PADEMANGAN,ANCOL,23947,6959,16988,12982,29970,2021-09-24
3173041007,JAKARTA BARAT,TAMBORA,ANGKE,29381,7877,21504,15905,37409,2021-09-24
3175041005,JAKARTA TIMUR,KRAMAT JATI,BALE KAMBANG,29074,9179,19895,13759,33654,2021-09-24
3175031003,JAKARTA TIMUR,JATINEGARA,BALI MESTER,9752,2651,7101,5454,12555,2021-09-24
3175101006,JAKARTA TIMUR,CIPAYUNG,BAMBU APUS,26285,6834,19451,14944,34395,2021-09-24
3174031002,JAKARTA SELATAN,MAMPANG PRAPATAN,BANGKA,21566,6263,15303,11764,27067,2021-09-24
3175051002,JAKARTA TIMUR,PASAR REBO,BARU,23886,5134,18752,15200,33952,2021-09-24
3175041004,JAKARTA TIMUR,KRAMAT JATI,BATU AMPAR,47898,14853,33045,23750,56795,2021-09-24
3171071002,JAKARTA PUSAT,TANAH ABANG,BENDUNGAN HILIR,21494,5539,15955,12272,28227,2021-09-24
3175031002,JAKARTA TIMUR,JATINEGARA,BIDARA CINA,36689,11133,25556,18563,44119,2021-09-24
3174101002,JAKARTA SELATAN,PESANGGRAHAN,BINTARO,53098,13699,39399,31374,70773,2021-09-24
3174011005,JAKARTA SELATAN,TEBET,BUKIT DURI,34183,9265,24918,18529,43447,2021-09-24
3171041006,JAKARTA PUSAT,SENEN,BUNGUR,18144,4817,13327,10234,23561,2021-09-24
3175061007,JAKARTA TIMUR,CAKUNG,CAKUNG BARAT,57724,14761,42963,32819,75782,2021-09-24
3175061004,JAKARTA TIMUR,CAKUNG,CAKUNG TIMUR,58287,14728,43559,33346,76905,2021-09-24
3175041007,JAKARTA TIMUR,KRAMAT JATI,CAWANG,32762,9174,23588,17089,40677,2021-09-24
3175101008,JAKARTA TIMUR,CIPAYUNG,CEGER,18932,4804,14128,10882,25010,2021-09-24
3171031006,JAKARTA PUSAT,KEMAYORAN,CEMPAKA BARU,32581,8802,23779,17324,41103,2021-09-24
3171051002,JAKARTA PUSAT,CEMPAKA PUTIH,CEMPAKA PUTIH BARAT,35885,9799,26086,20336,46422,2021-09-24
3171051001,JAKARTA PUSAT,CEMPAKA PUTIH,CEMPAKA PUTIH TIMUR,24292,6204,18088,14399,32487,2021-09-24
3173011001,JAKARTA BARAT,CENGKARENG,CENGKARENG BARAT,66284,17371,48913,37935,86848,2021-09-24
3173011006,JAKARTA BARAT,CENGKARENG,CENGKARENG TIMUR,81027,20796,60231,45087,105318,2021-09-24
3175091002,JAKARTA TIMUR,CIRACAS,CIBUBUR,66364,15136,51228,39795,91023,2021-09-24
3171011002,JAKARTA PUSAT,GAMBIR,CIDENG,15390,3677,11713,9435,21148,2021-09-24
3174091003,JAKARTA SELATAN,JAGAKARSA,CIGANJUR,38497,9538,28959,21937,50896,2021-09-24
3175051003,JAKARTA TIMUR,PASAR REBO,CIJANTUNG,41419,9988,31431,24329,55760,2021-09-24
3171061003,JAKARTA PUSAT,MENTENG,CIKINI,8274,1879,6395,4497,10892,2021-09-24
3174081006,JAKARTA SELATAN,PANCORAN,CIKOKO,10547,2431,8116,6277,14393,2021-09-24
3174061001,JAKARTA SELATAN,CILANDAK,CILANDAK BARAT,51752,12603,39149,31152,70301,2021-09-24
3174041003,JAKARTA SELATAN,PASAR MINGGU,CILANDAK TIMUR,25145,6100,19045,15061,34106,2021-09-24
3175101002,JAKARTA TIMUR,CIPAYUNG,CILANGKAP,27635,6798,20837,16104,36941,2021-09-24
3175041006,JAKARTA TIMUR,KRAMAT JATI,CILILITAN,40181,11573,28608,21099,49707,2021-09-24
3172041001,JAKARTA UTARA,CILINCING,CILINCING,43609,12911,30698,21829,52527,2021-09-24
3175101001,JAKARTA TIMUR,CIPAYUNG,CIPAYUNG,26104,5923,20181,16131,36312,2021-09-24
3174091006,JAKARTA SELATAN,JAGAKARSA,CIPEDAK,38303,8999,29304,22873,52177,2021-09-24
3174061005,JAKARTA SELATAN,CILANDAK,CIPETE SELATAN,26704,6769,19935,15797,35732,2021-09-24
3174071010,JAKARTA SELATAN,KEBAYORAN BARU,CIPETE UTARA,34102,8486,25616,19160,44776,2021-09-24
3175021003,JAKARTA TIMUR,PULO GADUNG,CIPINANG,39306,9978,29328,22066,51394,2021-09-24
3175031007,JAKARTA TIMUR,JATINEGARA,CIPINANG BESAR SELATAN,35212,10456,24756,17360,42116,2021-09-24
3175031008,JAKARTA TIMUR,JATINEGARA,CIPINANG BESAR UTARA,45319,13806,31513,22337,53850,2021-09-24
3175031005,JAKARTA TIMUR,JATINEGARA,CIPINANG CEMPEDAK,32824,9518,23306,17888,41194,2021-09-24
3175081005,JAKARTA TIMUR,MAKASAR,CIPINANG MELAYU,42308,11063,31245,24385,55630,2021-09-24
3175031006,JAKARTA TIMUR,JATINEGARA,CIPINANG MUARA,55243,15427,39816,29454,69270,2021-09-24
3174051003,JAKARTA SELATAN,KEBAYORAN LAMA,CIPULIR,39937,10705,29232,21295,50527,2021-09-24
3175091001,JAKARTA TIMUR,CIRACAS,CIRACAS,64594,15386,49208,37294,86502,2021-09-24
3175041003,JAKARTA TIMUR,KRAMAT JATI,DUKUH,24609,6111,18498,14043,32541,2021-09-24
3175071001,JAKARTA TIMUR,DUREN SAWIT,DUREN SAWIT,61160,17183,43977,33100,77077,2021-09-24
3174081004,JAKARTA SELATAN,PANCORAN,DUREN TIGA,28319,7328,20991,14215,35206,2021-09-24
3173051005,JAKARTA BARAT,KEBON JERUK,DURI KEPA,60138,14802,45336,35933,81269,2021-09-24
3173011002,JAKARTA BARAT,CENGKARENG,DURI KOSAMBI,77923,22486,55437,40735,96172,2021-09-24
3171011006,JAKARTA PUSAT,GAMBIR,DURI PULO,19610,5281,14329,10688,25017,2021-09-24
3173041011,JAKARTA BARAT,TAMBORA,DURI SELATAN,14259,3344,10915,8511,19426,2021-09-24
3173041003,JAKARTA BARAT,TAMBORA,DURI UTARA,19844,4947,14897,11102,25999,2021-09-24
3171081003,JAKARTA PUSAT,JOHAR BARU,GALUR,18243,4441,13802,10430,24232,2021-09-24
3171011001,JAKARTA PUSAT,GAMBIR,GAMBIR,2191,561,1630,1315,2945,2021-09-24
3174061004,JAKARTA SELATAN,CILANDAK,GANDARIA SELATAN,22119,5714,16405,12689,29094,2021-09-24
3174071009,JAKARTA SELATAN,KEBAYORAN BARU,GANDARIA UTARA,39922,10538,29384,22469,51853,2021-09-24
3175051001,JAKARTA TIMUR,PASAR REBO,GEDONG,35755,9079,26676,20705,47381,2021-09-24
3171071001,JAKARTA PUSAT,TANAH ABANG,GELORA,3127,781,2346,1726,4072,2021-09-24
3173031007,JAKARTA BARAT,TAMAN SARI,GLODOK,7837,1614,6223,5260,11483,2021-09-24
3171061004,JAKARTA PUSAT,MENTENG,GONDANGDIA,4100,1055,3045,2606,5651,2021-09-24
3173021001,JAKARTA BARAT,GROGOL PETAMBURAN,GROGOL,16876,4227,12649,9769,22418,2021-09-24
3174051005,JAKARTA SELATAN,KEBAYORAN LAMA,GROGOL SELATAN,44251,12106,32145,24406,56551,2021-09-24
3174051004,JAKARTA SELATAN,KEBAYORAN LAMA,GROGOL UTARA,42494,11382,31112,23736,54848,2021-09-24
3174021007,JAKARTA SELATAN,SETIA BUDI,GUNTUR,3985,951,3034,2522,5556,2021-09-24
3174071002,JAKARTA SELATAN,KEBAYORAN BARU,GUNUNG,9436,2241,7195,5780,12975,2021-09-24
3171031005,JAKARTA PUSAT,KEMAYORAN,GUNUNG SAHARI SELATAN,19199,5019,14180,11059,25239,2021-09-24
3171021004,JAKARTA PUSAT,SAWAH BESAR,GUNUNG SAHARI UTARA,16650,3680,12970,10772,23742,2021-09-24
3175081004,JAKARTA TIMUR,MAKASAR,HALIM PERDANA KUSUMAH,28363,4821,23542,20446,43988,2021-09-24
3171031003,JAKARTA PUSAT,KEMAYORAN,HARAPAN MULIA,22557,5986,16571,12504,29075,2021-09-24
3174091001,JAKARTA SELATAN,JAGAKARSA,JAGAKARSA,62389,15375,47014,36772,83786,2021-09-24
3175021007,JAKARTA TIMUR,PULO GADUNG,JATI,32757,8101,24656,19493,44149,2021-09-24
3174041002,JAKARTA SELATAN,PASAR MINGGU,JATI PADANG,37502,10143,27359,21361,48720,2021-09-24
3173071004,JAKARTA BARAT,PALMERAH,JATI PULO,28738,7218,21520,15770,37290,2021-09-24
3175061001,JAKARTA TIMUR,CAKUNG,JATINEGARA,84160,22964,61196,46064,107260,2021-09-24
3175021004,JAKARTA TIMUR,PULO GADUNG,JATINEGARA KAUM,24632,6033,18599,13398,31997,2021-09-24
3173021004,JAKARTA BARAT,GROGOL PETAMBURAN,JELAMBAR,30266,7344,22922,18180,41102,2021-09-24
3173021006,JAKARTA BARAT,GROGOL PETAMBURAN,JELAMBAR BARU,38246,9447,28799,22843,51642,2021-09-24
3173041006,JAKARTA BARAT,TAMBORA,JEMBATAN BESI,29314,9082,20232,13884,34116,2021-09-24
3173041008,JAKARTA BARAT,TAMBORA,JEMBATAN LIMA,21021,6239,14782,10579,25361,2021-09-24
3173081005,JAKARTA BARAT,KEMBANGAN,JOGLO,40839,10554,30285,23255,53540,2021-09-24
3171081001,JAKARTA PUSAT,JOHAR BARU,JOHAR BARU,37488,8778,28710,22386,51096,2021-09-24
3173041002,JAKARTA BARAT,TAMBORA,KALI ANYAR,23856,6202,17654,12738,30392,2021-09-24
3172041004,JAKARTA UTARA,CILINCING,KALIBARU,67684,23060,44624,29419,74043,2021-09-24
3174081002,JAKARTA SELATAN,PANCORAN,KALIBATA,41994,12547,29447,19883,49330,2021-09-24
3173061001,JAKARTA BARAT,KALI DERES,KALIDERES,72447,19251,53196,41995,95191,2021-09-24
3175051004,JAKARTA TIMUR,PASAR REBO,KALISARI,43212,10425,32787,25622,58409,2021-09-24
3173061004,JAKARTA BARAT,KALI DERES,KAMAL,53783,16191,37592,27760,65352,2021-09-24
3172011002,JAKARTA UTARA,PENJARINGAN,KAMAL MUARA,12930,2583,10347,8395,18742,2021-09-24
3171071007,JAKARTA PUSAT,TANAH ABANG,KAMPUNG BALI,11358,3188,8170,5695,13865,2021-09-24
3175031001,JAKARTA TIMUR,JATINEGARA,KAMPUNG MELAYU,25717,8248,17469,12692,30161,2021-09-24
3171081002,JAKARTA PUSAT,JOHAR BARU,KAMPUNG RAWA,21237,4371,16866,12524,29390,2021-09-24
3175041002,JAKARTA TIMUR,KRAMAT JATI,KAMPUNG TENGAH,43993,13739,30254,21901,52155,2021-09-24
3173011005,JAKARTA BARAT,CENGKARENG,KAPUK,134466,40516,93950,67998,161948,2021-09-24
3172011003,JAKARTA UTARA,PENJARINGAN,KAPUK MUARA,35781,8271,27510,22909,50419,2021-09-24
3171021002,JAKARTA PUSAT,SAWAH BESAR,KARANG ANYAR,25761,6272,19489,14969,34458,2021-09-24
3174021004,JAKARTA SELATAN,SETIA BUDI,KARET,9623,2333,7290,5564,12854,2021-09-24
3174021003,JAKARTA SELATAN,SETIA BUDI,KARET KUNINGAN,16055,3921,12134,9569,21703,2021-09-24
3174021002,JAKARTA SELATAN,SETIA BUDI,KARET SEMANGGI,2770,648,2122,1768,3890,2021-09-24
3171071003,JAKARTA PUSAT,TANAH ABANG,KARET TENGSIN,19271,4819,14452,10615,25067,2021-09-24
3171021003,JAKARTA PUSAT,SAWAH BESAR,KARTINI,22292,5547,16745,13294,30039,2021-09-24
3175011003,JAKARTA TIMUR,MATRAMAN,KAYU MANIS,25284,7097,18187,12988,31175,2021-09-24
3175021006,JAKARTA TIMUR,PULO GADUNG,KAYU PUTIH,40696,9811,30885,24884,55769,2021-09-24
3173031006,JAKARTA BARAT,TAMAN SARI,KEAGUNGAN,17387,4407,12980,9849,22829,2021-09-24
3174041007,JAKARTA SELATAN,PASAR MINGGU,KEBAGUSAN,44552,12548,32004,24260,56264,2021-09-24
3174051006,JAKARTA SELATAN,KEBAYORAN LAMA,KEBAYORAN LAMA SELATAN,41212,10159,31053,24187,55240,2021-09-24
3174051001,JAKARTA SELATAN,KEBAYORAN LAMA,KEBAYORAN LAMA UTARA,42422,11580,30842,23430,54272,2021-09-24
3174011004,JAKARTA SELATAN,TEBET,KEBON BARU,35165,8944,26221,19872,46093,2021-09-24
3172021005,JAKARTA UTARA,TANJUNG PRIOK,KEBON BAWANG,50952,13211,37741,28753,66494,2021-09-24
3173051001,JAKARTA BARAT,KEBON JERUK,KEBON JERUK,53887,15334,38553,28877,67430,2021-09-24
3171071006,JAKARTA PUSAT,TANAH ABANG,KEBON KACANG,21531,6500,15031,10776,25807,2021-09-24
3171011005,JAKARTA PUSAT,GAMBIR,KEBON KELAPA,10163,2621,7542,5855,13397,2021-09-24
3171031002,JAKARTA PUSAT,KEMAYORAN,KEBON KOSONG,30019,8290,21729,16491,38220,2021-09-24
3175011005,JAKARTA TIMUR,MATRAMAN,KEBON MANGGIS,16490,4141,12349,9348,21697,2021-09-24
3171071005,JAKARTA PUSAT,TANAH ABANG,KEBON MELATI,32206,10438,21768,14544,36312,2021-09-24
3175081003,JAKARTA TIMUR,MAKASAR,KEBON PALA,46614,12158,34456,26361,60817,2021-09-24
3171061005,JAKARTA PUSAT,MENTENG,KEBON SIRIH,12299,3304,8995,6491,15486,2021-09-24
3173011004,JAKARTA BARAT,CENGKARENG,KEDAUNG KALI ANGKE,32612,8000,24612,18997,43609,2021-09-24
3173051007,JAKARTA BARAT,KEBON JERUK,KEDOYA SELATAN,32165,8153,24012,18286,42298,2021-09-24
3173051006,JAKARTA BARAT,KEBON JERUK,KEDOYA UTARA,45740,10942,34798,27755,62553,2021-09-24
3173051004,JAKARTA BARAT,KEBON JERUK,KELAPA DUA,23565,6612,16953,12993,29946,2021-09-24
3175091003,JAKARTA TIMUR,CIRACAS,KELAPA DUA WETAN,46875,10564,36311,28074,64385,2021-09-24
3172061003,JAKARTA UTARA,KELAPA GADING,KELAPA GADING BARAT,35717,7505,28212,24004,52216,2021-09-24
3172061001,JAKARTA UTARA,KELAPA GADING,KELAPA GADING TIMUR,33592,6310,27282,23619,50901,2021-09-24
3173071005,JAKARTA BARAT,PALMERAH,KEMANGGISAN,32139,7999,24140,18213,42353,2021-09-24
3171031001,JAKARTA PUSAT,KEMAYORAN,KEMAYORAN,20708,5376,15332,11799,27131,2021-09-24
3173081006,JAKARTA BARAT,KEMBANGAN,KEMBANGAN SELATAN,27130,7057,20073,16219,36292,2021-09-24
3173081001,JAKARTA BARAT,KEMBANGAN,KEMBANGAN UTARA,54451,14688,39763,30836,70599,2021-09-24
3171041002,JAKARTA PUSAT,SENEN,KENARI,9579,2332,7247,5734,12981,2021-09-24
3173041005,JAKARTA BARAT,TAMBORA,KERENDANG,19973,5350,14623,10742,25365,2021-09-24
3175071003,JAKARTA TIMUR,DUREN SAWIT,KLENDER,69978,20735,49243,35812,85055,2021-09-24
3172031001,JAKARTA UTARA,KOJA,KOJA,28175,8323,19852,15041,34893,2021-09-24
3173071006,JAKARTA BARAT,PALMERAH,KOTA BAMBU SELATAN,21158,5679,15479,11133,26612,2021-09-24
3173071003,JAKARTA BARAT,PALMERAH,KOTA BAMBU UTARA,24995,6902,18093,12935,31028,2021-09-24
3171041004,JAKARTA PUSAT,SENEN,KRAMAT,28835,8319,20516,14208,34724,2021-09-24
3175041001,JAKARTA TIMUR,KRAMAT JATI,KRAMAT JATI,34144,9462,24682,18402,43084,2021-09-24
3174071003,JAKARTA SELATAN,KEBAYORAN BARU,KRAMAT PELA,14413,3486,10927,8571,19498,2021-09-24
3173031002,JAKARTA BARAT,TAMAN SARI,KRUKUT,19244,4962,14282,10700,24982,2021-09-24
3174031005,JAKARTA SELATAN,MAMPANG PRAPATAN,KUNINGAN BARAT,12785,3146,9639,7354,16993,2021-09-24
3174021008,JAKARTA SELATAN,SETIA BUDI,KUNINGAN TIMUR,6008,1540,4468,3550,8018,2021-09-24
3171041005,JAKARTA PUSAT,SENEN,KWITANG,15486,4296,11190,8430,19620,2021-09-24
3172031003,JAKARTA UTARA,KOJA,LAGOA,59065,17633,41432,29840,71272,2021-09-24
3174061002,JAKARTA SELATAN,CILANDAK,LEBAK BULUS,37626,9629,27997,22067,50064,2021-09-24
3174091004,JAKARTA SELATAN,JAGAKARSA,LENTENG AGUNG,53946,14426,39520,29667,69187,2021-09-24
3175101007,JAKARTA TIMUR,CIPAYUNG,LUBANG BUAYA,63547,15380,48167,37039,85206,2021-09-24
3175081001,JAKARTA TIMUR,MAKASAR,MAKASAR,34390,8776,25614,20266,45880,2021-09-24
3175071006,JAKARTA TIMUR,DUREN SAWIT,MALAKA JAYA,30927,7627,23300,18238,41538,2021-09-24
3175071005,JAKARTA TIMUR,DUREN SAWIT,MALAKA SARI,27530,6339,21191,16832,38023,2021-09-24
3174031001,JAKARTA SELATAN,MAMPANG PRAPATAN,MAMPANG PRAPATAN,18159,4954,13205,10095,23300,2021-09-24
3173031005,JAKARTA BARAT,TAMAN SARI,MANGGA BESAR,7707,1621,6086,4912,10998,2021-09-24
3171021005,JAKARTA PUSAT,SAWAH BESAR,MANGGA DUA SELATAN,27442,6924,20518,15922,36440,2021-09-24
3174011007,JAKARTA SELATAN,TEBET,MANGGARAI,28373,6693,21680,16062,37742,2021-09-24
3174011006,JAKARTA SELATAN,TEBET,MANGGARAI SELATAN,23075,5475,17600,13566,31166,2021-09-24
3173031003,JAKARTA BARAT,TAMAN SARI,MAPHAR,16461,4122,12339,9558,21897,2021-09-24
3172041003,JAKARTA UTARA,CILINCING,MARUNDA,28943,8084,20859,14324,35183,2021-09-24
3174071001,JAKARTA SELATAN,KEBAYORAN BARU,MELAWAI,2627,598,2029,1758,3787,2021-09-24
3171061001,JAKARTA PUSAT,MENTENG,MENTENG,25624,7243,18381,13427,31808,2021-09-24
3174021005,JAKARTA SELATAN,SETIA BUDI,MENTENG ATAS,27816,6681,21135,16027,37162,2021-09-24
3174011003,JAKARTA SELATAN,TEBET,MENTENG DALAM,36028,9292,26736,20467,47203,2021-09-24
3173081003,JAKARTA BARAT,KEMBANGAN,MERUYA SELATAN,32130,8492,23638,18189,41827,2021-09-24
3173081002,JAKARTA BARAT,KEMBANGAN,MERUYA UTARA,43752,11580,32172,25831,58003,2021-09-24
3175101004,JAKARTA TIMUR,CIPAYUNG,MUNJUL,23871,5892,17979,14114,32093,2021-09-24
3172051002,JAKARTA UTARA,PADEMANGAN,PADEMANGAN BARAT,74240,21780,52460,39093,91553,2021-09-24
3172051001,JAKARTA UTARA,PADEMANGAN,PADEMANGAN TIMUR,37736,8428,29308,23763,53071,2021-09-24
3175011004,JAKARTA TIMUR,MATRAMAN,PAL MERIAM,19769,5568,14201,10581,24782,2021-09-24
3173071001,JAKARTA BARAT,PALMERAH,PALMERAH,63011,17450,45561,33542,79103,2021-09-24
3174081001,JAKARTA SELATAN,PANCORAN,PANCORAN,19421,5433,13988,10343,24331,2021-09-24
3172021003,JAKARTA UTARA,TANJUNG PRIOK,PAPANGGO,39097,9960,29137,22378,51515,2021-09-24
3171021001,JAKARTA PUSAT,SAWAH BESAR,PASAR BARU,12035,2782,9253,7761,17014,2021-09-24
3174021006,JAKARTA SELATAN,SETIA BUDI,PASAR MANGGIS,26752,6975,19777,15131,34908,2021-09-24
3174041001,JAKARTA SELATAN,PASAR MINGGU,PASAR MINGGU,24821,6242,18579,14584,33163,2021-09-24
3171041003,JAKARTA PUSAT,SENEN,PASEBAN,23533,6401,17132,12812,29944,2021-09-24
3173061005,JAKARTA BARAT,KALI DERES,PEGADUNGAN,75587,18994,56593,45719,102312,2021-09-24
3171061002,JAKARTA PUSAT,MENTENG,PEGANGSAAN,23455,6529,16926,11933,28859,2021-09-24
3172061002,JAKARTA UTARA,KELAPA GADING,PEGANGSAAN DUA,49976,9956,40020,34136,74156,2021-09-24
3172011004,JAKARTA UTARA,PENJARINGAN,PEJAGALAN,74578,19519,55059,43822,98881,2021-09-24
3174041006,JAKARTA SELATAN,PASAR MINGGU,PEJATEN BARAT,37346,10200,27146,21193,48339,2021-09-24
3174041005,JAKARTA SELATAN,PASAR MINGGU,PEJATEN TIMUR,57656,16680,40976,30595,71571,2021-09-24
3175051005,JAKARTA TIMUR,PASAR REBO,PEKAYON,43250,10415,32835,25245,58080,2021-09-24
3173041009,JAKARTA BARAT,TAMBORA,PEKOJAN,23587,5775,17812,13804,31616,2021-09-24
3174031003,JAKARTA SELATAN,MAMPANG PRAPATAN,PELA MAMPANG,43522,11652,31870,24791,56661,2021-09-24
3174081005,JAKARTA SELATAN,PANCORAN,PENGADEGAN,21478,5070,16408,11973,28381,2021-09-24
3175061003,JAKARTA TIMUR,CAKUNG,PENGGILINGAN,99255,29731,69524,49847,119371,2021-09-24
3172011001,JAKARTA UTARA,PENJARINGAN,PENJARINGAN,88308,27614,60694,43623,104317,2021-09-24
3174101001,JAKARTA SELATAN,PESANGGRAHAN,PESANGGRAHAN,27545,6300,21245,16966,38211,2021-09-24
3171071004,JAKARTA PUSAT,TANAH ABANG,PETAMBURAN,33271,10859,22412,15168,37580,2021-09-24
3174071008,JAKARTA SELATAN,KEBAYORAN BARU,PETOGOGAN,11499,2937,8562,6499,15061,2021-09-24
3171011004,JAKARTA PUSAT,GAMBIR,PETOJO SELATAN,14692,4137,10555,8316,18871,2021-09-24
3171011003,JAKARTA PUSAT,GAMBIR,PETOJO UTARA,17458,4669,12789,9667,22456,2021-09-24
3174101004,JAKARTA SELATAN,PESANGGRAHAN,PETUKANGAN SELATAN,37187,9918,27269,21568,48837,2021-09-24
3174101003,JAKARTA SELATAN,PESANGGRAHAN,PETUKANGAN UTARA,53716,14803,38913,29949,68862,2021-09-24
3175081002,JAKARTA TIMUR,MAKASAR,PINANG RANTI,27198,7423,19775,15224,34999,2021-09-24
3173031008,JAKARTA BARAT,TAMAN SARI,PINANGSIA,10729,2474,8255,6402,14657,2021-09-24
3175011001,JAKARTA TIMUR,MATRAMAN,PISANGAN BARU,31776,8829,22947,16176,39123,2021-09-24
3175021002,JAKARTA TIMUR,PULO GADUNG,PISANGAN TIMUR,41011,10253,30758,23992,54750,2021-09-24
3172011005,JAKARTA UTARA,PENJARINGAN,PLUIT,47783,11354,36429,30088,66517,2021-09-24
3175071002,JAKARTA TIMUR,DUREN SAWIT,PONDOK BAMBU,61550,17257,44293,33634,77927,2021-09-24
3175071004,JAKARTA TIMUR,DUREN SAWIT,PONDOK KELAPA,72015,18276,53739,41685,95424,2021-09-24
3175071007,JAKARTA TIMUR,DUREN SAWIT,PONDOK KOPI,35367,9619,25748,18577,44325,2021-09-24
3174061003,JAKARTA SELATAN,CILANDAK,PONDOK LABU,46464,10598,35866,28392,64258,2021-09-24
3174051002,JAKARTA SELATAN,KEBAYORAN LAMA,PONDOK PINANG,56169,13952,42217,32927,75144,2021-09-24
3175101003,JAKARTA TIMUR,CIPAYUNG,PONDOK RANGGON,25574,6605,18969,14767,33736,2021-09-24
3101011003,KAB.ADM.KEP.SERIBU,KEP. SERIBU UTARA,PULAU HARAPAN,2060,283,1777,1221,2998,2021-09-24
3101011002,KAB.ADM.KEP.SERIBU,KEP. SERIBU UTARA,PULAU KELAPA,5528,743,4785,3241,8026,2021-09-24
3101011001,KAB.ADM.KEP.SERIBU,KEP. SERIBU UTARA,PULAU PANGGANG,5450,649,4801,3011,7812,2021-09-24
3101021003,KAB.ADM.KEP.SERIBU,KEP. SERIBU SELATAN,PULAU PARI,2765,246,2519,2107,4626,2021-09-24
3101021002,KAB.ADM.KEP.SERIBU,KEP. SERIBU SELATAN,PULAU TIDUNG,4553,479,4074,3315,7389,2021-09-24
3101021001,KAB.ADM.KEP.SERIBU,KEP. SERIBU SELATAN,PULAU UNTUNG JAWA,1941,231,1710,1467,3177,2021-09-24
3174071007,JAKARTA SELATAN,KEBAYORAN BARU,PULO,5835,1267,4568,3836,8404,2021-09-24
3175021001,JAKARTA TIMUR,PULO GADUNG,PULO GADUNG,34422,9247,25175,19069,44244,2021-09-24
3175061005,JAKARTA TIMUR,CAKUNG,PULO GEBANG,97301,24742,72559,52690,125249,2021-09-24
3174041004,JAKARTA SELATAN,PASAR MINGGU,RAGUNAN,39616,9864,29752,23466,53218,2021-09-24
3175091005,JAKARTA TIMUR,CIRACAS,RAMBUTAN,36771,10904,25867,19017,44884,2021-09-24
3172031006,JAKARTA UTARA,KOJA,RAWA BADAK SELATAN,42179,12520,29659,21267,50926,2021-09-24
3172031004,JAKARTA UTARA,KOJA,RAWA BADAK UTARA,34408,10040,24368,18174,42542,2021-09-24
3174071005,JAKARTA SELATAN,KEBAYORAN BARU,RAWA BARAT,5625,1255,4370,3553,7923,2021-09-24
3173011003,JAKARTA BARAT,CENGKARENG,RAWA BUAYA,63799,16972,46827,33794,80621,2021-09-24
3175031004,JAKARTA TIMUR,JATINEGARA,RAWA BUNGA,21434,6482,14952,11058,26010,2021-09-24
3174081003,JAKARTA SELATAN,PANCORAN,RAWA JATI,20509,5079,15430,11054,26484,2021-09-24
3175061002,JAKARTA TIMUR,CAKUNG,RAWA TERATE,24637,5741,18896,14261,33157,2021-09-24
3175021005,JAKARTA TIMUR,PULO GADUNG,RAWAMANGUN,37612,9662,27950,21573,49523,2021-09-24
3171051003,JAKARTA PUSAT,CEMPAKA PUTIH,RAWASARI,21967,5751,16216,12537,28753,2021-09-24
3173041010,JAKARTA BARAT,TAMBORA,ROA MALAKA,3484,727,2757,2282,5039,2021-09-24
3172041006,JAKARTA UTARA,CILINCING,ROROTAN,41668,10779,30889,23062,53951,2021-09-24
3174071004,JAKARTA SELATAN,KEBAYORAN BARU,SELONG,2842,633,2209,1862,4071,2021-09-24
3173061002,JAKARTA BARAT,KALI DERES,SEMANAN,71354,20051,51303,38575,89878,2021-09-24
3172041007,JAKARTA UTARA,CILINCING,SEMPER BARAT,68587,17175,51412,40014,91426,2021-09-24
3172041005,JAKARTA UTARA,CILINCING,SEMPER TIMUR,36267,9697,26570,19971,46541,2021-09-24
3174071006,JAKARTA SELATAN,KEBAYORAN BARU,SENAYAN,2771,776,1995,1552,3547,2021-09-24
3171041001,JAKARTA PUSAT,SENEN,SENEN,6804,1768,5036,3981,9017,2021-09-24
3171031004,JAKARTA PUSAT,KEMAYORAN,SERDANG,29668,7712,21956,16728,38684,2021-09-24
3174021001,JAKARTA SELATAN,SETIA BUDI,SETIA BUDI,3023,781,2242,1765,4007,2021-09-24
3175101005,JAKARTA TIMUR,CIPAYUNG,SETU,20572,5624,14948,11252,26200,2021-09-24
3173071002,JAKARTA BARAT,PALMERAH,SLIPI,16591,3953,12638,9747,22385,2021-09-24
3173081004,JAKARTA BARAT,KEMBANGAN,SRENGSENG,45523,12801,32722,25350,58072,2021-09-24
3174091002,JAKARTA SELATAN,JAGAKARSA,SRENGSENG SAWAH,58196,12916,45280,35975,81255,2021-09-24
3173051003,JAKARTA BARAT,KEBON JERUK,SUKABUMI SELATAN,37033,10814,26219,18653,44872,2021-09-24
3173051002,JAKARTA BARAT,KEBON JERUK,SUKABUMI UTARA,38290,11511,26779,18540,45319,2021-09-24
3172041002,JAKARTA UTARA,CILINCING,SUKAPURA,53949,15365,38584,29656,68240,2021-09-24
3171031007,JAKARTA PUSAT,KEMAYORAN,SUMUR BATU,22717,5910,16807,13037,29844,2021-09-24
3172021004,JAKARTA UTARA,TANJUNG PRIOK,SUNGAI BAMBU,29876,7715,22161,17028,39189,2021-09-24
3172021006,JAKARTA UTARA,TANJUNG PRIOK,SUNTER AGUNG,71805,15737,56068,45942,102010,2021-09-24
3172021002,JAKARTA UTARA,TANJUNG PRIOK,SUNTER JAYA,63031,14713,48318,39230,87548,2021-09-24
3175091004,JAKARTA TIMUR,CIRACAS,SUSUKAN,38257,9339,28918,22323,51241,2021-09-24
3173031001,JAKARTA BARAT,TAMAN SARI,TAMAN SARI,14348,3409,10939,8710,19649,2021-09-24
3173041001,JAKARTA BARAT,TAMBORA,TAMBORA,10204,2818,7386,5475,12861,2021-09-24
3173041004,JAKARTA BARAT,TAMBORA,TANAH SEREAL,26387,5853,20534,15485,36019,2021-09-24
3171081004,JAKARTA PUSAT,JOHAR BARU,TANAH TINGGI,37693,8723,28970,21738,50708,2021-09-24
3173031004,JAKARTA BARAT,TAMAN SARI,TANGKI,13324,3181,10143,7964,18107,2021-09-24
3174091005,JAKARTA SELATAN,JAGAKARSA,TANJUNG BARAT,39770,9883,29887,22772,52659,2021-09-24
3173021005,JAKARTA BARAT,GROGOL PETAMBURAN,TANJUNG DUREN SELATAN,25337,6218,19119,15295,34414,2021-09-24
3173021002,JAKARTA BARAT,GROGOL PETAMBURAN,TANJUNG DUREN UTARA,17010,3836,13174,10617,23791,2021-09-24
3172021001,JAKARTA UTARA,TANJUNG PRIOK,TANJUNG PRIOK,34588,8910,25678,19379,45057,2021-09-24
3174011002,JAKARTA SELATAN,TEBET,TEBET BARAT,21194,4550,16644,13366,30010,2021-09-24
3174011001,JAKARTA SELATAN,TEBET,TEBET TIMUR,18199,3823,14376,11781,26157,2021-09-24
3173061003,JAKARTA BARAT,KALI DERES,TEGAL ALUR,83647,23072,60575,45848,106423,2021-09-24
3174031004,JAKARTA SELATAN,MAMPANG PRAPATAN,TEGAL PARANG,32401,9559,22842,16236,39078,2021-09-24
3173021003,JAKARTA BARAT,GROGOL PETAMBURAN,TOMANG,29605,6980,22625,17922,40547,2021-09-24
3172031005,JAKARTA UTARA,KOJA,TUGU SELATAN,39122,10972,28150,20541,48691,2021-09-24
3172031002,JAKARTA UTARA,KOJA,TUGU UTARA,67670,20017,47653,34531,82184,2021-09-24
3175061006,JAKARTA TIMUR,CAKUNG,UJUNG MENTENG,29934,6721,23213,18032,41245,2021-09-24
3174101005,JAKARTA SELATAN,PESANGGRAHAN,ULUJAMI,40544,11893,28651,21860,50511,2021-09-24
3175011006,JAKARTA TIMUR,MATRAMAN,UTAN KAYU SELATAN,33511,8336,25175,18987,44162,2021-09-24
3175011002,JAKARTA TIMUR,MATRAMAN,UTAN KAYU UTARA,28169,7693,20476,15294,35770,2021-09-24
3171031008,JAKARTA PUSAT,KEMAYORAN,UTAN PANJANG,29208,8097,21111,15804,36915,2021-09-24
3172021007,JAKARTA UTARA,TANJUNG PRIOK,WARAKAS,44401,10829,33572,25162,58734,2021-09-24
3173021007,JAKARTA BARAT,GROGOL PETAMBURAN,WIJAYA KUSUMA,38934,10622,28312,22041,50353,2021-09-24
3172051003,JAKARTA UTARA,PADEMANGAN,ANCOL,23947,6922,17025,13063,30088,2021-09-25
3173041007,JAKARTA BARAT,TAMBORA,ANGKE,29381,7832,21549,16057,37606,2021-09-25
3175041005,JAKARTA TIMUR,KRAMAT JATI,BALE KAMBANG,29074,9126,19948,13932,33880,2021-09-25
3175031003,JAKARTA TIMUR,JATINEGARA,BALI MESTER,9752,2636,7116,5494,12610,2021-09-25
3175101006,JAKARTA TIMUR,CIPAYUNG,BAMBU APUS,26285,6793,19492,15072,34564,2021-09-25
3174031002,JAKARTA SELATAN,MAMPANG PRAPATAN,BANGKA,21566,6228,15338,11832,27170,2021-09-25
3175051002,JAKARTA TIMUR,PASAR REBO,BARU,23886,5108,18778,15267,34045,2021-09-25
3175041004,JAKARTA TIMUR,KRAMAT JATI,BATU AMPAR,47898,14743,33155,23965,57120,2021-09-25
3171071002,JAKARTA PUSAT,TANAH ABANG,BENDUNGAN HILIR,21494,5489,16005,12443,28448,2021-09-25
3175031002,JAKARTA TIMUR,JATINEGARA,BIDARA CINA,36689,11044,25645,18715,44360,2021-09-25
3174101002,JAKARTA SELATAN,PESANGGRAHAN,BINTARO,53098,13616,39482,31576,71058,2021-09-25
3174011005,JAKARTA SELATAN,TEBET,BUKIT DURI,34183,9186,24997,18727,43724,2021-09-25
3171041006,JAKARTA PUSAT,SENEN,BUNGUR,18144,4786,13358,10335,23693,2021-09-25
3175061007,JAKARTA TIMUR,CAKUNG,CAKUNG BARAT,57724,14670,43054,33001,76055,2021-09-25
3175061004,JAKARTA TIMUR,CAKUNG,CAKUNG TIMUR,58287,14659,43628,33523,77151,2021-09-25
3175041007,JAKARTA TIMUR,KRAMAT JATI,CAWANG,32762,9120,23642,17228,40870,2021-09-25
3175101008,JAKARTA TIMUR,CIPAYUNG,CEGER,18932,4777,14155,10983,25138,2021-09-25
3171031006,JAKARTA PUSAT,KEMAYORAN,CEMPAKA BARU,32581,8737,23844,17464,41308,2021-09-25
3171051002,JAKARTA PUSAT,CEMPAKA PUTIH,CEMPAKA PUTIH BARAT,35885,9727,26158,20472,46630,2021-09-25
3171051001,JAKARTA PUSAT,CEMPAKA PUTIH,CEMPAKA PUTIH TIMUR,24292,6170,18122,14510,32632,2021-09-25
3173011001,JAKARTA BARAT,CENGKARENG,CENGKARENG BARAT,66284,17158,49126,38174,87300,2021-09-25
3173011006,JAKARTA BARAT,CENGKARENG,CENGKARENG TIMUR,81027,20594,60433,45452,105885,2021-09-25
3175091002,JAKARTA TIMUR,CIRACAS,CIBUBUR,66364,14997,51367,40176,91543,2021-09-25
3171011002,JAKARTA PUSAT,GAMBIR,CIDENG,15390,3652,11738,9558,21296,2021-09-25
3174091003,JAKARTA SELATAN,JAGAKARSA,CIGANJUR,38497,9470,29027,22055,51082,2021-09-25
3175051003,JAKARTA TIMUR,PASAR REBO,CIJANTUNG,41419,9921,31498,24469,55967,2021-09-25
3171061003,JAKARTA PUSAT,MENTENG,CIKINI,8274,1852,6422,4556,10978,2021-09-25
3174081006,JAKARTA SELATAN,PANCORAN,CIKOKO,10547,2411,8136,6324,14460,2021-09-25
3174061001,JAKARTA SELATAN,CILANDAK,CILANDAK BARAT,51752,12526,39226,31335,70561,2021-09-25
3174041003,JAKARTA SELATAN,PASAR MINGGU,CILANDAK TIMUR,25145,6064,19081,15121,34202,2021-09-25
3175101002,JAKARTA TIMUR,CIPAYUNG,CILANGKAP,27635,6767,20868,16216,37084,2021-09-25
3175041006,JAKARTA TIMUR,KRAMAT JATI,CILILITAN,40181,11501,28680,21275,49955,2021-09-25
3172041001,JAKARTA UTARA,CILINCING,CILINCING,43609,12794,30815,22021,52836,2021-09-25
3175101001,JAKARTA TIMUR,CIPAYUNG,CIPAYUNG,26104,5881,20223,16240,36463,2021-09-25
3174091006,JAKARTA SELATAN,JAGAKARSA,CIPEDAK,38303,8923,29380,22980,52360,2021-09-25
3174061005,JAKARTA SELATAN,CILANDAK,CIPETE SELATAN,26704,6723,19981,15876,35857,2021-09-25
3174071010,JAKARTA SELATAN,KEBAYORAN BARU,CIPETE UTARA,34102,8416,25686,19282,44968,2021-09-25
3175021003,JAKARTA TIMUR,PULO GADUNG,CIPINANG,39306,9896,29410,22260,51670,2021-09-25
3175031007,JAKARTA TIMUR,JATINEGARA,CIPINANG BESAR SELATAN,35212,10391,24821,17501,42322,2021-09-25
3175031008,JAKARTA TIMUR,JATINEGARA,CIPINANG BESAR UTARA,45319,13683,31636,22580,54216,2021-09-25
3175031005,JAKARTA TIMUR,JATINEGARA,CIPINANG CEMPEDAK,32824,9451,23373,18066,41439,2021-09-25
3175081005,JAKARTA TIMUR,MAKASAR,CIPINANG MELAYU,42308,10988,31320,24534,55854,2021-09-25
3175031006,JAKARTA TIMUR,JATINEGARA,CIPINANG MUARA,55243,15326,39917,29701,69618,2021-09-25
3174051003,JAKARTA SELATAN,KEBAYORAN LAMA,CIPULIR,39937,10647,29290,21420,50710,2021-09-25
3175091001,JAKARTA TIMUR,CIRACAS,CIRACAS,64594,15246,49348,37679,87027,2021-09-25
3175041003,JAKARTA TIMUR,KRAMAT JATI,DUKUH,24609,6016,18593,14149,32742,2021-09-25
3175071001,JAKARTA TIMUR,DUREN SAWIT,DUREN SAWIT,61160,17069,44091,33332,77423,2021-09-25
3174081004,JAKARTA SELATAN,PANCORAN,DUREN TIGA,28319,7255,21064,14420,35484,2021-09-25
3173051005,JAKARTA BARAT,KEBON JERUK,DURI KEPA,60138,14586,45552,36672,82224,2021-09-25
3173011002,JAKARTA BARAT,CENGKARENG,DURI KOSAMBI,77923,22263,55660,41196,96856,2021-09-25
3171011006,JAKARTA PUSAT,GAMBIR,DURI PULO,19610,5253,14357,10766,25123,2021-09-25
3173041011,JAKARTA BARAT,TAMBORA,DURI SELATAN,14259,3313,10946,8630,19576,2021-09-25
3173041003,JAKARTA BARAT,TAMBORA,DURI UTARA,19844,4913,14931,11225,26156,2021-09-25
3171081003,JAKARTA PUSAT,JOHAR BARU,GALUR,18243,4416,13827,10492,24319,2021-09-25
3171011001,JAKARTA PUSAT,GAMBIR,GAMBIR,2191,560,1631,1325,2956,2021-09-25
3174061004,JAKARTA SELATAN,CILANDAK,GANDARIA SELATAN,22119,5674,16445,12761,29206,2021-09-25
3174071009,JAKARTA SELATAN,KEBAYORAN BARU,GANDARIA UTARA,39922,10456,29466,22631,52097,2021-09-25
3175051001,JAKARTA TIMUR,PASAR REBO,GEDONG,35755,9010,26745,20841,47586,2021-09-25
3171071001,JAKARTA PUSAT,TANAH ABANG,GELORA,3127,773,2354,1776,4130,2021-09-25
3173031007,JAKARTA BARAT,TAMAN SARI,GLODOK,7837,1600,6237,5292,11529,2021-09-25
3171061004,JAKARTA PUSAT,MENTENG,GONDANGDIA,4100,1050,3050,2632,5682,2021-09-25
3173021001,JAKARTA BARAT,GROGOL PETAMBURAN,GROGOL,16876,4194,12682,9852,22534,2021-09-25
3174051005,JAKARTA SELATAN,KEBAYORAN LAMA,GROGOL SELATAN,44251,11994,32257,24580,56837,2021-09-25
3174051004,JAKARTA SELATAN,KEBAYORAN LAMA,GROGOL UTARA,42494,11243,31251,23972,55223,2021-09-25
3174021007,JAKARTA SELATAN,SETIA BUDI,GUNTUR,3985,944,3041,2535,5576,2021-09-25
3174071002,JAKARTA SELATAN,KEBAYORAN BARU,GUNUNG,9436,2224,7212,5843,13055,2021-09-25
3171031005,JAKARTA PUSAT,KEMAYORAN,GUNUNG SAHARI SELATAN,19199,4976,14223,11127,25350,2021-09-25
3171021004,JAKARTA PUSAT,SAWAH BESAR,GUNUNG SAHARI UTARA,16650,3650,13000,10857,23857,2021-09-25
3175081004,JAKARTA TIMUR,MAKASAR,HALIM PERDANA KUSUMAH,28363,4792,23571,20531,44102,2021-09-25
3171031003,JAKARTA PUSAT,KEMAYORAN,HARAPAN MULIA,22557,5933,16624,12574,29198,2021-09-25
3174091001,JAKARTA SELATAN,JAGAKARSA,JAGAKARSA,62389,15273,47116,36940,84056,2021-09-25
3175021007,JAKARTA TIMUR,PULO GADUNG,JATI,32757,8014,24743,19690,44433,2021-09-25
3174041002,JAKARTA SELATAN,PASAR MINGGU,JATI PADANG,37502,10048,27454,21487,48941,2021-09-25
3173071004,JAKARTA BARAT,PALMERAH,JATI PULO,28738,7160,21578,15970,37548,2021-09-25
3175061001,JAKARTA TIMUR,CAKUNG,JATINEGARA,84160,22814,61346,46410,107756,2021-09-25
3175021004,JAKARTA TIMUR,PULO GADUNG,JATINEGARA KAUM,24632,5994,18638,13553,32191,2021-09-25
3173021004,JAKARTA BARAT,GROGOL PETAMBURAN,JELAMBAR,30266,7278,22988,18323,41311,2021-09-25
3173021006,JAKARTA BARAT,GROGOL PETAMBURAN,JELAMBAR BARU,38246,9347,28899,23000,51899,2021-09-25
3173041006,JAKARTA BARAT,TAMBORA,JEMBATAN BESI,29314,9029,20285,13983,34268,2021-09-25
3173041008,JAKARTA BARAT,TAMBORA,JEMBATAN LIMA,21021,6204,14817,10702,25519,2021-09-25
3173081005,JAKARTA BARAT,KEMBANGAN,JOGLO,40839,10478,30361,23424,53785,2021-09-25
3171081001,JAKARTA PUSAT,JOHAR BARU,JOHAR BARU,37488,8694,28794,22536,51330,2021-09-25
3173041002,JAKARTA BARAT,TAMBORA,KALI ANYAR,23856,6155,17701,12907,30608,2021-09-25
3172041004,JAKARTA UTARA,CILINCING,KALIBARU,67684,22936,44748,29728,74476,2021-09-25
3174081002,JAKARTA SELATAN,PANCORAN,KALIBATA,41994,12462,29532,20124,49656,2021-09-25
3173061001,JAKARTA BARAT,KALI DERES,KALIDERES,72447,19103,53344,42276,95620,2021-09-25
3175051004,JAKARTA TIMUR,PASAR REBO,KALISARI,43212,10365,32847,25740,58587,2021-09-25
3173061004,JAKARTA BARAT,KALI DERES,KAMAL,53783,16091,37692,27899,65591,2021-09-25
3172011002,JAKARTA UTARA,PENJARINGAN,KAMAL MUARA,12930,2571,10359,8437,18796,2021-09-25
3171071007,JAKARTA PUSAT,TANAH ABANG,KAMPUNG BALI,11358,3151,8207,5738,13945,2021-09-25
3175031001,JAKARTA TIMUR,JATINEGARA,KAMPUNG MELAYU,25717,8144,17573,12786,30359,2021-09-25
3171081002,JAKARTA PUSAT,JOHAR BARU,KAMPUNG RAWA,21237,4346,16891,12599,29490,2021-09-25
3175041002,JAKARTA TIMUR,KRAMAT JATI,KAMPUNG TENGAH,43993,13655,30338,22082,52420,2021-09-25
3173011005,JAKARTA BARAT,CENGKARENG,KAPUK,134466,40271,94195,68985,163180,2021-09-25
3172011003,JAKARTA UTARA,PENJARINGAN,KAPUK MUARA,35781,8230,27551,23014,50565,2021-09-25
3171021002,JAKARTA PUSAT,SAWAH BESAR,KARANG ANYAR,25761,6213,19548,15125,34673,2021-09-25
3174021004,JAKARTA SELATAN,SETIA BUDI,KARET,9623,2320,7303,5596,12899,2021-09-25
3174021003,JAKARTA SELATAN,SETIA BUDI,KARET KUNINGAN,16055,3893,12162,9646,21808,2021-09-25
3174021002,JAKARTA SELATAN,SETIA BUDI,KARET SEMANGGI,2770,647,2123,1779,3902,2021-09-25
3171071003,JAKARTA PUSAT,TANAH ABANG,KARET TENGSIN,19271,4781,14490,10765,25255,2021-09-25
3171021003,JAKARTA PUSAT,SAWAH BESAR,KARTINI,22292,5494,16798,13371,30169,2021-09-25
3175011003,JAKARTA TIMUR,MATRAMAN,KAYU MANIS,25284,7037,18247,13100,31347,2021-09-25
3175021006,JAKARTA TIMUR,PULO GADUNG,KAYU PUTIH,40696,9724,30972,25059,56031,2021-09-25
3173031006,JAKARTA BARAT,TAMAN SARI,KEAGUNGAN,17387,4376,13011,9927,22938,2021-09-25
3174041007,JAKARTA SELATAN,PASAR MINGGU,KEBAGUSAN,44552,12446,32106,24391,56497,2021-09-25
3174051006,JAKARTA SELATAN,KEBAYORAN LAMA,KEBAYORAN LAMA SELATAN,41212,10085,31127,24305,55432,2021-09-25
3174051001,JAKARTA SELATAN,KEBAYORAN LAMA,KEBAYORAN LAMA UTARA,42422,11503,30919,23563,54482,2021-09-25
3174011004,JAKARTA SELATAN,TEBET,KEBON BARU,35165,8869,26296,20021,46317,2021-09-25
3172021005,JAKARTA UTARA,TANJUNG PRIOK,KEBON BAWANG,50952,13112,37840,28948,66788,2021-09-25
3173051001,JAKARTA BARAT,KEBON JERUK,KEBON JERUK,53887,15165,38722,29220,67942,2021-09-25
3171071006,JAKARTA PUSAT,TANAH ABANG,KEBON KACANG,21531,6462,15069,10892,25961,2021-09-25
3171011005,JAKARTA PUSAT,GAMBIR,KEBON KELAPA,10163,2600,7563,5900,13463,2021-09-25
3171031002,JAKARTA PUSAT,KEMAYORAN,KEBON KOSONG,30019,8236,21783,16602,38385,2021-09-25
3175011005,JAKARTA TIMUR,MATRAMAN,KEBON MANGGIS,16490,4094,12396,9408,21804,2021-09-25
3171071005,JAKARTA PUSAT,TANAH ABANG,KEBON MELATI,32206,10359,21847,14684,36531,2021-09-25
3175081003,JAKARTA TIMUR,MAKASAR,KEBON PALA,46614,12085,34529,26638,61167,2021-09-25
3171061005,JAKARTA PUSAT,MENTENG,KEBON SIRIH,12299,3279,9020,6594,15614,2021-09-25
3173011004,JAKARTA BARAT,CENGKARENG,KEDAUNG KALI ANGKE,32612,7914,24698,19167,43865,2021-09-25
3173051007,JAKARTA BARAT,KEBON JERUK,KEDOYA SELATAN,32165,8050,24115,18674,42789,2021-09-25
3173051006,JAKARTA BARAT,KEBON JERUK,KEDOYA UTARA,45740,10867,34873,28003,62876,2021-09-25
3173051004,JAKARTA BARAT,KEBON JERUK,KELAPA DUA,23565,6564,17001,13268,30269,2021-09-25
3175091003,JAKARTA TIMUR,CIRACAS,KELAPA DUA WETAN,46875,10500,36375,28358,64733,2021-09-25
3172061003,JAKARTA UTARA,KELAPA GADING,KELAPA GADING BARAT,35717,7454,28263,24139,52402,2021-09-25
3172061001,JAKARTA UTARA,KELAPA GADING,KELAPA GADING TIMUR,33592,6251,27341,23767,51108,2021-09-25
3173071005,JAKARTA BARAT,PALMERAH,KEMANGGISAN,32139,7933,24206,18434,42640,2021-09-25
3171031001,JAKARTA PUSAT,KEMAYORAN,KEMAYORAN,20708,5342,15366,11870,27236,2021-09-25
3173081006,JAKARTA BARAT,KEMBANGAN,KEMBANGAN SELATAN,27130,7014,20116,16335,36451,2021-09-25
3173081001,JAKARTA BARAT,KEMBANGAN,KEMBANGAN UTARA,54451,14603,39848,31047,70895,2021-09-25
3171041002,JAKARTA PUSAT,SENEN,KENARI,9579,2318,7261,5766,13027,2021-09-25
3173041005,JAKARTA BARAT,TAMBORA,KERENDANG,19973,5316,14657,10841,25498,2021-09-25
3175071003,JAKARTA TIMUR,DUREN SAWIT,KLENDER,69978,20594,49384,36067,85451,2021-09-25
3172031001,JAKARTA UTARA,KOJA,KOJA,28175,8275,19900,15130,35030,2021-09-25
3173071006,JAKARTA BARAT,PALMERAH,KOTA BAMBU SELATAN,21158,5638,15520,11275,26795,2021-09-25
3173071003,JAKARTA BARAT,PALMERAH,KOTA BAMBU UTARA,24995,6841,18154,13050,31204,2021-09-25
3171041004,JAKARTA PUSAT,SENEN,KRAMAT,28835,8276,20559,14366,34925,2021-09-25
3175041001,JAKARTA TIMUR,KRAMAT JATI,KRAMAT JATI,34144,9406,24738,18602,43340,2021-09-25
3174071003,JAKARTA SELATAN,KEBAYORAN BARU,KRAMAT PELA,14413,3460,10953,8630,19583,2021-09-25
3173031002,JAKARTA BARAT,TAMAN SARI,KRUKUT,19244,4924,14320,10779,25099,2021-09-25
3174031005,JAKARTA SELATAN,MAMPANG PRAPATAN,KUNINGAN BARAT,12785,3116,9669,7396,17065,2021-09-25
3174021008,JAKARTA SELATAN,SETIA BUDI,KUNINGAN TIMUR,6008,1530,4478,3583,8061,2021-09-25
3171041005,JAKARTA PUSAT,SENEN,KWITANG,15486,4254,11232,8490,19722,2021-09-25
3172031003,JAKARTA UTARA,KOJA,LAGOA,59065,17513,41552,30050,71602,2021-09-25
3174061002,JAKARTA SELATAN,CILANDAK,LEBAK BULUS,37626,9534,28092,22189,50281,2021-09-25
3174091004,JAKARTA SELATAN,JAGAKARSA,LENTENG AGUNG,53946,14297,39649,29823,69472,2021-09-25
3175101007,JAKARTA TIMUR,CIPAYUNG,LUBANG BUAYA,63547,15295,48252,37292,85544,2021-09-25
3175081001,JAKARTA TIMUR,MAKASAR,MAKASAR,34390,8708,25682,20380,46062,2021-09-25
3175071006,JAKARTA TIMUR,DUREN SAWIT,MALAKA JAYA,30927,7547,23380,18372,41752,2021-09-25
3175071005,JAKARTA TIMUR,DUREN SAWIT,MALAKA SARI,27530,6281,21249,16933,38182,2021-09-25
3174031001,JAKARTA SELATAN,MAMPANG PRAPATAN,MAMPANG PRAPATAN,18159,4928,13231,10153,23384,2021-09-25
3173031005,JAKARTA BARAT,TAMAN SARI,MANGGA BESAR,7707,1609,6098,4946,11044,2021-09-25
3171021005,JAKARTA PUSAT,SAWAH BESAR,MANGGA DUA SELATAN,27442,6858,20584,16017,36601,2021-09-25
3174011007,JAKARTA SELATAN,TEBET,MANGGARAI,28373,6650,21723,16172,37895,2021-09-25
3174011006,JAKARTA SELATAN,TEBET,MANGGARAI SELATAN,23075,5422,17653,13652,31305,2021-09-25
3173031003,JAKARTA BARAT,TAMAN SARI,MAPHAR,16461,4098,12363,9657,22020,2021-09-25
3172041003,JAKARTA UTARA,CILINCING,MARUNDA,28943,8015,20928,14533,35461,2021-09-25
3174071001,JAKARTA SELATAN,KEBAYORAN BARU,MELAWAI,2627,595,2032,1773,3805,2021-09-25
3171061001,JAKARTA PUSAT,MENTENG,MENTENG,25624,7186,18438,13578,32016,2021-09-25
3174021005,JAKARTA SELATAN,SETIA BUDI,MENTENG ATAS,27816,6627,21189,16149,37338,2021-09-25
3174011003,JAKARTA SELATAN,TEBET,MENTENG DALAM,36028,9236,26792,20639,47431,2021-09-25
3173081003,JAKARTA BARAT,KEMBANGAN,MERUYA SELATAN,32130,8418,23712,18306,42018,2021-09-25
3173081002,JAKARTA BARAT,KEMBANGAN,MERUYA UTARA,43752,11507,32245,25989,58234,2021-09-25
3175101004,JAKARTA TIMUR,CIPAYUNG,MUNJUL,23871,5863,18008,14214,32222,2021-09-25
3172051002,JAKARTA UTARA,PADEMANGAN,PADEMANGAN BARAT,74240,21681,52559,39302,91861,2021-09-25
3172051001,JAKARTA UTARA,PADEMANGAN,PADEMANGAN TIMUR,37736,8391,29345,23877,53222,2021-09-25
3175011004,JAKARTA TIMUR,MATRAMAN,PAL MERIAM,19769,5529,14240,10661,24901,2021-09-25
3173071001,JAKARTA BARAT,PALMERAH,PALMERAH,63011,17314,45697,34094,79791,2021-09-25
3174081001,JAKARTA SELATAN,PANCORAN,PANCORAN,19421,5406,14015,10472,24487,2021-09-25
3172021003,JAKARTA UTARA,TANJUNG PRIOK,PAPANGGO,39097,9898,29199,22526,51725,2021-09-25
3171021001,JAKARTA PUSAT,SAWAH BESAR,PASAR BARU,12035,2767,9268,7806,17074,2021-09-25
3174021006,JAKARTA SELATAN,SETIA BUDI,PASAR MANGGIS,26752,6932,19820,15214,35034,2021-09-25
3174041001,JAKARTA SELATAN,PASAR MINGGU,PASAR MINGGU,24821,6192,18629,14675,33304,2021-09-25
3171041003,JAKARTA PUSAT,SENEN,PASEBAN,23533,6354,17179,12903,30082,2021-09-25
3173061005,JAKARTA BARAT,KALI DERES,PEGADUNGAN,75587,18839,56748,45922,102670,2021-09-25
3171061002,JAKARTA PUSAT,MENTENG,PEGANGSAAN,23455,6475,16980,12035,29015,2021-09-25
3172061002,JAKARTA UTARA,KELAPA GADING,PEGANGSAAN DUA,49976,9882,40094,34314,74408,2021-09-25
3172011004,JAKARTA UTARA,PENJARINGAN,PEJAGALAN,74578,19383,55195,44069,99264,2021-09-25
3174041006,JAKARTA SELATAN,PASAR MINGGU,PEJATEN BARAT,37346,10127,27219,21336,48555,2021-09-25
3174041005,JAKARTA SELATAN,PASAR MINGGU,PEJATEN TIMUR,57656,16584,41072,30790,71862,2021-09-25
3175051005,JAKARTA TIMUR,PASAR REBO,PEKAYON,43250,10316,32934,25392,58326,2021-09-25
3173041009,JAKARTA BARAT,TAMBORA,PEKOJAN,23587,5726,17861,13903,31764,2021-09-25
3174031003,JAKARTA SELATAN,MAMPANG PRAPATAN,PELA MAMPANG,43522,11598,31924,24960,56884,2021-09-25
3174081005,JAKARTA SELATAN,PANCORAN,PENGADEGAN,21478,5029,16449,12072,28521,2021-09-25
3175061003,JAKARTA TIMUR,CAKUNG,PENGGILINGAN,99255,29462,69793,50352,120145,2021-09-25
3172011001,JAKARTA UTARA,PENJARINGAN,PENJARINGAN,88308,27437,60871,43887,104758,2021-09-25
3174101001,JAKARTA SELATAN,PESANGGRAHAN,PESANGGRAHAN,27545,6260,21285,17044,38329,2021-09-25
3171071004,JAKARTA PUSAT,TANAH ABANG,PETAMBURAN,33271,10791,22480,15308,37788,2021-09-25
3174071008,JAKARTA SELATAN,KEBAYORAN BARU,PETOGOGAN,11499,2897,8602,6532,15134,2021-09-25
3171011004,JAKARTA PUSAT,GAMBIR,PETOJO SELATAN,14692,4099,10593,8409,19002,2021-09-25
3171011003,JAKARTA PUSAT,GAMBIR,PETOJO UTARA,17458,4610,12848,9766,22614,2021-09-25
3174101004,JAKARTA SELATAN,PESANGGRAHAN,PETUKANGAN SELATAN,37187,9833,27354,21726,49080,2021-09-25
3174101003,JAKARTA SELATAN,PESANGGRAHAN,PETUKANGAN UTARA,53716,14694,39022,30141,69163,2021-09-25
3175081002,JAKARTA TIMUR,MAKASAR,PINANG RANTI,27198,7381,19817,15318,35135,2021-09-25
3173031008,JAKARTA BARAT,TAMAN SARI,PINANGSIA,10729,2465,8264,6449,14713,2021-09-25
3175011001,JAKARTA TIMUR,MATRAMAN,PISANGAN BARU,31776,8730,23046,16323,39369,2021-09-25
3175021002,JAKARTA TIMUR,PULO GADUNG,PISANGAN TIMUR,41011,10173,30838,24179,55017,2021-09-25
3172011005,JAKARTA UTARA,PENJARINGAN,PLUIT,47783,11242,36541,30308,66849,2021-09-25
3175071002,JAKARTA TIMUR,DUREN SAWIT,PONDOK BAMBU,61550,17134,44416,33885,78301,2021-09-25
3175071004,JAKARTA TIMUR,DUREN SAWIT,PONDOK KELAPA,72015,18141,53874,42107,95981,2021-09-25
3175071007,JAKARTA TIMUR,DUREN SAWIT,PONDOK KOPI,35367,9531,25836,18746,44582,2021-09-25
3174061003,JAKARTA SELATAN,CILANDAK,PONDOK LABU,46464,10526,35938,28544,64482,2021-09-25
3174051002,JAKARTA SELATAN,KEBAYORAN LAMA,PONDOK PINANG,56169,13844,42325,33159,75484,2021-09-25
3175101003,JAKARTA TIMUR,CIPAYUNG,PONDOK RANGGON,25574,6569,19005,14853,33858,2021-09-25
3101011003,KAB.ADM.KEP.SERIBU,KEP. SERIBU UTARA,PULAU HARAPAN,2060,279,1781,1322,3103,2021-09-25
3101011002,KAB.ADM.KEP.SERIBU,KEP. SERIBU UTARA,PULAU KELAPA,5528,728,4800,3310,8110,2021-09-25
3101011001,KAB.ADM.KEP.SERIBU,KEP. SERIBU UTARA,PULAU PANGGANG,5450,640,4810,3280,8090,2021-09-25
3101021003,KAB.ADM.KEP.SERIBU,KEP. SERIBU SELATAN,PULAU PARI,2765,242,2523,2182,4705,2021-09-25
3101021002,KAB.ADM.KEP.SERIBU,KEP. SERIBU SELATAN,PULAU TIDUNG,4553,471,4082,3490,7572,2021-09-25
3101021001,KAB.ADM.KEP.SERIBU,KEP. SERIBU SELATAN,PULAU UNTUNG JAWA,1941,231,1710,1489,3199,2021-09-25
3174071007,JAKARTA SELATAN,KEBAYORAN BARU,PULO,5835,1256,4579,3869,8448,2021-09-25
3175021001,JAKARTA TIMUR,PULO GADUNG,PULO GADUNG,34422,9168,25254,19284,44538,2021-09-25
3175061005,JAKARTA TIMUR,CAKUNG,PULO GEBANG,97301,24500,72801,53181,125982,2021-09-25
3174041004,JAKARTA SELATAN,PASAR MINGGU,RAGUNAN,39616,9791,29825,23594,53419,2021-09-25
3175091005,JAKARTA TIMUR,CIRACAS,RAMBUTAN,36771,10833,25938,19173,45111,2021-09-25
3172031006,JAKARTA UTARA,KOJA,RAWA BADAK SELATAN,42179,12441,29738,21419,51157,2021-09-25
3172031004,JAKARTA UTARA,KOJA,RAWA BADAK UTARA,34408,9975,24433,18268,42701,2021-09-25
3174071005,JAKARTA SELATAN,KEBAYORAN BARU,RAWA BARAT,5625,1247,4378,3580,7958,2021-09-25
3173011003,JAKARTA BARAT,CENGKARENG,RAWA BUAYA,63799,16815,46984,34211,81195,2021-09-25
3175031004,JAKARTA TIMUR,JATINEGARA,RAWA BUNGA,21434,6436,14998,11153,26151,2021-09-25
3174081003,JAKARTA SELATAN,PANCORAN,RAWA JATI,20509,5043,15466,11176,26642,2021-09-25
3175061002,JAKARTA TIMUR,CAKUNG,RAWA TERATE,24637,5708,18929,14337,33266,2021-09-25
3175021005,JAKARTA TIMUR,PULO GADUNG,RAWAMANGUN,37612,9596,28016,21780,49796,2021-09-25
3171051003,JAKARTA PUSAT,CEMPAKA PUTIH,RAWASARI,21967,5706,16261,12641,28902,2021-09-25
3173041010,JAKARTA BARAT,TAMBORA,ROA MALAKA,3484,722,2762,2300,5062,2021-09-25
3172041006,JAKARTA UTARA,CILINCING,ROROTAN,41668,10662,31006,23244,54250,2021-09-25
3174071004,JAKARTA SELATAN,KEBAYORAN BARU,SELONG,2842,627,2215,1882,4097,2021-09-25
3173061002,JAKARTA BARAT,KALI DERES,SEMANAN,71354,19906,51448,38813,90261,2021-09-25
3172041007,JAKARTA UTARA,CILINCING,SEMPER BARAT,68587,17016,51571,40284,91855,2021-09-25
3172041005,JAKARTA UTARA,CILINCING,SEMPER TIMUR,36267,9621,26646,20074,46720,2021-09-25
3174071006,JAKARTA SELATAN,KEBAYORAN BARU,SENAYAN,2771,775,1996,1565,3561,2021-09-25
3171041001,JAKARTA PUSAT,SENEN,SENEN,6804,1762,5042,4010,9052,2021-09-25
3171031004,JAKARTA PUSAT,KEMAYORAN,SERDANG,29668,7623,22045,16947,38992,2021-09-25
3174021001,JAKARTA SELATAN,SETIA BUDI,SETIA BUDI,3023,777,2246,1777,4023,2021-09-25
3175101005,JAKARTA TIMUR,CIPAYUNG,SETU,20572,5591,14981,11340,26321,2021-09-25
3173071002,JAKARTA BARAT,PALMERAH,SLIPI,16591,3923,12668,9828,22496,2021-09-25
3173081004,JAKARTA BARAT,KEMBANGAN,SRENGSENG,45523,12710,32813,25565,58378,2021-09-25
3174091002,JAKARTA SELATAN,JAGAKARSA,SRENGSENG SAWAH,58196,12804,45392,36141,81533,2021-09-25
3173051003,JAKARTA BARAT,KEBON JERUK,SUKABUMI SELATAN,37033,10742,26291,18824,45115,2021-09-25
3173051002,JAKARTA BARAT,KEBON JERUK,SUKABUMI UTARA,38290,11397,26893,18809,45702,2021-09-25
3172041002,JAKARTA UTARA,CILINCING,SUKAPURA,53949,15248,38701,29839,68540,2021-09-25
3171031007,JAKARTA PUSAT,KEMAYORAN,SUMUR BATU,22717,5862,16855,13211,30066,2021-09-25
3172021004,JAKARTA UTARA,TANJUNG PRIOK,SUNGAI BAMBU,29876,7650,22226,17141,39367,2021-09-25
3172021006,JAKARTA UTARA,TANJUNG PRIOK,SUNTER AGUNG,71805,15623,56182,46237,102419,2021-09-25
3172021002,JAKARTA UTARA,TANJUNG PRIOK,SUNTER JAYA,63031,14584,48447,39504,87951,2021-09-25
3175091004,JAKARTA TIMUR,CIRACAS,SUSUKAN,38257,9259,28998,22558,51556,2021-09-25
3173031001,JAKARTA BARAT,TAMAN SARI,TAMAN SARI,14348,3389,10959,8784,19743,2021-09-25
3173041001,JAKARTA BARAT,TAMBORA,TAMBORA,10204,2797,7407,5529,12936,2021-09-25
3173041004,JAKARTA BARAT,TAMBORA,TANAH SEREAL,26387,5808,20579,15691,36270,2021-09-25
3171081004,JAKARTA PUSAT,JOHAR BARU,TANAH TINGGI,37693,8665,29028,21905,50933,2021-09-25
3173031004,JAKARTA BARAT,TAMAN SARI,TANGKI,13324,3153,10171,8017,18188,2021-09-25
3174091005,JAKARTA SELATAN,JAGAKARSA,TANJUNG BARAT,39770,9795,29975,22939,52914,2021-09-25
3173021005,JAKARTA BARAT,GROGOL PETAMBURAN,TANJUNG DUREN SELATAN,25337,6168,19169,15562,34731,2021-09-25
3173021002,JAKARTA BARAT,GROGOL PETAMBURAN,TANJUNG DUREN UTARA,17010,3781,13229,10904,24133,2021-09-25
3172021001,JAKARTA UTARA,TANJUNG PRIOK,TANJUNG PRIOK,34588,8840,25748,19517,45265,2021-09-25
3174011002,JAKARTA SELATAN,TEBET,TEBET BARAT,21194,4514,16680,13464,30144,2021-09-25
3174011001,JAKARTA SELATAN,TEBET,TEBET TIMUR,18199,3792,14407,11878,26285,2021-09-25
3173061003,JAKARTA BARAT,KALI DERES,TEGAL ALUR,83647,22873,60774,46298,107072,2021-09-25
3174031004,JAKARTA SELATAN,MAMPANG PRAPATAN,TEGAL PARANG,32401,9524,22877,16353,39230,2021-09-25
3173021003,JAKARTA BARAT,GROGOL PETAMBURAN,TOMANG,29605,6909,22696,18028,40724,2021-09-25
3172031005,JAKARTA UTARA,KOJA,TUGU SELATAN,39122,10870,28252,20626,48878,2021-09-25
3172031002,JAKARTA UTARA,KOJA,TUGU UTARA,67670,19865,47805,34807,82612,2021-09-25
3175061006,JAKARTA TIMUR,CAKUNG,UJUNG MENTENG,29934,6677,23257,18143,41400,2021-09-25
3174101005,JAKARTA SELATAN,PESANGGRAHAN,ULUJAMI,40544,11831,28713,22011,50724,2021-09-25
3175011006,JAKARTA TIMUR,MATRAMAN,UTAN KAYU SELATAN,33511,8219,25292,19152,44444,2021-09-25
3175011002,JAKARTA TIMUR,MATRAMAN,UTAN KAYU UTARA,28169,7628,20541,15409,35950,2021-09-25
3171031008,JAKARTA PUSAT,KEMAYORAN,UTAN PANJANG,29208,8037,21171,15930,37101,2021-09-25
3172021007,JAKARTA UTARA,TANJUNG PRIOK,WARAKAS,44401,10752,33649,25300,58949,2021-09-25
3173021007,JAKARTA BARAT,GROGOL PETAMBURAN,WIJAYA KUSUMA,38934,10551,28383,22246,50629,2021-09-25
3172051003,JAKARTA UTARA,PADEMANGAN,ANCOL,23947,6887,17060,13114,30174,2021-09-26
3173041007,JAKARTA BARAT,TAMBORA,ANGKE,29381,7787,21594,16131,37725,2021-09-26
3175041005,JAKARTA TIMUR,KRAMAT JATI,BALE KAMBANG,29074,9027,20047,14018,34065,2021-09-26
3175031003,JAKARTA TIMUR,JATINEGARA,BALI MESTER,9752,2612,7140,5531,12671,2021-09-26
3175101006,JAKARTA TIMUR,CIPAYUNG,BAMBU APUS,26285,6756,19529,15149,34678,2021-09-26
3174031002,JAKARTA SELATAN,MAMPANG PRAPATAN,BANGKA,21566,6104,15462,11926,27388,2021-09-26
3175051002,JAKARTA TIMUR,PASAR REBO,BARU,23886,5069,18817,15319,34136,2021-09-26
3175041004,JAKARTA TIMUR,KRAMAT JATI,BATU AMPAR,47898,14615,33283,24143,57426,2021-09-26
3171071002,JAKARTA PUSAT,TANAH ABANG,BENDUNGAN HILIR,21494,5443,16051,12512,28563,2021-09-26
3175031002,JAKARTA TIMUR,JATINEGARA,BIDARA CINA,36689,10974,25715,18817,44532,2021-09-26
3174101002,JAKARTA SELATAN,PESANGGRAHAN,BINTARO,53098,13467,39631,31680,71311,2021-09-26
3174011005,JAKARTA SELATAN,TEBET,BUKIT DURI,34183,9095,25088,18833,43921,2021-09-26
3171041006,JAKARTA PUSAT,SENEN,BUNGUR,18144,4744,13400,10386,23786,2021-09-26
3175061007,JAKARTA TIMUR,CAKUNG,CAKUNG BARAT,57724,14560,43164,33202,76366,2021-09-26
3175061004,JAKARTA TIMUR,CAKUNG,CAKUNG TIMUR,58287,14538,43749,33694,77443,2021-09-26
3175041007,JAKARTA TIMUR,KRAMAT JATI,CAWANG,32762,9059,23703,17318,41021,2021-09-26
3175101008,JAKARTA TIMUR,CIPAYUNG,CEGER,18932,4752,14180,11020,25200,2021-09-26
3171031006,JAKARTA PUSAT,KEMAYORAN,CEMPAKA BARU,32581,8630,23951,17540,41491,2021-09-26
3171051002,JAKARTA PUSAT,CEMPAKA PUTIH,CEMPAKA PUTIH BARAT,35885,9653,26232,20566,46798,2021-09-26
3171051001,JAKARTA PUSAT,CEMPAKA PUTIH,CEMPAKA PUTIH TIMUR,24292,6129,18163,14562,32725,2021-09-26
3173011001,JAKARTA BARAT,CENGKARENG,CENGKARENG BARAT,66284,17050,49234,38326,87560,2021-09-26
3173011006,JAKARTA BARAT,CENGKARENG,CENGKARENG TIMUR,81027,20420,60607,45638,106245,2021-09-26
3175091002,JAKARTA TIMUR,CIRACAS,CIBUBUR,66364,14834,51530,40391,91921,2021-09-26
3171011002,JAKARTA PUSAT,GAMBIR,CIDENG,15390,3630,11760,9600,21360,2021-09-26
3174091003,JAKARTA SELATAN,JAGAKARSA,CIGANJUR,38497,9408,29089,22138,51227,2021-09-26
3175051003,JAKARTA TIMUR,PASAR REBO,CIJANTUNG,41419,9830,31589,24556,56145,2021-09-26
3171061003,JAKARTA PUSAT,MENTENG,CIKINI,8274,1840,6434,4584,11018,2021-09-26
3174081006,JAKARTA SELATAN,PANCORAN,CIKOKO,10547,2388,8159,6362,14521,2021-09-26
3174061001,JAKARTA SELATAN,CILANDAK,CILANDAK BARAT,51752,12414,39338,31507,70845,2021-09-26
3174041003,JAKARTA SELATAN,PASAR MINGGU,CILANDAK TIMUR,25145,6021,19124,15193,34317,2021-09-26
3175101002,JAKARTA TIMUR,CIPAYUNG,CILANGKAP,27635,6677,20958,16312,37270,2021-09-26
3175041006,JAKARTA TIMUR,KRAMAT JATI,CILILITAN,40181,11423,28758,21375,50133,2021-09-26
3172041001,JAKARTA UTARA,CILINCING,CILINCING,43609,12702,30907,22129,53036,2021-09-26
3175101001,JAKARTA TIMUR,CIPAYUNG,CIPAYUNG,26104,5850,20254,16314,36568,2021-09-26
3174091006,JAKARTA SELATAN,JAGAKARSA,CIPEDAK,38303,8837,29466,23068,52534,2021-09-26
3174061005,JAKARTA SELATAN,CILANDAK,CIPETE SELATAN,26704,6589,20115,15978,36093,2021-09-26
3174071010,JAKARTA SELATAN,KEBAYORAN BARU,CIPETE UTARA,34102,8360,25742,19376,45118,2021-09-26
3175021003,JAKARTA TIMUR,PULO GADUNG,CIPINANG,39306,9813,29493,22389,51882,2021-09-26
3175031007,JAKARTA TIMUR,JATINEGARA,CIPINANG BESAR SELATAN,35212,10320,24892,17620,42512,2021-09-26
3175031008,JAKARTA TIMUR,JATINEGARA,CIPINANG BESAR UTARA,45319,13579,31740,22684,54424,2021-09-26
3175031005,JAKARTA TIMUR,JATINEGARA,CIPINANG CEMPEDAK,32824,9392,23432,18142,41574,2021-09-26
3175081005,JAKARTA TIMUR,MAKASAR,CIPINANG MELAYU,42308,10902,31406,24708,56114,2021-09-26
3175031006,JAKARTA TIMUR,JATINEGARA,CIPINANG MUARA,55243,15215,40028,29846,69874,2021-09-26
3174051003,JAKARTA SELATAN,KEBAYORAN LAMA,CIPULIR,39937,10577,29360,21522,50882,2021-09-26
3175091001,JAKARTA TIMUR,CIRACAS,CIRACAS,64594,15129,49465,37831,87296,2021-09-26
3175041003,JAKARTA TIMUR,KRAMAT JATI,DUKUH,24609,5900,18709,14201,32910,2021-09-26
3175071001,JAKARTA TIMUR,DUREN SAWIT,DUREN SAWIT,61160,16941,44219,33531,77750,2021-09-26
3174081004,JAKARTA SELATAN,PANCORAN,DUREN TIGA,28319,7180,21139,14549,35688,2021-09-26
3173051005,JAKARTA BARAT,KEBON JERUK,DURI KEPA,60138,14498,45640,36894,82534,2021-09-26
3173011002,JAKARTA BARAT,CENGKARENG,DURI KOSAMBI,77923,22130,55793,41346,97139,2021-09-26
3171011006,JAKARTA PUSAT,GAMBIR,DURI PULO,19610,5182,14428,10812,25240,2021-09-26
3173041011,JAKARTA BARAT,TAMBORA,DURI SELATAN,14259,3278,10981,8674,19655,2021-09-26
3173041003,JAKARTA BARAT,TAMBORA,DURI UTARA,19844,4878,14966,11326,26292,2021-09-26
3171081003,JAKARTA PUSAT,JOHAR BARU,GALUR,18243,4394,13849,10524,24373,2021-09-26
3171011001,JAKARTA PUSAT,GAMBIR,GAMBIR,2191,559,1632,1327,2959,2021-09-26
3174061004,JAKARTA SELATAN,CILANDAK,GANDARIA SELATAN,22119,5627,16492,12819,29311,2021-09-26
3174071009,JAKARTA SELATAN,KEBAYORAN BARU,GANDARIA UTARA,39922,10378,29544,22765,52309,2021-09-26
3175051001,JAKARTA TIMUR,PASAR REBO,GEDONG,35755,8954,26801,20943,47744,2021-09-26
3171071001,JAKARTA PUSAT,TANAH ABANG,GELORA,3127,763,2364,1788,4152,2021-09-26
3173031007,JAKARTA BARAT,TAMAN SARI,GLODOK,7837,1580,6257,5314,11571,2021-09-26
3171061004,JAKARTA PUSAT,MENTENG,GONDANGDIA,4100,1046,3054,2647,5701,2021-09-26
3173021001,JAKARTA BARAT,GROGOL PETAMBURAN,GROGOL,16876,4166,12710,9891,22601,2021-09-26
3174051005,JAKARTA SELATAN,KEBAYORAN LAMA,GROGOL SELATAN,44251,11770,32481,24688,57169,2021-09-26
3174051004,JAKARTA SELATAN,KEBAYORAN LAMA,GROGOL UTARA,42494,11059,31435,24131,55566,2021-09-26
3174021007,JAKARTA SELATAN,SETIA BUDI,GUNTUR,3985,940,3045,2548,5593,2021-09-26
3174071002,JAKARTA SELATAN,KEBAYORAN BARU,GUNUNG,9436,2209,7227,5881,13108,2021-09-26
3171031005,JAKARTA PUSAT,KEMAYORAN,GUNUNG SAHARI SELATAN,19199,4941,14258,11165,25423,2021-09-26
3171021004,JAKARTA PUSAT,SAWAH BESAR,GUNUNG SAHARI UTARA,16650,3629,13021,10892,23913,2021-09-26
3175081004,JAKARTA TIMUR,MAKASAR,HALIM PERDANA KUSUMAH,28363,4766,23597,20583,44180,2021-09-26
3171031003,JAKARTA PUSAT,KEMAYORAN,HARAPAN MULIA,22557,5885,16672,12610,29282,2021-09-26
3174091001,JAKARTA SELATAN,JAGAKARSA,JAGAKARSA,62389,15157,47232,37070,84302,2021-09-26
3175021007,JAKARTA TIMUR,PULO GADUNG,JATI,32757,7970,24787,19802,44589,2021-09-26
3174041002,JAKARTA SELATAN,PASAR MINGGU,JATI PADANG,37502,9976,27526,21567,49093,2021-09-26
3173071004,JAKARTA BARAT,PALMERAH,JATI PULO,28738,7111,21627,16026,37653,2021-09-26
3175061001,JAKARTA TIMUR,CAKUNG,JATINEGARA,84160,22658,61502,46721,108223,2021-09-26
3175021004,JAKARTA TIMUR,PULO GADUNG,JATINEGARA KAUM,24632,5952,18680,13666,32346,2021-09-26
3173021004,JAKARTA BARAT,GROGOL PETAMBURAN,JELAMBAR,30266,7222,23044,18408,41452,2021-09-26
3173021006,JAKARTA BARAT,GROGOL PETAMBURAN,JELAMBAR BARU,38246,9242,29004,23113,52117,2021-09-26
3173041006,JAKARTA BARAT,TAMBORA,JEMBATAN BESI,29314,8974,20340,14044,34384,2021-09-26
3173041008,JAKARTA BARAT,TAMBORA,JEMBATAN LIMA,21021,6140,14881,10776,25657,2021-09-26
3173081005,JAKARTA BARAT,KEMBANGAN,JOGLO,40839,10392,30447,23543,53990,2021-09-26
3171081001,JAKARTA PUSAT,JOHAR BARU,JOHAR BARU,37488,8638,28850,22597,51447,2021-09-26
3173041002,JAKARTA BARAT,TAMBORA,KALI ANYAR,23856,6102,17754,12957,30711,2021-09-26
3172041004,JAKARTA UTARA,CILINCING,KALIBARU,67684,22815,44869,29961,74830,2021-09-26
3174081002,JAKARTA SELATAN,PANCORAN,KALIBATA,41994,12378,29616,20306,49922,2021-09-26
3173061001,JAKARTA BARAT,KALI DERES,KALIDERES,72447,18972,53475,42388,95863,2021-09-26
3175051004,JAKARTA TIMUR,PASAR REBO,KALISARI,43212,10279,32933,25838,58771,2021-09-26
3173061004,JAKARTA BARAT,KALI DERES,KAMAL,53783,16009,37774,27969,65743,2021-09-26
3172011002,JAKARTA UTARA,PENJARINGAN,KAMAL MUARA,12930,2564,10366,8457,18823,2021-09-26
3171071007,JAKARTA PUSAT,TANAH ABANG,KAMPUNG BALI,11358,3124,8234,5765,13999,2021-09-26
3175031001,JAKARTA TIMUR,JATINEGARA,KAMPUNG MELAYU,25717,8041,17676,12843,30519,2021-09-26
3171081002,JAKARTA PUSAT,JOHAR BARU,KAMPUNG RAWA,21237,4326,16911,12642,29553,2021-09-26
3175041002,JAKARTA TIMUR,KRAMAT JATI,KAMPUNG TENGAH,43993,13573,30420,22179,52599,2021-09-26
3173011005,JAKARTA BARAT,CENGKARENG,KAPUK,134466,40085,94381,69414,163795,2021-09-26
3172011003,JAKARTA UTARA,PENJARINGAN,KAPUK MUARA,35781,8184,27597,23074,50671,2021-09-26
3171021002,JAKARTA PUSAT,SAWAH BESAR,KARANG ANYAR,25761,6171,19590,15178,34768,2021-09-26
3174021004,JAKARTA SELATAN,SETIA BUDI,KARET,9623,2308,7315,5615,12930,2021-09-26
3174021003,JAKARTA SELATAN,SETIA BUDI,KARET KUNINGAN,16055,3873,12182,9679,21861,2021-09-26
3174021002,JAKARTA SELATAN,SETIA BUDI,KARET SEMANGGI,2770,646,2124,1783,3907,2021-09-26
3171071003,JAKARTA PUSAT,TANAH ABANG,KARET TENGSIN,19271,4748,14523,10833,25356,2021-09-26
3171021003,JAKARTA PUSAT,SAWAH BESAR,KARTINI,22292,5461,16831,13408,30239,2021-09-26
3175011003,JAKARTA TIMUR,MATRAMAN,KAYU MANIS,25284,6959,18325,13179,31504,2021-09-26
3175021006,JAKARTA TIMUR,PULO GADUNG,KAYU PUTIH,40696,9668,31028,25187,56215,2021-09-26
3173031006,JAKARTA BARAT,TAMAN SARI,KEAGUNGAN,17387,4324,13063,9975,23038,2021-09-26
3174041007,JAKARTA SELATAN,PASAR MINGGU,KEBAGUSAN,44552,12172,32380,24510,56890,2021-09-26
3174051006,JAKARTA SELATAN,KEBAYORAN LAMA,KEBAYORAN LAMA SELATAN,41212,10002,31210,24392,55602,2021-09-26
3174051001,JAKARTA SELATAN,KEBAYORAN LAMA,KEBAYORAN LAMA UTARA,42422,11400,31022,23697,54719,2021-09-26
3174011004,JAKARTA SELATAN,TEBET,KEBON BARU,35165,8811,26354,20101,46455,2021-09-26
3172021005,JAKARTA UTARA,TANJUNG PRIOK,KEBON BAWANG,50952,13024,37928,29079,67007,2021-09-26
3173051001,JAKARTA BARAT,KEBON JERUK,KEBON JERUK,53887,15052,38835,29368,68203,2021-09-26
3171071006,JAKARTA PUSAT,TANAH ABANG,KEBON KACANG,21531,6386,15145,10949,26094,2021-09-26
3171011005,JAKARTA PUSAT,GAMBIR,KEBON KELAPA,10163,2569,7594,5941,13535,2021-09-26
3171031002,JAKARTA PUSAT,KEMAYORAN,KEBON KOSONG,30019,8194,21825,16662,38487,2021-09-26
3175011005,JAKARTA TIMUR,MATRAMAN,KEBON MANGGIS,16490,4069,12421,9454,21875,2021-09-26
3171071005,JAKARTA PUSAT,TANAH ABANG,KEBON MELATI,32206,10289,21917,14779,36696,2021-09-26
3175081003,JAKARTA TIMUR,MAKASAR,KEBON PALA,46614,12001,34613,26793,61406,2021-09-26
3171061005,JAKARTA PUSAT,MENTENG,KEBON SIRIH,12299,3252,9047,6647,15694,2021-09-26
3173011004,JAKARTA BARAT,CENGKARENG,KEDAUNG KALI ANGKE,32612,7816,24796,19251,44047,2021-09-26
3173051007,JAKARTA BARAT,KEBON JERUK,KEDOYA SELATAN,32165,7874,24291,18888,43179,2021-09-26
3173051006,JAKARTA BARAT,KEBON JERUK,KEDOYA UTARA,45740,10779,34961,28117,63078,2021-09-26
3173051004,JAKARTA BARAT,KEBON JERUK,KELAPA DUA,23565,6517,17048,13320,30368,2021-09-26
3175091003,JAKARTA TIMUR,CIRACAS,KELAPA DUA WETAN,46875,10423,36452,28488,64940,2021-09-26
3172061003,JAKARTA UTARA,KELAPA GADING,KELAPA GADING BARAT,35717,7413,28304,24211,52515,2021-09-26
3172061001,JAKARTA UTARA,KELAPA GADING,KELAPA GADING TIMUR,33592,6221,27371,23892,51263,2021-09-26
3173071005,JAKARTA BARAT,PALMERAH,KEMANGGISAN,32139,7876,24263,18516,42779,2021-09-26
3171031001,JAKARTA PUSAT,KEMAYORAN,KEMAYORAN,20708,5313,15395,11908,27303,2021-09-26
3173081006,JAKARTA BARAT,KEMBANGAN,KEMBANGAN SELATAN,27130,6977,20153,16380,36533,2021-09-26
3173081001,JAKARTA BARAT,KEMBANGAN,KEMBANGAN UTARA,54451,14514,39937,31164,71101,2021-09-26
3171041002,JAKARTA PUSAT,SENEN,KENARI,9579,2308,7271,5778,13049,2021-09-26
3173041005,JAKARTA BARAT,TAMBORA,KERENDANG,19973,5268,14705,10920,25625,2021-09-26
3175071003,JAKARTA TIMUR,DUREN SAWIT,KLENDER,69978,20462,49516,36254,85770,2021-09-26
3172031001,JAKARTA UTARA,KOJA,KOJA,28175,8223,19952,15189,35141,2021-09-26
3173071006,JAKARTA BARAT,PALMERAH,KOTA BAMBU SELATAN,21158,5594,15564,11328,26892,2021-09-26
3173071003,JAKARTA BARAT,PALMERAH,KOTA BAMBU UTARA,24995,6799,18196,13113,31309,2021-09-26
3171041004,JAKARTA PUSAT,SENEN,KRAMAT,28835,8242,20593,14453,35046,2021-09-26
3175041001,JAKARTA TIMUR,KRAMAT JATI,KRAMAT JATI,34144,9349,24795,18707,43502,2021-09-26
3174071003,JAKARTA SELATAN,KEBAYORAN BARU,KRAMAT PELA,14413,3429,10984,8661,19645,2021-09-26
3173031002,JAKARTA BARAT,TAMAN SARI,KRUKUT,19244,4900,14344,10815,25159,2021-09-26
3174031005,JAKARTA SELATAN,MAMPANG PRAPATAN,KUNINGAN BARAT,12785,3091,9694,7422,17116,2021-09-26
3174021008,JAKARTA SELATAN,SETIA BUDI,KUNINGAN TIMUR,6008,1521,4487,3597,8084,2021-09-26
3171041005,JAKARTA PUSAT,SENEN,KWITANG,15486,4234,11252,8532,19784,2021-09-26
3172031003,JAKARTA UTARA,KOJA,LAGOA,59065,17389,41676,30199,71875,2021-09-26
3174061002,JAKARTA SELATAN,CILANDAK,LEBAK BULUS,37626,9447,28179,22316,50495,2021-09-26
3174091004,JAKARTA SELATAN,JAGAKARSA,LENTENG AGUNG,53946,14082,39864,29928,69792,2021-09-26
3175101007,JAKARTA TIMUR,CIPAYUNG,LUBANG BUAYA,63547,15206,48341,37456,85797,2021-09-26
3175081001,JAKARTA TIMUR,MAKASAR,MAKASAR,34390,8659,25731,20439,46170,2021-09-26
3175071006,JAKARTA TIMUR,DUREN SAWIT,MALAKA JAYA,30927,7488,23439,18484,41923,2021-09-26
3175071005,JAKARTA TIMUR,DUREN SAWIT,MALAKA SARI,27530,6243,21287,17024,38311,2021-09-26
3174031001,JAKARTA SELATAN,MAMPANG PRAPATAN,MAMPANG PRAPATAN,18159,4899,13260,10193,23453,2021-09-26
3173031005,JAKARTA BARAT,TAMAN SARI,MANGGA BESAR,7707,1599,6108,4963,11071,2021-09-26
3171021005,JAKARTA PUSAT,SAWAH BESAR,MANGGA DUA SELATAN,27442,6822,20620,16065,36685,2021-09-26
3174011007,JAKARTA SELATAN,TEBET,MANGGARAI,28373,6599,21774,16238,38012,2021-09-26
3174011006,JAKARTA SELATAN,TEBET,MANGGARAI SELATAN,23075,5366,17709,13703,31412,2021-09-26
3173031003,JAKARTA BARAT,TAMAN SARI,MAPHAR,16461,4056,12405,9698,22103,2021-09-26
3172041003,JAKARTA UTARA,CILINCING,MARUNDA,28943,7962,20981,14641,35622,2021-09-26
3174071001,JAKARTA SELATAN,KEBAYORAN BARU,MELAWAI,2627,591,2036,1783,3819,2021-09-26
3171061001,JAKARTA PUSAT,MENTENG,MENTENG,25624,7152,18472,13645,32117,2021-09-26
3174021005,JAKARTA SELATAN,SETIA BUDI,MENTENG ATAS,27816,6563,21253,16238,37491,2021-09-26
3174011003,JAKARTA SELATAN,TEBET,MENTENG DALAM,36028,9163,26865,20755,47620,2021-09-26
3173081003,JAKARTA BARAT,KEMBANGAN,MERUYA SELATAN,32130,8371,23759,18375,42134,2021-09-26
3173081002,JAKARTA BARAT,KEMBANGAN,MERUYA UTARA,43752,11441,32311,26094,58405,2021-09-26
3175101004,JAKARTA TIMUR,CIPAYUNG,MUNJUL,23871,5831,18040,14266,32306,2021-09-26
3172051002,JAKARTA UTARA,PADEMANGAN,PADEMANGAN BARAT,74240,21561,52679,39420,92099,2021-09-26
3172051001,JAKARTA UTARA,PADEMANGAN,PADEMANGAN TIMUR,37736,8333,29403,23967,53370,2021-09-26
3175011004,JAKARTA TIMUR,MATRAMAN,PAL MERIAM,19769,5478,14291,10707,24998,2021-09-26
3173071001,JAKARTA BARAT,PALMERAH,PALMERAH,63011,17193,45818,34285,80103,2021-09-26
3174081001,JAKARTA SELATAN,PANCORAN,PANCORAN,19421,5366,14055,10552,24607,2021-09-26
3172021003,JAKARTA UTARA,TANJUNG PRIOK,PAPANGGO,39097,9790,29307,22642,51949,2021-09-26
3171021001,JAKARTA PUSAT,SAWAH BESAR,PASAR BARU,12035,2749,9286,7828,17114,2021-09-26
3174021006,JAKARTA SELATAN,SETIA BUDI,PASAR MANGGIS,26752,6890,19862,15275,35137,2021-09-26
3174041001,JAKARTA SELATAN,PASAR MINGGU,PASAR MINGGU,24821,6139,18682,14751,33433,2021-09-26
3171041003,JAKARTA PUSAT,SENEN,PASEBAN,23533,6311,17222,12985,30207,2021-09-26
3173061005,JAKARTA BARAT,KALI DERES,PEGADUNGAN,75587,18747,56840,46040,102880,2021-09-26
3171061002,JAKARTA PUSAT,MENTENG,PEGANGSAAN,23455,6437,17018,12066,29084,2021-09-26
3172061002,JAKARTA UTARA,KELAPA GADING,PEGANGSAAN DUA,49976,9832,40144,34419,74563,2021-09-26
3172011004,JAKARTA UTARA,PENJARINGAN,PEJAGALAN,74578,19262,55316,44235,99551,2021-09-26
3174041006,JAKARTA SELATAN,PASAR MINGGU,PEJATEN BARAT,37346,10055,27291,21447,48738,2021-09-26
3174041005,JAKARTA SELATAN,PASAR MINGGU,PEJATEN TIMUR,57656,16494,41162,30998,72160,2021-09-26
3175051005,JAKARTA TIMUR,PASAR REBO,PEKAYON,43250,10239,33011,25508,58519,2021-09-26
3173041009,JAKARTA BARAT,TAMBORA,PEKOJAN,23587,5666,17921,13969,31890,2021-09-26
3174031003,JAKARTA SELATAN,MAMPANG PRAPATAN,PELA MAMPANG,43522,11469,32053,25104,57157,2021-09-26
3174081005,JAKARTA SELATAN,PANCORAN,PENGADEGAN,21478,5001,16477,12147,28624,2021-09-26
3175061003,JAKARTA TIMUR,CAKUNG,PENGGILINGAN,99255,29238,70017,50729,120746,2021-09-26
3172011001,JAKARTA UTARA,PENJARINGAN,PENJARINGAN,88308,27266,61042,44053,105095,2021-09-26
3174101001,JAKARTA SELATAN,PESANGGRAHAN,PESANGGRAHAN,27545,6204,21341,17106,38447,2021-09-26
3171071004,JAKARTA PUSAT,TANAH ABANG,PETAMBURAN,33271,10725,22546,15385,37931,2021-09-26
3174071008,JAKARTA SELATAN,KEBAYORAN BARU,PETOGOGAN,11499,2869,8630,6573,15203,2021-09-26
3171011004,JAKARTA PUSAT,GAMBIR,PETOJO SELATAN,14692,4067,10625,8441,19066,2021-09-26
3171011003,JAKARTA PUSAT,GAMBIR,PETOJO UTARA,17458,4577,12881,9805,22686,2021-09-26
3174101004,JAKARTA SELATAN,PESANGGRAHAN,PETUKANGAN SELATAN,37187,9718,27469,21823,49292,2021-09-26
3174101003,JAKARTA SELATAN,PESANGGRAHAN,PETUKANGAN UTARA,53716,14559,39157,30237,69394,2021-09-26
3175081002,JAKARTA TIMUR,MAKASAR,PINANG RANTI,27198,7333,19865,15384,35249,2021-09-26
3173031008,JAKARTA BARAT,TAMAN SARI,PINANGSIA,10729,2450,8279,6474,14753,2021-09-26
3175011001,JAKARTA TIMUR,MATRAMAN,PISANGAN BARU,31776,8661,23115,16423,39538,2021-09-26
3175021002,JAKARTA TIMUR,PULO GADUNG,PISANGAN TIMUR,41011,10102,30909,24313,55222,2021-09-26
3172011005,JAKARTA UTARA,PENJARINGAN,PLUIT,47783,11167,36616,30408,67024,2021-09-26
3175071002,JAKARTA TIMUR,DUREN SAWIT,PONDOK BAMBU,61550,17021,44529,34051,78580,2021-09-26
3175071004,JAKARTA TIMUR,DUREN SAWIT,PONDOK KELAPA,72015,18033,53982,42439,96421,2021-09-26
3175071007,JAKARTA TIMUR,DUREN SAWIT,PONDOK KOPI,35367,9441,25926,18874,44800,2021-09-26
3174061003,JAKARTA SELATAN,CILANDAK,PONDOK LABU,46464,10463,36001,28696,64697,2021-09-26
3174051002,JAKARTA SELATAN,KEBAYORAN LAMA,PONDOK PINANG,56169,13605,42564,33255,75819,2021-09-26
3175101003,JAKARTA TIMUR,CIPAYUNG,PONDOK RANGGON,25574,6525,19049,14895,33944,2021-09-26
3101011003,KAB.ADM.KEP.SERIBU,KEP. SERIBU UTARA,PULAU HARAPAN,2060,278,1782,1358,3140,2021-09-26
3101011002,KAB.ADM.KEP.SERIBU,KEP. SERIBU UTARA,PULAU KELAPA,5528,721,4807,3339,8146,2021-09-26
3101011001,KAB.ADM.KEP.SERIBU,KEP. SERIBU UTARA,PULAU PANGGANG,5450,631,4819,3396,8215,2021-09-26
3101021003,KAB.ADM.KEP.SERIBU,KEP. SERIBU SELATAN,PULAU PARI,2765,241,2524,2189,4713,2021-09-26
3101021002,KAB.ADM.KEP.SERIBU,KEP. SERIBU SELATAN,PULAU TIDUNG,4553,469,4084,3502,7586,2021-09-26
3101021001,KAB.ADM.KEP.SERIBU,KEP. SERIBU SELATAN,PULAU UNTUNG JAWA,1941,231,1710,1496,3206,2021-09-26
3174071007,JAKARTA SELATAN,KEBAYORAN BARU,PULO,5835,1247,4588,3885,8473,2021-09-26
3175021001,JAKARTA TIMUR,PULO GADUNG,PULO GADUNG,34422,9113,25309,19412,44721,2021-09-26
3175061005,JAKARTA TIMUR,CAKUNG,PULO GEBANG,97301,24256,73045,53563,126608,2021-09-26
3174041004,JAKARTA SELATAN,PASAR MINGGU,RAGUNAN,39616,9716,29900,23686,53586,2021-09-26
3175091005,JAKARTA TIMUR,CIRACAS,RAMBUTAN,36771,10760,26011,19248,45259,2021-09-26
3172031006,JAKARTA UTARA,KOJA,RAWA BADAK SELATAN,42179,12390,29789,21478,51267,2021-09-26
3172031004,JAKARTA UTARA,KOJA,RAWA BADAK UTARA,34408,9697,24711,18326,43037,2021-09-26
3174071005,JAKARTA SELATAN,KEBAYORAN BARU,RAWA BARAT,5625,1241,4384,3589,7973,2021-09-26
3173011003,JAKARTA BARAT,CENGKARENG,RAWA BUAYA,63799,16697,47102,34335,81437,2021-09-26
3175031004,JAKARTA TIMUR,JATINEGARA,RAWA BUNGA,21434,6387,15047,11213,26260,2021-09-26
3174081003,JAKARTA SELATAN,PANCORAN,RAWA JATI,20509,5013,15496,11248,26744,2021-09-26
3175061002,JAKARTA TIMUR,CAKUNG,RAWA TERATE,24637,5666,18971,14417,33388,2021-09-26
3175021005,JAKARTA TIMUR,PULO GADUNG,RAWAMANGUN,37612,9526,28086,21896,49982,2021-09-26
3171051003,JAKARTA PUSAT,CEMPAKA PUTIH,RAWASARI,21967,5668,16299,12694,28993,2021-09-26
3173041010,JAKARTA BARAT,TAMBORA,ROA MALAKA,3484,715,2769,2311,5080,2021-09-26
3172041006,JAKARTA UTARA,CILINCING,ROROTAN,41668,10572,31096,23361,54457,2021-09-26
3174071004,JAKARTA SELATAN,KEBAYORAN BARU,SELONG,2842,626,2216,1890,4106,2021-09-26
3173061002,JAKARTA BARAT,KALI DERES,SEMANAN,71354,19796,51558,38949,90507,2021-09-26
3172041007,JAKARTA UTARA,CILINCING,SEMPER BARAT,68587,16874,51713,40428,92141,2021-09-26
3172041005,JAKARTA UTARA,CILINCING,SEMPER TIMUR,36267,9561,26706,20140,46846,2021-09-26
3174071006,JAKARTA SELATAN,KEBAYORAN BARU,SENAYAN,2771,772,1999,1575,3574,2021-09-26
3171041001,JAKARTA PUSAT,SENEN,SENEN,6804,1756,5048,4020,9068,2021-09-26
3171031004,JAKARTA PUSAT,KEMAYORAN,SERDANG,29668,7576,22092,17019,39111,2021-09-26
3174021001,JAKARTA SELATAN,SETIA BUDI,SETIA BUDI,3023,774,2249,1785,4034,2021-09-26
3175101005,JAKARTA TIMUR,CIPAYUNG,SETU,20572,5554,15018,11390,26408,2021-09-26
3173071002,JAKARTA BARAT,PALMERAH,SLIPI,16591,3895,12696,9871,22567,2021-09-26
3173081004,JAKARTA BARAT,KEMBANGAN,SRENGSENG,45523,12623,32900,25721,58621,2021-09-26
3174091002,JAKARTA SELATAN,JAGAKARSA,SRENGSENG SAWAH,58196,12717,45479,36252,81731,2021-09-26
3173051003,JAKARTA BARAT,KEBON JERUK,SUKABUMI SELATAN,37033,10678,26355,18928,45283,2021-09-26
3173051002,JAKARTA BARAT,KEBON JERUK,SUKABUMI UTARA,38290,11326,26964,18937,45901,2021-09-26
3172041002,JAKARTA UTARA,CILINCING,SUKAPURA,53949,15107,38842,29991,68833,2021-09-26
3171031007,JAKARTA PUSAT,KEMAYORAN,SUMUR BATU,22717,5831,16886,13265,30151,2021-09-26
3172021004,JAKARTA UTARA,TANJUNG PRIOK,SUNGAI BAMBU,29876,7594,22282,17222,39504,2021-09-26
3172021006,JAKARTA UTARA,TANJUNG PRIOK,SUNTER AGUNG,71805,15533,56272,46436,102708,2021-09-26
3172021002,JAKARTA UTARA,TANJUNG PRIOK,SUNTER JAYA,63031,14479,48552,39650,88202,2021-09-26
3175091004,JAKARTA TIMUR,CIRACAS,SUSUKAN,38257,9197,29060,22656,51716,2021-09-26
3173031001,JAKARTA BARAT,TAMAN SARI,TAMAN SARI,14348,3362,10986,8817,19803,2021-09-26
3173041001,JAKARTA BARAT,TAMBORA,TAMBORA,10204,2772,7432,5564,12996,2021-09-26
3173041004,JAKARTA BARAT,TAMBORA,TANAH SEREAL,26387,5674,20713,16024,36737,2021-09-26
3171081004,JAKARTA PUSAT,JOHAR BARU,TANAH TINGGI,37693,8615,29078,21978,51056,2021-09-26
3173031004,JAKARTA BARAT,TAMAN SARI,TANGKI,13324,3066,10258,8047,18305,2021-09-26
3174091005,JAKARTA SELATAN,JAGAKARSA,TANJUNG BARAT,39770,9714,30056,23033,53089,2021-09-26
3173021005,JAKARTA BARAT,GROGOL PETAMBURAN,TANJUNG DUREN SELATAN,25337,6137,19200,15665,34865,2021-09-26
3173021002,JAKARTA BARAT,GROGOL PETAMBURAN,TANJUNG DUREN UTARA,17010,3746,13264,10975,24239,2021-09-26
3172021001,JAKARTA UTARA,TANJUNG PRIOK,TANJUNG PRIOK,34588,8796,25792,19652,45444,2021-09-26
3174011002,JAKARTA SELATAN,TEBET,TEBET BARAT,21194,4489,16705,13524,30229,2021-09-26
3174011001,JAKARTA SELATAN,TEBET,TEBET TIMUR,18199,3756,14443,11939,26382,2021-09-26
3173061003,JAKARTA BARAT,KALI DERES,TEGAL ALUR,83647,22696,60951,46625,107576,2021-09-26
3174031004,JAKARTA SELATAN,MAMPANG PRAPATAN,TEGAL PARANG,32401,9458,22943,16427,39370,2021-09-26
3173021003,JAKARTA BARAT,GROGOL PETAMBURAN,TOMANG,29605,6856,22749,18091,40840,2021-09-26
3172031005,JAKARTA UTARA,KOJA,TUGU SELATAN,39122,10820,28302,20702,49004,2021-09-26
3172031002,JAKARTA UTARA,KOJA,TUGU UTARA,67670,19737,47933,34941,82874,2021-09-26
3175061006,JAKARTA TIMUR,CAKUNG,UJUNG MENTENG,29934,6590,23344,18284,41628,2021-09-26
3174101005,JAKARTA SELATAN,PESANGGRAHAN,ULUJAMI,40544,11749,28795,22103,50898,2021-09-26
3175011006,JAKARTA TIMUR,MATRAMAN,UTAN KAYU SELATAN,33511,8121,25390,19253,44643,2021-09-26
3175011002,JAKARTA TIMUR,MATRAMAN,UTAN KAYU UTARA,28169,7564,20605,15499,36104,2021-09-26
3171031008,JAKARTA PUSAT,KEMAYORAN,UTAN PANJANG,29208,7980,21228,15974,37202,2021-09-26
3172021007,JAKARTA UTARA,TANJUNG PRIOK,WARAKAS,44401,10619,33782,25391,59173,2021-09-26
3173021007,JAKARTA BARAT,GROGOL PETAMBURAN,WIJAYA KUSUMA,38934,10500,28434,22312,50746,2021-09-26
3172051003,JAKARTA UTARA,PADEMANGAN,ANCOL,23947,6869,17078,13149,30227,2021-09-27
3173041007,JAKARTA BARAT,TAMBORA,ANGKE,29381,7764,21617,16169,37786,2021-09-27
3175041005,JAKARTA TIMUR,KRAMAT JATI,BALE KAMBANG,29074,8953,20121,14096,34217,2021-09-27
3175031003,JAKARTA TIMUR,JATINEGARA,BALI MESTER,9752,2603,7149,5551,12700,2021-09-27
3175101006,JAKARTA TIMUR,CIPAYUNG,BAMBU APUS,26285,6731,19554,15178,34732,2021-09-27
3174031002,JAKARTA SELATAN,MAMPANG PRAPATAN,BANGKA,21566,6030,15536,11997,27533,2021-09-27
3175051002,JAKARTA TIMUR,PASAR REBO,BARU,23886,5050,18836,15343,34179,2021-09-27
3175041004,JAKARTA TIMUR,KRAMAT JATI,BATU AMPAR,47898,14511,33387,24235,57622,2021-09-27
3171071002,JAKARTA PUSAT,TANAH ABANG,BENDUNGAN HILIR,21494,5415,16079,12547,28626,2021-09-27
3175031002,JAKARTA TIMUR,JATINEGARA,BIDARA CINA,36689,10939,25750,18860,44610,2021-09-27
3174101002,JAKARTA SELATAN,PESANGGRAHAN,BINTARO,53098,13365,39733,31795,71528,2021-09-27
3174011005,JAKARTA SELATAN,TEBET,BUKIT DURI,34183,9058,25125,18885,44010,2021-09-27
3171041006,JAKARTA PUSAT,SENEN,BUNGUR,18144,4729,13415,10407,23822,2021-09-27
3175061007,JAKARTA TIMUR,CAKUNG,CAKUNG BARAT,57724,14466,43258,33316,76574,2021-09-27
3175061004,JAKARTA TIMUR,CAKUNG,CAKUNG TIMUR,58287,14458,43829,33790,77619,2021-09-27
3175041007,JAKARTA TIMUR,KRAMAT JATI,CAWANG,32762,9008,23754,17358,41112,2021-09-27
3175101008,JAKARTA TIMUR,CIPAYUNG,CEGER,18932,4733,14199,11041,25240,2021-09-27
3171031006,JAKARTA PUSAT,KEMAYORAN,CEMPAKA BARU,32581,8568,24013,17577,41590,2021-09-27
3171051002,JAKARTA PUSAT,CEMPAKA PUTIH,CEMPAKA PUTIH BARAT,35885,9618,26267,20610,46877,2021-09-27
3171051001,JAKARTA PUSAT,CEMPAKA PUTIH,CEMPAKA PUTIH TIMUR,24292,6106,18186,14588,32774,2021-09-27
3173011001,JAKARTA BARAT,CENGKARENG,CENGKARENG BARAT,66284,16987,49297,38401,87698,2021-09-27
3173011006,JAKARTA BARAT,CENGKARENG,CENGKARENG TIMUR,81027,20326,60701,45752,106453,2021-09-27
3175091002,JAKARTA TIMUR,CIRACAS,CIBUBUR,66364,14757,51607,40518,92125,2021-09-27
3171011002,JAKARTA PUSAT,GAMBIR,CIDENG,15390,3617,11773,9625,21398,2021-09-27
3174091003,JAKARTA SELATAN,JAGAKARSA,CIGANJUR,38497,9374,29123,22186,51309,2021-09-27
3175051003,JAKARTA TIMUR,PASAR REBO,CIJANTUNG,41419,9791,31628,24607,56235,2021-09-27
3171061003,JAKARTA PUSAT,MENTENG,CIKINI,8274,1836,6438,4597,11035,2021-09-27
3174081006,JAKARTA SELATAN,PANCORAN,CIKOKO,10547,2375,8172,6384,14556,2021-09-27
3174061001,JAKARTA SELATAN,CILANDAK,CILANDAK BARAT,51752,12351,39401,31605,71006,2021-09-27
3174041003,JAKARTA SELATAN,PASAR MINGGU,CILANDAK TIMUR,25145,6004,19141,15219,34360,2021-09-27
3175101002,JAKARTA TIMUR,CIPAYUNG,CILANGKAP,27635,6633,21002,16344,37346,2021-09-27
3175041006,JAKARTA TIMUR,KRAMAT JATI,CILILITAN,40181,11372,28809,21420,50229,2021-09-27
3172041001,JAKARTA UTARA,CILINCING,CILINCING,43609,12647,30962,22170,53132,2021-09-27
3175101001,JAKARTA TIMUR,CIPAYUNG,CIPAYUNG,26104,5832,20272,16345,36617,2021-09-27
3174091006,JAKARTA SELATAN,JAGAKARSA,CIPEDAK,38303,8768,29535,23141,52676,2021-09-27
3174061005,JAKARTA SELATAN,CILANDAK,CIPETE SELATAN,26704,6545,20159,16019,36178,2021-09-27
3174071010,JAKARTA SELATAN,KEBAYORAN BARU,CIPETE UTARA,34102,8311,25791,19423,45214,2021-09-27
3175021003,JAKARTA TIMUR,PULO GADUNG,CIPINANG,39306,9762,29544,22446,51990,2021-09-27
3175031007,JAKARTA TIMUR,JATINEGARA,CIPINANG BESAR SELATAN,35212,10280,24932,17686,42618,2021-09-27
3175031008,JAKARTA TIMUR,JATINEGARA,CIPINANG BESAR UTARA,45319,13520,31799,22737,54536,2021-09-27
3175031005,JAKARTA TIMUR,JATINEGARA,CIPINANG CEMPEDAK,32824,9357,23467,18196,41663,2021-09-27
3175081005,JAKARTA TIMUR,MAKASAR,CIPINANG MELAYU,42308,10748,31560,24803,56363,2021-09-27
3175031006,JAKARTA TIMUR,JATINEGARA,CIPINANG MUARA,55243,15163,40080,29925,70005,2021-09-27
3174051003,JAKARTA SELATAN,KEBAYORAN LAMA,CIPULIR,39937,10526,29411,21573,50984,2021-09-27
3175091001,JAKARTA TIMUR,CIRACAS,CIRACAS,64594,15049,49545,37941,87486,2021-09-27
3175041003,JAKARTA TIMUR,KRAMAT JATI,DUKUH,24609,5839,18770,14236,33006,2021-09-27
3175071001,JAKARTA TIMUR,DUREN SAWIT,DUREN SAWIT,61160,16855,44305,33610,77915,2021-09-27
3174081004,JAKARTA SELATAN,PANCORAN,DUREN TIGA,28319,7144,21175,14585,35760,2021-09-27
3173051005,JAKARTA BARAT,KEBON JERUK,DURI KEPA,60138,14421,45717,37012,82729,2021-09-27
3173011002,JAKARTA BARAT,CENGKARENG,DURI KOSAMBI,77923,22028,55895,41426,97321,2021-09-27
3171011006,JAKARTA PUSAT,GAMBIR,DURI PULO,19610,5137,14473,10838,25311,2021-09-27
3173041011,JAKARTA BARAT,TAMBORA,DURI SELATAN,14259,3262,10997,8699,19696,2021-09-27
3173041003,JAKARTA BARAT,TAMBORA,DURI UTARA,19844,4849,14995,11364,26359,2021-09-27
3171081003,JAKARTA PUSAT,JOHAR BARU,GALUR,18243,4374,13869,10544,24413,2021-09-27
3171011001,JAKARTA PUSAT,GAMBIR,GAMBIR,2191,556,1635,1329,2964,2021-09-27
3174061004,JAKARTA SELATAN,CILANDAK,GANDARIA SELATAN,22119,5601,16518,12857,29375,2021-09-27
3174071009,JAKARTA SELATAN,KEBAYORAN BARU,GANDARIA UTARA,39922,10305,29617,22834,52451,2021-09-27
3175051001,JAKARTA TIMUR,PASAR REBO,GEDONG,35755,8909,26846,20988,47834,2021-09-27
3171071001,JAKARTA PUSAT,TANAH ABANG,GELORA,3127,755,2372,1797,4169,2021-09-27
3173031007,JAKARTA BARAT,TAMAN SARI,GLODOK,7837,1574,6263,5324,11587,2021-09-27
3171061004,JAKARTA PUSAT,MENTENG,GONDANGDIA,4100,1044,3056,2653,5709,2021-09-27
3173021001,JAKARTA BARAT,GROGOL PETAMBURAN,GROGOL,16876,4143,12733,9914,22647,2021-09-27
3174051005,JAKARTA SELATAN,KEBAYORAN LAMA,GROGOL SELATAN,44251,11690,32561,24754,57315,2021-09-27
3174051004,JAKARTA SELATAN,KEBAYORAN LAMA,GROGOL UTARA,42494,10998,31496,24193,55689,2021-09-27
3174021007,JAKARTA SELATAN,SETIA BUDI,GUNTUR,3985,937,3048,2553,5601,2021-09-27
3174071002,JAKARTA SELATAN,KEBAYORAN BARU,GUNUNG,9436,2194,7242,5895,13137,2021-09-27
3171031005,JAKARTA PUSAT,KEMAYORAN,GUNUNG SAHARI SELATAN,19199,4924,14275,11198,25473,2021-09-27
3171021004,JAKARTA PUSAT,SAWAH BESAR,GUNUNG SAHARI UTARA,16650,3615,13035,10910,23945,2021-09-27
3175081004,JAKARTA TIMUR,MAKASAR,HALIM PERDANA KUSUMAH,28363,4747,23616,20615,44231,2021-09-27
3171031003,JAKARTA PUSAT,KEMAYORAN,HARAPAN MULIA,22557,5866,16691,12637,29328,2021-09-27
3174091001,JAKARTA SELATAN,JAGAKARSA,JAGAKARSA,62389,15080,47309,37127,84436,2021-09-27
3175021007,JAKARTA TIMUR,PULO GADUNG,JATI,32757,7921,24836,19852,44688,2021-09-27
3174041002,JAKARTA SELATAN,PASAR MINGGU,JATI PADANG,37502,9929,27573,21611,49184,2021-09-27
3173071004,JAKARTA BARAT,PALMERAH,JATI PULO,28738,7078,21660,16060,37720,2021-09-27
3175061001,JAKARTA TIMUR,CAKUNG,JATINEGARA,84160,22560,61600,46849,108449,2021-09-27
3175021004,JAKARTA TIMUR,PULO GADUNG,JATINEGARA KAUM,24632,5927,18705,13702,32407,2021-09-27
3173021004,JAKARTA BARAT,GROGOL PETAMBURAN,JELAMBAR,30266,7189,23077,18456,41533,2021-09-27
3173021006,JAKARTA BARAT,GROGOL PETAMBURAN,JELAMBAR BARU,38246,9161,29085,23194,52279,2021-09-27
3173041006,JAKARTA BARAT,TAMBORA,JEMBATAN BESI,29314,8945,20369,14075,34444,2021-09-27
3173041008,JAKARTA BARAT,TAMBORA,JEMBATAN LIMA,21021,6103,14918,10806,25724,2021-09-27
3173081005,JAKARTA BARAT,KEMBANGAN,JOGLO,40839,10350,30489,23594,54083,2021-09-27
3171081001,JAKARTA PUSAT,JOHAR BARU,JOHAR BARU,37488,8604,28884,22631,51515,2021-09-27
3173041002,JAKARTA BARAT,TAMBORA,KALI ANYAR,23856,6084,17772,12977,30749,2021-09-27
3172041004,JAKARTA UTARA,CILINCING,KALIBARU,67684,22756,44928,30039,74967,2021-09-27
3174081002,JAKARTA SELATAN,PANCORAN,KALIBATA,41994,12331,29663,20370,50033,2021-09-27
3173061001,JAKARTA BARAT,KALI DERES,KALIDERES,72447,18828,53619,42503,96122,2021-09-27
3175051004,JAKARTA TIMUR,PASAR REBO,KALISARI,43212,10242,32970,25899,58869,2021-09-27
3173061004,JAKARTA BARAT,KALI DERES,KAMAL,53783,15847,37936,28178,66114,2021-09-27
3172011002,JAKARTA UTARA,PENJARINGAN,KAMAL MUARA,12930,2558,10372,8470,18842,2021-09-27
3171071007,JAKARTA PUSAT,TANAH ABANG,KAMPUNG BALI,11358,3108,8250,5784,14034,2021-09-27
3175031001,JAKARTA TIMUR,JATINEGARA,KAMPUNG MELAYU,25717,7984,17733,12870,30603,2021-09-27
3171081002,JAKARTA PUSAT,JOHAR BARU,KAMPUNG RAWA,21237,4313,16924,12660,29584,2021-09-27
3175041002,JAKARTA TIMUR,KRAMAT JATI,KAMPUNG TENGAH,43993,13524,30469,22244,52713,2021-09-27
3173011005,JAKARTA BARAT,CENGKARENG,KAPUK,134466,39861,94605,69740,164345,2021-09-27
3172011003,JAKARTA UTARA,PENJARINGAN,KAPUK MUARA,35781,8156,27625,23099,50724,2021-09-27
3171021002,JAKARTA PUSAT,SAWAH BESAR,KARANG ANYAR,25761,6143,19618,15213,34831,2021-09-27
3174021004,JAKARTA SELATAN,SETIA BUDI,KARET,9623,2294,7329,5627,12956,2021-09-27
3174021003,JAKARTA SELATAN,SETIA BUDI,KARET KUNINGAN,16055,3859,12196,9701,21897,2021-09-27
3174021002,JAKARTA SELATAN,SETIA BUDI,KARET SEMANGGI,2770,640,2130,1784,3914,2021-09-27
3171071003,JAKARTA PUSAT,TANAH ABANG,KARET TENGSIN,19271,4731,14540,10867,25407,2021-09-27
3171021003,JAKARTA PUSAT,SAWAH BESAR,KARTINI,22292,5443,16849,13422,30271,2021-09-27
3175011003,JAKARTA TIMUR,MATRAMAN,KAYU MANIS,25284,6900,18384,13224,31608,2021-09-27
3175021006,JAKARTA TIMUR,PULO GADUNG,KAYU PUTIH,40696,9603,31093,25300,56393,2021-09-27
3173031006,JAKARTA BARAT,TAMAN SARI,KEAGUNGAN,17387,4299,13088,9992,23080,2021-09-27
3174041007,JAKARTA SELATAN,PASAR MINGGU,KEBAGUSAN,44552,11789,32763,24556,57319,2021-09-27
3174051006,JAKARTA SELATAN,KEBAYORAN LAMA,KEBAYORAN LAMA SELATAN,41212,9800,31412,24502,55914,2021-09-27
3174051001,JAKARTA SELATAN,KEBAYORAN LAMA,KEBAYORAN LAMA UTARA,42422,11281,31141,23792,54933,2021-09-27
3174011004,JAKARTA SELATAN,TEBET,KEBON BARU,35165,8766,26399,20149,46548,2021-09-27
3172021005,JAKARTA UTARA,TANJUNG PRIOK,KEBON BAWANG,50952,12940,38012,29158,67170,2021-09-27
3173051001,JAKARTA BARAT,KEBON JERUK,KEBON JERUK,53887,14987,38900,29432,68332,2021-09-27
3171071006,JAKARTA PUSAT,TANAH ABANG,KEBON KACANG,21531,6351,15180,10982,26162,2021-09-27
3171011005,JAKARTA PUSAT,GAMBIR,KEBON KELAPA,10163,2560,7603,5952,13555,2021-09-27
3171031002,JAKARTA PUSAT,KEMAYORAN,KEBON KOSONG,30019,8168,21851,16695,38546,2021-09-27
3175011005,JAKARTA TIMUR,MATRAMAN,KEBON MANGGIS,16490,4056,12434,9479,21913,2021-09-27
3171071005,JAKARTA PUSAT,TANAH ABANG,KEBON MELATI,32206,10228,21978,14822,36800,2021-09-27
3175081003,JAKARTA TIMUR,MAKASAR,KEBON PALA,46614,11958,34656,26858,61514,2021-09-27
3171061005,JAKARTA PUSAT,MENTENG,KEBON SIRIH,12299,3226,9073,6672,15745,2021-09-27
3173011004,JAKARTA BARAT,CENGKARENG,KEDAUNG KALI ANGKE,32612,7760,24852,19304,44156,2021-09-27
3173051007,JAKARTA BARAT,KEBON JERUK,KEDOYA SELATAN,32165,7800,24365,18962,43327,2021-09-27
3173051006,JAKARTA BARAT,KEBON JERUK,KEDOYA UTARA,45740,10723,35017,28164,63181,2021-09-27
3173051004,JAKARTA BARAT,KEBON JERUK,KELAPA DUA,23565,6486,17079,13356,30435,2021-09-27
3175091003,JAKARTA TIMUR,CIRACAS,KELAPA DUA WETAN,46875,10384,36491,28543,65034,2021-09-27
3172061003,JAKARTA UTARA,KELAPA GADING,KELAPA GADING BARAT,35717,7375,28342,24265,52607,2021-09-27
3172061001,JAKARTA UTARA,KELAPA GADING,KELAPA GADING TIMUR,33592,6202,27390,23932,51322,2021-09-27
3173071005,JAKARTA BARAT,PALMERAH,KEMANGGISAN,32139,7834,24305,18562,42867,2021-09-27
3171031001,JAKARTA PUSAT,KEMAYORAN,KEMAYORAN,20708,5300,15408,11932,27340,2021-09-27
3173081006,JAKARTA BARAT,KEMBANGAN,KEMBANGAN SELATAN,27130,6959,20171,16408,36579,2021-09-27
3173081001,JAKARTA BARAT,KEMBANGAN,KEMBANGAN UTARA,54451,14472,39979,31205,71184,2021-09-27
3171041002,JAKARTA PUSAT,SENEN,KENARI,9579,2295,7284,5794,13078,2021-09-27
3173041005,JAKARTA BARAT,TAMBORA,KERENDANG,19973,5239,14734,10949,25683,2021-09-27
3175071003,JAKARTA TIMUR,DUREN SAWIT,KLENDER,69978,20374,49604,36340,85944,2021-09-27
3172031001,JAKARTA UTARA,KOJA,KOJA,28175,7927,20248,15277,35525,2021-09-27
3173071006,JAKARTA BARAT,PALMERAH,KOTA BAMBU SELATAN,21158,5563,15595,11357,26952,2021-09-27
3173071003,JAKARTA BARAT,PALMERAH,KOTA BAMBU UTARA,24995,6770,18225,13137,31362,2021-09-27
3171041004,JAKARTA PUSAT,SENEN,KRAMAT,28835,8222,20613,14489,35102,2021-09-27
3175041001,JAKARTA TIMUR,KRAMAT JATI,KRAMAT JATI,34144,9302,24842,18774,43616,2021-09-27
3174071003,JAKARTA SELATAN,KEBAYORAN BARU,KRAMAT PELA,14413,3410,11003,8678,19681,2021-09-27
3173031002,JAKARTA BARAT,TAMAN SARI,KRUKUT,19244,4874,14370,10836,25206,2021-09-27
3174031005,JAKARTA SELATAN,MAMPANG PRAPATAN,KUNINGAN BARAT,12785,3079,9706,7426,17132,2021-09-27
3174021008,JAKARTA SELATAN,SETIA BUDI,KUNINGAN TIMUR,6008,1517,4491,3609,8100,2021-09-27
3171041005,JAKARTA PUSAT,SENEN,KWITANG,15486,4211,11275,8556,19831,2021-09-27
3172031003,JAKARTA UTARA,KOJA,LAGOA,59065,17268,41797,30279,72076,2021-09-27
3174061002,JAKARTA SELATAN,CILANDAK,LEBAK BULUS,37626,9389,28237,22388,50625,2021-09-27
3174091004,JAKARTA SELATAN,JAGAKARSA,LENTENG AGUNG,53946,13989,39957,29985,69942,2021-09-27
3175101007,JAKARTA TIMUR,CIPAYUNG,LUBANG BUAYA,63547,15126,48421,37564,85985,2021-09-27
3175081001,JAKARTA TIMUR,MAKASAR,MAKASAR,34390,8626,25764,20474,46238,2021-09-27
3175071006,JAKARTA TIMUR,DUREN SAWIT,MALAKA JAYA,30927,7439,23488,18539,42027,2021-09-27
3175071005,JAKARTA TIMUR,DUREN SAWIT,MALAKA SARI,27530,6196,21334,17064,38398,2021-09-27
3174031001,JAKARTA SELATAN,MAMPANG PRAPATAN,MAMPANG PRAPATAN,18159,4882,13277,10214,23491,2021-09-27
3173031005,JAKARTA BARAT,TAMAN SARI,MANGGA BESAR,7707,1593,6114,4969,11083,2021-09-27
3171021005,JAKARTA PUSAT,SAWAH BESAR,MANGGA DUA SELATAN,27442,6785,20657,16088,36745,2021-09-27
3174011007,JAKARTA SELATAN,TEBET,MANGGARAI,28373,6556,21817,16277,38094,2021-09-27
3174011006,JAKARTA SELATAN,TEBET,MANGGARAI SELATAN,23075,5338,17737,13731,31468,2021-09-27
3173031003,JAKARTA BARAT,TAMAN SARI,MAPHAR,16461,4034,12427,9715,22142,2021-09-27
3172041003,JAKARTA UTARA,CILINCING,MARUNDA,28943,7943,21000,14713,35713,2021-09-27
3174071001,JAKARTA SELATAN,KEBAYORAN BARU,MELAWAI,2627,590,2037,1784,3821,2021-09-27
3171061001,JAKARTA PUSAT,MENTENG,MENTENG,25624,7120,18504,13680,32184,2021-09-27
3174021005,JAKARTA SELATAN,SETIA BUDI,MENTENG ATAS,27816,6530,21286,16274,37560,2021-09-27
3174011003,JAKARTA SELATAN,TEBET,MENTENG DALAM,36028,9121,26907,20797,47704,2021-09-27
3173081003,JAKARTA BARAT,KEMBANGAN,MERUYA SELATAN,32130,8329,23801,18405,42206,2021-09-27
3173081002,JAKARTA BARAT,KEMBANGAN,MERUYA UTARA,43752,11401,32351,26141,58492,2021-09-27
3175101004,JAKARTA TIMUR,CIPAYUNG,MUNJUL,23871,5809,18062,14284,32346,2021-09-27
3172051002,JAKARTA UTARA,PADEMANGAN,PADEMANGAN BARAT,74240,21320,52920,39713,92633,2021-09-27
3172051001,JAKARTA UTARA,PADEMANGAN,PADEMANGAN TIMUR,37736,8289,29447,24022,53469,2021-09-27
3175011004,JAKARTA TIMUR,MATRAMAN,PAL MERIAM,19769,5431,14338,10761,25099,2021-09-27
3173071001,JAKARTA BARAT,PALMERAH,PALMERAH,63011,17077,45934,34410,80344,2021-09-27
3174081001,JAKARTA SELATAN,PANCORAN,PANCORAN,19421,5347,14074,10576,24650,2021-09-27
3172021003,JAKARTA UTARA,TANJUNG PRIOK,PAPANGGO,39097,9737,29360,22707,52067,2021-09-27
3171021001,JAKARTA PUSAT,SAWAH BESAR,PASAR BARU,12035,2739,9296,7845,17141,2021-09-27
3174021006,JAKARTA SELATAN,SETIA BUDI,PASAR MANGGIS,26752,6846,19906,15310,35216,2021-09-27
3174041001,JAKARTA SELATAN,PASAR MINGGU,PASAR MINGGU,24821,6113,18708,14788,33496,2021-09-27
3171041003,JAKARTA PUSAT,SENEN,PASEBAN,23533,6276,17257,13025,30282,2021-09-27
3173061005,JAKARTA BARAT,KALI DERES,PEGADUNGAN,75587,18623,56964,46165,103129,2021-09-27
3171061002,JAKARTA PUSAT,MENTENG,PEGANGSAAN,23455,6414,17041,12091,29132,2021-09-27
3172061002,JAKARTA UTARA,KELAPA GADING,PEGANGSAAN DUA,49976,9802,40174,34473,74647,2021-09-27
3172011004,JAKARTA UTARA,PENJARINGAN,PEJAGALAN,74578,19169,55409,44307,99716,2021-09-27
3174041006,JAKARTA SELATAN,PASAR MINGGU,PEJATEN BARAT,37346,10007,27339,21487,48826,2021-09-27
3174041005,JAKARTA SELATAN,PASAR MINGGU,PEJATEN TIMUR,57656,16443,41213,31062,72275,2021-09-27
3175051005,JAKARTA TIMUR,PASAR REBO,PEKAYON,43250,10200,33050,25552,58602,2021-09-27
3173041009,JAKARTA BARAT,TAMBORA,PEKOJAN,23587,5619,17968,13998,31966,2021-09-27
3174031003,JAKARTA SELATAN,MAMPANG PRAPATAN,PELA MAMPANG,43522,11326,32196,25221,57417,2021-09-27
3174081005,JAKARTA SELATAN,PANCORAN,PENGADEGAN,21478,4971,16507,12176,28683,2021-09-27
3175061003,JAKARTA TIMUR,CAKUNG,PENGGILINGAN,99255,29006,70249,50935,121184,2021-09-27
3172011001,JAKARTA UTARA,PENJARINGAN,PENJARINGAN,88308,27113,61195,44157,105352,2021-09-27
3174101001,JAKARTA SELATAN,PESANGGRAHAN,PESANGGRAHAN,27545,6169,21376,17140,38516,2021-09-27
3171071004,JAKARTA PUSAT,TANAH ABANG,PETAMBURAN,33271,10680,22591,15430,38021,2021-09-27
3174071008,JAKARTA SELATAN,KEBAYORAN BARU,PETOGOGAN,11499,2861,8638,6588,15226,2021-09-27
3171011004,JAKARTA PUSAT,GAMBIR,PETOJO SELATAN,14692,4053,10639,8459,19098,2021-09-27
3171011003,JAKARTA PUSAT,GAMBIR,PETOJO UTARA,17458,4540,12918,9834,22752,2021-09-27
3174101004,JAKARTA SELATAN,PESANGGRAHAN,PETUKANGAN SELATAN,37187,9666,27521,21855,49376,2021-09-27
3174101003,JAKARTA SELATAN,PESANGGRAHAN,PETUKANGAN UTARA,53716,14467,39249,30299,69548,2021-09-27
3175081002,JAKARTA TIMUR,MAKASAR,PINANG RANTI,27198,7300,19898,15415,35313,2021-09-27
3173031008,JAKARTA BARAT,TAMAN SARI,PINANGSIA,10729,2439,8290,6492,14782,2021-09-27
3175011001,JAKARTA TIMUR,MATRAMAN,PISANGAN BARU,31776,8582,23194,16498,39692,2021-09-27
3175021002,JAKARTA TIMUR,PULO GADUNG,PISANGAN TIMUR,41011,10047,30964,24378,55342,2021-09-27
3172011005,JAKARTA UTARA,PENJARINGAN,PLUIT,47783,11134,36649,30449,67098,2021-09-27
3175071002,JAKARTA TIMUR,DUREN SAWIT,PONDOK BAMBU,61550,16931,44619,34130,78749,2021-09-27
3175071004,JAKARTA TIMUR,DUREN SAWIT,PONDOK KELAPA,72015,17920,54095,42595,96690,2021-09-27
3175071007,JAKARTA TIMUR,DUREN SAWIT,PONDOK KOPI,35367,9382,25985,18932,44917,2021-09-27
3174061003,JAKARTA SELATAN,CILANDAK,PONDOK LABU,46464,10402,36062,28771,64833,2021-09-27
3174051002,JAKARTA SELATAN,KEBAYORAN LAMA,PONDOK PINANG,56169,13475,42694,33346,76040,2021-09-27
3175101003,JAKARTA TIMUR,CIPAYUNG,PONDOK RANGGON,25574,6501,19073,14926,33999,2021-09-27
3101011003,KAB.ADM.KEP.SERIBU,KEP. SERIBU UTARA,PULAU HARAPAN,2060,275,1785,1367,3152,2021-09-27
3101011002,KAB.ADM.KEP.SERIBU,KEP. SERIBU UTARA,PULAU KELAPA,5528,716,4812,3354,8166,2021-09-27
3101011001,KAB.ADM.KEP.SERIBU,KEP. SERIBU UTARA,PULAU PANGGANG,5450,626,4824,3476,8300,2021-09-27
3101021003,KAB.ADM.KEP.SERIBU,KEP. SERIBU SELATAN,PULAU PARI,2765,239,2526,2200,4726,2021-09-27
3101021002,KAB.ADM.KEP.SERIBU,KEP. SERIBU SELATAN,PULAU TIDUNG,4553,468,4085,3517,7602,2021-09-27
3101021001,KAB.ADM.KEP.SERIBU,KEP. SERIBU SELATAN,PULAU UNTUNG JAWA,1941,230,1711,1499,3210,2021-09-27
3174071007,JAKARTA SELATAN,KEBAYORAN BARU,PULO,5835,1242,4593,3889,8482,2021-09-27
3175021001,JAKARTA TIMUR,PULO GADUNG,PULO GADUNG,34422,9071,25351,19477,44828,2021-09-27
3175061005,JAKARTA TIMUR,CAKUNG,PULO GEBANG,97301,24014,73287,53887,127174,2021-09-27
3174041004,JAKARTA SELATAN,PASAR MINGGU,RAGUNAN,39616,9651,29965,23737,53702,2021-09-27
3175091005,JAKARTA TIMUR,CIRACAS,RAMBUTAN,36771,10723,26048,19283,45331,2021-09-27
3172031006,JAKARTA UTARA,KOJA,RAWA BADAK SELATAN,42179,12346,29833,21538,51371,2021-09-27
3172031004,JAKARTA UTARA,KOJA,RAWA BADAK UTARA,34408,9579,24829,18399,43228,2021-09-27
3174071005,JAKARTA SELATAN,KEBAYORAN BARU,RAWA BARAT,5625,1239,4386,3597,7983,2021-09-27
3173011003,JAKARTA BARAT,CENGKARENG,RAWA BUAYA,63799,16634,47165,34403,81568,2021-09-27
3175031004,JAKARTA TIMUR,JATINEGARA,RAWA BUNGA,21434,6320,15114,11248,26362,2021-09-27
3174081003,JAKARTA SELATAN,PANCORAN,RAWA JATI,20509,4990,15519,11283,26802,2021-09-27
3175061002,JAKARTA TIMUR,CAKUNG,RAWA TERATE,24637,5621,19016,14457,33473,2021-09-27
3175021005,JAKARTA TIMUR,PULO GADUNG,RAWAMANGUN,37612,9482,28130,21952,50082,2021-09-27
3171051003,JAKARTA PUSAT,CEMPAKA PUTIH,RAWASARI,21967,5650,16317,12731,29048,2021-09-27
3173041010,JAKARTA BARAT,TAMBORA,ROA MALAKA,3484,710,2774,2319,5093,2021-09-27
3172041006,JAKARTA UTARA,CILINCING,ROROTAN,41668,10517,31151,23430,54581,2021-09-27
3174071004,JAKARTA SELATAN,KEBAYORAN BARU,SELONG,2842,622,2220,1891,4111,2021-09-27
3173061002,JAKARTA BARAT,KALI DERES,SEMANAN,71354,19655,51699,39040,90739,2021-09-27
3172041007,JAKARTA UTARA,CILINCING,SEMPER BARAT,68587,16777,51810,40509,92319,2021-09-27
3172041005,JAKARTA UTARA,CILINCING,SEMPER TIMUR,36267,9525,26742,20166,46908,2021-09-27
3174071006,JAKARTA SELATAN,KEBAYORAN BARU,SENAYAN,2771,771,2000,1579,3579,2021-09-27
3171041001,JAKARTA PUSAT,SENEN,SENEN,6804,1752,5052,4025,9077,2021-09-27
3171031004,JAKARTA PUSAT,KEMAYORAN,SERDANG,29668,7541,22127,17081,39208,2021-09-27
3174021001,JAKARTA SELATAN,SETIA BUDI,SETIA BUDI,3023,770,2253,1786,4039,2021-09-27
3175101005,JAKARTA TIMUR,CIPAYUNG,SETU,20572,5538,15034,11430,26464,2021-09-27
3173071002,JAKARTA BARAT,PALMERAH,SLIPI,16591,3875,12716,9901,22617,2021-09-27
3173081004,JAKARTA BARAT,KEMBANGAN,SRENGSENG,45523,12578,32945,25772,58717,2021-09-27
3174091002,JAKARTA SELATAN,JAGAKARSA,SRENGSENG SAWAH,58196,12640,45556,36319,81875,2021-09-27
3173051003,JAKARTA BARAT,KEBON JERUK,SUKABUMI SELATAN,37033,10629,26404,18972,45376,2021-09-27
3173051002,JAKARTA BARAT,KEBON JERUK,SUKABUMI UTARA,38290,11288,27002,18999,46001,2021-09-27
3172041002,JAKARTA UTARA,CILINCING,SUKAPURA,53949,14982,38967,30079,69046,2021-09-27
3171031007,JAKARTA PUSAT,KEMAYORAN,SUMUR BATU,22717,5803,16914,13300,30214,2021-09-27
3172021004,JAKARTA UTARA,TANJUNG PRIOK,SUNGAI BAMBU,29876,7556,22320,17254,39574,2021-09-27
3172021006,JAKARTA UTARA,TANJUNG PRIOK,SUNTER AGUNG,71805,15460,56345,46508,102853,2021-09-27
3172021002,JAKARTA UTARA,TANJUNG PRIOK,SUNTER JAYA,63031,14420,48611,39707,88318,2021-09-27
3175091004,JAKARTA TIMUR,CIRACAS,SUSUKAN,38257,9166,29091,22725,51816,2021-09-27
3173031001,JAKARTA BARAT,TAMAN SARI,TAMAN SARI,14348,3339,11009,8838,19847,2021-09-27
3173041001,JAKARTA BARAT,TAMBORA,TAMBORA,10204,2762,7442,5579,13021,2021-09-27
3173041004,JAKARTA BARAT,TAMBORA,TANAH SEREAL,26387,5627,20760,16173,36933,2021-09-27
3171081004,JAKARTA PUSAT,JOHAR BARU,TANAH TINGGI,37693,8585,29108,22022,51130,2021-09-27
3173031004,JAKARTA BARAT,TAMAN SARI,TANGKI,13324,3035,10289,8066,18355,2021-09-27
3174091005,JAKARTA SELATAN,JAGAKARSA,TANJUNG BARAT,39770,9673,30097,23078,53175,2021-09-27
3173021005,JAKARTA BARAT,GROGOL PETAMBURAN,TANJUNG DUREN SELATAN,25337,6108,19229,15711,34940,2021-09-27
3173021002,JAKARTA BARAT,GROGOL PETAMBURAN,TANJUNG DUREN UTARA,17010,3729,13281,11003,24284,2021-09-27
3172021001,JAKARTA UTARA,TANJUNG PRIOK,TANJUNG PRIOK,34588,8742,25846,19725,45571,2021-09-27
3174011002,JAKARTA SELATAN,TEBET,TEBET BARAT,21194,4443,16751,13569,30320,2021-09-27
3174011001,JAKARTA SELATAN,TEBET,TEBET TIMUR,18199,3731,14468,11957,26425,2021-09-27
3173061003,JAKARTA BARAT,KALI DERES,TEGAL ALUR,83647,22279,61368,47084,108452,2021-09-27
3174031004,JAKARTA SELATAN,MAMPANG PRAPATAN,TEGAL PARANG,32401,9411,22990,16468,39458,2021-09-27
3173021003,JAKARTA BARAT,GROGOL PETAMBURAN,TOMANG,29605,6821,22784,18125,40909,2021-09-27
3172031005,JAKARTA UTARA,KOJA,TUGU SELATAN,39122,10777,28345,20730,49075,2021-09-27
3172031002,JAKARTA UTARA,KOJA,TUGU UTARA,67670,19667,48003,35022,83025,2021-09-27
3175061006,JAKARTA TIMUR,CAKUNG,UJUNG MENTENG,29934,6534,23400,18356,41756,2021-09-27
3174101005,JAKARTA SELATAN,PESANGGRAHAN,ULUJAMI,40544,11705,28839,22158,50997,2021-09-27
3175011006,JAKARTA TIMUR,MATRAMAN,UTAN KAYU SELATAN,33511,8062,25449,19314,44763,2021-09-27
3175011002,JAKARTA TIMUR,MATRAMAN,UTAN KAYU UTARA,28169,7520,20649,15533,36182,2021-09-27
3171031008,JAKARTA PUSAT,KEMAYORAN,UTAN PANJANG,29208,7936,21272,16019,37291,2021-09-27
3172021007,JAKARTA UTARA,TANJUNG PRIOK,WARAKAS,44401,10548,33853,25482,59335,2021-09-27
3173021007,JAKARTA BARAT,GROGOL PETAMBURAN,WIJAYA KUSUMA,38934,10438,28496,22352,50848,2021-09-27
3172051003,JAKARTA UTARA,PADEMANGAN,ANCOL,23947,6802,17145,13235,30380,2021-09-28
3173041007,JAKARTA BARAT,TAMBORA,ANGKE,29381,7703,21678,16251,37929,2021-09-28
3175041005,JAKARTA TIMUR,KRAMAT JATI,BALE KAMBANG,29074,8857,20217,14176,34393,2021-09-28
3175031003,JAKARTA TIMUR,JATINEGARA,BALI MESTER,9752,2567,7185,5588,12773,2021-09-28
3175101006,JAKARTA TIMUR,CIPAYUNG,BAMBU APUS,26285,6628,19657,15251,34908,2021-09-28
3174031002,JAKARTA SELATAN,MAMPANG PRAPATAN,BANGKA,21566,5979,15587,12036,27623,2021-09-28
3175051002,JAKARTA TIMUR,PASAR REBO,BARU,23886,5015,18871,15392,34263,2021-09-28
3175041004,JAKARTA TIMUR,KRAMAT JATI,BATU AMPAR,47898,14344,33554,24378,57932,2021-09-28
3171071002,JAKARTA PUSAT,TANAH ABANG,BENDUNGAN HILIR,21494,5332,16162,12604,28766,2021-09-28
3175031002,JAKARTA TIMUR,JATINEGARA,BIDARA CINA,36689,10846,25843,18922,44765,2021-09-28
3174101002,JAKARTA SELATAN,PESANGGRAHAN,BINTARO,53098,13221,39877,31895,71772,2021-09-28
3174011005,JAKARTA SELATAN,TEBET,BUKIT DURI,34183,8935,25248,18984,44232,2021-09-28
3171041006,JAKARTA PUSAT,SENEN,BUNGUR,18144,4688,13456,10494,23950,2021-09-28
3175061007,JAKARTA TIMUR,CAKUNG,CAKUNG BARAT,57724,14342,43382,33419,76801,2021-09-28
3175061004,JAKARTA TIMUR,CAKUNG,CAKUNG TIMUR,58287,14300,43987,33918,77905,2021-09-28
3175041007,JAKARTA TIMUR,KRAMAT JATI,CAWANG,32762,8926,23836,17431,41267,2021-09-28
3175101008,JAKARTA TIMUR,CIPAYUNG,CEGER,18932,4675,14257,11077,25334,2021-09-28
3171031006,JAKARTA PUSAT,KEMAYORAN,CEMPAKA BARU,32581,8498,24083,17662,41745,2021-09-28
3171051002,JAKARTA PUSAT,CEMPAKA PUTIH,CEMPAKA PUTIH BARAT,35885,9520,26365,20703,47068,2021-09-28
3171051001,JAKARTA PUSAT,CEMPAKA PUTIH,CEMPAKA PUTIH TIMUR,24292,6051,18241,14638,32879,2021-09-28
3173011001,JAKARTA BARAT,CENGKARENG,CENGKARENG BARAT,66284,16809,49475,38534,88009,2021-09-28
3173011006,JAKARTA BARAT,CENGKARENG,CENGKARENG TIMUR,81027,20118,60909,45984,106893,2021-09-28
3175091002,JAKARTA TIMUR,CIRACAS,CIBUBUR,66364,14590,51774,40634,92408,2021-09-28
3171011002,JAKARTA PUSAT,GAMBIR,CIDENG,15390,3596,11794,9653,21447,2021-09-28
3174091003,JAKARTA SELATAN,JAGAKARSA,CIGANJUR,38497,9280,29217,22239,51456,2021-09-28
3175051003,JAKARTA TIMUR,PASAR REBO,CIJANTUNG,41419,9697,31722,24671,56393,2021-09-28
3171061003,JAKARTA PUSAT,MENTENG,CIKINI,8274,1815,6459,4620,11079,2021-09-28
3174081006,JAKARTA SELATAN,PANCORAN,CIKOKO,10547,2345,8202,6414,14616,2021-09-28
3174061001,JAKARTA SELATAN,CILANDAK,CILANDAK BARAT,51752,12225,39527,31719,71246,2021-09-28
3174041003,JAKARTA SELATAN,PASAR MINGGU,CILANDAK TIMUR,25145,5953,19192,15260,34452,2021-09-28
3175101002,JAKARTA TIMUR,CIPAYUNG,CILANGKAP,27635,6547,21088,16391,37479,2021-09-28
3175041006,JAKARTA TIMUR,KRAMAT JATI,CILILITAN,40181,11259,28922,21499,50421,2021-09-28
3172041001,JAKARTA UTARA,CILINCING,CILINCING,43609,12528,31081,22295,53376,2021-09-28
3175101001,JAKARTA TIMUR,CIPAYUNG,CIPAYUNG,26104,5779,20325,16397,36722,2021-09-28
3174091006,JAKARTA SELATAN,JAGAKARSA,CIPEDAK,38303,8702,29601,23203,52804,2021-09-28
3174061005,JAKARTA SELATAN,CILANDAK,CIPETE SELATAN,26704,6469,20235,16079,36314,2021-09-28
3174071010,JAKARTA SELATAN,KEBAYORAN BARU,CIPETE UTARA,34102,8243,25859,19489,45348,2021-09-28
3175021003,JAKARTA TIMUR,PULO GADUNG,CIPINANG,39306,9671,29635,22538,52173,2021-09-28
3175031007,JAKARTA TIMUR,JATINEGARA,CIPINANG BESAR SELATAN,35212,10183,25029,17782,42811,2021-09-28
3175031008,JAKARTA TIMUR,JATINEGARA,CIPINANG BESAR UTARA,45319,13334,31985,22821,54806,2021-09-28
3175031005,JAKARTA TIMUR,JATINEGARA,CIPINANG CEMPEDAK,32824,9272,23552,18276,41828,2021-09-28
3175081005,JAKARTA TIMUR,MAKASAR,CIPINANG MELAYU,42308,10579,31729,24918,56647,2021-09-28
3175031006,JAKARTA TIMUR,JATINEGARA,CIPINANG MUARA,55243,15030,40213,30027,70240,2021-09-28
3174051003,JAKARTA SELATAN,KEBAYORAN LAMA,CIPULIR,39937,10459,29478,21649,51127,2021-09-28
3175091001,JAKARTA TIMUR,CIRACAS,CIRACAS,64594,14881,49713,38115,87828,2021-09-28
3175041003,JAKARTA TIMUR,KRAMAT JATI,DUKUH,24609,5779,18830,14273,33103,2021-09-28
3175071001,JAKARTA TIMUR,DUREN SAWIT,DUREN SAWIT,61160,16659,44501,33732,78233,2021-09-28
3174081004,JAKARTA SELATAN,PANCORAN,DUREN TIGA,28319,7084,21235,14735,35970,2021-09-28
3173051005,JAKARTA BARAT,KEBON JERUK,DURI KEPA,60138,14334,45804,37181,82985,2021-09-28
3173011002,JAKARTA BARAT,CENGKARENG,DURI KOSAMBI,77923,21839,56084,41605,97689,2021-09-28
3171011006,JAKARTA PUSAT,GAMBIR,DURI PULO,19610,5084,14526,10898,25424,2021-09-28
3173041011,JAKARTA BARAT,TAMBORA,DURI SELATAN,14259,3225,11034,8746,19780,2021-09-28
3173041003,JAKARTA BARAT,TAMBORA,DURI UTARA,19844,4813,15031,11408,26439,2021-09-28
3171081003,JAKARTA PUSAT,JOHAR BARU,GALUR,18243,4341,13902,10569,24471,2021-09-28
3171011001,JAKARTA PUSAT,GAMBIR,GAMBIR,2191,550,1641,1330,2971,2021-09-28
3174061004,JAKARTA SELATAN,CILANDAK,GANDARIA SELATAN,22119,5559,16560,12908,29468,2021-09-28
3174071009,JAKARTA SELATAN,KEBAYORAN BARU,GANDARIA UTARA,39922,10205,29717,22914,52631,2021-09-28
3175051001,JAKARTA TIMUR,PASAR REBO,GEDONG,35755,8812,26943,21095,48038,2021-09-28
3171071001,JAKARTA PUSAT,TANAH ABANG,GELORA,3127,752,2375,1807,4182,2021-09-28
3173031007,JAKARTA BARAT,TAMAN SARI,GLODOK,7837,1561,6276,5345,11621,2021-09-28
3171061004,JAKARTA PUSAT,MENTENG,GONDANGDIA,4100,1040,3060,2655,5715,2021-09-28
3173021001,JAKARTA BARAT,GROGOL PETAMBURAN,GROGOL,16876,4116,12760,9953,22713,2021-09-28
3174051005,JAKARTA SELATAN,KEBAYORAN LAMA,GROGOL SELATAN,44251,11536,32715,24823,57538,2021-09-28
3174051004,JAKARTA SELATAN,KEBAYORAN LAMA,GROGOL UTARA,42494,10861,31633,24275,55908,2021-09-28
3174021007,JAKARTA SELATAN,SETIA BUDI,GUNTUR,3985,933,3052,2564,5616,2021-09-28
3174071002,JAKARTA SELATAN,KEBAYORAN BARU,GUNUNG,9436,2179,7257,5906,13163,2021-09-28
3171031005,JAKARTA PUSAT,KEMAYORAN,GUNUNG SAHARI SELATAN,19199,4880,14319,11226,25545,2021-09-28
3171021004,JAKARTA PUSAT,SAWAH BESAR,GUNUNG SAHARI UTARA,16650,3588,13062,10937,23999,2021-09-28
3175081004,JAKARTA TIMUR,MAKASAR,HALIM PERDANA KUSUMAH,28363,4715,23648,20672,44320,2021-09-28
3171031003,JAKARTA PUSAT,KEMAYORAN,HARAPAN MULIA,22557,5805,16752,12667,29419,2021-09-28
3174091001,JAKARTA SELATAN,JAGAKARSA,JAGAKARSA,62389,14885,47504,37235,84739,2021-09-28
3175021007,JAKARTA TIMUR,PULO GADUNG,JATI,32757,7842,24915,19924,44839,2021-09-28
3174041002,JAKARTA SELATAN,PASAR MINGGU,JATI PADANG,37502,9808,27694,21696,49390,2021-09-28
3173071004,JAKARTA BARAT,PALMERAH,JATI PULO,28738,7014,21724,16120,37844,2021-09-28
3175061001,JAKARTA TIMUR,CAKUNG,JATINEGARA,84160,22364,61796,47019,108815,2021-09-28
3175021004,JAKARTA TIMUR,PULO GADUNG,JATINEGARA KAUM,24632,5874,18758,13796,32554,2021-09-28
3173021004,JAKARTA BARAT,GROGOL PETAMBURAN,JELAMBAR,30266,7092,23174,18539,41713,2021-09-28
3173021006,JAKARTA BARAT,GROGOL PETAMBURAN,JELAMBAR BARU,38246,9059,29187,23280,52467,2021-09-28
3173041006,JAKARTA BARAT,TAMBORA,JEMBATAN BESI,29314,8884,20430,14201,34631,2021-09-28
3173041008,JAKARTA BARAT,TAMBORA,JEMBATAN LIMA,21021,6051,14970,10875,25845,2021-09-28
3173081005,JAKARTA BARAT,KEMBANGAN,JOGLO,40839,10290,30549,23650,54199,2021-09-28
3171081001,JAKARTA PUSAT,JOHAR BARU,JOHAR BARU,37488,8518,28970,22695,51665,2021-09-28
3173041002,JAKARTA BARAT,TAMBORA,KALI ANYAR,23856,6033,17823,13041,30864,2021-09-28
3172041004,JAKARTA UTARA,CILINCING,KALIBARU,67684,22624,45060,30200,75260,2021-09-28
3174081002,JAKARTA SELATAN,PANCORAN,KALIBATA,41994,12193,29801,20492,50293,2021-09-28
3173061001,JAKARTA BARAT,KALI DERES,KALIDERES,72447,18620,53827,42647,96474,2021-09-28
3175051004,JAKARTA TIMUR,PASAR REBO,KALISARI,43212,10136,33076,26002,59078,2021-09-28
3173061004,JAKARTA BARAT,KALI DERES,KAMAL,53783,15646,38137,28497,66634,2021-09-28
3172011002,JAKARTA UTARA,PENJARINGAN,KAMAL MUARA,12930,2541,10389,8501,18890,2021-09-28
3171071007,JAKARTA PUSAT,TANAH ABANG,KAMPUNG BALI,11358,3080,8278,5816,14094,2021-09-28
3175031001,JAKARTA TIMUR,JATINEGARA,KAMPUNG MELAYU,25717,7904,17813,12910,30723,2021-09-28
3171081002,JAKARTA PUSAT,JOHAR BARU,KAMPUNG RAWA,21237,4274,16963,12705,29668,2021-09-28
3175041002,JAKARTA TIMUR,KRAMAT JATI,KAMPUNG TENGAH,43993,13433,30560,22336,52896,2021-09-28
3173011005,JAKARTA BARAT,CENGKARENG,KAPUK,134466,39526,94940,70332,165272,2021-09-28
3172011003,JAKARTA UTARA,PENJARINGAN,KAPUK MUARA,35781,8106,27675,23160,50835,2021-09-28
3171021002,JAKARTA PUSAT,SAWAH BESAR,KARANG ANYAR,25761,6080,19681,15250,34931,2021-09-28
3174021004,JAKARTA SELATAN,SETIA BUDI,KARET,9623,2275,7348,5634,12982,2021-09-28
3174021003,JAKARTA SELATAN,SETIA BUDI,KARET KUNINGAN,16055,3829,12226,9726,21952,2021-09-28
3174021002,JAKARTA SELATAN,SETIA BUDI,KARET SEMANGGI,2770,635,2135,1789,3924,2021-09-28
3171071003,JAKARTA PUSAT,TANAH ABANG,KARET TENGSIN,19271,4686,14585,10915,25500,2021-09-28
3171021003,JAKARTA PUSAT,SAWAH BESAR,KARTINI,22292,5363,16929,13469,30398,2021-09-28
3175011003,JAKARTA TIMUR,MATRAMAN,KAYU MANIS,25284,6825,18459,13286,31745,2021-09-28
3175021006,JAKARTA TIMUR,PULO GADUNG,KAYU PUTIH,40696,9500,31196,25392,56588,2021-09-28
3173031006,JAKARTA BARAT,TAMAN SARI,KEAGUNGAN,17387,4263,13124,10014,23138,2021-09-28
3174041007,JAKARTA SELATAN,PASAR MINGGU,KEBAGUSAN,44552,11478,33074,24650,57724,2021-09-28
3174051006,JAKARTA SELATAN,KEBAYORAN LAMA,KEBAYORAN LAMA SELATAN,41212,9681,31531,24579,56110,2021-09-28
3174051001,JAKARTA SELATAN,KEBAYORAN LAMA,KEBAYORAN LAMA UTARA,42422,11183,31239,23871,55110,2021-09-28
3174011004,JAKARTA SELATAN,TEBET,KEBON BARU,35165,8680,26485,20227,46712,2021-09-28
3172021005,JAKARTA UTARA,TANJUNG PRIOK,KEBON BAWANG,50952,12808,38144,29294,67438,2021-09-28
3173051001,JAKARTA BARAT,KEBON JERUK,KEBON JERUK,53887,14802,39085,29592,68677,2021-09-28
3171071006,JAKARTA PUSAT,TANAH ABANG,KEBON KACANG,21531,6294,15237,11028,26265,2021-09-28
3171011005,JAKARTA PUSAT,GAMBIR,KEBON KELAPA,10163,2533,7630,5969,13599,2021-09-28
3171031002,JAKARTA PUSAT,KEMAYORAN,KEBON KOSONG,30019,8115,21904,16739,38643,2021-09-28
3175011005,JAKARTA TIMUR,MATRAMAN,KEBON MANGGIS,16490,4021,12469,9520,21989,2021-09-28
3171071005,JAKARTA PUSAT,TANAH ABANG,KEBON MELATI,32206,10133,22073,14880,36953,2021-09-28
3175081003,JAKARTA TIMUR,MAKASAR,KEBON PALA,46614,11789,34825,26975,61800,2021-09-28
3171061005,JAKARTA PUSAT,MENTENG,KEBON SIRIH,12299,3186,9113,6715,15828,2021-09-28
3173011004,JAKARTA BARAT,CENGKARENG,KEDAUNG KALI ANGKE,32612,7677,24935,19373,44308,2021-09-28
3173051007,JAKARTA BARAT,KEBON JERUK,KEDOYA SELATAN,32165,7718,24447,19073,43520,2021-09-28
3173051006,JAKARTA BARAT,KEBON JERUK,KEDOYA UTARA,45740,10626,35114,28261,63375,2021-09-28
3173051004,JAKARTA BARAT,KEBON JERUK,KELAPA DUA,23565,6413,17152,13409,30561,2021-09-28
3175091003,JAKARTA TIMUR,CIRACAS,KELAPA DUA WETAN,46875,10292,36583,28653,65236,2021-09-28
3172061003,JAKARTA UTARA,KELAPA GADING,KELAPA GADING BARAT,35717,7339,28378,24338,52716,2021-09-28
3172061001,JAKARTA UTARA,KELAPA GADING,KELAPA GADING TIMUR,33592,6160,27432,23995,51427,2021-09-28
3173071005,JAKARTA BARAT,PALMERAH,KEMANGGISAN,32139,7771,24368,18643,43011,2021-09-28
3171031001,JAKARTA PUSAT,KEMAYORAN,KEMAYORAN,20708,5255,15453,11974,27427,2021-09-28
3173081006,JAKARTA BARAT,KEMBANGAN,KEMBANGAN SELATAN,27130,6916,20214,16443,36657,2021-09-28
3173081001,JAKARTA BARAT,KEMBANGAN,KEMBANGAN UTARA,54451,14358,40093,31296,71389,2021-09-28
3171041002,JAKARTA PUSAT,SENEN,KENARI,9579,2280,7299,5808,13107,2021-09-28
3173041005,JAKARTA BARAT,TAMBORA,KERENDANG,19973,5196,14777,10995,25772,2021-09-28
3175071003,JAKARTA TIMUR,DUREN SAWIT,KLENDER,69978,20192,49786,36460,86246,2021-09-28
3172031001,JAKARTA UTARA,KOJA,KOJA,28175,7785,20390,15349,35739,2021-09-28
3173071006,JAKARTA BARAT,PALMERAH,KOTA BAMBU SELATAN,21158,5514,15644,11409,27053,2021-09-28
3173071003,JAKARTA BARAT,PALMERAH,KOTA BAMBU UTARA,24995,6688,18307,13196,31503,2021-09-28
3171041004,JAKARTA PUSAT,SENEN,KRAMAT,28835,8167,20668,14533,35201,2021-09-28
3175041001,JAKARTA TIMUR,KRAMAT JATI,KRAMAT JATI,34144,9209,24935,18844,43779,2021-09-28
3174071003,JAKARTA SELATAN,KEBAYORAN BARU,KRAMAT PELA,14413,3378,11035,8708,19743,2021-09-28
3173031002,JAKARTA BARAT,TAMAN SARI,KRUKUT,19244,4807,14437,10873,25310,2021-09-28
3174031005,JAKARTA SELATAN,MAMPANG PRAPATAN,KUNINGAN BARAT,12785,3029,9756,7458,17214,2021-09-28
3174021008,JAKARTA SELATAN,SETIA BUDI,KUNINGAN TIMUR,6008,1498,4510,3620,8130,2021-09-28
3171041005,JAKARTA PUSAT,SENEN,KWITANG,15486,4186,11300,8580,19880,2021-09-28
3172031003,JAKARTA UTARA,KOJA,LAGOA,59065,17100,41965,30468,72433,2021-09-28
3174061002,JAKARTA SELATAN,CILANDAK,LEBAK BULUS,37626,9300,28326,22462,50788,2021-09-28
3174091004,JAKARTA SELATAN,JAGAKARSA,LENTENG AGUNG,53946,13625,40321,30074,70395,2021-09-28
3175101007,JAKARTA TIMUR,CIPAYUNG,LUBANG BUAYA,63547,15011,48536,37672,86208,2021-09-28
3175081001,JAKARTA TIMUR,MAKASAR,MAKASAR,34390,8528,25862,20601,46463,2021-09-28
3175071006,JAKARTA TIMUR,DUREN SAWIT,MALAKA JAYA,30927,7352,23575,18614,42189,2021-09-28
3175071005,JAKARTA TIMUR,DUREN SAWIT,MALAKA SARI,27530,6132,21398,17112,38510,2021-09-28
3174031001,JAKARTA SELATAN,MAMPANG PRAPATAN,MAMPANG PRAPATAN,18159,4846,13313,10248,23561,2021-09-28
3173031005,JAKARTA BARAT,TAMAN SARI,MANGGA BESAR,7707,1574,6133,4983,11116,2021-09-28
3171021005,JAKARTA PUSAT,SAWAH BESAR,MANGGA DUA SELATAN,27442,6744,20698,16136,36834,2021-09-28
3174011007,JAKARTA SELATAN,TEBET,MANGGARAI,28373,6487,21886,16316,38202,2021-09-28
3174011006,JAKARTA SELATAN,TEBET,MANGGARAI SELATAN,23075,5287,17788,13782,31570,2021-09-28
3173031003,JAKARTA BARAT,TAMAN SARI,MAPHAR,16461,3988,12473,9737,22210,2021-09-28
3172041003,JAKARTA UTARA,CILINCING,MARUNDA,28943,7895,21048,14814,35862,2021-09-28
3174071001,JAKARTA SELATAN,KEBAYORAN BARU,MELAWAI,2627,588,2039,1793,3832,2021-09-28
3171061001,JAKARTA PUSAT,MENTENG,MENTENG,25624,7069,18555,13712,32267,2021-09-28
3174021005,JAKARTA SELATAN,SETIA BUDI,MENTENG ATAS,27816,6463,21353,16319,37672,2021-09-28
3174011003,JAKARTA SELATAN,TEBET,MENTENG DALAM,36028,8966,27062,20881,47943,2021-09-28
3173081003,JAKARTA BARAT,KEMBANGAN,MERUYA SELATAN,32130,8272,23858,18457,42315,2021-09-28
3173081002,JAKARTA BARAT,KEMBANGAN,MERUYA UTARA,43752,11318,32434,26221,58655,2021-09-28
3175101004,JAKARTA TIMUR,CIPAYUNG,MUNJUL,23871,5771,18100,14323,32423,2021-09-28
3172051002,JAKARTA UTARA,PADEMANGAN,PADEMANGAN BARAT,74240,21095,53145,39978,93123,2021-09-28
3172051001,JAKARTA UTARA,PADEMANGAN,PADEMANGAN TIMUR,37736,8206,29530,24107,53637,2021-09-28
3175011004,JAKARTA TIMUR,MATRAMAN,PAL MERIAM,19769,5400,14369,10810,25179,2021-09-28
3173071001,JAKARTA BARAT,PALMERAH,PALMERAH,63011,16922,46089,34614,80703,2021-09-28
3174081001,JAKARTA SELATAN,PANCORAN,PANCORAN,19421,5307,14114,10644,24758,2021-09-28
3172021003,JAKARTA UTARA,TANJUNG PRIOK,PAPANGGO,39097,9623,29474,22794,52268,2021-09-28
3171021001,JAKARTA PUSAT,SAWAH BESAR,PASAR BARU,12035,2723,9312,7862,17174,2021-09-28
3174021006,JAKARTA SELATAN,SETIA BUDI,PASAR MANGGIS,26752,6781,19971,15357,35328,2021-09-28
3174041001,JAKARTA SELATAN,PASAR MINGGU,PASAR MINGGU,24821,6050,18771,14836,33607,2021-09-28
3171041003,JAKARTA PUSAT,SENEN,PASEBAN,23533,6229,17304,13107,30411,2021-09-28
3173061005,JAKARTA BARAT,KALI DERES,PEGADUNGAN,75587,18453,57134,46359,103493,2021-09-28
3171061002,JAKARTA PUSAT,MENTENG,PEGANGSAAN,23455,6349,17106,12135,29241,2021-09-28
3172061002,JAKARTA UTARA,KELAPA GADING,PEGANGSAAN DUA,49976,9740,40236,34574,74810,2021-09-28
3172011004,JAKARTA UTARA,PENJARINGAN,PEJAGALAN,74578,18983,55595,44465,100060,2021-09-28
3174041006,JAKARTA SELATAN,PASAR MINGGU,PEJATEN BARAT,37346,9902,27444,21555,48999,2021-09-28
3174041005,JAKARTA SELATAN,PASAR MINGGU,PEJATEN TIMUR,57656,16339,41317,31226,72543,2021-09-28
3175051005,JAKARTA TIMUR,PASAR REBO,PEKAYON,43250,10089,33161,25649,58810,2021-09-28
3173041009,JAKARTA BARAT,TAMBORA,PEKOJAN,23587,5572,18015,14040,32055,2021-09-28
3174031003,JAKARTA SELATAN,MAMPANG PRAPATAN,PELA MAMPANG,43522,11194,32328,25294,57622,2021-09-28
3174081005,JAKARTA SELATAN,PANCORAN,PENGADEGAN,21478,4919,16559,12248,28807,2021-09-28
3175061003,JAKARTA TIMUR,CAKUNG,PENGGILINGAN,99255,28666,70589,51257,121846,2021-09-28
3172011001,JAKARTA UTARA,PENJARINGAN,PENJARINGAN,88308,26893,61415,44353,105768,2021-09-28
3174101001,JAKARTA SELATAN,PESANGGRAHAN,PESANGGRAHAN,27545,6098,21447,17202,38649,2021-09-28
3171071004,JAKARTA PUSAT,TANAH ABANG,PETAMBURAN,33271,10604,22667,15504,38171,2021-09-28
3174071008,JAKARTA SELATAN,KEBAYORAN BARU,PETOGOGAN,11499,2835,8664,6604,15268,2021-09-28
3171011004,JAKARTA PUSAT,GAMBIR,PETOJO SELATAN,14692,4004,10688,8491,19179,2021-09-28
3171011003,JAKARTA PUSAT,GAMBIR,PETOJO UTARA,17458,4508,12950,9865,22815,2021-09-28
3174101004,JAKARTA SELATAN,PESANGGRAHAN,PETUKANGAN SELATAN,37187,9590,27597,21920,49517,2021-09-28
3174101003,JAKARTA SELATAN,PESANGGRAHAN,PETUKANGAN UTARA,53716,14350,39366,30375,69741,2021-09-28
3175081002,JAKARTA TIMUR,MAKASAR,PINANG RANTI,27198,7251,19947,15465,35412,2021-09-28
3173031008,JAKARTA BARAT,TAMAN SARI,PINANGSIA,10729,2422,8307,6513,14820,2021-09-28
3175011001,JAKARTA TIMUR,MATRAMAN,PISANGAN BARU,31776,8462,23314,16691,40005,2021-09-28
3175021002,JAKARTA TIMUR,PULO GADUNG,PISANGAN TIMUR,41011,9950,31061,24477,55538,2021-09-28
3172011005,JAKARTA UTARA,PENJARINGAN,PLUIT,47783,11049,36734,30523,67257,2021-09-28
3175071002,JAKARTA TIMUR,DUREN SAWIT,PONDOK BAMBU,61550,16778,44772,34273,79045,2021-09-28
3175071004,JAKARTA TIMUR,DUREN SAWIT,PONDOK KELAPA,72015,17709,54306,42809,97115,2021-09-28
3175071007,JAKARTA TIMUR,DUREN SAWIT,PONDOK KOPI,35367,9276,26091,19017,45108,2021-09-28
3174061003,JAKARTA SELATAN,CILANDAK,PONDOK LABU,46464,10293,36171,28857,65028,2021-09-28
3174051002,JAKARTA SELATAN,KEBAYORAN LAMA,PONDOK PINANG,56169,13341,42828,33422,76250,2021-09-28
3175101003,JAKARTA TIMUR,CIPAYUNG,PONDOK RANGGON,25574,6453,19121,14973,34094,2021-09-28
3101011003,KAB.ADM.KEP.SERIBU,KEP. SERIBU UTARA,PULAU HARAPAN,2060,272,1788,1400,3188,2021-09-28
3101011002,KAB.ADM.KEP.SERIBU,KEP. SERIBU UTARA,PULAU KELAPA,5528,709,4819,3393,8212,2021-09-28
3101011001,KAB.ADM.KEP.SERIBU,KEP. SERIBU UTARA,PULAU PANGGANG,5450,618,4832,3604,8436,2021-09-28
3101021003,KAB.ADM.KEP.SERIBU,KEP. SERIBU SELATAN,PULAU PARI,2765,238,2527,2202,4729,2021-09-28
3101021002,KAB.ADM.KEP.SERIBU,KEP. SERIBU SELATAN,PULAU TIDUNG,4553,463,4090,3540,7630,2021-09-28
3101021001,KAB.ADM.KEP.SERIBU,KEP. SERIBU SELATAN,PULAU UNTUNG JAWA,1941,229,1712,1512,3224,2021-09-28
3174071007,JAKARTA SELATAN,KEBAYORAN BARU,PULO,5835,1231,4604,3899,8503,2021-09-28
3175021001,JAKARTA TIMUR,PULO GADUNG,PULO GADUNG,34422,8978,25444,19580,45024,2021-09-28
3175061005,JAKARTA TIMUR,CAKUNG,PULO GEBANG,97301,23734,73567,54157,127724,2021-09-28
3174041004,JAKARTA SELATAN,PASAR MINGGU,RAGUNAN,39616,9533,30083,23796,53879,2021-09-28
3175091005,JAKARTA TIMUR,CIRACAS,RAMBUTAN,36771,10621,26150,19356,45506,2021-09-28
3172031006,JAKARTA UTARA,KOJA,RAWA BADAK SELATAN,42179,12280,29899,21643,51542,2021-09-28
3172031004,JAKARTA UTARA,KOJA,RAWA BADAK UTARA,34408,9473,24935,18465,43400,2021-09-28
3174071005,JAKARTA SELATAN,KEBAYORAN BARU,RAWA BARAT,5625,1183,4442,3634,8076,2021-09-28
3173011003,JAKARTA BARAT,CENGKARENG,RAWA BUAYA,63799,16439,47360,34534,81894,2021-09-28
3175031004,JAKARTA TIMUR,JATINEGARA,RAWA BUNGA,21434,6251,15183,11292,26475,2021-09-28
3174081003,JAKARTA SELATAN,PANCORAN,RAWA JATI,20509,4953,15556,11332,26888,2021-09-28
3175061002,JAKARTA TIMUR,CAKUNG,RAWA TERATE,24637,5580,19057,14520,33577,2021-09-28
3175021005,JAKARTA TIMUR,PULO GADUNG,RAWAMANGUN,37612,9389,28223,22041,50264,2021-09-28
3171051003,JAKARTA PUSAT,CEMPAKA PUTIH,RAWASARI,21967,5607,16360,12799,29159,2021-09-28
3173041010,JAKARTA BARAT,TAMBORA,ROA MALAKA,3484,704,2780,2330,5110,2021-09-28
3172041006,JAKARTA UTARA,CILINCING,ROROTAN,41668,10409,31259,23511,54770,2021-09-28
3174071004,JAKARTA SELATAN,KEBAYORAN BARU,SELONG,2842,617,2225,1894,4119,2021-09-28
3173061002,JAKARTA BARAT,KALI DERES,SEMANAN,71354,19449,51905,39210,91115,2021-09-28
3172041007,JAKARTA UTARA,CILINCING,SEMPER BARAT,68587,16603,51984,40633,92617,2021-09-28
3172041005,JAKARTA UTARA,CILINCING,SEMPER TIMUR,36267,9430,26837,20243,47080,2021-09-28
3174071006,JAKARTA SELATAN,KEBAYORAN BARU,SENAYAN,2771,768,2003,1587,3590,2021-09-28
3171041001,JAKARTA PUSAT,SENEN,SENEN,6804,1736,5068,4032,9100,2021-09-28
3171031004,JAKARTA PUSAT,KEMAYORAN,SERDANG,29668,7442,22226,17159,39385,2021-09-28
3174021001,JAKARTA SELATAN,SETIA BUDI,SETIA BUDI,3023,765,2258,1789,4047,2021-09-28
3175101005,JAKARTA TIMUR,CIPAYUNG,SETU,20572,5485,15087,11472,26559,2021-09-28
3173071002,JAKARTA BARAT,PALMERAH,SLIPI,16591,3842,12749,9927,22676,2021-09-28
3173081004,JAKARTA BARAT,KEMBANGAN,SRENGSENG,45523,12462,33061,25882,58943,2021-09-28
3174091002,JAKARTA SELATAN,JAGAKARSA,SRENGSENG SAWAH,58196,12476,45720,36419,82139,2021-09-28
3173051003,JAKARTA BARAT,KEBON JERUK,SUKABUMI SELATAN,37033,10530,26503,19097,45600,2021-09-28
3173051002,JAKARTA BARAT,KEBON JERUK,SUKABUMI UTARA,38290,11188,27102,19124,46226,2021-09-28
3172041002,JAKARTA UTARA,CILINCING,SUKAPURA,53949,14825,39124,30207,69331,2021-09-28
3171031007,JAKARTA PUSAT,KEMAYORAN,SUMUR BATU,22717,5739,16978,13362,30340,2021-09-28
3172021004,JAKARTA UTARA,TANJUNG PRIOK,SUNGAI BAMBU,29876,7478,22398,17315,39713,2021-09-28
3172021006,JAKARTA UTARA,TANJUNG PRIOK,SUNTER AGUNG,71805,15298,56507,46649,103156,2021-09-28
3172021002,JAKARTA UTARA,TANJUNG PRIOK,SUNTER JAYA,63031,14280,48751,39823,88574,2021-09-28
3175091004,JAKARTA TIMUR,CIRACAS,SUSUKAN,38257,9036,29221,22818,52039,2021-09-28
3173031001,JAKARTA BARAT,TAMAN SARI,TAMAN SARI,14348,3299,11049,8856,19905,2021-09-28
3173041001,JAKARTA BARAT,TAMBORA,TAMBORA,10204,2737,7467,5614,13081,2021-09-28
3173041004,JAKARTA BARAT,TAMBORA,TANAH SEREAL,26387,5565,20822,16305,37127,2021-09-28
3171081004,JAKARTA PUSAT,JOHAR BARU,TANAH TINGGI,37693,8503,29190,22096,51286,2021-09-28
3173031004,JAKARTA BARAT,TAMAN SARI,TANGKI,13324,2990,10334,8082,18416,2021-09-28
3174091005,JAKARTA SELATAN,JAGAKARSA,TANJUNG BARAT,39770,9562,30208,23173,53381,2021-09-28
3173021005,JAKARTA BARAT,GROGOL PETAMBURAN,TANJUNG DUREN SELATAN,25337,6043,19294,15783,35077,2021-09-28
3173021002,JAKARTA BARAT,GROGOL PETAMBURAN,TANJUNG DUREN UTARA,17010,3685,13325,11058,24383,2021-09-28
3172021001,JAKARTA UTARA,TANJUNG PRIOK,TANJUNG PRIOK,34588,8668,25920,19813,45733,2021-09-28
3174011002,JAKARTA SELATAN,TEBET,TEBET BARAT,21194,4392,16802,13608,30410,2021-09-28
3174011001,JAKARTA SELATAN,TEBET,TEBET TIMUR,18199,3684,14515,11993,26508,2021-09-28
3173061003,JAKARTA BARAT,KALI DERES,TEGAL ALUR,83647,21857,61790,47505,109295,2021-09-28
3174031004,JAKARTA SELATAN,MAMPANG PRAPATAN,TEGAL PARANG,32401,9355,23046,16529,39575,2021-09-28
3173021003,JAKARTA BARAT,GROGOL PETAMBURAN,TOMANG,29605,6753,22852,18189,41041,2021-09-28
3172031005,JAKARTA UTARA,KOJA,TUGU SELATAN,39122,10718,28404,20882,49286,2021-09-28
3172031002,JAKARTA UTARA,KOJA,TUGU UTARA,67670,19442,48228,35192,83420,2021-09-28
3175061006,JAKARTA TIMUR,CAKUNG,UJUNG MENTENG,29934,6472,23462,18440,41902,2021-09-28
3174101005,JAKARTA SELATAN,PESANGGRAHAN,ULUJAMI,40544,11572,28972,22236,51208,2021-09-28
3175011006,JAKARTA TIMUR,MATRAMAN,UTAN KAYU SELATAN,33511,7954,25557,19407,44964,2021-09-28
3175011002,JAKARTA TIMUR,MATRAMAN,UTAN KAYU UTARA,28169,7450,20719,15612,36331,2021-09-28
3171031008,JAKARTA PUSAT,KEMAYORAN,UTAN PANJANG,29208,7873,21335,16068,37403,2021-09-28
3172021007,JAKARTA UTARA,TANJUNG PRIOK,WARAKAS,44401,10466,33935,25573,59508,2021-09-28
3173021007,JAKARTA BARAT,GROGOL PETAMBURAN,WIJAYA KUSUMA,38934,10358,28576,22433,51009,2021-09-28
3172051003,JAKARTA UTARA,PADEMANGAN,ANCOL,23947,6743,17204,13333,30537,2021-09-29
3173041007,JAKARTA BARAT,TAMBORA,ANGKE,29381,7641,21740,16369,38109,2021-09-29
3175041005,JAKARTA TIMUR,KRAMAT JATI,BALE KAMBANG,29074,8779,20295,14330,34625,2021-09-29
3175031003,JAKARTA TIMUR,JATINEGARA,BALI MESTER,9752,2543,7209,5627,12836,2021-09-29
3175101006,JAKARTA TIMUR,CIPAYUNG,BAMBU APUS,26285,6381,19904,15336,35240,2021-09-29
3174031002,JAKARTA SELATAN,MAMPANG PRAPATAN,BANGKA,21566,5932,15634,12106,27740,2021-09-29
3175051002,JAKARTA TIMUR,PASAR REBO,BARU,23886,4953,18933,15493,34426,2021-09-29
3175041004,JAKARTA TIMUR,KRAMAT JATI,BATU AMPAR,47898,14204,33694,24580,58274,2021-09-29
3171071002,JAKARTA PUSAT,TANAH ABANG,BENDUNGAN HILIR,21494,5285,16209,12690,28899,2021-09-29
3175031002,JAKARTA TIMUR,JATINEGARA,BIDARA CINA,36689,10768,25921,19068,44989,2021-09-29
3174101002,JAKARTA SELATAN,PESANGGRAHAN,BINTARO,53098,13066,40032,32066,72098,2021-09-29
3174011005,JAKARTA SELATAN,TEBET,BUKIT DURI,34183,8825,25358,19183,44541,2021-09-29
3171041006,JAKARTA PUSAT,SENEN,BUNGUR,18144,4660,13484,10552,24036,2021-09-29
3175061007,JAKARTA TIMUR,CAKUNG,CAKUNG BARAT,57724,14225,43499,33620,77119,2021-09-29
3175061004,JAKARTA TIMUR,CAKUNG,CAKUNG TIMUR,58287,14163,44124,34197,78321,2021-09-29
3175041007,JAKARTA TIMUR,KRAMAT JATI,CAWANG,32762,8828,23934,17562,41496,2021-09-29
3175101008,JAKARTA TIMUR,CIPAYUNG,CEGER,18932,4628,14304,11134,25438,2021-09-29
3171031006,JAKARTA PUSAT,KEMAYORAN,CEMPAKA BARU,32581,8416,24165,17757,41922,2021-09-29
3171051002,JAKARTA PUSAT,CEMPAKA PUTIH,CEMPAKA PUTIH BARAT,35885,9416,26469,20833,47302,2021-09-29
3171051001,JAKARTA PUSAT,CEMPAKA PUTIH,CEMPAKA PUTIH TIMUR,24292,6006,18286,14731,33017,2021-09-29
3173011001,JAKARTA BARAT,CENGKARENG,CENGKARENG BARAT,66284,16652,49632,38730,88362,2021-09-29
3173011006,JAKARTA BARAT,CENGKARENG,CENGKARENG TIMUR,81027,19878,61149,46299,107448,2021-09-29
3175091002,JAKARTA TIMUR,CIRACAS,CIBUBUR,66364,14428,51936,40837,92773,2021-09-29
3171011002,JAKARTA PUSAT,GAMBIR,CIDENG,15390,3567,11823,9693,21516,2021-09-29
3174091003,JAKARTA SELATAN,JAGAKARSA,CIGANJUR,38497,8765,29732,22337,52069,2021-09-29
3175051003,JAKARTA TIMUR,PASAR REBO,CIJANTUNG,41419,9582,31837,24836,56673,2021-09-29
3171061003,JAKARTA PUSAT,MENTENG,CIKINI,8274,1795,6479,4646,11125,2021-09-29
3174081006,JAKARTA SELATAN,PANCORAN,CIKOKO,10547,2292,8255,6487,14742,2021-09-29
3174061001,JAKARTA SELATAN,CILANDAK,CILANDAK BARAT,51752,12096,39656,31987,71643,2021-09-29
3174041003,JAKARTA SELATAN,PASAR MINGGU,CILANDAK TIMUR,25145,5896,19249,15337,34586,2021-09-29
3175101002,JAKARTA TIMUR,CIPAYUNG,CILANGKAP,27635,6495,21140,16475,37615,2021-09-29
3175041006,JAKARTA TIMUR,KRAMAT JATI,CILILITAN,40181,11133,29048,21651,50699,2021-09-29
3172041001,JAKARTA UTARA,CILINCING,CILINCING,43609,12429,31180,22473,53653,2021-09-29
3175101001,JAKARTA TIMUR,CIPAYUNG,CIPAYUNG,26104,5717,20387,16461,36848,2021-09-29
3174091006,JAKARTA SELATAN,JAGAKARSA,CIPEDAK,38303,8594,29709,23311,53020,2021-09-29
3174061005,JAKARTA SELATAN,CILANDAK,CIPETE SELATAN,26704,6390,20314,16197,36511,2021-09-29
3174071010,JAKARTA SELATAN,KEBAYORAN BARU,CIPETE UTARA,34102,8178,25924,19582,45506,2021-09-29
3175021003,JAKARTA TIMUR,PULO GADUNG,CIPINANG,39306,9586,29720,22701,52421,2021-09-29
3175031007,JAKARTA TIMUR,JATINEGARA,CIPINANG BESAR SELATAN,35212,10106,25106,17924,43030,2021-09-29
3175031008,JAKARTA TIMUR,JATINEGARA,CIPINANG BESAR UTARA,45319,13138,32181,22986,55167,2021-09-29
3175031005,JAKARTA TIMUR,JATINEGARA,CIPINANG CEMPEDAK,32824,9148,23676,18416,42092,2021-09-29
3175081005,JAKARTA TIMUR,MAKASAR,CIPINANG MELAYU,42308,10471,31837,25067,56904,2021-09-29
3175031006,JAKARTA TIMUR,JATINEGARA,CIPINANG MUARA,55243,14829,40414,30278,70692,2021-09-29
3174051003,JAKARTA SELATAN,KEBAYORAN LAMA,CIPULIR,39937,10387,29550,21795,51345,2021-09-29
3175091001,JAKARTA TIMUR,CIRACAS,CIRACAS,64594,14730,49864,38332,88196,2021-09-29
3175041003,JAKARTA TIMUR,KRAMAT JATI,DUKUH,24609,5717,18892,14393,33285,2021-09-29
3175071001,JAKARTA TIMUR,DUREN SAWIT,DUREN SAWIT,61160,16495,44665,33981,78646,2021-09-29
3174081004,JAKARTA SELATAN,PANCORAN,DUREN TIGA,28319,7025,21294,15020,36314,2021-09-29
3173051005,JAKARTA BARAT,KEBON JERUK,DURI KEPA,60138,14243,45895,37452,83347,2021-09-29
3173011002,JAKARTA BARAT,CENGKARENG,DURI KOSAMBI,77923,21551,56372,41830,98202,2021-09-29
3171011006,JAKARTA PUSAT,GAMBIR,DURI PULO,19610,5029,14581,10968,25549,2021-09-29
3173041011,JAKARTA BARAT,TAMBORA,DURI SELATAN,14259,3201,11058,8801,19859,2021-09-29
3173041003,JAKARTA BARAT,TAMBORA,DURI UTARA,19844,4744,15100,11521,26621,2021-09-29
3171081003,JAKARTA PUSAT,JOHAR BARU,GALUR,18243,4303,13940,10616,24556,2021-09-29
3171011001,JAKARTA PUSAT,GAMBIR,GAMBIR,2191,546,1645,1335,2980,2021-09-29
3174061004,JAKARTA SELATAN,CILANDAK,GANDARIA SELATAN,22119,5484,16635,12980,29615,2021-09-29
3174071009,JAKARTA SELATAN,KEBAYORAN BARU,GANDARIA UTARA,39922,10111,29811,23068,52879,2021-09-29
3175051001,JAKARTA TIMUR,PASAR REBO,GEDONG,35755,8732,27023,21230,48253,2021-09-29
3171071001,JAKARTA PUSAT,TANAH ABANG,GELORA,3127,748,2379,1825,4204,2021-09-29
3173031007,JAKARTA BARAT,TAMAN SARI,GLODOK,7837,1546,6291,5369,11660,2021-09-29
3171061004,JAKARTA PUSAT,MENTENG,GONDANGDIA,4100,1037,3063,2671,5734,2021-09-29
3173021001,JAKARTA BARAT,GROGOL PETAMBURAN,GROGOL,16876,4072,12804,10020,22824,2021-09-29
3174051005,JAKARTA SELATAN,KEBAYORAN LAMA,GROGOL SELATAN,44251,11421,32830,24954,57784,2021-09-29
3174051004,JAKARTA SELATAN,KEBAYORAN LAMA,GROGOL UTARA,42494,10780,31714,24435,56149,2021-09-29
3174021007,JAKARTA SELATAN,SETIA BUDI,GUNTUR,3985,931,3054,2575,5629,2021-09-29
3174071002,JAKARTA SELATAN,KEBAYORAN BARU,GUNUNG,9436,2160,7276,5949,13225,2021-09-29
3171031005,JAKARTA PUSAT,KEMAYORAN,GUNUNG SAHARI SELATAN,19199,4832,14367,11277,25644,2021-09-29
3171021004,JAKARTA PUSAT,SAWAH BESAR,GUNUNG SAHARI UTARA,16650,3554,13096,10983,24079,2021-09-29
3175081004,JAKARTA TIMUR,MAKASAR,HALIM PERDANA KUSUMAH,28363,4674,23689,20740,44429,2021-09-29
3171031003,JAKARTA PUSAT,KEMAYORAN,HARAPAN MULIA,22557,5736,16821,12748,29569,2021-09-29
3174091001,JAKARTA SELATAN,JAGAKARSA,JAGAKARSA,62389,14696,47693,37428,85121,2021-09-29
3175021007,JAKARTA TIMUR,PULO GADUNG,JATI,32757,7778,24979,20095,45074,2021-09-29
3174041002,JAKARTA SELATAN,PASAR MINGGU,JATI PADANG,37502,9677,27825,21802,49627,2021-09-29
3173071004,JAKARTA BARAT,PALMERAH,JATI PULO,28738,6947,21791,16217,38008,2021-09-29
3175061001,JAKARTA TIMUR,CAKUNG,JATINEGARA,84160,22167,61993,47410,109403,2021-09-29
3175021004,JAKARTA TIMUR,PULO GADUNG,JATINEGARA KAUM,24632,5794,18838,13971,32809,2021-09-29
3173021004,JAKARTA BARAT,GROGOL PETAMBURAN,JELAMBAR,30266,7028,23238,18638,41876,2021-09-29
3173021006,JAKARTA BARAT,GROGOL PETAMBURAN,JELAMBAR BARU,38246,8960,29286,23412,52698,2021-09-29
3173041006,JAKARTA BARAT,TAMBORA,JEMBATAN BESI,29314,8802,20512,14405,34917,2021-09-29
3173041008,JAKARTA BARAT,TAMBORA,JEMBATAN LIMA,21021,5985,15036,10961,25997,2021-09-29
3173081005,JAKARTA BARAT,KEMBANGAN,JOGLO,40839,10178,30661,24066,54727,2021-09-29
3171081001,JAKARTA PUSAT,JOHAR BARU,JOHAR BARU,37488,8438,29050,22832,51882,2021-09-29
3173041002,JAKARTA BARAT,TAMBORA,KALI ANYAR,23856,5974,17882,13133,31015,2021-09-29
3172041004,JAKARTA UTARA,CILINCING,KALIBARU,67684,22489,45195,30464,75659,2021-09-29
3174081002,JAKARTA SELATAN,PANCORAN,KALIBATA,41994,12041,29953,20855,50808,2021-09-29
3173061001,JAKARTA BARAT,KALI DERES,KALIDERES,72447,18456,53991,42825,96816,2021-09-29
3175051004,JAKARTA TIMUR,PASAR REBO,KALISARI,43212,10011,33201,26157,59358,2021-09-29
3173061004,JAKARTA BARAT,KALI DERES,KAMAL,53783,15524,38259,28592,66851,2021-09-29
3172011002,JAKARTA UTARA,PENJARINGAN,KAMAL MUARA,12930,2528,10402,8531,18933,2021-09-29
3171071007,JAKARTA PUSAT,TANAH ABANG,KAMPUNG BALI,11358,3048,8310,5855,14165,2021-09-29
3175031001,JAKARTA TIMUR,JATINEGARA,KAMPUNG MELAYU,25717,7829,17888,13012,30900,2021-09-29
3171081002,JAKARTA PUSAT,JOHAR BARU,KAMPUNG RAWA,21237,4235,17002,12768,29770,2021-09-29
3175041002,JAKARTA TIMUR,KRAMAT JATI,KAMPUNG TENGAH,43993,13344,30649,22486,53135,2021-09-29
3173011005,JAKARTA BARAT,CENGKARENG,KAPUK,134466,38988,95478,70857,166335,2021-09-29
3172011003,JAKARTA UTARA,PENJARINGAN,KAPUK MUARA,35781,8053,27728,23261,50989,2021-09-29
3171021002,JAKARTA PUSAT,SAWAH BESAR,KARANG ANYAR,25761,6023,19738,15336,35074,2021-09-29
3174021004,JAKARTA SELATAN,SETIA BUDI,KARET,9623,2256,7367,5669,13036,2021-09-29
3174021003,JAKARTA SELATAN,SETIA BUDI,KARET KUNINGAN,16055,3777,12278,9775,22053,2021-09-29
3174021002,JAKARTA SELATAN,SETIA BUDI,KARET SEMANGGI,2770,630,2140,1797,3937,2021-09-29
3171071003,JAKARTA PUSAT,TANAH ABANG,KARET TENGSIN,19271,4636,14635,10985,25620,2021-09-29
3171021003,JAKARTA PUSAT,SAWAH BESAR,KARTINI,22292,5310,16982,13537,30519,2021-09-29
3175011003,JAKARTA TIMUR,MATRAMAN,KAYU MANIS,25284,6754,18530,13396,31926,2021-09-29
3175021006,JAKARTA TIMUR,PULO GADUNG,KAYU PUTIH,40696,9378,31318,25634,56952,2021-09-29
3173031006,JAKARTA BARAT,TAMAN SARI,KEAGUNGAN,17387,4234,13153,10061,23214,2021-09-29
3174041007,JAKARTA SELATAN,PASAR MINGGU,KEBAGUSAN,44552,11276,33276,24843,58119,2021-09-29
3174051006,JAKARTA SELATAN,KEBAYORAN LAMA,KEBAYORAN LAMA SELATAN,41212,9607,31605,24689,56294,2021-09-29
3174051001,JAKARTA SELATAN,KEBAYORAN LAMA,KEBAYORAN LAMA UTARA,42422,11093,31329,23993,55322,2021-09-29
3174011004,JAKARTA SELATAN,TEBET,KEBON BARU,35165,8602,26563,20365,46928,2021-09-29
3172021005,JAKARTA UTARA,TANJUNG PRIOK,KEBON BAWANG,50952,12710,38242,29486,67728,2021-09-29
3173051001,JAKARTA BARAT,KEBON JERUK,KEBON JERUK,53887,14638,39249,29855,69104,2021-09-29
3171071006,JAKARTA PUSAT,TANAH ABANG,KEBON KACANG,21531,6258,15273,11137,26410,2021-09-29
3171011005,JAKARTA PUSAT,GAMBIR,KEBON KELAPA,10163,2514,7649,6009,13658,2021-09-29
3171031002,JAKARTA PUSAT,KEMAYORAN,KEBON KOSONG,30019,8055,21964,16825,38789,2021-09-29
3175011005,JAKARTA TIMUR,MATRAMAN,KEBON MANGGIS,16490,3985,12505,9573,22078,2021-09-29
3171071005,JAKARTA PUSAT,TANAH ABANG,KEBON MELATI,32206,10056,22150,14977,37127,2021-09-29
3175081003,JAKARTA TIMUR,MAKASAR,KEBON PALA,46614,11616,34998,27180,62178,2021-09-29
3171061005,JAKARTA PUSAT,MENTENG,KEBON SIRIH,12299,3163,9136,6762,15898,2021-09-29
3173011004,JAKARTA BARAT,CENGKARENG,KEDAUNG KALI ANGKE,32612,7604,25008,19442,44450,2021-09-29
3173051007,JAKARTA BARAT,KEBON JERUK,KEDOYA SELATAN,32165,7662,24503,19207,43710,2021-09-29
3173051006,JAKARTA BARAT,KEBON JERUK,KEDOYA UTARA,45740,10557,35183,28404,63587,2021-09-29
3173051004,JAKARTA BARAT,KEBON JERUK,KELAPA DUA,23565,6359,17206,13522,30728,2021-09-29
3175091003,JAKARTA TIMUR,CIRACAS,KELAPA DUA WETAN,46875,10192,36683,28812,65495,2021-09-29
3172061003,JAKARTA UTARA,KELAPA GADING,KELAPA GADING BARAT,35717,7293,28424,24473,52897,2021-09-29
3172061001,JAKARTA UTARA,KELAPA GADING,KELAPA GADING TIMUR,33592,6103,27489,24130,51619,2021-09-29
3173071005,JAKARTA BARAT,PALMERAH,KEMANGGISAN,32139,7684,24455,18802,43257,2021-09-29
3171031001,JAKARTA PUSAT,KEMAYORAN,KEMAYORAN,20708,5193,15515,12034,27549,2021-09-29
3173081006,JAKARTA BARAT,KEMBANGAN,KEMBANGAN SELATAN,27130,6843,20287,16544,36831,2021-09-29
3173081001,JAKARTA BARAT,KEMBANGAN,KEMBANGAN UTARA,54451,14267,40184,31441,71625,2021-09-29
3171041002,JAKARTA PUSAT,SENEN,KENARI,9579,2266,7313,5841,13154,2021-09-29
3173041005,JAKARTA BARAT,TAMBORA,KERENDANG,19973,5137,14836,11053,25889,2021-09-29
3175071003,JAKARTA TIMUR,DUREN SAWIT,KLENDER,69978,20010,49968,36743,86711,2021-09-29
3172031001,JAKARTA UTARA,KOJA,KOJA,28175,7734,20441,15423,35864,2021-09-29
3173071006,JAKARTA BARAT,PALMERAH,KOTA BAMBU SELATAN,21158,5461,15697,11473,27170,2021-09-29
3173071003,JAKARTA BARAT,PALMERAH,KOTA BAMBU UTARA,24995,6621,18374,13285,31659,2021-09-29
3171041004,JAKARTA PUSAT,SENEN,KRAMAT,28835,8125,20710,14626,35336,2021-09-29
3175041001,JAKARTA TIMUR,KRAMAT JATI,KRAMAT JATI,34144,9133,25011,18937,43948,2021-09-29
3174071003,JAKARTA SELATAN,KEBAYORAN BARU,KRAMAT PELA,14413,3356,11057,8746,19803,2021-09-29
3173031002,JAKARTA BARAT,TAMAN SARI,KRUKUT,19244,4760,14484,10925,25409,2021-09-29
3174031005,JAKARTA SELATAN,MAMPANG PRAPATAN,KUNINGAN BARAT,12785,2989,9796,7495,17291,2021-09-29
3174021008,JAKARTA SELATAN,SETIA BUDI,KUNINGAN TIMUR,6008,1485,4523,3630,8153,2021-09-29
3171041005,JAKARTA PUSAT,SENEN,KWITANG,15486,4159,11327,8613,19940,2021-09-29
3172031003,JAKARTA UTARA,KOJA,LAGOA,59065,16951,42114,30843,72957,2021-09-29
3174061002,JAKARTA SELATAN,CILANDAK,LEBAK BULUS,37626,9122,28504,22619,51123,2021-09-29
3174091004,JAKARTA SELATAN,JAGAKARSA,LENTENG AGUNG,53946,13327,40619,30260,70879,2021-09-29
3175101007,JAKARTA TIMUR,CIPAYUNG,LUBANG BUAYA,63547,14811,48736,37872,86608,2021-09-29
3175081001,JAKARTA TIMUR,MAKASAR,MAKASAR,34390,8418,25972,20753,46725,2021-09-29
3175071006,JAKARTA TIMUR,DUREN SAWIT,MALAKA JAYA,30927,7272,23655,18796,42451,2021-09-29
3175071005,JAKARTA TIMUR,DUREN SAWIT,MALAKA SARI,27530,6065,21465,17222,38687,2021-09-29
3174031001,JAKARTA SELATAN,MAMPANG PRAPATAN,MAMPANG PRAPATAN,18159,4801,13358,10297,23655,2021-09-29
3173031005,JAKARTA BARAT,TAMAN SARI,MANGGA BESAR,7707,1564,6143,5015,11158,2021-09-29
3171021005,JAKARTA PUSAT,SAWAH BESAR,MANGGA DUA SELATAN,27442,6692,20750,16218,36968,2021-09-29
3174011007,JAKARTA SELATAN,TEBET,MANGGARAI,28373,6416,21957,16420,38377,2021-09-29
3174011006,JAKARTA SELATAN,TEBET,MANGGARAI SELATAN,23075,5230,17845,13883,31728,2021-09-29
3173031003,JAKARTA BARAT,TAMAN SARI,MAPHAR,16461,3950,12511,9808,22319,2021-09-29
3172041003,JAKARTA UTARA,CILINCING,MARUNDA,28943,7822,21121,14912,36033,2021-09-29
3174071001,JAKARTA SELATAN,KEBAYORAN BARU,MELAWAI,2627,586,2041,1799,3840,2021-09-29
3171061001,JAKARTA PUSAT,MENTENG,MENTENG,25624,7020,18604,13789,32393,2021-09-29
3174021005,JAKARTA SELATAN,SETIA BUDI,MENTENG ATAS,27816,6427,21389,16384,37773,2021-09-29
3174011003,JAKARTA SELATAN,TEBET,MENTENG DALAM,36028,8836,27192,21044,48236,2021-09-29
3173081003,JAKARTA BARAT,KEMBANGAN,MERUYA SELATAN,32130,8194,23936,18547,42483,2021-09-29
3173081002,JAKARTA BARAT,KEMBANGAN,MERUYA UTARA,43752,11240,32512,26359,58871,2021-09-29
3175101004,JAKARTA TIMUR,CIPAYUNG,MUNJUL,23871,5730,18141,14395,32536,2021-09-29
3172051002,JAKARTA UTARA,PADEMANGAN,PADEMANGAN BARAT,74240,20839,53401,40340,93741,2021-09-29
3172051001,JAKARTA UTARA,PADEMANGAN,PADEMANGAN TIMUR,37736,8122,29614,24235,53849,2021-09-29
3175011004,JAKARTA TIMUR,MATRAMAN,PAL MERIAM,19769,5353,14416,10880,25296,2021-09-29
3173071001,JAKARTA BARAT,PALMERAH,PALMERAH,63011,16752,46259,34862,81121,2021-09-29
3174081001,JAKARTA SELATAN,PANCORAN,PANCORAN,19421,5271,14150,10777,24927,2021-09-29
3172021003,JAKARTA UTARA,TANJUNG PRIOK,PAPANGGO,39097,9554,29543,22905,52448,2021-09-29
3171021001,JAKARTA PUSAT,SAWAH BESAR,PASAR BARU,12035,2708,9327,7901,17228,2021-09-29
3174021006,JAKARTA SELATAN,SETIA BUDI,PASAR MANGGIS,26752,6723,20029,15432,35461,2021-09-29
3174041001,JAKARTA SELATAN,PASAR MINGGU,PASAR MINGGU,24821,5959,18862,14914,33776,2021-09-29
3171041003,JAKARTA PUSAT,SENEN,PASEBAN,23533,6167,17366,13172,30538,2021-09-29
3173061005,JAKARTA BARAT,KALI DERES,PEGADUNGAN,75587,18320,57267,46535,103802,2021-09-29
3171061002,JAKARTA PUSAT,MENTENG,PEGANGSAAN,23455,6293,17162,12198,29360,2021-09-29
3172061002,JAKARTA UTARA,KELAPA GADING,PEGANGSAAN DUA,49976,9680,40296,34750,75046,2021-09-29
3172011004,JAKARTA UTARA,PENJARINGAN,PEJAGALAN,74578,18810,55768,44700,100468,2021-09-29
3174041006,JAKARTA SELATAN,PASAR MINGGU,PEJATEN BARAT,37346,9777,27569,21710,49279,2021-09-29
3174041005,JAKARTA SELATAN,PASAR MINGGU,PEJATEN TIMUR,57656,16168,41488,31415,72903,2021-09-29
3175051005,JAKARTA TIMUR,PASAR REBO,PEKAYON,43250,9931,33319,25814,59133,2021-09-29
3173041009,JAKARTA BARAT,TAMBORA,PEKOJAN,23587,5537,18050,14119,32169,2021-09-29
3174031003,JAKARTA SELATAN,MAMPANG PRAPATAN,PELA MAMPANG,43522,11113,32409,25435,57844,2021-09-29
3174081005,JAKARTA SELATAN,PANCORAN,PENGADEGAN,21478,4875,16603,12368,28971,2021-09-29
3175061003,JAKARTA TIMUR,CAKUNG,PENGGILINGAN,99255,28266,70989,51948,122937,2021-09-29
3172011001,JAKARTA UTARA,PENJARINGAN,PENJARINGAN,88308,26659,61649,44580,106229,2021-09-29
3174101001,JAKARTA SELATAN,PESANGGRAHAN,PESANGGRAHAN,27545,6010,21535,17291,38826,2021-09-29
3171071004,JAKARTA PUSAT,TANAH ABANG,PETAMBURAN,33271,10529,22742,15624,38366,2021-09-29
3174071008,JAKARTA SELATAN,KEBAYORAN BARU,PETOGOGAN,11499,2815,8684,6631,15315,2021-09-29
3171011004,JAKARTA PUSAT,GAMBIR,PETOJO SELATAN,14692,3964,10728,8536,19264,2021-09-29
3171011003,JAKARTA PUSAT,GAMBIR,PETOJO UTARA,17458,4470,12988,9922,22910,2021-09-29
3174101004,JAKARTA SELATAN,PESANGGRAHAN,PETUKANGAN SELATAN,37187,9515,27672,22039,49711,2021-09-29
3174101003,JAKARTA SELATAN,PESANGGRAHAN,PETUKANGAN UTARA,53716,14210,39506,30547,70053,2021-09-29
3175081002,JAKARTA TIMUR,MAKASAR,PINANG RANTI,27198,7171,20027,15544,35571,2021-09-29
3173031008,JAKARTA BARAT,TAMAN SARI,PINANGSIA,10729,2410,8319,6545,14864,2021-09-29
3175011001,JAKARTA TIMUR,MATRAMAN,PISANGAN BARU,31776,8341,23435,16934,40369,2021-09-29
3175021002,JAKARTA TIMUR,PULO GADUNG,PISANGAN TIMUR,41011,9864,31147,24611,55758,2021-09-29
3172011005,JAKARTA UTARA,PENJARINGAN,PLUIT,47783,10955,36828,30713,67541,2021-09-29
3175071002,JAKARTA TIMUR,DUREN SAWIT,PONDOK BAMBU,61550,16627,44923,34483,79406,2021-09-29
3175071004,JAKARTA TIMUR,DUREN SAWIT,PONDOK KELAPA,72015,17524,54491,43316,97807,2021-09-29
3175071007,JAKARTA TIMUR,DUREN SAWIT,PONDOK KOPI,35367,9170,26197,19180,45377,2021-09-29
3174061003,JAKARTA SELATAN,CILANDAK,PONDOK LABU,46464,10159,36305,29063,65368,2021-09-29
3174051002,JAKARTA SELATAN,KEBAYORAN LAMA,PONDOK PINANG,56169,13224,42945,33621,76566,2021-09-29
3175101003,JAKARTA TIMUR,CIPAYUNG,PONDOK RANGGON,25574,6394,19180,15057,34237,2021-09-29
3101011003,KAB.ADM.KEP.SERIBU,KEP. SERIBU UTARA,PULAU HARAPAN,2060,270,1790,1432,3222,2021-09-29
3101011002,KAB.ADM.KEP.SERIBU,KEP. SERIBU UTARA,PULAU KELAPA,5528,699,4829,3557,8386,2021-09-29
3101011001,KAB.ADM.KEP.SERIBU,KEP. SERIBU UTARA,PULAU PANGGANG,5450,601,4849,3807,8656,2021-09-29
3101021003,KAB.ADM.KEP.SERIBU,KEP. SERIBU SELATAN,PULAU PARI,2765,235,2530,2213,4743,2021-09-29
3101021002,KAB.ADM.KEP.SERIBU,KEP. SERIBU SELATAN,PULAU TIDUNG,4553,461,4092,3558,7650,2021-09-29
3101021001,KAB.ADM.KEP.SERIBU,KEP. SERIBU SELATAN,PULAU UNTUNG JAWA,1941,227,1714,1527,3241,2021-09-29
3174071007,JAKARTA SELATAN,KEBAYORAN BARU,PULO,5835,1225,4610,3925,8535,2021-09-29
3175021001,JAKARTA TIMUR,PULO GADUNG,PULO GADUNG,34422,8896,25526,19734,45260,2021-09-29
3175061005,JAKARTA TIMUR,CAKUNG,PULO GEBANG,97301,23466,73835,54814,128649,2021-09-29
3174041004,JAKARTA SELATAN,PASAR MINGGU,RAGUNAN,39616,9433,30183,23905,54088,2021-09-29
3175091005,JAKARTA TIMUR,CIRACAS,RAMBUTAN,36771,10525,26246,19504,45750,2021-09-29
3172031006,JAKARTA UTARA,KOJA,RAWA BADAK SELATAN,42179,12142,30037,21725,51762,2021-09-29
3172031004,JAKARTA UTARA,KOJA,RAWA BADAK UTARA,34408,9422,24986,18566,43552,2021-09-29
3174071005,JAKARTA SELATAN,KEBAYORAN BARU,RAWA BARAT,5625,1171,4454,3657,8111,2021-09-29
3173011003,JAKARTA BARAT,CENGKARENG,RAWA BUAYA,63799,16289,47510,34751,82261,2021-09-29
3175031004,JAKARTA TIMUR,JATINEGARA,RAWA BUNGA,21434,6190,15244,11388,26632,2021-09-29
3174081003,JAKARTA SELATAN,PANCORAN,RAWA JATI,20509,4908,15601,11476,27077,2021-09-29
3175061002,JAKARTA TIMUR,CAKUNG,RAWA TERATE,24637,5533,19104,14626,33730,2021-09-29
3175021005,JAKARTA TIMUR,PULO GADUNG,RAWAMANGUN,37612,9305,28307,22246,50553,2021-09-29
3171051003,JAKARTA PUSAT,CEMPAKA PUTIH,RAWASARI,21967,5557,16410,12879,29289,2021-09-29
3173041010,JAKARTA BARAT,TAMBORA,ROA MALAKA,3484,697,2787,2347,5134,2021-09-29
3172041006,JAKARTA UTARA,CILINCING,ROROTAN,41668,10330,31338,23598,54936,2021-09-29
3174071004,JAKARTA SELATAN,KEBAYORAN BARU,SELONG,2842,612,2230,1906,4136,2021-09-29
3173061002,JAKARTA BARAT,KALI DERES,SEMANAN,71354,19283,52071,39385,91456,2021-09-29
3172041007,JAKARTA UTARA,CILINCING,SEMPER BARAT,68587,16469,52118,40842,92960,2021-09-29
3172041005,JAKARTA UTARA,CILINCING,SEMPER TIMUR,36267,9340,26927,20349,47276,2021-09-29
3174071006,JAKARTA SELATAN,KEBAYORAN BARU,SENAYAN,2771,758,2013,1599,3612,2021-09-29
3171041001,JAKARTA PUSAT,SENEN,SENEN,6804,1730,5074,4060,9134,2021-09-29
3171031004,JAKARTA PUSAT,KEMAYORAN,SERDANG,29668,7371,22297,17271,39568,2021-09-29
3174021001,JAKARTA SELATAN,SETIA BUDI,SETIA BUDI,3023,759,2264,1796,4060,2021-09-29
3175101005,JAKARTA TIMUR,CIPAYUNG,SETU,20572,5342,15230,11557,26787,2021-09-29
3173071002,JAKARTA BARAT,PALMERAH,SLIPI,16591,3807,12784,9985,22769,2021-09-29
3173081004,JAKARTA BARAT,KEMBANGAN,SRENGSENG,45523,12352,33171,26088,59259,2021-09-29
3174091002,JAKARTA SELATAN,JAGAKARSA,SRENGSENG SAWAH,58196,12350,45846,36567,82413,2021-09-29
3173051003,JAKARTA BARAT,KEBON JERUK,SUKABUMI SELATAN,37033,10417,26616,19239,45855,2021-09-29
3173051002,JAKARTA BARAT,KEBON JERUK,SUKABUMI UTARA,38290,11094,27196,19550,46746,2021-09-29
3172041002,JAKARTA UTARA,CILINCING,SUKAPURA,53949,14694,39255,30378,69633,2021-09-29
3171031007,JAKARTA PUSAT,KEMAYORAN,SUMUR BATU,22717,5694,17023,13452,30475,2021-09-29
3172021004,JAKARTA UTARA,TANJUNG PRIOK,SUNGAI BAMBU,29876,7423,22453,17392,39845,2021-09-29
3172021006,JAKARTA UTARA,TANJUNG PRIOK,SUNTER AGUNG,71805,15142,56663,46908,103571,2021-09-29
3172021002,JAKARTA UTARA,TANJUNG PRIOK,SUNTER JAYA,63031,14146,48885,40033,88918,2021-09-29
3175091004,JAKARTA TIMUR,CIRACAS,SUSUKAN,38257,8928,29329,22958,52287,2021-09-29
3173031001,JAKARTA BARAT,TAMAN SARI,TAMAN SARI,14348,3267,11081,8895,19976,2021-09-29
3173041001,JAKARTA BARAT,TAMBORA,TAMBORA,10204,2724,7480,5650,13130,2021-09-29
3173041004,JAKARTA BARAT,TAMBORA,TANAH SEREAL,26387,5502,20885,16410,37295,2021-09-29
3171081004,JAKARTA PUSAT,JOHAR BARU,TANAH TINGGI,37693,8444,29249,22209,51458,2021-09-29
3173031004,JAKARTA BARAT,TAMAN SARI,TANGKI,13324,2959,10365,8126,18491,2021-09-29
3174091005,JAKARTA SELATAN,JAGAKARSA,TANJUNG BARAT,39770,9470,30300,23287,53587,2021-09-29
3173021005,JAKARTA BARAT,GROGOL PETAMBURAN,TANJUNG DUREN SELATAN,25337,5973,19364,15885,35249,2021-09-29
3173021002,JAKARTA BARAT,GROGOL PETAMBURAN,TANJUNG DUREN UTARA,17010,3653,13357,11134,24491,2021-09-29
3172021001,JAKARTA UTARA,TANJUNG PRIOK,TANJUNG PRIOK,34588,8594,25994,19939,45933,2021-09-29
3174011002,JAKARTA SELATAN,TEBET,TEBET BARAT,21194,4345,16849,13700,30549,2021-09-29
3174011001,JAKARTA SELATAN,TEBET,TEBET TIMUR,18199,3652,14547,12097,26644,2021-09-29
3173061003,JAKARTA BARAT,KALI DERES,TEGAL ALUR,83647,21685,61962,47748,109710,2021-09-29
3174031004,JAKARTA SELATAN,MAMPANG PRAPATAN,TEGAL PARANG,32401,9207,23194,16666,39860,2021-09-29
3173021003,JAKARTA BARAT,GROGOL PETAMBURAN,TOMANG,29605,6684,22921,18313,41234,2021-09-29
3172031005,JAKARTA UTARA,KOJA,TUGU SELATAN,39122,10577,28545,20998,49543,2021-09-29
3172031002,JAKARTA UTARA,KOJA,TUGU UTARA,67670,19292,48378,35392,83770,2021-09-29
3175061006,JAKARTA TIMUR,CAKUNG,UJUNG MENTENG,29934,6426,23508,18535,42043,2021-09-29
3174101005,JAKARTA SELATAN,PESANGGRAHAN,ULUJAMI,40544,11477,29067,22350,51417,2021-09-29
3175011006,JAKARTA TIMUR,MATRAMAN,UTAN KAYU SELATAN,33511,7870,25641,19546,45187,2021-09-29
3175011002,JAKARTA TIMUR,MATRAMAN,UTAN KAYU UTARA,28169,7391,20778,15717,36495,2021-09-29
3171031008,JAKARTA PUSAT,KEMAYORAN,UTAN PANJANG,29208,7784,21424,16147,37571,2021-09-29
3172021007,JAKARTA UTARA,TANJUNG PRIOK,WARAKAS,44401,10355,34046,25711,59757,2021-09-29
3173021007,JAKARTA BARAT,GROGOL PETAMBURAN,WIJAYA KUSUMA,38934,10274,28660,22542,51202,2021-09-29
3172051003,JAKARTA UTARA,PADEMANGAN,ANCOL,23947,6688,17259,13376,30635,2021-09-30
3173041007,JAKARTA BARAT,TAMBORA,ANGKE,29381,7581,21800,16438,38238,2021-09-30
3175041005,JAKARTA TIMUR,KRAMAT JATI,BALE KAMBANG,29074,8708,20366,14412,34778,2021-09-30
3175031003,JAKARTA TIMUR,JATINEGARA,BALI MESTER,9752,2517,7235,5660,12895,2021-09-30
3175101006,JAKARTA TIMUR,CIPAYUNG,BAMBU APUS,26285,6252,20033,15380,35413,2021-09-30
3174031002,JAKARTA SELATAN,MAMPANG PRAPATAN,BANGKA,21566,5785,15781,12158,27939,2021-09-30
3175051002,JAKARTA TIMUR,PASAR REBO,BARU,23886,4899,18987,15536,34523,2021-09-30
3175041004,JAKARTA TIMUR,KRAMAT JATI,BATU AMPAR,47898,14105,33793,24706,58499,2021-09-30
3171071002,JAKARTA PUSAT,TANAH ABANG,BENDUNGAN HILIR,21494,5239,16255,12764,29019,2021-09-30
3175031002,JAKARTA TIMUR,JATINEGARA,BIDARA CINA,36689,10626,26063,19183,45246,2021-09-30
3174101002,JAKARTA SELATAN,PESANGGRAHAN,BINTARO,53098,12928,40170,32172,72342,2021-09-30
3174011005,JAKARTA SELATAN,TEBET,BUKIT DURI,34183,8698,25485,19365,44850,2021-09-30
3171041006,JAKARTA PUSAT,SENEN,BUNGUR,18144,4632,13512,10586,24098,2021-09-30
3175061007,JAKARTA TIMUR,CAKUNG,CAKUNG BARAT,57724,14018,43706,33810,77516,2021-09-30
3175061004,JAKARTA TIMUR,CAKUNG,CAKUNG TIMUR,58287,14043,44244,34307,78551,2021-09-30
3175041007,JAKARTA TIMUR,KRAMAT JATI,CAWANG,32762,8766,23996,17633,41629,2021-09-30
3175101008,JAKARTA TIMUR,CIPAYUNG,CEGER,18932,4552,14380,11185,25565,2021-09-30
3171031006,JAKARTA PUSAT,KEMAYORAN,CEMPAKA BARU,32581,8343,24238,17846,42084,2021-09-30
3171051002,JAKARTA PUSAT,CEMPAKA PUTIH,CEMPAKA PUTIH BARAT,35885,9345,26540,20909,47449,2021-09-30
3171051001,JAKARTA PUSAT,CEMPAKA PUTIH,CEMPAKA PUTIH TIMUR,24292,5962,18330,14779,33109,2021-09-30
3173011001,JAKARTA BARAT,CENGKARENG,CENGKARENG BARAT,66284,16517,49767,38891,88658,2021-09-30
3173011006,JAKARTA BARAT,CENGKARENG,CENGKARENG TIMUR,81027,19672,61355,46525,107880,2021-09-30
3175091002,JAKARTA TIMUR,CIRACAS,CIBUBUR,66364,14295,52069,41013,93082,2021-09-30
3171011002,JAKARTA PUSAT,GAMBIR,CIDENG,15390,3539,11851,9729,21580,2021-09-30
3174091003,JAKARTA SELATAN,JAGAKARSA,CIGANJUR,38497,8674,29823,22429,52252,2021-09-30
3175051003,JAKARTA TIMUR,PASAR REBO,CIJANTUNG,41419,9459,31960,24913,56873,2021-09-30
3171061003,JAKARTA PUSAT,MENTENG,CIKINI,8274,1781,6493,4673,11166,2021-09-30
3174081006,JAKARTA SELATAN,PANCORAN,CIKOKO,10547,2266,8281,6519,14800,2021-09-30
3174061001,JAKARTA SELATAN,CILANDAK,CILANDAK BARAT,51752,12006,39746,32153,71899,2021-09-30
3174041003,JAKARTA SELATAN,PASAR MINGGU,CILANDAK TIMUR,25145,5845,19300,15403,34703,2021-09-30
3175101002,JAKARTA TIMUR,CIPAYUNG,CILANGKAP,27635,6430,21205,16530,37735,2021-09-30
3175041006,JAKARTA TIMUR,KRAMAT JATI,CILILITAN,40181,11062,29119,21744,50863,2021-09-30
3172041001,JAKARTA UTARA,CILINCING,CILINCING,43609,12336,31273,22583,53856,2021-09-30
3175101001,JAKARTA TIMUR,CIPAYUNG,CIPAYUNG,26104,5638,20466,16518,36984,2021-09-30
3174091006,JAKARTA SELATAN,JAGAKARSA,CIPEDAK,38303,8524,29779,23378,53157,2021-09-30
3174061005,JAKARTA SELATAN,CILANDAK,CIPETE SELATAN,26704,6327,20377,16281,36658,2021-09-30
3174071010,JAKARTA SELATAN,KEBAYORAN BARU,CIPETE UTARA,34102,8121,25981,19673,45654,2021-09-30
3175021003,JAKARTA TIMUR,PULO GADUNG,CIPINANG,39306,9477,29829,22811,52640,2021-09-30
3175031007,JAKARTA TIMUR,JATINEGARA,CIPINANG BESAR SELATAN,35212,10024,25188,18000,43188,2021-09-30
3175031008,JAKARTA TIMUR,JATINEGARA,CIPINANG BESAR UTARA,45319,13000,32319,23083,55402,2021-09-30
3175031005,JAKARTA TIMUR,JATINEGARA,CIPINANG CEMPEDAK,32824,9028,23796,18527,42323,2021-09-30
3175081005,JAKARTA TIMUR,MAKASAR,CIPINANG MELAYU,42308,10388,31920,25190,57110,2021-09-30
3175031006,JAKARTA TIMUR,JATINEGARA,CIPINANG MUARA,55243,14728,40515,30402,70917,2021-09-30
3174051003,JAKARTA SELATAN,KEBAYORAN LAMA,CIPULIR,39937,10300,29637,21888,51525,2021-09-30
3175091001,JAKARTA TIMUR,CIRACAS,CIRACAS,64594,14583,50011,38506,88517,2021-09-30
3175041003,JAKARTA TIMUR,KRAMAT JATI,DUKUH,24609,5687,18922,14441,33363,2021-09-30
3175071001,JAKARTA TIMUR,DUREN SAWIT,DUREN SAWIT,61160,16336,44824,34120,78944,2021-09-30
3174081004,JAKARTA SELATAN,PANCORAN,DUREN TIGA,28319,6965,21354,15195,36549,2021-09-30
3173051005,JAKARTA BARAT,KEBON JERUK,DURI KEPA,60138,14162,45976,37627,83603,2021-09-30
3173011002,JAKARTA BARAT,CENGKARENG,DURI KOSAMBI,77923,21380,56543,41998,98541,2021-09-30
3171011006,JAKARTA PUSAT,GAMBIR,DURI PULO,19610,4964,14646,11011,25657,2021-09-30
3173041011,JAKARTA BARAT,TAMBORA,DURI SELATAN,14259,3173,11086,8847,19933,2021-09-30
3173041003,JAKARTA BARAT,TAMBORA,DURI UTARA,19844,4713,15131,11552,26683,2021-09-30
3171081003,JAKARTA PUSAT,JOHAR BARU,GALUR,18243,4275,13968,10653,24621,2021-09-30
3171011001,JAKARTA PUSAT,GAMBIR,GAMBIR,2191,540,1651,1338,2989,2021-09-30
3174061004,JAKARTA SELATAN,CILANDAK,GANDARIA SELATAN,22119,5400,16719,13037,29756,2021-09-30
3174071009,JAKARTA SELATAN,KEBAYORAN BARU,GANDARIA UTARA,39922,10025,29897,23145,53042,2021-09-30
3175051001,JAKARTA TIMUR,PASAR REBO,GEDONG,35755,8667,27088,21312,48400,2021-09-30
3171071001,JAKARTA PUSAT,TANAH ABANG,GELORA,3127,742,2385,1841,4226,2021-09-30
3173031007,JAKARTA BARAT,TAMAN SARI,GLODOK,7837,1535,6302,5384,11686,2021-09-30
3171061004,JAKARTA PUSAT,MENTENG,GONDANGDIA,4100,1032,3068,2679,5747,2021-09-30
3173021001,JAKARTA BARAT,GROGOL PETAMBURAN,GROGOL,16876,4048,12828,10055,22883,2021-09-30
3174051005,JAKARTA SELATAN,KEBAYORAN LAMA,GROGOL SELATAN,44251,11300,32951,25046,57997,2021-09-30
3174051004,JAKARTA SELATAN,KEBAYORAN LAMA,GROGOL UTARA,42494,10680,31814,24533,56347,2021-09-30
3174021007,JAKARTA SELATAN,SETIA BUDI,GUNTUR,3985,924,3061,2580,5641,2021-09-30
3174071002,JAKARTA SELATAN,KEBAYORAN BARU,GUNUNG,9436,2147,7289,5967,13256,2021-09-30
3171031005,JAKARTA PUSAT,KEMAYORAN,GUNUNG SAHARI SELATAN,19199,4787,14412,11316,25728,2021-09-30
3171021004,JAKARTA PUSAT,SAWAH BESAR,GUNUNG SAHARI UTARA,16650,3529,13121,11010,24131,2021-09-30
3175081004,JAKARTA TIMUR,MAKASAR,HALIM PERDANA KUSUMAH,28363,4622,23741,20814,44555,2021-09-30
3171031003,JAKARTA PUSAT,KEMAYORAN,HARAPAN MULIA,22557,5682,16875,12798,29673,2021-09-30
3174091001,JAKARTA SELATAN,JAGAKARSA,JAGAKARSA,62389,14437,47952,37622,85574,2021-09-30
3175021007,JAKARTA TIMUR,PULO GADUNG,JATI,32757,7697,25060,20190,45250,2021-09-30
3174041002,JAKARTA SELATAN,PASAR MINGGU,JATI PADANG,37502,9532,27970,21924,49894,2021-09-30
3173071004,JAKARTA BARAT,PALMERAH,JATI PULO,28738,6909,21829,16290,38119,2021-09-30
3175061001,JAKARTA TIMUR,CAKUNG,JATINEGARA,84160,22005,62155,47613,109768,2021-09-30
3175021004,JAKARTA TIMUR,PULO GADUNG,JATINEGARA KAUM,24632,5745,18887,14071,32958,2021-09-30
3173021004,JAKARTA BARAT,GROGOL PETAMBURAN,JELAMBAR,30266,6951,23315,18732,42047,2021-09-30
3173021006,JAKARTA BARAT,GROGOL PETAMBURAN,JELAMBAR BARU,38246,8898,29348,23498,52846,2021-09-30
3173041006,JAKARTA BARAT,TAMBORA,JEMBATAN BESI,29314,8727,20587,14500,35087,2021-09-30
3173041008,JAKARTA BARAT,TAMBORA,JEMBATAN LIMA,21021,5939,15082,11002,26084,2021-09-30
3173081005,JAKARTA BARAT,KEMBANGAN,JOGLO,40839,10073,30766,24192,54958,2021-09-30
3171081001,JAKARTA PUSAT,JOHAR BARU,JOHAR BARU,37488,8375,29113,22923,52036,2021-09-30
3173041002,JAKARTA BARAT,TAMBORA,KALI ANYAR,23856,5940,17916,13176,31092,2021-09-30
3172041004,JAKARTA UTARA,CILINCING,KALIBARU,67684,22354,45330,30606,75936,2021-09-30
3174081002,JAKARTA SELATAN,PANCORAN,KALIBATA,41994,11949,30045,21113,51158,2021-09-30
3173061001,JAKARTA BARAT,KALI DERES,KALIDERES,72447,18306,54141,43023,97164,2021-09-30
3175051004,JAKARTA TIMUR,PASAR REBO,KALISARI,43212,9870,33342,26268,59610,2021-09-30
3173061004,JAKARTA BARAT,KALI DERES,KAMAL,53783,15412,38371,28672,67043,2021-09-30
3172011002,JAKARTA UTARA,PENJARINGAN,KAMAL MUARA,12930,2519,10411,8553,18964,2021-09-30
3171071007,JAKARTA PUSAT,TANAH ABANG,KAMPUNG BALI,11358,3021,8337,5874,14211,2021-09-30
3175031001,JAKARTA TIMUR,JATINEGARA,KAMPUNG MELAYU,25717,7619,18098,13056,31154,2021-09-30
3171081002,JAKARTA PUSAT,JOHAR BARU,KAMPUNG RAWA,21237,4210,17027,12813,29840,2021-09-30
3175041002,JAKARTA TIMUR,KRAMAT JATI,KAMPUNG TENGAH,43993,13264,30729,22597,53326,2021-09-30
3173011005,JAKARTA BARAT,CENGKARENG,KAPUK,134466,38531,95935,71313,167248,2021-09-30
3172011003,JAKARTA UTARA,PENJARINGAN,KAPUK MUARA,35781,8012,27769,23309,51078,2021-09-30
3171021002,JAKARTA PUSAT,SAWAH BESAR,KARANG ANYAR,25761,5962,19799,15412,35211,2021-09-30
3174021004,JAKARTA SELATAN,SETIA BUDI,KARET,9623,2242,7381,5689,13070,2021-09-30
3174021003,JAKARTA SELATAN,SETIA BUDI,KARET KUNINGAN,16055,3755,12300,9813,22113,2021-09-30
3174021002,JAKARTA SELATAN,SETIA BUDI,KARET SEMANGGI,2770,629,2141,1802,3943,2021-09-30
3171071003,JAKARTA PUSAT,TANAH ABANG,KARET TENGSIN,19271,4585,14686,11025,25711,2021-09-30
3171021003,JAKARTA PUSAT,SAWAH BESAR,KARTINI,22292,5264,17028,13575,30603,2021-09-30
3175011003,JAKARTA TIMUR,MATRAMAN,KAYU MANIS,25284,6698,18586,13461,32047,2021-09-30
3175021006,JAKARTA TIMUR,PULO GADUNG,KAYU PUTIH,40696,9308,31388,25736,57124,2021-09-30
3173031006,JAKARTA BARAT,TAMAN SARI,KEAGUNGAN,17387,4203,13184,10091,23275,2021-09-30
3174041007,JAKARTA SELATAN,PASAR MINGGU,KEBAGUSAN,44552,11183,33369,24952,58321,2021-09-30
3174051006,JAKARTA SELATAN,KEBAYORAN LAMA,KEBAYORAN LAMA SELATAN,41212,9529,31683,24762,56445,2021-09-30
3174051001,JAKARTA SELATAN,KEBAYORAN LAMA,KEBAYORAN LAMA UTARA,42422,11012,31410,24053,55463,2021-09-30
3174011004,JAKARTA SELATAN,TEBET,KEBON BARU,35165,8531,26634,20452,47086,2021-09-30
3172021005,JAKARTA UTARA,TANJUNG PRIOK,KEBON BAWANG,50952,12609,38343,29621,67964,2021-09-30
3173051001,JAKARTA BARAT,KEBON JERUK,KEBON JERUK,53887,14513,39374,29997,69371,2021-09-30
3171071006,JAKARTA PUSAT,TANAH ABANG,KEBON KACANG,21531,6220,15311,11186,26497,2021-09-30
3171011005,JAKARTA PUSAT,GAMBIR,KEBON KELAPA,10163,2464,7699,6030,13729,2021-09-30
3171031002,JAKARTA PUSAT,KEMAYORAN,KEBON KOSONG,30019,7999,22020,16890,38910,2021-09-30
3175011005,JAKARTA TIMUR,MATRAMAN,KEBON MANGGIS,16490,3938,12552,9607,22159,2021-09-30
3171071005,JAKARTA PUSAT,TANAH ABANG,KEBON MELATI,32206,9990,22216,15043,37259,2021-09-30
3175081003,JAKARTA TIMUR,MAKASAR,KEBON PALA,46614,11495,35119,27290,62409,2021-09-30
3171061005,JAKARTA PUSAT,MENTENG,KEBON SIRIH,12299,3138,9161,6778,15939,2021-09-30
3173011004,JAKARTA BARAT,CENGKARENG,KEDAUNG KALI ANGKE,32612,7549,25063,19517,44580,2021-09-30
3173051007,JAKARTA BARAT,KEBON JERUK,KEDOYA SELATAN,32165,7544,24621,19312,43933,2021-09-30
3173051006,JAKARTA BARAT,KEBON JERUK,KEDOYA UTARA,45740,10479,35261,28510,63771,2021-09-30
3173051004,JAKARTA BARAT,KEBON JERUK,KELAPA DUA,23565,6245,17320,13589,30909,2021-09-30
3175091003,JAKARTA TIMUR,CIRACAS,KELAPA DUA WETAN,46875,10068,36807,28954,65761,2021-09-30
3172061003,JAKARTA UTARA,KELAPA GADING,KELAPA GADING BARAT,35717,7255,28462,24544,53006,2021-09-30
3172061001,JAKARTA UTARA,KELAPA GADING,KELAPA GADING TIMUR,33592,6075,27517,24198,51715,2021-09-30
3173071005,JAKARTA BARAT,PALMERAH,KEMANGGISAN,32139,7615,24524,18887,43411,2021-09-30
3171031001,JAKARTA PUSAT,KEMAYORAN,KEMAYORAN,20708,5145,15563,12078,27641,2021-09-30
3173081006,JAKARTA BARAT,KEMBANGAN,KEMBANGAN SELATAN,27130,6814,20316,16597,36913,2021-09-30
3173081001,JAKARTA BARAT,KEMBANGAN,KEMBANGAN UTARA,54451,14161,40290,31546,71836,2021-09-30
3171041002,JAKARTA PUSAT,SENEN,KENARI,9579,2245,7334,5862,13196,2021-09-30
3173041005,JAKARTA BARAT,TAMBORA,KERENDANG,19973,5096,14877,11094,25971,2021-09-30
3175071003,JAKARTA TIMUR,DUREN SAWIT,KLENDER,69978,19866,50112,36901,87013,2021-09-30
3172031001,JAKARTA UTARA,KOJA,KOJA,28175,7674,20501,15471,35972,2021-09-30
3173071006,JAKARTA BARAT,PALMERAH,KOTA BAMBU SELATAN,21158,5423,15735,11502,27237,2021-09-30
3173071003,JAKARTA BARAT,PALMERAH,KOTA BAMBU UTARA,24995,6567,18428,13333,31761,2021-09-30
3171041004,JAKARTA PUSAT,SENEN,KRAMAT,28835,8070,20765,14680,35445,2021-09-30
3175041001,JAKARTA TIMUR,KRAMAT JATI,KRAMAT JATI,34144,9079,25065,19013,44078,2021-09-30
3174071003,JAKARTA SELATAN,KEBAYORAN BARU,KRAMAT PELA,14413,3325,11088,8774,19862,2021-09-30
3173031002,JAKARTA BARAT,TAMAN SARI,KRUKUT,19244,4742,14502,10970,25472,2021-09-30
3174031005,JAKARTA SELATAN,MAMPANG PRAPATAN,KUNINGAN BARAT,12785,2952,9833,7535,17368,2021-09-30
3174021008,JAKARTA SELATAN,SETIA BUDI,KUNINGAN TIMUR,6008,1477,4531,3647,8178,2021-09-30
3171041005,JAKARTA PUSAT,SENEN,KWITANG,15486,4138,11348,8645,19993,2021-09-30
3172031003,JAKARTA UTARA,KOJA,LAGOA,59065,16777,42288,31084,73372,2021-09-30
3174061002,JAKARTA SELATAN,CILANDAK,LEBAK BULUS,37626,9047,28579,22730,51309,2021-09-30
3174091004,JAKARTA SELATAN,JAGAKARSA,LENTENG AGUNG,53946,13214,40732,30353,71085,2021-09-30
3175101007,JAKARTA TIMUR,CIPAYUNG,LUBANG BUAYA,63547,14717,48830,37991,86821,2021-09-30
3175081001,JAKARTA TIMUR,MAKASAR,MAKASAR,34390,8350,26040,20804,46844,2021-09-30
3175071006,JAKARTA TIMUR,DUREN SAWIT,MALAKA JAYA,30927,7176,23751,18879,42630,2021-09-30
3175071005,JAKARTA TIMUR,DUREN SAWIT,MALAKA SARI,27530,6002,21528,17317,38845,2021-09-30
3174031001,JAKARTA SELATAN,MAMPANG PRAPATAN,MAMPANG PRAPATAN,18159,4769,13390,10343,23733,2021-09-30
3173031005,JAKARTA BARAT,TAMAN SARI,MANGGA BESAR,7707,1552,6155,5037,11192,2021-09-30
3171021005,JAKARTA PUSAT,SAWAH BESAR,MANGGA DUA SELATAN,27442,6657,20785,16274,37059,2021-09-30
3174011007,JAKARTA SELATAN,TEBET,MANGGARAI,28373,6300,22073,16491,38564,2021-09-30
3174011006,JAKARTA SELATAN,TEBET,MANGGARAI SELATAN,23075,5158,17917,13953,31870,2021-09-30
3173031003,JAKARTA BARAT,TAMAN SARI,MAPHAR,16461,3913,12548,9848,22396,2021-09-30
3172041003,JAKARTA UTARA,CILINCING,MARUNDA,28943,7759,21184,14993,36177,2021-09-30
3174071001,JAKARTA SELATAN,KEBAYORAN BARU,MELAWAI,2627,586,2041,1801,3842,2021-09-30
3171061001,JAKARTA PUSAT,MENTENG,MENTENG,25624,6954,18670,13837,32507,2021-09-30
3174021005,JAKARTA SELATAN,SETIA BUDI,MENTENG ATAS,27816,6343,21473,16458,37931,2021-09-30
3174011003,JAKARTA SELATAN,TEBET,MENTENG DALAM,36028,8712,27316,21152,48468,2021-09-30
3173081003,JAKARTA BARAT,KEMBANGAN,MERUYA SELATAN,32130,8116,24014,18629,42643,2021-09-30
3173081002,JAKARTA BARAT,KEMBANGAN,MERUYA UTARA,43752,11164,32588,26446,59034,2021-09-30
3175101004,JAKARTA TIMUR,CIPAYUNG,MUNJUL,23871,5608,18263,14447,32710,2021-09-30
3172051002,JAKARTA UTARA,PADEMANGAN,PADEMANGAN BARAT,74240,20628,53612,40542,94154,2021-09-30
3172051001,JAKARTA UTARA,PADEMANGAN,PADEMANGAN TIMUR,37736,8052,29684,24310,53994,2021-09-30
3175011004,JAKARTA TIMUR,MATRAMAN,PAL MERIAM,19769,5317,14452,10914,25366,2021-09-30
3173071001,JAKARTA BARAT,PALMERAH,PALMERAH,63011,16643,46368,35003,81371,2021-09-30
3174081001,JAKARTA SELATAN,PANCORAN,PANCORAN,19421,5210,14211,10851,25062,2021-09-30
3172021003,JAKARTA UTARA,TANJUNG PRIOK,PAPANGGO,39097,9425,29672,23039,52711,2021-09-30
3171021001,JAKARTA PUSAT,SAWAH BESAR,PASAR BARU,12035,2692,9343,7917,17260,2021-09-30
3174021006,JAKARTA SELATAN,SETIA BUDI,PASAR MANGGIS,26752,6662,20090,15506,35596,2021-09-30
3174041001,JAKARTA SELATAN,PASAR MINGGU,PASAR MINGGU,24821,5858,18963,14993,33956,2021-09-30
3171041003,JAKARTA PUSAT,SENEN,PASEBAN,23533,6082,17451,13270,30721,2021-09-30
3173061005,JAKARTA BARAT,KALI DERES,PEGADUNGAN,75587,18192,57395,46690,104085,2021-09-30
3171061002,JAKARTA PUSAT,MENTENG,PEGANGSAAN,23455,6198,17257,12251,29508,2021-09-30
3172061002,JAKARTA UTARA,KELAPA GADING,PEGANGSAAN DUA,49976,9609,40367,34858,75225,2021-09-30
3172011004,JAKARTA UTARA,PENJARINGAN,PEJAGALAN,74578,18670,55908,44828,100736,2021-09-30
3174041006,JAKARTA SELATAN,PASAR MINGGU,PEJATEN BARAT,37346,9571,27775,21831,49606,2021-09-30
3174041005,JAKARTA SELATAN,PASAR MINGGU,PEJATEN TIMUR,57656,16037,41619,31542,73161,2021-09-30
3175051005,JAKARTA TIMUR,PASAR REBO,PEKAYON,43250,9801,33449,25924,59373,2021-09-30
3173041009,JAKARTA BARAT,TAMBORA,PEKOJAN,23587,5494,18093,14146,32239,2021-09-30
3174031003,JAKARTA SELATAN,MAMPANG PRAPATAN,PELA MAMPANG,43522,11021,32501,25528,58029,2021-09-30
3174081005,JAKARTA SELATAN,PANCORAN,PENGADEGAN,21478,4821,16657,12446,29103,2021-09-30
3175061003,JAKARTA TIMUR,CAKUNG,PENGGILINGAN,99255,27977,71278,52297,123575,2021-09-30
3172011001,JAKARTA UTARA,PENJARINGAN,PENJARINGAN,88308,26503,61805,44730,106535,2021-09-30
3174101001,JAKARTA SELATAN,PESANGGRAHAN,PESANGGRAHAN,27545,5940,21605,17350,38955,2021-09-30
3171071004,JAKARTA PUSAT,TANAH ABANG,PETAMBURAN,33271,10421,22850,15711,38561,2021-09-30
3174071008,JAKARTA SELATAN,KEBAYORAN BARU,PETOGOGAN,11499,2796,8703,6739,15442,2021-09-30
3171011004,JAKARTA PUSAT,GAMBIR,PETOJO SELATAN,14692,3931,10761,8567,19328,2021-09-30
3171011003,JAKARTA PUSAT,GAMBIR,PETOJO UTARA,17458,4451,13007,9966,22973,2021-09-30
3174101004,JAKARTA SELATAN,PESANGGRAHAN,PETUKANGAN SELATAN,37187,9425,27762,22094,49856,2021-09-30
3174101003,JAKARTA SELATAN,PESANGGRAHAN,PETUKANGAN UTARA,53716,14077,39639,30666,70305,2021-09-30
3175081002,JAKARTA TIMUR,MAKASAR,PINANG RANTI,27198,7107,20091,15615,35706,2021-09-30
3173031008,JAKARTA BARAT,TAMAN SARI,PINANGSIA,10729,2394,8335,6561,14896,2021-09-30
3175011001,JAKARTA TIMUR,MATRAMAN,PISANGAN BARU,31776,8269,23507,17026,40533,2021-09-30
3175021002,JAKARTA TIMUR,PULO GADUNG,PISANGAN TIMUR,41011,9696,31315,24757,56072,2021-09-30
3172011005,JAKARTA UTARA,PENJARINGAN,PLUIT,47783,10875,36908,30829,67737,2021-09-30
3175071002,JAKARTA TIMUR,DUREN SAWIT,PONDOK BAMBU,61550,16512,45038,34634,79672,2021-09-30
3175071004,JAKARTA TIMUR,DUREN SAWIT,PONDOK KELAPA,72015,17338,54677,43604,98281,2021-09-30
3175071007,JAKARTA TIMUR,DUREN SAWIT,PONDOK KOPI,35367,9018,26349,19282,45631,2021-09-30
3174061003,JAKARTA SELATAN,CILANDAK,PONDOK LABU,46464,10085,36379,29172,65551,2021-09-30
3174051002,JAKARTA SELATAN,KEBAYORAN LAMA,PONDOK PINANG,56169,13132,43037,33742,76779,2021-09-30
3175101003,JAKARTA TIMUR,CIPAYUNG,PONDOK RANGGON,25574,6355,19219,15129,34348,2021-09-30
3101011003,KAB.ADM.KEP.SERIBU,KEP. SERIBU UTARA,PULAU HARAPAN,2060,269,1791,1458,3249,2021-09-30
3101011002,KAB.ADM.KEP.SERIBU,KEP. SERIBU UTARA,PULAU KELAPA,5528,698,4830,3614,8444,2021-09-30
3101011001,KAB.ADM.KEP.SERIBU,KEP. SERIBU UTARA,PULAU PANGGANG,5450,596,4854,3895,8749,2021-09-30
3101021003,KAB.ADM.KEP.SERIBU,KEP. SERIBU SELATAN,PULAU PARI,2765,234,2531,2223,4754,2021-09-30
3101021002,KAB.ADM.KEP.SERIBU,KEP. SERIBU SELATAN,PULAU TIDUNG,4553,461,4092,3576,7668,2021-09-30
3101021001,KAB.ADM.KEP.SERIBU,KEP. SERIBU SELATAN,PULAU UNTUNG JAWA,1941,222,1719,1545,3264,2021-09-30
3174071007,JAKARTA SELATAN,KEBAYORAN BARU,PULO,5835,1212,4623,3941,8564,2021-09-30
3175021001,JAKARTA TIMUR,PULO GADUNG,PULO GADUNG,34422,8830,25592,19811,45403,2021-09-30
3175061005,JAKARTA TIMUR,CAKUNG,PULO GEBANG,97301,23251,74050,55098,129148,2021-09-30
3174041004,JAKARTA SELATAN,PASAR MINGGU,RAGUNAN,39616,9290,30326,23977,54303,2021-09-30
3175091005,JAKARTA TIMUR,CIRACAS,RAMBUTAN,36771,10441,26330,19588,45918,2021-09-30
3172031006,JAKARTA UTARA,KOJA,RAWA BADAK SELATAN,42179,12025,30154,21884,52038,2021-09-30
3172031004,JAKARTA UTARA,KOJA,RAWA BADAK UTARA,34408,9376,25032,18646,43678,2021-09-30
3174071005,JAKARTA SELATAN,KEBAYORAN BARU,RAWA BARAT,5625,1168,4457,3675,8132,2021-09-30
3173011003,JAKARTA BARAT,CENGKARENG,RAWA BUAYA,63799,16156,47643,34910,82553,2021-09-30
3175031004,JAKARTA TIMUR,JATINEGARA,RAWA BUNGA,21434,6150,15284,11434,26718,2021-09-30
3174081003,JAKARTA SELATAN,PANCORAN,RAWA JATI,20509,4857,15652,11538,27190,2021-09-30
3175061002,JAKARTA TIMUR,CAKUNG,RAWA TERATE,24637,5494,19143,14682,33825,2021-09-30
3175021005,JAKARTA TIMUR,PULO GADUNG,RAWAMANGUN,37612,9224,28388,22364,50752,2021-09-30
3171051003,JAKARTA PUSAT,CEMPAKA PUTIH,RAWASARI,21967,5520,16447,12935,29382,2021-09-30
3173041010,JAKARTA BARAT,TAMBORA,ROA MALAKA,3484,687,2797,2351,5148,2021-09-30
3172041006,JAKARTA UTARA,CILINCING,ROROTAN,41668,10231,31437,23680,55117,2021-09-30
3174071004,JAKARTA SELATAN,KEBAYORAN BARU,SELONG,2842,609,2233,1914,4147,2021-09-30
3173061002,JAKARTA BARAT,KALI DERES,SEMANAN,71354,19155,52199,39562,91761,2021-09-30
3172041007,JAKARTA UTARA,CILINCING,SEMPER BARAT,68587,16326,52261,40994,93255,2021-09-30
3172041005,JAKARTA UTARA,CILINCING,SEMPER TIMUR,36267,9259,27008,20420,47428,2021-09-30
3174071006,JAKARTA SELATAN,KEBAYORAN BARU,SENAYAN,2771,756,2015,1603,3618,2021-09-30
3171041001,JAKARTA PUSAT,SENEN,SENEN,6804,1716,5088,4066,9154,2021-09-30
3171031004,JAKARTA PUSAT,KEMAYORAN,SERDANG,29668,7309,22359,17365,39724,2021-09-30
3174021001,JAKARTA SELATAN,SETIA BUDI,SETIA BUDI,3023,746,2277,1802,4079,2021-09-30
3175101005,JAKARTA TIMUR,CIPAYUNG,SETU,20572,5303,15269,11609,26878,2021-09-30
3173071002,JAKARTA BARAT,PALMERAH,SLIPI,16591,3783,12808,10037,22845,2021-09-30
3173081004,JAKARTA BARAT,KEMBANGAN,SRENGSENG,45523,12248,33275,26203,59478,2021-09-30
3174091002,JAKARTA SELATAN,JAGAKARSA,SRENGSENG SAWAH,58196,12239,45957,36673,82630,2021-09-30
3173051003,JAKARTA BARAT,KEBON JERUK,SUKABUMI SELATAN,37033,10350,26683,19333,46016,2021-09-30
3173051002,JAKARTA BARAT,KEBON JERUK,SUKABUMI UTARA,38290,11020,27270,19708,46978,2021-09-30
3172041002,JAKARTA UTARA,CILINCING,SUKAPURA,53949,14575,39374,30481,69855,2021-09-30
3171031007,JAKARTA PUSAT,KEMAYORAN,SUMUR BATU,22717,5650,17067,13504,30571,2021-09-30
3172021004,JAKARTA UTARA,TANJUNG PRIOK,SUNGAI BAMBU,29876,7381,22495,17456,39951,2021-09-30
3172021006,JAKARTA UTARA,TANJUNG PRIOK,SUNTER AGUNG,71805,15036,56769,47082,103851,2021-09-30
3172021002,JAKARTA UTARA,TANJUNG PRIOK,SUNTER JAYA,63031,14020,49011,40156,89167,2021-09-30
3175091004,JAKARTA TIMUR,CIRACAS,SUSUKAN,38257,8846,29411,23074,52485,2021-09-30
3173031001,JAKARTA BARAT,TAMAN SARI,TAMAN SARI,14348,3242,11106,8925,20031,2021-09-30
3173041001,JAKARTA BARAT,TAMBORA,TAMBORA,10204,2706,7498,5673,13171,2021-09-30
3173041004,JAKARTA BARAT,TAMBORA,TANAH SEREAL,26387,5451,20936,16474,37410,2021-09-30
3171081004,JAKARTA PUSAT,JOHAR BARU,TANAH TINGGI,37693,8385,29308,22275,51583,2021-09-30
3173031004,JAKARTA BARAT,TAMAN SARI,TANGKI,13324,2927,10397,8146,18543,2021-09-30
3174091005,JAKARTA SELATAN,JAGAKARSA,TANJUNG BARAT,39770,9341,30429,23421,53850,2021-09-30
3173021005,JAKARTA BARAT,GROGOL PETAMBURAN,TANJUNG DUREN SELATAN,25337,5903,19434,15936,35370,2021-09-30
3173021002,JAKARTA BARAT,GROGOL PETAMBURAN,TANJUNG DUREN UTARA,17010,3627,13383,11196,24579,2021-09-30
3172021001,JAKARTA UTARA,TANJUNG PRIOK,TANJUNG PRIOK,34588,8534,26054,20031,46085,2021-09-30
3174011002,JAKARTA SELATAN,TEBET,TEBET BARAT,21194,4299,16895,13742,30637,2021-09-30
3174011001,JAKARTA SELATAN,TEBET,TEBET TIMUR,18199,3617,14582,12152,26734,2021-09-30
3173061003,JAKARTA BARAT,KALI DERES,TEGAL ALUR,83647,21495,62152,47961,110113,2021-09-30
3174031004,JAKARTA SELATAN,MAMPANG PRAPATAN,TEGAL PARANG,32401,9135,23266,16732,39998,2021-09-30
3173021003,JAKARTA BARAT,GROGOL PETAMBURAN,TOMANG,29605,6627,22978,18378,41356,2021-09-30
3172031005,JAKARTA UTARA,KOJA,TUGU SELATAN,39122,10433,28689,21078,49767,2021-09-30
3172031002,JAKARTA UTARA,KOJA,TUGU UTARA,67670,19044,48626,35596,84222,2021-09-30
3175061006,JAKARTA TIMUR,CAKUNG,UJUNG MENTENG,29934,6370,23564,18604,42168,2021-09-30
3174101005,JAKARTA SELATAN,PESANGGRAHAN,ULUJAMI,40544,11386,29158,22443,51601,2021-09-30
3175011006,JAKARTA TIMUR,MATRAMAN,UTAN KAYU SELATAN,33511,7798,25713,19636,45349,2021-09-30
3175011002,JAKARTA TIMUR,MATRAMAN,UTAN KAYU UTARA,28169,7293,20876,15847,36723,2021-09-30
3171031008,JAKARTA PUSAT,KEMAYORAN,UTAN PANJANG,29208,7711,21497,16200,37697,2021-09-30
3172021007,JAKARTA UTARA,TANJUNG PRIOK,WARAKAS,44401,10235,34166,25808,59974,2021-09-30
3173021007,JAKARTA BARAT,GROGOL PETAMBURAN,WIJAYA KUSUMA,38934,10147,28787,22629,51416,2021-09-30
3172051003,JAKARTA UTARA,PADEMANGAN,ANCOL,23947,6647,17300,13405,30705,2021-10-01
3173041007,JAKARTA BARAT,TAMBORA,ANGKE,29381,7559,21822,16471,38293,2021-10-01
3175041005,JAKARTA TIMUR,KRAMAT JATI,BALE KAMBANG,29074,8660,20414,14425,34839,2021-10-01
3175031003,JAKARTA TIMUR,JATINEGARA,BALI MESTER,9752,2496,7256,5665,12921,2021-10-01
3175101006,JAKARTA TIMUR,CIPAYUNG,BAMBU APUS,26285,6055,20230,15400,35630,2021-10-01
3174031002,JAKARTA SELATAN,MAMPANG PRAPATAN,BANGKA,21566,5745,15821,12175,27996,2021-10-01
3175051002,JAKARTA TIMUR,PASAR REBO,BARU,23886,4873,19013,15558,34571,2021-10-01
3175041004,JAKARTA TIMUR,KRAMAT JATI,BATU AMPAR,47898,14035,33863,24757,58620,2021-10-01
3171071002,JAKARTA PUSAT,TANAH ABANG,BENDUNGAN HILIR,21494,5209,16285,12784,29069,2021-10-01
3175031002,JAKARTA TIMUR,JATINEGARA,BIDARA CINA,36689,10559,26130,19214,45344,2021-10-01
3174101002,JAKARTA SELATAN,PESANGGRAHAN,BINTARO,53098,12853,40245,32215,72460,2021-10-01
3174011005,JAKARTA SELATAN,TEBET,BUKIT DURI,34183,8629,25554,19411,44965,2021-10-01
3171041006,JAKARTA PUSAT,SENEN,BUNGUR,18144,4606,13538,10606,24144,2021-10-01
3175061007,JAKARTA TIMUR,CAKUNG,CAKUNG BARAT,57724,13970,43754,33906,77660,2021-10-01
3175061004,JAKARTA TIMUR,CAKUNG,CAKUNG TIMUR,58287,13934,44353,34343,78696,2021-10-01
3175041007,JAKARTA TIMUR,KRAMAT JATI,CAWANG,32762,8728,24034,17668,41702,2021-10-01
3175101008,JAKARTA TIMUR,CIPAYUNG,CEGER,18932,4533,14399,11224,25623,2021-10-01
3171031006,JAKARTA PUSAT,KEMAYORAN,CEMPAKA BARU,32581,8292,24289,17885,42174,2021-10-01
3171051002,JAKARTA PUSAT,CEMPAKA PUTIH,CEMPAKA PUTIH BARAT,35885,9283,26602,20929,47531,2021-10-01
3171051001,JAKARTA PUSAT,CEMPAKA PUTIH,CEMPAKA PUTIH TIMUR,24292,5934,18358,14788,33146,2021-10-01
3173011001,JAKARTA BARAT,CENGKARENG,CENGKARENG BARAT,66284,16436,49848,38954,88802,2021-10-01
3173011006,JAKARTA BARAT,CENGKARENG,CENGKARENG TIMUR,81027,19489,61538,46671,108209,2021-10-01
3175091002,JAKARTA TIMUR,CIRACAS,CIBUBUR,66364,14201,52163,41045,93208,2021-10-01
3171011002,JAKARTA PUSAT,GAMBIR,CIDENG,15390,3530,11860,9738,21598,2021-10-01
3174091003,JAKARTA SELATAN,JAGAKARSA,CIGANJUR,38497,8611,29886,22453,52339,2021-10-01
3175051003,JAKARTA TIMUR,PASAR REBO,CIJANTUNG,41419,9404,32015,24952,56967,2021-10-01
3171061003,JAKARTA PUSAT,MENTENG,CIKINI,8274,1768,6506,4679,11185,2021-10-01
3174081006,JAKARTA SELATAN,PANCORAN,CIKOKO,10547,2259,8288,6542,14830,2021-10-01
3174061001,JAKARTA SELATAN,CILANDAK,CILANDAK BARAT,51752,11907,39845,32206,72051,2021-10-01
3174041003,JAKARTA SELATAN,PASAR MINGGU,CILANDAK TIMUR,25145,5762,19383,15420,34803,2021-10-01
3175101002,JAKARTA TIMUR,CIPAYUNG,CILANGKAP,27635,6401,21234,16550,37784,2021-10-01
3175041006,JAKARTA TIMUR,KRAMAT JATI,CILILITAN,40181,10990,29191,21780,50971,2021-10-01
3172041001,JAKARTA UTARA,CILINCING,CILINCING,43609,12285,31324,22640,53964,2021-10-01
3175101001,JAKARTA TIMUR,CIPAYUNG,CIPAYUNG,26104,5602,20502,16545,37047,2021-10-01
3174091006,JAKARTA SELATAN,JAGAKARSA,CIPEDAK,38303,8469,29834,23410,53244,2021-10-01
3174061005,JAKARTA SELATAN,CILANDAK,CIPETE SELATAN,26704,6255,20449,16302,36751,2021-10-01
3174071010,JAKARTA SELATAN,KEBAYORAN BARU,CIPETE UTARA,34102,8076,26026,19703,45729,2021-10-01
3175021003,JAKARTA TIMUR,PULO GADUNG,CIPINANG,39306,9395,29911,22847,52758,2021-10-01
3175031007,JAKARTA TIMUR,JATINEGARA,CIPINANG BESAR SELATAN,35212,9956,25256,18029,43285,2021-10-01
3175031008,JAKARTA TIMUR,JATINEGARA,CIPINANG BESAR UTARA,45319,12905,32414,23130,55544,2021-10-01
3175031005,JAKARTA TIMUR,JATINEGARA,CIPINANG CEMPEDAK,32824,8979,23845,18554,42399,2021-10-01
3175081005,JAKARTA TIMUR,MAKASAR,CIPINANG MELAYU,42308,10338,31970,25230,57200,2021-10-01
3175031006,JAKARTA TIMUR,JATINEGARA,CIPINANG MUARA,55243,14559,40684,30536,71220,2021-10-01
3174051003,JAKARTA SELATAN,KEBAYORAN LAMA,CIPULIR,39937,10240,29697,21917,51614,2021-10-01
3175091001,JAKARTA TIMUR,CIRACAS,CIRACAS,64594,14507,50087,38568,88655,2021-10-01
3175041003,JAKARTA TIMUR,KRAMAT JATI,DUKUH,24609,5658,18951,14472,33423,2021-10-01
3175071001,JAKARTA TIMUR,DUREN SAWIT,DUREN SAWIT,61160,16210,44950,34171,79121,2021-10-01
3174081004,JAKARTA SELATAN,PANCORAN,DUREN TIGA,28319,6920,21399,15292,36691,2021-10-01
3173051005,JAKARTA BARAT,KEBON JERUK,DURI KEPA,60138,14091,46047,37684,83731,2021-10-01
3173011002,JAKARTA BARAT,CENGKARENG,DURI KOSAMBI,77923,21238,56685,42082,98767,2021-10-01
3171011006,JAKARTA PUSAT,GAMBIR,DURI PULO,19610,4924,14686,11020,25706,2021-10-01
3173041011,JAKARTA BARAT,TAMBORA,DURI SELATAN,14259,3162,11097,8853,19950,2021-10-01
3173041003,JAKARTA BARAT,TAMBORA,DURI UTARA,19844,4694,15150,11569,26719,2021-10-01
3171081003,JAKARTA PUSAT,JOHAR BARU,GALUR,18243,4248,13995,10672,24667,2021-10-01
3171011001,JAKARTA PUSAT,GAMBIR,GAMBIR,2191,539,1652,1338,2990,2021-10-01
3174061004,JAKARTA SELATAN,CILANDAK,GANDARIA SELATAN,22119,5362,16757,13050,29807,2021-10-01
3174071009,JAKARTA SELATAN,KEBAYORAN BARU,GANDARIA UTARA,39922,9819,30103,23194,53297,2021-10-01
3175051001,JAKARTA TIMUR,PASAR REBO,GEDONG,35755,8628,27127,21334,48461,2021-10-01
3171071001,JAKARTA PUSAT,TANAH ABANG,GELORA,3127,738,2389,1845,4234,2021-10-01
3173031007,JAKARTA BARAT,TAMAN SARI,GLODOK,7837,1529,6308,5394,11702,2021-10-01
3171061004,JAKARTA PUSAT,MENTENG,GONDANGDIA,4100,1031,3069,2683,5752,2021-10-01
3173021001,JAKARTA BARAT,GROGOL PETAMBURAN,GROGOL,16876,4021,12855,10068,22923,2021-10-01
3174051005,JAKARTA SELATAN,KEBAYORAN LAMA,GROGOL SELATAN,44251,11231,33020,25083,58103,2021-10-01
3174051004,JAKARTA SELATAN,KEBAYORAN LAMA,GROGOL UTARA,42494,10639,31855,24566,56421,2021-10-01
3174021007,JAKARTA SELATAN,SETIA BUDI,GUNTUR,3985,923,3062,2583,5645,2021-10-01
3174071002,JAKARTA SELATAN,KEBAYORAN BARU,GUNUNG,9436,2138,7298,5981,13279,2021-10-01
3171031005,JAKARTA PUSAT,KEMAYORAN,GUNUNG SAHARI SELATAN,19199,4762,14437,11326,25763,2021-10-01
3171021004,JAKARTA PUSAT,SAWAH BESAR,GUNUNG SAHARI UTARA,16650,3510,13140,11025,24165,2021-10-01
3175081004,JAKARTA TIMUR,MAKASAR,HALIM PERDANA KUSUMAH,28363,4592,23771,20850,44621,2021-10-01
3171031003,JAKARTA PUSAT,KEMAYORAN,HARAPAN MULIA,22557,5651,16906,12813,29719,2021-10-01
3174091001,JAKARTA SELATAN,JAGAKARSA,JAGAKARSA,62389,14365,48024,37671,85695,2021-10-01
3175021007,JAKARTA TIMUR,PULO GADUNG,JATI,32757,7642,25115,20224,45339,2021-10-01
3174041002,JAKARTA SELATAN,PASAR MINGGU,JATI PADANG,37502,9424,28078,21982,50060,2021-10-01
3173071004,JAKARTA BARAT,PALMERAH,JATI PULO,28738,6873,21865,16316,38181,2021-10-01
3175061001,JAKARTA TIMUR,CAKUNG,JATINEGARA,84160,21852,62308,47727,110035,2021-10-01
3175021004,JAKARTA TIMUR,PULO GADUNG,JATINEGARA KAUM,24632,5708,18924,14112,33036,2021-10-01
3173021004,JAKARTA BARAT,GROGOL PETAMBURAN,JELAMBAR,30266,6904,23362,18756,42118,2021-10-01
3173021006,JAKARTA BARAT,GROGOL PETAMBURAN,JELAMBAR BARU,38246,8849,29397,23532,52929,2021-10-01
3173041006,JAKARTA BARAT,TAMBORA,JEMBATAN BESI,29314,8689,20625,14532,35157,2021-10-01
3173041008,JAKARTA BARAT,TAMBORA,JEMBATAN LIMA,21021,5923,15098,11016,26114,2021-10-01
3173081005,JAKARTA BARAT,KEMBANGAN,JOGLO,40839,10006,30833,24226,55059,2021-10-01
3171081001,JAKARTA PUSAT,JOHAR BARU,JOHAR BARU,37488,8314,29174,22966,52140,2021-10-01
3173041002,JAKARTA BARAT,TAMBORA,KALI ANYAR,23856,5907,17949,13193,31142,2021-10-01
3172041004,JAKARTA UTARA,CILINCING,KALIBARU,67684,22284,45400,30685,76085,2021-10-01
3174081002,JAKARTA SELATAN,PANCORAN,KALIBATA,41994,11874,30120,21212,51332,2021-10-01
3173061001,JAKARTA BARAT,KALI DERES,KALIDERES,72447,18211,54236,43089,97325,2021-10-01
3175051004,JAKARTA TIMUR,PASAR REBO,KALISARI,43212,9753,33459,26310,59769,2021-10-01
3173061004,JAKARTA BARAT,KALI DERES,KAMAL,53783,15325,38458,28737,67195,2021-10-01
3172011002,JAKARTA UTARA,PENJARINGAN,KAMAL MUARA,12930,2510,10420,8565,18985,2021-10-01
3171071007,JAKARTA PUSAT,TANAH ABANG,KAMPUNG BALI,11358,2995,8363,5888,14251,2021-10-01
3175031001,JAKARTA TIMUR,JATINEGARA,KAMPUNG MELAYU,25717,7587,18130,13070,31200,2021-10-01
3171081002,JAKARTA PUSAT,JOHAR BARU,KAMPUNG RAWA,21237,4110,17127,12834,29961,2021-10-01
3175041002,JAKARTA TIMUR,KRAMAT JATI,KAMPUNG TENGAH,43993,13172,30821,22653,53474,2021-10-01
3173011005,JAKARTA BARAT,CENGKARENG,KAPUK,134466,38313,96153,71452,167605,2021-10-01
3172011003,JAKARTA UTARA,PENJARINGAN,KAPUK MUARA,35781,7984,27797,23330,51127,2021-10-01
3171021002,JAKARTA PUSAT,SAWAH BESAR,KARANG ANYAR,25761,5927,19834,15430,35264,2021-10-01
3174021004,JAKARTA SELATAN,SETIA BUDI,KARET,9623,2231,7392,5692,13084,2021-10-01
3174021003,JAKARTA SELATAN,SETIA BUDI,KARET KUNINGAN,16055,3741,12314,9825,22139,2021-10-01
3174021002,JAKARTA SELATAN,SETIA BUDI,KARET SEMANGGI,2770,628,2142,1806,3948,2021-10-01
3171071003,JAKARTA PUSAT,TANAH ABANG,KARET TENGSIN,19271,4570,14701,11038,25739,2021-10-01
3171021003,JAKARTA PUSAT,SAWAH BESAR,KARTINI,22292,5226,17066,13599,30665,2021-10-01
3175011003,JAKARTA TIMUR,MATRAMAN,KAYU MANIS,25284,6649,18635,13483,32118,2021-10-01
3175021006,JAKARTA TIMUR,PULO GADUNG,KAYU PUTIH,40696,9248,31448,25787,57235,2021-10-01
3173031006,JAKARTA BARAT,TAMAN SARI,KEAGUNGAN,17387,4188,13199,10103,23302,2021-10-01
3174041007,JAKARTA SELATAN,PASAR MINGGU,KEBAGUSAN,44552,11109,33443,25013,58456,2021-10-01
3174051006,JAKARTA SELATAN,KEBAYORAN LAMA,KEBAYORAN LAMA SELATAN,41212,9460,31752,24795,56547,2021-10-01
3174051001,JAKARTA SELATAN,KEBAYORAN LAMA,KEBAYORAN LAMA UTARA,42422,10953,31469,24082,55551,2021-10-01
3174011004,JAKARTA SELATAN,TEBET,KEBON BARU,35165,8472,26693,20476,47169,2021-10-01
3172021005,JAKARTA UTARA,TANJUNG PRIOK,KEBON BAWANG,50952,12526,38426,29676,68102,2021-10-01
3173051001,JAKARTA BARAT,KEBON JERUK,KEBON JERUK,53887,14434,39453,30031,69484,2021-10-01
3171071006,JAKARTA PUSAT,TANAH ABANG,KEBON KACANG,21531,6196,15335,11200,26535,2021-10-01
3171011005,JAKARTA PUSAT,GAMBIR,KEBON KELAPA,10163,2421,7742,6036,13778,2021-10-01
3171031002,JAKARTA PUSAT,KEMAYORAN,KEBON KOSONG,30019,7787,22232,16905,39137,2021-10-01
3175011005,JAKARTA TIMUR,MATRAMAN,KEBON MANGGIS,16490,3906,12584,9625,22209,2021-10-01
3171071005,JAKARTA PUSAT,TANAH ABANG,KEBON MELATI,32206,9964,22242,15055,37297,2021-10-01
3175081003,JAKARTA TIMUR,MAKASAR,KEBON PALA,46614,11428,35186,27324,62510,2021-10-01
3171061005,JAKARTA PUSAT,MENTENG,KEBON SIRIH,12299,3127,9172,6791,15963,2021-10-01
3173011004,JAKARTA BARAT,CENGKARENG,KEDAUNG KALI ANGKE,32612,7518,25094,19544,44638,2021-10-01
3173051007,JAKARTA BARAT,KEBON JERUK,KEDOYA SELATAN,32165,7452,24713,19335,44048,2021-10-01
3173051006,JAKARTA BARAT,KEBON JERUK,KEDOYA UTARA,45740,10433,35307,28545,63852,2021-10-01
3173051004,JAKARTA BARAT,KEBON JERUK,KELAPA DUA,23565,6218,17347,13609,30956,2021-10-01
3175091003,JAKARTA TIMUR,CIRACAS,KELAPA DUA WETAN,46875,10011,36864,28997,65861,2021-10-01
3172061003,JAKARTA UTARA,KELAPA GADING,KELAPA GADING BARAT,35717,7213,28504,24568,53072,2021-10-01
3172061001,JAKARTA UTARA,KELAPA GADING,KELAPA GADING TIMUR,33592,6045,27547,24228,51775,2021-10-01
3173071005,JAKARTA BARAT,PALMERAH,KEMANGGISAN,32139,7567,24572,18908,43480,2021-10-01
3171031001,JAKARTA PUSAT,KEMAYORAN,KEMAYORAN,20708,5112,15596,12094,27690,2021-10-01
3173081006,JAKARTA BARAT,KEMBANGAN,KEMBANGAN SELATAN,27130,6772,20358,16620,36978,2021-10-01
3173081001,JAKARTA BARAT,KEMBANGAN,KEMBANGAN UTARA,54451,14093,40358,31578,71936,2021-10-01
3171041002,JAKARTA PUSAT,SENEN,KENARI,9579,2235,7344,5870,13214,2021-10-01
3173041005,JAKARTA BARAT,TAMBORA,KERENDANG,19973,5073,14900,11115,26015,2021-10-01
3175071003,JAKARTA TIMUR,DUREN SAWIT,KLENDER,69978,19777,50201,36956,87157,2021-10-01
3172031001,JAKARTA UTARA,KOJA,KOJA,28175,7632,20543,15498,36041,2021-10-01
3173071006,JAKARTA BARAT,PALMERAH,KOTA BAMBU SELATAN,21158,5391,15767,11512,27279,2021-10-01
3173071003,JAKARTA BARAT,PALMERAH,KOTA BAMBU UTARA,24995,6539,18456,13354,31810,2021-10-01
3171041004,JAKARTA PUSAT,SENEN,KRAMAT,28835,8033,20802,14695,35497,2021-10-01
3175041001,JAKARTA TIMUR,KRAMAT JATI,KRAMAT JATI,34144,9036,25108,19042,44150,2021-10-01
3174071003,JAKARTA SELATAN,KEBAYORAN BARU,KRAMAT PELA,14413,3307,11106,8785,19891,2021-10-01
3173031002,JAKARTA BARAT,TAMAN SARI,KRUKUT,19244,4728,14516,10983,25499,2021-10-01
3174031005,JAKARTA SELATAN,MAMPANG PRAPATAN,KUNINGAN BARAT,12785,2936,9849,7540,17389,2021-10-01
3174021008,JAKARTA SELATAN,SETIA BUDI,KUNINGAN TIMUR,6008,1471,4537,3653,8190,2021-10-01
3171041005,JAKARTA PUSAT,SENEN,KWITANG,15486,4120,11366,8657,20023,2021-10-01
3172031003,JAKARTA UTARA,KOJA,LAGOA,59065,16653,42412,31167,73579,2021-10-01
3174061002,JAKARTA SELATAN,CILANDAK,LEBAK BULUS,37626,8875,28751,22770,51521,2021-10-01
3174091004,JAKARTA SELATAN,JAGAKARSA,LENTENG AGUNG,53946,13140,40806,30383,71189,2021-10-01
3175101007,JAKARTA TIMUR,CIPAYUNG,LUBANG BUAYA,63547,14620,48927,38033,86960,2021-10-01
3175081001,JAKARTA TIMUR,MAKASAR,MAKASAR,34390,8307,26083,20830,46913,2021-10-01
3175071006,JAKARTA TIMUR,DUREN SAWIT,MALAKA JAYA,30927,7127,23800,18908,42708,2021-10-01
3175071005,JAKARTA TIMUR,DUREN SAWIT,MALAKA SARI,27530,5957,21573,17339,38912,2021-10-01
3174031001,JAKARTA SELATAN,MAMPANG PRAPATAN,MAMPANG PRAPATAN,18159,4672,13487,10382,23869,2021-10-01
3173031005,JAKARTA BARAT,TAMAN SARI,MANGGA BESAR,7707,1547,6160,5041,11201,2021-10-01
3171021005,JAKARTA PUSAT,SAWAH BESAR,MANGGA DUA SELATAN,27442,6635,20807,16291,37098,2021-10-01
3174011007,JAKARTA SELATAN,TEBET,MANGGARAI,28373,6255,22118,16520,38638,2021-10-01
3174011006,JAKARTA SELATAN,TEBET,MANGGARAI SELATAN,23075,5130,17945,13966,31911,2021-10-01
3173031003,JAKARTA BARAT,TAMAN SARI,MAPHAR,16461,3898,12563,9858,22421,2021-10-01
3172041003,JAKARTA UTARA,CILINCING,MARUNDA,28943,7733,21210,15028,36238,2021-10-01
3174071001,JAKARTA SELATAN,KEBAYORAN BARU,MELAWAI,2627,584,2043,1801,3844,2021-10-01
3171061001,JAKARTA PUSAT,MENTENG,MENTENG,25624,6918,18706,13853,32559,2021-10-01
3174021005,JAKARTA SELATAN,SETIA BUDI,MENTENG ATAS,27816,6301,21515,16476,37991,2021-10-01
3174011003,JAKARTA SELATAN,TEBET,MENTENG DALAM,36028,8674,27354,21184,48538,2021-10-01
3173081003,JAKARTA BARAT,KEMBANGAN,MERUYA SELATAN,32130,8079,24051,18654,42705,2021-10-01
3173081002,JAKARTA BARAT,KEMBANGAN,MERUYA UTARA,43752,11109,32643,26481,59124,2021-10-01
3175101004,JAKARTA TIMUR,CIPAYUNG,MUNJUL,23871,5525,18346,14479,32825,2021-10-01
3172051002,JAKARTA UTARA,PADEMANGAN,PADEMANGAN BARAT,74240,20528,53712,40628,94340,2021-10-01
3172051001,JAKARTA UTARA,PADEMANGAN,PADEMANGAN TIMUR,37736,7992,29744,24353,54097,2021-10-01
3175011004,JAKARTA TIMUR,MATRAMAN,PAL MERIAM,19769,5290,14479,10928,25407,2021-10-01
3173071001,JAKARTA BARAT,PALMERAH,PALMERAH,63011,16534,46477,35043,81520,2021-10-01
3174081001,JAKARTA SELATAN,PANCORAN,PANCORAN,19421,5171,14250,10904,25154,2021-10-01
3172021003,JAKARTA UTARA,TANJUNG PRIOK,PAPANGGO,39097,9376,29721,23076,52797,2021-10-01
3171021001,JAKARTA PUSAT,SAWAH BESAR,PASAR BARU,12035,2682,9353,7924,17277,2021-10-01
3174021006,JAKARTA SELATAN,SETIA BUDI,PASAR MANGGIS,26752,6632,20120,15522,35642,2021-10-01
3174041001,JAKARTA SELATAN,PASAR MINGGU,PASAR MINGGU,24821,5794,19027,15011,34038,2021-10-01
3171041003,JAKARTA PUSAT,SENEN,PASEBAN,23533,6045,17488,13303,30791,2021-10-01
3173061005,JAKARTA BARAT,KALI DERES,PEGADUNGAN,75587,18118,57469,46805,104274,2021-10-01
3171061002,JAKARTA PUSAT,MENTENG,PEGANGSAAN,23455,6163,17292,12273,29565,2021-10-01
3172061002,JAKARTA UTARA,KELAPA GADING,PEGANGSAAN DUA,49976,9574,40402,34910,75312,2021-10-01
3172011004,JAKARTA UTARA,PENJARINGAN,PEJAGALAN,74578,18584,55994,44900,100894,2021-10-01
3174041006,JAKARTA SELATAN,PASAR MINGGU,PEJATEN BARAT,37346,9490,27856,21871,49727,2021-10-01
3174041005,JAKARTA SELATAN,PASAR MINGGU,PEJATEN TIMUR,57656,15898,41758,31581,73339,2021-10-01
3175051005,JAKARTA TIMUR,PASAR REBO,PEKAYON,43250,9700,33550,25963,59513,2021-10-01
3173041009,JAKARTA BARAT,TAMBORA,PEKOJAN,23587,5469,18118,14167,32285,2021-10-01
3174031003,JAKARTA SELATAN,MAMPANG PRAPATAN,PELA MAMPANG,43522,10960,32562,25566,58128,2021-10-01
3174081005,JAKARTA SELATAN,PANCORAN,PENGADEGAN,21478,4796,16682,12495,29177,2021-10-01
3175061003,JAKARTA TIMUR,CAKUNG,PENGGILINGAN,99255,27827,71428,52375,123803,2021-10-01
3172011001,JAKARTA UTARA,PENJARINGAN,PENJARINGAN,88308,26383,61925,44824,106749,2021-10-01
3174101001,JAKARTA SELATAN,PESANGGRAHAN,PESANGGRAHAN,27545,5907,21638,17381,39019,2021-10-01
3171071004,JAKARTA PUSAT,TANAH ABANG,PETAMBURAN,33271,10379,22892,15738,38630,2021-10-01
3174071008,JAKARTA SELATAN,KEBAYORAN BARU,PETOGOGAN,11499,2786,8713,6745,15458,2021-10-01
3171011004,JAKARTA PUSAT,GAMBIR,PETOJO SELATAN,14692,3901,10791,8576,19367,2021-10-01
3171011003,JAKARTA PUSAT,GAMBIR,PETOJO UTARA,17458,4439,13019,9976,22995,2021-10-01
3174101004,JAKARTA SELATAN,PESANGGRAHAN,PETUKANGAN SELATAN,37187,9381,27806,22111,49917,2021-10-01
3174101003,JAKARTA SELATAN,PESANGGRAHAN,PETUKANGAN UTARA,53716,14010,39706,30709,70415,2021-10-01
3175081002,JAKARTA TIMUR,MAKASAR,PINANG RANTI,27198,7069,20129,15646,35775,2021-10-01
3173031008,JAKARTA BARAT,TAMAN SARI,PINANGSIA,10729,2373,8356,6565,14921,2021-10-01
3175011001,JAKARTA TIMUR,MATRAMAN,PISANGAN BARU,31776,8213,23563,17079,40642,2021-10-01
3175021002,JAKARTA TIMUR,PULO GADUNG,PISANGAN TIMUR,41011,9637,31374,24815,56189,2021-10-01
3172011005,JAKARTA UTARA,PENJARINGAN,PLUIT,47783,10823,36960,30869,67829,2021-10-01
3175071002,JAKARTA TIMUR,DUREN SAWIT,PONDOK BAMBU,61550,16371,45179,34682,79861,2021-10-01
3175071004,JAKARTA TIMUR,DUREN SAWIT,PONDOK KELAPA,72015,17229,54786,43785,98571,2021-10-01
3175071007,JAKARTA TIMUR,DUREN SAWIT,PONDOK KOPI,35367,8946,26421,19310,45731,2021-10-01
3174061003,JAKARTA SELATAN,CILANDAK,PONDOK LABU,46464,9978,36486,29224,65710,2021-10-01
3174051002,JAKARTA SELATAN,KEBAYORAN LAMA,PONDOK PINANG,56169,13061,43108,33802,76910,2021-10-01
3175101003,JAKARTA TIMUR,CIPAYUNG,PONDOK RANGGON,25574,6312,19262,15148,34410,2021-10-01
3101011003,KAB.ADM.KEP.SERIBU,KEP. SERIBU UTARA,PULAU HARAPAN,2060,268,1792,1463,3255,2021-10-01
3101011002,KAB.ADM.KEP.SERIBU,KEP. SERIBU UTARA,PULAU KELAPA,5528,692,4836,3646,8482,2021-10-01
3101011001,KAB.ADM.KEP.SERIBU,KEP. SERIBU UTARA,PULAU PANGGANG,5450,591,4859,3928,8787,2021-10-01
3101021003,KAB.ADM.KEP.SERIBU,KEP. SERIBU SELATAN,PULAU PARI,2765,231,2534,2241,4775,2021-10-01
3101021002,KAB.ADM.KEP.SERIBU,KEP. SERIBU SELATAN,PULAU TIDUNG,4553,455,4098,3589,7687,2021-10-01
3101021001,KAB.ADM.KEP.SERIBU,KEP. SERIBU SELATAN,PULAU UNTUNG JAWA,1941,220,1721,1555,3276,2021-10-01
3174071007,JAKARTA SELATAN,KEBAYORAN BARU,PULO,5835,1202,4633,3943,8576,2021-10-01
3175021001,JAKARTA TIMUR,PULO GADUNG,PULO GADUNG,34422,8760,25662,19849,45511,2021-10-01
3175061005,JAKARTA TIMUR,CAKUNG,PULO GEBANG,97301,23048,74253,55196,129449,2021-10-01
3174041004,JAKARTA SELATAN,PASAR MINGGU,RAGUNAN,39616,9195,30421,24024,54445,2021-10-01
3175091005,JAKARTA TIMUR,CIRACAS,RAMBUTAN,36771,10371,26400,19625,46025,2021-10-01
3172031006,JAKARTA UTARA,KOJA,RAWA BADAK SELATAN,42179,11953,30226,21968,52194,2021-10-01
3172031004,JAKARTA UTARA,KOJA,RAWA BADAK UTARA,34408,9343,25065,18679,43744,2021-10-01
3174071005,JAKARTA SELATAN,KEBAYORAN BARU,RAWA BARAT,5625,1146,4479,3679,8158,2021-10-01
3173011003,JAKARTA BARAT,CENGKARENG,RAWA BUAYA,63799,16076,47723,34985,82708,2021-10-01
3175031004,JAKARTA TIMUR,JATINEGARA,RAWA BUNGA,21434,6107,15327,11448,26775,2021-10-01
3174081003,JAKARTA SELATAN,PANCORAN,RAWA JATI,20509,4836,15673,11574,27247,2021-10-01
3175061002,JAKARTA TIMUR,CAKUNG,RAWA TERATE,24637,5464,19173,14719,33892,2021-10-01
3175021005,JAKARTA TIMUR,PULO GADUNG,RAWAMANGUN,37612,9139,28473,22413,50886,2021-10-01
3171051003,JAKARTA PUSAT,CEMPAKA PUTIH,RAWASARI,21967,5485,16482,12953,29435,2021-10-01
3173041010,JAKARTA BARAT,TAMBORA,ROA MALAKA,3484,684,2800,2353,5153,2021-10-01
3172041006,JAKARTA UTARA,CILINCING,ROROTAN,41668,10165,31503,23723,55226,2021-10-01
3174071004,JAKARTA SELATAN,KEBAYORAN BARU,SELONG,2842,608,2234,1916,4150,2021-10-01
3173061002,JAKARTA BARAT,KALI DERES,SEMANAN,71354,19055,52299,39662,91961,2021-10-01
3172041007,JAKARTA UTARA,CILINCING,SEMPER BARAT,68587,16236,52351,41040,93391,2021-10-01
3172041005,JAKARTA UTARA,CILINCING,SEMPER TIMUR,36267,9198,27069,20445,47514,2021-10-01
3174071006,JAKARTA SELATAN,KEBAYORAN BARU,SENAYAN,2771,749,2022,1609,3631,2021-10-01
3171041001,JAKARTA PUSAT,SENEN,SENEN,6804,1709,5095,4068,9163,2021-10-01
3171031004,JAKARTA PUSAT,KEMAYORAN,SERDANG,29668,7260,22408,17397,39805,2021-10-01
3174021001,JAKARTA SELATAN,SETIA BUDI,SETIA BUDI,3023,740,2283,1806,4089,2021-10-01
3175101005,JAKARTA TIMUR,CIPAYUNG,SETU,20572,5220,15352,11634,26986,2021-10-01
3173071002,JAKARTA BARAT,PALMERAH,SLIPI,16591,3757,12834,10057,22891,2021-10-01
3173081004,JAKARTA BARAT,KEMBANGAN,SRENGSENG,45523,12182,33341,26229,59570,2021-10-01
3174091002,JAKARTA SELATAN,JAGAKARSA,SRENGSENG SAWAH,58196,12033,46163,36802,82965,2021-10-01
3173051003,JAKARTA BARAT,KEBON JERUK,SUKABUMI SELATAN,37033,10295,26738,19384,46122,2021-10-01
3173051002,JAKARTA BARAT,KEBON JERUK,SUKABUMI UTARA,38290,10945,27345,19742,47087,2021-10-01
3172041002,JAKARTA UTARA,CILINCING,SUKAPURA,53949,14517,39432,30534,69966,2021-10-01
3171031007,JAKARTA PUSAT,KEMAYORAN,SUMUR BATU,22717,5613,17104,13528,30632,2021-10-01
3172021004,JAKARTA UTARA,TANJUNG PRIOK,SUNGAI BAMBU,29876,7335,22541,17476,40017,2021-10-01
3172021006,JAKARTA UTARA,TANJUNG PRIOK,SUNTER AGUNG,71805,14929,56876,47143,104019,2021-10-01
3172021002,JAKARTA UTARA,TANJUNG PRIOK,SUNTER JAYA,63031,13930,49101,40212,89313,2021-10-01
3175091004,JAKARTA TIMUR,CIRACAS,SUSUKAN,38257,8806,29451,23099,52550,2021-10-01
3173031001,JAKARTA BARAT,TAMAN SARI,TAMAN SARI,14348,3235,11113,8935,20048,2021-10-01
3173041001,JAKARTA BARAT,TAMBORA,TAMBORA,10204,2700,7504,5677,13181,2021-10-01
3173041004,JAKARTA BARAT,TAMBORA,TANAH SEREAL,26387,5431,20956,16493,37449,2021-10-01
3171081004,JAKARTA PUSAT,JOHAR BARU,TANAH TINGGI,37693,8302,29391,22314,51705,2021-10-01
3173031004,JAKARTA BARAT,TAMAN SARI,TANGKI,13324,2920,10404,8157,18561,2021-10-01
3174091005,JAKARTA SELATAN,JAGAKARSA,TANJUNG BARAT,39770,9271,30499,23465,53964,2021-10-01
3173021005,JAKARTA BARAT,GROGOL PETAMBURAN,TANJUNG DUREN SELATAN,25337,5857,19480,15972,35452,2021-10-01
3173021002,JAKARTA BARAT,GROGOL PETAMBURAN,TANJUNG DUREN UTARA,17010,3580,13430,11216,24646,2021-10-01
3172021001,JAKARTA UTARA,TANJUNG PRIOK,TANJUNG PRIOK,34588,8503,26085,20068,46153,2021-10-01
3174011002,JAKARTA SELATAN,TEBET,TEBET BARAT,21194,4272,16922,13764,30686,2021-10-01
3174011001,JAKARTA SELATAN,TEBET,TEBET TIMUR,18199,3586,14613,12169,26782,2021-10-01
3173061003,JAKARTA BARAT,KALI DERES,TEGAL ALUR,83647,21339,62308,48108,110416,2021-10-01
3174031004,JAKARTA SELATAN,MAMPANG PRAPATAN,TEGAL PARANG,32401,9070,23331,16769,40100,2021-10-01
3173021003,JAKARTA BARAT,GROGOL PETAMBURAN,TOMANG,29605,6591,23014,18397,41411,2021-10-01
3172031005,JAKARTA UTARA,KOJA,TUGU SELATAN,39122,10340,28782,21106,49888,2021-10-01
3172031002,JAKARTA UTARA,KOJA,TUGU UTARA,67670,18945,48725,35694,84419,2021-10-01
3175061006,JAKARTA TIMUR,CAKUNG,UJUNG MENTENG,29934,6322,23612,18626,42238,2021-10-01
3174101005,JAKARTA SELATAN,PESANGGRAHAN,ULUJAMI,40544,11273,29271,22479,51750,2021-10-01
3175011006,JAKARTA TIMUR,MATRAMAN,UTAN KAYU SELATAN,33511,7709,25802,19665,45467,2021-10-01
3175011002,JAKARTA TIMUR,MATRAMAN,UTAN KAYU UTARA,28169,7215,20954,15906,36860,2021-10-01
3171031008,JAKARTA PUSAT,KEMAYORAN,UTAN PANJANG,29208,7681,21527,16213,37740,2021-10-01
3172021007,JAKARTA UTARA,TANJUNG PRIOK,WARAKAS,44401,10095,34306,25894,60200,2021-10-01
3173021007,JAKARTA BARAT,GROGOL PETAMBURAN,WIJAYA KUSUMA,38934,10070,28864,22665,51529,2021-10-01
3172051003,JAKARTA UTARA,PADEMANGAN,ANCOL,23947,6616,17331,13473,30804,2021-10-02
3173041007,JAKARTA BARAT,TAMBORA,ANGKE,29381,7520,21861,16578,38439,2021-10-02
3175041005,JAKARTA TIMUR,KRAMAT JATI,BALE KAMBANG,29074,8598,20476,14546,35022,2021-10-02
3175031003,JAKARTA TIMUR,JATINEGARA,BALI MESTER,9752,2471,7281,5706,12987,2021-10-02
3175101006,JAKARTA TIMUR,CIPAYUNG,BAMBU APUS,26285,5873,20412,15472,35884,2021-10-02
3174031002,JAKARTA SELATAN,MAMPANG PRAPATAN,BANGKA,21566,5704,15862,12236,28098,2021-10-02
3175051002,JAKARTA TIMUR,PASAR REBO,BARU,23886,4854,19032,15603,34635,2021-10-02
3175041004,JAKARTA TIMUR,KRAMAT JATI,BATU AMPAR,47898,13948,33950,24932,58882,2021-10-02
3171071002,JAKARTA PUSAT,TANAH ABANG,BENDUNGAN HILIR,21494,5177,16317,12873,29190,2021-10-02
3175031002,JAKARTA TIMUR,JATINEGARA,BIDARA CINA,36689,10505,26184,19335,45519,2021-10-02
3174101002,JAKARTA SELATAN,PESANGGRAHAN,BINTARO,53098,12796,40302,32331,72633,2021-10-02
3174011005,JAKARTA SELATAN,TEBET,BUKIT DURI,34183,8590,25593,19591,45184,2021-10-02
3171041006,JAKARTA PUSAT,SENEN,BUNGUR,18144,4591,13553,10640,24193,2021-10-02
3175061007,JAKARTA TIMUR,CAKUNG,CAKUNG BARAT,57724,13931,43793,34050,77843,2021-10-02
3175061004,JAKARTA TIMUR,CAKUNG,CAKUNG TIMUR,58287,13843,44444,34580,79024,2021-10-02
3175041007,JAKARTA TIMUR,KRAMAT JATI,CAWANG,32762,8665,24097,17794,41891,2021-10-02
3175101008,JAKARTA TIMUR,CIPAYUNG,CEGER,18932,4513,14419,11268,25687,2021-10-02
3171031006,JAKARTA PUSAT,KEMAYORAN,CEMPAKA BARU,32581,8242,24339,17982,42321,2021-10-02
3171051002,JAKARTA PUSAT,CEMPAKA PUTIH,CEMPAKA PUTIH BARAT,35885,9230,26655,21069,47724,2021-10-02
3171051001,JAKARTA PUSAT,CEMPAKA PUTIH,CEMPAKA PUTIH TIMUR,24292,5902,18390,14911,33301,2021-10-02
3173011001,JAKARTA BARAT,CENGKARENG,CENGKARENG BARAT,66284,16335,49949,39142,89091,2021-10-02
3173011006,JAKARTA BARAT,CENGKARENG,CENGKARENG TIMUR,81027,19347,61680,46879,108559,2021-10-02
3175091002,JAKARTA TIMUR,CIRACAS,CIBUBUR,66364,14091,52273,41209,93482,2021-10-02
3171011002,JAKARTA PUSAT,GAMBIR,CIDENG,15390,3507,11883,9770,21653,2021-10-02
3174091003,JAKARTA SELATAN,JAGAKARSA,CIGANJUR,38497,8558,29939,22555,52494,2021-10-02
3175051003,JAKARTA TIMUR,PASAR REBO,CIJANTUNG,41419,9325,32094,25064,57158,2021-10-02
3171061003,JAKARTA PUSAT,MENTENG,CIKINI,8274,1757,6517,4705,11222,2021-10-02
3174081006,JAKARTA SELATAN,PANCORAN,CIKOKO,10547,2246,8301,6611,14912,2021-10-02
3174061001,JAKARTA SELATAN,CILANDAK,CILANDAK BARAT,51752,11802,39950,32399,72349,2021-10-02
3174041003,JAKARTA SELATAN,PASAR MINGGU,CILANDAK TIMUR,25145,5744,19401,15490,34891,2021-10-02
3175101002,JAKARTA TIMUR,CIPAYUNG,CILANGKAP,27635,6379,21256,16606,37862,2021-10-02
3175041006,JAKARTA TIMUR,KRAMAT JATI,CILILITAN,40181,10883,29298,21920,51218,2021-10-02
3172041001,JAKARTA UTARA,CILINCING,CILINCING,43609,12232,31377,22736,54113,2021-10-02
3175101001,JAKARTA TIMUR,CIPAYUNG,CIPAYUNG,26104,5525,20579,16627,37206,2021-10-02
3174091006,JAKARTA SELATAN,JAGAKARSA,CIPEDAK,38303,8434,29869,23480,53349,2021-10-02
3174061005,JAKARTA SELATAN,CILANDAK,CIPETE SELATAN,26704,6195,20509,16455,36964,2021-10-02
3174071010,JAKARTA SELATAN,KEBAYORAN BARU,CIPETE UTARA,34102,8045,26057,19811,45868,2021-10-02
3175021003,JAKARTA TIMUR,PULO GADUNG,CIPINANG,39306,9326,29980,23019,52999,2021-10-02
3175031007,JAKARTA TIMUR,JATINEGARA,CIPINANG BESAR SELATAN,35212,9906,25306,18126,43432,2021-10-02
3175031008,JAKARTA TIMUR,JATINEGARA,CIPINANG BESAR UTARA,45319,12810,32509,23252,55761,2021-10-02
3175031005,JAKARTA TIMUR,JATINEGARA,CIPINANG CEMPEDAK,32824,8950,23874,18669,42543,2021-10-02
3175081005,JAKARTA TIMUR,MAKASAR,CIPINANG MELAYU,42308,10276,32032,25356,57388,2021-10-02
3175031006,JAKARTA TIMUR,JATINEGARA,CIPINANG MUARA,55243,14464,40779,30732,71511,2021-10-02
3174051003,JAKARTA SELATAN,KEBAYORAN LAMA,CIPULIR,39937,10201,29736,22034,51770,2021-10-02
3175091001,JAKARTA TIMUR,CIRACAS,CIRACAS,64594,14431,50163,38734,88897,2021-10-02
3175041003,JAKARTA TIMUR,KRAMAT JATI,DUKUH,24609,5613,18996,14574,33570,2021-10-02
3175071001,JAKARTA TIMUR,DUREN SAWIT,DUREN SAWIT,61160,16112,45048,34365,79413,2021-10-02
3174081004,JAKARTA SELATAN,PANCORAN,DUREN TIGA,28319,6890,21429,15529,36958,2021-10-02
3173051005,JAKARTA BARAT,KEBON JERUK,DURI KEPA,60138,14005,46133,37877,84010,2021-10-02
3173011002,JAKARTA BARAT,CENGKARENG,DURI KOSAMBI,77923,21127,56796,42244,99040,2021-10-02
3171011006,JAKARTA PUSAT,GAMBIR,DURI PULO,19610,4888,14722,11060,25782,2021-10-02
3173041011,JAKARTA BARAT,TAMBORA,DURI SELATAN,14259,3141,11118,8904,20022,2021-10-02
3173041003,JAKARTA BARAT,TAMBORA,DURI UTARA,19844,4659,15185,11635,26820,2021-10-02
3171081003,JAKARTA PUSAT,JOHAR BARU,GALUR,18243,4230,14013,10712,24725,2021-10-02
3171011001,JAKARTA PUSAT,GAMBIR,GAMBIR,2191,536,1655,1345,3000,2021-10-02
3174061004,JAKARTA SELATAN,CILANDAK,GANDARIA SELATAN,22119,5323,16796,13171,29967,2021-10-02
3174071009,JAKARTA SELATAN,KEBAYORAN BARU,GANDARIA UTARA,39922,9765,30157,23351,53508,2021-10-02
3175051001,JAKARTA TIMUR,PASAR REBO,GEDONG,35755,8566,27189,21417,48606,2021-10-02
3171071001,JAKARTA PUSAT,TANAH ABANG,GELORA,3127,733,2394,1876,4270,2021-10-02
3173031007,JAKARTA BARAT,TAMAN SARI,GLODOK,7837,1514,6323,5430,11753,2021-10-02
3171061004,JAKARTA PUSAT,MENTENG,GONDANGDIA,4100,1027,3073,2698,5771,2021-10-02
3173021001,JAKARTA BARAT,GROGOL PETAMBURAN,GROGOL,16876,4009,12867,10123,22990,2021-10-02
3174051005,JAKARTA SELATAN,KEBAYORAN LAMA,GROGOL SELATAN,44251,11152,33099,25270,58369,2021-10-02
3174051004,JAKARTA SELATAN,KEBAYORAN LAMA,GROGOL UTARA,42494,10617,31877,24687,56564,2021-10-02
3174021007,JAKARTA SELATAN,SETIA BUDI,GUNTUR,3985,920,3065,2600,5665,2021-10-02
3174071002,JAKARTA SELATAN,KEBAYORAN BARU,GUNUNG,9436,2123,7313,6016,13329,2021-10-02
3171031005,JAKARTA PUSAT,KEMAYORAN,GUNUNG SAHARI SELATAN,19199,4737,14462,11381,25843,2021-10-02
3171021004,JAKARTA PUSAT,SAWAH BESAR,GUNUNG SAHARI UTARA,16650,3483,13167,11074,24241,2021-10-02
3175081004,JAKARTA TIMUR,MAKASAR,HALIM PERDANA KUSUMAH,28363,4571,23792,20914,44706,2021-10-02
3171031003,JAKARTA PUSAT,KEMAYORAN,HARAPAN MULIA,22557,5610,16947,12864,29811,2021-10-02
3174091001,JAKARTA SELATAN,JAGAKARSA,JAGAKARSA,62389,14267,48122,37831,85953,2021-10-02
3175021007,JAKARTA TIMUR,PULO GADUNG,JATI,32757,7593,25164,20373,45537,2021-10-02
3174041002,JAKARTA SELATAN,PASAR MINGGU,JATI PADANG,37502,9351,28151,22126,50277,2021-10-02
3173071004,JAKARTA BARAT,PALMERAH,JATI PULO,28738,6834,21904,16380,38284,2021-10-02
3175061001,JAKARTA TIMUR,CAKUNG,JATINEGARA,84160,21759,62401,47967,110368,2021-10-02
3175021004,JAKARTA TIMUR,PULO GADUNG,JATINEGARA KAUM,24632,5673,18959,14263,33222,2021-10-02
3173021004,JAKARTA BARAT,GROGOL PETAMBURAN,JELAMBAR,30266,6842,23424,18863,42287,2021-10-02
3173021006,JAKARTA BARAT,GROGOL PETAMBURAN,JELAMBAR BARU,38246,8800,29446,23643,53089,2021-10-02
3173041006,JAKARTA BARAT,TAMBORA,JEMBATAN BESI,29314,8653,20661,14664,35325,2021-10-02
3173041008,JAKARTA BARAT,TAMBORA,JEMBATAN LIMA,21021,5898,15123,11089,26212,2021-10-02
3173081005,JAKARTA BARAT,KEMBANGAN,JOGLO,40839,9921,30918,24370,55288,2021-10-02
3171081001,JAKARTA PUSAT,JOHAR BARU,JOHAR BARU,37488,8262,29226,23061,52287,2021-10-02
3173041002,JAKARTA BARAT,TAMBORA,KALI ANYAR,23856,5871,17985,13257,31242,2021-10-02
3172041004,JAKARTA UTARA,CILINCING,KALIBARU,67684,22211,45473,30811,76284,2021-10-02
3174081002,JAKARTA SELATAN,PANCORAN,KALIBATA,41994,11785,30209,21522,51731,2021-10-02
3173061001,JAKARTA BARAT,KALI DERES,KALIDERES,72447,18129,54318,43289,97607,2021-10-02
3175051004,JAKARTA TIMUR,PASAR REBO,KALISARI,43212,9631,33581,26459,60040,2021-10-02
3173061004,JAKARTA BARAT,KALI DERES,KAMAL,53783,15275,38508,28830,67338,2021-10-02
3172011002,JAKARTA UTARA,PENJARINGAN,KAMAL MUARA,12930,2505,10425,8590,19015,2021-10-02
3171071007,JAKARTA PUSAT,TANAH ABANG,KAMPUNG BALI,11358,2976,8382,5907,14289,2021-10-02
3175031001,JAKARTA TIMUR,JATINEGARA,KAMPUNG MELAYU,25717,7540,18177,13113,31290,2021-10-02
3171081002,JAKARTA PUSAT,JOHAR BARU,KAMPUNG RAWA,21237,4091,17146,12878,30024,2021-10-02
3175041002,JAKARTA TIMUR,KRAMAT JATI,KAMPUNG TENGAH,43993,13105,30888,22775,53663,2021-10-02
3173011005,JAKARTA BARAT,CENGKARENG,KAPUK,134466,38134,96332,71791,168123,2021-10-02
3172011003,JAKARTA UTARA,PENJARINGAN,KAPUK MUARA,35781,7953,27828,23425,51253,2021-10-02
3171021002,JAKARTA PUSAT,SAWAH BESAR,KARANG ANYAR,25761,5894,19867,15530,35397,2021-10-02
3174021004,JAKARTA SELATAN,SETIA BUDI,KARET,9623,2222,7401,5725,13126,2021-10-02
3174021003,JAKARTA SELATAN,SETIA BUDI,KARET KUNINGAN,16055,3708,12347,9867,22214,2021-10-02
3174021002,JAKARTA SELATAN,SETIA BUDI,KARET SEMANGGI,2770,626,2144,1817,3961,2021-10-02
3171071003,JAKARTA PUSAT,TANAH ABANG,KARET TENGSIN,19271,4547,14724,11092,25816,2021-10-02
3171021003,JAKARTA PUSAT,SAWAH BESAR,KARTINI,22292,5181,17111,13659,30770,2021-10-02
3175011003,JAKARTA TIMUR,MATRAMAN,KAYU MANIS,25284,6619,18665,13598,32263,2021-10-02
3175021006,JAKARTA TIMUR,PULO GADUNG,KAYU PUTIH,40696,9164,31532,25928,57460,2021-10-02
3173031006,JAKARTA BARAT,TAMAN SARI,KEAGUNGAN,17387,4170,13217,10142,23359,2021-10-02
3174041007,JAKARTA SELATAN,PASAR MINGGU,KEBAGUSAN,44552,11054,33498,25136,58634,2021-10-02
3174051006,JAKARTA SELATAN,KEBAYORAN LAMA,KEBAYORAN LAMA SELATAN,41212,9389,31823,24887,56710,2021-10-02
3174051001,JAKARTA SELATAN,KEBAYORAN LAMA,KEBAYORAN LAMA UTARA,42422,10906,31516,24180,55696,2021-10-02
3174011004,JAKARTA SELATAN,TEBET,KEBON BARU,35165,8419,26746,20616,47362,2021-10-02
3172021005,JAKARTA UTARA,TANJUNG PRIOK,KEBON BAWANG,50952,12459,38493,29800,68293,2021-10-02
3173051001,JAKARTA BARAT,KEBON JERUK,KEBON JERUK,53887,14312,39575,30238,69813,2021-10-02
3171071006,JAKARTA PUSAT,TANAH ABANG,KEBON KACANG,21531,6157,15374,11271,26645,2021-10-02
3171011005,JAKARTA PUSAT,GAMBIR,KEBON KELAPA,10163,2409,7754,6071,13825,2021-10-02
3171031002,JAKARTA PUSAT,KEMAYORAN,KEBON KOSONG,30019,7651,22368,16986,39354,2021-10-02
3175011005,JAKARTA TIMUR,MATRAMAN,KEBON MANGGIS,16490,3893,12597,9670,22267,2021-10-02
3171071005,JAKARTA PUSAT,TANAH ABANG,KEBON MELATI,32206,9877,22329,15150,37479,2021-10-02
3175081003,JAKARTA TIMUR,MAKASAR,KEBON PALA,46614,11337,35277,27484,62761,2021-10-02
3171061005,JAKARTA PUSAT,MENTENG,KEBON SIRIH,12299,3106,9193,6826,16019,2021-10-02
3173011004,JAKARTA BARAT,CENGKARENG,KEDAUNG KALI ANGKE,32612,7494,25118,19607,44725,2021-10-02
3173051007,JAKARTA BARAT,KEBON JERUK,KEDOYA SELATAN,32165,7365,24800,19425,44225,2021-10-02
3173051006,JAKARTA BARAT,KEBON JERUK,KEDOYA UTARA,45740,10368,35372,28652,64024,2021-10-02
3173051004,JAKARTA BARAT,KEBON JERUK,KELAPA DUA,23565,6167,17398,13713,31111,2021-10-02
3175091003,JAKARTA TIMUR,CIRACAS,KELAPA DUA WETAN,46875,9957,36918,29124,66042,2021-10-02
3172061003,JAKARTA UTARA,KELAPA GADING,KELAPA GADING BARAT,35717,7177,28540,24645,53185,2021-10-02
3172061001,JAKARTA UTARA,KELAPA GADING,KELAPA GADING TIMUR,33592,5996,27596,24324,51920,2021-10-02
3173071005,JAKARTA BARAT,PALMERAH,KEMANGGISAN,32139,7512,24627,19017,43644,2021-10-02
3171031001,JAKARTA PUSAT,KEMAYORAN,KEMAYORAN,20708,5080,15628,12150,27778,2021-10-02
3173081006,JAKARTA BARAT,KEMBANGAN,KEMBANGAN SELATAN,27130,6746,20384,16713,37097,2021-10-02
3173081001,JAKARTA BARAT,KEMBANGAN,KEMBANGAN UTARA,54451,14021,40430,31698,72128,2021-10-02
3171041002,JAKARTA PUSAT,SENEN,KENARI,9579,2223,7356,5887,13243,2021-10-02
3173041005,JAKARTA BARAT,TAMBORA,KERENDANG,19973,5042,14931,11198,26129,2021-10-02
3175071003,JAKARTA TIMUR,DUREN SAWIT,KLENDER,69978,19675,50303,37192,87495,2021-10-02
3172031001,JAKARTA UTARA,KOJA,KOJA,28175,7591,20584,15554,36138,2021-10-02
3173071006,JAKARTA BARAT,PALMERAH,KOTA BAMBU SELATAN,21158,5363,15795,11553,27348,2021-10-02
3173071003,JAKARTA BARAT,PALMERAH,KOTA BAMBU UTARA,24995,6509,18486,13406,31892,2021-10-02
3171041004,JAKARTA PUSAT,SENEN,KRAMAT,28835,8002,20833,14748,35581,2021-10-02
3175041001,JAKARTA TIMUR,KRAMAT JATI,KRAMAT JATI,34144,8999,25145,19121,44266,2021-10-02
3174071003,JAKARTA SELATAN,KEBAYORAN BARU,KRAMAT PELA,14413,3287,11126,8823,19949,2021-10-02
3173031002,JAKARTA BARAT,TAMAN SARI,KRUKUT,19244,4708,14536,11034,25570,2021-10-02
3174031005,JAKARTA SELATAN,MAMPANG PRAPATAN,KUNINGAN BARAT,12785,2902,9883,7566,17449,2021-10-02
3174021008,JAKARTA SELATAN,SETIA BUDI,KUNINGAN TIMUR,6008,1463,4545,3669,8214,2021-10-02
3171041005,JAKARTA PUSAT,SENEN,KWITANG,15486,4108,11378,8690,20068,2021-10-02
3172031003,JAKARTA UTARA,KOJA,LAGOA,59065,16556,42509,31341,73850,2021-10-02
3174061002,JAKARTA SELATAN,CILANDAK,LEBAK BULUS,37626,8830,28796,22911,51707,2021-10-02
3174091004,JAKARTA SELATAN,JAGAKARSA,LENTENG AGUNG,53946,13039,40907,30520,71427,2021-10-02
3175101007,JAKARTA TIMUR,CIPAYUNG,LUBANG BUAYA,63547,14513,49034,38179,87213,2021-10-02
3175081001,JAKARTA TIMUR,MAKASAR,MAKASAR,34390,8259,26131,20949,47080,2021-10-02
3175071006,JAKARTA TIMUR,DUREN SAWIT,MALAKA JAYA,30927,7073,23854,19054,42908,2021-10-02
3175071005,JAKARTA TIMUR,DUREN SAWIT,MALAKA SARI,27530,5889,21641,17461,39102,2021-10-02
3174031001,JAKARTA SELATAN,MAMPANG PRAPATAN,MAMPANG PRAPATAN,18159,4644,13515,10419,23934,2021-10-02
3173031005,JAKARTA BARAT,TAMAN SARI,MANGGA BESAR,7707,1537,6170,5065,11235,2021-10-02
3171021005,JAKARTA PUSAT,SAWAH BESAR,MANGGA DUA SELATAN,27442,6622,20820,16338,37158,2021-10-02
3174011007,JAKARTA SELATAN,TEBET,MANGGARAI,28373,6219,22154,16575,38729,2021-10-02
3174011006,JAKARTA SELATAN,TEBET,MANGGARAI SELATAN,23075,5096,17979,14061,32040,2021-10-02
3173031003,JAKARTA BARAT,TAMAN SARI,MAPHAR,16461,3876,12585,9907,22492,2021-10-02
3172041003,JAKARTA UTARA,CILINCING,MARUNDA,28943,7693,21250,15097,36347,2021-10-02
3174071001,JAKARTA SELATAN,KEBAYORAN BARU,MELAWAI,2627,583,2044,1812,3856,2021-10-02
3171061001,JAKARTA PUSAT,MENTENG,MENTENG,25624,6858,18766,13925,32691,2021-10-02
3174021005,JAKARTA SELATAN,SETIA BUDI,MENTENG ATAS,27816,6232,21584,16595,38179,2021-10-02
3174011003,JAKARTA SELATAN,TEBET,MENTENG DALAM,36028,8630,27398,21331,48729,2021-10-02
3173081003,JAKARTA BARAT,KEMBANGAN,MERUYA SELATAN,32130,8038,24092,18754,42846,2021-10-02
3173081002,JAKARTA BARAT,KEMBANGAN,MERUYA UTARA,43752,10997,32755,26627,59382,2021-10-02
3175101004,JAKARTA TIMUR,CIPAYUNG,MUNJUL,23871,5448,18423,14565,32988,2021-10-02
3172051002,JAKARTA UTARA,PADEMANGAN,PADEMANGAN BARAT,74240,20389,53851,40781,94632,2021-10-02
3172051001,JAKARTA UTARA,PADEMANGAN,PADEMANGAN TIMUR,37736,7921,29815,24466,54281,2021-10-02
3175011004,JAKARTA TIMUR,MATRAMAN,PAL MERIAM,19769,5261,14508,10983,25491,2021-10-02
3173071001,JAKARTA BARAT,PALMERAH,PALMERAH,63011,16408,46603,35277,81880,2021-10-02
3174081001,JAKARTA SELATAN,PANCORAN,PANCORAN,19421,5149,14272,11046,25318,2021-10-02
3172021003,JAKARTA UTARA,TANJUNG PRIOK,PAPANGGO,39097,9326,29771,23151,52922,2021-10-02
3171021001,JAKARTA PUSAT,SAWAH BESAR,PASAR BARU,12035,2663,9372,7951,17323,2021-10-02
3174021006,JAKARTA SELATAN,SETIA BUDI,PASAR MANGGIS,26752,6602,20150,15589,35739,2021-10-02
3174041001,JAKARTA SELATAN,PASAR MINGGU,PASAR MINGGU,24821,5759,19062,15096,34158,2021-10-02
3171041003,JAKARTA PUSAT,SENEN,PASEBAN,23533,6008,17525,13365,30890,2021-10-02
3173061005,JAKARTA BARAT,KALI DERES,PEGADUNGAN,75587,18035,57552,46967,104519,2021-10-02
3171061002,JAKARTA PUSAT,MENTENG,PEGANGSAAN,23455,6132,17323,12345,29668,2021-10-02
3172061002,JAKARTA UTARA,KELAPA GADING,PEGANGSAAN DUA,49976,9510,40466,35070,75536,2021-10-02
3172011004,JAKARTA UTARA,PENJARINGAN,PEJAGALAN,74578,18458,56120,45155,101275,2021-10-02
3174041006,JAKARTA SELATAN,PASAR MINGGU,PEJATEN BARAT,37346,9409,27937,21974,49911,2021-10-02
3174041005,JAKARTA SELATAN,PASAR MINGGU,PEJATEN TIMUR,57656,15853,41803,31803,73606,2021-10-02
3175051005,JAKARTA TIMUR,PASAR REBO,PEKAYON,43250,9613,33637,26081,59718,2021-10-02
3173041009,JAKARTA BARAT,TAMBORA,PEKOJAN,23587,5439,18148,14244,32392,2021-10-02
3174031003,JAKARTA SELATAN,MAMPANG PRAPATAN,PELA MAMPANG,43522,10840,32682,25694,58376,2021-10-02
3174081005,JAKARTA SELATAN,PANCORAN,PENGADEGAN,21478,4755,16723,12638,29361,2021-10-02
3175061003,JAKARTA TIMUR,CAKUNG,PENGGILINGAN,99255,27676,71579,52827,124406,2021-10-02
3172011001,JAKARTA UTARA,PENJARINGAN,PENJARINGAN,88308,26279,62029,45015,107044,2021-10-02
3174101001,JAKARTA SELATAN,PESANGGRAHAN,PESANGGRAHAN,27545,5849,21696,17463,39159,2021-10-02
3171071004,JAKARTA PUSAT,TANAH ABANG,PETAMBURAN,33271,10284,22987,15837,38824,2021-10-02
3174071008,JAKARTA SELATAN,KEBAYORAN BARU,PETOGOGAN,11499,2774,8725,6782,15507,2021-10-02
3171011004,JAKARTA PUSAT,GAMBIR,PETOJO SELATAN,14692,3881,10811,8617,19428,2021-10-02
3171011003,JAKARTA PUSAT,GAMBIR,PETOJO UTARA,17458,4424,13034,10036,23070,2021-10-02
3174101004,JAKARTA SELATAN,PESANGGRAHAN,PETUKANGAN SELATAN,37187,9344,27843,22192,50035,2021-10-02
3174101003,JAKARTA SELATAN,PESANGGRAHAN,PETUKANGAN UTARA,53716,13940,39776,30841,70617,2021-10-02
3175081002,JAKARTA TIMUR,MAKASAR,PINANG RANTI,27198,7042,20156,15710,35866,2021-10-02
3173031008,JAKARTA BARAT,TAMAN SARI,PINANGSIA,10729,2368,8361,6589,14950,2021-10-02
3175011001,JAKARTA TIMUR,MATRAMAN,PISANGAN BARU,31776,8160,23616,17201,40817,2021-10-02
3175021002,JAKARTA TIMUR,PULO GADUNG,PISANGAN TIMUR,41011,9576,31435,24937,56372,2021-10-02
3172011005,JAKARTA UTARA,PENJARINGAN,PLUIT,47783,10739,37044,31015,68059,2021-10-02
3175071002,JAKARTA TIMUR,DUREN SAWIT,PONDOK BAMBU,61550,16270,45280,34909,80189,2021-10-02
3175071004,JAKARTA TIMUR,DUREN SAWIT,PONDOK KELAPA,72015,17110,54905,44024,98929,2021-10-02
3175071007,JAKARTA TIMUR,DUREN SAWIT,PONDOK KOPI,35367,8871,26496,19414,45910,2021-10-02
3174061003,JAKARTA SELATAN,CILANDAK,PONDOK LABU,46464,9820,36644,29453,66097,2021-10-02
3174051002,JAKARTA SELATAN,KEBAYORAN LAMA,PONDOK PINANG,56169,13027,43142,33949,77091,2021-10-02
3175101003,JAKARTA TIMUR,CIPAYUNG,PONDOK RANGGON,25574,6294,19280,15196,34476,2021-10-02
3101011003,KAB.ADM.KEP.SERIBU,KEP. SERIBU UTARA,PULAU HARAPAN,2060,268,1792,1468,3260,2021-10-02
3101011002,KAB.ADM.KEP.SERIBU,KEP. SERIBU UTARA,PULAU KELAPA,5528,689,4839,3736,8575,2021-10-02
3101011001,KAB.ADM.KEP.SERIBU,KEP. SERIBU UTARA,PULAU PANGGANG,5450,585,4865,4049,8914,2021-10-02
3101021003,KAB.ADM.KEP.SERIBU,KEP. SERIBU SELATAN,PULAU PARI,2765,225,2540,2261,4801,2021-10-02
3101021002,KAB.ADM.KEP.SERIBU,KEP. SERIBU SELATAN,PULAU TIDUNG,4553,454,4099,3617,7716,2021-10-02
3101021001,KAB.ADM.KEP.SERIBU,KEP. SERIBU SELATAN,PULAU UNTUNG JAWA,1941,219,1722,1563,3285,2021-10-02
3174071007,JAKARTA SELATAN,KEBAYORAN BARU,PULO,5835,1193,4642,3968,8610,2021-10-02
3175021001,JAKARTA TIMUR,PULO GADUNG,PULO GADUNG,34422,8710,25712,19971,45683,2021-10-02
3175061005,JAKARTA TIMUR,CAKUNG,PULO GEBANG,97301,22890,74411,55771,130182,2021-10-02
3174041004,JAKARTA SELATAN,PASAR MINGGU,RAGUNAN,39616,9131,30485,24130,54615,2021-10-02
3175091005,JAKARTA TIMUR,CIRACAS,RAMBUTAN,36771,10304,26467,19737,46204,2021-10-02
3172031006,JAKARTA UTARA,KOJA,RAWA BADAK SELATAN,42179,11890,30289,22133,52422,2021-10-02
3172031004,JAKARTA UTARA,KOJA,RAWA BADAK UTARA,34408,9283,25125,18764,43889,2021-10-02
3174071005,JAKARTA SELATAN,KEBAYORAN BARU,RAWA BARAT,5625,1138,4487,3705,8192,2021-10-02
3173011003,JAKARTA BARAT,CENGKARENG,RAWA BUAYA,63799,15975,47824,35174,82998,2021-10-02
3175031004,JAKARTA TIMUR,JATINEGARA,RAWA BUNGA,21434,6078,15356,11518,26874,2021-10-02
3174081003,JAKARTA SELATAN,PANCORAN,RAWA JATI,20509,4812,15697,11704,27401,2021-10-02
3175061002,JAKARTA TIMUR,CAKUNG,RAWA TERATE,24637,5442,19195,14829,34024,2021-10-02
3175021005,JAKARTA TIMUR,PULO GADUNG,RAWAMANGUN,37612,9054,28558,22563,51121,2021-10-02
3171051003,JAKARTA PUSAT,CEMPAKA PUTIH,RAWASARI,21967,5443,16524,13053,29577,2021-10-02
3173041010,JAKARTA BARAT,TAMBORA,ROA MALAKA,3484,680,2804,2363,5167,2021-10-02
3172041006,JAKARTA UTARA,CILINCING,ROROTAN,41668,10093,31575,23829,55404,2021-10-02
3174071004,JAKARTA SELATAN,KEBAYORAN BARU,SELONG,2842,603,2239,1929,4168,2021-10-02
3173061002,JAKARTA BARAT,KALI DERES,SEMANAN,71354,18992,52362,39778,92140,2021-10-02
3172041007,JAKARTA UTARA,CILINCING,SEMPER BARAT,68587,16155,52432,41167,93599,2021-10-02
3172041005,JAKARTA UTARA,CILINCING,SEMPER TIMUR,36267,9150,27117,20531,47648,2021-10-02
3174071006,JAKARTA SELATAN,KEBAYORAN BARU,SENAYAN,2771,744,2027,1615,3642,2021-10-02
3171041001,JAKARTA PUSAT,SENEN,SENEN,6804,1702,5102,4085,9187,2021-10-02
3171031004,JAKARTA PUSAT,KEMAYORAN,SERDANG,29668,7192,22476,17495,39971,2021-10-02
3174021001,JAKARTA SELATAN,SETIA BUDI,SETIA BUDI,3023,739,2284,1815,4099,2021-10-02
3175101005,JAKARTA TIMUR,CIPAYUNG,SETU,20572,5196,15376,11678,27054,2021-10-02
3173071002,JAKARTA BARAT,PALMERAH,SLIPI,16591,3726,12865,10102,22967,2021-10-02
3173081004,JAKARTA BARAT,KEMBANGAN,SRENGSENG,45523,12105,33418,26352,59770,2021-10-02
3174091002,JAKARTA SELATAN,JAGAKARSA,SRENGSENG SAWAH,58196,11968,46228,36944,83172,2021-10-02
3173051003,JAKARTA BARAT,KEBON JERUK,SUKABUMI SELATAN,37033,10222,26811,19504,46315,2021-10-02
3173051002,JAKARTA BARAT,KEBON JERUK,SUKABUMI UTARA,38290,10889,27401,19912,47313,2021-10-02
3172041002,JAKARTA UTARA,CILINCING,SUKAPURA,53949,14434,39515,30696,70211,2021-10-02
3171031007,JAKARTA PUSAT,KEMAYORAN,SUMUR BATU,22717,5585,17132,13606,30738,2021-10-02
3172021004,JAKARTA UTARA,TANJUNG PRIOK,SUNGAI BAMBU,29876,7308,22568,17561,40129,2021-10-02
3172021006,JAKARTA UTARA,TANJUNG PRIOK,SUNTER AGUNG,71805,14851,56954,47343,104297,2021-10-02
3172021002,JAKARTA UTARA,TANJUNG PRIOK,SUNTER JAYA,63031,13839,49192,40405,89597,2021-10-02
3175091004,JAKARTA TIMUR,CIRACAS,SUSUKAN,38257,8746,29511,23171,52682,2021-10-02
3173031001,JAKARTA BARAT,TAMAN SARI,TAMAN SARI,14348,3220,11128,8979,20107,2021-10-02
3173041001,JAKARTA BARAT,TAMBORA,TAMBORA,10204,2682,7522,5716,13238,2021-10-02
3173041004,JAKARTA BARAT,TAMBORA,TANAH SEREAL,26387,5393,20994,16572,37566,2021-10-02
3171081004,JAKARTA PUSAT,JOHAR BARU,TANAH TINGGI,37693,8259,29434,22404,51838,2021-10-02
3173031004,JAKARTA BARAT,TAMAN SARI,TANGKI,13324,2896,10428,8203,18631,2021-10-02
3174091005,JAKARTA SELATAN,JAGAKARSA,TANJUNG BARAT,39770,9200,30570,23619,54189,2021-10-02
3173021005,JAKARTA BARAT,GROGOL PETAMBURAN,TANJUNG DUREN SELATAN,25337,5821,19516,16051,35567,2021-10-02
3173021002,JAKARTA BARAT,GROGOL PETAMBURAN,TANJUNG DUREN UTARA,17010,3563,13447,11279,24726,2021-10-02
3172021001,JAKARTA UTARA,TANJUNG PRIOK,TANJUNG PRIOK,34588,8475,26113,20141,46254,2021-10-02
3174011002,JAKARTA SELATAN,TEBET,TEBET BARAT,21194,4249,16945,13871,30816,2021-10-02
3174011001,JAKARTA SELATAN,TEBET,TEBET TIMUR,18199,3563,14636,12268,26904,2021-10-02
3173061003,JAKARTA BARAT,KALI DERES,TEGAL ALUR,83647,21223,62424,48312,110736,2021-10-02
3174031004,JAKARTA SELATAN,MAMPANG PRAPATAN,TEGAL PARANG,32401,8980,23421,16847,40268,2021-10-02
3173021003,JAKARTA BARAT,GROGOL PETAMBURAN,TOMANG,29605,6542,23063,18473,41536,2021-10-02
3172031005,JAKARTA UTARA,KOJA,TUGU SELATAN,39122,10282,28840,21212,50052,2021-10-02
3172031002,JAKARTA UTARA,KOJA,TUGU UTARA,67670,18848,48822,35847,84669,2021-10-02
3175061006,JAKARTA TIMUR,CAKUNG,UJUNG MENTENG,29934,6283,23651,18705,42356,2021-10-02
3174101005,JAKARTA SELATAN,PESANGGRAHAN,ULUJAMI,40544,11157,29387,22563,51950,2021-10-02
3175011006,JAKARTA TIMUR,MATRAMAN,UTAN KAYU SELATAN,33511,7635,25876,19798,45674,2021-10-02
3175011002,JAKARTA TIMUR,MATRAMAN,UTAN KAYU UTARA,28169,7172,20997,16023,37020,2021-10-02
3171031008,JAKARTA PUSAT,KEMAYORAN,UTAN PANJANG,29208,7650,21558,16283,37841,2021-10-02
3172021007,JAKARTA UTARA,TANJUNG PRIOK,WARAKAS,44401,9945,34456,26013,60469,2021-10-02
3173021007,JAKARTA BARAT,GROGOL PETAMBURAN,WIJAYA KUSUMA,38934,10002,28932,22770,51702,2021-10-02
3172051003,JAKARTA UTARA,PADEMANGAN,ANCOL,23947,6602,17345,13495,30840,2021-10-03
3173041007,JAKARTA BARAT,TAMBORA,ANGKE,29381,7500,21881,16595,38476,2021-10-03
3175041005,JAKARTA TIMUR,KRAMAT JATI,BALE KAMBANG,29074,8556,20518,14605,35123,2021-10-03
3175031003,JAKARTA TIMUR,JATINEGARA,BALI MESTER,9752,2459,7293,5715,13008,2021-10-03
3175101006,JAKARTA TIMUR,CIPAYUNG,BAMBU APUS,26285,5868,20417,15484,35901,2021-10-03
3174031002,JAKARTA SELATAN,MAMPANG PRAPATAN,BANGKA,21566,5688,15878,12244,28122,2021-10-03
3175051002,JAKARTA TIMUR,PASAR REBO,BARU,23886,4843,19043,15613,34656,2021-10-03
3175041004,JAKARTA TIMUR,KRAMAT JATI,BATU AMPAR,47898,13903,33995,24996,58991,2021-10-03
3171071002,JAKARTA PUSAT,TANAH ABANG,BENDUNGAN HILIR,21494,5161,16333,12884,29217,2021-10-03
3175031002,JAKARTA TIMUR,JATINEGARA,BIDARA CINA,36689,10488,26201,19345,45546,2021-10-03
3174101002,JAKARTA SELATAN,PESANGGRAHAN,BINTARO,53098,12777,40321,32358,72679,2021-10-03
3174011005,JAKARTA SELATAN,TEBET,BUKIT DURI,34183,8579,25604,19601,45205,2021-10-03
3171041006,JAKARTA PUSAT,SENEN,BUNGUR,18144,4586,13558,10644,24202,2021-10-03
3175061007,JAKARTA TIMUR,CAKUNG,CAKUNG BARAT,57724,13923,43801,34059,77860,2021-10-03
3175061004,JAKARTA TIMUR,CAKUNG,CAKUNG TIMUR,58287,13737,44550,34677,79227,2021-10-03
3175041007,JAKARTA TIMUR,KRAMAT JATI,CAWANG,32762,8653,24109,17809,41918,2021-10-03
3175101008,JAKARTA TIMUR,CIPAYUNG,CEGER,18932,4506,14426,11271,25697,2021-10-03
3171031006,JAKARTA PUSAT,KEMAYORAN,CEMPAKA BARU,32581,8236,24345,17990,42335,2021-10-03
3171051002,JAKARTA PUSAT,CEMPAKA PUTIH,CEMPAKA PUTIH BARAT,35885,9221,26664,21079,47743,2021-10-03
3171051001,JAKARTA PUSAT,CEMPAKA PUTIH,CEMPAKA PUTIH TIMUR,24292,5894,18398,14925,33323,2021-10-03
3173011001,JAKARTA BARAT,CENGKARENG,CENGKARENG BARAT,66284,16324,49960,39165,89125,2021-10-03
3173011006,JAKARTA BARAT,CENGKARENG,CENGKARENG TIMUR,81027,19327,61700,46958,108658,2021-10-03
3175091002,JAKARTA TIMUR,CIRACAS,CIBUBUR,66364,14014,52350,41270,93620,2021-10-03
3171011002,JAKARTA PUSAT,GAMBIR,CIDENG,15390,3500,11890,9777,21667,2021-10-03
3174091003,JAKARTA SELATAN,JAGAKARSA,CIGANJUR,38497,8539,29958,22590,52548,2021-10-03
3175051003,JAKARTA TIMUR,PASAR REBO,CIJANTUNG,41419,9257,32162,25103,57265,2021-10-03
3171061003,JAKARTA PUSAT,MENTENG,CIKINI,8274,1749,6525,4710,11235,2021-10-03
3174081006,JAKARTA SELATAN,PANCORAN,CIKOKO,10547,2243,8304,6614,14918,2021-10-03
3174061001,JAKARTA SELATAN,CILANDAK,CILANDAK BARAT,51752,11764,39988,32451,72439,2021-10-03
3174041003,JAKARTA SELATAN,PASAR MINGGU,CILANDAK TIMUR,25145,5731,19414,15500,34914,2021-10-03
3175101002,JAKARTA TIMUR,CIPAYUNG,CILANGKAP,27635,6295,21340,16635,37975,2021-10-03
3175041006,JAKARTA TIMUR,KRAMAT JATI,CILILITAN,40181,10873,29308,21944,51252,2021-10-03
3172041001,JAKARTA UTARA,CILINCING,CILINCING,43609,12226,31383,22747,54130,2021-10-03
3175101001,JAKARTA TIMUR,CIPAYUNG,CIPAYUNG,26104,5515,20589,16635,37224,2021-10-03
3174091006,JAKARTA SELATAN,JAGAKARSA,CIPEDAK,38303,8415,29888,23495,53383,2021-10-03
3174061005,JAKARTA SELATAN,CILANDAK,CIPETE SELATAN,26704,6180,20524,16474,36998,2021-10-03
3174071010,JAKARTA SELATAN,KEBAYORAN BARU,CIPETE UTARA,34102,8019,26083,19821,45904,2021-10-03
3175021003,JAKARTA TIMUR,PULO GADUNG,CIPINANG,39306,9258,30048,23062,53110,2021-10-03
3175031007,JAKARTA TIMUR,JATINEGARA,CIPINANG BESAR SELATAN,35212,9891,25321,18137,43458,2021-10-03
3175031008,JAKARTA TIMUR,JATINEGARA,CIPINANG BESAR UTARA,45319,12801,32518,23261,55779,2021-10-03
3175031005,JAKARTA TIMUR,JATINEGARA,CIPINANG CEMPEDAK,32824,8828,23996,18731,42727,2021-10-03
3175081005,JAKARTA TIMUR,MAKASAR,CIPINANG MELAYU,42308,10254,32054,25373,57427,2021-10-03
3175031006,JAKARTA TIMUR,JATINEGARA,CIPINANG MUARA,55243,14450,40793,30757,71550,2021-10-03
3174051003,JAKARTA SELATAN,KEBAYORAN LAMA,CIPULIR,39937,10034,29903,22052,51955,2021-10-03
3175091001,JAKARTA TIMUR,CIRACAS,CIRACAS,64594,14330,50264,38834,89098,2021-10-03
3175041003,JAKARTA TIMUR,KRAMAT JATI,DUKUH,24609,5604,19005,14583,33588,2021-10-03
3175071001,JAKARTA TIMUR,DUREN SAWIT,DUREN SAWIT,61160,16090,45070,34397,79467,2021-10-03
3174081004,JAKARTA SELATAN,PANCORAN,DUREN TIGA,28319,6867,21452,15550,37002,2021-10-03
3173051005,JAKARTA BARAT,KEBON JERUK,DURI KEPA,60138,13984,46154,37899,84053,2021-10-03
3173011002,JAKARTA BARAT,CENGKARENG,DURI KOSAMBI,77923,20904,57019,42270,99289,2021-10-03
3171011006,JAKARTA PUSAT,GAMBIR,DURI PULO,19610,4882,14728,11063,25791,2021-10-03
3173041011,JAKARTA BARAT,TAMBORA,DURI SELATAN,14259,3135,11124,8909,20033,2021-10-03
3173041003,JAKARTA BARAT,TAMBORA,DURI UTARA,19844,4643,15201,11660,26861,2021-10-03
3171081003,JAKARTA PUSAT,JOHAR BARU,GALUR,18243,4227,14016,10718,24734,2021-10-03
3171011001,JAKARTA PUSAT,GAMBIR,GAMBIR,2191,534,1657,1347,3004,2021-10-03
3174061004,JAKARTA SELATAN,CILANDAK,GANDARIA SELATAN,22119,5309,16810,13187,29997,2021-10-03
3174071009,JAKARTA SELATAN,KEBAYORAN BARU,GANDARIA UTARA,39922,9742,30180,23368,53548,2021-10-03
3175051001,JAKARTA TIMUR,PASAR REBO,GEDONG,35755,8524,27231,21443,48674,2021-10-03
3171071001,JAKARTA PUSAT,TANAH ABANG,GELORA,3127,731,2396,1878,4274,2021-10-03
3173031007,JAKARTA BARAT,TAMAN SARI,GLODOK,7837,1505,6332,5433,11765,2021-10-03
3171061004,JAKARTA PUSAT,MENTENG,GONDANGDIA,4100,1024,3076,2699,5775,2021-10-03
3173021001,JAKARTA BARAT,GROGOL PETAMBURAN,GROGOL,16876,3999,12877,10128,23005,2021-10-03
3174051005,JAKARTA SELATAN,KEBAYORAN LAMA,GROGOL SELATAN,44251,11140,33111,25293,58404,2021-10-03
3174051004,JAKARTA SELATAN,KEBAYORAN LAMA,GROGOL UTARA,42494,10607,31887,24703,56590,2021-10-03
3174021007,JAKARTA SELATAN,SETIA BUDI,GUNTUR,3985,918,3067,2600,5667,2021-10-03
3174071002,JAKARTA SELATAN,KEBAYORAN BARU,GUNUNG,9436,2120,7316,6026,13342,2021-10-03
3171031005,JAKARTA PUSAT,KEMAYORAN,GUNUNG SAHARI SELATAN,19199,4726,14473,11385,25858,2021-10-03
3171021004,JAKARTA PUSAT,SAWAH BESAR,GUNUNG SAHARI UTARA,16650,3477,13173,11083,24256,2021-10-03
3175081004,JAKARTA TIMUR,MAKASAR,HALIM PERDANA KUSUMAH,28363,4553,23810,20923,44733,2021-10-03
3171031003,JAKARTA PUSAT,KEMAYORAN,HARAPAN MULIA,22557,5605,16952,12870,29822,2021-10-03
3174091001,JAKARTA SELATAN,JAGAKARSA,JAGAKARSA,62389,14228,48161,37858,86019,2021-10-03
3175021007,JAKARTA TIMUR,PULO GADUNG,JATI,32757,7573,25184,20392,45576,2021-10-03
3174041002,JAKARTA SELATAN,PASAR MINGGU,JATI PADANG,37502,9333,28169,22139,50308,2021-10-03
3173071004,JAKARTA BARAT,PALMERAH,JATI PULO,28738,6827,21911,16386,38297,2021-10-03
3175061001,JAKARTA TIMUR,CAKUNG,JATINEGARA,84160,21721,62439,48001,110440,2021-10-03
3175021004,JAKARTA TIMUR,PULO GADUNG,JATINEGARA KAUM,24632,5669,18963,14273,33236,2021-10-03
3173021004,JAKARTA BARAT,GROGOL PETAMBURAN,JELAMBAR,30266,6826,23440,18890,42330,2021-10-03
3173021006,JAKARTA BARAT,GROGOL PETAMBURAN,JELAMBAR BARU,38246,8789,29457,23683,53140,2021-10-03
3173041006,JAKARTA BARAT,TAMBORA,JEMBATAN BESI,29314,8642,20672,14676,35348,2021-10-03
3173041008,JAKARTA BARAT,TAMBORA,JEMBATAN LIMA,21021,5888,15133,11114,26247,2021-10-03
3173081005,JAKARTA BARAT,KEMBANGAN,JOGLO,40839,9912,30927,24387,55314,2021-10-03
3171081001,JAKARTA PUSAT,JOHAR BARU,JOHAR BARU,37488,8257,29231,23071,52302,2021-10-03
3173041002,JAKARTA BARAT,TAMBORA,KALI ANYAR,23856,5863,17993,13264,31257,2021-10-03
3172041004,JAKARTA UTARA,CILINCING,KALIBARU,67684,22131,45553,30882,76435,2021-10-03
3174081002,JAKARTA SELATAN,PANCORAN,KALIBATA,41994,11757,30237,21555,51792,2021-10-03
3173061001,JAKARTA BARAT,KALI DERES,KALIDERES,72447,18068,54379,43340,97719,2021-10-03
3175051004,JAKARTA TIMUR,PASAR REBO,KALISARI,43212,9588,33624,26492,60116,2021-10-03
3173061004,JAKARTA BARAT,KALI DERES,KAMAL,53783,15265,38518,28840,67358,2021-10-03
3172011002,JAKARTA UTARA,PENJARINGAN,KAMAL MUARA,12930,2505,10425,8596,19021,2021-10-03
3171071007,JAKARTA PUSAT,TANAH ABANG,KAMPUNG BALI,11358,2971,8387,5910,14297,2021-10-03
3175031001,JAKARTA TIMUR,JATINEGARA,KAMPUNG MELAYU,25717,7532,18185,13117,31302,2021-10-03
3171081002,JAKARTA PUSAT,JOHAR BARU,KAMPUNG RAWA,21237,4088,17149,12884,30033,2021-10-03
3175041002,JAKARTA TIMUR,KRAMAT JATI,KAMPUNG TENGAH,43993,13085,30908,22796,53704,2021-10-03
3173011005,JAKARTA BARAT,CENGKARENG,KAPUK,134466,38105,96361,71870,168231,2021-10-03
3172011003,JAKARTA UTARA,PENJARINGAN,KAPUK MUARA,35781,7943,27838,23442,51280,2021-10-03
3171021002,JAKARTA PUSAT,SAWAH BESAR,KARANG ANYAR,25761,5883,19878,15555,35433,2021-10-03
3174021004,JAKARTA SELATAN,SETIA BUDI,KARET,9623,2218,7405,5729,13134,2021-10-03
3174021003,JAKARTA SELATAN,SETIA BUDI,KARET KUNINGAN,16055,3706,12349,9873,22222,2021-10-03
3174021002,JAKARTA SELATAN,SETIA BUDI,KARET SEMANGGI,2770,624,2146,1818,3964,2021-10-03
3171071003,JAKARTA PUSAT,TANAH ABANG,KARET TENGSIN,19271,4543,14728,11095,25823,2021-10-03
3171021003,JAKARTA PUSAT,SAWAH BESAR,KARTINI,22292,5172,17120,13669,30789,2021-10-03
3175011003,JAKARTA TIMUR,MATRAMAN,KAYU MANIS,25284,6540,18744,13644,32388,2021-10-03
3175021006,JAKARTA TIMUR,PULO GADUNG,KAYU PUTIH,40696,9149,31547,25943,57490,2021-10-03
3173031006,JAKARTA BARAT,TAMAN SARI,KEAGUNGAN,17387,4154,13233,10147,23380,2021-10-03
3174041007,JAKARTA SELATAN,PASAR MINGGU,KEBAGUSAN,44552,11032,33520,25156,58676,2021-10-03
3174051006,JAKARTA SELATAN,KEBAYORAN LAMA,KEBAYORAN LAMA SELATAN,41212,9358,31854,24901,56755,2021-10-03
3174051001,JAKARTA SELATAN,KEBAYORAN LAMA,KEBAYORAN LAMA UTARA,42422,10876,31546,24216,55762,2021-10-03
3174011004,JAKARTA SELATAN,TEBET,KEBON BARU,35165,8412,26753,20621,47374,2021-10-03
3172021005,JAKARTA UTARA,TANJUNG PRIOK,KEBON BAWANG,50952,12439,38513,29815,68328,2021-10-03
3173051001,JAKARTA BARAT,KEBON JERUK,KEBON JERUK,53887,14304,39583,30263,69846,2021-10-03
3171071006,JAKARTA PUSAT,TANAH ABANG,KEBON KACANG,21531,6140,15391,11280,26671,2021-10-03
3171011005,JAKARTA PUSAT,GAMBIR,KEBON KELAPA,10163,2401,7762,6073,13835,2021-10-03
3171031002,JAKARTA PUSAT,KEMAYORAN,KEBON KOSONG,30019,7646,22373,17000,39373,2021-10-03
3175011005,JAKARTA TIMUR,MATRAMAN,KEBON MANGGIS,16490,3886,12604,9690,22294,2021-10-03
3171071005,JAKARTA PUSAT,TANAH ABANG,KEBON MELATI,32206,9870,22336,15156,37492,2021-10-03
3175081003,JAKARTA TIMUR,MAKASAR,KEBON PALA,46614,11232,35382,27555,62937,2021-10-03
3171061005,JAKARTA PUSAT,MENTENG,KEBON SIRIH,12299,3100,9199,6832,16031,2021-10-03
3173011004,JAKARTA BARAT,CENGKARENG,KEDAUNG KALI ANGKE,32612,7436,25176,19731,44907,2021-10-03
3173051007,JAKARTA BARAT,KEBON JERUK,KEDOYA SELATAN,32165,7355,24810,19441,44251,2021-10-03
3173051006,JAKARTA BARAT,KEBON JERUK,KEDOYA UTARA,45740,10349,35391,28673,64064,2021-10-03
3173051004,JAKARTA BARAT,KEBON JERUK,KELAPA DUA,23565,6158,17407,13728,31135,2021-10-03
3175091003,JAKARTA TIMUR,CIRACAS,KELAPA DUA WETAN,46875,9936,36939,29145,66084,2021-10-03
3172061003,JAKARTA UTARA,KELAPA GADING,KELAPA GADING BARAT,35717,7168,28549,24657,53206,2021-10-03
3172061001,JAKARTA UTARA,KELAPA GADING,KELAPA GADING TIMUR,33592,5974,27618,24353,51971,2021-10-03
3173071005,JAKARTA BARAT,PALMERAH,KEMANGGISAN,32139,7492,24647,19034,43681,2021-10-03
3171031001,JAKARTA PUSAT,KEMAYORAN,KEMAYORAN,20708,5069,15639,12163,27802,2021-10-03
3173081006,JAKARTA BARAT,KEMBANGAN,KEMBANGAN SELATAN,27130,6737,20393,16724,37117,2021-10-03
3173081001,JAKARTA BARAT,KEMBANGAN,KEMBANGAN UTARA,54451,14002,40449,31706,72155,2021-10-03
3171041002,JAKARTA PUSAT,SENEN,KENARI,9579,2219,7360,5891,13251,2021-10-03
3173041005,JAKARTA BARAT,TAMBORA,KERENDANG,19973,5018,14955,11232,26187,2021-10-03
3175071003,JAKARTA TIMUR,DUREN SAWIT,KLENDER,69978,19558,50420,37235,87655,2021-10-03
3172031001,JAKARTA UTARA,KOJA,KOJA,28175,7587,20588,15565,36153,2021-10-03
3173071006,JAKARTA BARAT,PALMERAH,KOTA BAMBU SELATAN,21158,5358,15800,11557,27357,2021-10-03
3173071003,JAKARTA BARAT,PALMERAH,KOTA BAMBU UTARA,24995,6502,18493,13410,31903,2021-10-03
3171041004,JAKARTA PUSAT,SENEN,KRAMAT,28835,7997,20838,14750,35588,2021-10-03
3175041001,JAKARTA TIMUR,KRAMAT JATI,KRAMAT JATI,34144,8979,25165,19135,44300,2021-10-03
3174071003,JAKARTA SELATAN,KEBAYORAN BARU,KRAMAT PELA,14413,3280,11133,8830,19963,2021-10-03
3173031002,JAKARTA BARAT,TAMAN SARI,KRUKUT,19244,4683,14561,11042,25603,2021-10-03
3174031005,JAKARTA SELATAN,MAMPANG PRAPATAN,KUNINGAN BARAT,12785,2865,9920,7619,17539,2021-10-03
3174021008,JAKARTA SELATAN,SETIA BUDI,KUNINGAN TIMUR,6008,1461,4547,3672,8219,2021-10-03
3171041005,JAKARTA PUSAT,SENEN,KWITANG,15486,4103,11383,8692,20075,2021-10-03
3172031003,JAKARTA UTARA,KOJA,LAGOA,59065,16541,42524,31351,73875,2021-10-03
3174061002,JAKARTA SELATAN,CILANDAK,LEBAK BULUS,37626,8815,28811,22944,51755,2021-10-03
3174091004,JAKARTA SELATAN,JAGAKARSA,LENTENG AGUNG,53946,12996,40950,30569,71519,2021-10-03
3175101007,JAKARTA TIMUR,CIPAYUNG,LUBANG BUAYA,63547,14500,49047,38193,87240,2021-10-03
3175081001,JAKARTA TIMUR,MAKASAR,MAKASAR,34390,8220,26170,20963,47133,2021-10-03
3175071006,JAKARTA TIMUR,DUREN SAWIT,MALAKA JAYA,30927,7062,23865,19070,42935,2021-10-03
3175071005,JAKARTA TIMUR,DUREN SAWIT,MALAKA SARI,27530,5884,21646,17471,39117,2021-10-03
3174031001,JAKARTA SELATAN,MAMPANG PRAPATAN,MAMPANG PRAPATAN,18159,4630,13529,10428,23957,2021-10-03
3173031005,JAKARTA BARAT,TAMAN SARI,MANGGA BESAR,7707,1523,6184,5067,11251,2021-10-03
3171021005,JAKARTA PUSAT,SAWAH BESAR,MANGGA DUA SELATAN,27442,6609,20833,16359,37192,2021-10-03
3174011007,JAKARTA SELATAN,TEBET,MANGGARAI,28373,6210,22163,16582,38745,2021-10-03
3174011006,JAKARTA SELATAN,TEBET,MANGGARAI SELATAN,23075,5085,17990,14087,32077,2021-10-03
3173031003,JAKARTA BARAT,TAMAN SARI,MAPHAR,16461,3859,12602,9917,22519,2021-10-03
3172041003,JAKARTA UTARA,CILINCING,MARUNDA,28943,7673,21270,15123,36393,2021-10-03
3174071001,JAKARTA SELATAN,KEBAYORAN BARU,MELAWAI,2627,583,2044,1813,3857,2021-10-03
3171061001,JAKARTA PUSAT,MENTENG,MENTENG,25624,6845,18779,13938,32717,2021-10-03
3174021005,JAKARTA SELATAN,SETIA BUDI,MENTENG ATAS,27816,6220,21596,16606,38202,2021-10-03
3174011003,JAKARTA SELATAN,TEBET,MENTENG DALAM,36028,8623,27405,21344,48749,2021-10-03
3173081003,JAKARTA BARAT,KEMBANGAN,MERUYA SELATAN,32130,8031,24099,18765,42864,2021-10-03
3173081002,JAKARTA BARAT,KEMBANGAN,MERUYA UTARA,43752,10985,32767,26646,59413,2021-10-03
3175101004,JAKARTA TIMUR,CIPAYUNG,MUNJUL,23871,5440,18431,14571,33002,2021-10-03
3172051002,JAKARTA UTARA,PADEMANGAN,PADEMANGAN BARAT,74240,20318,53922,40851,94773,2021-10-03
3172051001,JAKARTA UTARA,PADEMANGAN,PADEMANGAN TIMUR,37736,7902,29834,24486,54320,2021-10-03
3175011004,JAKARTA TIMUR,MATRAMAN,PAL MERIAM,19769,5236,14533,10994,25527,2021-10-03
3173071001,JAKARTA BARAT,PALMERAH,PALMERAH,63011,16382,46629,35309,81938,2021-10-03
3174081001,JAKARTA SELATAN,PANCORAN,PANCORAN,19421,5143,14278,11054,25332,2021-10-03
3172021003,JAKARTA UTARA,TANJUNG PRIOK,PAPANGGO,39097,9309,29788,23160,52948,2021-10-03
3171021001,JAKARTA PUSAT,SAWAH BESAR,PASAR BARU,12035,2654,9381,7954,17335,2021-10-03
3174021006,JAKARTA SELATAN,SETIA BUDI,PASAR MANGGIS,26752,6591,20161,15596,35757,2021-10-03
3174041001,JAKARTA SELATAN,PASAR MINGGU,PASAR MINGGU,24821,5742,19079,15111,34190,2021-10-03
3171041003,JAKARTA PUSAT,SENEN,PASEBAN,23533,6003,17530,13374,30904,2021-10-03
3173061005,JAKARTA BARAT,KALI DERES,PEGADUNGAN,75587,18019,57568,47002,104570,2021-10-03
3171061002,JAKARTA PUSAT,MENTENG,PEGANGSAAN,23455,6125,17330,12356,29686,2021-10-03
3172061002,JAKARTA UTARA,KELAPA GADING,PEGANGSAAN DUA,49976,9497,40479,35082,75561,2021-10-03
3172011004,JAKARTA UTARA,PENJARINGAN,PEJAGALAN,74578,18433,56145,45196,101341,2021-10-03
3174041006,JAKARTA SELATAN,PASAR MINGGU,PEJATEN BARAT,37346,9340,28006,22007,50013,2021-10-03
3174041005,JAKARTA SELATAN,PASAR MINGGU,PEJATEN TIMUR,57656,15731,41925,31904,73829,2021-10-03
3175051005,JAKARTA TIMUR,PASAR REBO,PEKAYON,43250,9580,33670,26095,59765,2021-10-03
3173041009,JAKARTA BARAT,TAMBORA,PEKOJAN,23587,5418,18169,14258,32427,2021-10-03
3174031003,JAKARTA SELATAN,MAMPANG PRAPATAN,PELA MAMPANG,43522,10725,32797,25745,58542,2021-10-03
3174081005,JAKARTA SELATAN,PANCORAN,PENGADEGAN,21478,4751,16727,12644,29371,2021-10-03
3175061003,JAKARTA TIMUR,CAKUNG,PENGGILINGAN,99255,27664,71591,52852,124443,2021-10-03
3172011001,JAKARTA UTARA,PENJARINGAN,PENJARINGAN,88308,26211,62097,45037,107134,2021-10-03
3174101001,JAKARTA SELATAN,PESANGGRAHAN,PESANGGRAHAN,27545,5825,21720,17474,39194,2021-10-03
3171071004,JAKARTA PUSAT,TANAH ABANG,PETAMBURAN,33271,10271,23000,15851,38851,2021-10-03
3174071008,JAKARTA SELATAN,KEBAYORAN BARU,PETOGOGAN,11499,2767,8732,6791,15523,2021-10-03
3171011004,JAKARTA PUSAT,GAMBIR,PETOJO SELATAN,14692,3876,10816,8626,19442,2021-10-03
3171011003,JAKARTA PUSAT,GAMBIR,PETOJO UTARA,17458,4411,13047,10041,23088,2021-10-03
3174101004,JAKARTA SELATAN,PESANGGRAHAN,PETUKANGAN SELATAN,37187,9317,27870,22205,50075,2021-10-03
3174101003,JAKARTA SELATAN,PESANGGRAHAN,PETUKANGAN UTARA,53716,13914,39802,30860,70662,2021-10-03
3175081002,JAKARTA TIMUR,MAKASAR,PINANG RANTI,27198,7014,20184,15727,35911,2021-10-03
3173031008,JAKARTA BARAT,TAMAN SARI,PINANGSIA,10729,2355,8374,6594,14968,2021-10-03
3175011001,JAKARTA TIMUR,MATRAMAN,PISANGAN BARU,31776,8147,23629,17221,40850,2021-10-03
3175021002,JAKARTA TIMUR,PULO GADUNG,PISANGAN TIMUR,41011,9565,31446,24954,56400,2021-10-03
3172011005,JAKARTA UTARA,PENJARINGAN,PLUIT,47783,10732,37051,31051,68102,2021-10-03
3175071002,JAKARTA TIMUR,DUREN SAWIT,PONDOK BAMBU,61550,16254,45296,34940,80236,2021-10-03
3175071004,JAKARTA TIMUR,DUREN SAWIT,PONDOK KELAPA,72015,17095,54920,44052,98972,2021-10-03
3175071007,JAKARTA TIMUR,DUREN SAWIT,PONDOK KOPI,35367,8868,26499,19420,45919,2021-10-03
3174061003,JAKARTA SELATAN,CILANDAK,PONDOK LABU,46464,9797,36667,29489,66156,2021-10-03
3174051002,JAKARTA SELATAN,KEBAYORAN LAMA,PONDOK PINANG,56169,12985,43184,33975,77159,2021-10-03
3175101003,JAKARTA TIMUR,CIPAYUNG,PONDOK RANGGON,25574,6280,19294,15201,34495,2021-10-03
3101011003,KAB.ADM.KEP.SERIBU,KEP. SERIBU UTARA,PULAU HARAPAN,2060,268,1792,1468,3260,2021-10-03
3101011002,KAB.ADM.KEP.SERIBU,KEP. SERIBU UTARA,PULAU KELAPA,5528,689,4839,3736,8575,2021-10-03
3101011001,KAB.ADM.KEP.SERIBU,KEP. SERIBU UTARA,PULAU PANGGANG,5450,582,4868,4060,8928,2021-10-03
3101021003,KAB.ADM.KEP.SERIBU,KEP. SERIBU SELATAN,PULAU PARI,2765,225,2540,2262,4802,2021-10-03
3101021002,KAB.ADM.KEP.SERIBU,KEP. SERIBU SELATAN,PULAU TIDUNG,4553,454,4099,3617,7716,2021-10-03
3101021001,KAB.ADM.KEP.SERIBU,KEP. SERIBU SELATAN,PULAU UNTUNG JAWA,1941,219,1722,1563,3285,2021-10-03
3174071007,JAKARTA SELATAN,KEBAYORAN BARU,PULO,5835,1190,4645,3971,8616,2021-10-03
3175021001,JAKARTA TIMUR,PULO GADUNG,PULO GADUNG,34422,8703,25719,19983,45702,2021-10-03
3175061005,JAKARTA TIMUR,CAKUNG,PULO GEBANG,97301,22875,74426,55797,130223,2021-10-03
3174041004,JAKARTA SELATAN,PASAR MINGGU,RAGUNAN,39616,9101,30515,24166,54681,2021-10-03
3175091005,JAKARTA TIMUR,CIRACAS,RAMBUTAN,36771,10274,26497,19759,46256,2021-10-03
3172031006,JAKARTA UTARA,KOJA,RAWA BADAK SELATAN,42179,11855,30324,22150,52474,2021-10-03
3172031004,JAKARTA UTARA,KOJA,RAWA BADAK UTARA,34408,9276,25132,18777,43909,2021-10-03
3174071005,JAKARTA SELATAN,KEBAYORAN BARU,RAWA BARAT,5625,1133,4492,3715,8207,2021-10-03
3173011003,JAKARTA BARAT,CENGKARENG,RAWA BUAYA,63799,15959,47840,35189,83029,2021-10-03
3175031004,JAKARTA TIMUR,JATINEGARA,RAWA BUNGA,21434,6076,15358,11527,26885,2021-10-03
3174081003,JAKARTA SELATAN,PANCORAN,RAWA JATI,20509,4802,15707,11712,27419,2021-10-03
3175061002,JAKARTA TIMUR,CAKUNG,RAWA TERATE,24637,5439,19198,14830,34028,2021-10-03
3175021005,JAKARTA TIMUR,PULO GADUNG,RAWAMANGUN,37612,9030,28582,22571,51153,2021-10-03
3171051003,JAKARTA PUSAT,CEMPAKA PUTIH,RAWASARI,21967,5438,16529,13061,29590,2021-10-03
3173041010,JAKARTA BARAT,TAMBORA,ROA MALAKA,3484,679,2805,2365,5170,2021-10-03
3172041006,JAKARTA UTARA,CILINCING,ROROTAN,41668,10038,31630,23865,55495,2021-10-03
3174071004,JAKARTA SELATAN,KEBAYORAN BARU,SELONG,2842,602,2240,1932,4172,2021-10-03
3173061002,JAKARTA BARAT,KALI DERES,SEMANAN,71354,18981,52373,39795,92168,2021-10-03
3172041007,JAKARTA UTARA,CILINCING,SEMPER BARAT,68587,16142,52445,41184,93629,2021-10-03
3172041005,JAKARTA UTARA,CILINCING,SEMPER TIMUR,36267,9138,27129,20542,47671,2021-10-03
3174071006,JAKARTA SELATAN,KEBAYORAN BARU,SENAYAN,2771,742,2029,1616,3645,2021-10-03
3171041001,JAKARTA PUSAT,SENEN,SENEN,6804,1701,5103,4087,9190,2021-10-03
3171031004,JAKARTA PUSAT,KEMAYORAN,SERDANG,29668,7184,22484,17497,39981,2021-10-03
3174021001,JAKARTA SELATAN,SETIA BUDI,SETIA BUDI,3023,737,2286,1817,4103,2021-10-03
3175101005,JAKARTA TIMUR,CIPAYUNG,SETU,20572,5192,15380,11681,27061,2021-10-03
3173071002,JAKARTA BARAT,PALMERAH,SLIPI,16591,3721,12870,10109,22979,2021-10-03
3173081004,JAKARTA BARAT,KEMBANGAN,SRENGSENG,45523,12090,33433,26374,59807,2021-10-03
3174091002,JAKARTA SELATAN,JAGAKARSA,SRENGSENG SAWAH,58196,11949,46247,36956,83203,2021-10-03
3173051003,JAKARTA BARAT,KEBON JERUK,SUKABUMI SELATAN,37033,10214,26819,19512,46331,2021-10-03
3173051002,JAKARTA BARAT,KEBON JERUK,SUKABUMI UTARA,38290,10870,27420,19928,47348,2021-10-03
3172041002,JAKARTA UTARA,CILINCING,SUKAPURA,53949,14418,39531,30716,70247,2021-10-03
3171031007,JAKARTA PUSAT,KEMAYORAN,SUMUR BATU,22717,5583,17134,13613,30747,2021-10-03
3172021004,JAKARTA UTARA,TANJUNG PRIOK,SUNGAI BAMBU,29876,7300,22576,17567,40143,2021-10-03
3172021006,JAKARTA UTARA,TANJUNG PRIOK,SUNTER AGUNG,71805,14740,57065,47402,104467,2021-10-03
3172021002,JAKARTA UTARA,TANJUNG PRIOK,SUNTER JAYA,63031,13830,49201,40433,89634,2021-10-03
3175091004,JAKARTA TIMUR,CIRACAS,SUSUKAN,38257,8733,29524,23182,52706,2021-10-03
3173031001,JAKARTA BARAT,TAMAN SARI,TAMAN SARI,14348,3198,11150,8994,20144,2021-10-03
3173041001,JAKARTA BARAT,TAMBORA,TAMBORA,10204,2675,7529,5722,13251,2021-10-03
3173041004,JAKARTA BARAT,TAMBORA,TANAH SEREAL,26387,5377,21010,16596,37606,2021-10-03
3171081004,JAKARTA PUSAT,JOHAR BARU,TANAH TINGGI,37693,8247,29446,22413,51859,2021-10-03
3173031004,JAKARTA BARAT,TAMAN SARI,TANGKI,13324,2755,10569,8212,18781,2021-10-03
3174091005,JAKARTA SELATAN,JAGAKARSA,TANJUNG BARAT,39770,9170,30600,23644,54244,2021-10-03
3173021005,JAKARTA BARAT,GROGOL PETAMBURAN,TANJUNG DUREN SELATAN,25337,5809,19528,16061,35589,2021-10-03
3173021002,JAKARTA BARAT,GROGOL PETAMBURAN,TANJUNG DUREN UTARA,17010,3538,13472,11296,24768,2021-10-03
3172021001,JAKARTA UTARA,TANJUNG PRIOK,TANJUNG PRIOK,34588,8399,26189,20224,46413,2021-10-03
3174011002,JAKARTA SELATAN,TEBET,TEBET BARAT,21194,4239,16955,13879,30834,2021-10-03
3174011001,JAKARTA SELATAN,TEBET,TEBET TIMUR,18199,3557,14642,12276,26918,2021-10-03
3173061003,JAKARTA BARAT,KALI DERES,TEGAL ALUR,83647,21207,62440,48370,110810,2021-10-03
3174031004,JAKARTA SELATAN,MAMPANG PRAPATAN,TEGAL PARANG,32401,8965,23436,16866,40302,2021-10-03
3173021003,JAKARTA BARAT,GROGOL PETAMBURAN,TOMANG,29605,6505,23100,18496,41596,2021-10-03
3172031005,JAKARTA UTARA,KOJA,TUGU SELATAN,39122,10279,28843,21225,50068,2021-10-03
3172031002,JAKARTA UTARA,KOJA,TUGU UTARA,67670,18828,48842,35859,84701,2021-10-03
3175061006,JAKARTA TIMUR,CAKUNG,UJUNG MENTENG,29934,6274,23660,18723,42383,2021-10-03
3174101005,JAKARTA SELATAN,PESANGGRAHAN,ULUJAMI,40544,11083,29461,22581,52042,2021-10-03
3175011006,JAKARTA TIMUR,MATRAMAN,UTAN KAYU SELATAN,33511,7599,25912,19821,45733,2021-10-03
3175011002,JAKARTA TIMUR,MATRAMAN,UTAN KAYU UTARA,28169,7159,21010,16045,37055,2021-10-03
3171031008,JAKARTA PUSAT,KEMAYORAN,UTAN PANJANG,29208,7584,21624,16319,37943,2021-10-03
3172021007,JAKARTA UTARA,TANJUNG PRIOK,WARAKAS,44401,9934,34467,26020,60487,2021-10-03
3173021007,JAKARTA BARAT,GROGOL PETAMBURAN,WIJAYA KUSUMA,38934,9994,28940,22783,51723,2021-10-03
3172051003,JAKARTA UTARA,PADEMANGAN,ANCOL,23947,6571,17376,13527,30903,2021-10-04
3173041007,JAKARTA BARAT,TAMBORA,ANGKE,29381,7470,21911,16630,38541,2021-10-04
3175041005,JAKARTA TIMUR,KRAMAT JATI,BALE KAMBANG,29074,8497,20577,14675,35252,2021-10-04
3175031003,JAKARTA TIMUR,JATINEGARA,BALI MESTER,9752,2444,7308,5745,13053,2021-10-04
3175101006,JAKARTA TIMUR,CIPAYUNG,BAMBU APUS,26285,5837,20448,15517,35965,2021-10-04
3174031002,JAKARTA SELATAN,MAMPANG PRAPATAN,BANGKA,21566,5662,15904,12276,28180,2021-10-04
3175051002,JAKARTA TIMUR,PASAR REBO,BARU,23886,4796,19090,15660,34750,2021-10-04
3175041004,JAKARTA TIMUR,KRAMAT JATI,BATU AMPAR,47898,13831,34067,25095,59162,2021-10-04
3171071002,JAKARTA PUSAT,TANAH ABANG,BENDUNGAN HILIR,21494,5128,16366,12929,29295,2021-10-04
3175031002,JAKARTA TIMUR,JATINEGARA,BIDARA CINA,36689,10418,26271,19424,45695,2021-10-04
3174101002,JAKARTA SELATAN,PESANGGRAHAN,BINTARO,53098,12660,40438,32463,72901,2021-10-04
3174011005,JAKARTA SELATAN,TEBET,BUKIT DURI,34183,8521,25662,19687,45349,2021-10-04
3171041006,JAKARTA PUSAT,SENEN,BUNGUR,18144,4565,13579,10684,24263,2021-10-04
3175061007,JAKARTA TIMUR,CAKUNG,CAKUNG BARAT,57724,13853,43871,34181,78052,2021-10-04
3175061004,JAKARTA TIMUR,CAKUNG,CAKUNG TIMUR,58287,13675,44612,34780,79392,2021-10-04
3175041007,JAKARTA TIMUR,KRAMAT JATI,CAWANG,32762,8605,24157,17898,42055,2021-10-04
3175101008,JAKARTA TIMUR,CIPAYUNG,CEGER,18932,4490,14442,11312,25754,2021-10-04
3171031006,JAKARTA PUSAT,KEMAYORAN,CEMPAKA BARU,32581,8192,24389,18075,42464,2021-10-04
3171051002,JAKARTA PUSAT,CEMPAKA PUTIH,CEMPAKA PUTIH BARAT,35885,9142,26743,21171,47914,2021-10-04
3171051001,JAKARTA PUSAT,CEMPAKA PUTIH,CEMPAKA PUTIH TIMUR,24292,5855,18437,14988,33425,2021-10-04
3173011001,JAKARTA BARAT,CENGKARENG,CENGKARENG BARAT,66284,16248,50036,39256,89292,2021-10-04
3173011006,JAKARTA BARAT,CENGKARENG,CENGKARENG TIMUR,81027,19222,61805,47075,108880,2021-10-04
3175091002,JAKARTA TIMUR,CIRACAS,CIBUBUR,66364,13920,52444,41378,93822,2021-10-04
3171011002,JAKARTA PUSAT,GAMBIR,CIDENG,15390,3482,11908,9796,21704,2021-10-04
3174091003,JAKARTA SELATAN,JAGAKARSA,CIGANJUR,38497,8480,30017,22635,52652,2021-10-04
3175051003,JAKARTA TIMUR,PASAR REBO,CIJANTUNG,41419,9151,32268,25179,57447,2021-10-04
3171061003,JAKARTA PUSAT,MENTENG,CIKINI,8274,1734,6540,4731,11271,2021-10-04
3174081006,JAKARTA SELATAN,PANCORAN,CIKOKO,10547,2233,8314,6632,14946,2021-10-04
3174061001,JAKARTA SELATAN,CILANDAK,CILANDAK BARAT,51752,11658,40094,32553,72647,2021-10-04
3174041003,JAKARTA SELATAN,PASAR MINGGU,CILANDAK TIMUR,25145,5699,19446,15545,34991,2021-10-04
3175101002,JAKARTA TIMUR,CIPAYUNG,CILANGKAP,27635,6249,21386,16681,38067,2021-10-04
3175041006,JAKARTA TIMUR,KRAMAT JATI,CILILITAN,40181,10818,29363,22018,51381,2021-10-04
3172041001,JAKARTA UTARA,CILINCING,CILINCING,43609,12171,31438,22838,54276,2021-10-04
3175101001,JAKARTA TIMUR,CIPAYUNG,CIPAYUNG,26104,5490,20614,16680,37294,2021-10-04
3174091006,JAKARTA SELATAN,JAGAKARSA,CIPEDAK,38303,8360,29943,23564,53507,2021-10-04
3174061005,JAKARTA SELATAN,CILANDAK,CIPETE SELATAN,26704,6141,20563,16525,37088,2021-10-04
3174071010,JAKARTA SELATAN,KEBAYORAN BARU,CIPETE UTARA,34102,7956,26146,19888,46034,2021-10-04
3175021003,JAKARTA TIMUR,PULO GADUNG,CIPINANG,39306,9196,30110,23197,53307,2021-10-04
3175031007,JAKARTA TIMUR,JATINEGARA,CIPINANG BESAR SELATAN,35212,9830,25382,18231,43613,2021-10-04
3175031008,JAKARTA TIMUR,JATINEGARA,CIPINANG BESAR UTARA,45319,12751,32568,23357,55925,2021-10-04
3175031005,JAKARTA TIMUR,JATINEGARA,CIPINANG CEMPEDAK,32824,8672,24152,18810,42962,2021-10-04
3175081005,JAKARTA TIMUR,MAKASAR,CIPINANG MELAYU,42308,10165,32143,25518,57661,2021-10-04
3175031006,JAKARTA TIMUR,JATINEGARA,CIPINANG MUARA,55243,14376,40867,30882,71749,2021-10-04
3174051003,JAKARTA SELATAN,KEBAYORAN LAMA,CIPULIR,39937,9963,29974,22119,52093,2021-10-04
3175091001,JAKARTA TIMUR,CIRACAS,CIRACAS,64594,14222,50372,38951,89323,2021-10-04
3175041003,JAKARTA TIMUR,KRAMAT JATI,DUKUH,24609,5572,19037,14614,33651,2021-10-04
3175071001,JAKARTA TIMUR,DUREN SAWIT,DUREN SAWIT,61160,16004,45156,34529,79685,2021-10-04
3174081004,JAKARTA SELATAN,PANCORAN,DUREN TIGA,28319,6825,21494,15597,37091,2021-10-04
3173051005,JAKARTA BARAT,KEBON JERUK,DURI KEPA,60138,13909,46229,37999,84228,2021-10-04
3173011002,JAKARTA BARAT,CENGKARENG,DURI KOSAMBI,77923,20756,57167,42437,99604,2021-10-04
3171011006,JAKARTA PUSAT,GAMBIR,DURI PULO,19610,4862,14748,11106,25854,2021-10-04
3173041011,JAKARTA BARAT,TAMBORA,DURI SELATAN,14259,3120,11139,8928,20067,2021-10-04
3173041003,JAKARTA BARAT,TAMBORA,DURI UTARA,19844,4616,15228,11691,26919,2021-10-04
3171081003,JAKARTA PUSAT,JOHAR BARU,GALUR,18243,4205,14038,10748,24786,2021-10-04
3171011001,JAKARTA PUSAT,GAMBIR,GAMBIR,2191,526,1665,1348,3013,2021-10-04
3174061004,JAKARTA SELATAN,CILANDAK,GANDARIA SELATAN,22119,5258,16861,13240,30101,2021-10-04
3174071009,JAKARTA SELATAN,KEBAYORAN BARU,GANDARIA UTARA,39922,9672,30250,23452,53702,2021-10-04
3175051001,JAKARTA TIMUR,PASAR REBO,GEDONG,35755,8464,27291,21504,48795,2021-10-04
3171071001,JAKARTA PUSAT,TANAH ABANG,GELORA,3127,730,2397,1888,4285,2021-10-04
3173031007,JAKARTA BARAT,TAMAN SARI,GLODOK,7837,1498,6339,5447,11786,2021-10-04
3171061004,JAKARTA PUSAT,MENTENG,GONDANGDIA,4100,1017,3083,2709,5792,2021-10-04
3173021001,JAKARTA BARAT,GROGOL PETAMBURAN,GROGOL,16876,3986,12890,10157,23047,2021-10-04
3174051005,JAKARTA SELATAN,KEBAYORAN LAMA,GROGOL SELATAN,44251,11077,33174,25389,58563,2021-10-04
3174051004,JAKARTA SELATAN,KEBAYORAN LAMA,GROGOL UTARA,42494,10541,31953,24781,56734,2021-10-04
3174021007,JAKARTA SELATAN,SETIA BUDI,GUNTUR,3985,913,3072,2603,5675,2021-10-04
3174071002,JAKARTA SELATAN,KEBAYORAN BARU,GUNUNG,9436,2103,7333,6039,13372,2021-10-04
3171031005,JAKARTA PUSAT,KEMAYORAN,GUNUNG SAHARI SELATAN,19199,4695,14504,11414,25918,2021-10-04
3171021004,JAKARTA PUSAT,SAWAH BESAR,GUNUNG SAHARI UTARA,16650,3455,13195,11117,24312,2021-10-04
3175081004,JAKARTA TIMUR,MAKASAR,HALIM PERDANA KUSUMAH,28363,4516,23847,20978,44825,2021-10-04
3171031003,JAKARTA PUSAT,KEMAYORAN,HARAPAN MULIA,22557,5563,16994,12919,29913,2021-10-04
3174091001,JAKARTA SELATAN,JAGAKARSA,JAGAKARSA,62389,14050,48339,37960,86299,2021-10-04
3175021007,JAKARTA TIMUR,PULO GADUNG,JATI,32757,7538,25219,20459,45678,2021-10-04
3174041002,JAKARTA SELATAN,PASAR MINGGU,JATI PADANG,37502,9285,28217,22206,50423,2021-10-04
3173071004,JAKARTA BARAT,PALMERAH,JATI PULO,28738,6787,21951,16438,38389,2021-10-04
3175061001,JAKARTA TIMUR,CAKUNG,JATINEGARA,84160,21488,62672,48219,110891,2021-10-04
3175021004,JAKARTA TIMUR,PULO GADUNG,JATINEGARA KAUM,24632,5632,19000,14331,33331,2021-10-04
3173021004,JAKARTA BARAT,GROGOL PETAMBURAN,JELAMBAR,30266,6806,23460,18952,42412,2021-10-04
3173021006,JAKARTA BARAT,GROGOL PETAMBURAN,JELAMBAR BARU,38246,8737,29509,23746,53255,2021-10-04
3173041006,JAKARTA BARAT,TAMBORA,JEMBATAN BESI,29314,8610,20704,14740,35444,2021-10-04
3173041008,JAKARTA BARAT,TAMBORA,JEMBATAN LIMA,21021,5867,15154,11137,26291,2021-10-04
3173081005,JAKARTA BARAT,KEMBANGAN,JOGLO,40839,9838,31001,24456,55457,2021-10-04
3171081001,JAKARTA PUSAT,JOHAR BARU,JOHAR BARU,37488,8217,29271,23136,52407,2021-10-04
3173041002,JAKARTA BARAT,TAMBORA,KALI ANYAR,23856,5836,18020,13293,31313,2021-10-04
3172041004,JAKARTA UTARA,CILINCING,KALIBARU,67684,21964,45720,30959,76679,2021-10-04
3174081002,JAKARTA SELATAN,PANCORAN,KALIBATA,41994,11697,30297,21627,51924,2021-10-04
3173061001,JAKARTA BARAT,KALI DERES,KALIDERES,72447,17902,54545,43495,98040,2021-10-04
3175051004,JAKARTA TIMUR,PASAR REBO,KALISARI,43212,9489,33723,26557,60280,2021-10-04
3173061004,JAKARTA BARAT,KALI DERES,KAMAL,53783,15173,38610,28906,67516,2021-10-04
3172011002,JAKARTA UTARA,PENJARINGAN,KAMAL MUARA,12930,2503,10427,8616,19043,2021-10-04
3171071007,JAKARTA PUSAT,TANAH ABANG,KAMPUNG BALI,11358,2953,8405,5935,14340,2021-10-04
3175031001,JAKARTA TIMUR,JATINEGARA,KAMPUNG MELAYU,25717,7495,18222,13169,31391,2021-10-04
3171081002,JAKARTA PUSAT,JOHAR BARU,KAMPUNG RAWA,21237,4064,17173,12918,30091,2021-10-04
3175041002,JAKARTA TIMUR,KRAMAT JATI,KAMPUNG TENGAH,43993,13018,30975,22860,53835,2021-10-04
3173011005,JAKARTA BARAT,CENGKARENG,KAPUK,134466,37886,96580,72111,168691,2021-10-04
3172011003,JAKARTA UTARA,PENJARINGAN,KAPUK MUARA,35781,7905,27876,23476,51352,2021-10-04
3171021002,JAKARTA PUSAT,SAWAH BESAR,KARANG ANYAR,25761,5852,19909,15615,35524,2021-10-04
3174021004,JAKARTA SELATAN,SETIA BUDI,KARET,9623,2197,7426,5752,13178,2021-10-04
3174021003,JAKARTA SELATAN,SETIA BUDI,KARET KUNINGAN,16055,3687,12368,9903,22271,2021-10-04
3174021002,JAKARTA SELATAN,SETIA BUDI,KARET SEMANGGI,2770,620,2150,1822,3972,2021-10-04
3171071003,JAKARTA PUSAT,TANAH ABANG,KARET TENGSIN,19271,4522,14749,11125,25874,2021-10-04
3171021003,JAKARTA PUSAT,SAWAH BESAR,KARTINI,22292,5152,17140,13719,30859,2021-10-04
3175011003,JAKARTA TIMUR,MATRAMAN,KAYU MANIS,25284,6456,18828,13714,32542,2021-10-04
3175021006,JAKARTA TIMUR,PULO GADUNG,KAYU PUTIH,40696,9103,31593,26024,57617,2021-10-04
3173031006,JAKARTA BARAT,TAMAN SARI,KEAGUNGAN,17387,4133,13254,10178,23432,2021-10-04
3174041007,JAKARTA SELATAN,PASAR MINGGU,KEBAGUSAN,44552,10890,33662,25229,58891,2021-10-04
3174051006,JAKARTA SELATAN,KEBAYORAN LAMA,KEBAYORAN LAMA SELATAN,41212,9262,31950,24982,56932,2021-10-04
3174051001,JAKARTA SELATAN,KEBAYORAN LAMA,KEBAYORAN LAMA UTARA,42422,10791,31631,24280,55911,2021-10-04
3174011004,JAKARTA SELATAN,TEBET,KEBON BARU,35165,8356,26809,20693,47502,2021-10-04
3172021005,JAKARTA UTARA,TANJUNG PRIOK,KEBON BAWANG,50952,12359,38593,29939,68532,2021-10-04
3173051001,JAKARTA BARAT,KEBON JERUK,KEBON JERUK,53887,14230,39657,30378,70035,2021-10-04
3171071006,JAKARTA PUSAT,TANAH ABANG,KEBON KACANG,21531,6107,15424,11341,26765,2021-10-04
3171011005,JAKARTA PUSAT,GAMBIR,KEBON KELAPA,10163,2375,7788,6092,13880,2021-10-04
3171031002,JAKARTA PUSAT,KEMAYORAN,KEBON KOSONG,30019,7603,22416,17054,39470,2021-10-04
3175011005,JAKARTA TIMUR,MATRAMAN,KEBON MANGGIS,16490,3852,12638,9725,22363,2021-10-04
3171071005,JAKARTA PUSAT,TANAH ABANG,KEBON MELATI,32206,9814,22392,15239,37631,2021-10-04
3175081003,JAKARTA TIMUR,MAKASAR,KEBON PALA,46614,11084,35530,27672,63202,2021-10-04
3171061005,JAKARTA PUSAT,MENTENG,KEBON SIRIH,12299,3081,9218,6869,16087,2021-10-04
3173011004,JAKARTA BARAT,CENGKARENG,KEDAUNG KALI ANGKE,32612,7399,25213,19785,44998,2021-10-04
3173051007,JAKARTA BARAT,KEBON JERUK,KEDOYA SELATAN,32165,7310,24855,19498,44353,2021-10-04
3173051006,JAKARTA BARAT,KEBON JERUK,KEDOYA UTARA,45740,10300,35440,28747,64187,2021-10-04
3173051004,JAKARTA BARAT,KEBON JERUK,KELAPA DUA,23565,6116,17449,13762,31211,2021-10-04
3175091003,JAKARTA TIMUR,CIRACAS,KELAPA DUA WETAN,46875,9877,36998,29227,66225,2021-10-04
3172061003,JAKARTA UTARA,KELAPA GADING,KELAPA GADING BARAT,35717,7133,28584,24696,53280,2021-10-04
3172061001,JAKARTA UTARA,KELAPA GADING,KELAPA GADING TIMUR,33592,5954,27638,24401,52039,2021-10-04
3173071005,JAKARTA BARAT,PALMERAH,KEMANGGISAN,32139,7443,24696,19103,43799,2021-10-04
3171031001,JAKARTA PUSAT,KEMAYORAN,KEMAYORAN,20708,5040,15668,12212,27880,2021-10-04
3173081006,JAKARTA BARAT,KEMBANGAN,KEMBANGAN SELATAN,27130,6696,20434,16769,37203,2021-10-04
3173081001,JAKARTA BARAT,KEMBANGAN,KEMBANGAN UTARA,54451,13920,40531,31774,72305,2021-10-04
3171041002,JAKARTA PUSAT,SENEN,KENARI,9579,2199,7380,5912,13292,2021-10-04
3173041005,JAKARTA BARAT,TAMBORA,KERENDANG,19973,4989,14984,11259,26243,2021-10-04
3175071003,JAKARTA TIMUR,DUREN SAWIT,KLENDER,69978,19305,50673,37441,88114,2021-10-04
3172031001,JAKARTA UTARA,KOJA,KOJA,28175,7539,20636,15628,36264,2021-10-04
3173071006,JAKARTA BARAT,PALMERAH,KOTA BAMBU SELATAN,21158,5333,15825,11594,27419,2021-10-04
3173071003,JAKARTA BARAT,PALMERAH,KOTA BAMBU UTARA,24995,6458,18537,13455,31992,2021-10-04
3171041004,JAKARTA PUSAT,SENEN,KRAMAT,28835,7958,20877,14802,35679,2021-10-04
3175041001,JAKARTA TIMUR,KRAMAT JATI,KRAMAT JATI,34144,8934,25210,19196,44406,2021-10-04
3174071003,JAKARTA SELATAN,KEBAYORAN BARU,KRAMAT PELA,14413,3253,11160,8851,20011,2021-10-04
3173031002,JAKARTA BARAT,TAMAN SARI,KRUKUT,19244,4649,14595,11071,25666,2021-10-04
3174031005,JAKARTA SELATAN,MAMPANG PRAPATAN,KUNINGAN BARAT,12785,2847,9938,7648,17586,2021-10-04
3174021008,JAKARTA SELATAN,SETIA BUDI,KUNINGAN TIMUR,6008,1454,4554,3679,8233,2021-10-04
3171041005,JAKARTA PUSAT,SENEN,KWITANG,15486,4081,11405,8729,20134,2021-10-04
3172031003,JAKARTA UTARA,KOJA,LAGOA,59065,16470,42595,31475,74070,2021-10-04
3174061002,JAKARTA SELATAN,CILANDAK,LEBAK BULUS,37626,8748,28878,23025,51903,2021-10-04
3174091004,JAKARTA SELATAN,JAGAKARSA,LENTENG AGUNG,53946,12732,41214,30698,71912,2021-10-04
3175101007,JAKARTA TIMUR,CIPAYUNG,LUBANG BUAYA,63547,14406,49141,38317,87458,2021-10-04
3175081001,JAKARTA TIMUR,MAKASAR,MAKASAR,34390,8164,26226,21027,47253,2021-10-04
3175071006,JAKARTA TIMUR,DUREN SAWIT,MALAKA JAYA,30927,7020,23907,19171,43078,2021-10-04
3175071005,JAKARTA TIMUR,DUREN SAWIT,MALAKA SARI,27530,5820,21710,17545,39255,2021-10-04
3174031001,JAKARTA SELATAN,MAMPANG PRAPATAN,MAMPANG PRAPATAN,18159,4605,13554,10478,24032,2021-10-04
3173031005,JAKARTA BARAT,TAMAN SARI,MANGGA BESAR,7707,1518,6189,5073,11262,2021-10-04
3171021005,JAKARTA PUSAT,SAWAH BESAR,MANGGA DUA SELATAN,27442,6570,20872,16405,37277,2021-10-04
3174011007,JAKARTA SELATAN,TEBET,MANGGARAI,28373,6160,22213,16653,38866,2021-10-04
3174011006,JAKARTA SELATAN,TEBET,MANGGARAI SELATAN,23075,5037,18038,14146,32184,2021-10-04
3173031003,JAKARTA BARAT,TAMAN SARI,MAPHAR,16461,3830,12631,9948,22579,2021-10-04
3172041003,JAKARTA UTARA,CILINCING,MARUNDA,28943,7642,21301,15149,36450,2021-10-04
3174071001,JAKARTA SELATAN,KEBAYORAN BARU,MELAWAI,2627,581,2046,1814,3860,2021-10-04
3171061001,JAKARTA PUSAT,MENTENG,MENTENG,25624,6726,18898,13990,32888,2021-10-04
3174021005,JAKARTA SELATAN,SETIA BUDI,MENTENG ATAS,27816,6185,21631,16686,38317,2021-10-04
3174011003,JAKARTA SELATAN,TEBET,MENTENG DALAM,36028,8580,27448,21421,48869,2021-10-04
3173081003,JAKARTA BARAT,KEMBANGAN,MERUYA SELATAN,32130,7983,24147,18808,42955,2021-10-04
3173081002,JAKARTA BARAT,KEMBANGAN,MERUYA UTARA,43752,10922,32830,26720,59550,2021-10-04
3175101004,JAKARTA TIMUR,CIPAYUNG,MUNJUL,23871,5409,18462,14625,33087,2021-10-04
3172051002,JAKARTA UTARA,PADEMANGAN,PADEMANGAN BARAT,74240,20188,54052,41009,95061,2021-10-04
3172051001,JAKARTA UTARA,PADEMANGAN,PADEMANGAN TIMUR,37736,7853,29883,24536,54419,2021-10-04
3175011004,JAKARTA TIMUR,MATRAMAN,PAL MERIAM,19769,5190,14579,11050,25629,2021-10-04
3173071001,JAKARTA BARAT,PALMERAH,PALMERAH,63011,16294,46717,35435,82152,2021-10-04
3174081001,JAKARTA SELATAN,PANCORAN,PANCORAN,19421,5120,14301,11093,25394,2021-10-04
3172021003,JAKARTA UTARA,TANJUNG PRIOK,PAPANGGO,39097,9247,29850,23241,53091,2021-10-04
3171021001,JAKARTA PUSAT,SAWAH BESAR,PASAR BARU,12035,2646,9389,7971,17360,2021-10-04
3174021006,JAKARTA SELATAN,SETIA BUDI,PASAR MANGGIS,26752,6556,20196,15653,35849,2021-10-04
3174041001,JAKARTA SELATAN,PASAR MINGGU,PASAR MINGGU,24821,5695,19126,15164,34290,2021-10-04
3171041003,JAKARTA PUSAT,SENEN,PASEBAN,23533,5967,17566,13429,30995,2021-10-04
3173061005,JAKARTA BARAT,KALI DERES,PEGADUNGAN,75587,17956,57631,47074,104705,2021-10-04
3171061002,JAKARTA PUSAT,MENTENG,PEGANGSAAN,23455,6081,17374,12396,29770,2021-10-04
3172061002,JAKARTA UTARA,KELAPA GADING,PEGANGSAAN DUA,49976,9431,40545,35136,75681,2021-10-04
3172011004,JAKARTA UTARA,PENJARINGAN,PEJAGALAN,74578,18318,56260,45314,101574,2021-10-04
3174041006,JAKARTA SELATAN,PASAR MINGGU,PEJATEN BARAT,37346,9287,28059,22068,50127,2021-10-04
3174041005,JAKARTA SELATAN,PASAR MINGGU,PEJATEN TIMUR,57656,15578,42078,32076,74154,2021-10-04
3175051005,JAKARTA TIMUR,PASAR REBO,PEKAYON,43250,9505,33745,26194,59939,2021-10-04
3173041009,JAKARTA BARAT,TAMBORA,PEKOJAN,23587,5388,18199,14279,32478,2021-10-04
3174031003,JAKARTA SELATAN,MAMPANG PRAPATAN,PELA MAMPANG,43522,10569,32953,25806,58759,2021-10-04
3174081005,JAKARTA SELATAN,PANCORAN,PENGADEGAN,21478,4716,16762,12681,29443,2021-10-04
3175061003,JAKARTA TIMUR,CAKUNG,PENGGILINGAN,99255,27508,71747,53046,124793,2021-10-04
3172011001,JAKARTA UTARA,PENJARINGAN,PENJARINGAN,88308,26042,62266,45159,107425,2021-10-04
3174101001,JAKARTA SELATAN,PESANGGRAHAN,PESANGGRAHAN,27545,5758,21787,17518,39305,2021-10-04
3171071004,JAKARTA PUSAT,TANAH ABANG,PETAMBURAN,33271,10201,23070,15926,38996,2021-10-04
3174071008,JAKARTA SELATAN,KEBAYORAN BARU,PETOGOGAN,11499,2747,8752,6824,15576,2021-10-04
3171011004,JAKARTA PUSAT,GAMBIR,PETOJO SELATAN,14692,3850,10842,8648,19490,2021-10-04
3171011003,JAKARTA PUSAT,GAMBIR,PETOJO UTARA,17458,4387,13071,10072,23143,2021-10-04
3174101004,JAKARTA SELATAN,PESANGGRAHAN,PETUKANGAN SELATAN,37187,9250,27937,22263,50200,2021-10-04
3174101003,JAKARTA SELATAN,PESANGGRAHAN,PETUKANGAN UTARA,53716,13842,39874,30967,70841,2021-10-04
3175081002,JAKARTA TIMUR,MAKASAR,PINANG RANTI,27198,6977,20221,15769,35990,2021-10-04
3173031008,JAKARTA BARAT,TAMAN SARI,PINANGSIA,10729,2350,8379,6606,14985,2021-10-04
3175011001,JAKARTA TIMUR,MATRAMAN,PISANGAN BARU,31776,8071,23705,17315,41020,2021-10-04
3175021002,JAKARTA TIMUR,PULO GADUNG,PISANGAN TIMUR,41011,9509,31502,25047,56549,2021-10-04
3172011005,JAKARTA UTARA,PENJARINGAN,PLUIT,47783,10708,37075,31094,68169,2021-10-04
3175071002,JAKARTA TIMUR,DUREN SAWIT,PONDOK BAMBU,61550,16154,45396,35064,80460,2021-10-04
3175071004,JAKARTA TIMUR,DUREN SAWIT,PONDOK KELAPA,72015,16964,55051,44274,99325,2021-10-04
3175071007,JAKARTA TIMUR,DUREN SAWIT,PONDOK KOPI,35367,8812,26555,19535,46090,2021-10-04
3174061003,JAKARTA SELATAN,CILANDAK,PONDOK LABU,46464,9712,36752,29590,66342,2021-10-04
3174051002,JAKARTA SELATAN,KEBAYORAN LAMA,PONDOK PINANG,56169,12715,43454,34083,77537,2021-10-04
3175101003,JAKARTA TIMUR,CIPAYUNG,PONDOK RANGGON,25574,6245,19329,15283,34612,2021-10-04
3101011003,KAB.ADM.KEP.SERIBU,KEP. SERIBU UTARA,PULAU HARAPAN,2060,267,1793,1470,3263,2021-10-04
3101011002,KAB.ADM.KEP.SERIBU,KEP. SERIBU UTARA,PULAU KELAPA,5528,688,4840,3738,8578,2021-10-04
3101011001,KAB.ADM.KEP.SERIBU,KEP. SERIBU UTARA,PULAU PANGGANG,5450,579,4871,4069,8940,2021-10-04
3101021003,KAB.ADM.KEP.SERIBU,KEP. SERIBU SELATAN,PULAU PARI,2765,225,2540,2263,4803,2021-10-04
3101021002,KAB.ADM.KEP.SERIBU,KEP. SERIBU SELATAN,PULAU TIDUNG,4553,453,4100,3617,7717,2021-10-04
3101021001,KAB.ADM.KEP.SERIBU,KEP. SERIBU SELATAN,PULAU UNTUNG JAWA,1941,217,1724,1565,3289,2021-10-04
3174071007,JAKARTA SELATAN,KEBAYORAN BARU,PULO,5835,1181,4654,3975,8629,2021-10-04
3175021001,JAKARTA TIMUR,PULO GADUNG,PULO GADUNG,34422,8666,25756,20063,45819,2021-10-04
3175061005,JAKARTA TIMUR,CAKUNG,PULO GEBANG,97301,22635,74666,56149,130815,2021-10-04
3174041004,JAKARTA SELATAN,PASAR MINGGU,RAGUNAN,39616,9026,30590,24232,54822,2021-10-04
3175091005,JAKARTA TIMUR,CIRACAS,RAMBUTAN,36771,10209,26562,19829,46391,2021-10-04
3172031006,JAKARTA UTARA,KOJA,RAWA BADAK SELATAN,42179,11777,30402,22210,52612,2021-10-04
3172031004,JAKARTA UTARA,KOJA,RAWA BADAK UTARA,34408,9229,25179,18833,44012,2021-10-04
3174071005,JAKARTA SELATAN,KEBAYORAN BARU,RAWA BARAT,5625,1129,4496,3723,8219,2021-10-04
3173011003,JAKARTA BARAT,CENGKARENG,RAWA BUAYA,63799,15884,47915,35297,83212,2021-10-04
3175031004,JAKARTA TIMUR,JATINEGARA,RAWA BUNGA,21434,6053,15381,11564,26945,2021-10-04
3174081003,JAKARTA SELATAN,PANCORAN,RAWA JATI,20509,4770,15739,11753,27492,2021-10-04
3175061002,JAKARTA TIMUR,CAKUNG,RAWA TERATE,24637,5388,19249,14890,34139,2021-10-04
3175021005,JAKARTA TIMUR,PULO GADUNG,RAWAMANGUN,37612,8973,28639,22657,51296,2021-10-04
3171051003,JAKARTA PUSAT,CEMPAKA PUTIH,RAWASARI,21967,5412,16555,13107,29662,2021-10-04
3173041010,JAKARTA BARAT,TAMBORA,ROA MALAKA,3484,677,2807,2367,5174,2021-10-04
3172041006,JAKARTA UTARA,CILINCING,ROROTAN,41668,9993,31675,23932,55607,2021-10-04
3174071004,JAKARTA SELATAN,KEBAYORAN BARU,SELONG,2842,602,2240,1933,4173,2021-10-04
3173061002,JAKARTA BARAT,KALI DERES,SEMANAN,71354,18869,52485,39922,92407,2021-10-04
3172041007,JAKARTA UTARA,CILINCING,SEMPER BARAT,68587,16043,52544,41291,93835,2021-10-04
3172041005,JAKARTA UTARA,CILINCING,SEMPER TIMUR,36267,9090,27177,20612,47789,2021-10-04
3174071006,JAKARTA SELATAN,KEBAYORAN BARU,SENAYAN,2771,739,2032,1624,3656,2021-10-04
3171041001,JAKARTA PUSAT,SENEN,SENEN,6804,1700,5104,4100,9204,2021-10-04
3171031004,JAKARTA PUSAT,KEMAYORAN,SERDANG,29668,7152,22516,17554,40070,2021-10-04
3174021001,JAKARTA SELATAN,SETIA BUDI,SETIA BUDI,3023,736,2287,1823,4110,2021-10-04
3175101005,JAKARTA TIMUR,CIPAYUNG,SETU,20572,5159,15413,11726,27139,2021-10-04
3173071002,JAKARTA BARAT,PALMERAH,SLIPI,16591,3701,12890,10139,23029,2021-10-04
3173081004,JAKARTA BARAT,KEMBANGAN,SRENGSENG,45523,12025,33498,26429,59927,2021-10-04
3174091002,JAKARTA SELATAN,JAGAKARSA,SRENGSENG SAWAH,58196,11869,46327,37076,83403,2021-10-04
3173051003,JAKARTA BARAT,KEBON JERUK,SUKABUMI SELATAN,37033,10165,26868,19576,46444,2021-10-04
3173051002,JAKARTA BARAT,KEBON JERUK,SUKABUMI UTARA,38290,10803,27487,20003,47490,2021-10-04
3172041002,JAKARTA UTARA,CILINCING,SUKAPURA,53949,14325,39624,30820,70444,2021-10-04
3171031007,JAKARTA PUSAT,KEMAYORAN,SUMUR BATU,22717,5546,17171,13666,30837,2021-10-04
3172021004,JAKARTA UTARA,TANJUNG PRIOK,SUNGAI BAMBU,29876,7250,22626,17633,40259,2021-10-04
3172021006,JAKARTA UTARA,TANJUNG PRIOK,SUNTER AGUNG,71805,14580,57225,47502,104727,2021-10-04
3172021002,JAKARTA UTARA,TANJUNG PRIOK,SUNTER JAYA,63031,13753,49278,40542,89820,2021-10-04
3175091004,JAKARTA TIMUR,CIRACAS,SUSUKAN,38257,8669,29588,23243,52831,2021-10-04
3173031001,JAKARTA BARAT,TAMAN SARI,TAMAN SARI,14348,3179,11169,9026,20195,2021-10-04
3173041001,JAKARTA BARAT,TAMBORA,TAMBORA,10204,2666,7538,5748,13286,2021-10-04
3173041004,JAKARTA BARAT,TAMBORA,TANAH SEREAL,26387,5346,21041,16624,37665,2021-10-04
3171081004,JAKARTA PUSAT,JOHAR BARU,TANAH TINGGI,37693,8202,29491,22485,51976,2021-10-04
3173031004,JAKARTA BARAT,TAMAN SARI,TANGKI,13324,2729,10595,8255,18850,2021-10-04
3174091005,JAKARTA SELATAN,JAGAKARSA,TANJUNG BARAT,39770,9099,30671,23727,54398,2021-10-04
3173021005,JAKARTA BARAT,GROGOL PETAMBURAN,TANJUNG DUREN SELATAN,25337,5769,19568,16104,35672,2021-10-04
3173021002,JAKARTA BARAT,GROGOL PETAMBURAN,TANJUNG DUREN UTARA,17010,3518,13492,11325,24817,2021-10-04
3172021001,JAKARTA UTARA,TANJUNG PRIOK,TANJUNG PRIOK,34588,8258,26330,20358,46688,2021-10-04
3174011002,JAKARTA SELATAN,TEBET,TEBET BARAT,21194,4214,16980,13921,30901,2021-10-04
3174011001,JAKARTA SELATAN,TEBET,TEBET TIMUR,18199,3534,14665,12320,26985,2021-10-04
3173061003,JAKARTA BARAT,KALI DERES,TEGAL ALUR,83647,21076,62571,48496,111067,2021-10-04
3174031004,JAKARTA SELATAN,MAMPANG PRAPATAN,TEGAL PARANG,32401,8841,23560,16930,40490,2021-10-04
3173021003,JAKARTA BARAT,GROGOL PETAMBURAN,TOMANG,29605,6456,23149,18556,41705,2021-10-04
3172031005,JAKARTA UTARA,KOJA,TUGU SELATAN,39122,10223,28899,21287,50186,2021-10-04
3172031002,JAKARTA UTARA,KOJA,TUGU UTARA,67670,18739,48931,35984,84915,2021-10-04
3175061006,JAKARTA TIMUR,CAKUNG,UJUNG MENTENG,29934,6227,23707,18792,42499,2021-10-04
3174101005,JAKARTA SELATAN,PESANGGRAHAN,ULUJAMI,40544,11012,29532,22626,52158,2021-10-04
3175011006,JAKARTA TIMUR,MATRAMAN,UTAN KAYU SELATAN,33511,7535,25976,19894,45870,2021-10-04
3175011002,JAKARTA TIMUR,MATRAMAN,UTAN KAYU UTARA,28169,7104,21065,16111,37176,2021-10-04
3171031008,JAKARTA PUSAT,KEMAYORAN,UTAN PANJANG,29208,7452,21756,16385,38141,2021-10-04
3172021007,JAKARTA UTARA,TANJUNG PRIOK,WARAKAS,44401,9861,34540,26115,60655,2021-10-04
3173021007,JAKARTA BARAT,GROGOL PETAMBURAN,WIJAYA KUSUMA,38934,9930,29004,22842,51846,2021-10-04
3172051003,JAKARTA UTARA,PADEMANGAN,ANCOL,23947,6533,17414,13558,30972,2021-10-05
3173041007,JAKARTA BARAT,TAMBORA,ANGKE,29381,7415,21966,16694,38660,2021-10-05
3175041005,JAKARTA TIMUR,KRAMAT JATI,BALE KAMBANG,29074,8419,20655,14771,35426,2021-10-05
3175031003,JAKARTA TIMUR,JATINEGARA,BALI MESTER,9752,2427,7325,5773,13098,2021-10-05
3175101006,JAKARTA TIMUR,CIPAYUNG,BAMBU APUS,26285,5800,20485,15575,36060,2021-10-05
3174031002,JAKARTA SELATAN,MAMPANG PRAPATAN,BANGKA,21566,5631,15935,12316,28251,2021-10-05
3175051002,JAKARTA TIMUR,PASAR REBO,BARU,23886,4759,19127,15692,34819,2021-10-05
3175041004,JAKARTA TIMUR,KRAMAT JATI,BATU AMPAR,47898,13712,34186,25237,59423,2021-10-05
3171071002,JAKARTA PUSAT,TANAH ABANG,BENDUNGAN HILIR,21494,5101,16393,12983,29376,2021-10-05
3175031002,JAKARTA TIMUR,JATINEGARA,BIDARA CINA,36689,10343,26346,19501,45847,2021-10-05
3174101002,JAKARTA SELATAN,PESANGGRAHAN,BINTARO,53098,12577,40521,32583,73104,2021-10-05
3174011005,JAKARTA SELATAN,TEBET,BUKIT DURI,34183,8449,25734,19770,45504,2021-10-05
3171041006,JAKARTA PUSAT,SENEN,BUNGUR,18144,4542,13602,10716,24318,2021-10-05
3175061007,JAKARTA TIMUR,CAKUNG,CAKUNG BARAT,57724,13767,43957,34319,78276,2021-10-05
3175061004,JAKARTA TIMUR,CAKUNG,CAKUNG TIMUR,58287,13562,44725,34900,79625,2021-10-05
3175041007,JAKARTA TIMUR,KRAMAT JATI,CAWANG,32762,8542,24220,17983,42203,2021-10-05
3175101008,JAKARTA TIMUR,CIPAYUNG,CEGER,18932,4371,14561,11402,25963,2021-10-05
3171031006,JAKARTA PUSAT,KEMAYORAN,CEMPAKA BARU,32581,8128,24453,18137,42590,2021-10-05
3171051002,JAKARTA PUSAT,CEMPAKA PUTIH,CEMPAKA PUTIH BARAT,35885,9079,26806,21266,48072,2021-10-05
3171051001,JAKARTA PUSAT,CEMPAKA PUTIH,CEMPAKA PUTIH TIMUR,24292,5809,18483,15067,33550,2021-10-05
3173011001,JAKARTA BARAT,CENGKARENG,CENGKARENG BARAT,66284,16116,50168,39441,89609,2021-10-05
3173011006,JAKARTA BARAT,CENGKARENG,CENGKARENG TIMUR,81027,19072,61955,47230,109185,2021-10-05
3175091002,JAKARTA TIMUR,CIRACAS,CIBUBUR,66364,13799,52565,41477,94042,2021-10-05
3171011002,JAKARTA PUSAT,GAMBIR,CIDENG,15390,3452,11938,9831,21769,2021-10-05
3174091003,JAKARTA SELATAN,JAGAKARSA,CIGANJUR,38497,8379,30118,22716,52834,2021-10-05
3175051003,JAKARTA TIMUR,PASAR REBO,CIJANTUNG,41419,9089,32330,25282,57612,2021-10-05
3171061003,JAKARTA PUSAT,MENTENG,CIKINI,8274,1726,6548,4742,11290,2021-10-05
3174081006,JAKARTA SELATAN,PANCORAN,CIKOKO,10547,2204,8343,6682,15025,2021-10-05
3174061001,JAKARTA SELATAN,CILANDAK,CILANDAK BARAT,51752,11569,40183,32702,72885,2021-10-05
3174041003,JAKARTA SELATAN,PASAR MINGGU,CILANDAK TIMUR,25145,5671,19474,15587,35061,2021-10-05
3175101002,JAKARTA TIMUR,CIPAYUNG,CILANGKAP,27635,6140,21495,16752,38247,2021-10-05
3175041006,JAKARTA TIMUR,KRAMAT JATI,CILILITAN,40181,10669,29512,22138,51650,2021-10-05
3172041001,JAKARTA UTARA,CILINCING,CILINCING,43609,12089,31520,22948,54468,2021-10-05
3175101001,JAKARTA TIMUR,CIPAYUNG,CIPAYUNG,26104,5438,20666,16745,37411,2021-10-05
3174091006,JAKARTA SELATAN,JAGAKARSA,CIPEDAK,38303,8272,30031,23612,53643,2021-10-05
3174061005,JAKARTA SELATAN,CILANDAK,CIPETE SELATAN,26704,6089,20615,16623,37238,2021-10-05
3174071010,JAKARTA SELATAN,KEBAYORAN BARU,CIPETE UTARA,34102,7906,26196,19972,46168,2021-10-05
3175021003,JAKARTA TIMUR,PULO GADUNG,CIPINANG,39306,9113,30193,23299,53492,2021-10-05
3175031007,JAKARTA TIMUR,JATINEGARA,CIPINANG BESAR SELATAN,35212,9770,25442,18312,43754,2021-10-05
3175031008,JAKARTA TIMUR,JATINEGARA,CIPINANG BESAR UTARA,45319,12654,32665,23438,56103,2021-10-05
3175031005,JAKARTA TIMUR,JATINEGARA,CIPINANG CEMPEDAK,32824,8539,24285,18917,43202,2021-10-05
3175081005,JAKARTA TIMUR,MAKASAR,CIPINANG MELAYU,42308,10124,32184,25593,57777,2021-10-05
3175031006,JAKARTA TIMUR,JATINEGARA,CIPINANG MUARA,55243,14272,40971,30987,71958,2021-10-05
3174051003,JAKARTA SELATAN,KEBAYORAN LAMA,CIPULIR,39937,9903,30034,22218,52252,2021-10-05
3175091001,JAKARTA TIMUR,CIRACAS,CIRACAS,64594,14069,50525,39069,89594,2021-10-05
3175041003,JAKARTA TIMUR,KRAMAT JATI,DUKUH,24609,5544,19065,14645,33710,2021-10-05
3175071001,JAKARTA TIMUR,DUREN SAWIT,DUREN SAWIT,61160,15818,45342,34737,80079,2021-10-05
3174081004,JAKARTA SELATAN,PANCORAN,DUREN TIGA,28319,6683,21636,15767,37403,2021-10-05
3173051005,JAKARTA BARAT,KEBON JERUK,DURI KEPA,60138,13775,46363,38095,84458,2021-10-05
3173011002,JAKARTA BARAT,CENGKARENG,DURI KOSAMBI,77923,20578,57345,42647,99992,2021-10-05
3171011006,JAKARTA PUSAT,GAMBIR,DURI PULO,19610,4838,14772,11143,25915,2021-10-05
3173041011,JAKARTA BARAT,TAMBORA,DURI SELATAN,14259,3108,11151,8952,20103,2021-10-05
3173041003,JAKARTA BARAT,TAMBORA,DURI UTARA,19844,4581,15263,11749,27012,2021-10-05
3171081003,JAKARTA PUSAT,JOHAR BARU,GALUR,18243,4184,14059,10807,24866,2021-10-05
3171011001,JAKARTA PUSAT,GAMBIR,GAMBIR,2191,526,1665,1353,3018,2021-10-05
3174061004,JAKARTA SELATAN,CILANDAK,GANDARIA SELATAN,22119,5217,16902,13309,30211,2021-10-05
3174071009,JAKARTA SELATAN,KEBAYORAN BARU,GANDARIA UTARA,39922,9610,30312,23543,53855,2021-10-05
3175051001,JAKARTA TIMUR,PASAR REBO,GEDONG,35755,8382,27373,21596,48969,2021-10-05
3171071001,JAKARTA PUSAT,TANAH ABANG,GELORA,3127,726,2401,1905,4306,2021-10-05
3173031007,JAKARTA BARAT,TAMAN SARI,GLODOK,7837,1490,6347,5456,11803,2021-10-05
3171061004,JAKARTA PUSAT,MENTENG,GONDANGDIA,4100,1013,3087,2723,5810,2021-10-05
3173021001,JAKARTA BARAT,GROGOL PETAMBURAN,GROGOL,16876,3976,12900,10197,23097,2021-10-05
3174051005,JAKARTA SELATAN,KEBAYORAN LAMA,GROGOL SELATAN,44251,10991,33260,25513,58773,2021-10-05
3174051004,JAKARTA SELATAN,KEBAYORAN LAMA,GROGOL UTARA,42494,10485,32009,24914,56923,2021-10-05
3174021007,JAKARTA SELATAN,SETIA BUDI,GUNTUR,3985,908,3077,2611,5688,2021-10-05
3174071002,JAKARTA SELATAN,KEBAYORAN BARU,GUNUNG,9436,2095,7341,6056,13397,2021-10-05
3171031005,JAKARTA PUSAT,KEMAYORAN,GUNUNG SAHARI SELATAN,19199,4641,14558,11470,26028,2021-10-05
3171021004,JAKARTA PUSAT,SAWAH BESAR,GUNUNG SAHARI UTARA,16650,3432,13218,11158,24376,2021-10-05
3175081004,JAKARTA TIMUR,MAKASAR,HALIM PERDANA KUSUMAH,28363,4483,23880,21024,44904,2021-10-05
3171031003,JAKARTA PUSAT,KEMAYORAN,HARAPAN MULIA,22557,5522,17035,12968,30003,2021-10-05
3174091001,JAKARTA SELATAN,JAGAKARSA,JAGAKARSA,62389,13874,48515,38068,86583,2021-10-05
3175021007,JAKARTA TIMUR,PULO GADUNG,JATI,32757,7475,25282,20539,45821,2021-10-05
3174041002,JAKARTA SELATAN,PASAR MINGGU,JATI PADANG,37502,9209,28293,22297,50590,2021-10-05
3173071004,JAKARTA BARAT,PALMERAH,JATI PULO,28738,6739,21999,16508,38507,2021-10-05
3175061001,JAKARTA TIMUR,CAKUNG,JATINEGARA,84160,21354,62806,48494,111300,2021-10-05
3175021004,JAKARTA TIMUR,PULO GADUNG,JATINEGARA KAUM,24632,5587,19045,14426,33471,2021-10-05
3173021004,JAKARTA BARAT,GROGOL PETAMBURAN,JELAMBAR,30266,6756,23510,19035,42545,2021-10-05
3173021006,JAKARTA BARAT,GROGOL PETAMBURAN,JELAMBAR BARU,38246,8649,29597,23857,53454,2021-10-05
3173041006,JAKARTA BARAT,TAMBORA,JEMBATAN BESI,29314,8565,20749,14820,35569,2021-10-05
3173041008,JAKARTA BARAT,TAMBORA,JEMBATAN LIMA,21021,5822,15199,11190,26389,2021-10-05
3173081005,JAKARTA BARAT,KEMBANGAN,JOGLO,40839,9805,31034,24508,55542,2021-10-05
3171081001,JAKARTA PUSAT,JOHAR BARU,JOHAR BARU,37488,8137,29351,23220,52571,2021-10-05
3173041002,JAKARTA BARAT,TAMBORA,KALI ANYAR,23856,5806,18050,13339,31389,2021-10-05
3172041004,JAKARTA UTARA,CILINCING,KALIBARU,67684,21846,45838,31101,76939,2021-10-05
3174081002,JAKARTA SELATAN,PANCORAN,KALIBATA,41994,11548,30446,21821,52267,2021-10-05
3173061001,JAKARTA BARAT,KALI DERES,KALIDERES,72447,17785,54662,43708,98370,2021-10-05
3175051004,JAKARTA TIMUR,PASAR REBO,KALISARI,43212,9384,33828,26644,60472,2021-10-05
3173061004,JAKARTA BARAT,KALI DERES,KAMAL,53783,15116,38667,29007,67674,2021-10-05
3172011002,JAKARTA UTARA,PENJARINGAN,KAMAL MUARA,12930,2495,10435,8632,19067,2021-10-05
3171071007,JAKARTA PUSAT,TANAH ABANG,KAMPUNG BALI,11358,2902,8456,5965,14421,2021-10-05
3175031001,JAKARTA TIMUR,JATINEGARA,KAMPUNG MELAYU,25717,7448,18269,13239,31508,2021-10-05
3171081002,JAKARTA PUSAT,JOHAR BARU,KAMPUNG RAWA,21237,4043,17194,12974,30168,2021-10-05
3175041002,JAKARTA TIMUR,KRAMAT JATI,KAMPUNG TENGAH,43993,12855,31138,22992,54130,2021-10-05
3173011005,JAKARTA BARAT,CENGKARENG,KAPUK,134466,37683,96783,72442,169225,2021-10-05
3172011003,JAKARTA UTARA,PENJARINGAN,KAPUK MUARA,35781,7869,27912,23533,51445,2021-10-05
3171021002,JAKARTA PUSAT,SAWAH BESAR,KARANG ANYAR,25761,5804,19957,15670,35627,2021-10-05
3174021004,JAKARTA SELATAN,SETIA BUDI,KARET,9623,2187,7436,5768,13204,2021-10-05
3174021003,JAKARTA SELATAN,SETIA BUDI,KARET KUNINGAN,16055,3671,12384,9921,22305,2021-10-05
3174021002,JAKARTA SELATAN,SETIA BUDI,KARET SEMANGGI,2770,615,2155,1826,3981,2021-10-05
3171071003,JAKARTA PUSAT,TANAH ABANG,KARET TENGSIN,19271,4495,14776,11174,25950,2021-10-05
3171021003,JAKARTA PUSAT,SAWAH BESAR,KARTINI,22292,5106,17186,13777,30963,2021-10-05
3175011003,JAKARTA TIMUR,MATRAMAN,KAYU MANIS,25284,6413,18871,13762,32633,2021-10-05
3175021006,JAKARTA TIMUR,PULO GADUNG,KAYU PUTIH,40696,9003,31693,26142,57835,2021-10-05
3173031006,JAKARTA BARAT,TAMAN SARI,KEAGUNGAN,17387,4097,13290,10228,23518,2021-10-05
3174041007,JAKARTA SELATAN,PASAR MINGGU,KEBAGUSAN,44552,10823,33729,25321,59050,2021-10-05
3174051006,JAKARTA SELATAN,KEBAYORAN LAMA,KEBAYORAN LAMA SELATAN,41212,9195,32017,25074,57091,2021-10-05
3174051001,JAKARTA SELATAN,KEBAYORAN LAMA,KEBAYORAN LAMA UTARA,42422,10713,31709,24367,56076,2021-10-05
3174011004,JAKARTA SELATAN,TEBET,KEBON BARU,35165,8296,26869,20812,47681,2021-10-05
3172021005,JAKARTA UTARA,TANJUNG PRIOK,KEBON BAWANG,50952,12269,38683,30054,68737,2021-10-05
3173051001,JAKARTA BARAT,KEBON JERUK,KEBON JERUK,53887,14086,39801,30493,70294,2021-10-05
3171071006,JAKARTA PUSAT,TANAH ABANG,KEBON KACANG,21531,6072,15459,11396,26855,2021-10-05
3171011005,JAKARTA PUSAT,GAMBIR,KEBON KELAPA,10163,2357,7806,6115,13921,2021-10-05
3171031002,JAKARTA PUSAT,KEMAYORAN,KEBON KOSONG,30019,7477,22542,17119,39661,2021-10-05
3175011005,JAKARTA TIMUR,MATRAMAN,KEBON MANGGIS,16490,3817,12673,9774,22447,2021-10-05
3171071005,JAKARTA PUSAT,TANAH ABANG,KEBON MELATI,32206,9775,22431,15321,37752,2021-10-05
3175081003,JAKARTA TIMUR,MAKASAR,KEBON PALA,46614,11037,35577,27746,63323,2021-10-05
3171061005,JAKARTA PUSAT,MENTENG,KEBON SIRIH,12299,3064,9235,6888,16123,2021-10-05
3173011004,JAKARTA BARAT,CENGKARENG,KEDAUNG KALI ANGKE,32612,7362,25250,19861,45111,2021-10-05
3173051007,JAKARTA BARAT,KEBON JERUK,KEDOYA SELATAN,32165,7231,24934,19549,44483,2021-10-05
3173051006,JAKARTA BARAT,KEBON JERUK,KEDOYA UTARA,45740,10212,35528,28816,64344,2021-10-05
3173051004,JAKARTA BARAT,KEBON JERUK,KELAPA DUA,23565,5990,17575,13811,31386,2021-10-05
3175091003,JAKARTA TIMUR,CIRACAS,KELAPA DUA WETAN,46875,9769,37106,29333,66439,2021-10-05
3172061003,JAKARTA UTARA,KELAPA GADING,KELAPA GADING BARAT,35717,7108,28609,24781,53390,2021-10-05
3172061001,JAKARTA UTARA,KELAPA GADING,KELAPA GADING TIMUR,33592,5910,27682,24469,52151,2021-10-05
3173071005,JAKARTA BARAT,PALMERAH,KEMANGGISAN,32139,7387,24752,19220,43972,2021-10-05
3171031001,JAKARTA PUSAT,KEMAYORAN,KEMAYORAN,20708,4997,15711,12253,27964,2021-10-05
3173081006,JAKARTA BARAT,KEMBANGAN,KEMBANGAN SELATAN,27130,6663,20467,16825,37292,2021-10-05
3173081001,JAKARTA BARAT,KEMBANGAN,KEMBANGAN UTARA,54451,13833,40618,31899,72517,2021-10-05
3171041002,JAKARTA PUSAT,SENEN,KENARI,9579,2190,7389,5929,13318,2021-10-05
3173041005,JAKARTA BARAT,TAMBORA,KERENDANG,19973,4957,15016,11307,26323,2021-10-05
3175071003,JAKARTA TIMUR,DUREN SAWIT,KLENDER,69978,19185,50793,37650,88443,2021-10-05
3172031001,JAKARTA UTARA,KOJA,KOJA,28175,7454,20721,15681,36402,2021-10-05
3173071006,JAKARTA BARAT,PALMERAH,KOTA BAMBU SELATAN,21158,5303,15855,11638,27493,2021-10-05
3173071003,JAKARTA BARAT,PALMERAH,KOTA BAMBU UTARA,24995,6419,18576,13519,32095,2021-10-05
3171041004,JAKARTA PUSAT,SENEN,KRAMAT,28835,7920,20915,14840,35755,2021-10-05
3175041001,JAKARTA TIMUR,KRAMAT JATI,KRAMAT JATI,34144,8892,25252,19264,44516,2021-10-05
3174071003,JAKARTA SELATAN,KEBAYORAN BARU,KRAMAT PELA,14413,3231,11182,8884,20066,2021-10-05
3173031002,JAKARTA BARAT,TAMAN SARI,KRUKUT,19244,4548,14696,11134,25830,2021-10-05
3174031005,JAKARTA SELATAN,MAMPANG PRAPATAN,KUNINGAN BARAT,12785,2827,9958,7672,17630,2021-10-05
3174021008,JAKARTA SELATAN,SETIA BUDI,KUNINGAN TIMUR,6008,1450,4558,3697,8255,2021-10-05
3171041005,JAKARTA PUSAT,SENEN,KWITANG,15486,4060,11426,8754,20180,2021-10-05
3172031003,JAKARTA UTARA,KOJA,LAGOA,59065,16388,42677,31643,74320,2021-10-05
3174061002,JAKARTA SELATAN,CILANDAK,LEBAK BULUS,37626,8597,29029,23167,52196,2021-10-05
3174091004,JAKARTA SELATAN,JAGAKARSA,LENTENG AGUNG,53946,12416,41530,30833,72363,2021-10-05
3175101007,JAKARTA TIMUR,CIPAYUNG,LUBANG BUAYA,63547,14295,49252,38446,87698,2021-10-05
3175081001,JAKARTA TIMUR,MAKASAR,MAKASAR,34390,8097,26293,21126,47419,2021-10-05
3175071006,JAKARTA TIMUR,DUREN SAWIT,MALAKA JAYA,30927,6909,24018,19267,43285,2021-10-05
3175071005,JAKARTA TIMUR,DUREN SAWIT,MALAKA SARI,27530,5754,21776,17609,39385,2021-10-05
3174031001,JAKARTA SELATAN,MAMPANG PRAPATAN,MAMPANG PRAPATAN,18159,4584,13575,10516,24091,2021-10-05
3173031005,JAKARTA BARAT,TAMAN SARI,MANGGA BESAR,7707,1507,6200,5092,11292,2021-10-05
3171021005,JAKARTA PUSAT,SAWAH BESAR,MANGGA DUA SELATAN,27442,6525,20917,16477,37394,2021-10-05
3174011007,JAKARTA SELATAN,TEBET,MANGGARAI,28373,6088,22285,16714,38999,2021-10-05
3174011006,JAKARTA SELATAN,TEBET,MANGGARAI SELATAN,23075,4999,18076,14203,32279,2021-10-05
3173031003,JAKARTA BARAT,TAMAN SARI,MAPHAR,16461,3808,12653,9998,22651,2021-10-05
3172041003,JAKARTA UTARA,CILINCING,MARUNDA,28943,7590,21353,15206,36559,2021-10-05
3174071001,JAKARTA SELATAN,KEBAYORAN BARU,MELAWAI,2627,576,2051,1817,3868,2021-10-05
3171061001,JAKARTA PUSAT,MENTENG,MENTENG,25624,6703,18921,14037,32958,2021-10-05
3174021005,JAKARTA SELATAN,SETIA BUDI,MENTENG ATAS,27816,6127,21689,16738,38427,2021-10-05
3174011003,JAKARTA SELATAN,TEBET,MENTENG DALAM,36028,8466,27562,21547,49109,2021-10-05
3173081003,JAKARTA BARAT,KEMBANGAN,MERUYA SELATAN,32130,7931,24199,18893,43092,2021-10-05
3173081002,JAKARTA BARAT,KEMBANGAN,MERUYA UTARA,43752,10869,32883,26810,59693,2021-10-05
3175101004,JAKARTA TIMUR,CIPAYUNG,MUNJUL,23871,5295,18576,14665,33241,2021-10-05
3172051002,JAKARTA UTARA,PADEMANGAN,PADEMANGAN BARAT,74240,20086,54154,41133,95287,2021-10-05
3172051001,JAKARTA UTARA,PADEMANGAN,PADEMANGAN TIMUR,37736,7811,29925,24610,54535,2021-10-05
3175011004,JAKARTA TIMUR,MATRAMAN,PAL MERIAM,19769,5157,14612,11088,25700,2021-10-05
3173071001,JAKARTA BARAT,PALMERAH,PALMERAH,63011,16167,46844,35568,82412,2021-10-05
3174081001,JAKARTA SELATAN,PANCORAN,PANCORAN,19421,5082,14339,11157,25496,2021-10-05
3172021003,JAKARTA UTARA,TANJUNG PRIOK,PAPANGGO,39097,9178,29919,23310,53229,2021-10-05
3171021001,JAKARTA PUSAT,SAWAH BESAR,PASAR BARU,12035,2632,9403,7995,17398,2021-10-05
3174021006,JAKARTA SELATAN,SETIA BUDI,PASAR MANGGIS,26752,6523,20229,15697,35926,2021-10-05
3174041001,JAKARTA SELATAN,PASAR MINGGU,PASAR MINGGU,24821,5648,19173,15214,34387,2021-10-05
3171041003,JAKARTA PUSAT,SENEN,PASEBAN,23533,5911,17622,13480,31102,2021-10-05
3173061005,JAKARTA BARAT,KALI DERES,PEGADUNGAN,75587,17853,57734,47261,104995,2021-10-05
3171061002,JAKARTA PUSAT,MENTENG,PEGANGSAAN,23455,6033,17422,12442,29864,2021-10-05
3172061002,JAKARTA UTARA,KELAPA GADING,PEGANGSAAN DUA,49976,9370,40606,35235,75841,2021-10-05
3172011004,JAKARTA UTARA,PENJARINGAN,PEJAGALAN,74578,18190,56388,45485,101873,2021-10-05
3174041006,JAKARTA SELATAN,PASAR MINGGU,PEJATEN BARAT,37346,9209,28137,22145,50282,2021-10-05
3174041005,JAKARTA SELATAN,PASAR MINGGU,PEJATEN TIMUR,57656,15433,42223,32285,74508,2021-10-05
3175051005,JAKARTA TIMUR,PASAR REBO,PEKAYON,43250,9426,33824,26278,60102,2021-10-05
3173041009,JAKARTA BARAT,TAMBORA,PEKOJAN,23587,5346,18241,14331,32572,2021-10-05
3174031003,JAKARTA SELATAN,MAMPANG PRAPATAN,PELA MAMPANG,43522,10495,33027,25895,58922,2021-10-05
3174081005,JAKARTA SELATAN,PANCORAN,PENGADEGAN,21478,4665,16813,12808,29621,2021-10-05
3175061003,JAKARTA TIMUR,CAKUNG,PENGGILINGAN,99255,27332,71923,53383,125306,2021-10-05
3172011001,JAKARTA UTARA,PENJARINGAN,PENJARINGAN,88308,25904,62404,45325,107729,2021-10-05
3174101001,JAKARTA SELATAN,PESANGGRAHAN,PESANGGRAHAN,27545,5703,21842,17574,39416,2021-10-05
3171071004,JAKARTA PUSAT,TANAH ABANG,PETAMBURAN,33271,10164,23107,15994,39101,2021-10-05
3174071008,JAKARTA SELATAN,KEBAYORAN BARU,PETOGOGAN,11499,2734,8765,6855,15620,2021-10-05
3171011004,JAKARTA PUSAT,GAMBIR,PETOJO SELATAN,14692,3833,10859,8680,19539,2021-10-05
3171011003,JAKARTA PUSAT,GAMBIR,PETOJO UTARA,17458,4365,13093,10096,23189,2021-10-05
3174101004,JAKARTA SELATAN,PESANGGRAHAN,PETUKANGAN SELATAN,37187,9163,28024,22315,50339,2021-10-05
3174101003,JAKARTA SELATAN,PESANGGRAHAN,PETUKANGAN UTARA,53716,13775,39941,31068,71009,2021-10-05
3175081002,JAKARTA TIMUR,MAKASAR,PINANG RANTI,27198,6957,20241,15818,36059,2021-10-05
3173031008,JAKARTA BARAT,TAMAN SARI,PINANGSIA,10729,2338,8391,6622,15013,2021-10-05
3175011001,JAKARTA TIMUR,MATRAMAN,PISANGAN BARU,31776,8009,23767,17411,41178,2021-10-05
3175021002,JAKARTA TIMUR,PULO GADUNG,PISANGAN TIMUR,41011,9383,31628,25157,56785,2021-10-05
3172011005,JAKARTA UTARA,PENJARINGAN,PLUIT,47783,10667,37116,31168,68284,2021-10-05
3175071002,JAKARTA TIMUR,DUREN SAWIT,PONDOK BAMBU,61550,15938,45612,35263,80875,2021-10-05
3175071004,JAKARTA TIMUR,DUREN SAWIT,PONDOK KELAPA,72015,16796,55219,44442,99661,2021-10-05
3175071007,JAKARTA TIMUR,DUREN SAWIT,PONDOK KOPI,35367,8688,26679,19636,46315,2021-10-05
3174061003,JAKARTA SELATAN,CILANDAK,PONDOK LABU,46464,9650,36814,29760,66574,2021-10-05
3174051002,JAKARTA SELATAN,KEBAYORAN LAMA,PONDOK PINANG,56169,12657,43512,34190,77702,2021-10-05
3175101003,JAKARTA TIMUR,CIPAYUNG,PONDOK RANGGON,25574,6133,19441,15348,34789,2021-10-05
3101011003,KAB.ADM.KEP.SERIBU,KEP. SERIBU UTARA,PULAU HARAPAN,2060,267,1793,1473,3266,2021-10-05
3101011002,KAB.ADM.KEP.SERIBU,KEP. SERIBU UTARA,PULAU KELAPA,5528,682,4846,3761,8607,2021-10-05
3101011001,KAB.ADM.KEP.SERIBU,KEP. SERIBU UTARA,PULAU PANGGANG,5450,575,4875,4087,8962,2021-10-05
3101021003,KAB.ADM.KEP.SERIBU,KEP. SERIBU SELATAN,PULAU PARI,2765,225,2540,2271,4811,2021-10-05
3101021002,KAB.ADM.KEP.SERIBU,KEP. SERIBU SELATAN,PULAU TIDUNG,4553,451,4102,3623,7725,2021-10-05
3101021001,KAB.ADM.KEP.SERIBU,KEP. SERIBU SELATAN,PULAU UNTUNG JAWA,1941,215,1726,1569,3295,2021-10-05
3174071007,JAKARTA SELATAN,KEBAYORAN BARU,PULO,5835,1165,4670,3989,8659,2021-10-05
3175021001,JAKARTA TIMUR,PULO GADUNG,PULO GADUNG,34422,8612,25810,20130,45940,2021-10-05
3175061005,JAKARTA TIMUR,CAKUNG,PULO GEBANG,97301,22406,74895,56472,131367,2021-10-05
3174041004,JAKARTA SELATAN,PASAR MINGGU,RAGUNAN,39616,8940,30676,24322,54998,2021-10-05
3175091005,JAKARTA TIMUR,CIRACAS,RAMBUTAN,36771,10127,26644,19894,46538,2021-10-05
3172031006,JAKARTA UTARA,KOJA,RAWA BADAK SELATAN,42179,11699,30480,22305,52785,2021-10-05
3172031004,JAKARTA UTARA,KOJA,RAWA BADAK UTARA,34408,9155,25253,18925,44178,2021-10-05
3174071005,JAKARTA SELATAN,KEBAYORAN BARU,RAWA BARAT,5625,1124,4501,3740,8241,2021-10-05
3173011003,JAKARTA BARAT,CENGKARENG,RAWA BUAYA,63799,15752,48047,35492,83539,2021-10-05
3175031004,JAKARTA TIMUR,JATINEGARA,RAWA BUNGA,21434,6007,15427,11604,27031,2021-10-05
3174081003,JAKARTA SELATAN,PANCORAN,RAWA JATI,20509,4748,15761,11837,27598,2021-10-05
3175061002,JAKARTA TIMUR,CAKUNG,RAWA TERATE,24637,5344,19293,14964,34257,2021-10-05
3175021005,JAKARTA TIMUR,PULO GADUNG,RAWAMANGUN,37612,8910,28702,22748,51450,2021-10-05
3171051003,JAKARTA PUSAT,CEMPAKA PUTIH,RAWASARI,21967,5372,16595,13181,29776,2021-10-05
3173041010,JAKARTA BARAT,TAMBORA,ROA MALAKA,3484,675,2809,2369,5178,2021-10-05
3172041006,JAKARTA UTARA,CILINCING,ROROTAN,41668,9920,31748,24006,55754,2021-10-05
3174071004,JAKARTA SELATAN,KEBAYORAN BARU,SELONG,2842,599,2243,1946,4189,2021-10-05
3173061002,JAKARTA BARAT,KALI DERES,SEMANAN,71354,18771,52583,40085,92668,2021-10-05
3172041007,JAKARTA UTARA,CILINCING,SEMPER BARAT,68587,15936,52651,41419,94070,2021-10-05
3172041005,JAKARTA UTARA,CILINCING,SEMPER TIMUR,36267,9013,27254,20702,47956,2021-10-05
3174071006,JAKARTA SELATAN,KEBAYORAN BARU,SENAYAN,2771,736,2035,1627,3662,2021-10-05
3171041001,JAKARTA PUSAT,SENEN,SENEN,6804,1686,5118,4116,9234,2021-10-05
3171031004,JAKARTA PUSAT,KEMAYORAN,SERDANG,29668,7093,22575,17627,40202,2021-10-05
3174021001,JAKARTA SELATAN,SETIA BUDI,SETIA BUDI,3023,730,2293,1831,4124,2021-10-05
3175101005,JAKARTA TIMUR,CIPAYUNG,SETU,20572,5135,15437,11759,27196,2021-10-05
3173071002,JAKARTA BARAT,PALMERAH,SLIPI,16591,3673,12918,10185,23103,2021-10-05
3173081004,JAKARTA BARAT,KEMBANGAN,SRENGSENG,45523,11945,33578,26521,60099,2021-10-05
3174091002,JAKARTA SELATAN,JAGAKARSA,SRENGSENG SAWAH,58196,11677,46519,37211,83730,2021-10-05
3173051003,JAKARTA BARAT,KEBON JERUK,SUKABUMI SELATAN,37033,10084,26949,19650,46599,2021-10-05
3173051002,JAKARTA BARAT,KEBON JERUK,SUKABUMI UTARA,38290,10724,27566,20110,47676,2021-10-05
3172041002,JAKARTA UTARA,CILINCING,SUKAPURA,53949,14234,39715,30911,70626,2021-10-05
3171031007,JAKARTA PUSAT,KEMAYORAN,SUMUR BATU,22717,5487,17230,13719,30949,2021-10-05
3172021004,JAKARTA UTARA,TANJUNG PRIOK,SUNGAI BAMBU,29876,7197,22679,17693,40372,2021-10-05
3172021006,JAKARTA UTARA,TANJUNG PRIOK,SUNTER AGUNG,71805,14503,57302,47645,104947,2021-10-05
3172021002,JAKARTA UTARA,TANJUNG PRIOK,SUNTER JAYA,63031,13598,49433,40674,90107,2021-10-05
3175091004,JAKARTA TIMUR,CIRACAS,SUSUKAN,38257,8583,29674,23327,53001,2021-10-05
3173031001,JAKARTA BARAT,TAMAN SARI,TAMAN SARI,14348,3160,11188,9065,20253,2021-10-05
3173041001,JAKARTA BARAT,TAMBORA,TAMBORA,10204,2651,7553,5771,13324,2021-10-05
3173041004,JAKARTA BARAT,TAMBORA,TANAH SEREAL,26387,5269,21118,16726,37844,2021-10-05
3171081004,JAKARTA PUSAT,JOHAR BARU,TANAH TINGGI,37693,8158,29535,22560,52095,2021-10-05
3173031004,JAKARTA BARAT,TAMAN SARI,TANGKI,13324,2712,10612,8312,18924,2021-10-05
3174091005,JAKARTA SELATAN,JAGAKARSA,TANJUNG BARAT,39770,9041,30729,23826,54555,2021-10-05
3173021005,JAKARTA BARAT,GROGOL PETAMBURAN,TANJUNG DUREN SELATAN,25337,5717,19620,16154,35774,2021-10-05
3173021002,JAKARTA BARAT,GROGOL PETAMBURAN,TANJUNG DUREN UTARA,17010,3503,13507,11357,24864,2021-10-05
3172021001,JAKARTA UTARA,TANJUNG PRIOK,TANJUNG PRIOK,34588,8220,26368,20446,46814,2021-10-05
3174011002,JAKARTA SELATAN,TEBET,TEBET BARAT,21194,4160,17034,14026,31060,2021-10-05
3174011001,JAKARTA SELATAN,TEBET,TEBET TIMUR,18199,3496,14703,12369,27072,2021-10-05
3173061003,JAKARTA BARAT,KALI DERES,TEGAL ALUR,83647,20906,62741,48694,111435,2021-10-05
3174031004,JAKARTA SELATAN,MAMPANG PRAPATAN,TEGAL PARANG,32401,8742,23659,17003,40662,2021-10-05
3173021003,JAKARTA BARAT,GROGOL PETAMBURAN,TOMANG,29605,6415,23190,18624,41814,2021-10-05
3172031005,JAKARTA UTARA,KOJA,TUGU SELATAN,39122,10180,28942,21529,50471,2021-10-05
3172031002,JAKARTA UTARA,KOJA,TUGU UTARA,67670,18676,48994,36134,85128,2021-10-05
3175061006,JAKARTA TIMUR,CAKUNG,UJUNG MENTENG,29934,6104,23830,18959,42789,2021-10-05
3174101005,JAKARTA SELATAN,PESANGGRAHAN,ULUJAMI,40544,10957,29587,22697,52284,2021-10-05
3175011006,JAKARTA TIMUR,MATRAMAN,UTAN KAYU SELATAN,33511,7473,26038,19978,46016,2021-10-05
3175011002,JAKARTA TIMUR,MATRAMAN,UTAN KAYU UTARA,28169,7067,21102,16170,37272,2021-10-05
3171031008,JAKARTA PUSAT,KEMAYORAN,UTAN PANJANG,29208,7396,21812,16440,38252,2021-10-05
3172021007,JAKARTA UTARA,TANJUNG PRIOK,WARAKAS,44401,9792,34609,26197,60806,2021-10-05
3173021007,JAKARTA BARAT,GROGOL PETAMBURAN,WIJAYA KUSUMA,38934,9836,29098,22936,52034,2021-10-05
3172051003,JAKARTA UTARA,PADEMANGAN,ANCOL,23947,6501,17446,13595,31041,2021-10-06
3173041007,JAKARTA BARAT,TAMBORA,ANGKE,29381,7376,22005,16764,38769,2021-10-06
3175041005,JAKARTA TIMUR,KRAMAT JATI,BALE KAMBANG,29074,8373,20701,14832,35533,2021-10-06
3175031003,JAKARTA TIMUR,JATINEGARA,BALI MESTER,9752,2412,7340,5795,13135,2021-10-06
3175101006,JAKARTA TIMUR,CIPAYUNG,BAMBU APUS,26285,5756,20529,15620,36149,2021-10-06
3174031002,JAKARTA SELATAN,MAMPANG PRAPATAN,BANGKA,21566,5601,15965,12362,28327,2021-10-06
3175051002,JAKARTA TIMUR,PASAR REBO,BARU,23886,4722,19164,15737,34901,2021-10-06
3175041004,JAKARTA TIMUR,KRAMAT JATI,BATU AMPAR,47898,13636,34262,25359,59621,2021-10-06
3171071002,JAKARTA PUSAT,TANAH ABANG,BENDUNGAN HILIR,21494,5059,16435,13028,29463,2021-10-06
3175031002,JAKARTA TIMUR,JATINEGARA,BIDARA CINA,36689,10263,26426,19583,46009,2021-10-06
3174101002,JAKARTA SELATAN,PESANGGRAHAN,BINTARO,53098,12509,40589,32679,73268,2021-10-06
3174011005,JAKARTA SELATAN,TEBET,BUKIT DURI,34183,8387,25796,19869,45665,2021-10-06
3171041006,JAKARTA PUSAT,SENEN,BUNGUR,18144,4503,13641,10760,24401,2021-10-06
3175061007,JAKARTA TIMUR,CAKUNG,CAKUNG BARAT,57724,13690,44034,34483,78517,2021-10-06
3175061004,JAKARTA TIMUR,CAKUNG,CAKUNG TIMUR,58287,13482,44805,35041,79846,2021-10-06
3175041007,JAKARTA TIMUR,KRAMAT JATI,CAWANG,32762,8496,24266,18056,42322,2021-10-06
3175101008,JAKARTA TIMUR,CIPAYUNG,CEGER,18932,4345,14587,11442,26029,2021-10-06
3171031006,JAKARTA PUSAT,KEMAYORAN,CEMPAKA BARU,32581,8060,24521,18208,42729,2021-10-06
3171051002,JAKARTA PUSAT,CEMPAKA PUTIH,CEMPAKA PUTIH BARAT,35885,9015,26870,21345,48215,2021-10-06
3171051001,JAKARTA PUSAT,CEMPAKA PUTIH,CEMPAKA PUTIH TIMUR,24292,5767,18525,15116,33641,2021-10-06
3173011001,JAKARTA BARAT,CENGKARENG,CENGKARENG BARAT,66284,16007,50277,39645,89922,2021-10-06
3173011006,JAKARTA BARAT,CENGKARENG,CENGKARENG TIMUR,81027,18973,62054,47418,109472,2021-10-06
3175091002,JAKARTA TIMUR,CIRACAS,CIBUBUR,66364,13670,52694,41605,94299,2021-10-06
3171011002,JAKARTA PUSAT,GAMBIR,CIDENG,15390,3427,11963,9862,21825,2021-10-06
3174091003,JAKARTA SELATAN,JAGAKARSA,CIGANJUR,38497,8301,30196,22819,53015,2021-10-06
3175051003,JAKARTA TIMUR,PASAR REBO,CIJANTUNG,41419,9044,32375,25356,57731,2021-10-06
3171061003,JAKARTA PUSAT,MENTENG,CIKINI,8274,1722,6552,4761,11313,2021-10-06
3174081006,JAKARTA SELATAN,PANCORAN,CIKOKO,10547,2192,8355,6719,15074,2021-10-06
3174061001,JAKARTA SELATAN,CILANDAK,CILANDAK BARAT,51752,11443,40309,32802,73111,2021-10-06
3174041003,JAKARTA SELATAN,PASAR MINGGU,CILANDAK TIMUR,25145,5612,19533,15628,35161,2021-10-06
3175101002,JAKARTA TIMUR,CIPAYUNG,CILANGKAP,27635,6052,21583,16852,38435,2021-10-06
3175041006,JAKARTA TIMUR,KRAMAT JATI,CILILITAN,40181,10591,29590,22240,51830,2021-10-06
3172041001,JAKARTA UTARA,CILINCING,CILINCING,43609,12013,31596,23033,54629,2021-10-06
3175101001,JAKARTA TIMUR,CIPAYUNG,CIPAYUNG,26104,5399,20705,16812,37517,2021-10-06
3174091006,JAKARTA SELATAN,JAGAKARSA,CIPEDAK,38303,8189,30114,23694,53808,2021-10-06
3174061005,JAKARTA SELATAN,CILANDAK,CIPETE SELATAN,26704,6049,20655,16732,37387,2021-10-06
3174071010,JAKARTA SELATAN,KEBAYORAN BARU,CIPETE UTARA,34102,7768,26334,20054,46388,2021-10-06
3175021003,JAKARTA TIMUR,PULO GADUNG,CIPINANG,39306,9012,30294,23404,53698,2021-10-06
3175031007,JAKARTA TIMUR,JATINEGARA,CIPINANG BESAR SELATAN,35212,9704,25508,18383,43891,2021-10-06
3175031008,JAKARTA TIMUR,JATINEGARA,CIPINANG BESAR UTARA,45319,12587,32732,23541,56273,2021-10-06
3175031005,JAKARTA TIMUR,JATINEGARA,CIPINANG CEMPEDAK,32824,8409,24415,18999,43414,2021-10-06
3175081005,JAKARTA TIMUR,MAKASAR,CIPINANG MELAYU,42308,9810,32498,25678,58176,2021-10-06
3175031006,JAKARTA TIMUR,JATINEGARA,CIPINANG MUARA,55243,14190,41053,31104,72157,2021-10-06
3174051003,JAKARTA SELATAN,KEBAYORAN LAMA,CIPULIR,39937,9859,30078,22320,52398,2021-10-06
3175091001,JAKARTA TIMUR,CIRACAS,CIRACAS,64594,13964,50630,39165,89795,2021-10-06
3175041003,JAKARTA TIMUR,KRAMAT JATI,DUKUH,24609,5509,19100,14687,33787,2021-10-06
3175071001,JAKARTA TIMUR,DUREN SAWIT,DUREN SAWIT,61160,15657,45503,34957,80460,2021-10-06
3174081004,JAKARTA SELATAN,PANCORAN,DUREN TIGA,28319,6653,21666,15912,37578,2021-10-06
3173051005,JAKARTA BARAT,KEBON JERUK,DURI KEPA,60138,13694,46444,38202,84646,2021-10-06
3173011002,JAKARTA BARAT,CENGKARENG,DURI KOSAMBI,77923,20449,57474,42840,100314,2021-10-06
3171011006,JAKARTA PUSAT,GAMBIR,DURI PULO,19610,4802,14808,11182,25990,2021-10-06
3173041011,JAKARTA BARAT,TAMBORA,DURI SELATAN,14259,3083,11176,8989,20165,2021-10-06
3173041003,JAKARTA BARAT,TAMBORA,DURI UTARA,19844,4540,15304,11807,27111,2021-10-06
3171081003,JAKARTA PUSAT,JOHAR BARU,GALUR,18243,4163,14080,10841,24921,2021-10-06
3171011001,JAKARTA PUSAT,GAMBIR,GAMBIR,2191,525,1666,1357,3023,2021-10-06
3174061004,JAKARTA SELATAN,CILANDAK,GANDARIA SELATAN,22119,5164,16955,13381,30336,2021-10-06
3174071009,JAKARTA SELATAN,KEBAYORAN BARU,GANDARIA UTARA,39922,9554,30368,23636,54004,2021-10-06
3175051001,JAKARTA TIMUR,PASAR REBO,GEDONG,35755,8326,27429,21661,49090,2021-10-06
3171071001,JAKARTA PUSAT,TANAH ABANG,GELORA,3127,722,2405,1931,4336,2021-10-06
3173031007,JAKARTA BARAT,TAMAN SARI,GLODOK,7837,1484,6353,5469,11822,2021-10-06
3171061004,JAKARTA PUSAT,MENTENG,GONDANGDIA,4100,1010,3090,2727,5817,2021-10-06
3173021001,JAKARTA BARAT,GROGOL PETAMBURAN,GROGOL,16876,3945,12931,10238,23169,2021-10-06
3174051005,JAKARTA SELATAN,KEBAYORAN LAMA,GROGOL SELATAN,44251,10913,33338,25608,58946,2021-10-06
3174051004,JAKARTA SELATAN,KEBAYORAN LAMA,GROGOL UTARA,42494,10426,32068,25036,57104,2021-10-06
3174021007,JAKARTA SELATAN,SETIA BUDI,GUNTUR,3985,900,3085,2618,5703,2021-10-06
3174071002,JAKARTA SELATAN,KEBAYORAN BARU,GUNUNG,9436,2044,7392,6082,13474,2021-10-06
3171031005,JAKARTA PUSAT,KEMAYORAN,GUNUNG SAHARI SELATAN,19199,4594,14605,11515,26120,2021-10-06
3171021004,JAKARTA PUSAT,SAWAH BESAR,GUNUNG SAHARI UTARA,16650,3415,13235,11176,24411,2021-10-06
3175081004,JAKARTA TIMUR,MAKASAR,HALIM PERDANA KUSUMAH,28363,4457,23906,21064,44970,2021-10-06
3171031003,JAKARTA PUSAT,KEMAYORAN,HARAPAN MULIA,22557,5478,17079,13015,30094,2021-10-06
3174091001,JAKARTA SELATAN,JAGAKARSA,JAGAKARSA,62389,13742,48647,38215,86862,2021-10-06
3175021007,JAKARTA TIMUR,PULO GADUNG,JATI,32757,7417,25340,20626,45966,2021-10-06
3174041002,JAKARTA SELATAN,PASAR MINGGU,JATI PADANG,37502,9153,28349,22382,50731,2021-10-06
3173071004,JAKARTA BARAT,PALMERAH,JATI PULO,28738,6708,22030,16566,38596,2021-10-06
3175061001,JAKARTA TIMUR,CAKUNG,JATINEGARA,84160,21263,62897,48707,111604,2021-10-06
3175021004,JAKARTA TIMUR,PULO GADUNG,JATINEGARA KAUM,24632,5544,19088,14473,33561,2021-10-06
3173021004,JAKARTA BARAT,GROGOL PETAMBURAN,JELAMBAR,30266,6606,23660,19166,42826,2021-10-06
3173021006,JAKARTA BARAT,GROGOL PETAMBURAN,JELAMBAR BARU,38246,8580,29666,23937,53603,2021-10-06
3173041006,JAKARTA BARAT,TAMBORA,JEMBATAN BESI,29314,8528,20786,14887,35673,2021-10-06
3173041008,JAKARTA BARAT,TAMBORA,JEMBATAN LIMA,21021,5798,15223,11238,26461,2021-10-06
3173081005,JAKARTA BARAT,KEMBANGAN,JOGLO,40839,9746,31093,24626,55719,2021-10-06
3171081001,JAKARTA PUSAT,JOHAR BARU,JOHAR BARU,37488,8084,29404,23299,52703,2021-10-06
3173041002,JAKARTA BARAT,TAMBORA,KALI ANYAR,23856,5772,18084,13389,31473,2021-10-06
3172041004,JAKARTA UTARA,CILINCING,KALIBARU,67684,21747,45937,31219,77156,2021-10-06
3174081002,JAKARTA SELATAN,PANCORAN,KALIBATA,41994,11458,30536,22036,52572,2021-10-06
3173061001,JAKARTA BARAT,KALI DERES,KALIDERES,72447,17678,54769,43880,98649,2021-10-06
3175051004,JAKARTA TIMUR,PASAR REBO,KALISARI,43212,9299,33913,26728,60641,2021-10-06
3173061004,JAKARTA BARAT,KALI DERES,KAMAL,53783,14999,38784,29097,67881,2021-10-06
3172011002,JAKARTA UTARA,PENJARINGAN,KAMAL MUARA,12930,2482,10448,8650,19098,2021-10-06
3171071007,JAKARTA PUSAT,TANAH ABANG,KAMPUNG BALI,11358,2865,8493,5992,14485,2021-10-06
3175031001,JAKARTA TIMUR,JATINEGARA,KAMPUNG MELAYU,25717,7407,18310,13293,31603,2021-10-06
3171081002,JAKARTA PUSAT,JOHAR BARU,KAMPUNG RAWA,21237,4024,17213,13020,30233,2021-10-06
3175041002,JAKARTA TIMUR,KRAMAT JATI,KAMPUNG TENGAH,43993,12735,31258,23079,54337,2021-10-06
3173011005,JAKARTA BARAT,CENGKARENG,KAPUK,134466,37536,96930,72670,169600,2021-10-06
3172011003,JAKARTA UTARA,PENJARINGAN,KAPUK MUARA,35781,7834,27947,23582,51529,2021-10-06
3171021002,JAKARTA PUSAT,SAWAH BESAR,KARANG ANYAR,25761,5769,19992,15732,35724,2021-10-06
3174021004,JAKARTA SELATAN,SETIA BUDI,KARET,9623,2177,7446,5782,13228,2021-10-06
3174021003,JAKARTA SELATAN,SETIA BUDI,KARET KUNINGAN,16055,3635,12420,9960,22380,2021-10-06
3174021002,JAKARTA SELATAN,SETIA BUDI,KARET SEMANGGI,2770,611,2159,1827,3986,2021-10-06
3171071003,JAKARTA PUSAT,TANAH ABANG,KARET TENGSIN,19271,4467,14804,11219,26023,2021-10-06
3171021003,JAKARTA PUSAT,SAWAH BESAR,KARTINI,22292,5073,17219,13823,31042,2021-10-06
3175011003,JAKARTA TIMUR,MATRAMAN,KAYU MANIS,25284,6371,18913,13810,32723,2021-10-06
3175021006,JAKARTA TIMUR,PULO GADUNG,KAYU PUTIH,40696,8942,31754,26240,57994,2021-10-06
3173031006,JAKARTA BARAT,TAMAN SARI,KEAGUNGAN,17387,4068,13319,10262,23581,2021-10-06
3174041007,JAKARTA SELATAN,PASAR MINGGU,KEBAGUSAN,44552,10755,33797,25457,59254,2021-10-06
3174051006,JAKARTA SELATAN,KEBAYORAN LAMA,KEBAYORAN LAMA SELATAN,41212,9142,32070,25146,57216,2021-10-06
3174051001,JAKARTA SELATAN,KEBAYORAN LAMA,KEBAYORAN LAMA UTARA,42422,10653,31769,24439,56208,2021-10-06
3174011004,JAKARTA SELATAN,TEBET,KEBON BARU,35165,8223,26942,20898,47840,2021-10-06
3172021005,JAKARTA UTARA,TANJUNG PRIOK,KEBON BAWANG,50952,12181,38771,30189,68960,2021-10-06
3173051001,JAKARTA BARAT,KEBON JERUK,KEBON JERUK,53887,13968,39919,30603,70522,2021-10-06
3171071006,JAKARTA PUSAT,TANAH ABANG,KEBON KACANG,21531,6042,15489,11439,26928,2021-10-06
3171011005,JAKARTA PUSAT,GAMBIR,KEBON KELAPA,10163,2341,7822,6139,13961,2021-10-06
3171031002,JAKARTA PUSAT,KEMAYORAN,KEBON KOSONG,30019,7425,22594,17172,39766,2021-10-06
3175011005,JAKARTA TIMUR,MATRAMAN,KEBON MANGGIS,16490,3801,12689,9804,22493,2021-10-06
3171071005,JAKARTA PUSAT,TANAH ABANG,KEBON MELATI,32206,9744,22462,15382,37844,2021-10-06
3175081003,JAKARTA TIMUR,MAKASAR,KEBON PALA,46614,10988,35626,27805,63431,2021-10-06
3171061005,JAKARTA PUSAT,MENTENG,KEBON SIRIH,12299,3047,9252,6913,16165,2021-10-06
3173011004,JAKARTA BARAT,CENGKARENG,KEDAUNG KALI ANGKE,32612,7324,25288,19913,45201,2021-10-06
3173051007,JAKARTA BARAT,KEBON JERUK,KEDOYA SELATAN,32165,7160,25005,19601,44606,2021-10-06
3173051006,JAKARTA BARAT,KEBON JERUK,KEDOYA UTARA,45740,10151,35589,28899,64488,2021-10-06
3173051004,JAKARTA BARAT,KEBON JERUK,KELAPA DUA,23565,5933,17632,13851,31483,2021-10-06
3175091003,JAKARTA TIMUR,CIRACAS,KELAPA DUA WETAN,46875,9667,37208,29424,66632,2021-10-06
3172061003,JAKARTA UTARA,KELAPA GADING,KELAPA GADING BARAT,35717,7068,28649,24835,53484,2021-10-06
3172061001,JAKARTA UTARA,KELAPA GADING,KELAPA GADING TIMUR,33592,5885,27707,24527,52234,2021-10-06
3173071005,JAKARTA BARAT,PALMERAH,KEMANGGISAN,32139,7319,24820,19318,44138,2021-10-06
3171031001,JAKARTA PUSAT,KEMAYORAN,KEMAYORAN,20708,4960,15748,12292,28040,2021-10-06
3173081006,JAKARTA BARAT,KEMBANGAN,KEMBANGAN SELATAN,27130,6612,20518,16917,37435,2021-10-06
3173081001,JAKARTA BARAT,KEMBANGAN,KEMBANGAN UTARA,54451,13787,40664,31990,72654,2021-10-06
3171041002,JAKARTA PUSAT,SENEN,KENARI,9579,2178,7401,5956,13357,2021-10-06
3173041005,JAKARTA BARAT,TAMBORA,KERENDANG,19973,4920,15053,11358,26411,2021-10-06
3175071003,JAKARTA TIMUR,DUREN SAWIT,KLENDER,69978,19052,50926,37882,88808,2021-10-06
3172031001,JAKARTA UTARA,KOJA,KOJA,28175,7419,20756,15732,36488,2021-10-06
3173071006,JAKARTA BARAT,PALMERAH,KOTA BAMBU SELATAN,21158,5279,15879,11702,27581,2021-10-06
3173071003,JAKARTA BARAT,PALMERAH,KOTA BAMBU UTARA,24995,6378,18617,13592,32209,2021-10-06
3171041004,JAKARTA PUSAT,SENEN,KRAMAT,28835,7894,20941,14883,35824,2021-10-06
3175041001,JAKARTA TIMUR,KRAMAT JATI,KRAMAT JATI,34144,8840,25304,19323,44627,2021-10-06
3174071003,JAKARTA SELATAN,KEBAYORAN BARU,KRAMAT PELA,14413,3219,11194,8912,20106,2021-10-06
3173031002,JAKARTA BARAT,TAMAN SARI,KRUKUT,19244,4498,14746,11191,25937,2021-10-06
3174031005,JAKARTA SELATAN,MAMPANG PRAPATAN,KUNINGAN BARAT,12785,2807,9978,7697,17675,2021-10-06
3174021008,JAKARTA SELATAN,SETIA BUDI,KUNINGAN TIMUR,6008,1443,4565,3702,8267,2021-10-06
3171041005,JAKARTA PUSAT,SENEN,KWITANG,15486,4042,11444,8782,20226,2021-10-06
3172031003,JAKARTA UTARA,KOJA,LAGOA,59065,16296,42769,31756,74525,2021-10-06
3174061002,JAKARTA SELATAN,CILANDAK,LEBAK BULUS,37626,8552,29074,23261,52335,2021-10-06
3174091004,JAKARTA SELATAN,JAGAKARSA,LENTENG AGUNG,53946,12310,41636,30946,72582,2021-10-06
3175101007,JAKARTA TIMUR,CIPAYUNG,LUBANG BUAYA,63547,14173,49374,38565,87939,2021-10-06
3175081001,JAKARTA TIMUR,MAKASAR,MAKASAR,34390,8052,26338,21178,47516,2021-10-06
3175071006,JAKARTA TIMUR,DUREN SAWIT,MALAKA JAYA,30927,6819,24108,19365,43473,2021-10-06
3175071005,JAKARTA TIMUR,DUREN SAWIT,MALAKA SARI,27530,5707,21823,17675,39498,2021-10-06
3174031001,JAKARTA SELATAN,MAMPANG PRAPATAN,MAMPANG PRAPATAN,18159,4542,13617,10560,24177,2021-10-06
3173031005,JAKARTA BARAT,TAMAN SARI,MANGGA BESAR,7707,1498,6209,5102,11311,2021-10-06
3171021005,JAKARTA PUSAT,SAWAH BESAR,MANGGA DUA SELATAN,27442,6494,20948,16532,37480,2021-10-06
3174011007,JAKARTA SELATAN,TEBET,MANGGARAI,28373,6038,22335,16781,39116,2021-10-06
3174011006,JAKARTA SELATAN,TEBET,MANGGARAI SELATAN,23075,4960,18115,14288,32403,2021-10-06
3173031003,JAKARTA BARAT,TAMAN SARI,MAPHAR,16461,3783,12678,10024,22702,2021-10-06
3172041003,JAKARTA UTARA,CILINCING,MARUNDA,28943,7571,21372,15267,36639,2021-10-06
3174071001,JAKARTA SELATAN,KEBAYORAN BARU,MELAWAI,2627,574,2053,1820,3873,2021-10-06
3171061001,JAKARTA PUSAT,MENTENG,MENTENG,25624,6662,18962,14083,33045,2021-10-06
3174021005,JAKARTA SELATAN,SETIA BUDI,MENTENG ATAS,27816,6089,21727,16793,38520,2021-10-06
3174011003,JAKARTA SELATAN,TEBET,MENTENG DALAM,36028,8358,27670,21658,49328,2021-10-06
3173081003,JAKARTA BARAT,KEMBANGAN,MERUYA SELATAN,32130,7869,24261,18976,43237,2021-10-06
3173081002,JAKARTA BARAT,KEMBANGAN,MERUYA UTARA,43752,10774,32978,26906,59884,2021-10-06
3175101004,JAKARTA TIMUR,CIPAYUNG,MUNJUL,23871,5200,18671,14705,33376,2021-10-06
3172051002,JAKARTA UTARA,PADEMANGAN,PADEMANGAN BARAT,74240,19967,54273,41301,95574,2021-10-06
3172051001,JAKARTA UTARA,PADEMANGAN,PADEMANGAN TIMUR,37736,7758,29978,24694,54672,2021-10-06
3175011004,JAKARTA TIMUR,MATRAMAN,PAL MERIAM,19769,5115,14654,11118,25772,2021-10-06
3173071001,JAKARTA BARAT,PALMERAH,PALMERAH,63011,16088,46923,35717,82640,2021-10-06
3174081001,JAKARTA SELATAN,PANCORAN,PANCORAN,19421,5052,14369,11225,25594,2021-10-06
3172021003,JAKARTA UTARA,TANJUNG PRIOK,PAPANGGO,39097,9138,29959,23376,53335,2021-10-06
3171021001,JAKARTA PUSAT,SAWAH BESAR,PASAR BARU,12035,2617,9418,8021,17439,2021-10-06
3174021006,JAKARTA SELATAN,SETIA BUDI,PASAR MANGGIS,26752,6446,20306,15772,36078,2021-10-06
3174041001,JAKARTA SELATAN,PASAR MINGGU,PASAR MINGGU,24821,5602,19219,15279,34498,2021-10-06
3171041003,JAKARTA PUSAT,SENEN,PASEBAN,23533,5876,17657,13541,31198,2021-10-06
3173061005,JAKARTA BARAT,KALI DERES,PEGADUNGAN,75587,17783,57804,47452,105256,2021-10-06
3171061002,JAKARTA PUSAT,MENTENG,PEGANGSAAN,23455,5990,17465,12492,29957,2021-10-06
3172061002,JAKARTA UTARA,KELAPA GADING,PEGANGSAAN DUA,49976,9318,40658,35322,75980,2021-10-06
3172011004,JAKARTA UTARA,PENJARINGAN,PEJAGALAN,74578,18088,56490,45642,102132,2021-10-06
3174041006,JAKARTA SELATAN,PASAR MINGGU,PEJATEN BARAT,37346,9131,28215,22219,50434,2021-10-06
3174041005,JAKARTA SELATAN,PASAR MINGGU,PEJATEN TIMUR,57656,15340,42316,32404,74720,2021-10-06
3175051005,JAKARTA TIMUR,PASAR REBO,PEKAYON,43250,9380,33870,26383,60253,2021-10-06
3173041009,JAKARTA BARAT,TAMBORA,PEKOJAN,23587,5315,18272,14377,32649,2021-10-06
3174031003,JAKARTA SELATAN,MAMPANG PRAPATAN,PELA MAMPANG,43522,10452,33070,25994,59064,2021-10-06
3174081005,JAKARTA SELATAN,PANCORAN,PENGADEGAN,21478,4636,16842,12879,29721,2021-10-06
3175061003,JAKARTA TIMUR,CAKUNG,PENGGILINGAN,99255,27148,72107,53661,125768,2021-10-06
3172011001,JAKARTA UTARA,PENJARINGAN,PENJARINGAN,88308,25780,62528,45478,108006,2021-10-06
3174101001,JAKARTA SELATAN,PESANGGRAHAN,PESANGGRAHAN,27545,5662,21883,17636,39519,2021-10-06
3171071004,JAKARTA PUSAT,TANAH ABANG,PETAMBURAN,33271,10109,23162,16076,39238,2021-10-06
3174071008,JAKARTA SELATAN,KEBAYORAN BARU,PETOGOGAN,11499,2709,8790,6882,15672,2021-10-06
3171011004,JAKARTA PUSAT,GAMBIR,PETOJO SELATAN,14692,3810,10882,8706,19588,2021-10-06
3171011003,JAKARTA PUSAT,GAMBIR,PETOJO UTARA,17458,4344,13114,10133,23247,2021-10-06
3174101004,JAKARTA SELATAN,PESANGGRAHAN,PETUKANGAN SELATAN,37187,9071,28116,22375,50491,2021-10-06
3174101003,JAKARTA SELATAN,PESANGGRAHAN,PETUKANGAN UTARA,53716,13676,40040,31179,71219,2021-10-06
3175081002,JAKARTA TIMUR,MAKASAR,PINANG RANTI,27198,6908,20290,15864,36154,2021-10-06
3173031008,JAKARTA BARAT,TAMAN SARI,PINANGSIA,10729,2327,8402,6644,15046,2021-10-06
3175011001,JAKARTA TIMUR,MATRAMAN,PISANGAN BARU,31776,7940,23836,17491,41327,2021-10-06
3175021002,JAKARTA TIMUR,PULO GADUNG,PISANGAN TIMUR,41011,9272,31739,25240,56979,2021-10-06
3172011005,JAKARTA UTARA,PENJARINGAN,PLUIT,47783,10623,37160,31234,68394,2021-10-06
3175071002,JAKARTA TIMUR,DUREN SAWIT,PONDOK BAMBU,61550,15736,45814,35443,81257,2021-10-06
3175071004,JAKARTA TIMUR,DUREN SAWIT,PONDOK KELAPA,72015,16657,55358,44636,99994,2021-10-06
3175071007,JAKARTA TIMUR,DUREN SAWIT,PONDOK KOPI,35367,8498,26869,19758,46627,2021-10-06
3174061003,JAKARTA SELATAN,CILANDAK,PONDOK LABU,46464,9559,36905,29914,66819,2021-10-06
3174051002,JAKARTA SELATAN,KEBAYORAN LAMA,PONDOK PINANG,56169,12593,43576,34300,77876,2021-10-06
3175101003,JAKARTA TIMUR,CIPAYUNG,PONDOK RANGGON,25574,6029,19545,15408,34953,2021-10-06
3101011003,KAB.ADM.KEP.SERIBU,KEP. SERIBU UTARA,PULAU HARAPAN,2060,260,1800,1475,3275,2021-10-06
3101011002,KAB.ADM.KEP.SERIBU,KEP. SERIBU UTARA,PULAU KELAPA,5528,675,4853,3776,8629,2021-10-06
3101011001,KAB.ADM.KEP.SERIBU,KEP. SERIBU UTARA,PULAU PANGGANG,5450,569,4881,4103,8984,2021-10-06
3101021003,KAB.ADM.KEP.SERIBU,KEP. SERIBU SELATAN,PULAU PARI,2765,222,2543,2292,4835,2021-10-06
3101021002,KAB.ADM.KEP.SERIBU,KEP. SERIBU SELATAN,PULAU TIDUNG,4553,447,4106,3629,7735,2021-10-06
3101021001,KAB.ADM.KEP.SERIBU,KEP. SERIBU SELATAN,PULAU UNTUNG JAWA,1941,211,1730,1573,3303,2021-10-06
3174071007,JAKARTA SELATAN,KEBAYORAN BARU,PULO,5835,1156,4679,4000,8679,2021-10-06
3175021001,JAKARTA TIMUR,PULO GADUNG,PULO GADUNG,34422,8584,25838,20204,46042,2021-10-06
3175061005,JAKARTA TIMUR,CAKUNG,PULO GEBANG,97301,22248,75053,56710,131763,2021-10-06
3174041004,JAKARTA SELATAN,PASAR MINGGU,RAGUNAN,39616,8908,30708,24453,55161,2021-10-06
3175091005,JAKARTA TIMUR,CIRACAS,RAMBUTAN,36771,10064,26707,19953,46660,2021-10-06
3172031006,JAKARTA UTARA,KOJA,RAWA BADAK SELATAN,42179,11651,30528,22392,52920,2021-10-06
3172031004,JAKARTA UTARA,KOJA,RAWA BADAK UTARA,34408,9109,25299,19010,44309,2021-10-06
3174071005,JAKARTA SELATAN,KEBAYORAN BARU,RAWA BARAT,5625,1112,4513,3745,8258,2021-10-06
3173011003,JAKARTA BARAT,CENGKARENG,RAWA BUAYA,63799,15630,48169,35650,83819,2021-10-06
3175031004,JAKARTA TIMUR,JATINEGARA,RAWA BUNGA,21434,5975,15459,11642,27101,2021-10-06
3174081003,JAKARTA SELATAN,PANCORAN,RAWA JATI,20509,4705,15804,11930,27734,2021-10-06
3175061002,JAKARTA TIMUR,CAKUNG,RAWA TERATE,24637,5321,19316,15025,34341,2021-10-06
3175021005,JAKARTA TIMUR,PULO GADUNG,RAWAMANGUN,37612,8834,28778,22847,51625,2021-10-06
3171051003,JAKARTA PUSAT,CEMPAKA PUTIH,RAWASARI,21967,5340,16627,13241,29868,2021-10-06
3173041010,JAKARTA BARAT,TAMBORA,ROA MALAKA,3484,671,2813,2377,5190,2021-10-06
3172041006,JAKARTA UTARA,CILINCING,ROROTAN,41668,9863,31805,24079,55884,2021-10-06
3174071004,JAKARTA SELATAN,KEBAYORAN BARU,SELONG,2842,596,2246,1958,4204,2021-10-06
3173061002,JAKARTA BARAT,KALI DERES,SEMANAN,71354,18688,52666,40259,92925,2021-10-06
3172041007,JAKARTA UTARA,CILINCING,SEMPER BARAT,68587,15834,52753,41554,94307,2021-10-06
3172041005,JAKARTA UTARA,CILINCING,SEMPER TIMUR,36267,8958,27309,20780,48089,2021-10-06
3174071006,JAKARTA SELATAN,KEBAYORAN BARU,SENAYAN,2771,730,2041,1631,3672,2021-10-06
3171041001,JAKARTA PUSAT,SENEN,SENEN,6804,1678,5126,4125,9251,2021-10-06
3171031004,JAKARTA PUSAT,KEMAYORAN,SERDANG,29668,7030,22638,17693,40331,2021-10-06
3174021001,JAKARTA SELATAN,SETIA BUDI,SETIA BUDI,3023,722,2301,1837,4138,2021-10-06
3175101005,JAKARTA TIMUR,CIPAYUNG,SETU,20572,5113,15459,11806,27265,2021-10-06
3173071002,JAKARTA BARAT,PALMERAH,SLIPI,16591,3642,12949,10228,23177,2021-10-06
3173081004,JAKARTA BARAT,KEMBANGAN,SRENGSENG,45523,11867,33656,26634,60290,2021-10-06
3174091002,JAKARTA SELATAN,JAGAKARSA,SRENGSENG SAWAH,58196,11576,46620,37322,83942,2021-10-06
3173051003,JAKARTA BARAT,KEBON JERUK,SUKABUMI SELATAN,37033,10021,27012,19720,46732,2021-10-06
3173051002,JAKARTA BARAT,KEBON JERUK,SUKABUMI UTARA,38290,10634,27656,20217,47873,2021-10-06
3172041002,JAKARTA UTARA,CILINCING,SUKAPURA,53949,14171,39778,31025,70803,2021-10-06
3171031007,JAKARTA PUSAT,KEMAYORAN,SUMUR BATU,22717,5438,17279,13777,31056,2021-10-06
3172021004,JAKARTA UTARA,TANJUNG PRIOK,SUNGAI BAMBU,29876,7149,22727,17776,40503,2021-10-06
3172021006,JAKARTA UTARA,TANJUNG PRIOK,SUNTER AGUNG,71805,14424,57381,47776,105157,2021-10-06
3172021002,JAKARTA UTARA,TANJUNG PRIOK,SUNTER JAYA,63031,13465,49566,40809,90375,2021-10-06
3175091004,JAKARTA TIMUR,CIRACAS,SUSUKAN,38257,8509,29748,23419,53167,2021-10-06
3173031001,JAKARTA BARAT,TAMAN SARI,TAMAN SARI,14348,3143,11205,9100,20305,2021-10-06
3173041001,JAKARTA BARAT,TAMBORA,TAMBORA,10204,2631,7573,5797,13370,2021-10-06
3173041004,JAKARTA BARAT,TAMBORA,TANAH SEREAL,26387,5224,21163,16775,37938,2021-10-06
3171081004,JAKARTA PUSAT,JOHAR BARU,TANAH TINGGI,37693,8124,29569,22622,52191,2021-10-06
3173031004,JAKARTA BARAT,TAMAN SARI,TANGKI,13324,2691,10633,8349,18982,2021-10-06
3174091005,JAKARTA SELATAN,JAGAKARSA,TANJUNG BARAT,39770,8998,30772,23912,54684,2021-10-06
3173021005,JAKARTA BARAT,GROGOL PETAMBURAN,TANJUNG DUREN SELATAN,25337,5668,19669,16199,35868,2021-10-06
3173021002,JAKARTA BARAT,GROGOL PETAMBURAN,TANJUNG DUREN UTARA,17010,3453,13557,11396,24953,2021-10-06
3172021001,JAKARTA UTARA,TANJUNG PRIOK,TANJUNG PRIOK,34588,8193,26395,20535,46930,2021-10-06
3174011002,JAKARTA SELATAN,TEBET,TEBET BARAT,21194,4137,17057,14092,31149,2021-10-06
3174011001,JAKARTA SELATAN,TEBET,TEBET TIMUR,18199,3457,14742,12425,27167,2021-10-06
3173061003,JAKARTA BARAT,KALI DERES,TEGAL ALUR,83647,20776,62871,48866,111737,2021-10-06
3174031004,JAKARTA SELATAN,MAMPANG PRAPATAN,TEGAL PARANG,32401,8674,23727,17077,40804,2021-10-06
3173021003,JAKARTA BARAT,GROGOL PETAMBURAN,TOMANG,29605,6371,23234,18673,41907,2021-10-06
3172031005,JAKARTA UTARA,KOJA,TUGU SELATAN,39122,10103,29019,21776,50795,2021-10-06
3172031002,JAKARTA UTARA,KOJA,TUGU UTARA,67670,18567,49103,36314,85417,2021-10-06
3175061006,JAKARTA TIMUR,CAKUNG,UJUNG MENTENG,29934,6061,23873,19029,42902,2021-10-06
3174101005,JAKARTA SELATAN,PESANGGRAHAN,ULUJAMI,40544,10837,29707,22787,52494,2021-10-06
3175011006,JAKARTA TIMUR,MATRAMAN,UTAN KAYU SELATAN,33511,7400,26111,20067,46178,2021-10-06
3175011002,JAKARTA TIMUR,MATRAMAN,UTAN KAYU UTARA,28169,7038,21131,16213,37344,2021-10-06
3171031008,JAKARTA PUSAT,KEMAYORAN,UTAN PANJANG,29208,7337,21871,16493,38364,2021-10-06
3172021007,JAKARTA UTARA,TANJUNG PRIOK,WARAKAS,44401,9736,34665,26283,60948,2021-10-06
3173021007,JAKARTA BARAT,GROGOL PETAMBURAN,WIJAYA KUSUMA,38934,9773,29161,23027,52188,2021-10-06
3172051003,JAKARTA UTARA,PADEMANGAN,ANCOL,23947,6479,17468,13622,31090,2021-10-07
3173041007,JAKARTA BARAT,TAMBORA,ANGKE,29381,7338,22043,16829,38872,2021-10-07
3175041005,JAKARTA TIMUR,KRAMAT JATI,BALE KAMBANG,29074,8337,20737,14877,35614,2021-10-07
3175031003,JAKARTA TIMUR,JATINEGARA,BALI MESTER,9752,2398,7354,5809,13163,2021-10-07
3175101006,JAKARTA TIMUR,CIPAYUNG,BAMBU APUS,26285,5713,20572,15672,36244,2021-10-07
3174031002,JAKARTA SELATAN,MAMPANG PRAPATAN,BANGKA,21566,5533,16033,12420,28453,2021-10-07
3175051002,JAKARTA TIMUR,PASAR REBO,BARU,23886,4685,19201,15780,34981,2021-10-07
3175041004,JAKARTA TIMUR,KRAMAT JATI,BATU AMPAR,47898,13569,34329,25436,59765,2021-10-07
3171071002,JAKARTA PUSAT,TANAH ABANG,BENDUNGAN HILIR,21494,5020,16474,13078,29552,2021-10-07
3175031002,JAKARTA TIMUR,JATINEGARA,BIDARA CINA,36689,10203,26486,19651,46137,2021-10-07
3174101002,JAKARTA SELATAN,PESANGGRAHAN,BINTARO,53098,12429,40669,32765,73434,2021-10-07
3174011005,JAKARTA SELATAN,TEBET,BUKIT DURI,34183,8319,25864,19940,45804,2021-10-07
3171041006,JAKARTA PUSAT,SENEN,BUNGUR,18144,4480,13664,10797,24461,2021-10-07
3175061007,JAKARTA TIMUR,CAKUNG,CAKUNG BARAT,57724,13638,44086,34572,78658,2021-10-07
3175061004,JAKARTA TIMUR,CAKUNG,CAKUNG TIMUR,58287,13404,44883,35157,80040,2021-10-07
3175041007,JAKARTA TIMUR,KRAMAT JATI,CAWANG,32762,8442,24320,18123,42443,2021-10-07
3175101008,JAKARTA TIMUR,CIPAYUNG,CEGER,18932,4326,14606,11475,26081,2021-10-07
3171031006,JAKARTA PUSAT,KEMAYORAN,CEMPAKA BARU,32581,8011,24570,18255,42825,2021-10-07
3171051002,JAKARTA PUSAT,CEMPAKA PUTIH,CEMPAKA PUTIH BARAT,35885,8913,26972,21428,48400,2021-10-07
3171051001,JAKARTA PUSAT,CEMPAKA PUTIH,CEMPAKA PUTIH TIMUR,24292,5740,18552,15168,33720,2021-10-07
3173011001,JAKARTA BARAT,CENGKARENG,CENGKARENG BARAT,66284,15895,50389,39804,90193,2021-10-07
3173011006,JAKARTA BARAT,CENGKARENG,CENGKARENG TIMUR,81027,18851,62176,47674,109850,2021-10-07
3175091002,JAKARTA TIMUR,CIRACAS,CIBUBUR,66364,13520,52844,41743,94587,2021-10-07
3171011002,JAKARTA PUSAT,GAMBIR,CIDENG,15390,3399,11991,9899,21890,2021-10-07
3174091003,JAKARTA SELATAN,JAGAKARSA,CIGANJUR,38497,8244,30253,22895,53148,2021-10-07
3175051003,JAKARTA TIMUR,PASAR REBO,CIJANTUNG,41419,9004,32415,25416,57831,2021-10-07
3171061003,JAKARTA PUSAT,MENTENG,CIKINI,8274,1712,6562,4772,11334,2021-10-07
3174081006,JAKARTA SELATAN,PANCORAN,CIKOKO,10547,2181,8366,6756,15122,2021-10-07
3174061001,JAKARTA SELATAN,CILANDAK,CILANDAK BARAT,51752,11296,40456,32945,73401,2021-10-07
3174041003,JAKARTA SELATAN,PASAR MINGGU,CILANDAK TIMUR,25145,5589,19556,15679,35235,2021-10-07
3175101002,JAKARTA TIMUR,CIPAYUNG,CILANGKAP,27635,5939,21696,16933,38629,2021-10-07
3175041006,JAKARTA TIMUR,KRAMAT JATI,CILILITAN,40181,10537,29644,22314,51958,2021-10-07
3172041001,JAKARTA UTARA,CILINCING,CILINCING,43609,11953,31656,23107,54763,2021-10-07
3175101001,JAKARTA TIMUR,CIPAYUNG,CIPAYUNG,26104,5317,20787,16858,37645,2021-10-07
3174091006,JAKARTA SELATAN,JAGAKARSA,CIPEDAK,38303,8129,30174,23750,53924,2021-10-07
3174061005,JAKARTA SELATAN,CILANDAK,CIPETE SELATAN,26704,6010,20694,16817,37511,2021-10-07
3174071010,JAKARTA SELATAN,KEBAYORAN BARU,CIPETE UTARA,34102,7734,26368,20193,46561,2021-10-07
3175021003,JAKARTA TIMUR,PULO GADUNG,CIPINANG,39306,8942,30364,23479,53843,2021-10-07
3175031007,JAKARTA TIMUR,JATINEGARA,CIPINANG BESAR SELATAN,35212,9644,25568,18438,44006,2021-10-07
3175031008,JAKARTA TIMUR,JATINEGARA,CIPINANG BESAR UTARA,45319,12498,32821,23623,56444,2021-10-07
3175031005,JAKARTA TIMUR,JATINEGARA,CIPINANG CEMPEDAK,32824,8253,24571,19095,43666,2021-10-07
3175081005,JAKARTA TIMUR,MAKASAR,CIPINANG MELAYU,42308,9782,32526,25748,58274,2021-10-07
3175031006,JAKARTA TIMUR,JATINEGARA,CIPINANG MUARA,55243,14114,41129,31187,72316,2021-10-07
3174051003,JAKARTA SELATAN,KEBAYORAN LAMA,CIPULIR,39937,9811,30126,22389,52515,2021-10-07
3175091001,JAKARTA TIMUR,CIRACAS,CIRACAS,64594,13854,50740,39272,90012,2021-10-07
3175041003,JAKARTA TIMUR,KRAMAT JATI,DUKUH,24609,5483,19126,14711,33837,2021-10-07
3175071001,JAKARTA TIMUR,DUREN SAWIT,DUREN SAWIT,61160,15492,45668,35168,80836,2021-10-07
3174081004,JAKARTA SELATAN,PANCORAN,DUREN TIGA,28319,6616,21703,16047,37750,2021-10-07
3173051005,JAKARTA BARAT,KEBON JERUK,DURI KEPA,60138,13586,46552,38339,84891,2021-10-07
3173011002,JAKARTA BARAT,CENGKARENG,DURI KOSAMBI,77923,20329,57594,42972,100566,2021-10-07
3171011006,JAKARTA PUSAT,GAMBIR,DURI PULO,19610,4759,14851,11245,26096,2021-10-07
3173041011,JAKARTA BARAT,TAMBORA,DURI SELATAN,14259,3050,11209,9027,20236,2021-10-07
3173041003,JAKARTA BARAT,TAMBORA,DURI UTARA,19844,4514,15330,11868,27198,2021-10-07
3171081003,JAKARTA PUSAT,JOHAR BARU,GALUR,18243,4137,14106,10868,24974,2021-10-07
3171011001,JAKARTA PUSAT,GAMBIR,GAMBIR,2191,522,1669,1363,3032,2021-10-07
3174061004,JAKARTA SELATAN,CILANDAK,GANDARIA SELATAN,22119,5123,16996,13437,30433,2021-10-07
3174071009,JAKARTA SELATAN,KEBAYORAN BARU,GANDARIA UTARA,39922,9489,30433,23734,54167,2021-10-07
3175051001,JAKARTA TIMUR,PASAR REBO,GEDONG,35755,8274,27481,21725,49206,2021-10-07
3171071001,JAKARTA PUSAT,TANAH ABANG,GELORA,3127,716,2411,1932,4343,2021-10-07
3173031007,JAKARTA BARAT,TAMAN SARI,GLODOK,7837,1482,6355,5488,11843,2021-10-07
3171061004,JAKARTA PUSAT,MENTENG,GONDANGDIA,4100,1007,3093,2731,5824,2021-10-07
3173021001,JAKARTA BARAT,GROGOL PETAMBURAN,GROGOL,16876,3916,12960,10270,23230,2021-10-07
3174051005,JAKARTA SELATAN,KEBAYORAN LAMA,GROGOL SELATAN,44251,10864,33387,25685,59072,2021-10-07
3174051004,JAKARTA SELATAN,KEBAYORAN LAMA,GROGOL UTARA,42494,10381,32113,25118,57231,2021-10-07
3174021007,JAKARTA SELATAN,SETIA BUDI,GUNTUR,3985,893,3092,2621,5713,2021-10-07
3174071002,JAKARTA SELATAN,KEBAYORAN BARU,GUNUNG,9436,2035,7401,6105,13506,2021-10-07
3171031005,JAKARTA PUSAT,KEMAYORAN,GUNUNG SAHARI SELATAN,19199,4554,14645,11549,26194,2021-10-07
3171021004,JAKARTA PUSAT,SAWAH BESAR,GUNUNG SAHARI UTARA,16650,3385,13265,11192,24457,2021-10-07
3175081004,JAKARTA TIMUR,MAKASAR,HALIM PERDANA KUSUMAH,28363,4408,23955,21115,45070,2021-10-07
3171031003,JAKARTA PUSAT,KEMAYORAN,HARAPAN MULIA,22557,5435,17122,13047,30169,2021-10-07
3174091001,JAKARTA SELATAN,JAGAKARSA,JAGAKARSA,62389,13624,48765,38351,87116,2021-10-07
3175021007,JAKARTA TIMUR,PULO GADUNG,JATI,32757,7360,25397,20687,46084,2021-10-07
3174041002,JAKARTA SELATAN,PASAR MINGGU,JATI PADANG,37502,9107,28395,22447,50842,2021-10-07
3173071004,JAKARTA BARAT,PALMERAH,JATI PULO,28738,6678,22060,16625,38685,2021-10-07
3175061001,JAKARTA TIMUR,CAKUNG,JATINEGARA,84160,21173,62987,48887,111874,2021-10-07
3175021004,JAKARTA TIMUR,PULO GADUNG,JATINEGARA KAUM,24632,5508,19124,14520,33644,2021-10-07
3173021004,JAKARTA BARAT,GROGOL PETAMBURAN,JELAMBAR,30266,6548,23718,19255,42973,2021-10-07
3173021006,JAKARTA BARAT,GROGOL PETAMBURAN,JELAMBAR BARU,38246,8529,29717,24045,53762,2021-10-07
3173041006,JAKARTA BARAT,TAMBORA,JEMBATAN BESI,29314,8480,20834,14962,35796,2021-10-07
3173041008,JAKARTA BARAT,TAMBORA,JEMBATAN LIMA,21021,5761,15260,11278,26538,2021-10-07
3173081005,JAKARTA BARAT,KEMBANGAN,JOGLO,40839,9696,31143,24757,55900,2021-10-07
3171081001,JAKARTA PUSAT,JOHAR BARU,JOHAR BARU,37488,8031,29457,23361,52818,2021-10-07
3173041002,JAKARTA BARAT,TAMBORA,KALI ANYAR,23856,5739,18117,13456,31573,2021-10-07
3172041004,JAKARTA UTARA,CILINCING,KALIBARU,67684,21666,46018,31307,77325,2021-10-07
3174081002,JAKARTA SELATAN,PANCORAN,KALIBATA,41994,11363,30631,22236,52867,2021-10-07
3173061001,JAKARTA BARAT,KALI DERES,KALIDERES,72447,17591,54856,44050,98906,2021-10-07
3175051004,JAKARTA TIMUR,PASAR REBO,KALISARI,43212,9227,33985,26803,60788,2021-10-07
3173061004,JAKARTA BARAT,KALI DERES,KAMAL,53783,14961,38822,29207,68029,2021-10-07
3172011002,JAKARTA UTARA,PENJARINGAN,KAMAL MUARA,12930,2477,10453,8660,19113,2021-10-07
3171071007,JAKARTA PUSAT,TANAH ABANG,KAMPUNG BALI,11358,2839,8519,6012,14531,2021-10-07
3175031001,JAKARTA TIMUR,JATINEGARA,KAMPUNG MELAYU,25717,7370,18347,13334,31681,2021-10-07
3171081002,JAKARTA PUSAT,JOHAR BARU,KAMPUNG RAWA,21237,4002,17235,13054,30289,2021-10-07
3175041002,JAKARTA TIMUR,KRAMAT JATI,KAMPUNG TENGAH,43993,12627,31366,23165,54531,2021-10-07
3173011005,JAKARTA BARAT,CENGKARENG,KAPUK,134466,37359,97107,72938,170045,2021-10-07
3172011003,JAKARTA UTARA,PENJARINGAN,KAPUK MUARA,35781,7797,27984,23629,51613,2021-10-07
3171021002,JAKARTA PUSAT,SAWAH BESAR,KARANG ANYAR,25761,5742,20019,15781,35800,2021-10-07
3174021004,JAKARTA SELATAN,SETIA BUDI,KARET,9623,2161,7462,5799,13261,2021-10-07
3174021003,JAKARTA SELATAN,SETIA BUDI,KARET KUNINGAN,16055,3626,12429,9978,22407,2021-10-07
3174021002,JAKARTA SELATAN,SETIA BUDI,KARET SEMANGGI,2770,606,2164,1830,3994,2021-10-07
3171071003,JAKARTA PUSAT,TANAH ABANG,KARET TENGSIN,19271,4392,14879,11250,26129,2021-10-07
3171021003,JAKARTA PUSAT,SAWAH BESAR,KARTINI,22292,5019,17273,13854,31127,2021-10-07
3175011003,JAKARTA TIMUR,MATRAMAN,KAYU MANIS,25284,6331,18953,13861,32814,2021-10-07
3175021006,JAKARTA TIMUR,PULO GADUNG,KAYU PUTIH,40696,8903,31793,26304,58097,2021-10-07
3173031006,JAKARTA BARAT,TAMAN SARI,KEAGUNGAN,17387,4049,13338,10303,23641,2021-10-07
3174041007,JAKARTA SELATAN,PASAR MINGGU,KEBAGUSAN,44552,10690,33862,25557,59419,2021-10-07
3174051006,JAKARTA SELATAN,KEBAYORAN LAMA,KEBAYORAN LAMA SELATAN,41212,9086,32126,25226,57352,2021-10-07
3174051001,JAKARTA SELATAN,KEBAYORAN LAMA,KEBAYORAN LAMA UTARA,42422,10584,31838,24500,56338,2021-10-07
3174011004,JAKARTA SELATAN,TEBET,KEBON BARU,35165,8146,27019,20982,48001,2021-10-07
3172021005,JAKARTA UTARA,TANJUNG PRIOK,KEBON BAWANG,50952,12109,38843,30281,69124,2021-10-07
3173051001,JAKARTA BARAT,KEBON JERUK,KEBON JERUK,53887,13843,40044,30722,70766,2021-10-07
3171071006,JAKARTA PUSAT,TANAH ABANG,KEBON KACANG,21531,6007,15524,11486,27010,2021-10-07
3171011005,JAKARTA PUSAT,GAMBIR,KEBON KELAPA,10163,2327,7836,6159,13995,2021-10-07
3171031002,JAKARTA PUSAT,KEMAYORAN,KEBON KOSONG,30019,7346,22673,17236,39909,2021-10-07
3175011005,JAKARTA TIMUR,MATRAMAN,KEBON MANGGIS,16490,3771,12719,9850,22569,2021-10-07
3171071005,JAKARTA PUSAT,TANAH ABANG,KEBON MELATI,32206,9702,22504,15463,37967,2021-10-07
3175081003,JAKARTA TIMUR,MAKASAR,KEBON PALA,46614,10922,35692,27864,63556,2021-10-07
3171061005,JAKARTA PUSAT,MENTENG,KEBON SIRIH,12299,3036,9263,6927,16190,2021-10-07
3173011004,JAKARTA BARAT,CENGKARENG,KEDAUNG KALI ANGKE,32612,7294,25318,19960,45278,2021-10-07
3173051007,JAKARTA BARAT,KEBON JERUK,KEDOYA SELATAN,32165,7101,25064,19660,44724,2021-10-07
3173051006,JAKARTA BARAT,KEBON JERUK,KEDOYA UTARA,45740,10110,35630,28969,64599,2021-10-07
3173051004,JAKARTA BARAT,KEBON JERUK,KELAPA DUA,23565,5837,17728,13915,31643,2021-10-07
3175091003,JAKARTA TIMUR,CIRACAS,KELAPA DUA WETAN,46875,9568,37307,29531,66838,2021-10-07
3172061003,JAKARTA UTARA,KELAPA GADING,KELAPA GADING BARAT,35717,6996,28721,24908,53629,2021-10-07
3172061001,JAKARTA UTARA,KELAPA GADING,KELAPA GADING TIMUR,33592,5818,27774,24588,52362,2021-10-07
3173071005,JAKARTA BARAT,PALMERAH,KEMANGGISAN,32139,7263,24876,19383,44259,2021-10-07
3171031001,JAKARTA PUSAT,KEMAYORAN,KEMAYORAN,20708,4944,15764,12318,28082,2021-10-07
3173081006,JAKARTA BARAT,KEMBANGAN,KEMBANGAN SELATAN,27130,6588,20542,16960,37502,2021-10-07
3173081001,JAKARTA BARAT,KEMBANGAN,KEMBANGAN UTARA,54451,13712,40739,32102,72841,2021-10-07
3171041002,JAKARTA PUSAT,SENEN,KENARI,9579,2169,7410,5976,13386,2021-10-07
3173041005,JAKARTA BARAT,TAMBORA,KERENDANG,19973,4887,15086,11419,26505,2021-10-07
3175071003,JAKARTA TIMUR,DUREN SAWIT,KLENDER,69978,18940,51038,38031,89069,2021-10-07
3172031001,JAKARTA UTARA,KOJA,KOJA,28175,7368,20807,15785,36592,2021-10-07
3173071006,JAKARTA BARAT,PALMERAH,KOTA BAMBU SELATAN,21158,5253,15905,11737,27642,2021-10-07
3173071003,JAKARTA BARAT,PALMERAH,KOTA BAMBU UTARA,24995,6341,18654,13654,32308,2021-10-07
3171041004,JAKARTA PUSAT,SENEN,KRAMAT,28835,7850,20985,14928,35913,2021-10-07
3175041001,JAKARTA TIMUR,KRAMAT JATI,KRAMAT JATI,34144,8701,25443,19393,44836,2021-10-07
3174071003,JAKARTA SELATAN,KEBAYORAN BARU,KRAMAT PELA,14413,3199,11214,8936,20150,2021-10-07
3173031002,JAKARTA BARAT,TAMAN SARI,KRUKUT,19244,4461,14783,11243,26026,2021-10-07
3174031005,JAKARTA SELATAN,MAMPANG PRAPATAN,KUNINGAN BARAT,12785,2783,10002,7713,17715,2021-10-07
3174021008,JAKARTA SELATAN,SETIA BUDI,KUNINGAN TIMUR,6008,1434,4574,3713,8287,2021-10-07
3171041005,JAKARTA PUSAT,SENEN,KWITANG,15486,4020,11466,8808,20274,2021-10-07
3172031003,JAKARTA UTARA,KOJA,LAGOA,59065,16235,42830,31845,74675,2021-10-07
3174061002,JAKARTA SELATAN,CILANDAK,LEBAK BULUS,37626,8508,29118,23343,52461,2021-10-07
3174091004,JAKARTA SELATAN,JAGAKARSA,LENTENG AGUNG,53946,12169,41777,31054,72831,2021-10-07
3175101007,JAKARTA TIMUR,CIPAYUNG,LUBANG BUAYA,63547,14072,49475,38672,88147,2021-10-07
3175081001,JAKARTA TIMUR,MAKASAR,MAKASAR,34390,8000,26390,21253,47643,2021-10-07
3175071006,JAKARTA TIMUR,DUREN SAWIT,MALAKA JAYA,30927,6710,24217,19468,43685,2021-10-07
3175071005,JAKARTA TIMUR,DUREN SAWIT,MALAKA SARI,27530,5644,21886,17785,39671,2021-10-07
3174031001,JAKARTA SELATAN,MAMPANG PRAPATAN,MAMPANG PRAPATAN,18159,4496,13663,10584,24247,2021-10-07
3173031005,JAKARTA BARAT,TAMAN SARI,MANGGA BESAR,7707,1491,6216,5119,11335,2021-10-07
3171021005,JAKARTA PUSAT,SAWAH BESAR,MANGGA DUA SELATAN,27442,6465,20977,16581,37558,2021-10-07
3174011007,JAKARTA SELATAN,TEBET,MANGGARAI,28373,5977,22396,16840,39236,2021-10-07
3174011006,JAKARTA SELATAN,TEBET,MANGGARAI SELATAN,23075,4918,18157,14339,32496,2021-10-07
3173031003,JAKARTA BARAT,TAMAN SARI,MAPHAR,16461,3754,12707,10052,22759,2021-10-07
3172041003,JAKARTA UTARA,CILINCING,MARUNDA,28943,7525,21418,15334,36752,2021-10-07
3174071001,JAKARTA SELATAN,KEBAYORAN BARU,MELAWAI,2627,572,2055,1826,3881,2021-10-07
3171061001,JAKARTA PUSAT,MENTENG,MENTENG,25624,6630,18994,14128,33122,2021-10-07
3174021005,JAKARTA SELATAN,SETIA BUDI,MENTENG ATAS,27816,6034,21782,16848,38630,2021-10-07
3174011003,JAKARTA SELATAN,TEBET,MENTENG DALAM,36028,8217,27811,21758,49569,2021-10-07
3173081003,JAKARTA BARAT,KEMBANGAN,MERUYA SELATAN,32130,7820,24310,19064,43374,2021-10-07
3173081002,JAKARTA BARAT,KEMBANGAN,MERUYA UTARA,43752,10571,33181,27009,60190,2021-10-07
3175101004,JAKARTA TIMUR,CIPAYUNG,MUNJUL,23871,5106,18765,14744,33509,2021-10-07
3172051002,JAKARTA UTARA,PADEMANGAN,PADEMANGAN BARAT,74240,19896,54344,41395,95739,2021-10-07
3172051001,JAKARTA UTARA,PADEMANGAN,PADEMANGAN TIMUR,37736,7701,30035,24754,54789,2021-10-07
3175011004,JAKARTA TIMUR,MATRAMAN,PAL MERIAM,19769,5074,14695,11160,25855,2021-10-07
3173071001,JAKARTA BARAT,PALMERAH,PALMERAH,63011,15977,47034,35864,82898,2021-10-07
3174081001,JAKARTA SELATAN,PANCORAN,PANCORAN,19421,4928,14493,11293,25786,2021-10-07
3172021003,JAKARTA UTARA,TANJUNG PRIOK,PAPANGGO,39097,9083,30014,23419,53433,2021-10-07
3171021001,JAKARTA PUSAT,SAWAH BESAR,PASAR BARU,12035,2606,9429,8028,17457,2021-10-07
3174021006,JAKARTA SELATAN,SETIA BUDI,PASAR MANGGIS,26752,6405,20347,15807,36154,2021-10-07
3174041001,JAKARTA SELATAN,PASAR MINGGU,PASAR MINGGU,24821,5562,19259,15328,34587,2021-10-07
3171041003,JAKARTA PUSAT,SENEN,PASEBAN,23533,5841,17692,13588,31280,2021-10-07
3173061005,JAKARTA BARAT,KALI DERES,PEGADUNGAN,75587,17687,57900,47636,105536,2021-10-07
3171061002,JAKARTA PUSAT,MENTENG,PEGANGSAAN,23455,5946,17509,12534,30043,2021-10-07
3172061002,JAKARTA UTARA,KELAPA GADING,PEGANGSAAN DUA,49976,9283,40693,35401,76094,2021-10-07
3172011004,JAKARTA UTARA,PENJARINGAN,PEJAGALAN,74578,17984,56594,45785,102379,2021-10-07
3174041006,JAKARTA SELATAN,PASAR MINGGU,PEJATEN BARAT,37346,9067,28279,22289,50568,2021-10-07
3174041005,JAKARTA SELATAN,PASAR MINGGU,PEJATEN TIMUR,57656,15273,42383,32589,74972,2021-10-07
3175051005,JAKARTA TIMUR,PASAR REBO,PEKAYON,43250,9304,33946,26449,60395,2021-10-07
3173041009,JAKARTA BARAT,TAMBORA,PEKOJAN,23587,5271,18316,14431,32747,2021-10-07
3174031003,JAKARTA SELATAN,MAMPANG PRAPATAN,PELA MAMPANG,43522,10341,33181,26070,59251,2021-10-07
3174081005,JAKARTA SELATAN,PANCORAN,PENGADEGAN,21478,4597,16881,12961,29842,2021-10-07
3175061003,JAKARTA TIMUR,CAKUNG,PENGGILINGAN,99255,26970,72285,53930,126215,2021-10-07
3172011001,JAKARTA UTARA,PENJARINGAN,PENJARINGAN,88308,25699,62609,45588,108197,2021-10-07
3174101001,JAKARTA SELATAN,PESANGGRAHAN,PESANGGRAHAN,27545,5604,21941,17685,39626,2021-10-07
3171071004,JAKARTA PUSAT,TANAH ABANG,PETAMBURAN,33271,10046,23225,16157,39382,2021-10-07
3174071008,JAKARTA SELATAN,KEBAYORAN BARU,PETOGOGAN,11499,2697,8802,6898,15700,2021-10-07
3171011004,JAKARTA PUSAT,GAMBIR,PETOJO SELATAN,14692,3797,10895,8732,19627,2021-10-07
3171011003,JAKARTA PUSAT,GAMBIR,PETOJO UTARA,17458,4325,13133,10154,23287,2021-10-07
3174101004,JAKARTA SELATAN,PESANGGRAHAN,PETUKANGAN SELATAN,37187,8998,28189,22418,50607,2021-10-07
3174101003,JAKARTA SELATAN,PESANGGRAHAN,PETUKANGAN UTARA,53716,13612,40104,31309,71413,2021-10-07
3175081002,JAKARTA TIMUR,MAKASAR,PINANG RANTI,27198,6859,20339,15927,36266,2021-10-07
3173031008,JAKARTA BARAT,TAMAN SARI,PINANGSIA,10729,2283,8446,6670,15116,2021-10-07
3175011001,JAKARTA TIMUR,MATRAMAN,PISANGAN BARU,31776,7857,23919,17567,41486,2021-10-07
3175021002,JAKARTA TIMUR,PULO GADUNG,PISANGAN TIMUR,41011,9186,31825,25304,57129,2021-10-07
3172011005,JAKARTA UTARA,PENJARINGAN,PLUIT,47783,10579,37204,31301,68505,2021-10-07
3175071002,JAKARTA TIMUR,DUREN SAWIT,PONDOK BAMBU,61550,15564,45986,35602,81588,2021-10-07
3175071004,JAKARTA TIMUR,DUREN SAWIT,PONDOK KELAPA,72015,16503,55512,44766,100278,2021-10-07
3175071007,JAKARTA TIMUR,DUREN SAWIT,PONDOK KOPI,35367,8295,27072,19881,46953,2021-10-07
3174061003,JAKARTA SELATAN,CILANDAK,PONDOK LABU,46464,9464,37000,30056,67056,2021-10-07
3174051002,JAKARTA SELATAN,KEBAYORAN LAMA,PONDOK PINANG,56169,12533,43636,34380,78016,2021-10-07
3175101003,JAKARTA TIMUR,CIPAYUNG,PONDOK RANGGON,25574,5877,19697,15437,35134,2021-10-07
3101011003,KAB.ADM.KEP.SERIBU,KEP. SERIBU UTARA,PULAU HARAPAN,2060,260,1800,1481,3281,2021-10-07
3101011002,KAB.ADM.KEP.SERIBU,KEP. SERIBU UTARA,PULAU KELAPA,5528,673,4855,3812,8667,2021-10-07
3101011001,KAB.ADM.KEP.SERIBU,KEP. SERIBU UTARA,PULAU PANGGANG,5450,565,4885,4157,9042,2021-10-07
3101021003,KAB.ADM.KEP.SERIBU,KEP. SERIBU SELATAN,PULAU PARI,2765,216,2549,2296,4845,2021-10-07
3101021002,KAB.ADM.KEP.SERIBU,KEP. SERIBU SELATAN,PULAU TIDUNG,4553,437,4116,3651,7767,2021-10-07
3101021001,KAB.ADM.KEP.SERIBU,KEP. SERIBU SELATAN,PULAU UNTUNG JAWA,1941,211,1730,1574,3304,2021-10-07
3174071007,JAKARTA SELATAN,KEBAYORAN BARU,PULO,5835,1152,4683,4013,8696,2021-10-07
3175021001,JAKARTA TIMUR,PULO GADUNG,PULO GADUNG,34422,8536,25886,20250,46136,2021-10-07
3175061005,JAKARTA TIMUR,CAKUNG,PULO GEBANG,97301,22054,75247,56959,132206,2021-10-07
3174041004,JAKARTA SELATAN,PASAR MINGGU,RAGUNAN,39616,8840,30776,24515,55291,2021-10-07
3175091005,JAKARTA TIMUR,CIRACAS,RAMBUTAN,36771,9992,26779,20011,46790,2021-10-07
3172031006,JAKARTA UTARA,KOJA,RAWA BADAK SELATAN,42179,11557,30622,22473,53095,2021-10-07
3172031004,JAKARTA UTARA,KOJA,RAWA BADAK UTARA,34408,9063,25345,19055,44400,2021-10-07
3174071005,JAKARTA SELATAN,KEBAYORAN BARU,RAWA BARAT,5625,1109,4516,3756,8272,2021-10-07
3173011003,JAKARTA BARAT,CENGKARENG,RAWA BUAYA,63799,15516,48283,35942,84225,2021-10-07
3175031004,JAKARTA TIMUR,JATINEGARA,RAWA BUNGA,21434,5941,15493,11661,27154,2021-10-07
3174081003,JAKARTA SELATAN,PANCORAN,RAWA JATI,20509,4642,15867,12009,27876,2021-10-07
3175061002,JAKARTA TIMUR,CAKUNG,RAWA TERATE,24637,5288,19349,15074,34423,2021-10-07
3175021005,JAKARTA TIMUR,PULO GADUNG,RAWAMANGUN,37612,8791,28821,22915,51736,2021-10-07
3171051003,JAKARTA PUSAT,CEMPAKA PUTIH,RAWASARI,21967,5308,16659,13286,29945,2021-10-07
3173041010,JAKARTA BARAT,TAMBORA,ROA MALAKA,3484,668,2816,2384,5200,2021-10-07
3172041006,JAKARTA UTARA,CILINCING,ROROTAN,41668,9795,31873,24164,56037,2021-10-07
3174071004,JAKARTA SELATAN,KEBAYORAN BARU,SELONG,2842,594,2248,1964,4212,2021-10-07
3173061002,JAKARTA BARAT,KALI DERES,SEMANAN,71354,18587,52767,40421,93188,2021-10-07
3172041007,JAKARTA UTARA,CILINCING,SEMPER BARAT,68587,15739,52848,41670,94518,2021-10-07
3172041005,JAKARTA UTARA,CILINCING,SEMPER TIMUR,36267,8907,27360,20842,48202,2021-10-07
3174071006,JAKARTA SELATAN,KEBAYORAN BARU,SENAYAN,2771,726,2045,1639,3684,2021-10-07
3171041001,JAKARTA PUSAT,SENEN,SENEN,6804,1672,5132,4130,9262,2021-10-07
3171031004,JAKARTA PUSAT,KEMAYORAN,SERDANG,29668,6980,22688,17749,40437,2021-10-07
3174021001,JAKARTA SELATAN,SETIA BUDI,SETIA BUDI,3023,722,2301,1841,4142,2021-10-07
3175101005,JAKARTA TIMUR,CIPAYUNG,SETU,20572,4999,15573,11855,27428,2021-10-07
3173071002,JAKARTA BARAT,PALMERAH,SLIPI,16591,3617,12974,10280,23254,2021-10-07
3173081004,JAKARTA BARAT,KEMBANGAN,SRENGSENG,45523,11808,33715,26746,60461,2021-10-07
3174091002,JAKARTA SELATAN,JAGAKARSA,SRENGSENG SAWAH,58196,11477,46719,37434,84153,2021-10-07
3173051003,JAKARTA BARAT,KEBON JERUK,SUKABUMI SELATAN,37033,9956,27077,19874,46951,2021-10-07
3173051002,JAKARTA BARAT,KEBON JERUK,SUKABUMI UTARA,38290,10574,27716,20306,48022,2021-10-07
3172041002,JAKARTA UTARA,CILINCING,SUKAPURA,53949,14090,39859,31107,70966,2021-10-07
3171031007,JAKARTA PUSAT,KEMAYORAN,SUMUR BATU,22717,5390,17327,13825,31152,2021-10-07
3172021004,JAKARTA UTARA,TANJUNG PRIOK,SUNGAI BAMBU,29876,7102,22774,17846,40620,2021-10-07
3172021006,JAKARTA UTARA,TANJUNG PRIOK,SUNTER AGUNG,71805,14292,57513,47887,105400,2021-10-07
3172021002,JAKARTA UTARA,TANJUNG PRIOK,SUNTER JAYA,63031,13363,49668,40911,90579,2021-10-07
3175091004,JAKARTA TIMUR,CIRACAS,SUSUKAN,38257,8416,29841,23492,53333,2021-10-07
3173031001,JAKARTA BARAT,TAMAN SARI,TAMAN SARI,14348,3126,11222,9130,20352,2021-10-07
3173041001,JAKARTA BARAT,TAMBORA,TAMBORA,10204,2617,7587,5817,13404,2021-10-07
3173041004,JAKARTA BARAT,TAMBORA,TANAH SEREAL,26387,5198,21189,16812,38001,2021-10-07
3171081004,JAKARTA PUSAT,JOHAR BARU,TANAH TINGGI,37693,8085,29608,22689,52297,2021-10-07
3173031004,JAKARTA BARAT,TAMAN SARI,TANGKI,13324,2633,10691,8384,19075,2021-10-07
3174091005,JAKARTA SELATAN,JAGAKARSA,TANJUNG BARAT,39770,8885,30885,23965,54850,2021-10-07
3173021005,JAKARTA BARAT,GROGOL PETAMBURAN,TANJUNG DUREN SELATAN,25337,5620,19717,16249,35966,2021-10-07
3173021002,JAKARTA BARAT,GROGOL PETAMBURAN,TANJUNG DUREN UTARA,17010,3421,13589,11433,25022,2021-10-07
3172021001,JAKARTA UTARA,TANJUNG PRIOK,TANJUNG PRIOK,34588,8161,26427,20583,47010,2021-10-07
3174011002,JAKARTA SELATAN,TEBET,TEBET BARAT,21194,4106,17088,14146,31234,2021-10-07
3174011001,JAKARTA SELATAN,TEBET,TEBET TIMUR,18199,3426,14773,12470,27243,2021-10-07
3173061003,JAKARTA BARAT,KALI DERES,TEGAL ALUR,83647,20635,63012,49048,112060,2021-10-07
3174031004,JAKARTA SELATAN,MAMPANG PRAPATAN,TEGAL PARANG,32401,8596,23805,17132,40937,2021-10-07
3173021003,JAKARTA BARAT,GROGOL PETAMBURAN,TOMANG,29605,6333,23272,18745,42017,2021-10-07
3172031005,JAKARTA UTARA,KOJA,TUGU SELATAN,39122,10060,29062,21852,50914,2021-10-07
3172031002,JAKARTA UTARA,KOJA,TUGU UTARA,67670,18468,49202,36453,85655,2021-10-07
3175061006,JAKARTA TIMUR,CAKUNG,UJUNG MENTENG,29934,6026,23908,19088,42996,2021-10-07
3174101005,JAKARTA SELATAN,PESANGGRAHAN,ULUJAMI,40544,10779,29765,22903,52668,2021-10-07
3175011006,JAKARTA TIMUR,MATRAMAN,UTAN KAYU SELATAN,33511,7318,26193,20132,46325,2021-10-07
3175011002,JAKARTA TIMUR,MATRAMAN,UTAN KAYU UTARA,28169,6986,21183,16273,37456,2021-10-07
3171031008,JAKARTA PUSAT,KEMAYORAN,UTAN PANJANG,29208,7196,22012,16552,38564,2021-10-07
3172021007,JAKARTA UTARA,TANJUNG PRIOK,WARAKAS,44401,9671,34730,26343,61073,2021-10-07
3173021007,JAKARTA BARAT,GROGOL PETAMBURAN,WIJAYA KUSUMA,38934,9723,29211,23097,52308,2021-10-07
3172051003,JAKARTA UTARA,PADEMANGAN,ANCOL,23947,6456,17491,13649,31140,2021-10-08
3173041007,JAKARTA BARAT,TAMBORA,ANGKE,29381,7317,22064,16851,38915,2021-10-08
3175041005,JAKARTA TIMUR,KRAMAT JATI,BALE KAMBANG,29074,8317,20757,14903,35660,2021-10-08
3175031003,JAKARTA TIMUR,JATINEGARA,BALI MESTER,9752,2388,7364,5817,13181,2021-10-08
3175101006,JAKARTA TIMUR,CIPAYUNG,BAMBU APUS,26285,5681,20604,15705,36309,2021-10-08
3174031002,JAKARTA SELATAN,MAMPANG PRAPATAN,BANGKA,21566,5504,16062,12447,28509,2021-10-08
3175051002,JAKARTA TIMUR,PASAR REBO,BARU,23886,4664,19222,15801,35023,2021-10-08
3175041004,JAKARTA TIMUR,KRAMAT JATI,BATU AMPAR,47898,13535,34363,25494,59857,2021-10-08
3171071002,JAKARTA PUSAT,TANAH ABANG,BENDUNGAN HILIR,21494,5010,16484,13092,29576,2021-10-08
3175031002,JAKARTA TIMUR,JATINEGARA,BIDARA CINA,36689,10167,26522,19697,46219,2021-10-08
3174101002,JAKARTA SELATAN,PESANGGRAHAN,BINTARO,53098,12372,40726,32842,73568,2021-10-08
3174011005,JAKARTA SELATAN,TEBET,BUKIT DURI,34183,8293,25890,19965,45855,2021-10-08
3171041006,JAKARTA PUSAT,SENEN,BUNGUR,18144,4459,13685,10821,24506,2021-10-08
3175061007,JAKARTA TIMUR,CAKUNG,CAKUNG BARAT,57724,13601,44123,34620,78743,2021-10-08
3175061004,JAKARTA TIMUR,CAKUNG,CAKUNG TIMUR,58287,13339,44948,35209,80157,2021-10-08
3175041007,JAKARTA TIMUR,KRAMAT JATI,CAWANG,32762,8419,24343,18159,42502,2021-10-08
3175101008,JAKARTA TIMUR,CIPAYUNG,CEGER,18932,4308,14624,11510,26134,2021-10-08
3171031006,JAKARTA PUSAT,KEMAYORAN,CEMPAKA BARU,32581,7968,24613,18282,42895,2021-10-08
3171051002,JAKARTA PUSAT,CEMPAKA PUTIH,CEMPAKA PUTIH BARAT,35885,8865,27020,21462,48482,2021-10-08
3171051001,JAKARTA PUSAT,CEMPAKA PUTIH,CEMPAKA PUTIH TIMUR,24292,5715,18577,15190,33767,2021-10-08
3173011001,JAKARTA BARAT,CENGKARENG,CENGKARENG BARAT,66284,15825,50459,39883,90342,2021-10-08
3173011006,JAKARTA BARAT,CENGKARENG,CENGKARENG TIMUR,81027,18730,62297,47753,110050,2021-10-08
3175091002,JAKARTA TIMUR,CIRACAS,CIBUBUR,66364,13452,52912,41808,94720,2021-10-08
3171011002,JAKARTA PUSAT,GAMBIR,CIDENG,15390,3385,12005,9913,21918,2021-10-08
3174091003,JAKARTA SELATAN,JAGAKARSA,CIGANJUR,38497,8228,30269,22937,53206,2021-10-08
3175051003,JAKARTA TIMUR,PASAR REBO,CIJANTUNG,41419,8986,32433,25462,57895,2021-10-08
3171061003,JAKARTA PUSAT,MENTENG,CIKINI,8274,1705,6569,4782,11351,2021-10-08
3174081006,JAKARTA SELATAN,PANCORAN,CIKOKO,10547,2175,8372,6780,15152,2021-10-08
3174061001,JAKARTA SELATAN,CILANDAK,CILANDAK BARAT,51752,11172,40580,32996,73576,2021-10-08
3174041003,JAKARTA SELATAN,PASAR MINGGU,CILANDAK TIMUR,25145,5539,19606,15702,35308,2021-10-08
3175101002,JAKARTA TIMUR,CIPAYUNG,CILANGKAP,27635,5905,21730,16970,38700,2021-10-08
3175041006,JAKARTA TIMUR,KRAMAT JATI,CILILITAN,40181,10495,29686,22354,52040,2021-10-08
3172041001,JAKARTA UTARA,CILINCING,CILINCING,43609,11925,31684,23149,54833,2021-10-08
3175101001,JAKARTA TIMUR,CIPAYUNG,CIPAYUNG,26104,5293,20811,16896,37707,2021-10-08
3174091006,JAKARTA SELATAN,JAGAKARSA,CIPEDAK,38303,8089,30214,23786,54000,2021-10-08
3174061005,JAKARTA SELATAN,CILANDAK,CIPETE SELATAN,26704,5969,20735,16846,37581,2021-10-08
3174071010,JAKARTA SELATAN,KEBAYORAN BARU,CIPETE UTARA,34102,7615,26487,20242,46729,2021-10-08
3175021003,JAKARTA TIMUR,PULO GADUNG,CIPINANG,39306,8873,30433,23529,53962,2021-10-08
3175031007,JAKARTA TIMUR,JATINEGARA,CIPINANG BESAR SELATAN,35212,9600,25612,18475,44087,2021-10-08
3175031008,JAKARTA TIMUR,JATINEGARA,CIPINANG BESAR UTARA,45319,12447,32872,23656,56528,2021-10-08
3175031005,JAKARTA TIMUR,JATINEGARA,CIPINANG CEMPEDAK,32824,8212,24612,19128,43740,2021-10-08
3175081005,JAKARTA TIMUR,MAKASAR,CIPINANG MELAYU,42308,9706,32602,25780,58382,2021-10-08
3175031006,JAKARTA TIMUR,JATINEGARA,CIPINANG MUARA,55243,13998,41245,31272,72517,2021-10-08
3174051003,JAKARTA SELATAN,KEBAYORAN LAMA,CIPULIR,39937,9769,30168,22427,52595,2021-10-08
3175091001,JAKARTA TIMUR,CIRACAS,CIRACAS,64594,13811,50783,39320,90103,2021-10-08
3175041003,JAKARTA TIMUR,KRAMAT JATI,DUKUH,24609,5473,19136,14729,33865,2021-10-08
3175071001,JAKARTA TIMUR,DUREN SAWIT,DUREN SAWIT,61160,15375,45785,35240,81025,2021-10-08
3174081004,JAKARTA SELATAN,PANCORAN,DUREN TIGA,28319,6600,21719,16082,37801,2021-10-08
3173051005,JAKARTA BARAT,KEBON JERUK,DURI KEPA,60138,13545,46593,38406,84999,2021-10-08
3173011002,JAKARTA BARAT,CENGKARENG,DURI KOSAMBI,77923,20142,57781,43153,100934,2021-10-08
3171011006,JAKARTA PUSAT,GAMBIR,DURI PULO,19610,4731,14879,11271,26150,2021-10-08
3173041011,JAKARTA BARAT,TAMBORA,DURI SELATAN,14259,3038,11221,9036,20257,2021-10-08
3173041003,JAKARTA BARAT,TAMBORA,DURI UTARA,19844,4503,15341,11892,27233,2021-10-08
3171081003,JAKARTA PUSAT,JOHAR BARU,GALUR,18243,4133,14110,10879,24989,2021-10-08
3171011001,JAKARTA PUSAT,GAMBIR,GAMBIR,2191,519,1672,1365,3037,2021-10-08
3174061004,JAKARTA SELATAN,CILANDAK,GANDARIA SELATAN,22119,5086,17033,13460,30493,2021-10-08
3174071009,JAKARTA SELATAN,KEBAYORAN BARU,GANDARIA UTARA,39922,9354,30568,23797,54365,2021-10-08
3175051001,JAKARTA TIMUR,PASAR REBO,GEDONG,35755,8244,27511,21755,49266,2021-10-08
3171071001,JAKARTA PUSAT,TANAH ABANG,GELORA,3127,713,2414,1936,4350,2021-10-08
3173031007,JAKARTA BARAT,TAMAN SARI,GLODOK,7837,1475,6362,5500,11862,2021-10-08
3171061004,JAKARTA PUSAT,MENTENG,GONDANGDIA,4100,1003,3097,2734,5831,2021-10-08
3173021001,JAKARTA BARAT,GROGOL PETAMBURAN,GROGOL,16876,3901,12975,10284,23259,2021-10-08
3174051005,JAKARTA SELATAN,KEBAYORAN LAMA,GROGOL SELATAN,44251,10812,33439,25725,59164,2021-10-08
3174051004,JAKARTA SELATAN,KEBAYORAN LAMA,GROGOL UTARA,42494,10320,32174,25153,57327,2021-10-08
3174021007,JAKARTA SELATAN,SETIA BUDI,GUNTUR,3985,890,3095,2625,5720,2021-10-08
3174071002,JAKARTA SELATAN,KEBAYORAN BARU,GUNUNG,9436,2030,7406,6107,13513,2021-10-08
3171031005,JAKARTA PUSAT,KEMAYORAN,GUNUNG SAHARI SELATAN,19199,4529,14670,11571,26241,2021-10-08
3171021004,JAKARTA PUSAT,SAWAH BESAR,GUNUNG SAHARI UTARA,16650,3370,13280,11210,24490,2021-10-08
3175081004,JAKARTA TIMUR,MAKASAR,HALIM PERDANA KUSUMAH,28363,4390,23973,21127,45100,2021-10-08
3171031003,JAKARTA PUSAT,KEMAYORAN,HARAPAN MULIA,22557,5386,17171,13056,30227,2021-10-08
3174091001,JAKARTA SELATAN,JAGAKARSA,JAGAKARSA,62389,13580,48809,38417,87226,2021-10-08
3175021007,JAKARTA TIMUR,PULO GADUNG,JATI,32757,7313,25444,20723,46167,2021-10-08
3174041002,JAKARTA SELATAN,PASAR MINGGU,JATI PADANG,37502,9048,28454,22522,50976,2021-10-08
3173071004,JAKARTA BARAT,PALMERAH,JATI PULO,28738,6642,22096,16646,38742,2021-10-08
3175061001,JAKARTA TIMUR,CAKUNG,JATINEGARA,84160,20998,63162,49040,112202,2021-10-08
3175021004,JAKARTA TIMUR,PULO GADUNG,JATINEGARA KAUM,24632,5476,19156,14554,33710,2021-10-08
3173021004,JAKARTA BARAT,GROGOL PETAMBURAN,JELAMBAR,30266,6482,23784,19293,43077,2021-10-08
3173021006,JAKARTA BARAT,GROGOL PETAMBURAN,JELAMBAR BARU,38246,8475,29771,24106,53877,2021-10-08
3173041006,JAKARTA BARAT,TAMBORA,JEMBATAN BESI,29314,8463,20851,14997,35848,2021-10-08
3173041008,JAKARTA BARAT,TAMBORA,JEMBATAN LIMA,21021,5747,15274,11305,26579,2021-10-08
3173081005,JAKARTA BARAT,KEMBANGAN,JOGLO,40839,9663,31176,24799,55975,2021-10-08
3171081001,JAKARTA PUSAT,JOHAR BARU,JOHAR BARU,37488,8011,29477,23395,52872,2021-10-08
3173041002,JAKARTA BARAT,TAMBORA,KALI ANYAR,23856,5726,18130,13474,31604,2021-10-08
3172041004,JAKARTA UTARA,CILINCING,KALIBARU,67684,21583,46101,31405,77506,2021-10-08
3174081002,JAKARTA SELATAN,PANCORAN,KALIBATA,41994,11270,30724,22409,53133,2021-10-08
3173061001,JAKARTA BARAT,KALI DERES,KALIDERES,72447,17513,54934,44159,99093,2021-10-08
3175051004,JAKARTA TIMUR,PASAR REBO,KALISARI,43212,9195,34017,26840,60857,2021-10-08
3173061004,JAKARTA BARAT,KALI DERES,KAMAL,53783,14878,38905,29329,68234,2021-10-08
3172011002,JAKARTA UTARA,PENJARINGAN,KAMAL MUARA,12930,2476,10454,8667,19121,2021-10-08
3171071007,JAKARTA PUSAT,TANAH ABANG,KAMPUNG BALI,11358,2834,8524,6027,14551,2021-10-08
3175031001,JAKARTA TIMUR,JATINEGARA,KAMPUNG MELAYU,25717,7310,18407,13363,31770,2021-10-08
3171081002,JAKARTA PUSAT,JOHAR BARU,KAMPUNG RAWA,21237,3993,17244,13065,30309,2021-10-08
3175041002,JAKARTA TIMUR,KRAMAT JATI,KAMPUNG TENGAH,43993,12595,31398,23212,54610,2021-10-08
3173011005,JAKARTA BARAT,CENGKARENG,KAPUK,134466,37212,97254,73048,170302,2021-10-08
3172011003,JAKARTA UTARA,PENJARINGAN,KAPUK MUARA,35781,7780,28001,23654,51655,2021-10-08
3171021002,JAKARTA PUSAT,SAWAH BESAR,KARANG ANYAR,25761,5707,20054,15801,35855,2021-10-08
3174021004,JAKARTA SELATAN,SETIA BUDI,KARET,9623,2156,7467,5805,13272,2021-10-08
3174021003,JAKARTA SELATAN,SETIA BUDI,KARET KUNINGAN,16055,3620,12435,9992,22427,2021-10-08
3174021002,JAKARTA SELATAN,SETIA BUDI,KARET SEMANGGI,2770,605,2165,1835,4000,2021-10-08
3171071003,JAKARTA PUSAT,TANAH ABANG,KARET TENGSIN,19271,4363,14908,11267,26175,2021-10-08
3171021003,JAKARTA PUSAT,SAWAH BESAR,KARTINI,22292,4990,17302,13867,31169,2021-10-08
3175011003,JAKARTA TIMUR,MATRAMAN,KAYU MANIS,25284,6269,19015,13885,32900,2021-10-08
3175021006,JAKARTA TIMUR,PULO GADUNG,KAYU PUTIH,40696,8851,31845,26342,58187,2021-10-08
3173031006,JAKARTA BARAT,TAMAN SARI,KEAGUNGAN,17387,4009,13378,10338,23716,2021-10-08
3174041007,JAKARTA SELATAN,PASAR MINGGU,KEBAGUSAN,44552,10631,33921,25596,59517,2021-10-08
3174051006,JAKARTA SELATAN,KEBAYORAN LAMA,KEBAYORAN LAMA SELATAN,41212,8945,32267,25325,57592,2021-10-08
3174051001,JAKARTA SELATAN,KEBAYORAN LAMA,KEBAYORAN LAMA UTARA,42422,10535,31887,24532,56419,2021-10-08
3174011004,JAKARTA SELATAN,TEBET,KEBON BARU,35165,8061,27104,21035,48139,2021-10-08
3172021005,JAKARTA UTARA,TANJUNG PRIOK,KEBON BAWANG,50952,12030,38922,30365,69287,2021-10-08
3173051001,JAKARTA BARAT,KEBON JERUK,KEBON JERUK,53887,13786,40101,30789,70890,2021-10-08
3171071006,JAKARTA PUSAT,TANAH ABANG,KEBON KACANG,21531,5988,15543,11500,27043,2021-10-08
3171011005,JAKARTA PUSAT,GAMBIR,KEBON KELAPA,10163,2313,7850,6171,14021,2021-10-08
3171031002,JAKARTA PUSAT,KEMAYORAN,KEBON KOSONG,30019,7291,22728,17261,39989,2021-10-08
3175011005,JAKARTA TIMUR,MATRAMAN,KEBON MANGGIS,16490,3744,12746,9873,22619,2021-10-08
3171071005,JAKARTA PUSAT,TANAH ABANG,KEBON MELATI,32206,9678,22528,15495,38023,2021-10-08
3175081003,JAKARTA TIMUR,MAKASAR,KEBON PALA,46614,10884,35730,27900,63630,2021-10-08
3171061005,JAKARTA PUSAT,MENTENG,KEBON SIRIH,12299,3025,9274,6936,16210,2021-10-08
3173011004,JAKARTA BARAT,CENGKARENG,KEDAUNG KALI ANGKE,32612,7263,25349,19990,45339,2021-10-08
3173051007,JAKARTA BARAT,KEBON JERUK,KEDOYA SELATAN,32165,7055,25110,19685,44795,2021-10-08
3173051006,JAKARTA BARAT,KEBON JERUK,KEDOYA UTARA,45740,10055,35685,29006,64691,2021-10-08
3173051004,JAKARTA BARAT,KEBON JERUK,KELAPA DUA,23565,5806,17759,13940,31699,2021-10-08
3175091003,JAKARTA TIMUR,CIRACAS,KELAPA DUA WETAN,46875,9523,37352,29592,66944,2021-10-08
3172061003,JAKARTA UTARA,KELAPA GADING,KELAPA GADING BARAT,35717,6947,28770,24965,53735,2021-10-08
3172061001,JAKARTA UTARA,KELAPA GADING,KELAPA GADING TIMUR,33592,5784,27808,24619,52427,2021-10-08
3173071005,JAKARTA BARAT,PALMERAH,KEMANGGISAN,32139,7219,24920,19416,44336,2021-10-08
3171031001,JAKARTA PUSAT,KEMAYORAN,KEMAYORAN,20708,4918,15790,12336,28126,2021-10-08
3173081006,JAKARTA BARAT,KEMBANGAN,KEMBANGAN SELATAN,27130,6561,20569,16990,37559,2021-10-08
3173081001,JAKARTA BARAT,KEMBANGAN,KEMBANGAN UTARA,54451,13670,40781,32142,72923,2021-10-08
3171041002,JAKARTA PUSAT,SENEN,KENARI,9579,2158,7421,5986,13407,2021-10-08
3173041005,JAKARTA BARAT,TAMBORA,KERENDANG,19973,4874,15099,11452,26551,2021-10-08
3175071003,JAKARTA TIMUR,DUREN SAWIT,KLENDER,69978,18821,51157,38136,89293,2021-10-08
3172031001,JAKARTA UTARA,KOJA,KOJA,28175,7339,20836,15813,36649,2021-10-08
3173071006,JAKARTA BARAT,PALMERAH,KOTA BAMBU SELATAN,21158,5220,15938,11752,27690,2021-10-08
3173071003,JAKARTA BARAT,PALMERAH,KOTA BAMBU UTARA,24995,6305,18690,13678,32368,2021-10-08
3171041004,JAKARTA PUSAT,SENEN,KRAMAT,28835,7814,21021,14962,35983,2021-10-08
3175041001,JAKARTA TIMUR,KRAMAT JATI,KRAMAT JATI,34144,8662,25482,19428,44910,2021-10-08
3174071003,JAKARTA SELATAN,KEBAYORAN BARU,KRAMAT PELA,14413,3187,11226,8955,20181,2021-10-08
3173031002,JAKARTA BARAT,TAMAN SARI,KRUKUT,19244,4424,14820,11271,26091,2021-10-08
3174031005,JAKARTA SELATAN,MAMPANG PRAPATAN,KUNINGAN BARAT,12785,2779,10006,7730,17736,2021-10-08
3174021008,JAKARTA SELATAN,SETIA BUDI,KUNINGAN TIMUR,6008,1426,4582,3722,8304,2021-10-08
3171041005,JAKARTA PUSAT,SENEN,KWITANG,15486,4004,11482,8822,20304,2021-10-08
3172031003,JAKARTA UTARA,KOJA,LAGOA,59065,16143,42922,31922,74844,2021-10-08
3174061002,JAKARTA SELATAN,CILANDAK,LEBAK BULUS,37626,8410,29216,23399,52615,2021-10-08
3174091004,JAKARTA SELATAN,JAGAKARSA,LENTENG AGUNG,53946,12128,41818,31102,72920,2021-10-08
3175101007,JAKARTA TIMUR,CIPAYUNG,LUBANG BUAYA,63547,14010,49537,38737,88274,2021-10-08
3175081001,JAKARTA TIMUR,MAKASAR,MAKASAR,34390,7962,26428,21289,47717,2021-10-08
3175071006,JAKARTA TIMUR,DUREN SAWIT,MALAKA JAYA,30927,6613,24314,19513,43827,2021-10-08
3175071005,JAKARTA TIMUR,DUREN SAWIT,MALAKA SARI,27530,5597,21933,17831,39764,2021-10-08
3174031001,JAKARTA SELATAN,MAMPANG PRAPATAN,MAMPANG PRAPATAN,18159,4479,13680,10605,24285,2021-10-08
3173031005,JAKARTA BARAT,TAMAN SARI,MANGGA BESAR,7707,1486,6221,5124,11345,2021-10-08
3171021005,JAKARTA PUSAT,SAWAH BESAR,MANGGA DUA SELATAN,27442,6434,21008,16608,37616,2021-10-08
3174011007,JAKARTA SELATAN,TEBET,MANGGARAI,28373,5960,22413,16868,39281,2021-10-08
3174011006,JAKARTA SELATAN,TEBET,MANGGARAI SELATAN,23075,4895,18180,14365,32545,2021-10-08
3173031003,JAKARTA BARAT,TAMAN SARI,MAPHAR,16461,3744,12717,10072,22789,2021-10-08
3172041003,JAKARTA UTARA,CILINCING,MARUNDA,28943,7504,21439,15366,36805,2021-10-08
3174071001,JAKARTA SELATAN,KEBAYORAN BARU,MELAWAI,2627,571,2056,1830,3886,2021-10-08
3171061001,JAKARTA PUSAT,MENTENG,MENTENG,25624,6615,19009,14152,33161,2021-10-08
3174021005,JAKARTA SELATAN,SETIA BUDI,MENTENG ATAS,27816,6016,21800,16882,38682,2021-10-08
3174011003,JAKARTA SELATAN,TEBET,MENTENG DALAM,36028,8183,27845,21810,49655,2021-10-08
3173081003,JAKARTA BARAT,KEMBANGAN,MERUYA SELATAN,32130,7785,24345,19101,43446,2021-10-08
3173081002,JAKARTA BARAT,KEMBANGAN,MERUYA UTARA,43752,10511,33241,27046,60287,2021-10-08
3175101004,JAKARTA TIMUR,CIPAYUNG,MUNJUL,23871,5083,18788,14759,33547,2021-10-08
3172051002,JAKARTA UTARA,PADEMANGAN,PADEMANGAN BARAT,74240,19848,54392,41476,95868,2021-10-08
3172051001,JAKARTA UTARA,PADEMANGAN,PADEMANGAN TIMUR,37736,7681,30055,24798,54853,2021-10-08
3175011004,JAKARTA TIMUR,MATRAMAN,PAL MERIAM,19769,5013,14756,11188,25944,2021-10-08
3173071001,JAKARTA BARAT,PALMERAH,PALMERAH,63011,15885,47126,35932,83058,2021-10-08
3174081001,JAKARTA SELATAN,PANCORAN,PANCORAN,19421,4914,14507,11325,25832,2021-10-08
3172021003,JAKARTA UTARA,TANJUNG PRIOK,PAPANGGO,39097,9031,30066,23456,53522,2021-10-08
3171021001,JAKARTA PUSAT,SAWAH BESAR,PASAR BARU,12035,2598,9437,8037,17474,2021-10-08
3174021006,JAKARTA SELATAN,SETIA BUDI,PASAR MANGGIS,26752,6386,20366,15829,36195,2021-10-08
3174041001,JAKARTA SELATAN,PASAR MINGGU,PASAR MINGGU,24821,5535,19286,15350,34636,2021-10-08
3171041003,JAKARTA PUSAT,SENEN,PASEBAN,23533,5814,17719,13666,31385,2021-10-08
3173061005,JAKARTA BARAT,KALI DERES,PEGADUNGAN,75587,17584,58003,47783,105786,2021-10-08
3171061002,JAKARTA PUSAT,MENTENG,PEGANGSAAN,23455,5919,17536,12560,30096,2021-10-08
3172061002,JAKARTA UTARA,KELAPA GADING,PEGANGSAAN DUA,49976,9239,40737,35455,76192,2021-10-08
3172011004,JAKARTA UTARA,PENJARINGAN,PEJAGALAN,74578,17916,56662,45853,102515,2021-10-08
3174041006,JAKARTA SELATAN,PASAR MINGGU,PEJATEN BARAT,37346,9002,28344,22315,50659,2021-10-08
3174041005,JAKARTA SELATAN,PASAR MINGGU,PEJATEN TIMUR,57656,15138,42518,32687,75205,2021-10-08
3175051005,JAKARTA TIMUR,PASAR REBO,PEKAYON,43250,9267,33983,26486,60469,2021-10-08
3173041009,JAKARTA BARAT,TAMBORA,PEKOJAN,23587,5257,18330,14461,32791,2021-10-08
3174031003,JAKARTA SELATAN,MAMPANG PRAPATAN,PELA MAMPANG,43522,10309,33213,26104,59317,2021-10-08
3174081005,JAKARTA SELATAN,PANCORAN,PENGADEGAN,21478,4582,16896,12991,29887,2021-10-08
3175061003,JAKARTA TIMUR,CAKUNG,PENGGILINGAN,99255,26834,72421,54071,126492,2021-10-08
3172011001,JAKARTA UTARA,PENJARINGAN,PENJARINGAN,88308,25584,62724,45655,108379,2021-10-08
3174101001,JAKARTA SELATAN,PESANGGRAHAN,PESANGGRAHAN,27545,5583,21962,17703,39665,2021-10-08
3171071004,JAKARTA PUSAT,TANAH ABANG,PETAMBURAN,33271,10019,23252,16195,39447,2021-10-08
3174071008,JAKARTA SELATAN,KEBAYORAN BARU,PETOGOGAN,11499,2682,8817,6912,15729,2021-10-08
3171011004,JAKARTA PUSAT,GAMBIR,PETOJO SELATAN,14692,3781,10911,8744,19655,2021-10-08
3171011003,JAKARTA PUSAT,GAMBIR,PETOJO UTARA,17458,4307,13151,10164,23315,2021-10-08
3174101004,JAKARTA SELATAN,PESANGGRAHAN,PETUKANGAN SELATAN,37187,8941,28246,22451,50697,2021-10-08
3174101003,JAKARTA SELATAN,PESANGGRAHAN,PETUKANGAN UTARA,53716,13562,40154,31367,71521,2021-10-08
3175081002,JAKARTA TIMUR,MAKASAR,PINANG RANTI,27198,6840,20358,15952,36310,2021-10-08
3173031008,JAKARTA BARAT,TAMAN SARI,PINANGSIA,10729,2269,8460,6683,15143,2021-10-08
3175011001,JAKARTA TIMUR,MATRAMAN,PISANGAN BARU,31776,7783,23993,17603,41596,2021-10-08
3175021002,JAKARTA TIMUR,PULO GADUNG,PISANGAN TIMUR,41011,9105,31906,25330,57236,2021-10-08
3172011005,JAKARTA UTARA,PENJARINGAN,PLUIT,47783,10548,37235,31322,68557,2021-10-08
3175071002,JAKARTA TIMUR,DUREN SAWIT,PONDOK BAMBU,61550,15413,46137,35686,81823,2021-10-08
3175071004,JAKARTA TIMUR,DUREN SAWIT,PONDOK KELAPA,72015,16395,55620,44834,100454,2021-10-08
3175071007,JAKARTA TIMUR,DUREN SAWIT,PONDOK KOPI,35367,8205,27162,19912,47074,2021-10-08
3174061003,JAKARTA SELATAN,CILANDAK,PONDOK LABU,46464,9409,37055,30115,67170,2021-10-08
3174051002,JAKARTA SELATAN,KEBAYORAN LAMA,PONDOK PINANG,56169,12276,43893,34589,78482,2021-10-08
3175101003,JAKARTA TIMUR,CIPAYUNG,PONDOK RANGGON,25574,5637,19937,15505,35442,2021-10-08
3101011003,KAB.ADM.KEP.SERIBU,KEP. SERIBU UTARA,PULAU HARAPAN,2060,257,1803,1483,3286,2021-10-08
3101011002,KAB.ADM.KEP.SERIBU,KEP. SERIBU UTARA,PULAU KELAPA,5528,672,4856,3814,8670,2021-10-08
3101011001,KAB.ADM.KEP.SERIBU,KEP. SERIBU UTARA,PULAU PANGGANG,5450,553,4897,4159,9056,2021-10-08
3101021003,KAB.ADM.KEP.SERIBU,KEP. SERIBU SELATAN,PULAU PARI,2765,215,2550,2298,4848,2021-10-08
3101021002,KAB.ADM.KEP.SERIBU,KEP. SERIBU SELATAN,PULAU TIDUNG,4553,437,4116,3654,7770,2021-10-08
3101021001,KAB.ADM.KEP.SERIBU,KEP. SERIBU SELATAN,PULAU UNTUNG JAWA,1941,206,1735,1575,3310,2021-10-08
3174071007,JAKARTA SELATAN,KEBAYORAN BARU,PULO,5835,1150,4685,4020,8705,2021-10-08
3175021001,JAKARTA TIMUR,PULO GADUNG,PULO GADUNG,34422,8500,25922,20282,46204,2021-10-08
3175061005,JAKARTA TIMUR,CAKUNG,PULO GEBANG,97301,21928,75373,57083,132456,2021-10-08
3174041004,JAKARTA SELATAN,PASAR MINGGU,RAGUNAN,39616,8791,30825,24567,55392,2021-10-08
3175091005,JAKARTA TIMUR,CIRACAS,RAMBUTAN,36771,9968,26803,20038,46841,2021-10-08
3172031006,JAKARTA UTARA,KOJA,RAWA BADAK SELATAN,42179,11460,30719,22646,53365,2021-10-08
3172031004,JAKARTA UTARA,KOJA,RAWA BADAK UTARA,34408,9002,25406,19101,44507,2021-10-08
3174071005,JAKARTA SELATAN,KEBAYORAN BARU,RAWA BARAT,5625,1109,4516,3760,8276,2021-10-08
3173011003,JAKARTA BARAT,CENGKARENG,RAWA BUAYA,63799,15277,48522,36017,84539,2021-10-08
3175031004,JAKARTA TIMUR,JATINEGARA,RAWA BUNGA,21434,5918,15516,11674,27190,2021-10-08
3174081003,JAKARTA SELATAN,PANCORAN,RAWA JATI,20509,4593,15916,12210,28126,2021-10-08
3175061002,JAKARTA TIMUR,CAKUNG,RAWA TERATE,24637,5266,19371,15100,34471,2021-10-08
3175021005,JAKARTA TIMUR,PULO GADUNG,RAWAMANGUN,37612,8740,28872,22950,51822,2021-10-08
3171051003,JAKARTA PUSAT,CEMPAKA PUTIH,RAWASARI,21967,5281,16686,13310,29996,2021-10-08
3173041010,JAKARTA BARAT,TAMBORA,ROA MALAKA,3484,667,2817,2384,5201,2021-10-08
3172041006,JAKARTA UTARA,CILINCING,ROROTAN,41668,9772,31896,24210,56106,2021-10-08
3174071004,JAKARTA SELATAN,KEBAYORAN BARU,SELONG,2842,594,2248,1965,4213,2021-10-08
3173061002,JAKARTA BARAT,KALI DERES,SEMANAN,71354,18509,52845,40560,93405,2021-10-08
3172041007,JAKARTA UTARA,CILINCING,SEMPER BARAT,68587,15689,52898,41760,94658,2021-10-08
3172041005,JAKARTA UTARA,CILINCING,SEMPER TIMUR,36267,8882,27385,20880,48265,2021-10-08
3174071006,JAKARTA SELATAN,KEBAYORAN BARU,SENAYAN,2771,724,2047,1643,3690,2021-10-08
3171041001,JAKARTA PUSAT,SENEN,SENEN,6804,1666,5138,4133,9271,2021-10-08
3171031004,JAKARTA PUSAT,KEMAYORAN,SERDANG,29668,6942,22726,17768,40494,2021-10-08
3174021001,JAKARTA SELATAN,SETIA BUDI,SETIA BUDI,3023,721,2302,1843,4145,2021-10-08
3175101005,JAKARTA TIMUR,CIPAYUNG,SETU,20572,4974,15598,11888,27486,2021-10-08
3173071002,JAKARTA BARAT,PALMERAH,SLIPI,16591,3590,13001,10300,23301,2021-10-08
3173081004,JAKARTA BARAT,KEMBANGAN,SRENGSENG,45523,11769,33754,26790,60544,2021-10-08
3174091002,JAKARTA SELATAN,JAGAKARSA,SRENGSENG SAWAH,58196,11363,46833,37550,84383,2021-10-08
3173051003,JAKARTA BARAT,KEBON JERUK,SUKABUMI SELATAN,37033,9920,27113,19913,47026,2021-10-08
3173051002,JAKARTA BARAT,KEBON JERUK,SUKABUMI UTARA,38290,10536,27754,20367,48121,2021-10-08
3172041002,JAKARTA UTARA,CILINCING,SUKAPURA,53949,14044,39905,31174,71079,2021-10-08
3171031007,JAKARTA PUSAT,KEMAYORAN,SUMUR BATU,22717,5360,17357,13846,31203,2021-10-08
3172021004,JAKARTA UTARA,TANJUNG PRIOK,SUNGAI BAMBU,29876,7054,22822,17891,40713,2021-10-08
3172021006,JAKARTA UTARA,TANJUNG PRIOK,SUNTER AGUNG,71805,14187,57618,47977,105595,2021-10-08
3172021002,JAKARTA UTARA,TANJUNG PRIOK,SUNTER JAYA,63031,13259,49772,40966,90738,2021-10-08
3175091004,JAKARTA TIMUR,CIRACAS,SUSUKAN,38257,8388,29869,23528,53397,2021-10-08
3173031001,JAKARTA BARAT,TAMAN SARI,TAMAN SARI,14348,3117,11231,9142,20373,2021-10-08
3173041001,JAKARTA BARAT,TAMBORA,TAMBORA,10204,2611,7593,5824,13417,2021-10-08
3173041004,JAKARTA BARAT,TAMBORA,TANAH SEREAL,26387,5181,21206,16836,38042,2021-10-08
3171081004,JAKARTA PUSAT,JOHAR BARU,TANAH TINGGI,37693,8079,29614,22719,52333,2021-10-08
3173031004,JAKARTA BARAT,TAMAN SARI,TANGKI,13324,2613,10711,8403,19114,2021-10-08
3174091005,JAKARTA SELATAN,JAGAKARSA,TANJUNG BARAT,39770,8478,31292,24034,55326,2021-10-08
3173021005,JAKARTA BARAT,GROGOL PETAMBURAN,TANJUNG DUREN SELATAN,25337,5601,19736,16275,36011,2021-10-08
3173021002,JAKARTA BARAT,GROGOL PETAMBURAN,TANJUNG DUREN UTARA,17010,3397,13613,11446,25059,2021-10-08
3172021001,JAKARTA UTARA,TANJUNG PRIOK,TANJUNG PRIOK,34588,8126,26462,20617,47079,2021-10-08
3174011002,JAKARTA SELATAN,TEBET,TEBET BARAT,21194,4086,17108,14176,31284,2021-10-08
3174011001,JAKARTA SELATAN,TEBET,TEBET TIMUR,18199,3415,14784,12492,27276,2021-10-08
3173061003,JAKARTA BARAT,KALI DERES,TEGAL ALUR,83647,20516,63131,49228,112359,2021-10-08
3174031004,JAKARTA SELATAN,MAMPANG PRAPATAN,TEGAL PARANG,32401,8572,23829,17163,40992,2021-10-08
3173021003,JAKARTA BARAT,GROGOL PETAMBURAN,TOMANG,29605,6307,23298,18764,42062,2021-10-08
3172031005,JAKARTA UTARA,KOJA,TUGU SELATAN,39122,9998,29124,21917,51041,2021-10-08
3172031002,JAKARTA UTARA,KOJA,TUGU UTARA,67670,18370,49300,36542,85842,2021-10-08
3175061006,JAKARTA TIMUR,CAKUNG,UJUNG MENTENG,29934,5989,23945,19120,43065,2021-10-08
3174101005,JAKARTA SELATAN,PESANGGRAHAN,ULUJAMI,40544,10733,29811,22944,52755,2021-10-08
3175011006,JAKARTA TIMUR,MATRAMAN,UTAN KAYU SELATAN,33511,7239,26272,20160,46432,2021-10-08
3175011002,JAKARTA TIMUR,MATRAMAN,UTAN KAYU UTARA,28169,6900,21269,16300,37569,2021-10-08
3171031008,JAKARTA PUSAT,KEMAYORAN,UTAN PANJANG,29208,7036,22172,16586,38758,2021-10-08
3172021007,JAKARTA UTARA,TANJUNG PRIOK,WARAKAS,44401,9601,34800,26405,61205,2021-10-08
3173021007,JAKARTA BARAT,GROGOL PETAMBURAN,WIJAYA KUSUMA,38934,9690,29244,23160,52404,2021-10-08
3172051003,JAKARTA UTARA,PADEMANGAN,ANCOL,23947,6439,17508,13683,31191,2021-10-09
3173041007,JAKARTA BARAT,TAMBORA,ANGKE,29381,7271,22110,16948,39058,2021-10-09
3175041005,JAKARTA TIMUR,KRAMAT JATI,BALE KAMBANG,29074,8285,20789,14957,35746,2021-10-09
3175031003,JAKARTA TIMUR,JATINEGARA,BALI MESTER,9752,2358,7394,5848,13242,2021-10-09
3175101006,JAKARTA TIMUR,CIPAYUNG,BAMBU APUS,26285,5648,20637,15751,36388,2021-10-09
3174031002,JAKARTA SELATAN,MAMPANG PRAPATAN,BANGKA,21566,5440,16126,12504,28630,2021-10-09
3175051002,JAKARTA TIMUR,PASAR REBO,BARU,23886,4630,19256,15844,35100,2021-10-09
3175041004,JAKARTA TIMUR,KRAMAT JATI,BATU AMPAR,47898,13435,34463,25617,60080,2021-10-09
3171071002,JAKARTA PUSAT,TANAH ABANG,BENDUNGAN HILIR,21494,4963,16531,13152,29683,2021-10-09
3175031002,JAKARTA TIMUR,JATINEGARA,BIDARA CINA,36689,10109,26580,19766,46346,2021-10-09
3174101002,JAKARTA SELATAN,PESANGGRAHAN,BINTARO,53098,12308,40790,32977,73767,2021-10-09
3174011005,JAKARTA SELATAN,TEBET,BUKIT DURI,34183,8227,25956,20098,46054,2021-10-09
3171041006,JAKARTA PUSAT,SENEN,BUNGUR,18144,4423,13721,10863,24584,2021-10-09
3175061007,JAKARTA TIMUR,CAKUNG,CAKUNG BARAT,57724,13547,44177,34724,78901,2021-10-09
3175061004,JAKARTA TIMUR,CAKUNG,CAKUNG TIMUR,58287,13279,45008,35288,80296,2021-10-09
3175041007,JAKARTA TIMUR,KRAMAT JATI,CAWANG,32762,8359,24403,18228,42631,2021-10-09
3175101008,JAKARTA TIMUR,CIPAYUNG,CEGER,18932,4269,14663,11545,26208,2021-10-09
3171031006,JAKARTA PUSAT,KEMAYORAN,CEMPAKA BARU,32581,7885,24696,18366,43062,2021-10-09
3171051002,JAKARTA PUSAT,CEMPAKA PUTIH,CEMPAKA PUTIH BARAT,35885,8784,27101,21588,48689,2021-10-09
3171051001,JAKARTA PUSAT,CEMPAKA PUTIH,CEMPAKA PUTIH TIMUR,24292,5680,18612,15232,33844,2021-10-09
3173011001,JAKARTA BARAT,CENGKARENG,CENGKARENG BARAT,66284,15714,50570,40056,90626,2021-10-09
3173011006,JAKARTA BARAT,CENGKARENG,CENGKARENG TIMUR,81027,18585,62442,48014,110456,2021-10-09
3175091002,JAKARTA TIMUR,CIRACAS,CIBUBUR,66364,13350,53014,41924,94938,2021-10-09
3171011002,JAKARTA PUSAT,GAMBIR,CIDENG,15390,3352,12038,9953,21991,2021-10-09
3174091003,JAKARTA SELATAN,JAGAKARSA,CIGANJUR,38497,8150,30347,23070,53417,2021-10-09
3175051003,JAKARTA TIMUR,PASAR REBO,CIJANTUNG,41419,8931,32488,25541,58029,2021-10-09
3171061003,JAKARTA PUSAT,MENTENG,CIKINI,8274,1700,6574,4808,11382,2021-10-09
3174081006,JAKARTA SELATAN,PANCORAN,CIKOKO,10547,2152,8395,6815,15210,2021-10-09
3174061001,JAKARTA SELATAN,CILANDAK,CILANDAK BARAT,51752,11100,40652,33139,73791,2021-10-09
3174041003,JAKARTA SELATAN,PASAR MINGGU,CILANDAK TIMUR,25145,5518,19627,15782,35409,2021-10-09
3175101002,JAKARTA TIMUR,CIPAYUNG,CILANGKAP,27635,5791,21844,17078,38922,2021-10-09
3175041006,JAKARTA TIMUR,KRAMAT JATI,CILILITAN,40181,10430,29751,22449,52200,2021-10-09
3172041001,JAKARTA UTARA,CILINCING,CILINCING,43609,11869,31740,23256,54996,2021-10-09
3175101001,JAKARTA TIMUR,CIPAYUNG,CIPAYUNG,26104,5238,20866,16948,37814,2021-10-09
3174091006,JAKARTA SELATAN,JAGAKARSA,CIPEDAK,38303,7989,30314,23874,54188,2021-10-09
3174061005,JAKARTA SELATAN,CILANDAK,CIPETE SELATAN,26704,5942,20762,16935,37697,2021-10-09
3174071010,JAKARTA SELATAN,KEBAYORAN BARU,CIPETE UTARA,34102,7582,26520,20353,46873,2021-10-09
3175021003,JAKARTA TIMUR,PULO GADUNG,CIPINANG,39306,8783,30523,23655,54178,2021-10-09
3175031007,JAKARTA TIMUR,JATINEGARA,CIPINANG BESAR SELATAN,35212,9542,25670,18554,44224,2021-10-09
3175031008,JAKARTA TIMUR,JATINEGARA,CIPINANG BESAR UTARA,45319,12355,32964,23727,56691,2021-10-09
3175031005,JAKARTA TIMUR,JATINEGARA,CIPINANG CEMPEDAK,32824,8161,24663,19203,43866,2021-10-09
3175081005,JAKARTA TIMUR,MAKASAR,CIPINANG MELAYU,42308,9635,32673,25936,58609,2021-10-09
3175031006,JAKARTA TIMUR,JATINEGARA,CIPINANG MUARA,55243,13883,41360,31408,72768,2021-10-09
3174051003,JAKARTA SELATAN,KEBAYORAN LAMA,CIPULIR,39937,9713,30224,22528,52752,2021-10-09
3175091001,JAKARTA TIMUR,CIRACAS,CIRACAS,64594,13721,50873,39435,90308,2021-10-09
3175041003,JAKARTA TIMUR,KRAMAT JATI,DUKUH,24609,5432,19177,14804,33981,2021-10-09
3175071001,JAKARTA TIMUR,DUREN SAWIT,DUREN SAWIT,61160,15208,45952,35380,81332,2021-10-09
3174081004,JAKARTA SELATAN,PANCORAN,DUREN TIGA,28319,6576,21743,16210,37953,2021-10-09
3173051005,JAKARTA BARAT,KEBON JERUK,DURI KEPA,60138,13461,46677,38561,85238,2021-10-09
3173011002,JAKARTA BARAT,CENGKARENG,DURI KOSAMBI,77923,19975,57948,43439,101387,2021-10-09
3171011006,JAKARTA PUSAT,GAMBIR,DURI PULO,19610,4705,14905,11344,26249,2021-10-09
3173041011,JAKARTA BARAT,TAMBORA,DURI SELATAN,14259,2996,11263,9064,20327,2021-10-09
3173041003,JAKARTA BARAT,TAMBORA,DURI UTARA,19844,4449,15395,11961,27356,2021-10-09
3171081003,JAKARTA PUSAT,JOHAR BARU,GALUR,18243,4096,14147,10917,25064,2021-10-09
3171011001,JAKARTA PUSAT,GAMBIR,GAMBIR,2191,510,1681,1369,3050,2021-10-09
3174061004,JAKARTA SELATAN,CILANDAK,GANDARIA SELATAN,22119,5024,17095,13541,30636,2021-10-09
3174071009,JAKARTA SELATAN,KEBAYORAN BARU,GANDARIA UTARA,39922,9309,30613,23932,54545,2021-10-09
3175051001,JAKARTA TIMUR,PASAR REBO,GEDONG,35755,8201,27554,21849,49403,2021-10-09
3171071001,JAKARTA PUSAT,TANAH ABANG,GELORA,3127,696,2431,1950,4381,2021-10-09
3173031007,JAKARTA BARAT,TAMAN SARI,GLODOK,7837,1467,6370,5524,11894,2021-10-09
3171061004,JAKARTA PUSAT,MENTENG,GONDANGDIA,4100,999,3101,2738,5839,2021-10-09
3173021001,JAKARTA BARAT,GROGOL PETAMBURAN,GROGOL,16876,3872,13004,10342,23346,2021-10-09
3174051005,JAKARTA SELATAN,KEBAYORAN LAMA,GROGOL SELATAN,44251,10742,33509,25839,59348,2021-10-09
3174051004,JAKARTA SELATAN,KEBAYORAN LAMA,GROGOL UTARA,42494,10247,32247,25277,57524,2021-10-09
3174021007,JAKARTA SELATAN,SETIA BUDI,GUNTUR,3985,862,3123,2638,5761,2021-10-09
3174071002,JAKARTA SELATAN,KEBAYORAN BARU,GUNUNG,9436,2025,7411,6127,13538,2021-10-09
3171031005,JAKARTA PUSAT,KEMAYORAN,GUNUNG SAHARI SELATAN,19199,4509,14690,11641,26331,2021-10-09
3171021004,JAKARTA PUSAT,SAWAH BESAR,GUNUNG SAHARI UTARA,16650,3348,13302,11240,24542,2021-10-09
3175081004,JAKARTA TIMUR,MAKASAR,HALIM PERDANA KUSUMAH,28363,4322,24041,21226,45267,2021-10-09
3171031003,JAKARTA PUSAT,KEMAYORAN,HARAPAN MULIA,22557,5340,17217,13121,30338,2021-10-09
3174091001,JAKARTA SELATAN,JAGAKARSA,JAGAKARSA,62389,13458,48931,38578,87509,2021-10-09
3175021007,JAKARTA TIMUR,PULO GADUNG,JATI,32757,7247,25510,20808,46318,2021-10-09
3174041002,JAKARTA SELATAN,PASAR MINGGU,JATI PADANG,37502,8953,28549,22603,51152,2021-10-09
3173071004,JAKARTA BARAT,PALMERAH,JATI PULO,28738,6590,22148,16724,38872,2021-10-09
3175061001,JAKARTA TIMUR,CAKUNG,JATINEGARA,84160,20906,63254,49242,112496,2021-10-09
3175021004,JAKARTA TIMUR,PULO GADUNG,JATINEGARA KAUM,24632,5429,19203,14606,33809,2021-10-09
3173021004,JAKARTA BARAT,GROGOL PETAMBURAN,JELAMBAR,30266,6411,23855,19385,43240,2021-10-09
3173021006,JAKARTA BARAT,GROGOL PETAMBURAN,JELAMBAR BARU,38246,8392,29854,24262,54116,2021-10-09
3173041006,JAKARTA BARAT,TAMBORA,JEMBATAN BESI,29314,8406,20908,15106,36014,2021-10-09
3173041008,JAKARTA BARAT,TAMBORA,JEMBATAN LIMA,21021,5712,15309,11362,26671,2021-10-09
3173081005,JAKARTA BARAT,KEMBANGAN,JOGLO,40839,9590,31249,24952,56201,2021-10-09
3171081001,JAKARTA PUSAT,JOHAR BARU,JOHAR BARU,37488,7946,29542,23510,53052,2021-10-09
3173041002,JAKARTA BARAT,TAMBORA,KALI ANYAR,23856,5665,18191,13530,31721,2021-10-09
3172041004,JAKARTA UTARA,CILINCING,KALIBARU,67684,21492,46192,31536,77728,2021-10-09
3174081002,JAKARTA SELATAN,PANCORAN,KALIBATA,41994,11186,30808,22631,53439,2021-10-09
3173061001,JAKARTA BARAT,KALI DERES,KALIDERES,72447,17361,55086,44332,99418,2021-10-09
3175051004,JAKARTA TIMUR,PASAR REBO,KALISARI,43212,9124,34088,26961,61049,2021-10-09
3173061004,JAKARTA BARAT,KALI DERES,KAMAL,53783,14817,38966,29480,68446,2021-10-09
3172011002,JAKARTA UTARA,PENJARINGAN,KAMAL MUARA,12930,2461,10469,8688,19157,2021-10-09
3171071007,JAKARTA PUSAT,TANAH ABANG,KAMPUNG BALI,11358,2801,8557,6058,14615,2021-10-09
3175031001,JAKARTA TIMUR,JATINEGARA,KAMPUNG MELAYU,25717,7171,18546,13412,31958,2021-10-09
3171081002,JAKARTA PUSAT,JOHAR BARU,KAMPUNG RAWA,21237,3953,17284,13110,30394,2021-10-09
3175041002,JAKARTA TIMUR,KRAMAT JATI,KAMPUNG TENGAH,43993,12495,31498,23359,54857,2021-10-09
3173011005,JAKARTA BARAT,CENGKARENG,KAPUK,134466,36930,97536,73396,170932,2021-10-09
3172011003,JAKARTA UTARA,PENJARINGAN,KAPUK MUARA,35781,7738,28043,23717,51760,2021-10-09
3171021002,JAKARTA PUSAT,SAWAH BESAR,KARANG ANYAR,25761,5666,20095,15864,35959,2021-10-09
3174021004,JAKARTA SELATAN,SETIA BUDI,KARET,9623,2148,7475,5824,13299,2021-10-09
3174021003,JAKARTA SELATAN,SETIA BUDI,KARET KUNINGAN,16055,3588,12467,10037,22504,2021-10-09
3174021002,JAKARTA SELATAN,SETIA BUDI,KARET SEMANGGI,2770,603,2167,1837,4004,2021-10-09
3171071003,JAKARTA PUSAT,TANAH ABANG,KARET TENGSIN,19271,4293,14978,11361,26339,2021-10-09
3171021003,JAKARTA PUSAT,SAWAH BESAR,KARTINI,22292,4943,17349,13930,31279,2021-10-09
3175011003,JAKARTA TIMUR,MATRAMAN,KAYU MANIS,25284,6218,19066,13958,33024,2021-10-09
3175021006,JAKARTA TIMUR,PULO GADUNG,KAYU PUTIH,40696,8785,31911,26443,58354,2021-10-09
3173031006,JAKARTA BARAT,TAMAN SARI,KEAGUNGAN,17387,3964,13423,10386,23809,2021-10-09
3174041007,JAKARTA SELATAN,PASAR MINGGU,KEBAGUSAN,44552,10565,33987,25684,59671,2021-10-09
3174051006,JAKARTA SELATAN,KEBAYORAN LAMA,KEBAYORAN LAMA SELATAN,41212,8891,32321,25430,57751,2021-10-09
3174051001,JAKARTA SELATAN,KEBAYORAN LAMA,KEBAYORAN LAMA UTARA,42422,10485,31937,24622,56559,2021-10-09
3174011004,JAKARTA SELATAN,TEBET,KEBON BARU,35165,7877,27288,21142,48430,2021-10-09
3172021005,JAKARTA UTARA,TANJUNG PRIOK,KEBON BAWANG,50952,11956,38996,30490,69486,2021-10-09
3173051001,JAKARTA BARAT,KEBON JERUK,KEBON JERUK,53887,13690,40197,31086,71283,2021-10-09
3171071006,JAKARTA PUSAT,TANAH ABANG,KEBON KACANG,21531,5948,15583,11566,27149,2021-10-09
3171011005,JAKARTA PUSAT,GAMBIR,KEBON KELAPA,10163,2303,7860,6184,14044,2021-10-09
3171031002,JAKARTA PUSAT,KEMAYORAN,KEBON KOSONG,30019,7106,22913,17316,40229,2021-10-09
3175011005,JAKARTA TIMUR,MATRAMAN,KEBON MANGGIS,16490,3723,12767,9941,22708,2021-10-09
3171071005,JAKARTA PUSAT,TANAH ABANG,KEBON MELATI,32206,9636,22570,15581,38151,2021-10-09
3175081003,JAKARTA TIMUR,MAKASAR,KEBON PALA,46614,10822,35792,27999,63791,2021-10-09
3171061005,JAKARTA PUSAT,MENTENG,KEBON SIRIH,12299,3005,9294,6961,16255,2021-10-09
3173011004,JAKARTA BARAT,CENGKARENG,KEDAUNG KALI ANGKE,32612,7234,25378,20057,45435,2021-10-09
3173051007,JAKARTA BARAT,KEBON JERUK,KEDOYA SELATAN,32165,7005,25160,19764,44924,2021-10-09
3173051006,JAKARTA BARAT,KEBON JERUK,KEDOYA UTARA,45740,9990,35750,29115,64865,2021-10-09
3173051004,JAKARTA BARAT,KEBON JERUK,KELAPA DUA,23565,5754,17811,14028,31839,2021-10-09
3175091003,JAKARTA TIMUR,CIRACAS,KELAPA DUA WETAN,46875,9442,37433,29712,67145,2021-10-09
3172061003,JAKARTA UTARA,KELAPA GADING,KELAPA GADING BARAT,35717,6920,28797,25030,53827,2021-10-09
3172061001,JAKARTA UTARA,KELAPA GADING,KELAPA GADING TIMUR,33592,5744,27848,24682,52530,2021-10-09
3173071005,JAKARTA BARAT,PALMERAH,KEMANGGISAN,32139,7160,24979,19511,44490,2021-10-09
3171031001,JAKARTA PUSAT,KEMAYORAN,KEMAYORAN,20708,4890,15818,12375,28193,2021-10-09
3173081006,JAKARTA BARAT,KEMBANGAN,KEMBANGAN SELATAN,27130,6540,20590,17039,37629,2021-10-09
3173081001,JAKARTA BARAT,KEMBANGAN,KEMBANGAN UTARA,54451,13609,40842,32305,73147,2021-10-09
3171041002,JAKARTA PUSAT,SENEN,KENARI,9579,2136,7443,6014,13457,2021-10-09
3173041005,JAKARTA BARAT,TAMBORA,KERENDANG,19973,4836,15137,11506,26643,2021-10-09
3175071003,JAKARTA TIMUR,DUREN SAWIT,KLENDER,69978,18679,51299,38314,89613,2021-10-09
3172031001,JAKARTA UTARA,KOJA,KOJA,28175,7293,20882,15895,36777,2021-10-09
3173071006,JAKARTA BARAT,PALMERAH,KOTA BAMBU SELATAN,21158,5191,15967,11798,27765,2021-10-09
3173071003,JAKARTA BARAT,PALMERAH,KOTA BAMBU UTARA,24995,6264,18731,13743,32474,2021-10-09
3171041004,JAKARTA PUSAT,SENEN,KRAMAT,28835,7788,21047,15039,36086,2021-10-09
3175041001,JAKARTA TIMUR,KRAMAT JATI,KRAMAT JATI,34144,8555,25589,19519,45108,2021-10-09
3174071003,JAKARTA SELATAN,KEBAYORAN BARU,KRAMAT PELA,14413,3167,11246,9003,20249,2021-10-09
3173031002,JAKARTA BARAT,TAMAN SARI,KRUKUT,19244,4406,14838,11305,26143,2021-10-09
3174031005,JAKARTA SELATAN,MAMPANG PRAPATAN,KUNINGAN BARAT,12785,2759,10026,7750,17776,2021-10-09
3174021008,JAKARTA SELATAN,SETIA BUDI,KUNINGAN TIMUR,6008,1415,4593,3732,8325,2021-10-09
3171041005,JAKARTA PUSAT,SENEN,KWITANG,15486,3992,11494,8852,20346,2021-10-09
3172031003,JAKARTA UTARA,KOJA,LAGOA,59065,16028,43037,32094,75131,2021-10-09
3174061002,JAKARTA SELATAN,CILANDAK,LEBAK BULUS,37626,8371,29255,23500,52755,2021-10-09
3174091004,JAKARTA SELATAN,JAGAKARSA,LENTENG AGUNG,53946,12046,41900,31226,73126,2021-10-09
3175101007,JAKARTA TIMUR,CIPAYUNG,LUBANG BUAYA,63547,13903,49644,38852,88496,2021-10-09
3175081001,JAKARTA TIMUR,MAKASAR,MAKASAR,34390,7882,26508,21400,47908,2021-10-09
3175071006,JAKARTA TIMUR,DUREN SAWIT,MALAKA JAYA,30927,6504,24423,19576,43999,2021-10-09
3175071005,JAKARTA TIMUR,DUREN SAWIT,MALAKA SARI,27530,5516,22014,17906,39920,2021-10-09
3174031001,JAKARTA SELATAN,MAMPANG PRAPATAN,MAMPANG PRAPATAN,18159,4433,13726,10626,24352,2021-10-09
3173031005,JAKARTA BARAT,TAMAN SARI,MANGGA BESAR,7707,1474,6233,5165,11398,2021-10-09
3171021005,JAKARTA PUSAT,SAWAH BESAR,MANGGA DUA SELATAN,27442,6399,21043,16679,37722,2021-10-09
3174011007,JAKARTA SELATAN,TEBET,MANGGARAI,28373,5904,22469,16944,39413,2021-10-09
3174011006,JAKARTA SELATAN,TEBET,MANGGARAI SELATAN,23075,4835,18240,14443,32683,2021-10-09
3173031003,JAKARTA BARAT,TAMAN SARI,MAPHAR,16461,3723,12738,10115,22853,2021-10-09
3172041003,JAKARTA UTARA,CILINCING,MARUNDA,28943,7452,21491,15435,36926,2021-10-09
3174071001,JAKARTA SELATAN,KEBAYORAN BARU,MELAWAI,2627,569,2058,1837,3895,2021-10-09
3171061001,JAKARTA PUSAT,MENTENG,MENTENG,25624,6575,19049,14200,33249,2021-10-09
3174021005,JAKARTA SELATAN,SETIA BUDI,MENTENG ATAS,27816,5939,21877,16974,38851,2021-10-09
3174011003,JAKARTA SELATAN,TEBET,MENTENG DALAM,36028,8099,27929,21884,49813,2021-10-09
3173081003,JAKARTA BARAT,KEMBANGAN,MERUYA SELATAN,32130,7742,24388,19179,43567,2021-10-09
3173081002,JAKARTA BARAT,KEMBANGAN,MERUYA UTARA,43752,10461,33291,27193,60484,2021-10-09
3175101004,JAKARTA TIMUR,CIPAYUNG,MUNJUL,23871,5053,18818,14805,33623,2021-10-09
3172051002,JAKARTA UTARA,PADEMANGAN,PADEMANGAN BARAT,74240,19761,54479,41630,96109,2021-10-09
3172051001,JAKARTA UTARA,PADEMANGAN,PADEMANGAN TIMUR,37736,7625,30111,24894,55005,2021-10-09
3175011004,JAKARTA TIMUR,MATRAMAN,PAL MERIAM,19769,4984,14785,11234,26019,2021-10-09
3173071001,JAKARTA BARAT,PALMERAH,PALMERAH,63011,15766,47245,36095,83340,2021-10-09
3174081001,JAKARTA SELATAN,PANCORAN,PANCORAN,19421,4892,14529,11379,25908,2021-10-09
3172021003,JAKARTA UTARA,TANJUNG PRIOK,PAPANGGO,39097,8989,30108,23524,53632,2021-10-09
3171021001,JAKARTA PUSAT,SAWAH BESAR,PASAR BARU,12035,2584,9451,8056,17507,2021-10-09
3174021006,JAKARTA SELATAN,SETIA BUDI,PASAR MANGGIS,26752,6338,20414,15882,36296,2021-10-09
3174041001,JAKARTA SELATAN,PASAR MINGGU,PASAR MINGGU,24821,5490,19331,15401,34732,2021-10-09
3171041003,JAKARTA PUSAT,SENEN,PASEBAN,23533,5772,17761,13721,31482,2021-10-09
3173061005,JAKARTA BARAT,KALI DERES,PEGADUNGAN,75587,17448,58139,47992,106131,2021-10-09
3171061002,JAKARTA PUSAT,MENTENG,PEGANGSAAN,23455,5878,17577,12606,30183,2021-10-09
3172061002,JAKARTA UTARA,KELAPA GADING,PEGANGSAAN DUA,49976,9180,40796,35575,76371,2021-10-09
3172011004,JAKARTA UTARA,PENJARINGAN,PEJAGALAN,74578,17708,56870,46062,102932,2021-10-09
3174041006,JAKARTA SELATAN,PASAR MINGGU,PEJATEN BARAT,37346,8927,28419,22411,50830,2021-10-09
3174041005,JAKARTA SELATAN,PASAR MINGGU,PEJATEN TIMUR,57656,15068,42588,32860,75448,2021-10-09
3175051005,JAKARTA TIMUR,PASAR REBO,PEKAYON,43250,9203,34047,26557,60604,2021-10-09
3173041009,JAKARTA BARAT,TAMBORA,PEKOJAN,23587,5222,18365,14528,32893,2021-10-09
3174031003,JAKARTA SELATAN,MAMPANG PRAPATAN,PELA MAMPANG,43522,10222,33300,26204,59504,2021-10-09
3174081005,JAKARTA SELATAN,PANCORAN,PENGADEGAN,21478,4544,16934,13116,30050,2021-10-09
3175061003,JAKARTA TIMUR,CAKUNG,PENGGILINGAN,99255,26672,72583,54314,126897,2021-10-09
3172011001,JAKARTA UTARA,PENJARINGAN,PENJARINGAN,88308,25488,62820,45792,108612,2021-10-09
3174101001,JAKARTA SELATAN,PESANGGRAHAN,PESANGGRAHAN,27545,5527,22018,17781,39799,2021-10-09
3171071004,JAKARTA PUSAT,TANAH ABANG,PETAMBURAN,33271,9980,23291,16284,39575,2021-10-09
3174071008,JAKARTA SELATAN,KEBAYORAN BARU,PETOGOGAN,11499,2644,8855,7000,15855,2021-10-09
3171011004,JAKARTA PUSAT,GAMBIR,PETOJO SELATAN,14692,3767,10925,8770,19695,2021-10-09
3171011003,JAKARTA PUSAT,GAMBIR,PETOJO UTARA,17458,4261,13197,10222,23419,2021-10-09
3174101004,JAKARTA SELATAN,PESANGGRAHAN,PETUKANGAN SELATAN,37187,8888,28299,22523,50822,2021-10-09
3174101003,JAKARTA SELATAN,PESANGGRAHAN,PETUKANGAN UTARA,53716,13473,40243,31509,71752,2021-10-09
3175081002,JAKARTA TIMUR,MAKASAR,PINANG RANTI,27198,6804,20394,16011,36405,2021-10-09
3173031008,JAKARTA BARAT,TAMAN SARI,PINANGSIA,10729,2234,8495,6714,15209,2021-10-09
3175011001,JAKARTA TIMUR,MATRAMAN,PISANGAN BARU,31776,7714,24062,17708,41770,2021-10-09
3175021002,JAKARTA TIMUR,PULO GADUNG,PISANGAN TIMUR,41011,8987,32024,25438,57462,2021-10-09
3172011005,JAKARTA UTARA,PENJARINGAN,PLUIT,47783,10480,37303,31405,68708,2021-10-09
3175071002,JAKARTA TIMUR,DUREN SAWIT,PONDOK BAMBU,61550,15329,46221,35799,82020,2021-10-09
3175071004,JAKARTA TIMUR,DUREN SAWIT,PONDOK KELAPA,72015,16279,55736,44968,100704,2021-10-09
3175071007,JAKARTA TIMUR,DUREN SAWIT,PONDOK KOPI,35367,8099,27268,20003,47271,2021-10-09
3174061003,JAKARTA SELATAN,CILANDAK,PONDOK LABU,46464,9356,37108,30241,67349,2021-10-09
3174051002,JAKARTA SELATAN,KEBAYORAN LAMA,PONDOK PINANG,56169,12217,43952,34702,78654,2021-10-09
3175101003,JAKARTA TIMUR,CIPAYUNG,PONDOK RANGGON,25574,5499,20075,15541,35616,2021-10-09
3101011003,KAB.ADM.KEP.SERIBU,KEP. SERIBU UTARA,PULAU HARAPAN,2060,250,1810,1495,3305,2021-10-09
3101011002,KAB.ADM.KEP.SERIBU,KEP. SERIBU UTARA,PULAU KELAPA,5528,670,4858,3836,8694,2021-10-09
3101011001,KAB.ADM.KEP.SERIBU,KEP. SERIBU UTARA,PULAU PANGGANG,5450,538,4912,4235,9147,2021-10-09
3101021003,KAB.ADM.KEP.SERIBU,KEP. SERIBU SELATAN,PULAU PARI,2765,213,2552,2302,4854,2021-10-09
3101021002,KAB.ADM.KEP.SERIBU,KEP. SERIBU SELATAN,PULAU TIDUNG,4553,431,4122,3662,7784,2021-10-09
3101021001,KAB.ADM.KEP.SERIBU,KEP. SERIBU SELATAN,PULAU UNTUNG JAWA,1941,205,1736,1580,3316,2021-10-09
3174071007,JAKARTA SELATAN,KEBAYORAN BARU,PULO,5835,1136,4699,4030,8729,2021-10-09
3175021001,JAKARTA TIMUR,PULO GADUNG,PULO GADUNG,34422,8449,25973,20350,46323,2021-10-09
3175061005,JAKARTA TIMUR,CAKUNG,PULO GEBANG,97301,21748,75553,57409,132962,2021-10-09
3174041004,JAKARTA SELATAN,PASAR MINGGU,RAGUNAN,39616,8727,30889,24639,55528,2021-10-09
3175091005,JAKARTA TIMUR,CIRACAS,RAMBUTAN,36771,9890,26881,20133,47014,2021-10-09
3172031006,JAKARTA UTARA,KOJA,RAWA BADAK SELATAN,42179,11415,30764,22746,53510,2021-10-09
3172031004,JAKARTA UTARA,KOJA,RAWA BADAK UTARA,34408,8924,25484,19179,44663,2021-10-09
3174071005,JAKARTA SELATAN,KEBAYORAN BARU,RAWA BARAT,5625,1105,4520,3775,8295,2021-10-09
3173011003,JAKARTA BARAT,CENGKARENG,RAWA BUAYA,63799,15131,48668,36247,84915,2021-10-09
3175031004,JAKARTA TIMUR,JATINEGARA,RAWA BUNGA,21434,5894,15540,11708,27248,2021-10-09
3174081003,JAKARTA SELATAN,PANCORAN,RAWA JATI,20509,4544,15965,12337,28302,2021-10-09
3175061002,JAKARTA TIMUR,CAKUNG,RAWA TERATE,24637,5242,19395,15141,34536,2021-10-09
3175021005,JAKARTA TIMUR,PULO GADUNG,RAWAMANGUN,37612,8686,28926,23063,51989,2021-10-09
3171051003,JAKARTA PUSAT,CEMPAKA PUTIH,RAWASARI,21967,5233,16734,13360,30094,2021-10-09
3173041010,JAKARTA BARAT,TAMBORA,ROA MALAKA,3484,664,2820,2393,5213,2021-10-09
3172041006,JAKARTA UTARA,CILINCING,ROROTAN,41668,9704,31964,24303,56267,2021-10-09
3174071004,JAKARTA SELATAN,KEBAYORAN BARU,SELONG,2842,591,2251,1975,4226,2021-10-09
3173061002,JAKARTA BARAT,KALI DERES,SEMANAN,71354,18382,52972,40733,93705,2021-10-09
3172041007,JAKARTA UTARA,CILINCING,SEMPER BARAT,68587,15583,53004,41942,94946,2021-10-09
3172041005,JAKARTA UTARA,CILINCING,SEMPER TIMUR,36267,8824,27443,20982,48425,2021-10-09
3174071006,JAKARTA SELATAN,KEBAYORAN BARU,SENAYAN,2771,718,2053,1663,3716,2021-10-09
3171041001,JAKARTA PUSAT,SENEN,SENEN,6804,1656,5148,4151,9299,2021-10-09
3171031004,JAKARTA PUSAT,KEMAYORAN,SERDANG,29668,6830,22838,17850,40688,2021-10-09
3174021001,JAKARTA SELATAN,SETIA BUDI,SETIA BUDI,3023,715,2308,1848,4156,2021-10-09
3175101005,JAKARTA TIMUR,CIPAYUNG,SETU,20572,4960,15612,11926,27538,2021-10-09
3173071002,JAKARTA BARAT,PALMERAH,SLIPI,16591,3547,13044,10344,23388,2021-10-09
3173081004,JAKARTA BARAT,KEMBANGAN,SRENGSENG,45523,11709,33814,26956,60770,2021-10-09
3174091002,JAKARTA SELATAN,JAGAKARSA,SRENGSENG SAWAH,58196,11161,47035,37746,84781,2021-10-09
3173051003,JAKARTA BARAT,KEBON JERUK,SUKABUMI SELATAN,37033,9869,27164,20012,47176,2021-10-09
3173051002,JAKARTA BARAT,KEBON JERUK,SUKABUMI UTARA,38290,10477,27813,20484,48297,2021-10-09
3172041002,JAKARTA UTARA,CILINCING,SUKAPURA,53949,13948,40001,31323,71324,2021-10-09
3171031007,JAKARTA PUSAT,KEMAYORAN,SUMUR BATU,22717,5323,17394,13906,31300,2021-10-09
3172021004,JAKARTA UTARA,TANJUNG PRIOK,SUNGAI BAMBU,29876,6991,22885,17961,40846,2021-10-09
3172021006,JAKARTA UTARA,TANJUNG PRIOK,SUNTER AGUNG,71805,14102,57703,48093,105796,2021-10-09
3172021002,JAKARTA UTARA,TANJUNG PRIOK,SUNTER JAYA,63031,13117,49914,41079,90993,2021-10-09
3175091004,JAKARTA TIMUR,CIRACAS,SUSUKAN,38257,8306,29951,23604,53555,2021-10-09
3173031001,JAKARTA BARAT,TAMAN SARI,TAMAN SARI,14348,3086,11262,9181,20443,2021-10-09
3173041001,JAKARTA BARAT,TAMBORA,TAMBORA,10204,2601,7603,5844,13447,2021-10-09
3173041004,JAKARTA BARAT,TAMBORA,TANAH SEREAL,26387,5134,21253,16908,38161,2021-10-09
3171081004,JAKARTA PUSAT,JOHAR BARU,TANAH TINGGI,37693,8029,29664,22801,52465,2021-10-09
3173031004,JAKARTA BARAT,TAMAN SARI,TANGKI,13324,2595,10729,8438,19167,2021-10-09
3174091005,JAKARTA SELATAN,JAGAKARSA,TANJUNG BARAT,39770,8157,31613,24133,55746,2021-10-09
3173021005,JAKARTA BARAT,GROGOL PETAMBURAN,TANJUNG DUREN SELATAN,25337,5580,19757,16333,36090,2021-10-09
3173021002,JAKARTA BARAT,GROGOL PETAMBURAN,TANJUNG DUREN UTARA,17010,3365,13645,11498,25143,2021-10-09
3172021001,JAKARTA UTARA,TANJUNG PRIOK,TANJUNG PRIOK,34588,8089,26499,20672,47171,2021-10-09
3174011002,JAKARTA SELATAN,TEBET,TEBET BARAT,21194,4063,17131,14219,31350,2021-10-09
3174011001,JAKARTA SELATAN,TEBET,TEBET TIMUR,18199,3390,14809,12546,27355,2021-10-09
3173061003,JAKARTA BARAT,KALI DERES,TEGAL ALUR,83647,20384,63263,49434,112697,2021-10-09
3174031004,JAKARTA SELATAN,MAMPANG PRAPATAN,TEGAL PARANG,32401,8459,23942,17229,41171,2021-10-09
3173021003,JAKARTA BARAT,GROGOL PETAMBURAN,TOMANG,29605,6267,23338,18833,42171,2021-10-09
3172031005,JAKARTA UTARA,KOJA,TUGU SELATAN,39122,9948,29174,22048,51222,2021-10-09
3172031002,JAKARTA UTARA,KOJA,TUGU UTARA,67670,18263,49407,36708,86115,2021-10-09
3175061006,JAKARTA TIMUR,CAKUNG,UJUNG MENTENG,29934,5962,23972,19185,43157,2021-10-09
3174101005,JAKARTA SELATAN,PESANGGRAHAN,ULUJAMI,40544,10659,29885,23012,52897,2021-10-09
3175011006,JAKARTA TIMUR,MATRAMAN,UTAN KAYU SELATAN,33511,7168,26343,20274,46617,2021-10-09
3175011002,JAKARTA TIMUR,MATRAMAN,UTAN KAYU UTARA,28169,6824,21345,16380,37725,2021-10-09
3171031008,JAKARTA PUSAT,KEMAYORAN,UTAN PANJANG,29208,6911,22297,16649,38946,2021-10-09
3172021007,JAKARTA UTARA,TANJUNG PRIOK,WARAKAS,44401,9518,34883,26511,61394,2021-10-09
3173021007,JAKARTA BARAT,GROGOL PETAMBURAN,WIJAYA KUSUMA,38934,9650,29284,23233,52517,2021-10-09
3172051003,JAKARTA UTARA,PADEMANGAN,ANCOL,23947,6398,17549,13738,31287,2021-10-10
3173041007,JAKARTA BARAT,TAMBORA,ANGKE,29381,7218,22163,17062,39225,2021-10-10
3175041005,JAKARTA TIMUR,KRAMAT JATI,BALE KAMBANG,29074,8219,20855,15089,35944,2021-10-10
3175031003,JAKARTA TIMUR,JATINEGARA,BALI MESTER,9752,2336,7416,5869,13285,2021-10-10
3175101006,JAKARTA TIMUR,CIPAYUNG,BAMBU APUS,26285,5611,20674,15844,36518,2021-10-10
3174031002,JAKARTA SELATAN,MAMPANG PRAPATAN,BANGKA,21566,5405,16161,12566,28727,2021-10-10
3175051002,JAKARTA TIMUR,PASAR REBO,BARU,23886,4600,19286,15901,35187,2021-10-10
3175041004,JAKARTA TIMUR,KRAMAT JATI,BATU AMPAR,47898,13357,34541,25779,60320,2021-10-10
3171071002,JAKARTA PUSAT,TANAH ABANG,BENDUNGAN HILIR,21494,4926,16568,13241,29809,2021-10-10
3175031002,JAKARTA TIMUR,JATINEGARA,BIDARA CINA,36689,10030,26659,19889,46548,2021-10-10
3174101002,JAKARTA SELATAN,PESANGGRAHAN,BINTARO,53098,12222,40876,33089,73965,2021-10-10
3174011005,JAKARTA SELATAN,TEBET,BUKIT DURI,34183,8161,26022,20274,46296,2021-10-10
3171041006,JAKARTA PUSAT,SENEN,BUNGUR,18144,4405,13739,10906,24645,2021-10-10
3175061007,JAKARTA TIMUR,CAKUNG,CAKUNG BARAT,57724,13492,44232,34949,79181,2021-10-10
3175061004,JAKARTA TIMUR,CAKUNG,CAKUNG TIMUR,58287,13210,45077,35529,80606,2021-10-10
3175041007,JAKARTA TIMUR,KRAMAT JATI,CAWANG,32762,8285,24477,18329,42806,2021-10-10
3175101008,JAKARTA TIMUR,CIPAYUNG,CEGER,18932,4258,14674,11592,26266,2021-10-10
3171031006,JAKARTA PUSAT,KEMAYORAN,CEMPAKA BARU,32581,7848,24733,18444,43177,2021-10-10
3171051002,JAKARTA PUSAT,CEMPAKA PUTIH,CEMPAKA PUTIH BARAT,35885,8719,27166,21705,48871,2021-10-10
3171051001,JAKARTA PUSAT,CEMPAKA PUTIH,CEMPAKA PUTIH TIMUR,24292,5652,18640,15310,33950,2021-10-10
3173011001,JAKARTA BARAT,CENGKARENG,CENGKARENG BARAT,66284,15571,50713,40327,91040,2021-10-10
3173011006,JAKARTA BARAT,CENGKARENG,CENGKARENG TIMUR,81027,18460,62567,48366,110933,2021-10-10
3175091002,JAKARTA TIMUR,CIRACAS,CIBUBUR,66364,13165,53199,42140,95339,2021-10-10
3171011002,JAKARTA PUSAT,GAMBIR,CIDENG,15390,3338,12052,10008,22060,2021-10-10
3174091003,JAKARTA SELATAN,JAGAKARSA,CIGANJUR,38497,8069,30428,23214,53642,2021-10-10
3175051003,JAKARTA TIMUR,PASAR REBO,CIJANTUNG,41419,8875,32544,25671,58215,2021-10-10
3171061003,JAKARTA PUSAT,MENTENG,CIKINI,8274,1678,6596,4840,11436,2021-10-10
3174081006,JAKARTA SELATAN,PANCORAN,CIKOKO,10547,2135,8412,6889,15301,2021-10-10
3174061001,JAKARTA SELATAN,CILANDAK,CILANDAK BARAT,51752,10991,40761,33320,74081,2021-10-10
3174041003,JAKARTA SELATAN,PASAR MINGGU,CILANDAK TIMUR,25145,5475,19670,15847,35517,2021-10-10
3175101002,JAKARTA TIMUR,CIPAYUNG,CILANGKAP,27635,5646,21989,17210,39199,2021-10-10
3175041006,JAKARTA TIMUR,KRAMAT JATI,CILILITAN,40181,10324,29857,22607,52464,2021-10-10
3172041001,JAKARTA UTARA,CILINCING,CILINCING,43609,11800,31809,23373,55182,2021-10-10
3175101001,JAKARTA TIMUR,CIPAYUNG,CIPAYUNG,26104,5173,20931,17033,37964,2021-10-10
3174091006,JAKARTA SELATAN,JAGAKARSA,CIPEDAK,38303,7897,30406,24008,54414,2021-10-10
3174061005,JAKARTA SELATAN,CILANDAK,CIPETE SELATAN,26704,5903,20801,17049,37850,2021-10-10
3174071010,JAKARTA SELATAN,KEBAYORAN BARU,CIPETE UTARA,34102,7533,26569,20517,47086,2021-10-10
3175021003,JAKARTA TIMUR,PULO GADUNG,CIPINANG,39306,8740,30566,23784,54350,2021-10-10
3175031007,JAKARTA TIMUR,JATINEGARA,CIPINANG BESAR SELATAN,35212,9503,25709,18690,44399,2021-10-10
3175031008,JAKARTA TIMUR,JATINEGARA,CIPINANG BESAR UTARA,45319,12274,33045,23837,56882,2021-10-10
3175031005,JAKARTA TIMUR,JATINEGARA,CIPINANG CEMPEDAK,32824,8078,24746,19323,44069,2021-10-10
3175081005,JAKARTA TIMUR,MAKASAR,CIPINANG MELAYU,42308,9463,32845,26059,58904,2021-10-10
3175031006,JAKARTA TIMUR,JATINEGARA,CIPINANG MUARA,55243,13797,41446,31646,73092,2021-10-10
3174051003,JAKARTA SELATAN,KEBAYORAN LAMA,CIPULIR,39937,9658,30279,22687,52966,2021-10-10
3175091001,JAKARTA TIMUR,CIRACAS,CIRACAS,64594,13575,51019,39633,90652,2021-10-10
3175041003,JAKARTA TIMUR,KRAMAT JATI,DUKUH,24609,5399,19210,14855,34065,2021-10-10
3175071001,JAKARTA TIMUR,DUREN SAWIT,DUREN SAWIT,61160,14988,46172,35592,81764,2021-10-10
3174081004,JAKARTA SELATAN,PANCORAN,DUREN TIGA,28319,6468,21851,16377,38228,2021-10-10
3173051005,JAKARTA BARAT,KEBON JERUK,DURI KEPA,60138,13375,46763,38747,85510,2021-10-10
3173011002,JAKARTA BARAT,CENGKARENG,DURI KOSAMBI,77923,19893,58030,43654,101684,2021-10-10
3171011006,JAKARTA PUSAT,GAMBIR,DURI PULO,19610,4682,14928,11409,26337,2021-10-10
3173041011,JAKARTA BARAT,TAMBORA,DURI SELATAN,14259,2932,11327,9127,20454,2021-10-10
3173041003,JAKARTA BARAT,TAMBORA,DURI UTARA,19844,4399,15445,12023,27468,2021-10-10
3171081003,JAKARTA PUSAT,JOHAR BARU,GALUR,18243,4064,14179,10968,25147,2021-10-10
3171011001,JAKARTA PUSAT,GAMBIR,GAMBIR,2191,508,1683,1375,3058,2021-10-10
3174061004,JAKARTA SELATAN,CILANDAK,GANDARIA SELATAN,22119,4987,17132,13640,30772,2021-10-10
3174071009,JAKARTA SELATAN,KEBAYORAN BARU,GANDARIA UTARA,39922,9251,30671,24077,54748,2021-10-10
3175051001,JAKARTA TIMUR,PASAR REBO,GEDONG,35755,8139,27616,21957,49573,2021-10-10
3171071001,JAKARTA PUSAT,TANAH ABANG,GELORA,3127,690,2437,1960,4397,2021-10-10
3173031007,JAKARTA BARAT,TAMAN SARI,GLODOK,7837,1453,6384,5547,11931,2021-10-10
3171061004,JAKARTA PUSAT,MENTENG,GONDANGDIA,4100,993,3107,2749,5856,2021-10-10
3173021001,JAKARTA BARAT,GROGOL PETAMBURAN,GROGOL,16876,3853,13023,10400,23423,2021-10-10
3174051005,JAKARTA SELATAN,KEBAYORAN LAMA,GROGOL SELATAN,44251,10530,33721,25961,59682,2021-10-10
3174051004,JAKARTA SELATAN,KEBAYORAN LAMA,GROGOL UTARA,42494,10192,32302,25439,57741,2021-10-10
3174021007,JAKARTA SELATAN,SETIA BUDI,GUNTUR,3985,854,3131,2647,5778,2021-10-10
3174071002,JAKARTA SELATAN,KEBAYORAN BARU,GUNUNG,9436,2005,7431,6163,13594,2021-10-10
3171031005,JAKARTA PUSAT,KEMAYORAN,GUNUNG SAHARI SELATAN,19199,4493,14706,11694,26400,2021-10-10
3171021004,JAKARTA PUSAT,SAWAH BESAR,GUNUNG SAHARI UTARA,16650,3331,13319,11304,24623,2021-10-10
3175081004,JAKARTA TIMUR,MAKASAR,HALIM PERDANA KUSUMAH,28363,4276,24087,21294,45381,2021-10-10
3171031003,JAKARTA PUSAT,KEMAYORAN,HARAPAN MULIA,22557,5307,17250,13179,30429,2021-10-10
3174091001,JAKARTA SELATAN,JAGAKARSA,JAGAKARSA,62389,13338,49051,38818,87869,2021-10-10
3175021007,JAKARTA TIMUR,PULO GADUNG,JATI,32757,7201,25556,20933,46489,2021-10-10
3174041002,JAKARTA SELATAN,PASAR MINGGU,JATI PADANG,37502,8916,28586,22695,51281,2021-10-10
3173071004,JAKARTA BARAT,PALMERAH,JATI PULO,28738,6566,22172,16835,39007,2021-10-10
3175061001,JAKARTA TIMUR,CAKUNG,JATINEGARA,84160,20790,63370,49579,112949,2021-10-10
3175021004,JAKARTA TIMUR,PULO GADUNG,JATINEGARA KAUM,24632,5334,19298,14723,34021,2021-10-10
3173021004,JAKARTA BARAT,GROGOL PETAMBURAN,JELAMBAR,30266,6371,23895,19475,43370,2021-10-10
3173021006,JAKARTA BARAT,GROGOL PETAMBURAN,JELAMBAR BARU,38246,8317,29929,24409,54338,2021-10-10
3173041006,JAKARTA BARAT,TAMBORA,JEMBATAN BESI,29314,8330,20984,15240,36224,2021-10-10
3173041008,JAKARTA BARAT,TAMBORA,JEMBATAN LIMA,21021,5668,15353,11437,26790,2021-10-10
3173081005,JAKARTA BARAT,KEMBANGAN,JOGLO,40839,9542,31297,25096,56393,2021-10-10
3171081001,JAKARTA PUSAT,JOHAR BARU,JOHAR BARU,37488,7880,29608,23659,53267,2021-10-10
3173041002,JAKARTA BARAT,TAMBORA,KALI ANYAR,23856,5610,18246,13631,31877,2021-10-10
3172041004,JAKARTA UTARA,CILINCING,KALIBARU,67684,21314,46370,31713,78083,2021-10-10
3174081002,JAKARTA SELATAN,PANCORAN,KALIBATA,41994,11086,30908,22845,53753,2021-10-10
3173061001,JAKARTA BARAT,KALI DERES,KALIDERES,72447,17307,55140,44493,99633,2021-10-10
3175051004,JAKARTA TIMUR,PASAR REBO,KALISARI,43212,9051,34161,27089,61250,2021-10-10
3173061004,JAKARTA BARAT,KALI DERES,KAMAL,53783,14531,39252,29575,68827,2021-10-10
3172011002,JAKARTA UTARA,PENJARINGAN,KAMAL MUARA,12930,2455,10475,8712,19187,2021-10-10
3171071007,JAKARTA PUSAT,TANAH ABANG,KAMPUNG BALI,11358,2777,8581,6089,14670,2021-10-10
3175031001,JAKARTA TIMUR,JATINEGARA,KAMPUNG MELAYU,25717,7086,18631,13479,32110,2021-10-10
3171081002,JAKARTA PUSAT,JOHAR BARU,KAMPUNG RAWA,21237,3922,17315,13188,30503,2021-10-10
3175041002,JAKARTA TIMUR,KRAMAT JATI,KAMPUNG TENGAH,43993,12392,31601,23530,55131,2021-10-10
3173011005,JAKARTA BARAT,CENGKARENG,KAPUK,134466,36814,97652,73808,171460,2021-10-10
3172011003,JAKARTA UTARA,PENJARINGAN,KAPUK MUARA,35781,7708,28073,23807,51880,2021-10-10
3171021002,JAKARTA PUSAT,SAWAH BESAR,KARANG ANYAR,25761,5645,20116,15956,36072,2021-10-10
3174021004,JAKARTA SELATAN,SETIA BUDI,KARET,9623,2136,7487,5858,13345,2021-10-10
3174021003,JAKARTA SELATAN,SETIA BUDI,KARET KUNINGAN,16055,3574,12481,10091,22572,2021-10-10
3174021002,JAKARTA SELATAN,SETIA BUDI,KARET SEMANGGI,2770,600,2170,1842,4012,2021-10-10
3171071003,JAKARTA PUSAT,TANAH ABANG,KARET TENGSIN,19271,4221,15050,11463,26513,2021-10-10
3171021003,JAKARTA PUSAT,SAWAH BESAR,KARTINI,22292,4920,17372,13992,31364,2021-10-10
3175011003,JAKARTA TIMUR,MATRAMAN,KAYU MANIS,25284,6174,19110,14064,33174,2021-10-10
3175021006,JAKARTA TIMUR,PULO GADUNG,KAYU PUTIH,40696,8743,31953,26560,58513,2021-10-10
3173031006,JAKARTA BARAT,TAMAN SARI,KEAGUNGAN,17387,3943,13444,10443,23887,2021-10-10
3174041007,JAKARTA SELATAN,PASAR MINGGU,KEBAGUSAN,44552,10510,34042,25830,59872,2021-10-10
3174051006,JAKARTA SELATAN,KEBAYORAN LAMA,KEBAYORAN LAMA SELATAN,41212,8838,32374,25565,57939,2021-10-10
3174051001,JAKARTA SELATAN,KEBAYORAN LAMA,KEBAYORAN LAMA UTARA,42422,10429,31993,24749,56742,2021-10-10
3174011004,JAKARTA SELATAN,TEBET,KEBON BARU,35165,7807,27358,21235,48593,2021-10-10
3172021005,JAKARTA UTARA,TANJUNG PRIOK,KEBON BAWANG,50952,11875,39077,30713,69790,2021-10-10
3173051001,JAKARTA BARAT,KEBON JERUK,KEBON JERUK,53887,13622,40265,31313,71578,2021-10-10
3171071006,JAKARTA PUSAT,TANAH ABANG,KEBON KACANG,21531,5901,15630,11655,27285,2021-10-10
3171011005,JAKARTA PUSAT,GAMBIR,KEBON KELAPA,10163,2289,7874,6223,14097,2021-10-10
3171031002,JAKARTA PUSAT,KEMAYORAN,KEBON KOSONG,30019,7071,22948,17403,40351,2021-10-10
3175011005,JAKARTA TIMUR,MATRAMAN,KEBON MANGGIS,16490,3708,12782,9988,22770,2021-10-10
3171071005,JAKARTA PUSAT,TANAH ABANG,KEBON MELATI,32206,9550,22656,15680,38336,2021-10-10
3175081003,JAKARTA TIMUR,MAKASAR,KEBON PALA,46614,10749,35865,28151,64016,2021-10-10
3171061005,JAKARTA PUSAT,MENTENG,KEBON SIRIH,12299,2985,9314,7002,16316,2021-10-10
3173011004,JAKARTA BARAT,CENGKARENG,KEDAUNG KALI ANGKE,32612,7212,25400,20151,45551,2021-10-10
3173051007,JAKARTA BARAT,KEBON JERUK,KEDOYA SELATAN,32165,6941,25224,19878,45102,2021-10-10
3173051006,JAKARTA BARAT,KEBON JERUK,KEDOYA UTARA,45740,9942,35798,29275,65073,2021-10-10
3173051004,JAKARTA BARAT,KEBON JERUK,KELAPA DUA,23565,5717,17848,14133,31981,2021-10-10
3175091003,JAKARTA TIMUR,CIRACAS,KELAPA DUA WETAN,46875,9339,37536,29847,67383,2021-10-10
3172061003,JAKARTA UTARA,KELAPA GADING,KELAPA GADING BARAT,35717,6897,28820,25117,53937,2021-10-10
3172061001,JAKARTA UTARA,KELAPA GADING,KELAPA GADING TIMUR,33592,5716,27876,24792,52668,2021-10-10
3173071005,JAKARTA BARAT,PALMERAH,KEMANGGISAN,32139,7126,25013,19638,44651,2021-10-10
3171031001,JAKARTA PUSAT,KEMAYORAN,KEMAYORAN,20708,4867,15841,12432,28273,2021-10-10
3173081006,JAKARTA BARAT,KEMBANGAN,KEMBANGAN SELATAN,27130,6506,20624,17141,37765,2021-10-10
3173081001,JAKARTA BARAT,KEMBANGAN,KEMBANGAN UTARA,54451,13540,40911,32473,73384,2021-10-10
3171041002,JAKARTA PUSAT,SENEN,KENARI,9579,2127,7452,6043,13495,2021-10-10
3173041005,JAKARTA BARAT,TAMBORA,KERENDANG,19973,4803,15170,11587,26757,2021-10-10
3175071003,JAKARTA TIMUR,DUREN SAWIT,KLENDER,69978,18573,51405,38555,89960,2021-10-10
3172031001,JAKARTA UTARA,KOJA,KOJA,28175,7268,20907,15980,36887,2021-10-10
3173071006,JAKARTA BARAT,PALMERAH,KOTA BAMBU SELATAN,21158,5180,15978,11860,27838,2021-10-10
3173071003,JAKARTA BARAT,PALMERAH,KOTA BAMBU UTARA,24995,6244,18751,13841,32592,2021-10-10
3171041004,JAKARTA PUSAT,SENEN,KRAMAT,28835,7758,21077,15165,36242,2021-10-10
3175041001,JAKARTA TIMUR,KRAMAT JATI,KRAMAT JATI,34144,8434,25710,19662,45372,2021-10-10
3174071003,JAKARTA SELATAN,KEBAYORAN BARU,KRAMAT PELA,14413,3150,11263,9030,20293,2021-10-10
3173031002,JAKARTA BARAT,TAMAN SARI,KRUKUT,19244,4389,14855,11343,26198,2021-10-10
3174031005,JAKARTA SELATAN,MAMPANG PRAPATAN,KUNINGAN BARAT,12785,2735,10050,7798,17848,2021-10-10
3174021008,JAKARTA SELATAN,SETIA BUDI,KUNINGAN TIMUR,6008,1409,4599,3745,8344,2021-10-10
3171041005,JAKARTA PUSAT,SENEN,KWITANG,15486,3973,11513,8900,20413,2021-10-10
3172031003,JAKARTA UTARA,KOJA,LAGOA,59065,15935,43130,32273,75403,2021-10-10
3174061002,JAKARTA SELATAN,CILANDAK,LEBAK BULUS,37626,8330,29296,23632,52928,2021-10-10
3174091004,JAKARTA SELATAN,JAGAKARSA,LENTENG AGUNG,53946,11910,42036,31461,73497,2021-10-10
3175101007,JAKARTA TIMUR,CIPAYUNG,LUBANG BUAYA,63547,13811,49736,39231,88967,2021-10-10
3175081001,JAKARTA TIMUR,MAKASAR,MAKASAR,34390,7607,26783,21491,48274,2021-10-10
3175071006,JAKARTA TIMUR,DUREN SAWIT,MALAKA JAYA,30927,6429,24498,19687,44185,2021-10-10
3175071005,JAKARTA TIMUR,DUREN SAWIT,MALAKA SARI,27530,5450,22080,18008,40088,2021-10-10
3174031001,JAKARTA SELATAN,MAMPANG PRAPATAN,MAMPANG PRAPATAN,18159,4378,13781,10667,24448,2021-10-10
3173031005,JAKARTA BARAT,TAMAN SARI,MANGGA BESAR,7707,1463,6244,5188,11432,2021-10-10
3171021005,JAKARTA PUSAT,SAWAH BESAR,MANGGA DUA SELATAN,27442,6366,21076,16786,37862,2021-10-10
3174011007,JAKARTA SELATAN,TEBET,MANGGARAI,28373,5878,22495,17040,39535,2021-10-10
3174011006,JAKARTA SELATAN,TEBET,MANGGARAI SELATAN,23075,4801,18274,14549,32823,2021-10-10
3173031003,JAKARTA BARAT,TAMAN SARI,MAPHAR,16461,3615,12846,10177,23023,2021-10-10
3172041003,JAKARTA UTARA,CILINCING,MARUNDA,28943,7391,21552,15522,37074,2021-10-10
3174071001,JAKARTA SELATAN,KEBAYORAN BARU,MELAWAI,2627,565,2062,1849,3911,2021-10-10
3171061001,JAKARTA PUSAT,MENTENG,MENTENG,25624,6523,19101,14280,33381,2021-10-10
3174021005,JAKARTA SELATAN,SETIA BUDI,MENTENG ATAS,27816,5891,21925,17064,38989,2021-10-10
3174011003,JAKARTA SELATAN,TEBET,MENTENG DALAM,36028,8064,27964,21999,49963,2021-10-10
3173081003,JAKARTA BARAT,KEMBANGAN,MERUYA SELATAN,32130,7692,24438,19300,43738,2021-10-10
3173081002,JAKARTA BARAT,KEMBANGAN,MERUYA UTARA,43752,10399,33353,27406,60759,2021-10-10
3175101004,JAKARTA TIMUR,CIPAYUNG,MUNJUL,23871,5031,18840,14916,33756,2021-10-10
3172051002,JAKARTA UTARA,PADEMANGAN,PADEMANGAN BARAT,74240,19590,54650,41860,96510,2021-10-10
3172051001,JAKARTA UTARA,PADEMANGAN,PADEMANGAN TIMUR,37736,7550,30186,25006,55192,2021-10-10
3175011004,JAKARTA TIMUR,MATRAMAN,PAL MERIAM,19769,4867,14902,11332,26234,2021-10-10
3173071001,JAKARTA BARAT,PALMERAH,PALMERAH,63011,15683,47328,36357,83685,2021-10-10
3174081001,JAKARTA SELATAN,PANCORAN,PANCORAN,19421,4730,14691,11500,26191,2021-10-10
3172021003,JAKARTA UTARA,TANJUNG PRIOK,PAPANGGO,39097,8947,30150,23641,53791,2021-10-10
3171021001,JAKARTA PUSAT,SAWAH BESAR,PASAR BARU,12035,2569,9466,8089,17555,2021-10-10
3174021006,JAKARTA SELATAN,SETIA BUDI,PASAR MANGGIS,26752,6271,20481,15984,36465,2021-10-10
3174041001,JAKARTA SELATAN,PASAR MINGGU,PASAR MINGGU,24821,5450,19371,15474,34845,2021-10-10
3171041003,JAKARTA PUSAT,SENEN,PASEBAN,23533,5742,17791,13778,31569,2021-10-10
3173061005,JAKARTA BARAT,KALI DERES,PEGADUNGAN,75587,17395,58192,48109,106301,2021-10-10
3171061002,JAKARTA PUSAT,MENTENG,PEGANGSAAN,23455,5845,17610,12665,30275,2021-10-10
3172061002,JAKARTA UTARA,KELAPA GADING,PEGANGSAAN DUA,49976,9097,40879,35742,76621,2021-10-10
3172011004,JAKARTA UTARA,PENJARINGAN,PEJAGALAN,74578,17603,56975,46297,103272,2021-10-10
3174041006,JAKARTA SELATAN,PASAR MINGGU,PEJATEN BARAT,37346,8741,28605,22552,51157,2021-10-10
3174041005,JAKARTA SELATAN,PASAR MINGGU,PEJATEN TIMUR,57656,15001,42655,33049,75704,2021-10-10
3175051005,JAKARTA TIMUR,PASAR REBO,PEKAYON,43250,9128,34122,26727,60849,2021-10-10
3173041009,JAKARTA BARAT,TAMBORA,PEKOJAN,23587,5188,18399,14603,33002,2021-10-10
3174031003,JAKARTA SELATAN,MAMPANG PRAPATAN,PELA MAMPANG,43522,10120,33402,26336,59738,2021-10-10
3174081005,JAKARTA SELATAN,PANCORAN,PENGADEGAN,21478,4513,16965,13246,30211,2021-10-10
3175061003,JAKARTA TIMUR,CAKUNG,PENGGILINGAN,99255,26544,72711,54700,127411,2021-10-10
3172011001,JAKARTA UTARA,PENJARINGAN,PENJARINGAN,88308,25376,62932,46018,108950,2021-10-10
3174101001,JAKARTA SELATAN,PESANGGRAHAN,PESANGGRAHAN,27545,5484,22061,17836,39897,2021-10-10
3171071004,JAKARTA PUSAT,TANAH ABANG,PETAMBURAN,33271,9923,23348,16389,39737,2021-10-10
3174071008,JAKARTA SELATAN,KEBAYORAN BARU,PETOGOGAN,11499,2613,8886,7042,15928,2021-10-10
3171011004,JAKARTA PUSAT,GAMBIR,PETOJO SELATAN,14692,3753,10939,8809,19748,2021-10-10
3171011003,JAKARTA PUSAT,GAMBIR,PETOJO UTARA,17458,4237,13221,10271,23492,2021-10-10
3174101004,JAKARTA SELATAN,PESANGGRAHAN,PETUKANGAN SELATAN,37187,8812,28375,22625,51000,2021-10-10
3174101003,JAKARTA SELATAN,PESANGGRAHAN,PETUKANGAN UTARA,53716,13361,40355,31715,72070,2021-10-10
3175081002,JAKARTA TIMUR,MAKASAR,PINANG RANTI,27198,6766,20432,16099,36531,2021-10-10
3173031008,JAKARTA BARAT,TAMAN SARI,PINANGSIA,10729,2185,8544,6764,15308,2021-10-10
3175011001,JAKARTA TIMUR,MATRAMAN,PISANGAN BARU,31776,7683,24093,17811,41904,2021-10-10
3175021002,JAKARTA TIMUR,PULO GADUNG,PISANGAN TIMUR,41011,8901,32110,25589,57699,2021-10-10
3172011005,JAKARTA UTARA,PENJARINGAN,PLUIT,47783,10364,37419,31536,68955,2021-10-10
3175071002,JAKARTA TIMUR,DUREN SAWIT,PONDOK BAMBU,61550,15185,46365,36079,82444,2021-10-10
3175071004,JAKARTA TIMUR,DUREN SAWIT,PONDOK KELAPA,72015,16196,55819,45190,101009,2021-10-10
3175071007,JAKARTA TIMUR,DUREN SAWIT,PONDOK KOPI,35367,8046,27321,20149,47470,2021-10-10
3174061003,JAKARTA SELATAN,CILANDAK,PONDOK LABU,46464,9296,37168,30414,67582,2021-10-10
3174051002,JAKARTA SELATAN,KEBAYORAN LAMA,PONDOK PINANG,56169,12141,44028,34829,78857,2021-10-10
3175101003,JAKARTA TIMUR,CIPAYUNG,PONDOK RANGGON,25574,5436,20138,15628,35766,2021-10-10
3101011003,KAB.ADM.KEP.SERIBU,KEP. SERIBU UTARA,PULAU HARAPAN,2060,249,1811,1515,3326,2021-10-10
3101011002,KAB.ADM.KEP.SERIBU,KEP. SERIBU UTARA,PULAU KELAPA,5528,668,4860,3857,8717,2021-10-10
3101011001,KAB.ADM.KEP.SERIBU,KEP. SERIBU UTARA,PULAU PANGGANG,5450,527,4923,4265,9188,2021-10-10
3101021003,KAB.ADM.KEP.SERIBU,KEP. SERIBU SELATAN,PULAU PARI,2765,212,2553,2312,4865,2021-10-10
3101021002,KAB.ADM.KEP.SERIBU,KEP. SERIBU SELATAN,PULAU TIDUNG,4553,428,4125,3676,7801,2021-10-10
3101021001,KAB.ADM.KEP.SERIBU,KEP. SERIBU SELATAN,PULAU UNTUNG JAWA,1941,203,1738,1590,3328,2021-10-10
3174071007,JAKARTA SELATAN,KEBAYORAN BARU,PULO,5835,1130,4705,4052,8757,2021-10-10
3175021001,JAKARTA TIMUR,PULO GADUNG,PULO GADUNG,34422,8417,26005,20443,46448,2021-10-10
3175061005,JAKARTA TIMUR,CAKUNG,PULO GEBANG,97301,21576,75725,57798,133523,2021-10-10
3174041004,JAKARTA SELATAN,PASAR MINGGU,RAGUNAN,39616,8675,30941,24826,55767,2021-10-10
3175091005,JAKARTA TIMUR,CIRACAS,RAMBUTAN,36771,9813,26958,20240,47198,2021-10-10
3172031006,JAKARTA UTARA,KOJA,RAWA BADAK SELATAN,42179,11373,30806,22835,53641,2021-10-10
3172031004,JAKARTA UTARA,KOJA,RAWA BADAK UTARA,34408,8802,25606,19317,44923,2021-10-10
3174071005,JAKARTA SELATAN,KEBAYORAN BARU,RAWA BARAT,5625,1100,4525,3809,8334,2021-10-10
3173011003,JAKARTA BARAT,CENGKARENG,RAWA BUAYA,63799,14959,48840,36561,85401,2021-10-10
3175031004,JAKARTA TIMUR,JATINEGARA,RAWA BUNGA,21434,5864,15570,11795,27365,2021-10-10
3174081003,JAKARTA SELATAN,PANCORAN,RAWA JATI,20509,4487,16022,12528,28550,2021-10-10
3175061002,JAKARTA TIMUR,CAKUNG,RAWA TERATE,24637,5202,19435,15210,34645,2021-10-10
3175021005,JAKARTA TIMUR,PULO GADUNG,RAWAMANGUN,37612,8628,28984,23178,52162,2021-10-10
3171051003,JAKARTA PUSAT,CEMPAKA PUTIH,RAWASARI,21967,5195,16772,13447,30219,2021-10-10
3173041010,JAKARTA BARAT,TAMBORA,ROA MALAKA,3484,664,2820,2402,5222,2021-10-10
3172041006,JAKARTA UTARA,CILINCING,ROROTAN,41668,9579,32089,24482,56571,2021-10-10
3174071004,JAKARTA SELATAN,KEBAYORAN BARU,SELONG,2842,589,2253,1983,4236,2021-10-10
3173061002,JAKARTA BARAT,KALI DERES,SEMANAN,71354,18313,53041,40904,93945,2021-10-10
3172041007,JAKARTA UTARA,CILINCING,SEMPER BARAT,68587,15475,53112,42149,95261,2021-10-10
3172041005,JAKARTA UTARA,CILINCING,SEMPER TIMUR,36267,8774,27493,21105,48598,2021-10-10
3174071006,JAKARTA SELATAN,KEBAYORAN BARU,SENAYAN,2771,716,2055,1674,3729,2021-10-10
3171041001,JAKARTA PUSAT,SENEN,SENEN,6804,1646,5158,4164,9322,2021-10-10
3171031004,JAKARTA PUSAT,KEMAYORAN,SERDANG,29668,6791,22877,17916,40793,2021-10-10
3174021001,JAKARTA SELATAN,SETIA BUDI,SETIA BUDI,3023,710,2313,1859,4172,2021-10-10
3175101005,JAKARTA TIMUR,CIPAYUNG,SETU,20572,4933,15639,12003,27642,2021-10-10
3173071002,JAKARTA BARAT,PALMERAH,SLIPI,16591,3522,13069,10400,23469,2021-10-10
3173081004,JAKARTA BARAT,KEMBANGAN,SRENGSENG,45523,11654,33869,27144,61013,2021-10-10
3174091002,JAKARTA SELATAN,JAGAKARSA,SRENGSENG SAWAH,58196,11012,47184,37972,85156,2021-10-10
3173051003,JAKARTA BARAT,KEBON JERUK,SUKABUMI SELATAN,37033,9831,27202,20132,47334,2021-10-10
3173051002,JAKARTA BARAT,KEBON JERUK,SUKABUMI UTARA,38290,10411,27879,20630,48509,2021-10-10
3172041002,JAKARTA UTARA,CILINCING,SUKAPURA,53949,13815,40134,31497,71631,2021-10-10
3171031007,JAKARTA PUSAT,KEMAYORAN,SUMUR BATU,22717,5301,17416,13977,31393,2021-10-10
3172021004,JAKARTA UTARA,TANJUNG PRIOK,SUNGAI BAMBU,29876,6917,22959,18051,41010,2021-10-10
3172021006,JAKARTA UTARA,TANJUNG PRIOK,SUNTER AGUNG,71805,14038,57767,48262,106029,2021-10-10
3172021002,JAKARTA UTARA,TANJUNG PRIOK,SUNTER JAYA,63031,13042,49989,41302,91291,2021-10-10
3175091004,JAKARTA TIMUR,CIRACAS,SUSUKAN,38257,8222,30035,23711,53746,2021-10-10
3173031001,JAKARTA BARAT,TAMAN SARI,TAMAN SARI,14348,3064,11284,9255,20539,2021-10-10
3173041001,JAKARTA BARAT,TAMBORA,TAMBORA,10204,2582,7622,5871,13493,2021-10-10
3173041004,JAKARTA BARAT,TAMBORA,TANAH SEREAL,26387,5072,21315,16973,38288,2021-10-10
3171081004,JAKARTA PUSAT,JOHAR BARU,TANAH TINGGI,37693,7953,29740,22933,52673,2021-10-10
3173031004,JAKARTA BARAT,TAMAN SARI,TANGKI,13324,2571,10753,8490,19243,2021-10-10
3174091005,JAKARTA SELATAN,JAGAKARSA,TANJUNG BARAT,39770,7745,32025,24250,56275,2021-10-10
3173021005,JAKARTA BARAT,GROGOL PETAMBURAN,TANJUNG DUREN SELATAN,25337,5545,19792,16422,36214,2021-10-10
3173021002,JAKARTA BARAT,GROGOL PETAMBURAN,TANJUNG DUREN UTARA,17010,3334,13676,11559,25235,2021-10-10
3172021001,JAKARTA UTARA,TANJUNG PRIOK,TANJUNG PRIOK,34588,8065,26523,20759,47282,2021-10-10
3174011002,JAKARTA SELATAN,TEBET,TEBET BARAT,21194,4032,17162,14300,31462,2021-10-10
3174011001,JAKARTA SELATAN,TEBET,TEBET TIMUR,18199,3363,14836,12609,27445,2021-10-10
3173061003,JAKARTA BARAT,KALI DERES,TEGAL ALUR,83647,20307,63340,49587,112927,2021-10-10
3174031004,JAKARTA SELATAN,MAMPANG PRAPATAN,TEGAL PARANG,32401,8321,24080,17334,41414,2021-10-10
3173021003,JAKARTA BARAT,GROGOL PETAMBURAN,TOMANG,29605,6235,23370,18920,42290,2021-10-10
3172031005,JAKARTA UTARA,KOJA,TUGU SELATAN,39122,9882,29240,22247,51487,2021-10-10
3172031002,JAKARTA UTARA,KOJA,TUGU UTARA,67670,18204,49466,36873,86339,2021-10-10
3175061006,JAKARTA TIMUR,CAKUNG,UJUNG MENTENG,29934,5927,24007,19302,43309,2021-10-10
3174101005,JAKARTA SELATAN,PESANGGRAHAN,ULUJAMI,40544,10560,29984,23109,53093,2021-10-10
3175011006,JAKARTA TIMUR,MATRAMAN,UTAN KAYU SELATAN,33511,7115,26396,20401,46797,2021-10-10
3175011002,JAKARTA TIMUR,MATRAMAN,UTAN KAYU UTARA,28169,6768,21401,16511,37912,2021-10-10
3171031008,JAKARTA PUSAT,KEMAYORAN,UTAN PANJANG,29208,6851,22357,16726,39083,2021-10-10
3172021007,JAKARTA UTARA,TANJUNG PRIOK,WARAKAS,44401,9460,34941,26649,61590,2021-10-10
3173021007,JAKARTA BARAT,GROGOL PETAMBURAN,WIJAYA KUSUMA,38934,9607,29327,23334,52661,2021-10-10
3172051003,JAKARTA UTARA,PADEMANGAN,ANCOL,23947,6387,17560,13760,31320,2021-10-11
3173041007,JAKARTA BARAT,TAMBORA,ANGKE,29381,7199,22182,17092,39274,2021-10-11
3175041005,JAKARTA TIMUR,KRAMAT JATI,BALE KAMBANG,29074,8200,20874,15106,35980,2021-10-11
3175031003,JAKARTA TIMUR,JATINEGARA,BALI MESTER,9752,2330,7422,5881,13303,2021-10-11
3175101006,JAKARTA TIMUR,CIPAYUNG,BAMBU APUS,26285,5601,20684,15857,36541,2021-10-11
3174031002,JAKARTA SELATAN,MAMPANG PRAPATAN,BANGKA,21566,5393,16173,12582,28755,2021-10-11
3175051002,JAKARTA TIMUR,PASAR REBO,BARU,23886,4590,19296,15928,35224,2021-10-11
3175041004,JAKARTA TIMUR,KRAMAT JATI,BATU AMPAR,47898,13338,34560,25809,60369,2021-10-11
3171071002,JAKARTA PUSAT,TANAH ABANG,BENDUNGAN HILIR,21494,4914,16580,13268,29848,2021-10-11
3175031002,JAKARTA TIMUR,JATINEGARA,BIDARA CINA,36689,10010,26679,19918,46597,2021-10-11
3174101002,JAKARTA SELATAN,PESANGGRAHAN,BINTARO,53098,12168,40930,33165,74095,2021-10-11
3174011005,JAKARTA SELATAN,TEBET,BUKIT DURI,34183,8144,26039,20309,46348,2021-10-11
3171041006,JAKARTA PUSAT,SENEN,BUNGUR,18144,4396,13748,10926,24674,2021-10-11
3175061007,JAKARTA TIMUR,CAKUNG,CAKUNG BARAT,57724,13448,44276,35003,79279,2021-10-11
3175061004,JAKARTA TIMUR,CAKUNG,CAKUNG TIMUR,58287,13103,45184,35611,80795,2021-10-11
3175041007,JAKARTA TIMUR,KRAMAT JATI,CAWANG,32762,8268,24494,18358,42852,2021-10-11
3175101008,JAKARTA TIMUR,CIPAYUNG,CEGER,18932,4247,14685,11603,26288,2021-10-11
3171031006,JAKARTA PUSAT,KEMAYORAN,CEMPAKA BARU,32581,7826,24755,18478,43233,2021-10-11
3171051002,JAKARTA PUSAT,CEMPAKA PUTIH,CEMPAKA PUTIH BARAT,35885,8697,27188,21731,48919,2021-10-11
3171051001,JAKARTA PUSAT,CEMPAKA PUTIH,CEMPAKA PUTIH TIMUR,24292,5645,18647,15329,33976,2021-10-11
3173011001,JAKARTA BARAT,CENGKARENG,CENGKARENG BARAT,66284,15556,50728,40371,91099,2021-10-11
3173011006,JAKARTA BARAT,CENGKARENG,CENGKARENG TIMUR,81027,18429,62598,48445,111043,2021-10-11
3175091002,JAKARTA TIMUR,CIRACAS,CIBUBUR,66364,13114,53250,42191,95441,2021-10-11
3171011002,JAKARTA PUSAT,GAMBIR,CIDENG,15390,3328,12062,10015,22077,2021-10-11
3174091003,JAKARTA SELATAN,JAGAKARSA,CIGANJUR,38497,8057,30440,23251,53691,2021-10-11
3175051003,JAKARTA TIMUR,PASAR REBO,CIJANTUNG,41419,8819,32600,25722,58322,2021-10-11
3171061003,JAKARTA PUSAT,MENTENG,CIKINI,8274,1673,6601,4849,11450,2021-10-11
3174081006,JAKARTA SELATAN,PANCORAN,CIKOKO,10547,2134,8413,6897,15310,2021-10-11
3174061001,JAKARTA SELATAN,CILANDAK,CILANDAK BARAT,51752,10949,40803,33366,74169,2021-10-11
3174041003,JAKARTA SELATAN,PASAR MINGGU,CILANDAK TIMUR,25145,5454,19691,15879,35570,2021-10-11
3175101002,JAKARTA TIMUR,CIPAYUNG,CILANGKAP,27635,5628,22007,17225,39232,2021-10-11
3175041006,JAKARTA TIMUR,KRAMAT JATI,CILILITAN,40181,10305,29876,22652,52528,2021-10-11
3172041001,JAKARTA UTARA,CILINCING,CILINCING,43609,11775,31834,23414,55248,2021-10-11
3175101001,JAKARTA TIMUR,CIPAYUNG,CIPAYUNG,26104,5166,20938,17052,37990,2021-10-11
3174091006,JAKARTA SELATAN,JAGAKARSA,CIPEDAK,38303,7883,30420,24037,54457,2021-10-11
3174061005,JAKARTA SELATAN,CILANDAK,CIPETE SELATAN,26704,5886,20818,17074,37892,2021-10-11
3174071010,JAKARTA SELATAN,KEBAYORAN BARU,CIPETE UTARA,34102,7517,26585,20539,47124,2021-10-11
3175021003,JAKARTA TIMUR,PULO GADUNG,CIPINANG,39306,8718,30588,23824,54412,2021-10-11
3175031007,JAKARTA TIMUR,JATINEGARA,CIPINANG BESAR SELATAN,35212,9484,25728,18713,44441,2021-10-11
3175031008,JAKARTA TIMUR,JATINEGARA,CIPINANG BESAR UTARA,45319,12254,33065,23879,56944,2021-10-11
3175031005,JAKARTA TIMUR,JATINEGARA,CIPINANG CEMPEDAK,32824,8027,24797,19354,44151,2021-10-11
3175081005,JAKARTA TIMUR,MAKASAR,CIPINANG MELAYU,42308,9268,33040,26133,59173,2021-10-11
3175031006,JAKARTA TIMUR,JATINEGARA,CIPINANG MUARA,55243,13766,41477,31686,73163,2021-10-11
3174051003,JAKARTA SELATAN,KEBAYORAN LAMA,CIPULIR,39937,9633,30304,22727,53031,2021-10-11
3175091001,JAKARTA TIMUR,CIRACAS,CIRACAS,64594,13516,51078,39707,90785,2021-10-11
3175041003,JAKARTA TIMUR,KRAMAT JATI,DUKUH,24609,5390,19219,14868,34087,2021-10-11
3175071001,JAKARTA TIMUR,DUREN SAWIT,DUREN SAWIT,61160,14768,46392,35709,82101,2021-10-11
3174081004,JAKARTA SELATAN,PANCORAN,DUREN TIGA,28319,6437,21882,16413,38295,2021-10-11
3173051005,JAKARTA BARAT,KEBON JERUK,DURI KEPA,60138,13349,46789,38809,85598,2021-10-11
3173011002,JAKARTA BARAT,CENGKARENG,DURI KOSAMBI,77923,19870,58053,43736,101789,2021-10-11
3171011006,JAKARTA PUSAT,GAMBIR,DURI PULO,19610,4671,14939,11440,26379,2021-10-11
3173041011,JAKARTA BARAT,TAMBORA,DURI SELATAN,14259,2905,11354,9148,20502,2021-10-11
3173041003,JAKARTA BARAT,TAMBORA,DURI UTARA,19844,4364,15480,12053,27533,2021-10-11
3171081003,JAKARTA PUSAT,JOHAR BARU,GALUR,18243,4055,14188,10985,25173,2021-10-11
3171011001,JAKARTA PUSAT,GAMBIR,GAMBIR,2191,507,1684,1377,3061,2021-10-11
3174061004,JAKARTA SELATAN,CILANDAK,GANDARIA SELATAN,22119,4970,17149,13660,30809,2021-10-11
3174071009,JAKARTA SELATAN,KEBAYORAN BARU,GANDARIA UTARA,39922,9221,30701,24107,54808,2021-10-11
3175051001,JAKARTA TIMUR,PASAR REBO,GEDONG,35755,8127,27628,21990,49618,2021-10-11
3171071001,JAKARTA PUSAT,TANAH ABANG,GELORA,3127,686,2441,1964,4405,2021-10-11
3173031007,JAKARTA BARAT,TAMAN SARI,GLODOK,7837,1447,6390,5552,11942,2021-10-11
3171061004,JAKARTA PUSAT,MENTENG,GONDANGDIA,4100,992,3108,2751,5859,2021-10-11
3173021001,JAKARTA BARAT,GROGOL PETAMBURAN,GROGOL,16876,3837,13039,10426,23465,2021-10-11
3174051005,JAKARTA SELATAN,KEBAYORAN LAMA,GROGOL SELATAN,44251,10496,33755,25999,59754,2021-10-11
3174051004,JAKARTA SELATAN,KEBAYORAN LAMA,GROGOL UTARA,42494,10158,32336,25481,57817,2021-10-11
3174021007,JAKARTA SELATAN,SETIA BUDI,GUNTUR,3985,854,3131,2650,5781,2021-10-11
3174071002,JAKARTA SELATAN,KEBAYORAN BARU,GUNUNG,9436,1997,7439,6176,13615,2021-10-11
3171031005,JAKARTA PUSAT,KEMAYORAN,GUNUNG SAHARI SELATAN,19199,4486,14713,11702,26415,2021-10-11
3171021004,JAKARTA PUSAT,SAWAH BESAR,GUNUNG SAHARI UTARA,16650,3327,13323,11316,24639,2021-10-11
3175081004,JAKARTA TIMUR,MAKASAR,HALIM PERDANA KUSUMAH,28363,4260,24103,21304,45407,2021-10-11
3171031003,JAKARTA PUSAT,KEMAYORAN,HARAPAN MULIA,22557,5299,17258,13193,30451,2021-10-11
3174091001,JAKARTA SELATAN,JAGAKARSA,JAGAKARSA,62389,13312,49077,38870,87947,2021-10-11
3175021007,JAKARTA TIMUR,PULO GADUNG,JATI,32757,7178,25579,20957,46536,2021-10-11
3174041002,JAKARTA SELATAN,PASAR MINGGU,JATI PADANG,37502,8890,28612,22719,51331,2021-10-11
3173071004,JAKARTA BARAT,PALMERAH,JATI PULO,28738,6552,22186,16857,39043,2021-10-11
3175061001,JAKARTA TIMUR,CAKUNG,JATINEGARA,84160,20745,63415,49670,113085,2021-10-11
3175021004,JAKARTA TIMUR,PULO GADUNG,JATINEGARA KAUM,24632,5316,19316,14742,34058,2021-10-11
3173021004,JAKARTA BARAT,GROGOL PETAMBURAN,JELAMBAR,30266,6360,23906,19506,43412,2021-10-11
3173021006,JAKARTA BARAT,GROGOL PETAMBURAN,JELAMBAR BARU,38246,8292,29954,24436,54390,2021-10-11
3173041006,JAKARTA BARAT,TAMBORA,JEMBATAN BESI,29314,8276,21038,15285,36323,2021-10-11
3173041008,JAKARTA BARAT,TAMBORA,JEMBATAN LIMA,21021,5630,15391,11459,26850,2021-10-11
3173081005,JAKARTA BARAT,KEMBANGAN,JOGLO,40839,9521,31318,25134,56452,2021-10-11
3171081001,JAKARTA PUSAT,JOHAR BARU,JOHAR BARU,37488,7858,29630,23693,53323,2021-10-11
3173041002,JAKARTA BARAT,TAMBORA,KALI ANYAR,23856,5582,18274,13652,31926,2021-10-11
3172041004,JAKARTA UTARA,CILINCING,KALIBARU,67684,21227,46457,31752,78209,2021-10-11
3174081002,JAKARTA SELATAN,PANCORAN,KALIBATA,41994,11048,30946,22889,53835,2021-10-11
3173061001,JAKARTA BARAT,KALI DERES,KALIDERES,72447,17278,55169,44556,99725,2021-10-11
3175051004,JAKARTA TIMUR,PASAR REBO,KALISARI,43212,8988,34224,27152,61376,2021-10-11
3173061004,JAKARTA BARAT,KALI DERES,KAMAL,53783,14518,39265,29622,68887,2021-10-11
3172011002,JAKARTA UTARA,PENJARINGAN,KAMAL MUARA,12930,2451,10479,8715,19194,2021-10-11
3171071007,JAKARTA PUSAT,TANAH ABANG,KAMPUNG BALI,11358,2772,8586,6107,14693,2021-10-11
3175031001,JAKARTA TIMUR,JATINEGARA,KAMPUNG MELAYU,25717,7080,18637,13505,32142,2021-10-11
3171081002,JAKARTA PUSAT,JOHAR BARU,KAMPUNG RAWA,21237,3909,17328,13197,30525,2021-10-11
3175041002,JAKARTA TIMUR,KRAMAT JATI,KAMPUNG TENGAH,43993,12371,31622,23577,55199,2021-10-11
3173011005,JAKARTA BARAT,CENGKARENG,KAPUK,134466,36650,97816,74094,171910,2021-10-11
3172011003,JAKARTA UTARA,PENJARINGAN,KAPUK MUARA,35781,7693,28088,23829,51917,2021-10-11
3171021002,JAKARTA PUSAT,SAWAH BESAR,KARANG ANYAR,25761,5625,20136,15977,36113,2021-10-11
3174021004,JAKARTA SELATAN,SETIA BUDI,KARET,9623,2129,7494,5869,13363,2021-10-11
3174021003,JAKARTA SELATAN,SETIA BUDI,KARET KUNINGAN,16055,3566,12489,10106,22595,2021-10-11
3174021002,JAKARTA SELATAN,SETIA BUDI,KARET SEMANGGI,2770,600,2170,1844,4014,2021-10-11
3171071003,JAKARTA PUSAT,TANAH ABANG,KARET TENGSIN,19271,4210,15061,11487,26548,2021-10-11
3171021003,JAKARTA PUSAT,SAWAH BESAR,KARTINI,22292,4911,17381,14010,31391,2021-10-11
3175011003,JAKARTA TIMUR,MATRAMAN,KAYU MANIS,25284,6162,19122,14088,33210,2021-10-11
3175021006,JAKARTA TIMUR,PULO GADUNG,KAYU PUTIH,40696,8723,31973,26581,58554,2021-10-11
3173031006,JAKARTA BARAT,TAMAN SARI,KEAGUNGAN,17387,3932,13455,10470,23925,2021-10-11
3174041007,JAKARTA SELATAN,PASAR MINGGU,KEBAGUSAN,44552,10388,34164,25863,60027,2021-10-11
3174051006,JAKARTA SELATAN,KEBAYORAN LAMA,KEBAYORAN LAMA SELATAN,41212,8802,32410,25601,58011,2021-10-11
3174051001,JAKARTA SELATAN,KEBAYORAN LAMA,KEBAYORAN LAMA UTARA,42422,10401,32021,24802,56823,2021-10-11
3174011004,JAKARTA SELATAN,TEBET,KEBON BARU,35165,7785,27380,21284,48664,2021-10-11
3172021005,JAKARTA UTARA,TANJUNG PRIOK,KEBON BAWANG,50952,11838,39114,30752,69866,2021-10-11
3173051001,JAKARTA BARAT,KEBON JERUK,KEBON JERUK,53887,13574,40313,31353,71666,2021-10-11
3171071006,JAKARTA PUSAT,TANAH ABANG,KEBON KACANG,21531,5893,15638,11675,27313,2021-10-11
3171011005,JAKARTA PUSAT,GAMBIR,KEBON KELAPA,10163,2286,7877,6233,14110,2021-10-11
3171031002,JAKARTA PUSAT,KEMAYORAN,KEBON KOSONG,30019,7052,22967,17428,40395,2021-10-11
3175011005,JAKARTA TIMUR,MATRAMAN,KEBON MANGGIS,16490,3702,12788,9999,22787,2021-10-11
3171071005,JAKARTA PUSAT,TANAH ABANG,KEBON MELATI,32206,9528,22678,15707,38385,2021-10-11
3175081003,JAKARTA TIMUR,MAKASAR,KEBON PALA,46614,10718,35896,28189,64085,2021-10-11
3171061005,JAKARTA PUSAT,MENTENG,KEBON SIRIH,12299,2978,9321,7018,16339,2021-10-11
3173011004,JAKARTA BARAT,CENGKARENG,KEDAUNG KALI ANGKE,32612,7151,25461,20268,45729,2021-10-11
3173051007,JAKARTA BARAT,KEBON JERUK,KEDOYA SELATAN,32165,6910,25255,19916,45171,2021-10-11
3173051006,JAKARTA BARAT,KEBON JERUK,KEDOYA UTARA,45740,9910,35830,29313,65143,2021-10-11
3173051004,JAKARTA BARAT,KEBON JERUK,KELAPA DUA,23565,5696,17869,14147,32016,2021-10-11
3175091003,JAKARTA TIMUR,CIRACAS,KELAPA DUA WETAN,46875,9311,37564,29889,67453,2021-10-11
3172061003,JAKARTA UTARA,KELAPA GADING,KELAPA GADING BARAT,35717,6884,28833,25144,53977,2021-10-11
3172061001,JAKARTA UTARA,KELAPA GADING,KELAPA GADING TIMUR,33592,5704,27888,24821,52709,2021-10-11
3173071005,JAKARTA BARAT,PALMERAH,KEMANGGISAN,32139,7050,25089,19668,44757,2021-10-11
3171031001,JAKARTA PUSAT,KEMAYORAN,KEMAYORAN,20708,4859,15849,12448,28297,2021-10-11
3173081006,JAKARTA BARAT,KEMBANGAN,KEMBANGAN SELATAN,27130,6495,20635,17224,37859,2021-10-11
3173081001,JAKARTA BARAT,KEMBANGAN,KEMBANGAN UTARA,54451,13519,40932,32539,73471,2021-10-11
3171041002,JAKARTA PUSAT,SENEN,KENARI,9579,2121,7458,6050,13508,2021-10-11
3173041005,JAKARTA BARAT,TAMBORA,KERENDANG,19973,4790,15183,11609,26792,2021-10-11
3175071003,JAKARTA TIMUR,DUREN SAWIT,KLENDER,69978,18536,51442,38623,90065,2021-10-11
3172031001,JAKARTA UTARA,KOJA,KOJA,28175,7210,20965,15995,36960,2021-10-11
3173071006,JAKARTA BARAT,PALMERAH,KOTA BAMBU SELATAN,21158,5164,15994,11885,27879,2021-10-11
3173071003,JAKARTA BARAT,PALMERAH,KOTA BAMBU UTARA,24995,6228,18767,13863,32630,2021-10-11
3171041004,JAKARTA PUSAT,SENEN,KRAMAT,28835,7747,21088,15194,36282,2021-10-11
3175041001,JAKARTA TIMUR,KRAMAT JATI,KRAMAT JATI,34144,8408,25736,19678,45414,2021-10-11
3174071003,JAKARTA SELATAN,KEBAYORAN BARU,KRAMAT PELA,14413,3142,11271,9046,20317,2021-10-11
3173031002,JAKARTA BARAT,TAMAN SARI,KRUKUT,19244,4375,14869,11354,26223,2021-10-11
3174031005,JAKARTA SELATAN,MAMPANG PRAPATAN,KUNINGAN BARAT,12785,2730,10055,7811,17866,2021-10-11
3174021008,JAKARTA SELATAN,SETIA BUDI,KUNINGAN TIMUR,6008,1407,4601,3748,8349,2021-10-11
3171041005,JAKARTA PUSAT,SENEN,KWITANG,15486,3967,11519,8910,20429,2021-10-11
3172031003,JAKARTA UTARA,KOJA,LAGOA,59065,15904,43161,32320,75481,2021-10-11
3174061002,JAKARTA SELATAN,CILANDAK,LEBAK BULUS,37626,8309,29317,23663,52980,2021-10-11
3174091004,JAKARTA SELATAN,JAGAKARSA,LENTENG AGUNG,53946,11768,42178,31530,73708,2021-10-11
3175101007,JAKARTA TIMUR,CIPAYUNG,LUBANG BUAYA,63547,13779,49768,39270,89038,2021-10-11
3175081001,JAKARTA TIMUR,MAKASAR,MAKASAR,34390,7316,27074,21520,48594,2021-10-11
3175071006,JAKARTA TIMUR,DUREN SAWIT,MALAKA JAYA,30927,6413,24514,19730,44244,2021-10-11
3175071005,JAKARTA TIMUR,DUREN SAWIT,MALAKA SARI,27530,5434,22096,18031,40127,2021-10-11
3174031001,JAKARTA SELATAN,MAMPANG PRAPATAN,MAMPANG PRAPATAN,18159,4369,13790,10683,24473,2021-10-11
3173031005,JAKARTA BARAT,TAMAN SARI,MANGGA BESAR,7707,1459,6248,5197,11445,2021-10-11
3171021005,JAKARTA PUSAT,SAWAH BESAR,MANGGA DUA SELATAN,27442,6354,21088,16808,37896,2021-10-11
3174011007,JAKARTA SELATAN,TEBET,MANGGARAI,28373,5858,22515,17064,39579,2021-10-11
3174011006,JAKARTA SELATAN,TEBET,MANGGARAI SELATAN,23075,4791,18284,14575,32859,2021-10-11
3173031003,JAKARTA BARAT,TAMAN SARI,MAPHAR,16461,3599,12862,10203,23065,2021-10-11
3172041003,JAKARTA UTARA,CILINCING,MARUNDA,28943,7385,21558,15528,37086,2021-10-11
3174071001,JAKARTA SELATAN,KEBAYORAN BARU,MELAWAI,2627,564,2063,1851,3914,2021-10-11
3171061001,JAKARTA PUSAT,MENTENG,MENTENG,25624,6504,19120,14296,33416,2021-10-11
3174021005,JAKARTA SELATAN,SETIA BUDI,MENTENG ATAS,27816,5874,21942,17089,39031,2021-10-11
3174011003,JAKARTA SELATAN,TEBET,MENTENG DALAM,36028,8047,27981,22035,50016,2021-10-11
3173081003,JAKARTA BARAT,KEMBANGAN,MERUYA SELATAN,32130,7675,24455,19321,43776,2021-10-11
3173081002,JAKARTA BARAT,KEMBANGAN,MERUYA UTARA,43752,10372,33380,27467,60847,2021-10-11
3175101004,JAKARTA TIMUR,CIPAYUNG,MUNJUL,23871,5022,18849,14931,33780,2021-10-11
3172051002,JAKARTA UTARA,PADEMANGAN,PADEMANGAN BARAT,74240,19549,54691,41929,96620,2021-10-11
3172051001,JAKARTA UTARA,PADEMANGAN,PADEMANGAN TIMUR,37736,7525,30211,25029,55240,2021-10-11
3175011004,JAKARTA TIMUR,MATRAMAN,PAL MERIAM,19769,4782,14987,11352,26339,2021-10-11
3173071001,JAKARTA BARAT,PALMERAH,PALMERAH,63011,15593,47418,36425,83843,2021-10-11
3174081001,JAKARTA SELATAN,PANCORAN,PANCORAN,19421,4718,14703,11518,26221,2021-10-11
3172021003,JAKARTA UTARA,TANJUNG PRIOK,PAPANGGO,39097,8921,30176,23669,53845,2021-10-11
3171021001,JAKARTA PUSAT,SAWAH BESAR,PASAR BARU,12035,2566,9469,8093,17562,2021-10-11
3174021006,JAKARTA SELATAN,SETIA BUDI,PASAR MANGGIS,26752,6254,20498,16010,36508,2021-10-11
3174041001,JAKARTA SELATAN,PASAR MINGGU,PASAR MINGGU,24821,5434,19387,15501,34888,2021-10-11
3171041003,JAKARTA PUSAT,SENEN,PASEBAN,23533,5722,17811,13798,31609,2021-10-11
3173061005,JAKARTA BARAT,KALI DERES,PEGADUNGAN,75587,17373,58214,48156,106370,2021-10-11
3171061002,JAKARTA PUSAT,MENTENG,PEGANGSAAN,23455,5825,17630,12680,30310,2021-10-11
3172061002,JAKARTA UTARA,KELAPA GADING,PEGANGSAAN DUA,49976,9081,40895,35775,76670,2021-10-11
3172011004,JAKARTA UTARA,PENJARINGAN,PEJAGALAN,74578,17540,57038,46365,103403,2021-10-11
3174041006,JAKARTA SELATAN,PASAR MINGGU,PEJATEN BARAT,37346,8659,28687,22576,51263,2021-10-11
3174041005,JAKARTA SELATAN,PASAR MINGGU,PEJATEN TIMUR,57656,14978,42678,33095,75773,2021-10-11
3175051005,JAKARTA TIMUR,PASAR REBO,PEKAYON,43250,9085,34165,26774,60939,2021-10-11
3173041009,JAKARTA BARAT,TAMBORA,PEKOJAN,23587,5169,18418,14626,33044,2021-10-11
3174031003,JAKARTA SELATAN,MAMPANG PRAPATAN,PELA MAMPANG,43522,10075,33447,26362,59809,2021-10-11
3174081005,JAKARTA SELATAN,PANCORAN,PENGADEGAN,21478,4502,16976,13272,30248,2021-10-11
3175061003,JAKARTA TIMUR,CAKUNG,PENGGILINGAN,99255,26498,72757,54782,127539,2021-10-11
3172011001,JAKARTA UTARA,PENJARINGAN,PENJARINGAN,88308,25309,62999,46077,109076,2021-10-11
3174101001,JAKARTA SELATAN,PESANGGRAHAN,PESANGGRAHAN,27545,5468,22077,17857,39934,2021-10-11
3171071004,JAKARTA PUSAT,TANAH ABANG,PETAMBURAN,33271,9875,23396,16429,39825,2021-10-11
3174071008,JAKARTA SELATAN,KEBAYORAN BARU,PETOGOGAN,11499,2607,8892,7052,15944,2021-10-11
3171011004,JAKARTA PUSAT,GAMBIR,PETOJO SELATAN,14692,3748,10944,8816,19760,2021-10-11
3171011003,JAKARTA PUSAT,GAMBIR,PETOJO UTARA,17458,4233,13225,10284,23509,2021-10-11
3174101004,JAKARTA SELATAN,PESANGGRAHAN,PETUKANGAN SELATAN,37187,8784,28403,22667,51070,2021-10-11
3174101003,JAKARTA SELATAN,PESANGGRAHAN,PETUKANGAN UTARA,53716,13339,40377,31772,72149,2021-10-11
3175081002,JAKARTA TIMUR,MAKASAR,PINANG RANTI,27198,6748,20450,16120,36570,2021-10-11
3173031008,JAKARTA BARAT,TAMAN SARI,PINANGSIA,10729,2170,8559,6789,15348,2021-10-11
3175011001,JAKARTA TIMUR,MATRAMAN,PISANGAN BARU,31776,7671,24105,17844,41949,2021-10-11
3175021002,JAKARTA TIMUR,PULO GADUNG,PISANGAN TIMUR,41011,8861,32150,25629,57779,2021-10-11
3172011005,JAKARTA UTARA,PENJARINGAN,PLUIT,47783,10345,37438,31557,68995,2021-10-11
3175071002,JAKARTA TIMUR,DUREN SAWIT,PONDOK BAMBU,61550,15144,46406,36138,82544,2021-10-11
3175071004,JAKARTA TIMUR,DUREN SAWIT,PONDOK KELAPA,72015,16153,55862,45262,101124,2021-10-11
3175071007,JAKARTA TIMUR,DUREN SAWIT,PONDOK KOPI,35367,8023,27344,20192,47536,2021-10-11
3174061003,JAKARTA SELATAN,CILANDAK,PONDOK LABU,46464,9265,37199,30473,67672,2021-10-11
3174051002,JAKARTA SELATAN,KEBAYORAN LAMA,PONDOK PINANG,56169,12125,44044,34877,78921,2021-10-11
3175101003,JAKARTA TIMUR,CIPAYUNG,PONDOK RANGGON,25574,5425,20149,15642,35791,2021-10-11
3101011003,KAB.ADM.KEP.SERIBU,KEP. SERIBU UTARA,PULAU HARAPAN,2060,249,1811,1515,3326,2021-10-11
3101011002,KAB.ADM.KEP.SERIBU,KEP. SERIBU UTARA,PULAU KELAPA,5528,664,4864,3859,8723,2021-10-11
3101011001,KAB.ADM.KEP.SERIBU,KEP. SERIBU UTARA,PULAU PANGGANG,5450,526,4924,4267,9191,2021-10-11
3101021003,KAB.ADM.KEP.SERIBU,KEP. SERIBU SELATAN,PULAU PARI,2765,212,2553,2314,4867,2021-10-11
3101021002,KAB.ADM.KEP.SERIBU,KEP. SERIBU SELATAN,PULAU TIDUNG,4553,426,4127,3680,7807,2021-10-11
3101021001,KAB.ADM.KEP.SERIBU,KEP. SERIBU SELATAN,PULAU UNTUNG JAWA,1941,203,1738,1590,3328,2021-10-11
3174071007,JAKARTA SELATAN,KEBAYORAN BARU,PULO,5835,1130,4705,4060,8765,2021-10-11
3175021001,JAKARTA TIMUR,PULO GADUNG,PULO GADUNG,34422,8407,26015,20463,46478,2021-10-11
3175061005,JAKARTA TIMUR,CAKUNG,PULO GEBANG,97301,21533,75768,57896,133664,2021-10-11
3174041004,JAKARTA SELATAN,PASAR MINGGU,RAGUNAN,39616,8662,30954,24857,55811,2021-10-11
3175091005,JAKARTA TIMUR,CIRACAS,RAMBUTAN,36771,9797,26974,20264,47238,2021-10-11
3172031006,JAKARTA UTARA,KOJA,RAWA BADAK SELATAN,42179,11355,30824,22863,53687,2021-10-11
3172031004,JAKARTA UTARA,KOJA,RAWA BADAK UTARA,34408,8772,25636,19348,44984,2021-10-11
3174071005,JAKARTA SELATAN,KEBAYORAN BARU,RAWA BARAT,5625,1097,4528,3810,8338,2021-10-11
3173011003,JAKARTA BARAT,CENGKARENG,RAWA BUAYA,63799,14935,48864,36638,85502,2021-10-11
3175031004,JAKARTA TIMUR,JATINEGARA,RAWA BUNGA,21434,5847,15587,11810,27397,2021-10-11
3174081003,JAKARTA SELATAN,PANCORAN,RAWA JATI,20509,4473,16036,12538,28574,2021-10-11
3175061002,JAKARTA TIMUR,CAKUNG,RAWA TERATE,24637,5191,19446,15233,34679,2021-10-11
3175021005,JAKARTA TIMUR,PULO GADUNG,RAWAMANGUN,37612,8606,29006,23205,52211,2021-10-11
3171051003,JAKARTA PUSAT,CEMPAKA PUTIH,RAWASARI,21967,5183,16784,13467,30251,2021-10-11
3173041010,JAKARTA BARAT,TAMBORA,ROA MALAKA,3484,664,2820,2406,5226,2021-10-11
3172041006,JAKARTA UTARA,CILINCING,ROROTAN,41668,9561,32107,24509,56616,2021-10-11
3174071004,JAKARTA SELATAN,KEBAYORAN BARU,SELONG,2842,589,2253,1988,4241,2021-10-11
3173061002,JAKARTA BARAT,KALI DERES,SEMANAN,71354,18251,53103,40990,94093,2021-10-11
3172041007,JAKARTA UTARA,CILINCING,SEMPER BARAT,68587,15437,53150,42198,95348,2021-10-11
3172041005,JAKARTA UTARA,CILINCING,SEMPER TIMUR,36267,8756,27511,21129,48640,2021-10-11
3174071006,JAKARTA SELATAN,KEBAYORAN BARU,SENAYAN,2771,715,2056,1676,3732,2021-10-11
3171041001,JAKARTA PUSAT,SENEN,SENEN,6804,1642,5162,4172,9334,2021-10-11
3171031004,JAKARTA PUSAT,KEMAYORAN,SERDANG,29668,6778,22890,17936,40826,2021-10-11
3174021001,JAKARTA SELATAN,SETIA BUDI,SETIA BUDI,3023,709,2314,1860,4174,2021-10-11
3175101005,JAKARTA TIMUR,CIPAYUNG,SETU,20572,4927,15645,12014,27659,2021-10-11
3173071002,JAKARTA BARAT,PALMERAH,SLIPI,16591,3514,13077,10416,23493,2021-10-11
3173081004,JAKARTA BARAT,KEMBANGAN,SRENGSENG,45523,11631,33892,27181,61073,2021-10-11
3174091002,JAKARTA SELATAN,JAGAKARSA,SRENGSENG SAWAH,58196,10995,47201,38015,85216,2021-10-11
3173051003,JAKARTA BARAT,KEBON JERUK,SUKABUMI SELATAN,37033,9671,27362,20157,47519,2021-10-11
3173051002,JAKARTA BARAT,KEBON JERUK,SUKABUMI UTARA,38290,10368,27922,20661,48583,2021-10-11
3172041002,JAKARTA UTARA,CILINCING,SUKAPURA,53949,13781,40168,31538,71706,2021-10-11
3171031007,JAKARTA PUSAT,KEMAYORAN,SUMUR BATU,22717,5292,17425,13989,31414,2021-10-11
3172021004,JAKARTA UTARA,TANJUNG PRIOK,SUNGAI BAMBU,29876,6862,23014,18076,41090,2021-10-11
3172021006,JAKARTA UTARA,TANJUNG PRIOK,SUNTER AGUNG,71805,14001,57804,48302,106106,2021-10-11
3172021002,JAKARTA UTARA,TANJUNG PRIOK,SUNTER JAYA,63031,13000,50031,41348,91379,2021-10-11
3175091004,JAKARTA TIMUR,CIRACAS,SUSUKAN,38257,8203,30054,23739,53793,2021-10-11
3173031001,JAKARTA BARAT,TAMAN SARI,TAMAN SARI,14348,3052,11296,9301,20597,2021-10-11
3173041001,JAKARTA BARAT,TAMBORA,TAMBORA,10204,2573,7631,5881,13512,2021-10-11
3173041004,JAKARTA BARAT,TAMBORA,TANAH SEREAL,26387,5045,21342,17000,38342,2021-10-11
3171081004,JAKARTA PUSAT,JOHAR BARU,TANAH TINGGI,37693,7935,29758,22964,52722,2021-10-11
3173031004,JAKARTA BARAT,TAMAN SARI,TANGKI,13324,2568,10756,8501,19257,2021-10-11
3174091005,JAKARTA SELATAN,JAGAKARSA,TANJUNG BARAT,39770,7720,32050,24283,56333,2021-10-11
3173021005,JAKARTA BARAT,GROGOL PETAMBURAN,TANJUNG DUREN SELATAN,25337,5539,19798,16450,36248,2021-10-11
3173021002,JAKARTA BARAT,GROGOL PETAMBURAN,TANJUNG DUREN UTARA,17010,3326,13684,11565,25249,2021-10-11
3172021001,JAKARTA UTARA,TANJUNG PRIOK,TANJUNG PRIOK,34588,8043,26545,20780,47325,2021-10-11
3174011002,JAKARTA SELATAN,TEBET,TEBET BARAT,21194,4018,17176,14325,31501,2021-10-11
3174011001,JAKARTA SELATAN,TEBET,TEBET TIMUR,18199,3353,14846,12626,27472,2021-10-11
3173061003,JAKARTA BARAT,KALI DERES,TEGAL ALUR,83647,20285,63362,49641,113003,2021-10-11
3174031004,JAKARTA SELATAN,MAMPANG PRAPATAN,TEGAL PARANG,32401,8276,24125,17364,41489,2021-10-11
3173021003,JAKARTA BARAT,GROGOL PETAMBURAN,TOMANG,29605,6218,23387,18953,42340,2021-10-11
3172031005,JAKARTA UTARA,KOJA,TUGU SELATAN,39122,9857,29265,22276,51541,2021-10-11
3172031002,JAKARTA UTARA,KOJA,TUGU UTARA,67670,18051,49619,36917,86536,2021-10-11
3175061006,JAKARTA TIMUR,CAKUNG,UJUNG MENTENG,29934,5911,24023,19328,43351,2021-10-11
3174101005,JAKARTA SELATAN,PESANGGRAHAN,ULUJAMI,40544,10532,30012,23149,53161,2021-10-11
3175011006,JAKARTA TIMUR,MATRAMAN,UTAN KAYU SELATAN,33511,7092,26419,20434,46853,2021-10-11
3175011002,JAKARTA TIMUR,MATRAMAN,UTAN KAYU UTARA,28169,6754,21415,16535,37950,2021-10-11
3171031008,JAKARTA PUSAT,KEMAYORAN,UTAN PANJANG,29208,6830,22378,16750,39128,2021-10-11
3172021007,JAKARTA UTARA,TANJUNG PRIOK,WARAKAS,44401,9430,34971,26673,61644,2021-10-11
3173021007,JAKARTA BARAT,GROGOL PETAMBURAN,WIJAYA KUSUMA,38934,9573,29361,23364,52725,2021-10-11
3172051003,JAKARTA UTARA,PADEMANGAN,ANCOL,23947,6380,17567,13766,31333,2021-10-12
3173041007,JAKARTA BARAT,TAMBORA,ANGKE,29381,7192,22189,17103,39292,2021-10-12
3175041005,JAKARTA TIMUR,KRAMAT JATI,BALE KAMBANG,29074,8184,20890,15116,36006,2021-10-12
3175031003,JAKARTA TIMUR,JATINEGARA,BALI MESTER,9752,2323,7429,5885,13314,2021-10-12
3175101006,JAKARTA TIMUR,CIPAYUNG,BAMBU APUS,26285,5576,20709,15879,36588,2021-10-12
3174031002,JAKARTA SELATAN,MAMPANG PRAPATAN,BANGKA,21566,5376,16190,12606,28796,2021-10-12
3175051002,JAKARTA TIMUR,PASAR REBO,BARU,23886,4580,19306,15938,35244,2021-10-12
3175041004,JAKARTA TIMUR,KRAMAT JATI,BATU AMPAR,47898,13296,34602,25835,60437,2021-10-12
3171071002,JAKARTA PUSAT,TANAH ABANG,BENDUNGAN HILIR,21494,4905,16589,13281,29870,2021-10-12
3175031002,JAKARTA TIMUR,JATINEGARA,BIDARA CINA,36689,9998,26691,19933,46624,2021-10-12
3174101002,JAKARTA SELATAN,PESANGGRAHAN,BINTARO,53098,12121,40977,33204,74181,2021-10-12
3174011005,JAKARTA SELATAN,TEBET,BUKIT DURI,34183,8131,26052,20329,46381,2021-10-12
3171041006,JAKARTA PUSAT,SENEN,BUNGUR,18144,4390,13754,10938,24692,2021-10-12
3175061007,JAKARTA TIMUR,CAKUNG,CAKUNG BARAT,57724,13429,44295,35037,79332,2021-10-12
3175061004,JAKARTA TIMUR,CAKUNG,CAKUNG TIMUR,58287,13084,45203,35649,80852,2021-10-12
3175041007,JAKARTA TIMUR,KRAMAT JATI,CAWANG,32762,8246,24516,18385,42901,2021-10-12
3175101008,JAKARTA TIMUR,CIPAYUNG,CEGER,18932,4216,14716,11620,26336,2021-10-12
3171031006,JAKARTA PUSAT,KEMAYORAN,CEMPAKA BARU,32581,7814,24767,18493,43260,2021-10-12
3171051002,JAKARTA PUSAT,CEMPAKA PUTIH,CEMPAKA PUTIH BARAT,35885,8685,27200,21742,48942,2021-10-12
3171051001,JAKARTA PUSAT,CEMPAKA PUTIH,CEMPAKA PUTIH TIMUR,24292,5639,18653,15347,34000,2021-10-12
3173011001,JAKARTA BARAT,CENGKARENG,CENGKARENG BARAT,66284,15512,50772,40415,91187,2021-10-12
3173011006,JAKARTA BARAT,CENGKARENG,CENGKARENG TIMUR,81027,18368,62659,48522,111181,2021-10-12
3175091002,JAKARTA TIMUR,CIRACAS,CIBUBUR,66364,13082,53282,42221,95503,2021-10-12
3171011002,JAKARTA PUSAT,GAMBIR,CIDENG,15390,3325,12065,10021,22086,2021-10-12
3174091003,JAKARTA SELATAN,JAGAKARSA,CIGANJUR,38497,8035,30462,23273,53735,2021-10-12
3175051003,JAKARTA TIMUR,PASAR REBO,CIJANTUNG,41419,8806,32613,25750,58363,2021-10-12
3171061003,JAKARTA PUSAT,MENTENG,CIKINI,8274,1667,6607,4854,11461,2021-10-12
3174081006,JAKARTA SELATAN,PANCORAN,CIKOKO,10547,2122,8425,6900,15325,2021-10-12
3174061001,JAKARTA SELATAN,CILANDAK,CILANDAK BARAT,51752,10927,40825,33389,74214,2021-10-12
3174041003,JAKARTA SELATAN,PASAR MINGGU,CILANDAK TIMUR,25145,5443,19702,15888,35590,2021-10-12
3175101002,JAKARTA TIMUR,CIPAYUNG,CILANGKAP,27635,5617,22018,17241,39259,2021-10-12
3175041006,JAKARTA TIMUR,KRAMAT JATI,CILILITAN,40181,10273,29908,22664,52572,2021-10-12
3172041001,JAKARTA UTARA,CILINCING,CILINCING,43609,11762,31847,23432,55279,2021-10-12
3175101001,JAKARTA TIMUR,CIPAYUNG,CIPAYUNG,26104,5145,20959,17070,38029,2021-10-12
3174091006,JAKARTA SELATAN,JAGAKARSA,CIPEDAK,38303,7850,30453,24052,54505,2021-10-12
3174061005,JAKARTA SELATAN,CILANDAK,CIPETE SELATAN,26704,5874,20830,17086,37916,2021-10-12
3174071010,JAKARTA SELATAN,KEBAYORAN BARU,CIPETE UTARA,34102,7511,26591,20555,47146,2021-10-12
3175021003,JAKARTA TIMUR,PULO GADUNG,CIPINANG,39306,8693,30613,23842,54455,2021-10-12
3175031007,JAKARTA TIMUR,JATINEGARA,CIPINANG BESAR SELATAN,35212,9468,25744,18730,44474,2021-10-12
3175031008,JAKARTA TIMUR,JATINEGARA,CIPINANG BESAR UTARA,45319,12235,33084,23892,56976,2021-10-12
3175031005,JAKARTA TIMUR,JATINEGARA,CIPINANG CEMPEDAK,32824,8005,24819,19370,44189,2021-10-12
3175081005,JAKARTA TIMUR,MAKASAR,CIPINANG MELAYU,42308,9246,33062,26154,59216,2021-10-12
3175031006,JAKARTA TIMUR,JATINEGARA,CIPINANG MUARA,55243,13738,41505,31713,73218,2021-10-12
3174051003,JAKARTA SELATAN,KEBAYORAN LAMA,CIPULIR,39937,9624,30313,22740,53053,2021-10-12
3175091001,JAKARTA TIMUR,CIRACAS,CIRACAS,64594,13491,51103,39728,90831,2021-10-12
3175041003,JAKARTA TIMUR,KRAMAT JATI,DUKUH,24609,5375,19234,14880,34114,2021-10-12
3175071001,JAKARTA TIMUR,DUREN SAWIT,DUREN SAWIT,61160,14743,46417,35730,82147,2021-10-12
3174081004,JAKARTA SELATAN,PANCORAN,DUREN TIGA,28319,6424,21895,16436,38331,2021-10-12
3173051005,JAKARTA BARAT,KEBON JERUK,DURI KEPA,60138,13326,46812,38846,85658,2021-10-12
3173011002,JAKARTA BARAT,CENGKARENG,DURI KOSAMBI,77923,19819,58104,43813,101917,2021-10-12
3171011006,JAKARTA PUSAT,GAMBIR,DURI PULO,19610,4658,14952,11451,26403,2021-10-12
3173041011,JAKARTA BARAT,TAMBORA,DURI SELATAN,14259,2898,11361,9154,20515,2021-10-12
3173041003,JAKARTA BARAT,TAMBORA,DURI UTARA,19844,4360,15484,12060,27544,2021-10-12
3171081003,JAKARTA PUSAT,JOHAR BARU,GALUR,18243,4047,14196,11001,25197,2021-10-12
3171011001,JAKARTA PUSAT,GAMBIR,GAMBIR,2191,505,1686,1378,3064,2021-10-12
3174061004,JAKARTA SELATAN,CILANDAK,GANDARIA SELATAN,22119,4956,17163,13670,30833,2021-10-12
3174071009,JAKARTA SELATAN,KEBAYORAN BARU,GANDARIA UTARA,39922,9196,30726,24131,54857,2021-10-12
3175051001,JAKARTA TIMUR,PASAR REBO,GEDONG,35755,8104,27651,22010,49661,2021-10-12
3171071001,JAKARTA PUSAT,TANAH ABANG,GELORA,3127,686,2441,1967,4408,2021-10-12
3173031007,JAKARTA BARAT,TAMAN SARI,GLODOK,7837,1443,6394,5560,11954,2021-10-12
3171061004,JAKARTA PUSAT,MENTENG,GONDANGDIA,4100,991,3109,2752,5861,2021-10-12
3173021001,JAKARTA BARAT,GROGOL PETAMBURAN,GROGOL,16876,3833,13043,10432,23475,2021-10-12
3174051005,JAKARTA SELATAN,KEBAYORAN LAMA,GROGOL SELATAN,44251,10474,33777,26009,59786,2021-10-12
3174051004,JAKARTA SELATAN,KEBAYORAN LAMA,GROGOL UTARA,42494,10144,32350,25502,57852,2021-10-12
3174021007,JAKARTA SELATAN,SETIA BUDI,GUNTUR,3985,854,3131,2650,5781,2021-10-12
3174071002,JAKARTA SELATAN,KEBAYORAN BARU,GUNUNG,9436,1995,7441,6180,13621,2021-10-12
3171031005,JAKARTA PUSAT,KEMAYORAN,GUNUNG SAHARI SELATAN,19199,4479,14720,11709,26429,2021-10-12
3171021004,JAKARTA PUSAT,SAWAH BESAR,GUNUNG SAHARI UTARA,16650,3316,13334,11326,24660,2021-10-12
3175081004,JAKARTA TIMUR,MAKASAR,HALIM PERDANA KUSUMAH,28363,4241,24122,21313,45435,2021-10-12
3171031003,JAKARTA PUSAT,KEMAYORAN,HARAPAN MULIA,22557,5287,17270,13203,30473,2021-10-12
3174091001,JAKARTA SELATAN,JAGAKARSA,JAGAKARSA,62389,13267,49122,38898,88020,2021-10-12
3175021007,JAKARTA TIMUR,PULO GADUNG,JATI,32757,7158,25599,20971,46570,2021-10-12
3174041002,JAKARTA SELATAN,PASAR MINGGU,JATI PADANG,37502,8826,28676,22779,51455,2021-10-12
3173071004,JAKARTA BARAT,PALMERAH,JATI PULO,28738,6536,22202,16879,39081,2021-10-12
3175061001,JAKARTA TIMUR,CAKUNG,JATINEGARA,84160,20720,63440,49709,113149,2021-10-12
3175021004,JAKARTA TIMUR,PULO GADUNG,JATINEGARA KAUM,24632,5306,19326,14754,34080,2021-10-12
3173021004,JAKARTA BARAT,GROGOL PETAMBURAN,JELAMBAR,30266,6332,23934,19545,43479,2021-10-12
3173021006,JAKARTA BARAT,GROGOL PETAMBURAN,JELAMBAR BARU,38246,8271,29975,24474,54449,2021-10-12
3173041006,JAKARTA BARAT,TAMBORA,JEMBATAN BESI,29314,8262,21052,15299,36351,2021-10-12
3173041008,JAKARTA BARAT,TAMBORA,JEMBATAN LIMA,21021,5626,15395,11471,26866,2021-10-12
3173081005,JAKARTA BARAT,KEMBANGAN,JOGLO,40839,9508,31331,25145,56476,2021-10-12
3171081001,JAKARTA PUSAT,JOHAR BARU,JOHAR BARU,37488,7826,29662,23718,53380,2021-10-12
3173041002,JAKARTA BARAT,TAMBORA,KALI ANYAR,23856,5575,18281,13669,31950,2021-10-12
3172041004,JAKARTA UTARA,CILINCING,KALIBARU,67684,21182,46502,31785,78287,2021-10-12
3174081002,JAKARTA SELATAN,PANCORAN,KALIBATA,41994,11036,30958,22909,53867,2021-10-12
3173061001,JAKARTA BARAT,KALI DERES,KALIDERES,72447,17231,55216,44620,99836,2021-10-12
3175051004,JAKARTA TIMUR,PASAR REBO,KALISARI,43212,8950,34262,27173,61435,2021-10-12
3173061004,JAKARTA BARAT,KALI DERES,KAMAL,53783,14475,39308,29695,69003,2021-10-12
3172011002,JAKARTA UTARA,PENJARINGAN,KAMAL MUARA,12930,2445,10485,8720,19205,2021-10-12
3171071007,JAKARTA PUSAT,TANAH ABANG,KAMPUNG BALI,11358,2767,8591,6122,14713,2021-10-12
3175031001,JAKARTA TIMUR,JATINEGARA,KAMPUNG MELAYU,25717,7072,18645,13513,32158,2021-10-12
3171081002,JAKARTA PUSAT,JOHAR BARU,KAMPUNG RAWA,21237,3898,17339,13210,30549,2021-10-12
3175041002,JAKARTA TIMUR,KRAMAT JATI,KAMPUNG TENGAH,43993,12349,31644,23592,55236,2021-10-12
3173011005,JAKARTA BARAT,CENGKARENG,KAPUK,134466,36558,97908,74164,172072,2021-10-12
3172011003,JAKARTA UTARA,PENJARINGAN,KAPUK MUARA,35781,7686,28095,23843,51938,2021-10-12
3171021002,JAKARTA PUSAT,SAWAH BESAR,KARANG ANYAR,25761,5610,20151,15989,36140,2021-10-12
3174021004,JAKARTA SELATAN,SETIA BUDI,KARET,9623,2127,7496,5879,13375,2021-10-12
3174021003,JAKARTA SELATAN,SETIA BUDI,KARET KUNINGAN,16055,3565,12490,10115,22605,2021-10-12
3174021002,JAKARTA SELATAN,SETIA BUDI,KARET SEMANGGI,2770,600,2170,1844,4014,2021-10-12
3171071003,JAKARTA PUSAT,TANAH ABANG,KARET TENGSIN,19271,4203,15068,11494,26562,2021-10-12
3171021003,JAKARTA PUSAT,SAWAH BESAR,KARTINI,22292,4894,17398,14026,31424,2021-10-12
3175011003,JAKARTA TIMUR,MATRAMAN,KAYU MANIS,25284,6149,19135,14098,33233,2021-10-12
3175021006,JAKARTA TIMUR,PULO GADUNG,KAYU PUTIH,40696,8710,31986,26610,58596,2021-10-12
3173031006,JAKARTA BARAT,TAMAN SARI,KEAGUNGAN,17387,3904,13483,10487,23970,2021-10-12
3174041007,JAKARTA SELATAN,PASAR MINGGU,KEBAGUSAN,44552,10371,34181,25885,60066,2021-10-12
3174051006,JAKARTA SELATAN,KEBAYORAN LAMA,KEBAYORAN LAMA SELATAN,41212,8784,32428,25630,58058,2021-10-12
3174051001,JAKARTA SELATAN,KEBAYORAN LAMA,KEBAYORAN LAMA UTARA,42422,10386,32036,24820,56856,2021-10-12
3174011004,JAKARTA SELATAN,TEBET,KEBON BARU,35165,7777,27388,21305,48693,2021-10-12
3172021005,JAKARTA UTARA,TANJUNG PRIOK,KEBON BAWANG,50952,11804,39148,30788,69936,2021-10-12
3173051001,JAKARTA BARAT,KEBON JERUK,KEBON JERUK,53887,13550,40337,31373,71710,2021-10-12
3171071006,JAKARTA PUSAT,TANAH ABANG,KEBON KACANG,21531,5888,15643,11684,27327,2021-10-12
3171011005,JAKARTA PUSAT,GAMBIR,KEBON KELAPA,10163,2283,7880,6236,14116,2021-10-12
3171031002,JAKARTA PUSAT,KEMAYORAN,KEBON KOSONG,30019,7043,22976,17443,40419,2021-10-12
3175011005,JAKARTA TIMUR,MATRAMAN,KEBON MANGGIS,16490,3681,12809,10029,22838,2021-10-12
3171071005,JAKARTA PUSAT,TANAH ABANG,KEBON MELATI,32206,9514,22692,15719,38411,2021-10-12
3175081003,JAKARTA TIMUR,MAKASAR,KEBON PALA,46614,10690,35924,28213,64137,2021-10-12
3171061005,JAKARTA PUSAT,MENTENG,KEBON SIRIH,12299,2967,9332,7020,16352,2021-10-12
3173011004,JAKARTA BARAT,CENGKARENG,KEDAUNG KALI ANGKE,32612,7132,25480,20282,45762,2021-10-12
3173051007,JAKARTA BARAT,KEBON JERUK,KEDOYA SELATAN,32165,6884,25281,19941,45222,2021-10-12
3173051006,JAKARTA BARAT,KEBON JERUK,KEDOYA UTARA,45740,9873,35867,29362,65229,2021-10-12
3173051004,JAKARTA BARAT,KEBON JERUK,KELAPA DUA,23565,5681,17884,14161,32045,2021-10-12
3175091003,JAKARTA TIMUR,CIRACAS,KELAPA DUA WETAN,46875,9294,37581,29909,67490,2021-10-12
3172061003,JAKARTA UTARA,KELAPA GADING,KELAPA GADING BARAT,35717,6867,28850,25178,54028,2021-10-12
3172061001,JAKARTA UTARA,KELAPA GADING,KELAPA GADING TIMUR,33592,5694,27898,24841,52739,2021-10-12
3173071005,JAKARTA BARAT,PALMERAH,KEMANGGISAN,32139,7037,25102,19680,44782,2021-10-12
3171031001,JAKARTA PUSAT,KEMAYORAN,KEMAYORAN,20708,4851,15857,12458,28315,2021-10-12
3173081006,JAKARTA BARAT,KEMBANGAN,KEMBANGAN SELATAN,27130,6488,20642,17229,37871,2021-10-12
3173081001,JAKARTA BARAT,KEMBANGAN,KEMBANGAN UTARA,54451,13507,40944,32555,73499,2021-10-12
3171041002,JAKARTA PUSAT,SENEN,KENARI,9579,2120,7459,6052,13511,2021-10-12
3173041005,JAKARTA BARAT,TAMBORA,KERENDANG,19973,4787,15186,11620,26806,2021-10-12
3175071003,JAKARTA TIMUR,DUREN SAWIT,KLENDER,69978,18512,51466,38646,90112,2021-10-12
3172031001,JAKARTA UTARA,KOJA,KOJA,28175,7199,20976,16008,36984,2021-10-12
3173071006,JAKARTA BARAT,PALMERAH,KOTA BAMBU SELATAN,21158,5154,16004,11892,27896,2021-10-12
3173071003,JAKARTA BARAT,PALMERAH,KOTA BAMBU UTARA,24995,6209,18786,13876,32662,2021-10-12
3171041004,JAKARTA PUSAT,SENEN,KRAMAT,28835,7732,21103,15213,36316,2021-10-12
3175041001,JAKARTA TIMUR,KRAMAT JATI,KRAMAT JATI,34144,8375,25769,19702,45471,2021-10-12
3174071003,JAKARTA SELATAN,KEBAYORAN BARU,KRAMAT PELA,14413,3130,11283,9054,20337,2021-10-12
3173031002,JAKARTA BARAT,TAMAN SARI,KRUKUT,19244,4324,14920,11388,26308,2021-10-12
3174031005,JAKARTA SELATAN,MAMPANG PRAPATAN,KUNINGAN BARAT,12785,2722,10063,7819,17882,2021-10-12
3174021008,JAKARTA SELATAN,SETIA BUDI,KUNINGAN TIMUR,6008,1403,4605,3753,8358,2021-10-12
3171041005,JAKARTA PUSAT,SENEN,KWITANG,15486,3962,11524,8913,20437,2021-10-12
3172031003,JAKARTA UTARA,KOJA,LAGOA,59065,15875,43190,32360,75550,2021-10-12
3174061002,JAKARTA SELATAN,CILANDAK,LEBAK BULUS,37626,8284,29342,23678,53020,2021-10-12
3174091004,JAKARTA SELATAN,JAGAKARSA,LENTENG AGUNG,53946,11698,42248,31580,73828,2021-10-12
3175101007,JAKARTA TIMUR,CIPAYUNG,LUBANG BUAYA,63547,13728,49819,39318,89137,2021-10-12
3175081001,JAKARTA TIMUR,MAKASAR,MAKASAR,34390,7295,27095,21539,48634,2021-10-12
3175071006,JAKARTA TIMUR,DUREN SAWIT,MALAKA JAYA,30927,6401,24526,19750,44276,2021-10-12
3175071005,JAKARTA TIMUR,DUREN SAWIT,MALAKA SARI,27530,5424,22106,18045,40151,2021-10-12
3174031001,JAKARTA SELATAN,MAMPANG PRAPATAN,MAMPANG PRAPATAN,18159,4362,13797,10699,24496,2021-10-12
3173031005,JAKARTA BARAT,TAMAN SARI,MANGGA BESAR,7707,1455,6252,5201,11453,2021-10-12
3171021005,JAKARTA PUSAT,SAWAH BESAR,MANGGA DUA SELATAN,27442,6339,21103,16827,37930,2021-10-12
3174011007,JAKARTA SELATAN,TEBET,MANGGARAI,28373,5842,22531,17079,39610,2021-10-12
3174011006,JAKARTA SELATAN,TEBET,MANGGARAI SELATAN,23075,4781,18294,14585,32879,2021-10-12
3173031003,JAKARTA BARAT,TAMAN SARI,MAPHAR,16461,3593,12868,10208,23076,2021-10-12
3172041003,JAKARTA UTARA,CILINCING,MARUNDA,28943,7379,21564,15540,37104,2021-10-12
3174071001,JAKARTA SELATAN,KEBAYORAN BARU,MELAWAI,2627,564,2063,1851,3914,2021-10-12
3171061001,JAKARTA PUSAT,MENTENG,MENTENG,25624,6498,19126,14303,33429,2021-10-12
3174021005,JAKARTA SELATAN,SETIA BUDI,MENTENG ATAS,27816,5860,21956,17105,39061,2021-10-12
3174011003,JAKARTA SELATAN,TEBET,MENTENG DALAM,36028,8031,27997,22058,50055,2021-10-12
3173081003,JAKARTA BARAT,KEMBANGAN,MERUYA SELATAN,32130,7662,24468,19332,43800,2021-10-12
3173081002,JAKARTA BARAT,KEMBANGAN,MERUYA UTARA,43752,10358,33394,27475,60869,2021-10-12
3175101004,JAKARTA TIMUR,CIPAYUNG,MUNJUL,23871,5003,18868,14944,33812,2021-10-12
3172051002,JAKARTA UTARA,PADEMANGAN,PADEMANGAN BARAT,74240,19519,54721,41973,96694,2021-10-12
3172051001,JAKARTA UTARA,PADEMANGAN,PADEMANGAN TIMUR,37736,7516,30220,25050,55270,2021-10-12
3175011004,JAKARTA TIMUR,MATRAMAN,PAL MERIAM,19769,4772,14997,11363,26360,2021-10-12
3173071001,JAKARTA BARAT,PALMERAH,PALMERAH,63011,15571,47440,36447,83887,2021-10-12
3174081001,JAKARTA SELATAN,PANCORAN,PANCORAN,19421,4712,14709,11523,26232,2021-10-12
3172021003,JAKARTA UTARA,TANJUNG PRIOK,PAPANGGO,39097,8899,30198,23694,53892,2021-10-12
3171021001,JAKARTA PUSAT,SAWAH BESAR,PASAR BARU,12035,2562,9473,8100,17573,2021-10-12
3174021006,JAKARTA SELATAN,SETIA BUDI,PASAR MANGGIS,26752,6249,20503,16013,36516,2021-10-12
3174041001,JAKARTA SELATAN,PASAR MINGGU,PASAR MINGGU,24821,5419,19402,15520,34922,2021-10-12
3171041003,JAKARTA PUSAT,SENEN,PASEBAN,23533,5710,17823,13879,31702,2021-10-12
3173061005,JAKARTA BARAT,KALI DERES,PEGADUNGAN,75587,17312,58275,48256,106531,2021-10-12
3171061002,JAKARTA PUSAT,MENTENG,PEGANGSAAN,23455,5815,17640,12694,30334,2021-10-12
3172061002,JAKARTA UTARA,KELAPA GADING,PEGANGSAAN DUA,49976,9068,40908,35810,76718,2021-10-12
3172011004,JAKARTA UTARA,PENJARINGAN,PEJAGALAN,74578,17505,57073,46392,103465,2021-10-12
3174041006,JAKARTA SELATAN,PASAR MINGGU,PEJATEN BARAT,37346,8641,28705,22594,51299,2021-10-12
3174041005,JAKARTA SELATAN,PASAR MINGGU,PEJATEN TIMUR,57656,14962,42694,33129,75823,2021-10-12
3175051005,JAKARTA TIMUR,PASAR REBO,PEKAYON,43250,9060,34190,26803,60993,2021-10-12
3173041009,JAKARTA BARAT,TAMBORA,PEKOJAN,23587,5164,18423,14639,33062,2021-10-12
3174031003,JAKARTA SELATAN,MAMPANG PRAPATAN,PELA MAMPANG,43522,10053,33469,26388,59857,2021-10-12
3174081005,JAKARTA SELATAN,PANCORAN,PENGADEGAN,21478,4491,16987,13284,30271,2021-10-12
3175061003,JAKARTA TIMUR,CAKUNG,PENGGILINGAN,99255,26459,72796,54830,127626,2021-10-12
3172011001,JAKARTA UTARA,PENJARINGAN,PENJARINGAN,88308,25254,63054,46127,109181,2021-10-12
3174101001,JAKARTA SELATAN,PESANGGRAHAN,PESANGGRAHAN,27545,5456,22089,17869,39958,2021-10-12
3171071004,JAKARTA PUSAT,TANAH ABANG,PETAMBURAN,33271,9869,23402,16439,39841,2021-10-12
3174071008,JAKARTA SELATAN,KEBAYORAN BARU,PETOGOGAN,11499,2596,8903,7057,15960,2021-10-12
3171011004,JAKARTA PUSAT,GAMBIR,PETOJO SELATAN,14692,3746,10946,8822,19768,2021-10-12
3171011003,JAKARTA PUSAT,GAMBIR,PETOJO UTARA,17458,4227,13231,10287,23518,2021-10-12
3174101004,JAKARTA SELATAN,PESANGGRAHAN,PETUKANGAN SELATAN,37187,8767,28420,22685,51105,2021-10-12
3174101003,JAKARTA SELATAN,PESANGGRAHAN,PETUKANGAN UTARA,53716,13319,40397,31784,72181,2021-10-12
3175081002,JAKARTA TIMUR,MAKASAR,PINANG RANTI,27198,6733,20465,16138,36603,2021-10-12
3173031008,JAKARTA BARAT,TAMAN SARI,PINANGSIA,10729,2164,8565,6794,15359,2021-10-12
3175011001,JAKARTA TIMUR,MATRAMAN,PISANGAN BARU,31776,7646,24130,17883,42013,2021-10-12
3175021002,JAKARTA TIMUR,PULO GADUNG,PISANGAN TIMUR,41011,8831,32180,25645,57825,2021-10-12
3172011005,JAKARTA UTARA,PENJARINGAN,PLUIT,47783,10330,37453,31567,69020,2021-10-12
3175071002,JAKARTA TIMUR,DUREN SAWIT,PONDOK BAMBU,61550,15109,46441,36160,82601,2021-10-12
3175071004,JAKARTA TIMUR,DUREN SAWIT,PONDOK KELAPA,72015,16130,55885,45283,101168,2021-10-12
3175071007,JAKARTA TIMUR,DUREN SAWIT,PONDOK KOPI,35367,8000,27367,20213,47580,2021-10-12
3174061003,JAKARTA SELATAN,CILANDAK,PONDOK LABU,46464,9238,37226,30484,67710,2021-10-12
3174051002,JAKARTA SELATAN,KEBAYORAN LAMA,PONDOK PINANG,56169,12100,44069,34900,78969,2021-10-12
3175101003,JAKARTA TIMUR,CIPAYUNG,PONDOK RANGGON,25574,5399,20175,15672,35847,2021-10-12
3101011003,KAB.ADM.KEP.SERIBU,KEP. SERIBU UTARA,PULAU HARAPAN,2060,249,1811,1515,3326,2021-10-12
3101011002,KAB.ADM.KEP.SERIBU,KEP. SERIBU UTARA,PULAU KELAPA,5528,663,4865,3860,8725,2021-10-12
3101011001,KAB.ADM.KEP.SERIBU,KEP. SERIBU UTARA,PULAU PANGGANG,5450,524,4926,4269,9195,2021-10-12
3101021003,KAB.ADM.KEP.SERIBU,KEP. SERIBU SELATAN,PULAU PARI,2765,212,2553,2315,4868,2021-10-12
3101021002,KAB.ADM.KEP.SERIBU,KEP. SERIBU SELATAN,PULAU TIDUNG,4553,424,4129,3683,7812,2021-10-12
3101021001,KAB.ADM.KEP.SERIBU,KEP. SERIBU SELATAN,PULAU UNTUNG JAWA,1941,201,1740,1590,3330,2021-10-12
3174071007,JAKARTA SELATAN,KEBAYORAN BARU,PULO,5835,1129,4706,4061,8767,2021-10-12
3175021001,JAKARTA TIMUR,PULO GADUNG,PULO GADUNG,34422,8390,26032,20488,46520,2021-10-12
3175061005,JAKARTA TIMUR,CAKUNG,PULO GEBANG,97301,21473,75828,57969,133797,2021-10-12
3174041004,JAKARTA SELATAN,PASAR MINGGU,RAGUNAN,39616,8645,30971,24873,55844,2021-10-12
3175091005,JAKARTA TIMUR,CIRACAS,RAMBUTAN,36771,9775,26996,20270,47266,2021-10-12
3172031006,JAKARTA UTARA,KOJA,RAWA BADAK SELATAN,42179,11306,30873,22988,53861,2021-10-12
3172031004,JAKARTA UTARA,KOJA,RAWA BADAK UTARA,34408,8750,25658,19362,45020,2021-10-12
3174071005,JAKARTA SELATAN,KEBAYORAN BARU,RAWA BARAT,5625,1096,4529,3812,8341,2021-10-12
3173011003,JAKARTA BARAT,CENGKARENG,RAWA BUAYA,63799,14888,48911,36709,85620,2021-10-12
3175031004,JAKARTA TIMUR,JATINEGARA,RAWA BUNGA,21434,5841,15593,11820,27413,2021-10-12
3174081003,JAKARTA SELATAN,PANCORAN,RAWA JATI,20509,4463,16046,12546,28592,2021-10-12
3175061002,JAKARTA TIMUR,CAKUNG,RAWA TERATE,24637,5171,19466,15255,34721,2021-10-12
3175021005,JAKARTA TIMUR,PULO GADUNG,RAWAMANGUN,37612,8590,29022,23244,52266,2021-10-12
3171051003,JAKARTA PUSAT,CEMPAKA PUTIH,RAWASARI,21967,5170,16797,13476,30273,2021-10-12
3173041010,JAKARTA BARAT,TAMBORA,ROA MALAKA,3484,664,2820,2408,5228,2021-10-12
3172041006,JAKARTA UTARA,CILINCING,ROROTAN,41668,9554,32114,24526,56640,2021-10-12
3174071004,JAKARTA SELATAN,KEBAYORAN BARU,SELONG,2842,589,2253,1988,4241,2021-10-12
3173061002,JAKARTA BARAT,KALI DERES,SEMANAN,71354,18152,53202,41118,94320,2021-10-12
3172041007,JAKARTA UTARA,CILINCING,SEMPER BARAT,68587,15410,53177,42240,95417,2021-10-12
3172041005,JAKARTA UTARA,CILINCING,SEMPER TIMUR,36267,8745,27522,21149,48671,2021-10-12
3174071006,JAKARTA SELATAN,KEBAYORAN BARU,SENAYAN,2771,715,2056,1676,3732,2021-10-12
3171041001,JAKARTA PUSAT,SENEN,SENEN,6804,1636,5168,4178,9346,2021-10-12
3171031004,JAKARTA PUSAT,KEMAYORAN,SERDANG,29668,6759,22909,17949,40858,2021-10-12
3174021001,JAKARTA SELATAN,SETIA BUDI,SETIA BUDI,3023,704,2319,1862,4181,2021-10-12
3175101005,JAKARTA TIMUR,CIPAYUNG,SETU,20572,4912,15660,12024,27684,2021-10-12
3173071002,JAKARTA BARAT,PALMERAH,SLIPI,16591,3511,13080,10423,23503,2021-10-12
3173081004,JAKARTA BARAT,KEMBANGAN,SRENGSENG,45523,11609,33914,27193,61107,2021-10-12
3174091002,JAKARTA SELATAN,JAGAKARSA,SRENGSENG SAWAH,58196,10954,47242,38064,85306,2021-10-12
3173051003,JAKARTA BARAT,KEBON JERUK,SUKABUMI SELATAN,37033,9618,27415,20169,47584,2021-10-12
3173051002,JAKARTA BARAT,KEBON JERUK,SUKABUMI UTARA,38290,10350,27940,20672,48612,2021-10-12
3172041002,JAKARTA UTARA,CILINCING,SUKAPURA,53949,13764,40185,31574,71759,2021-10-12
3171031007,JAKARTA PUSAT,KEMAYORAN,SUMUR BATU,22717,5284,17433,13999,31432,2021-10-12
3172021004,JAKARTA UTARA,TANJUNG PRIOK,SUNGAI BAMBU,29876,6849,23027,18105,41132,2021-10-12
3172021006,JAKARTA UTARA,TANJUNG PRIOK,SUNTER AGUNG,71805,13975,57830,48344,106174,2021-10-12
3172021002,JAKARTA UTARA,TANJUNG PRIOK,SUNTER JAYA,63031,12900,50131,41388,91519,2021-10-12
3175091004,JAKARTA TIMUR,CIRACAS,SUSUKAN,38257,8185,30072,23758,53830,2021-10-12
3173031001,JAKARTA BARAT,TAMAN SARI,TAMAN SARI,14348,3047,11301,9311,20612,2021-10-12
3173041001,JAKARTA BARAT,TAMBORA,TAMBORA,10204,2568,7636,5886,13522,2021-10-12
3173041004,JAKARTA BARAT,TAMBORA,TANAH SEREAL,26387,5036,21351,17011,38362,2021-10-12
3171081004,JAKARTA PUSAT,JOHAR BARU,TANAH TINGGI,37693,7920,29773,22977,52750,2021-10-12
3173031004,JAKARTA BARAT,TAMAN SARI,TANGKI,13324,2561,10763,8507,19270,2021-10-12
3174091005,JAKARTA SELATAN,JAGAKARSA,TANJUNG BARAT,39770,7697,32073,24368,56441,2021-10-12
3173021005,JAKARTA BARAT,GROGOL PETAMBURAN,TANJUNG DUREN SELATAN,25337,5532,19805,16458,36263,2021-10-12
3173021002,JAKARTA BARAT,GROGOL PETAMBURAN,TANJUNG DUREN UTARA,17010,3316,13694,11569,25263,2021-10-12
3172021001,JAKARTA UTARA,TANJUNG PRIOK,TANJUNG PRIOK,34588,8036,26552,20809,47361,2021-10-12
3174011002,JAKARTA SELATAN,TEBET,TEBET BARAT,21194,4008,17186,14333,31519,2021-10-12
3174011001,JAKARTA SELATAN,TEBET,TEBET TIMUR,18199,3346,14853,12646,27499,2021-10-12
3173061003,JAKARTA BARAT,KALI DERES,TEGAL ALUR,83647,20194,63453,49776,113229,2021-10-12
3174031004,JAKARTA SELATAN,MAMPANG PRAPATAN,TEGAL PARANG,32401,8265,24136,17382,41518,2021-10-12
3173021003,JAKARTA BARAT,GROGOL PETAMBURAN,TOMANG,29605,6209,23396,18971,42367,2021-10-12
3172031005,JAKARTA UTARA,KOJA,TUGU SELATAN,39122,9839,29283,22304,51587,2021-10-12
3172031002,JAKARTA UTARA,KOJA,TUGU UTARA,67670,17914,49756,37133,86889,2021-10-12
3175061006,JAKARTA TIMUR,CAKUNG,UJUNG MENTENG,29934,5896,24038,19347,43385,2021-10-12
3174101005,JAKARTA SELATAN,PESANGGRAHAN,ULUJAMI,40544,10526,30018,23166,53184,2021-10-12
3175011006,JAKARTA TIMUR,MATRAMAN,UTAN KAYU SELATAN,33511,7076,26435,20453,46888,2021-10-12
3175011002,JAKARTA TIMUR,MATRAMAN,UTAN KAYU UTARA,28169,6738,21431,16560,37991,2021-10-12
3171031008,JAKARTA PUSAT,KEMAYORAN,UTAN PANJANG,29208,6817,22391,16761,39152,2021-10-12
3172021007,JAKARTA UTARA,TANJUNG PRIOK,WARAKAS,44401,9386,35015,26719,61734,2021-10-12
3173021007,JAKARTA BARAT,GROGOL PETAMBURAN,WIJAYA KUSUMA,38934,9547,29387,23430,52817,2021-10-12
3172051003,JAKARTA UTARA,PADEMANGAN,ANCOL,23947,6339,17608,13819,31427,2021-10-13
3173041007,JAKARTA BARAT,TAMBORA,ANGKE,29381,7137,22244,17175,39419,2021-10-13
3175041005,JAKARTA TIMUR,KRAMAT JATI,BALE KAMBANG,29074,8135,20939,15198,36137,2021-10-13
3175031003,JAKARTA TIMUR,JATINEGARA,BALI MESTER,9752,2308,7444,5901,13345,2021-10-13
3175101006,JAKARTA TIMUR,CIPAYUNG,BAMBU APUS,26285,5517,20768,15950,36718,2021-10-13
3174031002,JAKARTA SELATAN,MAMPANG PRAPATAN,BANGKA,21566,5338,16228,12659,28887,2021-10-13
3175051002,JAKARTA TIMUR,PASAR REBO,BARU,23886,4533,19353,15984,35337,2021-10-13
3175041004,JAKARTA TIMUR,KRAMAT JATI,BATU AMPAR,47898,13130,34768,26011,60779,2021-10-13
3171071002,JAKARTA PUSAT,TANAH ABANG,BENDUNGAN HILIR,21494,4863,16631,13342,29973,2021-10-13
3175031002,JAKARTA TIMUR,JATINEGARA,BIDARA CINA,36689,9892,26797,20020,46817,2021-10-13
3174101002,JAKARTA SELATAN,PESANGGRAHAN,BINTARO,53098,12063,41035,33281,74316,2021-10-13
3174011005,JAKARTA SELATAN,TEBET,BUKIT DURI,34183,8066,26117,20431,46548,2021-10-13
3171041006,JAKARTA PUSAT,SENEN,BUNGUR,18144,4357,13787,10979,24766,2021-10-13
3175061007,JAKARTA TIMUR,CAKUNG,CAKUNG BARAT,57724,13378,44346,35160,79506,2021-10-13
3175061004,JAKARTA TIMUR,CAKUNG,CAKUNG TIMUR,58287,12969,45318,35813,81131,2021-10-13
3175041007,JAKARTA TIMUR,KRAMAT JATI,CAWANG,32762,8180,24582,18451,43033,2021-10-13
3175101008,JAKARTA TIMUR,CIPAYUNG,CEGER,18932,4176,14756,11655,26411,2021-10-13
3171031006,JAKARTA PUSAT,KEMAYORAN,CEMPAKA BARU,32581,7733,24848,18584,43432,2021-10-13
3171051002,JAKARTA PUSAT,CEMPAKA PUTIH,CEMPAKA PUTIH BARAT,35885,8602,27283,21850,49133,2021-10-13
3171051001,JAKARTA PUSAT,CEMPAKA PUTIH,CEMPAKA PUTIH TIMUR,24292,5586,18706,15407,34113,2021-10-13
3173011001,JAKARTA BARAT,CENGKARENG,CENGKARENG BARAT,66284,15370,50914,40594,91508,2021-10-13
3173011006,JAKARTA BARAT,CENGKARENG,CENGKARENG TIMUR,81027,18209,62818,48793,111611,2021-10-13
3175091002,JAKARTA TIMUR,CIRACAS,CIBUBUR,66364,12928,53436,42349,95785,2021-10-13
3171011002,JAKARTA PUSAT,GAMBIR,CIDENG,15390,3302,12088,10052,22140,2021-10-13
3174091003,JAKARTA SELATAN,JAGAKARSA,CIGANJUR,38497,7942,30555,23399,53954,2021-10-13
3175051003,JAKARTA TIMUR,PASAR REBO,CIJANTUNG,41419,8745,32674,25847,58521,2021-10-13
3171061003,JAKARTA PUSAT,MENTENG,CIKINI,8274,1659,6615,4876,11491,2021-10-13
3174081006,JAKARTA SELATAN,PANCORAN,CIKOKO,10547,2106,8441,6929,15370,2021-10-13
3174061001,JAKARTA SELATAN,CILANDAK,CILANDAK BARAT,51752,10717,41035,33591,74626,2021-10-13
3174041003,JAKARTA SELATAN,PASAR MINGGU,CILANDAK TIMUR,25145,5387,19758,15938,35696,2021-10-13
3175101002,JAKARTA TIMUR,CIPAYUNG,CILANGKAP,27635,5456,22179,17545,39724,2021-10-13
3175041006,JAKARTA TIMUR,KRAMAT JATI,CILILITAN,40181,10173,30008,22789,52797,2021-10-13
3172041001,JAKARTA UTARA,CILINCING,CILINCING,43609,11679,31930,23534,55464,2021-10-13
3175101001,JAKARTA TIMUR,CIPAYUNG,CIPAYUNG,26104,5090,21014,17168,38182,2021-10-13
3174091006,JAKARTA SELATAN,JAGAKARSA,CIPEDAK,38303,7649,30654,24150,54804,2021-10-13
3174061005,JAKARTA SELATAN,CILANDAK,CIPETE SELATAN,26704,5827,20877,17154,38031,2021-10-13
3174071010,JAKARTA SELATAN,KEBAYORAN BARU,CIPETE UTARA,34102,7394,26708,20657,47365,2021-10-13
3175021003,JAKARTA TIMUR,PULO GADUNG,CIPINANG,39306,8581,30725,23953,54678,2021-10-13
3175031007,JAKARTA TIMUR,JATINEGARA,CIPINANG BESAR SELATAN,35212,9381,25831,18838,44669,2021-10-13
3175031008,JAKARTA TIMUR,JATINEGARA,CIPINANG BESAR UTARA,45319,12085,33234,24031,57265,2021-10-13
3175031005,JAKARTA TIMUR,JATINEGARA,CIPINANG CEMPEDAK,32824,7943,24881,19436,44317,2021-10-13
3175081005,JAKARTA TIMUR,MAKASAR,CIPINANG MELAYU,42308,9210,33098,26231,59329,2021-10-13
3175031006,JAKARTA TIMUR,JATINEGARA,CIPINANG MUARA,55243,13602,41641,31879,73520,2021-10-13
3174051003,JAKARTA SELATAN,KEBAYORAN LAMA,CIPULIR,39937,9544,30393,22901,53294,2021-10-13
3175091001,JAKARTA TIMUR,CIRACAS,CIRACAS,64594,13376,51218,39835,91053,2021-10-13
3175041003,JAKARTA TIMUR,KRAMAT JATI,DUKUH,24609,5333,19276,14947,34223,2021-10-13
3175071001,JAKARTA TIMUR,DUREN SAWIT,DUREN SAWIT,61160,14597,46563,35879,82442,2021-10-13
3174081004,JAKARTA SELATAN,PANCORAN,DUREN TIGA,28319,6359,21960,16649,38609,2021-10-13
3173051005,JAKARTA BARAT,KEBON JERUK,DURI KEPA,60138,13238,46900,38979,85879,2021-10-13
3173011002,JAKARTA BARAT,CENGKARENG,DURI KOSAMBI,77923,19552,58371,44071,102442,2021-10-13
3171011006,JAKARTA PUSAT,GAMBIR,DURI PULO,19610,4641,14969,11475,26444,2021-10-13
3173041011,JAKARTA BARAT,TAMBORA,DURI SELATAN,14259,2827,11432,9189,20621,2021-10-13
3173041003,JAKARTA BARAT,TAMBORA,DURI UTARA,19844,4327,15517,12108,27625,2021-10-13
3171081003,JAKARTA PUSAT,JOHAR BARU,GALUR,18243,4019,14224,11051,25275,2021-10-13
3171011001,JAKARTA PUSAT,GAMBIR,GAMBIR,2191,504,1687,1381,3068,2021-10-13
3174061004,JAKARTA SELATAN,CILANDAK,GANDARIA SELATAN,22119,4925,17194,13706,30900,2021-10-13
3174071009,JAKARTA SELATAN,KEBAYORAN BARU,GANDARIA UTARA,39922,9115,30807,24220,55027,2021-10-13
3175051001,JAKARTA TIMUR,PASAR REBO,GEDONG,35755,8028,27727,22103,49830,2021-10-13
3171071001,JAKARTA PUSAT,TANAH ABANG,GELORA,3127,683,2444,1976,4420,2021-10-13
3173031007,JAKARTA BARAT,TAMAN SARI,GLODOK,7837,1436,6401,5570,11971,2021-10-13
3171061004,JAKARTA PUSAT,MENTENG,GONDANGDIA,4100,990,3110,2757,5867,2021-10-13
3173021001,JAKARTA BARAT,GROGOL PETAMBURAN,GROGOL,16876,3789,13087,10468,23555,2021-10-13
3174051005,JAKARTA SELATAN,KEBAYORAN LAMA,GROGOL SELATAN,44251,10377,33874,26168,60042,2021-10-13
3174051004,JAKARTA SELATAN,KEBAYORAN LAMA,GROGOL UTARA,42494,10056,32438,25621,58059,2021-10-13
3174021007,JAKARTA SELATAN,SETIA BUDI,GUNTUR,3985,844,3141,2656,5797,2021-10-13
3174071002,JAKARTA SELATAN,KEBAYORAN BARU,GUNUNG,9436,1957,7479,6197,13676,2021-10-13
3171031005,JAKARTA PUSAT,KEMAYORAN,GUNUNG SAHARI SELATAN,19199,4420,14779,11756,26535,2021-10-13
3171021004,JAKARTA PUSAT,SAWAH BESAR,GUNUNG SAHARI UTARA,16650,3280,13370,11351,24721,2021-10-13
3175081004,JAKARTA TIMUR,MAKASAR,HALIM PERDANA KUSUMAH,28363,4209,24154,21381,45535,2021-10-13
3171031003,JAKARTA PUSAT,KEMAYORAN,HARAPAN MULIA,22557,5240,17317,13264,30581,2021-10-13
3174091001,JAKARTA SELATAN,JAGAKARSA,JAGAKARSA,62389,12782,49607,39060,88667,2021-10-13
3175021007,JAKARTA TIMUR,PULO GADUNG,JATI,32757,7103,25654,21030,46684,2021-10-13
3174041002,JAKARTA SELATAN,PASAR MINGGU,JATI PADANG,37502,8746,28756,22861,51617,2021-10-13
3173071004,JAKARTA BARAT,PALMERAH,JATI PULO,28738,6491,22247,16927,39174,2021-10-13
3175061001,JAKARTA TIMUR,CAKUNG,JATINEGARA,84160,20582,63578,49900,113478,2021-10-13
3175021004,JAKARTA TIMUR,PULO GADUNG,JATINEGARA KAUM,24632,5258,19374,14818,34192,2021-10-13
3173021004,JAKARTA BARAT,GROGOL PETAMBURAN,JELAMBAR,30266,6278,23988,19611,43599,2021-10-13
3173021006,JAKARTA BARAT,GROGOL PETAMBURAN,JELAMBAR BARU,38246,8146,30100,24592,54692,2021-10-13
3173041006,JAKARTA BARAT,TAMBORA,JEMBATAN BESI,29314,8219,21095,15390,36485,2021-10-13
3173041008,JAKARTA BARAT,TAMBORA,JEMBATAN LIMA,21021,5599,15422,11530,26952,2021-10-13
3173081005,JAKARTA BARAT,KEMBANGAN,JOGLO,40839,9439,31400,25249,56649,2021-10-13
3171081001,JAKARTA PUSAT,JOHAR BARU,JOHAR BARU,37488,7694,29794,23890,53684,2021-10-13
3173041002,JAKARTA BARAT,TAMBORA,KALI ANYAR,23856,5535,18321,13724,32045,2021-10-13
3172041004,JAKARTA UTARA,CILINCING,KALIBARU,67684,21032,46652,31928,78580,2021-10-13
3174081002,JAKARTA SELATAN,PANCORAN,KALIBATA,41994,10931,31063,23132,54195,2021-10-13
3173061001,JAKARTA BARAT,KALI DERES,KALIDERES,72447,17094,55353,44795,100148,2021-10-13
3175051004,JAKARTA TIMUR,PASAR REBO,KALISARI,43212,8846,34366,27268,61634,2021-10-13
3173061004,JAKARTA BARAT,KALI DERES,KAMAL,53783,14425,39358,29842,69200,2021-10-13
3172011002,JAKARTA UTARA,PENJARINGAN,KAMAL MUARA,12930,2428,10502,8733,19235,2021-10-13
3171071007,JAKARTA PUSAT,TANAH ABANG,KAMPUNG BALI,11358,2742,8616,6139,14755,2021-10-13
3175031001,JAKARTA TIMUR,JATINEGARA,KAMPUNG MELAYU,25717,6981,18736,13645,32381,2021-10-13
3171081002,JAKARTA PUSAT,JOHAR BARU,KAMPUNG RAWA,21237,3865,17372,13269,30641,2021-10-13
3175041002,JAKARTA TIMUR,KRAMAT JATI,KAMPUNG TENGAH,43993,12216,31777,23696,55473,2021-10-13
3173011005,JAKARTA BARAT,CENGKARENG,KAPUK,134466,36179,98287,74688,172975,2021-10-13
3172011003,JAKARTA UTARA,PENJARINGAN,KAPUK MUARA,35781,7646,28135,23904,52039,2021-10-13
3171021002,JAKARTA PUSAT,SAWAH BESAR,KARANG ANYAR,25761,5572,20189,16054,36243,2021-10-13
3174021004,JAKARTA SELATAN,SETIA BUDI,KARET,9623,2115,7508,5908,13416,2021-10-13
3174021003,JAKARTA SELATAN,SETIA BUDI,KARET KUNINGAN,16055,3540,12515,10145,22660,2021-10-13
3174021002,JAKARTA SELATAN,SETIA BUDI,KARET SEMANGGI,2770,599,2171,1853,4024,2021-10-13
3171071003,JAKARTA PUSAT,TANAH ABANG,KARET TENGSIN,19271,4170,15101,11550,26651,2021-10-13
3171021003,JAKARTA PUSAT,SAWAH BESAR,KARTINI,22292,4855,17437,14057,31494,2021-10-13
3175011003,JAKARTA TIMUR,MATRAMAN,KAYU MANIS,25284,6096,19188,14155,33343,2021-10-13
3175021006,JAKARTA TIMUR,PULO GADUNG,KAYU PUTIH,40696,8618,32078,26713,58791,2021-10-13
3173031006,JAKARTA BARAT,TAMAN SARI,KEAGUNGAN,17387,3879,13508,10525,24033,2021-10-13
3174041007,JAKARTA SELATAN,PASAR MINGGU,KEBAGUSAN,44552,10280,34272,25992,60264,2021-10-13
3174051006,JAKARTA SELATAN,KEBAYORAN LAMA,KEBAYORAN LAMA SELATAN,41212,8733,32479,25705,58184,2021-10-13
3174051001,JAKARTA SELATAN,KEBAYORAN LAMA,KEBAYORAN LAMA UTARA,42422,10244,32178,25049,57227,2021-10-13
3174011004,JAKARTA SELATAN,TEBET,KEBON BARU,35165,7647,27518,21404,48922,2021-10-13
3172021005,JAKARTA UTARA,TANJUNG PRIOK,KEBON BAWANG,50952,11733,39219,30888,70107,2021-10-13
3173051001,JAKARTA BARAT,KEBON JERUK,KEBON JERUK,53887,13395,40492,31551,72043,2021-10-13
3171071006,JAKARTA PUSAT,TANAH ABANG,KEBON KACANG,21531,5841,15690,11754,27444,2021-10-13
3171011005,JAKARTA PUSAT,GAMBIR,KEBON KELAPA,10163,2272,7891,6260,14151,2021-10-13
3171031002,JAKARTA PUSAT,KEMAYORAN,KEBON KOSONG,30019,6902,23117,17505,40622,2021-10-13
3175011005,JAKARTA TIMUR,MATRAMAN,KEBON MANGGIS,16490,3652,12838,10070,22908,2021-10-13
3171071005,JAKARTA PUSAT,TANAH ABANG,KEBON MELATI,32206,9429,22777,15814,38591,2021-10-13
3175081003,JAKARTA TIMUR,MAKASAR,KEBON PALA,46614,10624,35990,28297,64287,2021-10-13
3171061005,JAKARTA PUSAT,MENTENG,KEBON SIRIH,12299,2942,9357,7056,16413,2021-10-13
3173011004,JAKARTA BARAT,CENGKARENG,KEDAUNG KALI ANGKE,32612,7099,25513,20368,45881,2021-10-13
3173051007,JAKARTA BARAT,KEBON JERUK,KEDOYA SELATAN,32165,6796,25369,20057,45426,2021-10-13
3173051006,JAKARTA BARAT,KEBON JERUK,KEDOYA UTARA,45740,9798,35942,29439,65381,2021-10-13
3173051004,JAKARTA BARAT,KEBON JERUK,KELAPA DUA,23565,5597,17968,14253,32221,2021-10-13
3175091003,JAKARTA TIMUR,CIRACAS,KELAPA DUA WETAN,46875,9183,37692,30034,67726,2021-10-13
3172061003,JAKARTA UTARA,KELAPA GADING,KELAPA GADING BARAT,35717,6824,28893,25235,54128,2021-10-13
3172061001,JAKARTA UTARA,KELAPA GADING,KELAPA GADING TIMUR,33592,5651,27941,24915,52856,2021-10-13
3173071005,JAKARTA BARAT,PALMERAH,KEMANGGISAN,32139,6946,25193,19778,44971,2021-10-13
3171031001,JAKARTA PUSAT,KEMAYORAN,KEMAYORAN,20708,4815,15893,12498,28391,2021-10-13
3173081006,JAKARTA BARAT,KEMBANGAN,KEMBANGAN SELATAN,27130,6442,20688,17280,37968,2021-10-13
3173081001,JAKARTA BARAT,KEMBANGAN,KEMBANGAN UTARA,54451,13427,41024,32734,73758,2021-10-13
3171041002,JAKARTA PUSAT,SENEN,KENARI,9579,2105,7474,6071,13545,2021-10-13
3173041005,JAKARTA BARAT,TAMBORA,KERENDANG,19973,4751,15222,11686,26908,2021-10-13
3175071003,JAKARTA TIMUR,DUREN SAWIT,KLENDER,69978,18390,51588,38798,90386,2021-10-13
3172031001,JAKARTA UTARA,KOJA,KOJA,28175,7150,21025,16073,37098,2021-10-13
3173071006,JAKARTA BARAT,PALMERAH,KOTA BAMBU SELATAN,21158,5109,16049,11982,28031,2021-10-13
3173071003,JAKARTA BARAT,PALMERAH,KOTA BAMBU UTARA,24995,6149,18846,13971,32817,2021-10-13
3171041004,JAKARTA PUSAT,SENEN,KRAMAT,28835,7690,21145,15311,36456,2021-10-13
3175041001,JAKARTA TIMUR,KRAMAT JATI,KRAMAT JATI,34144,8297,25847,19763,45610,2021-10-13
3174071003,JAKARTA SELATAN,KEBAYORAN BARU,KRAMAT PELA,14413,3110,11303,9085,20388,2021-10-13
3173031002,JAKARTA BARAT,TAMAN SARI,KRUKUT,19244,4281,14963,11432,26395,2021-10-13
3174031005,JAKARTA SELATAN,MAMPANG PRAPATAN,KUNINGAN BARAT,12785,2695,10090,7869,17959,2021-10-13
3174021008,JAKARTA SELATAN,SETIA BUDI,KUNINGAN TIMUR,6008,1396,4612,3762,8374,2021-10-13
3171041005,JAKARTA PUSAT,SENEN,KWITANG,15486,3941,11545,8947,20492,2021-10-13
3172031003,JAKARTA UTARA,KOJA,LAGOA,59065,15766,43299,32523,75822,2021-10-13
3174061002,JAKARTA SELATAN,CILANDAK,LEBAK BULUS,37626,8076,29550,23822,53372,2021-10-13
3174091004,JAKARTA SELATAN,JAGAKARSA,LENTENG AGUNG,53946,11543,42403,31736,74139,2021-10-13
3175101007,JAKARTA TIMUR,CIPAYUNG,LUBANG BUAYA,63547,13577,49970,39428,89398,2021-10-13
3175081001,JAKARTA TIMUR,MAKASAR,MAKASAR,34390,7238,27152,21622,48774,2021-10-13
3175071006,JAKARTA TIMUR,DUREN SAWIT,MALAKA JAYA,30927,6319,24608,19814,44422,2021-10-13
3175071005,JAKARTA TIMUR,DUREN SAWIT,MALAKA SARI,27530,5380,22150,18087,40237,2021-10-13
3174031001,JAKARTA SELATAN,MAMPANG PRAPATAN,MAMPANG PRAPATAN,18159,4288,13871,10745,24616,2021-10-13
3173031005,JAKARTA BARAT,TAMAN SARI,MANGGA BESAR,7707,1440,6267,5210,11477,2021-10-13
3171021005,JAKARTA PUSAT,SAWAH BESAR,MANGGA DUA SELATAN,27442,6311,21131,16881,38012,2021-10-13
3174011007,JAKARTA SELATAN,TEBET,MANGGARAI,28373,5804,22569,17133,39702,2021-10-13
3174011006,JAKARTA SELATAN,TEBET,MANGGARAI SELATAN,23075,4735,18340,14631,32971,2021-10-13
3173031003,JAKARTA BARAT,TAMAN SARI,MAPHAR,16461,3538,12923,10243,23166,2021-10-13
3172041003,JAKARTA UTARA,CILINCING,MARUNDA,28943,7306,21637,15625,37262,2021-10-13
3174071001,JAKARTA SELATAN,KEBAYORAN BARU,MELAWAI,2627,562,2065,1856,3921,2021-10-13
3171061001,JAKARTA PUSAT,MENTENG,MENTENG,25624,6452,19172,14334,33506,2021-10-13
3174021005,JAKARTA SELATAN,SETIA BUDI,MENTENG ATAS,27816,5806,22010,17171,39181,2021-10-13
3174011003,JAKARTA SELATAN,TEBET,MENTENG DALAM,36028,7969,28059,22145,50204,2021-10-13
3173081003,JAKARTA BARAT,KEMBANGAN,MERUYA SELATAN,32130,7552,24578,19490,44068,2021-10-13
3173081002,JAKARTA BARAT,KEMBANGAN,MERUYA UTARA,43752,10260,33492,27625,61117,2021-10-13
3175101004,JAKARTA TIMUR,CIPAYUNG,MUNJUL,23871,4941,18930,15005,33935,2021-10-13
3172051002,JAKARTA UTARA,PADEMANGAN,PADEMANGAN BARAT,74240,19392,54848,42124,96972,2021-10-13
3172051001,JAKARTA UTARA,PADEMANGAN,PADEMANGAN TIMUR,37736,7455,30281,25124,55405,2021-10-13
3175011004,JAKARTA TIMUR,MATRAMAN,PAL MERIAM,19769,4741,15028,11396,26424,2021-10-13
3173071001,JAKARTA BARAT,PALMERAH,PALMERAH,63011,15392,47619,36626,84245,2021-10-13
3174081001,JAKARTA SELATAN,PANCORAN,PANCORAN,19421,4682,14739,11584,26323,2021-10-13
3172021003,JAKARTA UTARA,TANJUNG PRIOK,PAPANGGO,39097,8824,30273,23756,54029,2021-10-13
3171021001,JAKARTA PUSAT,SAWAH BESAR,PASAR BARU,12035,2549,9486,8121,17607,2021-10-13
3174021006,JAKARTA SELATAN,SETIA BUDI,PASAR MANGGIS,26752,6172,20580,16060,36640,2021-10-13
3174041001,JAKARTA SELATAN,PASAR MINGGU,PASAR MINGGU,24821,5352,19469,15585,35054,2021-10-13
3171041003,JAKARTA PUSAT,SENEN,PASEBAN,23533,5675,17858,13917,31775,2021-10-13
3173061005,JAKARTA BARAT,KALI DERES,PEGADUNGAN,75587,17229,58358,48398,106756,2021-10-13
3171061002,JAKARTA PUSAT,MENTENG,PEGANGSAAN,23455,5785,17670,12746,30416,2021-10-13
3172061002,JAKARTA UTARA,KELAPA GADING,PEGANGSAAN DUA,49976,9019,40957,35921,76878,2021-10-13
3172011004,JAKARTA UTARA,PENJARINGAN,PEJAGALAN,74578,17321,57257,46642,103899,2021-10-13
3174041006,JAKARTA SELATAN,PASAR MINGGU,PEJATEN BARAT,37346,8551,28795,22702,51497,2021-10-13
3174041005,JAKARTA SELATAN,PASAR MINGGU,PEJATEN TIMUR,57656,14855,42801,33253,76054,2021-10-13
3175051005,JAKARTA TIMUR,PASAR REBO,PEKAYON,43250,8989,34261,26904,61165,2021-10-13
3173041009,JAKARTA BARAT,TAMBORA,PEKOJAN,23587,5110,18477,14704,33181,2021-10-13
3174031003,JAKARTA SELATAN,MAMPANG PRAPATAN,PELA MAMPANG,43522,9928,33594,26469,60063,2021-10-13
3174081005,JAKARTA SELATAN,PANCORAN,PENGADEGAN,21478,4433,17045,13389,30434,2021-10-13
3175061003,JAKARTA TIMUR,CAKUNG,PENGGILINGAN,99255,26228,73027,55121,128148,2021-10-13
3172011001,JAKARTA UTARA,PENJARINGAN,PENJARINGAN,88308,25154,63154,46255,109409,2021-10-13
3174101001,JAKARTA SELATAN,PESANGGRAHAN,PESANGGRAHAN,27545,5428,22117,17981,40098,2021-10-13
3171071004,JAKARTA PUSAT,TANAH ABANG,PETAMBURAN,33271,9772,23499,16606,40105,2021-10-13
3174071008,JAKARTA SELATAN,KEBAYORAN BARU,PETOGOGAN,11499,2573,8926,7171,16097,2021-10-13
3171011004,JAKARTA PUSAT,GAMBIR,PETOJO SELATAN,14692,3665,11027,8885,19912,2021-10-13
3171011003,JAKARTA PUSAT,GAMBIR,PETOJO UTARA,17458,4186,13272,10313,23585,2021-10-13
3174101004,JAKARTA SELATAN,PESANGGRAHAN,PETUKANGAN SELATAN,37187,8686,28501,22760,51261,2021-10-13
3174101003,JAKARTA SELATAN,PESANGGRAHAN,PETUKANGAN UTARA,53716,13194,40522,31920,72442,2021-10-13
3175081002,JAKARTA TIMUR,MAKASAR,PINANG RANTI,27198,6696,20502,16199,36701,2021-10-13
3173031008,JAKARTA BARAT,TAMAN SARI,PINANGSIA,10729,2123,8606,6818,15424,2021-10-13
3175011001,JAKARTA TIMUR,MATRAMAN,PISANGAN BARU,31776,7533,24243,17975,42218,2021-10-13
3175021002,JAKARTA TIMUR,PULO GADUNG,PISANGAN TIMUR,41011,8786,32225,25761,57986,2021-10-13
3172011005,JAKARTA UTARA,PENJARINGAN,PLUIT,47783,10238,37545,31646,69191,2021-10-13
3175071002,JAKARTA TIMUR,DUREN SAWIT,PONDOK BAMBU,61550,14864,46686,36328,83014,2021-10-13
3175071004,JAKARTA TIMUR,DUREN SAWIT,PONDOK KELAPA,72015,16011,56004,45498,101502,2021-10-13
3175071007,JAKARTA TIMUR,DUREN SAWIT,PONDOK KOPI,35367,7843,27524,20332,47856,2021-10-13
3174061003,JAKARTA SELATAN,CILANDAK,PONDOK LABU,46464,9125,37339,30616,67955,2021-10-13
3174051002,JAKARTA SELATAN,KEBAYORAN LAMA,PONDOK PINANG,56169,12008,44161,34995,79156,2021-10-13
3175101003,JAKARTA TIMUR,CIPAYUNG,PONDOK RANGGON,25574,5386,20188,15725,35913,2021-10-13
3101011003,KAB.ADM.KEP.SERIBU,KEP. SERIBU UTARA,PULAU HARAPAN,2060,248,1812,1532,3344,2021-10-13
3101011002,KAB.ADM.KEP.SERIBU,KEP. SERIBU UTARA,PULAU KELAPA,5528,655,4873,3883,8756,2021-10-13
3101011001,KAB.ADM.KEP.SERIBU,KEP. SERIBU UTARA,PULAU PANGGANG,5450,512,4938,4282,9220,2021-10-13
3101021003,KAB.ADM.KEP.SERIBU,KEP. SERIBU SELATAN,PULAU PARI,2765,212,2553,2323,4876,2021-10-13
3101021002,KAB.ADM.KEP.SERIBU,KEP. SERIBU SELATAN,PULAU TIDUNG,4553,422,4131,3687,7818,2021-10-13
3101021001,KAB.ADM.KEP.SERIBU,KEP. SERIBU SELATAN,PULAU UNTUNG JAWA,1941,197,1744,1594,3338,2021-10-13
3174071007,JAKARTA SELATAN,KEBAYORAN BARU,PULO,5835,1121,4714,4078,8792,2021-10-13
3175021001,JAKARTA TIMUR,PULO GADUNG,PULO GADUNG,34422,8331,26091,20571,46662,2021-10-13
3175061005,JAKARTA TIMUR,CAKUNG,PULO GEBANG,97301,21206,76095,58287,134382,2021-10-13
3174041004,JAKARTA SELATAN,PASAR MINGGU,RAGUNAN,39616,8524,31092,24993,56085,2021-10-13
3175091005,JAKARTA TIMUR,CIRACAS,RAMBUTAN,36771,9695,27076,20329,47405,2021-10-13
3172031006,JAKARTA UTARA,KOJA,RAWA BADAK SELATAN,42179,11200,30979,23145,54124,2021-10-13
3172031004,JAKARTA UTARA,KOJA,RAWA BADAK UTARA,34408,8684,25724,19453,45177,2021-10-13
3174071005,JAKARTA SELATAN,KEBAYORAN BARU,RAWA BARAT,5625,1092,4533,3825,8358,2021-10-13
3173011003,JAKARTA BARAT,CENGKARENG,RAWA BUAYA,63799,14730,49069,36986,86055,2021-10-13
3175031004,JAKARTA TIMUR,JATINEGARA,RAWA BUNGA,21434,5789,15645,11876,27521,2021-10-13
3174081003,JAKARTA SELATAN,PANCORAN,RAWA JATI,20509,4429,16080,12622,28702,2021-10-13
3175061002,JAKARTA TIMUR,CAKUNG,RAWA TERATE,24637,5128,19509,15304,34813,2021-10-13
3175021005,JAKARTA TIMUR,PULO GADUNG,RAWAMANGUN,37612,8480,29132,23357,52489,2021-10-13
3171051003,JAKARTA PUSAT,CEMPAKA PUTIH,RAWASARI,21967,5072,16895,13565,30460,2021-10-13
3173041010,JAKARTA BARAT,TAMBORA,ROA MALAKA,3484,660,2824,2413,5237,2021-10-13
3172041006,JAKARTA UTARA,CILINCING,ROROTAN,41668,9471,32197,24632,56829,2021-10-13
3174071004,JAKARTA SELATAN,KEBAYORAN BARU,SELONG,2842,587,2255,1993,4248,2021-10-13
3173061002,JAKARTA BARAT,KALI DERES,SEMANAN,71354,18091,53263,41333,94596,2021-10-13
3172041007,JAKARTA UTARA,CILINCING,SEMPER BARAT,68587,15223,53364,42385,95749,2021-10-13
3172041005,JAKARTA UTARA,CILINCING,SEMPER TIMUR,36267,8682,27585,21271,48856,2021-10-13
3174071006,JAKARTA SELATAN,KEBAYORAN BARU,SENAYAN,2771,715,2056,1684,3740,2021-10-13
3171041001,JAKARTA PUSAT,SENEN,SENEN,6804,1628,5176,4187,9363,2021-10-13
3171031004,JAKARTA PUSAT,KEMAYORAN,SERDANG,29668,6707,22961,18009,40970,2021-10-13
3174021001,JAKARTA SELATAN,SETIA BUDI,SETIA BUDI,3023,702,2321,1868,4189,2021-10-13
3175101005,JAKARTA TIMUR,CIPAYUNG,SETU,20572,4825,15747,12079,27826,2021-10-13
3173071002,JAKARTA BARAT,PALMERAH,SLIPI,16591,3457,13134,10470,23604,2021-10-13
3173081004,JAKARTA BARAT,KEMBANGAN,SRENGSENG,45523,11483,34040,27395,61435,2021-10-13
3174091002,JAKARTA SELATAN,JAGAKARSA,SRENGSENG SAWAH,58196,10833,47363,38205,85568,2021-10-13
3173051003,JAKARTA BARAT,KEBON JERUK,SUKABUMI SELATAN,37033,9527,27506,20287,47793,2021-10-13
3173051002,JAKARTA BARAT,KEBON JERUK,SUKABUMI UTARA,38290,10226,28064,20825,48889,2021-10-13
3172041002,JAKARTA UTARA,CILINCING,SUKAPURA,53949,13659,40290,31699,71989,2021-10-13
3171031007,JAKARTA PUSAT,KEMAYORAN,SUMUR BATU,22717,5221,17496,14052,31548,2021-10-13
3172021004,JAKARTA UTARA,TANJUNG PRIOK,SUNGAI BAMBU,29876,6810,23066,18165,41231,2021-10-13
3172021006,JAKARTA UTARA,TANJUNG PRIOK,SUNTER AGUNG,71805,13893,57912,48481,106393,2021-10-13
3172021002,JAKARTA UTARA,TANJUNG PRIOK,SUNTER JAYA,63031,12736,50295,41543,91838,2021-10-13
3175091004,JAKARTA TIMUR,CIRACAS,SUSUKAN,38257,8113,30144,23828,53972,2021-10-13
3173031001,JAKARTA BARAT,TAMAN SARI,TAMAN SARI,14348,3003,11345,9357,20702,2021-10-13
3173041001,JAKARTA BARAT,TAMBORA,TAMBORA,10204,2554,7650,5908,13558,2021-10-13
3173041004,JAKARTA BARAT,TAMBORA,TANAH SEREAL,26387,4990,21397,17067,38464,2021-10-13
3171081004,JAKARTA PUSAT,JOHAR BARU,TANAH TINGGI,37693,7875,29818,23095,52913,2021-10-13
3173031004,JAKARTA BARAT,TAMAN SARI,TANGKI,13324,2542,10782,8537,19319,2021-10-13
3174091005,JAKARTA SELATAN,JAGAKARSA,TANJUNG BARAT,39770,7645,32125,24476,56601,2021-10-13
3173021005,JAKARTA BARAT,GROGOL PETAMBURAN,TANJUNG DUREN SELATAN,25337,5476,19861,16530,36391,2021-10-13
3173021002,JAKARTA BARAT,GROGOL PETAMBURAN,TANJUNG DUREN UTARA,17010,3255,13755,11620,25375,2021-10-13
3172021001,JAKARTA UTARA,TANJUNG PRIOK,TANJUNG PRIOK,34588,7979,26609,20872,47481,2021-10-13
3174011002,JAKARTA SELATAN,TEBET,TEBET BARAT,21194,3967,17227,14405,31632,2021-10-13
3174011001,JAKARTA SELATAN,TEBET,TEBET TIMUR,18199,3297,14902,12696,27598,2021-10-13
3173061003,JAKARTA BARAT,KALI DERES,TEGAL ALUR,83647,20090,63557,50002,113559,2021-10-13
3174031004,JAKARTA SELATAN,MAMPANG PRAPATAN,TEGAL PARANG,32401,8185,24216,17463,41679,2021-10-13
3173021003,JAKARTA BARAT,GROGOL PETAMBURAN,TOMANG,29605,6141,23464,19029,42493,2021-10-13
3172031005,JAKARTA UTARA,KOJA,TUGU SELATAN,39122,9739,29383,22399,51782,2021-10-13
3172031002,JAKARTA UTARA,KOJA,TUGU UTARA,67670,17809,49861,37325,87186,2021-10-13
3175061006,JAKARTA TIMUR,CAKUNG,UJUNG MENTENG,29934,5843,24091,19420,43511,2021-10-13
3174101005,JAKARTA SELATAN,PESANGGRAHAN,ULUJAMI,40544,10416,30128,23249,53377,2021-10-13
3175011006,JAKARTA TIMUR,MATRAMAN,UTAN KAYU SELATAN,33511,7005,26506,20522,47028,2021-10-13
3175011002,JAKARTA TIMUR,MATRAMAN,UTAN KAYU UTARA,28169,6672,21497,16622,38119,2021-10-13
3171031008,JAKARTA PUSAT,KEMAYORAN,UTAN PANJANG,29208,6705,22503,16827,39330,2021-10-13
3172021007,JAKARTA UTARA,TANJUNG PRIOK,WARAKAS,44401,9277,35124,26828,61952,2021-10-13
3173021007,JAKARTA BARAT,GROGOL PETAMBURAN,WIJAYA KUSUMA,38934,9454,29480,23536,53016,2021-10-13
3172051003,JAKARTA UTARA,PADEMANGAN,ANCOL,23947,6325,17622,13848,31470,2021-10-14
3173041007,JAKARTA BARAT,TAMBORA,ANGKE,29381,7111,22270,17226,39496,2021-10-14
3175041005,JAKARTA TIMUR,KRAMAT JATI,BALE KAMBANG,29074,8107,20967,15227,36194,2021-10-14
3175031003,JAKARTA TIMUR,JATINEGARA,BALI MESTER,9752,2297,7455,5916,13371,2021-10-14
3175101006,JAKARTA TIMUR,CIPAYUNG,BAMBU APUS,26285,5509,20776,15970,36746,2021-10-14
3174031002,JAKARTA SELATAN,MAMPANG PRAPATAN,BANGKA,21566,5317,16249,12703,28952,2021-10-14
3175051002,JAKARTA TIMUR,PASAR REBO,BARU,23886,4516,19370,16021,35391,2021-10-14
3175041004,JAKARTA TIMUR,KRAMAT JATI,BATU AMPAR,47898,13070,34828,26070,60898,2021-10-14
3171071002,JAKARTA PUSAT,TANAH ABANG,BENDUNGAN HILIR,21494,4851,16643,13359,30002,2021-10-14
3175031002,JAKARTA TIMUR,JATINEGARA,BIDARA CINA,36689,9849,26840,20080,46920,2021-10-14
3174101002,JAKARTA SELATAN,PESANGGRAHAN,BINTARO,53098,12030,41068,33323,74391,2021-10-14
3174011005,JAKARTA SELATAN,TEBET,BUKIT DURI,34183,8013,26170,20479,46649,2021-10-14
3171041006,JAKARTA PUSAT,SENEN,BUNGUR,18144,4327,13817,10996,24813,2021-10-14
3175061007,JAKARTA TIMUR,CAKUNG,CAKUNG BARAT,57724,13345,44379,35230,79609,2021-10-14
3175061004,JAKARTA TIMUR,CAKUNG,CAKUNG TIMUR,58287,12904,45383,35887,81270,2021-10-14
3175041007,JAKARTA TIMUR,KRAMAT JATI,CAWANG,32762,8121,24641,18480,43121,2021-10-14
3175101008,JAKARTA TIMUR,CIPAYUNG,CEGER,18932,4163,14769,11672,26441,2021-10-14
3171031006,JAKARTA PUSAT,KEMAYORAN,CEMPAKA BARU,32581,7707,24874,18650,43524,2021-10-14
3171051002,JAKARTA PUSAT,CEMPAKA PUTIH,CEMPAKA PUTIH BARAT,35885,8587,27298,21913,49211,2021-10-14
3171051001,JAKARTA PUSAT,CEMPAKA PUTIH,CEMPAKA PUTIH TIMUR,24292,5561,18731,15454,34185,2021-10-14
3173011001,JAKARTA BARAT,CENGKARENG,CENGKARENG BARAT,66284,15292,50992,40702,91694,2021-10-14
3173011006,JAKARTA BARAT,CENGKARENG,CENGKARENG TIMUR,81027,18105,62922,48960,111882,2021-10-14
3175091002,JAKARTA TIMUR,CIRACAS,CIBUBUR,66364,12895,53469,42403,95872,2021-10-14
3171011002,JAKARTA PUSAT,GAMBIR,CIDENG,15390,3292,12098,10063,22161,2021-10-14
3174091003,JAKARTA SELATAN,JAGAKARSA,CIGANJUR,38497,7902,30595,23468,54063,2021-10-14
3175051003,JAKARTA TIMUR,PASAR REBO,CIJANTUNG,41419,8710,32709,25912,58621,2021-10-14
3171061003,JAKARTA PUSAT,MENTENG,CIKINI,8274,1656,6618,4881,11499,2021-10-14
3174081006,JAKARTA SELATAN,PANCORAN,CIKOKO,10547,2097,8450,6935,15385,2021-10-14
3174061001,JAKARTA SELATAN,CILANDAK,CILANDAK BARAT,51752,10658,41094,33670,74764,2021-10-14
3174041003,JAKARTA SELATAN,PASAR MINGGU,CILANDAK TIMUR,25145,5363,19782,15987,35769,2021-10-14
3175101002,JAKARTA TIMUR,CIPAYUNG,CILANGKAP,27635,5441,22194,17563,39757,2021-10-14
3175041006,JAKARTA TIMUR,KRAMAT JATI,CILILITAN,40181,10139,30042,22848,52890,2021-10-14
3172041001,JAKARTA UTARA,CILINCING,CILINCING,43609,11622,31987,23581,55568,2021-10-14
3175101001,JAKARTA TIMUR,CIPAYUNG,CIPAYUNG,26104,5079,21025,17194,38219,2021-10-14
3174091006,JAKARTA SELATAN,JAGAKARSA,CIPEDAK,38303,7582,30721,24207,54928,2021-10-14
3174061005,JAKARTA SELATAN,CILANDAK,CIPETE SELATAN,26704,5808,20896,17204,38100,2021-10-14
3174071010,JAKARTA SELATAN,KEBAYORAN BARU,CIPETE UTARA,34102,7365,26737,20695,47432,2021-10-14
3175021003,JAKARTA TIMUR,PULO GADUNG,CIPINANG,39306,8531,30775,24019,54794,2021-10-14
3175031007,JAKARTA TIMUR,JATINEGARA,CIPINANG BESAR SELATAN,35212,9339,25873,18901,44774,2021-10-14
3175031008,JAKARTA TIMUR,JATINEGARA,CIPINANG BESAR UTARA,45319,12007,33312,24141,57453,2021-10-14
3175031005,JAKARTA TIMUR,JATINEGARA,CIPINANG CEMPEDAK,32824,7921,24903,19495,44398,2021-10-14
3175081005,JAKARTA TIMUR,MAKASAR,CIPINANG MELAYU,42308,9165,33143,26296,59439,2021-10-14
3175031006,JAKARTA TIMUR,JATINEGARA,CIPINANG MUARA,55243,13528,41715,31964,73679,2021-10-14
3174051003,JAKARTA SELATAN,KEBAYORAN LAMA,CIPULIR,39937,9525,30412,22936,53348,2021-10-14
3175091001,JAKARTA TIMUR,CIRACAS,CIRACAS,64594,13323,51271,39890,91161,2021-10-14
3175041003,JAKARTA TIMUR,KRAMAT JATI,DUKUH,24609,5294,19315,14995,34310,2021-10-14
3175071001,JAKARTA TIMUR,DUREN SAWIT,DUREN SAWIT,61160,14523,46637,35996,82633,2021-10-14
3174081004,JAKARTA SELATAN,PANCORAN,DUREN TIGA,28319,6340,21979,16743,38722,2021-10-14
3173051005,JAKARTA BARAT,KEBON JERUK,DURI KEPA,60138,13147,46991,39049,86040,2021-10-14
3173011002,JAKARTA BARAT,CENGKARENG,DURI KOSAMBI,77923,19419,58504,44304,102808,2021-10-14
3171011006,JAKARTA PUSAT,GAMBIR,DURI PULO,19610,4632,14978,11484,26462,2021-10-14
3173041011,JAKARTA BARAT,TAMBORA,DURI SELATAN,14259,2806,11453,9208,20661,2021-10-14
3173041003,JAKARTA BARAT,TAMBORA,DURI UTARA,19844,4230,15614,12206,27820,2021-10-14
3171081003,JAKARTA PUSAT,JOHAR BARU,GALUR,18243,3996,14247,11069,25316,2021-10-14
3171011001,JAKARTA PUSAT,GAMBIR,GAMBIR,2191,504,1687,1386,3073,2021-10-14
3174061004,JAKARTA SELATAN,CILANDAK,GANDARIA SELATAN,22119,4898,17221,13728,30949,2021-10-14
3174071009,JAKARTA SELATAN,KEBAYORAN BARU,GANDARIA UTARA,39922,9086,30836,24278,55114,2021-10-14
3175051001,JAKARTA TIMUR,PASAR REBO,GEDONG,35755,7988,27767,22163,49930,2021-10-14
3171071001,JAKARTA PUSAT,TANAH ABANG,GELORA,3127,682,2445,1983,4428,2021-10-14
3173031007,JAKARTA BARAT,TAMAN SARI,GLODOK,7837,1427,6410,5577,11987,2021-10-14
3171061004,JAKARTA PUSAT,MENTENG,GONDANGDIA,4100,988,3112,2761,5873,2021-10-14
3173021001,JAKARTA BARAT,GROGOL PETAMBURAN,GROGOL,16876,3776,13100,10485,23585,2021-10-14
3174051005,JAKARTA SELATAN,KEBAYORAN LAMA,GROGOL SELATAN,44251,10338,33913,26265,60178,2021-10-14
3174051004,JAKARTA SELATAN,KEBAYORAN LAMA,GROGOL UTARA,42494,10001,32493,25656,58149,2021-10-14
3174021007,JAKARTA SELATAN,SETIA BUDI,GUNTUR,3985,842,3143,2662,5805,2021-10-14
3174071002,JAKARTA SELATAN,KEBAYORAN BARU,GUNUNG,9436,1946,7490,6203,13693,2021-10-14
3171031005,JAKARTA PUSAT,KEMAYORAN,GUNUNG SAHARI SELATAN,19199,4392,14807,11803,26610,2021-10-14
3171021004,JAKARTA PUSAT,SAWAH BESAR,GUNUNG SAHARI UTARA,16650,3268,13382,11372,24754,2021-10-14
3175081004,JAKARTA TIMUR,MAKASAR,HALIM PERDANA KUSUMAH,28363,4186,24177,21415,45592,2021-10-14
3171031003,JAKARTA PUSAT,KEMAYORAN,HARAPAN MULIA,22557,5220,17337,13293,30630,2021-10-14
3174091001,JAKARTA SELATAN,JAGAKARSA,JAGAKARSA,62389,12693,49696,39188,88884,2021-10-14
3175021007,JAKARTA TIMUR,PULO GADUNG,JATI,32757,7028,25729,21093,46822,2021-10-14
3174041002,JAKARTA SELATAN,PASAR MINGGU,JATI PADANG,37502,8647,28855,22934,51789,2021-10-14
3173071004,JAKARTA BARAT,PALMERAH,JATI PULO,28738,6478,22260,16945,39205,2021-10-14
3175061001,JAKARTA TIMUR,CAKUNG,JATINEGARA,84160,20525,63635,49993,113628,2021-10-14
3175021004,JAKARTA TIMUR,PULO GADUNG,JATINEGARA KAUM,24632,5154,19478,14868,34346,2021-10-14
3173021004,JAKARTA BARAT,GROGOL PETAMBURAN,JELAMBAR,30266,6246,24020,19667,43687,2021-10-14
3173021006,JAKARTA BARAT,GROGOL PETAMBURAN,JELAMBAR BARU,38246,8100,30146,24668,54814,2021-10-14
3173041006,JAKARTA BARAT,TAMBORA,JEMBATAN BESI,29314,8114,21200,15528,36728,2021-10-14
3173041008,JAKARTA BARAT,TAMBORA,JEMBATAN LIMA,21021,5570,15451,11564,27015,2021-10-14
3173081005,JAKARTA BARAT,KEMBANGAN,JOGLO,40839,9376,31463,25366,56829,2021-10-14
3171081001,JAKARTA PUSAT,JOHAR BARU,JOHAR BARU,37488,7654,29834,23961,53795,2021-10-14
3173041002,JAKARTA BARAT,TAMBORA,KALI ANYAR,23856,5511,18345,13756,32101,2021-10-14
3172041004,JAKARTA UTARA,CILINCING,KALIBARU,67684,20633,47051,32227,79278,2021-10-14
3174081002,JAKARTA SELATAN,PANCORAN,KALIBATA,41994,10878,31116,23220,54336,2021-10-14
3173061001,JAKARTA BARAT,KALI DERES,KALIDERES,72447,17037,55410,44869,100279,2021-10-14
3175051004,JAKARTA TIMUR,PASAR REBO,KALISARI,43212,8798,34414,27335,61749,2021-10-14
3173061004,JAKARTA BARAT,KALI DERES,KAMAL,53783,14389,39394,29902,69296,2021-10-14
3172011002,JAKARTA UTARA,PENJARINGAN,KAMAL MUARA,12930,2423,10507,8746,19253,2021-10-14
3171071007,JAKARTA PUSAT,TANAH ABANG,KAMPUNG BALI,11358,2737,8621,6146,14767,2021-10-14
3175031001,JAKARTA TIMUR,JATINEGARA,KAMPUNG MELAYU,25717,6901,18816,13793,32609,2021-10-14
3171081002,JAKARTA PUSAT,JOHAR BARU,KAMPUNG RAWA,21237,3851,17386,13294,30680,2021-10-14
3175041002,JAKARTA TIMUR,KRAMAT JATI,KAMPUNG TENGAH,43993,12138,31855,23760,55615,2021-10-14
3173011005,JAKARTA BARAT,CENGKARENG,KAPUK,134466,36041,98425,74950,173375,2021-10-14
3172011003,JAKARTA UTARA,PENJARINGAN,KAPUK MUARA,35781,7620,28161,23931,52092,2021-10-14
3171021002,JAKARTA PUSAT,SAWAH BESAR,KARANG ANYAR,25761,5563,20198,16090,36288,2021-10-14
3174021004,JAKARTA SELATAN,SETIA BUDI,KARET,9623,2104,7519,5914,13433,2021-10-14
3174021003,JAKARTA SELATAN,SETIA BUDI,KARET KUNINGAN,16055,3529,12526,10153,22679,2021-10-14
3174021002,JAKARTA SELATAN,SETIA BUDI,KARET SEMANGGI,2770,598,2172,1855,4027,2021-10-14
3171071003,JAKARTA PUSAT,TANAH ABANG,KARET TENGSIN,19271,4156,15115,11592,26707,2021-10-14
3171021003,JAKARTA PUSAT,SAWAH BESAR,KARTINI,22292,4842,17450,14086,31536,2021-10-14
3175011003,JAKARTA TIMUR,MATRAMAN,KAYU MANIS,25284,6082,19202,14189,33391,2021-10-14
3175021006,JAKARTA TIMUR,PULO GADUNG,KAYU PUTIH,40696,8594,32102,26747,58849,2021-10-14
3173031006,JAKARTA BARAT,TAMAN SARI,KEAGUNGAN,17387,3843,13544,10559,24103,2021-10-14
3174041007,JAKARTA SELATAN,PASAR MINGGU,KEBAGUSAN,44552,10231,34321,26097,60418,2021-10-14
3174051006,JAKARTA SELATAN,KEBAYORAN LAMA,KEBAYORAN LAMA SELATAN,41212,8711,32501,25760,58261,2021-10-14
3174051001,JAKARTA SELATAN,KEBAYORAN LAMA,KEBAYORAN LAMA UTARA,42422,10217,32205,25084,57289,2021-10-14
3174011004,JAKARTA SELATAN,TEBET,KEBON BARU,35165,7563,27602,21445,49047,2021-10-14
3172021005,JAKARTA UTARA,TANJUNG PRIOK,KEBON BAWANG,50952,11685,39267,30973,70240,2021-10-14
3173051001,JAKARTA BARAT,KEBON JERUK,KEBON JERUK,53887,13331,40556,31633,72189,2021-10-14
3171071006,JAKARTA PUSAT,TANAH ABANG,KEBON KACANG,21531,5824,15707,11765,27472,2021-10-14
3171011005,JAKARTA PUSAT,GAMBIR,KEBON KELAPA,10163,2266,7897,6268,14165,2021-10-14
3171031002,JAKARTA PUSAT,KEMAYORAN,KEBON KOSONG,30019,6834,23185,17528,40713,2021-10-14
3175011005,JAKARTA TIMUR,MATRAMAN,KEBON MANGGIS,16490,3644,12846,10099,22945,2021-10-14
3171071005,JAKARTA PUSAT,TANAH ABANG,KEBON MELATI,32206,9416,22790,15828,38618,2021-10-14
3175081003,JAKARTA TIMUR,MAKASAR,KEBON PALA,46614,10577,36037,28360,64397,2021-10-14
3171061005,JAKARTA PUSAT,MENTENG,KEBON SIRIH,12299,2928,9371,7076,16447,2021-10-14
3173011004,JAKARTA BARAT,CENGKARENG,KEDAUNG KALI ANGKE,32612,7078,25534,20408,45942,2021-10-14
3173051007,JAKARTA BARAT,KEBON JERUK,KEDOYA SELATAN,32165,6731,25434,20092,45526,2021-10-14
3173051006,JAKARTA BARAT,KEBON JERUK,KEDOYA UTARA,45740,9748,35992,29471,65463,2021-10-14
3173051004,JAKARTA BARAT,KEBON JERUK,KELAPA DUA,23565,5561,18004,14294,32298,2021-10-14
3175091003,JAKARTA TIMUR,CIRACAS,KELAPA DUA WETAN,46875,9134,37741,30087,67828,2021-10-14
3172061003,JAKARTA UTARA,KELAPA GADING,KELAPA GADING BARAT,35717,6790,28927,25267,54194,2021-10-14
3172061001,JAKARTA UTARA,KELAPA GADING,KELAPA GADING TIMUR,33592,5624,27968,24950,52918,2021-10-14
3173071005,JAKARTA BARAT,PALMERAH,KEMANGGISAN,32139,6934,25205,19814,45019,2021-10-14
3171031001,JAKARTA PUSAT,KEMAYORAN,KEMAYORAN,20708,4805,15903,12518,28421,2021-10-14
3173081006,JAKARTA BARAT,KEMBANGAN,KEMBANGAN SELATAN,27130,6436,20694,17305,37999,2021-10-14
3173081001,JAKARTA BARAT,KEMBANGAN,KEMBANGAN UTARA,54451,13372,41079,32817,73896,2021-10-14
3171041002,JAKARTA PUSAT,SENEN,KENARI,9579,2099,7480,6079,13559,2021-10-14
3173041005,JAKARTA BARAT,TAMBORA,KERENDANG,19973,4728,15245,11720,26965,2021-10-14
3175071003,JAKARTA TIMUR,DUREN SAWIT,KLENDER,69978,18329,51649,38878,90527,2021-10-14
3172031001,JAKARTA UTARA,KOJA,KOJA,28175,7129,21046,16119,37165,2021-10-14
3173071006,JAKARTA BARAT,PALMERAH,KOTA BAMBU SELATAN,21158,5097,16061,12021,28082,2021-10-14
3173071003,JAKARTA BARAT,PALMERAH,KOTA BAMBU UTARA,24995,6130,18865,14000,32865,2021-10-14
3171041004,JAKARTA PUSAT,SENEN,KRAMAT,28835,7670,21165,15343,36508,2021-10-14
3175041001,JAKARTA TIMUR,KRAMAT JATI,KRAMAT JATI,34144,8275,25869,19801,45670,2021-10-14
3174071003,JAKARTA SELATAN,KEBAYORAN BARU,KRAMAT PELA,14413,3098,11315,9110,20425,2021-10-14
3173031002,JAKARTA BARAT,TAMAN SARI,KRUKUT,19244,4236,15008,11472,26480,2021-10-14
3174031005,JAKARTA SELATAN,MAMPANG PRAPATAN,KUNINGAN BARAT,12785,2691,10094,7911,18005,2021-10-14
3174021008,JAKARTA SELATAN,SETIA BUDI,KUNINGAN TIMUR,6008,1390,4618,3772,8390,2021-10-14
3171041005,JAKARTA PUSAT,SENEN,KWITANG,15486,3928,11558,8958,20516,2021-10-14
3172031003,JAKARTA UTARA,KOJA,LAGOA,59065,15671,43394,32673,76067,2021-10-14
3174061002,JAKARTA SELATAN,CILANDAK,LEBAK BULUS,37626,8044,29582,23887,53469,2021-10-14
3174091004,JAKARTA SELATAN,JAGAKARSA,LENTENG AGUNG,53946,11379,42567,31846,74413,2021-10-14
3175101007,JAKARTA TIMUR,CIPAYUNG,LUBANG BUAYA,63547,13503,50044,39507,89551,2021-10-14
3175081001,JAKARTA TIMUR,MAKASAR,MAKASAR,34390,7211,27179,21674,48853,2021-10-14
3175071006,JAKARTA TIMUR,DUREN SAWIT,MALAKA JAYA,30927,6288,24639,19855,44494,2021-10-14
3175071005,JAKARTA TIMUR,DUREN SAWIT,MALAKA SARI,27530,5285,22245,18141,40386,2021-10-14
3174031001,JAKARTA SELATAN,MAMPANG PRAPATAN,MAMPANG PRAPATAN,18159,4260,13899,10769,24668,2021-10-14
3173031005,JAKARTA BARAT,TAMAN SARI,MANGGA BESAR,7707,1438,6269,5217,11486,2021-10-14
3171021005,JAKARTA PUSAT,SAWAH BESAR,MANGGA DUA SELATAN,27442,6298,21144,16922,38066,2021-10-14
3174011007,JAKARTA SELATAN,TEBET,MANGGARAI,28373,5775,22598,17156,39754,2021-10-14
3174011006,JAKARTA SELATAN,TEBET,MANGGARAI SELATAN,23075,4715,18360,14662,33022,2021-10-14
3173031003,JAKARTA BARAT,TAMAN SARI,MAPHAR,16461,3515,12946,10259,23205,2021-10-14
3172041003,JAKARTA UTARA,CILINCING,MARUNDA,28943,7259,21684,15670,37354,2021-10-14
3174071001,JAKARTA SELATAN,KEBAYORAN BARU,MELAWAI,2627,562,2065,1858,3923,2021-10-14
3171061001,JAKARTA PUSAT,MENTENG,MENTENG,25624,6410,19214,14350,33564,2021-10-14
3174021005,JAKARTA SELATAN,SETIA BUDI,MENTENG ATAS,27816,5779,22037,17194,39231,2021-10-14
3174011003,JAKARTA SELATAN,TEBET,MENTENG DALAM,36028,7935,28093,22189,50282,2021-10-14
3173081003,JAKARTA BARAT,KEMBANGAN,MERUYA SELATAN,32130,7501,24629,19575,44204,2021-10-14
3173081002,JAKARTA BARAT,KEMBANGAN,MERUYA UTARA,43752,10243,33509,27685,61194,2021-10-14
3175101004,JAKARTA TIMUR,CIPAYUNG,MUNJUL,23871,4880,18991,15037,34028,2021-10-14
3172051002,JAKARTA UTARA,PADEMANGAN,PADEMANGAN BARAT,74240,19350,54890,42193,97083,2021-10-14
3172051001,JAKARTA UTARA,PADEMANGAN,PADEMANGAN TIMUR,37736,7427,30309,25175,55484,2021-10-14
3175011004,JAKARTA TIMUR,MATRAMAN,PAL MERIAM,19769,4725,15044,11427,26471,2021-10-14
3173071001,JAKARTA BARAT,PALMERAH,PALMERAH,63011,15359,47652,36674,84326,2021-10-14
3174081001,JAKARTA SELATAN,PANCORAN,PANCORAN,19421,4663,14758,11611,26369,2021-10-14
3172021003,JAKARTA UTARA,TANJUNG PRIOK,PAPANGGO,39097,8786,30311,23792,54103,2021-10-14
3171021001,JAKARTA PUSAT,SAWAH BESAR,PASAR BARU,12035,2544,9491,8133,17624,2021-10-14
3174021006,JAKARTA SELATAN,SETIA BUDI,PASAR MANGGIS,26752,6164,20588,16078,36666,2021-10-14
3174041001,JAKARTA SELATAN,PASAR MINGGU,PASAR MINGGU,24821,5323,19498,15615,35113,2021-10-14
3171041003,JAKARTA PUSAT,SENEN,PASEBAN,23533,5653,17880,13950,31830,2021-10-14
3173061005,JAKARTA BARAT,KALI DERES,PEGADUNGAN,75587,17187,58400,48494,106894,2021-10-14
3171061002,JAKARTA PUSAT,MENTENG,PEGANGSAAN,23455,5767,17688,12769,30457,2021-10-14
3172061002,JAKARTA UTARA,KELAPA GADING,PEGANGSAAN DUA,49976,8996,40980,35970,76950,2021-10-14
3172011004,JAKARTA UTARA,PENJARINGAN,PEJAGALAN,74578,17245,57333,46715,104048,2021-10-14
3174041006,JAKARTA SELATAN,PASAR MINGGU,PEJATEN BARAT,37346,8502,28844,22765,51609,2021-10-14
3174041005,JAKARTA SELATAN,PASAR MINGGU,PEJATEN TIMUR,57656,14794,42862,33315,76177,2021-10-14
3175051005,JAKARTA TIMUR,PASAR REBO,PEKAYON,43250,8955,34295,26959,61254,2021-10-14
3173041009,JAKARTA BARAT,TAMBORA,PEKOJAN,23587,5089,18498,14736,33234,2021-10-14
3174031003,JAKARTA SELATAN,MAMPANG PRAPATAN,PELA MAMPANG,43522,9875,33647,26522,60169,2021-10-14
3174081005,JAKARTA SELATAN,PANCORAN,PENGADEGAN,21478,4417,17061,13426,30487,2021-10-14
3175061003,JAKARTA TIMUR,CAKUNG,PENGGILINGAN,99255,26103,73152,55279,128431,2021-10-14
3172011001,JAKARTA UTARA,PENJARINGAN,PENJARINGAN,88308,25092,63216,46325,109541,2021-10-14
3174101001,JAKARTA SELATAN,PESANGGRAHAN,PESANGGRAHAN,27545,5383,22162,18016,40178,2021-10-14
3171071004,JAKARTA PUSAT,TANAH ABANG,PETAMBURAN,33271,9742,23529,16695,40224,2021-10-14
3174071008,JAKARTA SELATAN,KEBAYORAN BARU,PETOGOGAN,11499,2565,8934,7187,16121,2021-10-14
3171011004,JAKARTA PUSAT,GAMBIR,PETOJO SELATAN,14692,3650,11042,8899,19941,2021-10-14
3171011003,JAKARTA PUSAT,GAMBIR,PETOJO UTARA,17458,4156,13302,10337,23639,2021-10-14
3174101004,JAKARTA SELATAN,PESANGGRAHAN,PETUKANGAN SELATAN,37187,8647,28540,22805,51345,2021-10-14
3174101003,JAKARTA SELATAN,PESANGGRAHAN,PETUKANGAN UTARA,53716,13145,40571,31950,72521,2021-10-14
3175081002,JAKARTA TIMUR,MAKASAR,PINANG RANTI,27198,6642,20556,16249,36805,2021-10-14
3173031008,JAKARTA BARAT,TAMAN SARI,PINANGSIA,10729,2102,8627,6829,15456,2021-10-14
3175011001,JAKARTA TIMUR,MATRAMAN,PISANGAN BARU,31776,7499,24277,18031,42308,2021-10-14
3175021002,JAKARTA TIMUR,PULO GADUNG,PISANGAN TIMUR,41011,8750,32261,25824,58085,2021-10-14
3172011005,JAKARTA UTARA,PENJARINGAN,PLUIT,47783,10205,37578,31671,69249,2021-10-14
3175071002,JAKARTA TIMUR,DUREN SAWIT,PONDOK BAMBU,61550,14798,46752,36438,83190,2021-10-14
3175071004,JAKARTA TIMUR,DUREN SAWIT,PONDOK KELAPA,72015,15971,56044,45640,101684,2021-10-14
3175071007,JAKARTA TIMUR,DUREN SAWIT,PONDOK KOPI,35367,7797,27570,20458,48028,2021-10-14
3174061003,JAKARTA SELATAN,CILANDAK,PONDOK LABU,46464,9071,37393,30711,68104,2021-10-14
3174051002,JAKARTA SELATAN,KEBAYORAN LAMA,PONDOK PINANG,56169,11922,44247,35050,79297,2021-10-14
3175101003,JAKARTA TIMUR,CIPAYUNG,PONDOK RANGGON,25574,5378,20196,15748,35944,2021-10-14
3101011003,KAB.ADM.KEP.SERIBU,KEP. SERIBU UTARA,PULAU HARAPAN,2060,244,1816,1539,3355,2021-10-14
3101011002,KAB.ADM.KEP.SERIBU,KEP. SERIBU UTARA,PULAU KELAPA,5528,650,4878,3904,8782,2021-10-14
3101011001,KAB.ADM.KEP.SERIBU,KEP. SERIBU UTARA,PULAU PANGGANG,5450,506,4944,4296,9240,2021-10-14
3101021003,KAB.ADM.KEP.SERIBU,KEP. SERIBU SELATAN,PULAU PARI,2765,212,2553,2325,4878,2021-10-14
3101021002,KAB.ADM.KEP.SERIBU,KEP. SERIBU SELATAN,PULAU TIDUNG,4553,420,4133,3694,7827,2021-10-14
3101021001,KAB.ADM.KEP.SERIBU,KEP. SERIBU SELATAN,PULAU UNTUNG JAWA,1941,191,1750,1597,3347,2021-10-14
3174071007,JAKARTA SELATAN,KEBAYORAN BARU,PULO,5835,1117,4718,4084,8802,2021-10-14
3175021001,JAKARTA TIMUR,PULO GADUNG,PULO GADUNG,34422,8309,26113,20607,46720,2021-10-14
3175061005,JAKARTA TIMUR,CAKUNG,PULO GEBANG,97301,21147,76154,58450,134604,2021-10-14
3174041004,JAKARTA SELATAN,PASAR MINGGU,RAGUNAN,39616,8471,31145,25063,56208,2021-10-14
3175091005,JAKARTA TIMUR,CIRACAS,RAMBUTAN,36771,9629,27142,20377,47519,2021-10-14
3172031006,JAKARTA UTARA,KOJA,RAWA BADAK SELATAN,42179,11132,31047,23273,54320,2021-10-14
3172031004,JAKARTA UTARA,KOJA,RAWA BADAK UTARA,34408,8639,25769,19497,45266,2021-10-14
3174071005,JAKARTA SELATAN,KEBAYORAN BARU,RAWA BARAT,5625,1090,4535,3834,8369,2021-10-14
3173011003,JAKARTA BARAT,CENGKARENG,RAWA BUAYA,63799,14655,49144,37182,86326,2021-10-14
3175031004,JAKARTA TIMUR,JATINEGARA,RAWA BUNGA,21434,5764,15670,11919,27589,2021-10-14
3174081003,JAKARTA SELATAN,PANCORAN,RAWA JATI,20509,4413,16096,12656,28752,2021-10-14
3175061002,JAKARTA TIMUR,CAKUNG,RAWA TERATE,24637,5119,19518,15319,34837,2021-10-14
3175021005,JAKARTA TIMUR,PULO GADUNG,RAWAMANGUN,37612,8450,29162,23380,52542,2021-10-14
3171051003,JAKARTA PUSAT,CEMPAKA PUTIH,RAWASARI,21967,5051,16916,13596,30512,2021-10-14
3173041010,JAKARTA BARAT,TAMBORA,ROA MALAKA,3484,658,2826,2414,5240,2021-10-14
3172041006,JAKARTA UTARA,CILINCING,ROROTAN,41668,9405,32263,24703,56966,2021-10-14
3174071004,JAKARTA SELATAN,KEBAYORAN BARU,SELONG,2842,584,2258,1994,4252,2021-10-14
3173061002,JAKARTA BARAT,KALI DERES,SEMANAN,71354,18021,53333,41501,94834,2021-10-14
3172041007,JAKARTA UTARA,CILINCING,SEMPER BARAT,68587,15067,53520,42549,96069,2021-10-14
3172041005,JAKARTA UTARA,CILINCING,SEMPER TIMUR,36267,8621,27646,21338,48984,2021-10-14
3174071006,JAKARTA SELATAN,KEBAYORAN BARU,SENAYAN,2771,714,2057,1686,3743,2021-10-14
3171041001,JAKARTA PUSAT,SENEN,SENEN,6804,1624,5180,4193,9373,2021-10-14
3171031004,JAKARTA PUSAT,KEMAYORAN,SERDANG,29668,6686,22982,18066,41048,2021-10-14
3174021001,JAKARTA SELATAN,SETIA BUDI,SETIA BUDI,3023,701,2322,1869,4191,2021-10-14
3175101005,JAKARTA TIMUR,CIPAYUNG,SETU,20572,4728,15844,12104,27948,2021-10-14
3173071002,JAKARTA BARAT,PALMERAH,SLIPI,16591,3435,13156,10491,23647,2021-10-14
3173081004,JAKARTA BARAT,KEMBANGAN,SRENGSENG,45523,11432,34091,27502,61593,2021-10-14
3174091002,JAKARTA SELATAN,JAGAKARSA,SRENGSENG SAWAH,58196,10723,47473,38353,85826,2021-10-14
3173051003,JAKARTA BARAT,KEBON JERUK,SUKABUMI SELATAN,37033,9467,27566,20340,47906,2021-10-14
3173051002,JAKARTA BARAT,KEBON JERUK,SUKABUMI UTARA,38290,10109,28181,20889,49070,2021-10-14
3172041002,JAKARTA UTARA,CILINCING,SUKAPURA,53949,13615,40334,31779,72113,2021-10-14
3171031007,JAKARTA PUSAT,KEMAYORAN,SUMUR BATU,22717,5193,17524,14093,31617,2021-10-14
3172021004,JAKARTA UTARA,TANJUNG PRIOK,SUNGAI BAMBU,29876,6788,23088,18183,41271,2021-10-14
3172021006,JAKARTA UTARA,TANJUNG PRIOK,SUNTER AGUNG,71805,13841,57964,48559,106523,2021-10-14
3172021002,JAKARTA UTARA,TANJUNG PRIOK,SUNTER JAYA,63031,12660,50371,41658,92029,2021-10-14
3175091004,JAKARTA TIMUR,CIRACAS,SUSUKAN,38257,8078,30179,23855,54034,2021-10-14
3173031001,JAKARTA BARAT,TAMAN SARI,TAMAN SARI,14348,2984,11364,9365,20729,2021-10-14
3173041001,JAKARTA BARAT,TAMBORA,TAMBORA,10204,2548,7656,5921,13577,2021-10-14
3173041004,JAKARTA BARAT,TAMBORA,TANAH SEREAL,26387,4977,21410,17091,38501,2021-10-14
3171081004,JAKARTA PUSAT,JOHAR BARU,TANAH TINGGI,37693,7849,29844,23143,52987,2021-10-14
3173031004,JAKARTA BARAT,TAMAN SARI,TANGKI,13324,2535,10789,8544,19333,2021-10-14
3174091005,JAKARTA SELATAN,JAGAKARSA,TANJUNG BARAT,39770,7583,32187,24560,56747,2021-10-14
3173021005,JAKARTA BARAT,GROGOL PETAMBURAN,TANJUNG DUREN SELATAN,25337,5457,19880,16603,36483,2021-10-14
3173021002,JAKARTA BARAT,GROGOL PETAMBURAN,TANJUNG DUREN UTARA,17010,3242,13768,11650,25418,2021-10-14
3172021001,JAKARTA UTARA,TANJUNG PRIOK,TANJUNG PRIOK,34588,7959,26629,20908,47537,2021-10-14
3174011002,JAKARTA SELATAN,TEBET,TEBET BARAT,21194,3946,17248,14428,31676,2021-10-14
3174011001,JAKARTA SELATAN,TEBET,TEBET TIMUR,18199,3280,14919,12729,27648,2021-10-14
3173061003,JAKARTA BARAT,KALI DERES,TEGAL ALUR,83647,20012,63635,50120,113755,2021-10-14
3174031004,JAKARTA SELATAN,MAMPANG PRAPATAN,TEGAL PARANG,32401,8129,24272,17516,41788,2021-10-14
3173021003,JAKARTA BARAT,GROGOL PETAMBURAN,TOMANG,29605,6117,23488,19062,42550,2021-10-14
3172031005,JAKARTA UTARA,KOJA,TUGU SELATAN,39122,9707,29415,22541,51956,2021-10-14
3172031002,JAKARTA UTARA,KOJA,TUGU UTARA,67670,17717,49953,37453,87406,2021-10-14
3175061006,JAKARTA TIMUR,CAKUNG,UJUNG MENTENG,29934,5831,24103,19471,43574,2021-10-14
3174101005,JAKARTA SELATAN,PESANGGRAHAN,ULUJAMI,40544,10386,30158,23317,53475,2021-10-14
3175011006,JAKARTA TIMUR,MATRAMAN,UTAN KAYU SELATAN,33511,6970,26541,20600,47141,2021-10-14
3175011002,JAKARTA TIMUR,MATRAMAN,UTAN KAYU UTARA,28169,6649,21520,16653,38173,2021-10-14
3171031008,JAKARTA PUSAT,KEMAYORAN,UTAN PANJANG,29208,6675,22533,16863,39396,2021-10-14
3172021007,JAKARTA UTARA,TANJUNG PRIOK,WARAKAS,44401,9247,35154,26867,62021,2021-10-14
3173021007,JAKARTA BARAT,GROGOL PETAMBURAN,WIJAYA KUSUMA,38934,9385,29549,23590,53139,2021-10-14
3172051003,JAKARTA UTARA,PADEMANGAN,ANCOL,23947,6307,17640,13898,31538,2021-10-15
3173041007,JAKARTA BARAT,TAMBORA,ANGKE,29381,7051,22330,17339,39669,2021-10-15
3175041005,JAKARTA TIMUR,KRAMAT JATI,BALE KAMBANG,29074,8042,21032,15400,36432,2021-10-15
3175031003,JAKARTA TIMUR,JATINEGARA,BALI MESTER,9752,2284,7468,5952,13420,2021-10-15
3175101006,JAKARTA TIMUR,CIPAYUNG,BAMBU APUS,26285,5460,20825,16065,36890,2021-10-15
3174031002,JAKARTA SELATAN,MAMPANG PRAPATAN,BANGKA,21566,5268,16298,12781,29079,2021-10-15
3175051002,JAKARTA TIMUR,PASAR REBO,BARU,23886,4460,19426,16092,35518,2021-10-15
3175041004,JAKARTA TIMUR,KRAMAT JATI,BATU AMPAR,47898,12973,34925,26231,61156,2021-10-15
3171071002,JAKARTA PUSAT,TANAH ABANG,BENDUNGAN HILIR,21494,4803,16691,13475,30166,2021-10-15
3175031002,JAKARTA TIMUR,JATINEGARA,BIDARA CINA,36689,9781,26908,20201,47109,2021-10-15
3174101002,JAKARTA SELATAN,PESANGGRAHAN,BINTARO,53098,11951,41147,33444,74591,2021-10-15
3174011005,JAKARTA SELATAN,TEBET,BUKIT DURI,34183,7973,26210,20586,46796,2021-10-15
3171041006,JAKARTA PUSAT,SENEN,BUNGUR,18144,4302,13842,11061,24903,2021-10-15
3175061007,JAKARTA TIMUR,CAKUNG,CAKUNG BARAT,57724,13291,44433,35343,79776,2021-10-15
3175061004,JAKARTA TIMUR,CAKUNG,CAKUNG TIMUR,58287,12863,45424,35995,81419,2021-10-15
3175041007,JAKARTA TIMUR,KRAMAT JATI,CAWANG,32762,8073,24689,18606,43295,2021-10-15
3175101008,JAKARTA TIMUR,CIPAYUNG,CEGER,18932,4134,14798,11727,26525,2021-10-15
3171031006,JAKARTA PUSAT,KEMAYORAN,CEMPAKA BARU,32581,7653,24928,18756,43684,2021-10-15
3171051002,JAKARTA PUSAT,CEMPAKA PUTIH,CEMPAKA PUTIH BARAT,35885,8532,27353,22043,49396,2021-10-15
3171051001,JAKARTA PUSAT,CEMPAKA PUTIH,CEMPAKA PUTIH TIMUR,24292,5515,18777,15552,34329,2021-10-15
3173011001,JAKARTA BARAT,CENGKARENG,CENGKARENG BARAT,66284,15212,51072,41180,92252,2021-10-15
3173011006,JAKARTA BARAT,CENGKARENG,CENGKARENG TIMUR,81027,17990,63037,49190,112227,2021-10-15
3175091002,JAKARTA TIMUR,CIRACAS,CIBUBUR,66364,12740,53624,42646,96270,2021-10-15
3171011002,JAKARTA PUSAT,GAMBIR,CIDENG,15390,3262,12128,10128,22256,2021-10-15
3174091003,JAKARTA SELATAN,JAGAKARSA,CIGANJUR,38497,7696,30801,23596,54397,2021-10-15
3175051003,JAKARTA TIMUR,PASAR REBO,CIJANTUNG,41419,8617,32802,26033,58835,2021-10-15
3171061003,JAKARTA PUSAT,MENTENG,CIKINI,8274,1627,6647,4983,11630,2021-10-15
3174081006,JAKARTA SELATAN,PANCORAN,CIKOKO,10547,2076,8471,6984,15455,2021-10-15
3174061001,JAKARTA SELATAN,CILANDAK,CILANDAK BARAT,51752,10517,41235,33837,75072,2021-10-15
3174041003,JAKARTA SELATAN,PASAR MINGGU,CILANDAK TIMUR,25145,5296,19849,16079,35928,2021-10-15
3175101002,JAKARTA TIMUR,CIPAYUNG,CILANGKAP,27635,5413,22222,17626,39848,2021-10-15
3175041006,JAKARTA TIMUR,KRAMAT JATI,CILILITAN,40181,10043,30138,23046,53184,2021-10-15
3172041001,JAKARTA UTARA,CILINCING,CILINCING,43609,11561,32048,23701,55749,2021-10-15
3175101001,JAKARTA TIMUR,CIPAYUNG,CIPAYUNG,26104,5047,21057,17267,38324,2021-10-15
3174091006,JAKARTA SELATAN,JAGAKARSA,CIPEDAK,38303,7475,30828,24335,55163,2021-10-15
3174061005,JAKARTA SELATAN,CILANDAK,CIPETE SELATAN,26704,5756,20948,17307,38255,2021-10-15
3174071010,JAKARTA SELATAN,KEBAYORAN BARU,CIPETE UTARA,34102,7239,26863,20792,47655,2021-10-15
3175021003,JAKARTA TIMUR,PULO GADUNG,CIPINANG,39306,8410,30896,24216,55112,2021-10-15
3175031007,JAKARTA TIMUR,JATINEGARA,CIPINANG BESAR SELATAN,35212,9309,25903,19003,44906,2021-10-15
3175031008,JAKARTA TIMUR,JATINEGARA,CIPINANG BESAR UTARA,45319,11944,33375,24370,57745,2021-10-15
3175031005,JAKARTA TIMUR,JATINEGARA,CIPINANG CEMPEDAK,32824,7867,24957,19637,44594,2021-10-15
3175081005,JAKARTA TIMUR,MAKASAR,CIPINANG MELAYU,42308,9130,33178,26424,59602,2021-10-15
3175031006,JAKARTA TIMUR,JATINEGARA,CIPINANG MUARA,55243,13422,41821,32183,74004,2021-10-15
3174051003,JAKARTA SELATAN,KEBAYORAN LAMA,CIPULIR,39937,9400,30537,23182,53719,2021-10-15
3175091001,JAKARTA TIMUR,CIRACAS,CIRACAS,64594,13210,51384,40092,91476,2021-10-15
3175041003,JAKARTA TIMUR,KRAMAT JATI,DUKUH,24609,5195,19414,15060,34474,2021-10-15
3175071001,JAKARTA TIMUR,DUREN SAWIT,DUREN SAWIT,61160,14419,46741,36217,82958,2021-10-15
3174081004,JAKARTA SELATAN,PANCORAN,DUREN TIGA,28319,6276,22043,17077,39120,2021-10-15
3173051005,JAKARTA BARAT,KEBON JERUK,DURI KEPA,60138,13012,47126,39237,86363,2021-10-15
3173011002,JAKARTA BARAT,CENGKARENG,DURI KOSAMBI,77923,19325,58598,44557,103155,2021-10-15
3171011006,JAKARTA PUSAT,GAMBIR,DURI PULO,19610,4593,15017,11543,26560,2021-10-15
3173041011,JAKARTA BARAT,TAMBORA,DURI SELATAN,14259,2787,11472,9264,20736,2021-10-15
3173041003,JAKARTA BARAT,TAMBORA,DURI UTARA,19844,4156,15688,12327,28015,2021-10-15
3171081003,JAKARTA PUSAT,JOHAR BARU,GALUR,18243,3971,14272,11123,25395,2021-10-15
3171011001,JAKARTA PUSAT,GAMBIR,GAMBIR,2191,501,1690,1396,3086,2021-10-15
3174061004,JAKARTA SELATAN,CILANDAK,GANDARIA SELATAN,22119,4865,17254,13815,31069,2021-10-15
3174071009,JAKARTA SELATAN,KEBAYORAN BARU,GANDARIA UTARA,39922,8992,30930,24456,55386,2021-10-15
3175051001,JAKARTA TIMUR,PASAR REBO,GEDONG,35755,7939,27816,22272,50088,2021-10-15
3171071001,JAKARTA PUSAT,TANAH ABANG,GELORA,3127,676,2451,1999,4450,2021-10-15
3173031007,JAKARTA BARAT,TAMAN SARI,GLODOK,7837,1414,6423,5594,12017,2021-10-15
3171061004,JAKARTA PUSAT,MENTENG,GONDANGDIA,4100,982,3118,2771,5889,2021-10-15
3173021001,JAKARTA BARAT,GROGOL PETAMBURAN,GROGOL,16876,3763,13113,10534,23647,2021-10-15
3174051005,JAKARTA SELATAN,KEBAYORAN LAMA,GROGOL SELATAN,44251,10212,34039,26476,60515,2021-10-15
3174051004,JAKARTA SELATAN,KEBAYORAN LAMA,GROGOL UTARA,42494,9942,32552,25816,58368,2021-10-15
3174021007,JAKARTA SELATAN,SETIA BUDI,GUNTUR,3985,834,3151,2665,5816,2021-10-15
3174071002,JAKARTA SELATAN,KEBAYORAN BARU,GUNUNG,9436,1929,7507,6253,13760,2021-10-15
3171031005,JAKARTA PUSAT,KEMAYORAN,GUNUNG SAHARI SELATAN,19199,4374,14825,11879,26704,2021-10-15
3171021004,JAKARTA PUSAT,SAWAH BESAR,GUNUNG SAHARI UTARA,16650,3239,13411,11426,24837,2021-10-15
3175081004,JAKARTA TIMUR,MAKASAR,HALIM PERDANA KUSUMAH,28363,4160,24203,21490,45693,2021-10-15
3171031003,JAKARTA PUSAT,KEMAYORAN,HARAPAN MULIA,22557,5188,17369,13379,30748,2021-10-15
3174091001,JAKARTA SELATAN,JAGAKARSA,JAGAKARSA,62389,12447,49942,39397,89339,2021-10-15
3175021007,JAKARTA TIMUR,PULO GADUNG,JATI,32757,6970,25787,21241,47028,2021-10-15
3174041002,JAKARTA SELATAN,PASAR MINGGU,JATI PADANG,37502,8578,28924,23076,52000,2021-10-15
3173071004,JAKARTA BARAT,PALMERAH,JATI PULO,28738,6416,22322,17054,39376,2021-10-15
3175061001,JAKARTA TIMUR,CAKUNG,JATINEGARA,84160,20295,63865,50288,114153,2021-10-15
3175021004,JAKARTA TIMUR,PULO GADUNG,JATINEGARA KAUM,24632,5072,19560,14983,34543,2021-10-15
3173021004,JAKARTA BARAT,GROGOL PETAMBURAN,JELAMBAR,30266,6195,24071,19780,43851,2021-10-15
3173021006,JAKARTA BARAT,GROGOL PETAMBURAN,JELAMBAR BARU,38246,8025,30221,24803,55024,2021-10-15
3173041006,JAKARTA BARAT,TAMBORA,JEMBATAN BESI,29314,7922,21392,15862,37254,2021-10-15
3173041008,JAKARTA BARAT,TAMBORA,JEMBATAN LIMA,21021,5519,15502,11652,27154,2021-10-15
3173081005,JAKARTA BARAT,KEMBANGAN,JOGLO,40839,9327,31512,25530,57042,2021-10-15
3171081001,JAKARTA PUSAT,JOHAR BARU,JOHAR BARU,37488,7619,29869,24124,53993,2021-10-15
3173041002,JAKARTA BARAT,TAMBORA,KALI ANYAR,23856,5445,18411,13858,32269,2021-10-15
3172041004,JAKARTA UTARA,CILINCING,KALIBARU,67684,20564,47120,32365,79485,2021-10-15
3174081002,JAKARTA SELATAN,PANCORAN,KALIBATA,41994,10768,31226,23426,54652,2021-10-15
3173061001,JAKARTA BARAT,KALI DERES,KALIDERES,72447,16915,55532,45053,100585,2021-10-15
3175051004,JAKARTA TIMUR,PASAR REBO,KALISARI,43212,8715,34497,27485,61982,2021-10-15
3173061004,JAKARTA BARAT,KALI DERES,KAMAL,53783,14337,39446,30007,69453,2021-10-15
3172011002,JAKARTA UTARA,PENJARINGAN,KAMAL MUARA,12930,2418,10512,8773,19285,2021-10-15
3171071007,JAKARTA PUSAT,TANAH ABANG,KAMPUNG BALI,11358,2718,8640,6185,14825,2021-10-15
3175031001,JAKARTA TIMUR,JATINEGARA,KAMPUNG MELAYU,25717,6800,18917,13920,32837,2021-10-15
3171081002,JAKARTA PUSAT,JOHAR BARU,KAMPUNG RAWA,21237,3828,17409,13341,30750,2021-10-15
3175041002,JAKARTA TIMUR,KRAMAT JATI,KAMPUNG TENGAH,43993,12038,31955,23938,55893,2021-10-15
3173011005,JAKARTA BARAT,CENGKARENG,KAPUK,134466,35875,98591,75481,174072,2021-10-15
3172011003,JAKARTA UTARA,PENJARINGAN,KAPUK MUARA,35781,7559,28222,24042,52264,2021-10-15
3171021002,JAKARTA PUSAT,SAWAH BESAR,KARANG ANYAR,25761,5512,20249,16165,36414,2021-10-15
3174021004,JAKARTA SELATAN,SETIA BUDI,KARET,9623,2093,7530,5946,13476,2021-10-15
3174021003,JAKARTA SELATAN,SETIA BUDI,KARET KUNINGAN,16055,3507,12548,10188,22736,2021-10-15
3174021002,JAKARTA SELATAN,SETIA BUDI,KARET SEMANGGI,2770,595,2175,1863,4038,2021-10-15
3171071003,JAKARTA PUSAT,TANAH ABANG,KARET TENGSIN,19271,4124,15147,11687,26834,2021-10-15
3171021003,JAKARTA PUSAT,SAWAH BESAR,KARTINI,22292,4814,17478,14158,31636,2021-10-15
3175011003,JAKARTA TIMUR,MATRAMAN,KAYU MANIS,25284,6045,19239,14286,33525,2021-10-15
3175021006,JAKARTA TIMUR,PULO GADUNG,KAYU PUTIH,40696,8542,32154,26927,59081,2021-10-15
3173031006,JAKARTA BARAT,TAMAN SARI,KEAGUNGAN,17387,3773,13614,10616,24230,2021-10-15
3174041007,JAKARTA SELATAN,PASAR MINGGU,KEBAGUSAN,44552,10168,34384,26268,60652,2021-10-15
3174051006,JAKARTA SELATAN,KEBAYORAN LAMA,KEBAYORAN LAMA SELATAN,41212,8631,32581,25927,58508,2021-10-15
3174051001,JAKARTA SELATAN,KEBAYORAN LAMA,KEBAYORAN LAMA UTARA,42422,10155,32267,25280,57547,2021-10-15
3174011004,JAKARTA SELATAN,TEBET,KEBON BARU,35165,7453,27712,21606,49318,2021-10-15
3172021005,JAKARTA UTARA,TANJUNG PRIOK,KEBON BAWANG,50952,11631,39321,31113,70434,2021-10-15
3173051001,JAKARTA BARAT,KEBON JERUK,KEBON JERUK,53887,13031,40856,31878,72734,2021-10-15
3171071006,JAKARTA PUSAT,TANAH ABANG,KEBON KACANG,21531,5762,15769,11850,27619,2021-10-15
3171011005,JAKARTA PUSAT,GAMBIR,KEBON KELAPA,10163,2250,7913,6298,14211,2021-10-15
3171031002,JAKARTA PUSAT,KEMAYORAN,KEBON KOSONG,30019,6784,23235,17617,40852,2021-10-15
3175011005,JAKARTA TIMUR,MATRAMAN,KEBON MANGGIS,16490,3627,12863,10143,23006,2021-10-15
3171071005,JAKARTA PUSAT,TANAH ABANG,KEBON MELATI,32206,9336,22870,15945,38815,2021-10-15
3175081003,JAKARTA TIMUR,MAKASAR,KEBON PALA,46614,10500,36114,28509,64623,2021-10-15
3171061005,JAKARTA PUSAT,MENTENG,KEBON SIRIH,12299,2916,9383,7116,16499,2021-10-15
3173011004,JAKARTA BARAT,CENGKARENG,KEDAUNG KALI ANGKE,32612,7031,25581,20481,46062,2021-10-15
3173051007,JAKARTA BARAT,KEBON JERUK,KEDOYA SELATAN,32165,6589,25576,20189,45765,2021-10-15
3173051006,JAKARTA BARAT,KEBON JERUK,KEDOYA UTARA,45740,9620,36120,29578,65698,2021-10-15
3173051004,JAKARTA BARAT,KEBON JERUK,KELAPA DUA,23565,5438,18127,14390,32517,2021-10-15
3175091003,JAKARTA TIMUR,CIRACAS,KELAPA DUA WETAN,46875,9061,37814,30228,68042,2021-10-15
3172061003,JAKARTA UTARA,KELAPA GADING,KELAPA GADING BARAT,35717,6754,28963,25359,54322,2021-10-15
3172061001,JAKARTA UTARA,KELAPA GADING,KELAPA GADING TIMUR,33592,5593,27999,25076,53075,2021-10-15
3173071005,JAKARTA BARAT,PALMERAH,KEMANGGISAN,32139,6854,25285,20010,45295,2021-10-15
3171031001,JAKARTA PUSAT,KEMAYORAN,KEMAYORAN,20708,4764,15944,12593,28537,2021-10-15
3173081006,JAKARTA BARAT,KEMBANGAN,KEMBANGAN SELATAN,27130,6369,20761,17430,38191,2021-10-15
3173081001,JAKARTA BARAT,KEMBANGAN,KEMBANGAN UTARA,54451,13286,41165,33016,74181,2021-10-15
3171041002,JAKARTA PUSAT,SENEN,KENARI,9579,2084,7495,6110,13605,2021-10-15
3173041005,JAKARTA BARAT,TAMBORA,KERENDANG,19973,4700,15273,11787,27060,2021-10-15
3175071003,JAKARTA TIMUR,DUREN SAWIT,KLENDER,69978,18243,51735,39093,90828,2021-10-15
3172031001,JAKARTA UTARA,KOJA,KOJA,28175,7115,21060,16178,37238,2021-10-15
3173071006,JAKARTA BARAT,PALMERAH,KOTA BAMBU SELATAN,21158,5060,16098,12099,28197,2021-10-15
3173071003,JAKARTA BARAT,PALMERAH,KOTA BAMBU UTARA,24995,6108,18887,14087,32974,2021-10-15
3171041004,JAKARTA PUSAT,SENEN,KRAMAT,28835,7638,21197,15442,36639,2021-10-15
3175041001,JAKARTA TIMUR,KRAMAT JATI,KRAMAT JATI,34144,8208,25936,19900,45836,2021-10-15
3174071003,JAKARTA SELATAN,KEBAYORAN BARU,KRAMAT PELA,14413,3085,11328,9171,20499,2021-10-15
3173031002,JAKARTA BARAT,TAMAN SARI,KRUKUT,19244,4172,15072,11562,26634,2021-10-15
3174031005,JAKARTA SELATAN,MAMPANG PRAPATAN,KUNINGAN BARAT,12785,2676,10109,8001,18110,2021-10-15
3174021008,JAKARTA SELATAN,SETIA BUDI,KUNINGAN TIMUR,6008,1381,4627,3786,8413,2021-10-15
3171041005,JAKARTA PUSAT,SENEN,KWITANG,15486,3911,11575,8991,20566,2021-10-15
3172031003,JAKARTA UTARA,KOJA,LAGOA,59065,15581,43484,32864,76348,2021-10-15
3174061002,JAKARTA SELATAN,CILANDAK,LEBAK BULUS,37626,7972,29654,24060,53714,2021-10-15
3174091004,JAKARTA SELATAN,JAGAKARSA,LENTENG AGUNG,53946,11235,42711,32055,74766,2021-10-15
3175101007,JAKARTA TIMUR,CIPAYUNG,LUBANG BUAYA,63547,13416,50131,39740,89871,2021-10-15
3175081001,JAKARTA TIMUR,MAKASAR,MAKASAR,34390,7146,27244,21820,49064,2021-10-15
3175071006,JAKARTA TIMUR,DUREN SAWIT,MALAKA JAYA,30927,6243,24684,19953,44637,2021-10-15
3175071005,JAKARTA TIMUR,DUREN SAWIT,MALAKA SARI,27530,5261,22269,18262,40531,2021-10-15
3174031001,JAKARTA SELATAN,MAMPANG PRAPATAN,MAMPANG PRAPATAN,18159,4215,13944,10829,24773,2021-10-15
3173031005,JAKARTA BARAT,TAMAN SARI,MANGGA BESAR,7707,1423,6284,5242,11526,2021-10-15
3171021005,JAKARTA PUSAT,SAWAH BESAR,MANGGA DUA SELATAN,27442,6272,21170,17006,38176,2021-10-15
3174011007,JAKARTA SELATAN,TEBET,MANGGARAI,28373,5749,22624,17209,39833,2021-10-15
3174011006,JAKARTA SELATAN,TEBET,MANGGARAI SELATAN,23075,4674,18401,14731,33132,2021-10-15
3173031003,JAKARTA BARAT,TAMAN SARI,MAPHAR,16461,3476,12985,10304,23289,2021-10-15
3172041003,JAKARTA UTARA,CILINCING,MARUNDA,28943,7234,21709,15741,37450,2021-10-15
3174071001,JAKARTA SELATAN,KEBAYORAN BARU,MELAWAI,2627,560,2067,1867,3934,2021-10-15
3171061001,JAKARTA PUSAT,MENTENG,MENTENG,25624,6373,19251,14411,33662,2021-10-15
3174021005,JAKARTA SELATAN,SETIA BUDI,MENTENG ATAS,27816,5743,22073,17278,39351,2021-10-15
3174011003,JAKARTA SELATAN,TEBET,MENTENG DALAM,36028,7884,28144,22280,50424,2021-10-15
3173081003,JAKARTA BARAT,KEMBANGAN,MERUYA SELATAN,32130,7448,24682,19744,44426,2021-10-15
3173081002,JAKARTA BARAT,KEMBANGAN,MERUYA UTARA,43752,10116,33636,27968,61604,2021-10-15
3175101004,JAKARTA TIMUR,CIPAYUNG,MUNJUL,23871,4858,19013,15104,34117,2021-10-15
3172051002,JAKARTA UTARA,PADEMANGAN,PADEMANGAN BARAT,74240,19266,54974,42324,97298,2021-10-15
3172051001,JAKARTA UTARA,PADEMANGAN,PADEMANGAN TIMUR,37736,7386,30350,25277,55627,2021-10-15
3175011004,JAKARTA TIMUR,MATRAMAN,PAL MERIAM,19769,4692,15077,11482,26559,2021-10-15
3173071001,JAKARTA BARAT,PALMERAH,PALMERAH,63011,15210,47801,37015,84816,2021-10-15
3174081001,JAKARTA SELATAN,PANCORAN,PANCORAN,19421,4557,14864,11779,26643,2021-10-15
3172021003,JAKARTA UTARA,TANJUNG PRIOK,PAPANGGO,39097,8750,30347,23875,54222,2021-10-15
3171021001,JAKARTA PUSAT,SAWAH BESAR,PASAR BARU,12035,2537,9498,8175,17673,2021-10-15
3174021006,JAKARTA SELATAN,SETIA BUDI,PASAR MANGGIS,26752,6089,20663,16202,36865,2021-10-15
3174041001,JAKARTA SELATAN,PASAR MINGGU,PASAR MINGGU,24821,5283,19538,15707,35245,2021-10-15
3171041003,JAKARTA PUSAT,SENEN,PASEBAN,23533,5571,17962,14047,32009,2021-10-15
3173061005,JAKARTA BARAT,KALI DERES,PEGADUNGAN,75587,17098,58489,48658,107147,2021-10-15
3171061002,JAKARTA PUSAT,MENTENG,PEGANGSAAN,23455,5724,17731,12834,30565,2021-10-15
3172061002,JAKARTA UTARA,KELAPA GADING,PEGANGSAAN DUA,49976,8957,41019,36067,77086,2021-10-15
3172011004,JAKARTA UTARA,PENJARINGAN,PEJAGALAN,74578,17118,57460,46976,104436,2021-10-15
3174041006,JAKARTA SELATAN,PASAR MINGGU,PEJATEN BARAT,37346,8434,28912,22931,51843,2021-10-15
3174041005,JAKARTA SELATAN,PASAR MINGGU,PEJATEN TIMUR,57656,14606,43050,33532,76582,2021-10-15
3175051005,JAKARTA TIMUR,PASAR REBO,PEKAYON,43250,8886,34364,27094,61458,2021-10-15
3173041009,JAKARTA BARAT,TAMBORA,PEKOJAN,23587,5034,18553,14798,33351,2021-10-15
3174031003,JAKARTA SELATAN,MAMPANG PRAPATAN,PELA MAMPANG,43522,9821,33701,26633,60334,2021-10-15
3174081005,JAKARTA SELATAN,PANCORAN,PENGADEGAN,21478,4390,17088,13555,30643,2021-10-15
3175061003,JAKARTA TIMUR,CAKUNG,PENGGILINGAN,99255,25962,73293,55647,128940,2021-10-15
3172011001,JAKARTA UTARA,PENJARINGAN,PENJARINGAN,88308,24981,63327,46501,109828,2021-10-15
3174101001,JAKARTA SELATAN,PESANGGRAHAN,PESANGGRAHAN,27545,5332,22213,18083,40296,2021-10-15
3171071004,JAKARTA PUSAT,TANAH ABANG,PETAMBURAN,33271,9683,23588,16871,40459,2021-10-15
3174071008,JAKARTA SELATAN,KEBAYORAN BARU,PETOGOGAN,11499,2551,8948,7227,16175,2021-10-15
3171011004,JAKARTA PUSAT,GAMBIR,PETOJO SELATAN,14692,3621,11071,8971,20042,2021-10-15
3171011003,JAKARTA PUSAT,GAMBIR,PETOJO UTARA,17458,4125,13333,10409,23742,2021-10-15
3174101004,JAKARTA SELATAN,PESANGGRAHAN,PETUKANGAN SELATAN,37187,8588,28599,22876,51475,2021-10-15
3174101003,JAKARTA SELATAN,PESANGGRAHAN,PETUKANGAN UTARA,53716,12999,40717,32155,72872,2021-10-15
3175081002,JAKARTA TIMUR,MAKASAR,PINANG RANTI,27198,6606,20592,16334,36926,2021-10-15
3173031008,JAKARTA BARAT,TAMAN SARI,PINANGSIA,10729,2084,8645,6848,15493,2021-10-15
3175011001,JAKARTA TIMUR,MATRAMAN,PISANGAN BARU,31776,7449,24327,18146,42473,2021-10-15
3175021002,JAKARTA TIMUR,PULO GADUNG,PISANGAN TIMUR,41011,8684,32327,25938,58265,2021-10-15
3172011005,JAKARTA UTARA,PENJARINGAN,PLUIT,47783,10099,37684,31814,69498,2021-10-15
3175071002,JAKARTA TIMUR,DUREN SAWIT,PONDOK BAMBU,61550,14621,46929,36654,83583,2021-10-15
3175071004,JAKARTA TIMUR,DUREN SAWIT,PONDOK KELAPA,72015,15900,56115,45910,102025,2021-10-15
3175071007,JAKARTA TIMUR,DUREN SAWIT,PONDOK KOPI,35367,7737,27630,20603,48233,2021-10-15
3174061003,JAKARTA SELATAN,CILANDAK,PONDOK LABU,46464,8979,37485,30996,68481,2021-10-15
3174051002,JAKARTA SELATAN,KEBAYORAN LAMA,PONDOK PINANG,56169,11783,44386,35476,79862,2021-10-15
3175101003,JAKARTA TIMUR,CIPAYUNG,PONDOK RANGGON,25574,5306,20268,15789,36057,2021-10-15
3101011003,KAB.ADM.KEP.SERIBU,KEP. SERIBU UTARA,PULAU HARAPAN,2060,240,1820,1551,3371,2021-10-15
3101011002,KAB.ADM.KEP.SERIBU,KEP. SERIBU UTARA,PULAU KELAPA,5528,648,4880,3916,8796,2021-10-15
3101011001,KAB.ADM.KEP.SERIBU,KEP. SERIBU UTARA,PULAU PANGGANG,5450,496,4954,4318,9272,2021-10-15
3101021003,KAB.ADM.KEP.SERIBU,KEP. SERIBU SELATAN,PULAU PARI,2765,206,2559,2368,4927,2021-10-15
3101021002,KAB.ADM.KEP.SERIBU,KEP. SERIBU SELATAN,PULAU TIDUNG,4553,416,4137,3702,7839,2021-10-15
3101021001,KAB.ADM.KEP.SERIBU,KEP. SERIBU SELATAN,PULAU UNTUNG JAWA,1941,186,1755,1598,3353,2021-10-15
3174071007,JAKARTA SELATAN,KEBAYORAN BARU,PULO,5835,1109,4726,4108,8834,2021-10-15
3175021001,JAKARTA TIMUR,PULO GADUNG,PULO GADUNG,34422,8255,26167,20735,46902,2021-10-15
3175061005,JAKARTA TIMUR,CAKUNG,PULO GEBANG,97301,21032,76269,58783,135052,2021-10-15
3174041004,JAKARTA SELATAN,PASAR MINGGU,RAGUNAN,39616,8373,31243,25234,56477,2021-10-15
3175091005,JAKARTA TIMUR,CIRACAS,RAMBUTAN,36771,9561,27210,20485,47695,2021-10-15
3172031006,JAKARTA UTARA,KOJA,RAWA BADAK SELATAN,42179,11100,31079,23363,54442,2021-10-15
3172031004,JAKARTA UTARA,KOJA,RAWA BADAK UTARA,34408,8613,25795,19589,45384,2021-10-15
3174071005,JAKARTA SELATAN,KEBAYORAN BARU,RAWA BARAT,5625,1081,4544,3844,8388,2021-10-15
3173011003,JAKARTA BARAT,CENGKARENG,RAWA BUAYA,63799,14556,49243,37458,86701,2021-10-15
3175031004,JAKARTA TIMUR,JATINEGARA,RAWA BUNGA,21434,5743,15691,12004,27695,2021-10-15
3174081003,JAKARTA SELATAN,PANCORAN,RAWA JATI,20509,4376,16133,12801,28934,2021-10-15
3175061002,JAKARTA TIMUR,CAKUNG,RAWA TERATE,24637,5100,19537,15367,34904,2021-10-15
3175021005,JAKARTA TIMUR,PULO GADUNG,RAWAMANGUN,37612,8375,29237,23534,52771,2021-10-15
3171051003,JAKARTA PUSAT,CEMPAKA PUTIH,RAWASARI,21967,5016,16951,13662,30613,2021-10-15
3173041010,JAKARTA BARAT,TAMBORA,ROA MALAKA,3484,653,2831,2425,5256,2021-10-15
3172041006,JAKARTA UTARA,CILINCING,ROROTAN,41668,9326,32342,24892,57234,2021-10-15
3174071004,JAKARTA SELATAN,KEBAYORAN BARU,SELONG,2842,580,2262,2008,4270,2021-10-15
3173061002,JAKARTA BARAT,KALI DERES,SEMANAN,71354,17937,53417,41655,95072,2021-10-15
3172041007,JAKARTA UTARA,CILINCING,SEMPER BARAT,68587,14976,53611,42748,96359,2021-10-15
3172041005,JAKARTA UTARA,CILINCING,SEMPER TIMUR,36267,8596,27671,21438,49109,2021-10-15
3174071006,JAKARTA SELATAN,KEBAYORAN BARU,SENAYAN,2771,706,2065,1702,3767,2021-10-15
3171041001,JAKARTA PUSAT,SENEN,SENEN,6804,1618,5186,4197,9383,2021-10-15
3171031004,JAKARTA PUSAT,KEMAYORAN,SERDANG,29668,6623,23045,18176,41221,2021-10-15
3174021001,JAKARTA SELATAN,SETIA BUDI,SETIA BUDI,3023,696,2327,1884,4211,2021-10-15
3175101005,JAKARTA TIMUR,CIPAYUNG,SETU,20572,4702,15870,12147,28017,2021-10-15
3173071002,JAKARTA BARAT,PALMERAH,SLIPI,16591,3395,13196,10553,23749,2021-10-15
3173081004,JAKARTA BARAT,KEMBANGAN,SRENGSENG,45523,11365,34158,27665,61823,2021-10-15
3174091002,JAKARTA SELATAN,JAGAKARSA,SRENGSENG SAWAH,58196,10584,47612,38560,86172,2021-10-15
3173051003,JAKARTA BARAT,KEBON JERUK,SUKABUMI SELATAN,37033,9394,27639,20471,48110,2021-10-15
3173051002,JAKARTA BARAT,KEBON JERUK,SUKABUMI UTARA,38290,10031,28259,21048,49307,2021-10-15
3172041002,JAKARTA UTARA,CILINCING,SUKAPURA,53949,13551,40398,31965,72363,2021-10-15
3171031007,JAKARTA PUSAT,KEMAYORAN,SUMUR BATU,22717,5148,17569,14205,31774,2021-10-15
3172021004,JAKARTA UTARA,TANJUNG PRIOK,SUNGAI BAMBU,29876,6755,23121,18260,41381,2021-10-15
3172021006,JAKARTA UTARA,TANJUNG PRIOK,SUNTER AGUNG,71805,13743,58062,48746,106808,2021-10-15
3172021002,JAKARTA UTARA,TANJUNG PRIOK,SUNTER JAYA,63031,12436,50595,41873,92468,2021-10-15
3175091004,JAKARTA TIMUR,CIRACAS,SUSUKAN,38257,8025,30232,23966,54198,2021-10-15
3173031001,JAKARTA BARAT,TAMAN SARI,TAMAN SARI,14348,2954,11394,9435,20829,2021-10-15
3173041001,JAKARTA BARAT,TAMBORA,TAMBORA,10204,2527,7677,5951,13628,2021-10-15
3173041004,JAKARTA BARAT,TAMBORA,TANAH SEREAL,26387,4943,21444,17208,38652,2021-10-15
3171081004,JAKARTA PUSAT,JOHAR BARU,TANAH TINGGI,37693,7819,29874,23262,53136,2021-10-15
3173031004,JAKARTA BARAT,TAMAN SARI,TANGKI,13324,2512,10812,8597,19409,2021-10-15
3174091005,JAKARTA SELATAN,JAGAKARSA,TANJUNG BARAT,39770,7533,32237,24738,56975,2021-10-15
3173021005,JAKARTA BARAT,GROGOL PETAMBURAN,TANJUNG DUREN SELATAN,25337,5408,19929,16744,36673,2021-10-15
3173021002,JAKARTA BARAT,GROGOL PETAMBURAN,TANJUNG DUREN UTARA,17010,3216,13794,11714,25508,2021-10-15
3172021001,JAKARTA UTARA,TANJUNG PRIOK,TANJUNG PRIOK,34588,7939,26649,20960,47609,2021-10-15
3174011002,JAKARTA SELATAN,TEBET,TEBET BARAT,21194,3894,17300,14535,31835,2021-10-15
3174011001,JAKARTA SELATAN,TEBET,TEBET TIMUR,18199,3260,14939,12806,27745,2021-10-15
3173061003,JAKARTA BARAT,KALI DERES,TEGAL ALUR,83647,19922,63725,50321,114046,2021-10-15
3174031004,JAKARTA SELATAN,MAMPANG PRAPATAN,TEGAL PARANG,32401,8071,24330,17642,41972,2021-10-15
3173021003,JAKARTA BARAT,GROGOL PETAMBURAN,TOMANG,29605,6058,23547,19162,42709,2021-10-15
3172031005,JAKARTA UTARA,KOJA,TUGU SELATAN,39122,9646,29476,22727,52203,2021-10-15
3172031002,JAKARTA UTARA,KOJA,TUGU UTARA,67670,17651,50019,37679,87698,2021-10-15
3175061006,JAKARTA TIMUR,CAKUNG,UJUNG MENTENG,29934,5816,24118,19560,43678,2021-10-15
3174101005,JAKARTA SELATAN,PESANGGRAHAN,ULUJAMI,40544,10343,30201,23435,53636,2021-10-15
3175011006,JAKARTA TIMUR,MATRAMAN,UTAN KAYU SELATAN,33511,6897,26614,20731,47345,2021-10-15
3175011002,JAKARTA TIMUR,MATRAMAN,UTAN KAYU UTARA,28169,6595,21574,16729,38303,2021-10-15
3171031008,JAKARTA PUSAT,KEMAYORAN,UTAN PANJANG,29208,6631,22577,16968,39545,2021-10-15
3172021007,JAKARTA UTARA,TANJUNG PRIOK,WARAKAS,44401,9143,35258,26978,62236,2021-10-15
3173021007,JAKARTA BARAT,GROGOL PETAMBURAN,WIJAYA KUSUMA,38934,9218,29716,23780,53496,2021-10-15
3172051003,JAKARTA UTARA,PADEMANGAN,ANCOL,23947,6291,17656,13926,31582,2021-10-16
3173041007,JAKARTA BARAT,TAMBORA,ANGKE,29381,7028,22353,17397,39750,2021-10-16
3175041005,JAKARTA TIMUR,KRAMAT JATI,BALE KAMBANG,29074,8013,21061,15451,36512,2021-10-16
3175031003,JAKARTA TIMUR,JATINEGARA,BALI MESTER,9752,2275,7477,5967,13444,2021-10-16
3175101006,JAKARTA TIMUR,CIPAYUNG,BAMBU APUS,26285,5438,20847,16104,36951,2021-10-16
3174031002,JAKARTA SELATAN,MAMPANG PRAPATAN,BANGKA,21566,5247,16319,12823,29142,2021-10-16
3175051002,JAKARTA TIMUR,PASAR REBO,BARU,23886,4424,19462,16131,35593,2021-10-16
3175041004,JAKARTA TIMUR,KRAMAT JATI,BATU AMPAR,47898,12920,34978,26301,61279,2021-10-16
3171071002,JAKARTA PUSAT,TANAH ABANG,BENDUNGAN HILIR,21494,4770,16724,13514,30238,2021-10-16
3175031002,JAKARTA TIMUR,JATINEGARA,BIDARA CINA,36689,9723,26966,20285,47251,2021-10-16
3174101002,JAKARTA SELATAN,PESANGGRAHAN,BINTARO,53098,11914,41184,33516,74700,2021-10-16
3174011005,JAKARTA SELATAN,TEBET,BUKIT DURI,34183,7955,26228,20627,46855,2021-10-16
3171041006,JAKARTA PUSAT,SENEN,BUNGUR,18144,4282,13862,11095,24957,2021-10-16
3175061007,JAKARTA TIMUR,CAKUNG,CAKUNG BARAT,57724,13231,44493,35430,79923,2021-10-16
3175061004,JAKARTA TIMUR,CAKUNG,CAKUNG TIMUR,58287,12806,45481,36067,81548,2021-10-16
3175041007,JAKARTA TIMUR,KRAMAT JATI,CAWANG,32762,8036,24726,18667,43393,2021-10-16
3175101008,JAKARTA TIMUR,CIPAYUNG,CEGER,18932,4118,14814,11754,26568,2021-10-16
3171031006,JAKARTA PUSAT,KEMAYORAN,CEMPAKA BARU,32581,7602,24979,18832,43811,2021-10-16
3171051002,JAKARTA PUSAT,CEMPAKA PUTIH,CEMPAKA PUTIH BARAT,35885,8493,27392,22126,49518,2021-10-16
3171051001,JAKARTA PUSAT,CEMPAKA PUTIH,CEMPAKA PUTIH TIMUR,24292,5494,18798,15602,34400,2021-10-16
3173011001,JAKARTA BARAT,CENGKARENG,CENGKARENG BARAT,66284,15149,51135,41329,92464,2021-10-16
3173011006,JAKARTA BARAT,CENGKARENG,CENGKARENG TIMUR,81027,17884,63143,49378,112521,2021-10-16
3175091002,JAKARTA TIMUR,CIRACAS,CIBUBUR,66364,12654,53710,42772,96482,2021-10-16
3171011002,JAKARTA PUSAT,GAMBIR,CIDENG,15390,3254,12136,10150,22286,2021-10-16
3174091003,JAKARTA SELATAN,JAGAKARSA,CIGANJUR,38497,7505,30992,23707,54699,2021-10-16
3175051003,JAKARTA TIMUR,PASAR REBO,CIJANTUNG,41419,8551,32868,26103,58971,2021-10-16
3171061003,JAKARTA PUSAT,MENTENG,CIKINI,8274,1621,6653,4992,11645,2021-10-16
3174081006,JAKARTA SELATAN,PANCORAN,CIKOKO,10547,2067,8480,7018,15498,2021-10-16
3174061001,JAKARTA SELATAN,CILANDAK,CILANDAK BARAT,51752,10482,41270,33941,75211,2021-10-16
3174041003,JAKARTA SELATAN,PASAR MINGGU,CILANDAK TIMUR,25145,5266,19879,16121,36000,2021-10-16
3175101002,JAKARTA TIMUR,CIPAYUNG,CILANGKAP,27635,5402,22233,17649,39882,2021-10-16
3175041006,JAKARTA TIMUR,KRAMAT JATI,CILILITAN,40181,9983,30198,23171,53369,2021-10-16
3172041001,JAKARTA UTARA,CILINCING,CILINCING,43609,11519,32090,23773,55863,2021-10-16
3175101001,JAKARTA TIMUR,CIPAYUNG,CIPAYUNG,26104,5029,21075,17296,38371,2021-10-16
3174091006,JAKARTA SELATAN,JAGAKARSA,CIPEDAK,38303,7380,30923,24415,55338,2021-10-16
3174061005,JAKARTA SELATAN,CILANDAK,CIPETE SELATAN,26704,5704,21000,17350,38350,2021-10-16
3174071010,JAKARTA SELATAN,KEBAYORAN BARU,CIPETE UTARA,34102,7211,26891,20832,47723,2021-10-16
3175021003,JAKARTA TIMUR,PULO GADUNG,CIPINANG,39306,8323,30983,24359,55342,2021-10-16
3175031007,JAKARTA TIMUR,JATINEGARA,CIPINANG BESAR SELATAN,35212,9271,25941,19079,45020,2021-10-16
3175031008,JAKARTA TIMUR,JATINEGARA,CIPINANG BESAR UTARA,45319,11888,33431,24448,57879,2021-10-16
3175031005,JAKARTA TIMUR,JATINEGARA,CIPINANG CEMPEDAK,32824,7842,24982,19694,44676,2021-10-16
3175081005,JAKARTA TIMUR,MAKASAR,CIPINANG MELAYU,42308,9082,33226,26526,59752,2021-10-16
3175031006,JAKARTA TIMUR,JATINEGARA,CIPINANG MUARA,55243,13337,41906,32309,74215,2021-10-16
3174051003,JAKARTA SELATAN,KEBAYORAN LAMA,CIPULIR,39937,9362,30575,23227,53802,2021-10-16
3175091001,JAKARTA TIMUR,CIRACAS,CIRACAS,64594,13143,51451,40188,91639,2021-10-16
3175041003,JAKARTA TIMUR,KRAMAT JATI,DUKUH,24609,5153,19456,15154,34610,2021-10-16
3175071001,JAKARTA TIMUR,DUREN SAWIT,DUREN SAWIT,61160,14337,46823,36355,83178,2021-10-16
3174081004,JAKARTA SELATAN,PANCORAN,DUREN TIGA,28319,6251,22068,17225,39293,2021-10-16
3173051005,JAKARTA BARAT,KEBON JERUK,DURI KEPA,60138,12963,47175,39339,86514,2021-10-16
3173011002,JAKARTA BARAT,CENGKARENG,DURI KOSAMBI,77923,19143,58780,44802,103582,2021-10-16
3171011006,JAKARTA PUSAT,GAMBIR,DURI PULO,19610,4582,15028,11580,26608,2021-10-16
3173041011,JAKARTA BARAT,TAMBORA,DURI SELATAN,14259,2776,11483,9283,20766,2021-10-16
3173041003,JAKARTA BARAT,TAMBORA,DURI UTARA,19844,4102,15742,12414,28156,2021-10-16
3171081003,JAKARTA PUSAT,JOHAR BARU,GALUR,18243,3965,14278,11144,25422,2021-10-16
3171011001,JAKARTA PUSAT,GAMBIR,GAMBIR,2191,497,1694,1403,3097,2021-10-16
3174061004,JAKARTA SELATAN,CILANDAK,GANDARIA SELATAN,22119,4831,17288,13879,31167,2021-10-16
3174071009,JAKARTA SELATAN,KEBAYORAN BARU,GANDARIA UTARA,39922,8944,30978,24533,55511,2021-10-16
3175051001,JAKARTA TIMUR,PASAR REBO,GEDONG,35755,7899,27856,22349,50205,2021-10-16
3171071001,JAKARTA PUSAT,TANAH ABANG,GELORA,3127,675,2452,2008,4460,2021-10-16
3173031007,JAKARTA BARAT,TAMAN SARI,GLODOK,7837,1354,6483,5624,12107,2021-10-16
3171061004,JAKARTA PUSAT,MENTENG,GONDANGDIA,4100,975,3125,2776,5901,2021-10-16
3173021001,JAKARTA BARAT,GROGOL PETAMBURAN,GROGOL,16876,3732,13144,10550,23694,2021-10-16
3174051005,JAKARTA SELATAN,KEBAYORAN LAMA,GROGOL SELATAN,44251,10164,34087,26588,60675,2021-10-16
3174051004,JAKARTA SELATAN,KEBAYORAN LAMA,GROGOL UTARA,42494,9894,32600,25891,58491,2021-10-16
3174021007,JAKARTA SELATAN,SETIA BUDI,GUNTUR,3985,825,3160,2683,5843,2021-10-16
3174071002,JAKARTA SELATAN,KEBAYORAN BARU,GUNUNG,9436,1924,7512,6274,13786,2021-10-16
3171031005,JAKARTA PUSAT,KEMAYORAN,GUNUNG SAHARI SELATAN,19199,4348,14851,11916,26767,2021-10-16
3171021004,JAKARTA PUSAT,SAWAH BESAR,GUNUNG SAHARI UTARA,16650,3221,13429,11468,24897,2021-10-16
3175081004,JAKARTA TIMUR,MAKASAR,HALIM PERDANA KUSUMAH,28363,4143,24220,21545,45765,2021-10-16
3171031003,JAKARTA PUSAT,KEMAYORAN,HARAPAN MULIA,22557,5093,17464,13446,30910,2021-10-16
3174091001,JAKARTA SELATAN,JAGAKARSA,JAGAKARSA,62389,12200,50189,39596,89785,2021-10-16
3175021007,JAKARTA TIMUR,PULO GADUNG,JATI,32757,6924,25833,21327,47160,2021-10-16
3174041002,JAKARTA SELATAN,PASAR MINGGU,JATI PADANG,37502,8523,28979,23177,52156,2021-10-16
3173071004,JAKARTA BARAT,PALMERAH,JATI PULO,28738,6398,22340,17098,39438,2021-10-16
3175061001,JAKARTA TIMUR,CAKUNG,JATINEGARA,84160,20164,63996,50429,114425,2021-10-16
3175021004,JAKARTA TIMUR,PULO GADUNG,JATINEGARA KAUM,24632,4956,19676,15044,34720,2021-10-16
3173021004,JAKARTA BARAT,GROGOL PETAMBURAN,JELAMBAR,30266,6151,24115,19835,43950,2021-10-16
3173021006,JAKARTA BARAT,GROGOL PETAMBURAN,JELAMBAR BARU,38246,7980,30266,24921,55187,2021-10-16
3173041006,JAKARTA BARAT,TAMBORA,JEMBATAN BESI,29314,7899,21415,15906,37321,2021-10-16
3173041008,JAKARTA BARAT,TAMBORA,JEMBATAN LIMA,21021,5495,15526,11700,27226,2021-10-16
3173081005,JAKARTA BARAT,KEMBANGAN,JOGLO,40839,9237,31602,25678,57280,2021-10-16
3171081001,JAKARTA PUSAT,JOHAR BARU,JOHAR BARU,37488,7577,29911,24225,54136,2021-10-16
3173041002,JAKARTA BARAT,TAMBORA,KALI ANYAR,23856,5412,18444,13896,32340,2021-10-16
3172041004,JAKARTA UTARA,CILINCING,KALIBARU,67684,20493,47191,32451,79642,2021-10-16
3174081002,JAKARTA SELATAN,PANCORAN,KALIBATA,41994,10716,31278,23577,54855,2021-10-16
3173061001,JAKARTA BARAT,KALI DERES,KALIDERES,72447,16818,55629,45187,100816,2021-10-16
3175051004,JAKARTA TIMUR,PASAR REBO,KALISARI,43212,8676,34536,27540,62076,2021-10-16
3173061004,JAKARTA BARAT,KALI DERES,KAMAL,53783,14279,39504,30092,69596,2021-10-16
3172011002,JAKARTA UTARA,PENJARINGAN,KAMAL MUARA,12930,2412,10518,8788,19306,2021-10-16
3171071007,JAKARTA PUSAT,TANAH ABANG,KAMPUNG BALI,11358,2711,8647,6219,14866,2021-10-16
3175031001,JAKARTA TIMUR,JATINEGARA,KAMPUNG MELAYU,25717,6779,18938,13982,32920,2021-10-16
3171081002,JAKARTA PUSAT,JOHAR BARU,KAMPUNG RAWA,21237,3815,17422,13377,30799,2021-10-16
3175041002,JAKARTA TIMUR,KRAMAT JATI,KAMPUNG TENGAH,43993,11991,32002,24030,56032,2021-10-16
3173011005,JAKARTA BARAT,CENGKARENG,KAPUK,134466,35748,98718,75761,174479,2021-10-16
3172011003,JAKARTA UTARA,PENJARINGAN,KAPUK MUARA,35781,7512,28269,24108,52377,2021-10-16
3171021002,JAKARTA PUSAT,SAWAH BESAR,KARANG ANYAR,25761,5492,20269,16220,36489,2021-10-16
3174021004,JAKARTA SELATAN,SETIA BUDI,KARET,9623,2089,7534,5953,13487,2021-10-16
3174021003,JAKARTA SELATAN,SETIA BUDI,KARET KUNINGAN,16055,3483,12572,10216,22788,2021-10-16
3174021002,JAKARTA SELATAN,SETIA BUDI,KARET SEMANGGI,2770,594,2176,1864,4040,2021-10-16
3171071003,JAKARTA PUSAT,TANAH ABANG,KARET TENGSIN,19271,4100,15171,11747,26918,2021-10-16
3171021003,JAKARTA PUSAT,SAWAH BESAR,KARTINI,22292,4781,17511,14228,31739,2021-10-16
3175011003,JAKARTA TIMUR,MATRAMAN,KAYU MANIS,25284,6018,19266,14336,33602,2021-10-16
3175021006,JAKARTA TIMUR,PULO GADUNG,KAYU PUTIH,40696,8502,32194,27025,59219,2021-10-16
3173031006,JAKARTA BARAT,TAMAN SARI,KEAGUNGAN,17387,3751,13636,10655,24291,2021-10-16
3174041007,JAKARTA SELATAN,PASAR MINGGU,KEBAGUSAN,44552,10119,34433,26375,60808,2021-10-16
3174051006,JAKARTA SELATAN,KEBAYORAN LAMA,KEBAYORAN LAMA SELATAN,41212,8603,32609,25993,58602,2021-10-16
3174051001,JAKARTA SELATAN,KEBAYORAN LAMA,KEBAYORAN LAMA UTARA,42422,10125,32297,25336,57633,2021-10-16
3174011004,JAKARTA SELATAN,TEBET,KEBON BARU,35165,7407,27758,21668,49426,2021-10-16
3172021005,JAKARTA UTARA,TANJUNG PRIOK,KEBON BAWANG,50952,11590,39362,31181,70543,2021-10-16
3173051001,JAKARTA BARAT,KEBON JERUK,KEBON JERUK,53887,12972,40915,32029,72944,2021-10-16
3171071006,JAKARTA PUSAT,TANAH ABANG,KEBON KACANG,21531,5741,15790,11873,27663,2021-10-16
3171011005,JAKARTA PUSAT,GAMBIR,KEBON KELAPA,10163,2246,7917,6320,14237,2021-10-16
3171031002,JAKARTA PUSAT,KEMAYORAN,KEBON KOSONG,30019,6736,23283,17680,40963,2021-10-16
3175011005,JAKARTA TIMUR,MATRAMAN,KEBON MANGGIS,16490,3601,12889,10180,23069,2021-10-16
3171071005,JAKARTA PUSAT,TANAH ABANG,KEBON MELATI,32206,9317,22889,16012,38901,2021-10-16
3175081003,JAKARTA TIMUR,MAKASAR,KEBON PALA,46614,10459,36155,28591,64746,2021-10-16
3171061005,JAKARTA PUSAT,MENTENG,KEBON SIRIH,12299,2903,9396,7130,16526,2021-10-16
3173011004,JAKARTA BARAT,CENGKARENG,KEDAUNG KALI ANGKE,32612,6994,25618,20549,46167,2021-10-16
3173051007,JAKARTA BARAT,KEBON JERUK,KEDOYA SELATAN,32165,6570,25595,20253,45848,2021-10-16
3173051006,JAKARTA BARAT,KEBON JERUK,KEDOYA UTARA,45740,9566,36174,29678,65852,2021-10-16
3173051004,JAKARTA BARAT,KEBON JERUK,KELAPA DUA,23565,5391,18174,14435,32609,2021-10-16
3175091003,JAKARTA TIMUR,CIRACAS,KELAPA DUA WETAN,46875,9008,37867,30296,68163,2021-10-16
3172061003,JAKARTA UTARA,KELAPA GADING,KELAPA GADING BARAT,35717,6738,28979,25412,54391,2021-10-16
3172061001,JAKARTA UTARA,KELAPA GADING,KELAPA GADING TIMUR,33592,5573,28019,25148,53167,2021-10-16
3173071005,JAKARTA BARAT,PALMERAH,KEMANGGISAN,32139,6833,25306,20083,45389,2021-10-16
3171031001,JAKARTA PUSAT,KEMAYORAN,KEMAYORAN,20708,4741,15967,12635,28602,2021-10-16
3173081006,JAKARTA BARAT,KEMBANGAN,KEMBANGAN SELATAN,27130,6329,20801,17461,38262,2021-10-16
3173081001,JAKARTA BARAT,KEMBANGAN,KEMBANGAN UTARA,54451,13258,41193,33110,74303,2021-10-16
3171041002,JAKARTA PUSAT,SENEN,KENARI,9579,2082,7497,6123,13620,2021-10-16
3173041005,JAKARTA BARAT,TAMBORA,KERENDANG,19973,4684,15289,11832,27121,2021-10-16
3175071003,JAKARTA TIMUR,DUREN SAWIT,KLENDER,69978,18133,51845,39213,91058,2021-10-16
3172031001,JAKARTA UTARA,KOJA,KOJA,28175,7096,21079,16211,37290,2021-10-16
3173071006,JAKARTA BARAT,PALMERAH,KOTA BAMBU SELATAN,21158,4970,16188,12191,28379,2021-10-16
3173071003,JAKARTA BARAT,PALMERAH,KOTA BAMBU UTARA,24995,6086,18909,14152,33061,2021-10-16
3171041004,JAKARTA PUSAT,SENEN,KRAMAT,28835,7620,21215,15503,36718,2021-10-16
3175041001,JAKARTA TIMUR,KRAMAT JATI,KRAMAT JATI,34144,8175,25969,19960,45929,2021-10-16
3174071003,JAKARTA SELATAN,KEBAYORAN BARU,KRAMAT PELA,14413,3071,11342,9209,20551,2021-10-16
3173031002,JAKARTA BARAT,TAMAN SARI,KRUKUT,19244,4141,15103,11616,26719,2021-10-16
3174031005,JAKARTA SELATAN,MAMPANG PRAPATAN,KUNINGAN BARAT,12785,2650,10135,8044,18179,2021-10-16
3174021008,JAKARTA SELATAN,SETIA BUDI,KUNINGAN TIMUR,6008,1365,4643,3794,8437,2021-10-16
3171041005,JAKARTA PUSAT,SENEN,KWITANG,15486,3897,11589,9018,20607,2021-10-16
3172031003,JAKARTA UTARA,KOJA,LAGOA,59065,15508,43557,32970,76527,2021-10-16
3174061002,JAKARTA SELATAN,CILANDAK,LEBAK BULUS,37626,7935,29691,24208,53899,2021-10-16
3174091004,JAKARTA SELATAN,JAGAKARSA,LENTENG AGUNG,53946,11140,42806,32200,75006,2021-10-16
3175101007,JAKARTA TIMUR,CIPAYUNG,LUBANG BUAYA,63547,13339,50208,39819,90027,2021-10-16
3175081001,JAKARTA TIMUR,MAKASAR,MAKASAR,34390,7097,27293,21919,49212,2021-10-16
3175071006,JAKARTA TIMUR,DUREN SAWIT,MALAKA JAYA,30927,6198,24729,20020,44749,2021-10-16
3175071005,JAKARTA TIMUR,DUREN SAWIT,MALAKA SARI,27530,5191,22339,18323,40662,2021-10-16
3174031001,JAKARTA SELATAN,MAMPANG PRAPATAN,MAMPANG PRAPATAN,18159,4198,13961,10862,24823,2021-10-16
3173031005,JAKARTA BARAT,TAMAN SARI,MANGGA BESAR,7707,1413,6294,5254,11548,2021-10-16
3171021005,JAKARTA PUSAT,SAWAH BESAR,MANGGA DUA SELATAN,27442,6250,21192,17044,38236,2021-10-16
3174011007,JAKARTA SELATAN,TEBET,MANGGARAI,28373,5727,22646,17253,39899,2021-10-16
3174011006,JAKARTA SELATAN,TEBET,MANGGARAI SELATAN,23075,4652,18423,14752,33175,2021-10-16
3173031003,JAKARTA BARAT,TAMAN SARI,MAPHAR,16461,3464,12997,10338,23335,2021-10-16
3172041003,JAKARTA UTARA,CILINCING,MARUNDA,28943,7207,21736,15795,37531,2021-10-16
3174071001,JAKARTA SELATAN,KEBAYORAN BARU,MELAWAI,2627,560,2067,1872,3939,2021-10-16
3171061001,JAKARTA PUSAT,MENTENG,MENTENG,25624,6353,19271,14437,33708,2021-10-16
3174021005,JAKARTA SELATAN,SETIA BUDI,MENTENG ATAS,27816,5691,22125,17361,39486,2021-10-16
3174011003,JAKARTA SELATAN,TEBET,MENTENG DALAM,36028,7850,28178,22339,50517,2021-10-16
3173081003,JAKARTA BARAT,KEMBANGAN,MERUYA SELATAN,32130,7386,24744,19817,44561,2021-10-16
3173081002,JAKARTA BARAT,KEMBANGAN,MERUYA UTARA,43752,10078,33674,28048,61722,2021-10-16
3175101004,JAKARTA TIMUR,CIPAYUNG,MUNJUL,23871,4755,19116,15169,34285,2021-10-16
3172051002,JAKARTA UTARA,PADEMANGAN,PADEMANGAN BARAT,74240,19214,55026,42424,97450,2021-10-16
3172051001,JAKARTA UTARA,PADEMANGAN,PADEMANGAN TIMUR,37736,7354,30382,25354,55736,2021-10-16
3175011004,JAKARTA TIMUR,MATRAMAN,PAL MERIAM,19769,4681,15088,11502,26590,2021-10-16
3173071001,JAKARTA BARAT,PALMERAH,PALMERAH,63011,15154,47857,37144,85001,2021-10-16
3174081001,JAKARTA SELATAN,PANCORAN,PANCORAN,19421,4534,14887,11834,26721,2021-10-16
3172021003,JAKARTA UTARA,TANJUNG PRIOK,PAPANGGO,39097,8725,30372,23931,54303,2021-10-16
3171021001,JAKARTA PUSAT,SAWAH BESAR,PASAR BARU,12035,2525,9510,8187,17697,2021-10-16
3174021006,JAKARTA SELATAN,SETIA BUDI,PASAR MANGGIS,26752,6062,20690,16230,36920,2021-10-16
3174041001,JAKARTA SELATAN,PASAR MINGGU,PASAR MINGGU,24821,5254,19567,15776,35343,2021-10-16
3171041003,JAKARTA PUSAT,SENEN,PASEBAN,23533,5548,17985,14099,32084,2021-10-16
3173061005,JAKARTA BARAT,KALI DERES,PEGADUNGAN,75587,17025,58562,48816,107378,2021-10-16
3171061002,JAKARTA PUSAT,MENTENG,PEGANGSAAN,23455,5708,17747,12877,30624,2021-10-16
3172061002,JAKARTA UTARA,KELAPA GADING,PEGANGSAAN DUA,49976,8931,41045,36145,77190,2021-10-16
3172011004,JAKARTA UTARA,PENJARINGAN,PEJAGALAN,74578,17025,57553,47142,104695,2021-10-16
3174041006,JAKARTA SELATAN,PASAR MINGGU,PEJATEN BARAT,37346,8379,28967,23023,51990,2021-10-16
3174041005,JAKARTA SELATAN,PASAR MINGGU,PEJATEN TIMUR,57656,14560,43096,33616,76712,2021-10-16
3175051005,JAKARTA TIMUR,PASAR REBO,PEKAYON,43250,8848,34402,27157,61559,2021-10-16
3173041009,JAKARTA BARAT,TAMBORA,PEKOJAN,23587,5002,18585,14847,33432,2021-10-16
3174031003,JAKARTA SELATAN,MAMPANG PRAPATAN,PELA MAMPANG,43522,9761,33761,26710,60471,2021-10-16
3174081005,JAKARTA SELATAN,PANCORAN,PENGADEGAN,21478,4367,17111,13680,30791,2021-10-16
3175061003,JAKARTA TIMUR,CAKUNG,PENGGILINGAN,99255,25844,73411,55818,129229,2021-10-16
3172011001,JAKARTA UTARA,PENJARINGAN,PENJARINGAN,88308,24923,63385,46589,109974,2021-10-16
3174101001,JAKARTA SELATAN,PESANGGRAHAN,PESANGGRAHAN,27545,5312,22233,18221,40454,2021-10-16
3171071004,JAKARTA PUSAT,TANAH ABANG,PETAMBURAN,33271,9639,23632,16958,40590,2021-10-16
3174071008,JAKARTA SELATAN,KEBAYORAN BARU,PETOGOGAN,11499,2530,8969,7255,16224,2021-10-16
3171011004,JAKARTA PUSAT,GAMBIR,PETOJO SELATAN,14692,3611,11081,9000,20081,2021-10-16
3171011003,JAKARTA PUSAT,GAMBIR,PETOJO UTARA,17458,4095,13363,10468,23831,2021-10-16
3174101004,JAKARTA SELATAN,PESANGGRAHAN,PETUKANGAN SELATAN,37187,8505,28682,23018,51700,2021-10-16
3174101003,JAKARTA SELATAN,PESANGGRAHAN,PETUKANGAN UTARA,53716,12956,40760,32270,73030,2021-10-16
3175081002,JAKARTA TIMUR,MAKASAR,PINANG RANTI,27198,6573,20625,16370,36995,2021-10-16
3173031008,JAKARTA BARAT,TAMAN SARI,PINANGSIA,10729,2080,8649,6868,15517,2021-10-16
3175011001,JAKARTA TIMUR,MATRAMAN,PISANGAN BARU,31776,7418,24358,18234,42592,2021-10-16
3175021002,JAKARTA TIMUR,PULO GADUNG,PISANGAN TIMUR,41011,8652,32359,25998,58357,2021-10-16
3172011005,JAKARTA UTARA,PENJARINGAN,PLUIT,47783,10017,37766,31887,69653,2021-10-16
3175071002,JAKARTA TIMUR,DUREN SAWIT,PONDOK BAMBU,61550,14493,47057,36777,83834,2021-10-16
3175071004,JAKARTA TIMUR,DUREN SAWIT,PONDOK KELAPA,72015,15828,56187,46057,102244,2021-10-16
3175071007,JAKARTA TIMUR,DUREN SAWIT,PONDOK KOPI,35367,7697,27670,20703,48373,2021-10-16
3174061003,JAKARTA SELATAN,CILANDAK,PONDOK LABU,46464,8960,37504,31045,68549,2021-10-16
3174051002,JAKARTA SELATAN,KEBAYORAN LAMA,PONDOK PINANG,56169,11761,44408,35536,79944,2021-10-16
3175101003,JAKARTA TIMUR,CIPAYUNG,PONDOK RANGGON,25574,5288,20286,15821,36107,2021-10-16
3101011003,KAB.ADM.KEP.SERIBU,KEP. SERIBU UTARA,PULAU HARAPAN,2060,240,1820,1552,3372,2021-10-16
3101011002,KAB.ADM.KEP.SERIBU,KEP. SERIBU UTARA,PULAU KELAPA,5528,647,4881,3931,8812,2021-10-16
3101011001,KAB.ADM.KEP.SERIBU,KEP. SERIBU UTARA,PULAU PANGGANG,5450,491,4959,4346,9305,2021-10-16
3101021003,KAB.ADM.KEP.SERIBU,KEP. SERIBU SELATAN,PULAU PARI,2765,206,2559,2368,4927,2021-10-16
3101021002,KAB.ADM.KEP.SERIBU,KEP. SERIBU SELATAN,PULAU TIDUNG,4553,411,4142,3707,7849,2021-10-16
3101021001,KAB.ADM.KEP.SERIBU,KEP. SERIBU SELATAN,PULAU UNTUNG JAWA,1941,178,1763,1599,3362,2021-10-16
3174071007,JAKARTA SELATAN,KEBAYORAN BARU,PULO,5835,1098,4737,4123,8860,2021-10-16
3175021001,JAKARTA TIMUR,PULO GADUNG,PULO GADUNG,34422,8237,26185,20804,46989,2021-10-16
3175061005,JAKARTA TIMUR,CAKUNG,PULO GEBANG,97301,20886,76415,59023,135438,2021-10-16
3174041004,JAKARTA SELATAN,PASAR MINGGU,RAGUNAN,39616,8343,31273,25341,56614,2021-10-16
3175091005,JAKARTA TIMUR,CIRACAS,RAMBUTAN,36771,9495,27276,20571,47847,2021-10-16
3172031006,JAKARTA UTARA,KOJA,RAWA BADAK SELATAN,42179,11030,31149,23496,54645,2021-10-16
3172031004,JAKARTA UTARA,KOJA,RAWA BADAK UTARA,34408,8568,25840,19643,45483,2021-10-16
3174071005,JAKARTA SELATAN,KEBAYORAN BARU,RAWA BARAT,5625,1075,4550,3855,8405,2021-10-16
3173011003,JAKARTA BARAT,CENGKARENG,RAWA BUAYA,63799,14460,49339,37645,86984,2021-10-16
3175031004,JAKARTA TIMUR,JATINEGARA,RAWA BUNGA,21434,5709,15725,12047,27772,2021-10-16
3174081003,JAKARTA SELATAN,PANCORAN,RAWA JATI,20509,4369,16140,12884,29024,2021-10-16
3175061002,JAKARTA TIMUR,CAKUNG,RAWA TERATE,24637,5065,19572,15395,34967,2021-10-16
3175021005,JAKARTA TIMUR,PULO GADUNG,RAWAMANGUN,37612,8336,29276,23594,52870,2021-10-16
3171051003,JAKARTA PUSAT,CEMPAKA PUTIH,RAWASARI,21967,4977,16990,13716,30706,2021-10-16
3173041010,JAKARTA BARAT,TAMBORA,ROA MALAKA,3484,649,2835,2430,5265,2021-10-16
3172041006,JAKARTA UTARA,CILINCING,ROROTAN,41668,9273,32395,24959,57354,2021-10-16
3174071004,JAKARTA SELATAN,KEBAYORAN BARU,SELONG,2842,580,2262,2013,4275,2021-10-16
3173061002,JAKARTA BARAT,KALI DERES,SEMANAN,71354,17804,53550,41813,95363,2021-10-16
3172041007,JAKARTA UTARA,CILINCING,SEMPER BARAT,68587,14886,53701,42895,96596,2021-10-16
3172041005,JAKARTA UTARA,CILINCING,SEMPER TIMUR,36267,8553,27714,21519,49233,2021-10-16
3174071006,JAKARTA SELATAN,KEBAYORAN BARU,SENAYAN,2771,703,2068,1706,3774,2021-10-16
3171041001,JAKARTA PUSAT,SENEN,SENEN,6804,1616,5188,4203,9391,2021-10-16
3171031004,JAKARTA PUSAT,KEMAYORAN,SERDANG,29668,6587,23081,18263,41344,2021-10-16
3174021001,JAKARTA SELATAN,SETIA BUDI,SETIA BUDI,3023,694,2329,1888,4217,2021-10-16
3175101005,JAKARTA TIMUR,CIPAYUNG,SETU,20572,4615,15957,12189,28146,2021-10-16
3173071002,JAKARTA BARAT,PALMERAH,SLIPI,16591,3367,13224,10592,23816,2021-10-16
3173081004,JAKARTA BARAT,KEMBANGAN,SRENGSENG,45523,11306,34217,27770,61987,2021-10-16
3174091002,JAKARTA SELATAN,JAGAKARSA,SRENGSENG SAWAH,58196,10471,47725,38658,86383,2021-10-16
3173051003,JAKARTA BARAT,KEBON JERUK,SUKABUMI SELATAN,37033,9347,27686,20527,48213,2021-10-16
3173051002,JAKARTA BARAT,KEBON JERUK,SUKABUMI UTARA,38290,9958,28332,21113,49445,2021-10-16
3172041002,JAKARTA UTARA,CILINCING,SUKAPURA,53949,13462,40487,32073,72560,2021-10-16
3171031007,JAKARTA PUSAT,KEMAYORAN,SUMUR BATU,22717,5103,17614,14296,31910,2021-10-16
3172021004,JAKARTA UTARA,TANJUNG PRIOK,SUNGAI BAMBU,29876,6731,23145,18308,41453,2021-10-16
3172021006,JAKARTA UTARA,TANJUNG PRIOK,SUNTER AGUNG,71805,13691,58114,48876,106990,2021-10-16
3172021002,JAKARTA UTARA,TANJUNG PRIOK,SUNTER JAYA,63031,12220,50811,42054,92865,2021-10-16
3175091004,JAKARTA TIMUR,CIRACAS,SUSUKAN,38257,7979,30278,24056,54334,2021-10-16
3173031001,JAKARTA BARAT,TAMAN SARI,TAMAN SARI,14348,2950,11398,9457,20855,2021-10-16
3173041001,JAKARTA BARAT,TAMBORA,TAMBORA,10204,2509,7695,5970,13665,2021-10-16
3173041004,JAKARTA BARAT,TAMBORA,TANAH SEREAL,26387,4916,21471,17260,38731,2021-10-16
3171081004,JAKARTA PUSAT,JOHAR BARU,TANAH TINGGI,37693,7794,29899,23322,53221,2021-10-16
3173031004,JAKARTA BARAT,TAMAN SARI,TANGKI,13324,2492,10832,8630,19462,2021-10-16
3174091005,JAKARTA SELATAN,JAGAKARSA,TANJUNG BARAT,39770,7498,32272,24845,57117,2021-10-16
3173021005,JAKARTA BARAT,GROGOL PETAMBURAN,TANJUNG DUREN SELATAN,25337,5370,19967,16816,36783,2021-10-16
3173021002,JAKARTA BARAT,GROGOL PETAMBURAN,TANJUNG DUREN UTARA,17010,3185,13825,11743,25568,2021-10-16
3172021001,JAKARTA UTARA,TANJUNG PRIOK,TANJUNG PRIOK,34588,7917,26671,21004,47675,2021-10-16
3174011002,JAKARTA SELATAN,TEBET,TEBET BARAT,21194,3877,17317,14574,31891,2021-10-16
3174011001,JAKARTA SELATAN,TEBET,TEBET TIMUR,18199,3244,14955,12840,27795,2021-10-16
3173061003,JAKARTA BARAT,KALI DERES,TEGAL ALUR,83647,19830,63817,50466,114283,2021-10-16
3174031004,JAKARTA SELATAN,MAMPANG PRAPATAN,TEGAL PARANG,32401,8035,24366,17702,42068,2021-10-16
3173021003,JAKARTA BARAT,GROGOL PETAMBURAN,TOMANG,29605,6026,23579,19202,42781,2021-10-16
3172031005,JAKARTA UTARA,KOJA,TUGU SELATAN,39122,9607,29515,22824,52339,2021-10-16
3172031002,JAKARTA UTARA,KOJA,TUGU UTARA,67670,17581,50089,37822,87911,2021-10-16
3175061006,JAKARTA TIMUR,CAKUNG,UJUNG MENTENG,29934,5786,24148,19604,43752,2021-10-16
3174101005,JAKARTA SELATAN,PESANGGRAHAN,ULUJAMI,40544,10306,30238,23487,53725,2021-10-16
3175011006,JAKARTA TIMUR,MATRAMAN,UTAN KAYU SELATAN,33511,6867,26644,20817,47461,2021-10-16
3175011002,JAKARTA TIMUR,MATRAMAN,UTAN KAYU UTARA,28169,6570,21599,16805,38404,2021-10-16
3171031008,JAKARTA PUSAT,KEMAYORAN,UTAN PANJANG,29208,6583,22625,17113,39738,2021-10-16
3172021007,JAKARTA UTARA,TANJUNG PRIOK,WARAKAS,44401,9094,35307,27050,62357,2021-10-16
3173021007,JAKARTA BARAT,GROGOL PETAMBURAN,WIJAYA KUSUMA,38934,9151,29783,23852,53635,2021-10-16
3172051003,JAKARTA UTARA,PADEMANGAN,ANCOL,23947,6229,17718,14029,31747,2021-10-17
3173041007,JAKARTA BARAT,TAMBORA,ANGKE,29381,6933,22448,17499,39947,2021-10-17
3175041005,JAKARTA TIMUR,KRAMAT JATI,BALE KAMBANG,29074,7945,21129,15550,36679,2021-10-17
3175031003,JAKARTA TIMUR,JATINEGARA,BALI MESTER,9752,2246,7506,6005,13511,2021-10-17
3175101006,JAKARTA TIMUR,CIPAYUNG,BAMBU APUS,26285,5317,20968,16230,37198,2021-10-17
3174031002,JAKARTA SELATAN,MAMPANG PRAPATAN,BANGKA,21566,5127,16439,12926,29365,2021-10-17
3175051002,JAKARTA TIMUR,PASAR REBO,BARU,23886,4348,19538,16207,35745,2021-10-17
3175041004,JAKARTA TIMUR,KRAMAT JATI,BATU AMPAR,47898,12802,35096,26474,61570,2021-10-17
3171071002,JAKARTA PUSAT,TANAH ABANG,BENDUNGAN HILIR,21494,4690,16804,13608,30412,2021-10-17
3175031002,JAKARTA TIMUR,JATINEGARA,BIDARA CINA,36689,9623,27066,20468,47534,2021-10-17
3174101002,JAKARTA SELATAN,PESANGGRAHAN,BINTARO,53098,11747,41351,33785,75136,2021-10-17
3174011005,JAKARTA SELATAN,TEBET,BUKIT DURI,34183,7851,26332,20827,47159,2021-10-17
3171041006,JAKARTA PUSAT,SENEN,BUNGUR,18144,4230,13914,11184,25098,2021-10-17
3175061007,JAKARTA TIMUR,CAKUNG,CAKUNG BARAT,57724,13053,44671,35697,80368,2021-10-17
3175061004,JAKARTA TIMUR,CAKUNG,CAKUNG TIMUR,58287,12576,45711,36302,82013,2021-10-17
3175041007,JAKARTA TIMUR,KRAMAT JATI,CAWANG,32762,7950,24812,18801,43613,2021-10-17
3175101008,JAKARTA TIMUR,CIPAYUNG,CEGER,18932,4074,14858,11828,26686,2021-10-17
3171031006,JAKARTA PUSAT,KEMAYORAN,CEMPAKA BARU,32581,7527,25054,18945,43999,2021-10-17
3171051002,JAKARTA PUSAT,CEMPAKA PUTIH,CEMPAKA PUTIH BARAT,35885,8404,27481,22256,49737,2021-10-17
3171051001,JAKARTA PUSAT,CEMPAKA PUTIH,CEMPAKA PUTIH TIMUR,24292,5439,18853,15683,34536,2021-10-17
3173011001,JAKARTA BARAT,CENGKARENG,CENGKARENG BARAT,66284,14971,51313,41566,92879,2021-10-17
3173011006,JAKARTA BARAT,CENGKARENG,CENGKARENG TIMUR,81027,17653,63374,49755,113129,2021-10-17
3175091002,JAKARTA TIMUR,CIRACAS,CIBUBUR,66364,12446,53918,43058,96976,2021-10-17
3171011002,JAKARTA PUSAT,GAMBIR,CIDENG,15390,3221,12169,10205,22374,2021-10-17
3174091003,JAKARTA SELATAN,JAGAKARSA,CIGANJUR,38497,7411,31086,23857,54943,2021-10-17
3175051003,JAKARTA TIMUR,PASAR REBO,CIJANTUNG,41419,8443,32976,26233,59209,2021-10-17
3171061003,JAKARTA PUSAT,MENTENG,CIKINI,8274,1592,6682,5039,11721,2021-10-17
3174081006,JAKARTA SELATAN,PANCORAN,CIKOKO,10547,1981,8566,7068,15634,2021-10-17
3174061001,JAKARTA SELATAN,CILANDAK,CILANDAK BARAT,51752,10313,41439,34186,75625,2021-10-17
3174041003,JAKARTA SELATAN,PASAR MINGGU,CILANDAK TIMUR,25145,5181,19964,16233,36197,2021-10-17
3175101002,JAKARTA TIMUR,CIPAYUNG,CILANGKAP,27635,5323,22312,17716,40028,2021-10-17
3175041006,JAKARTA TIMUR,KRAMAT JATI,CILILITAN,40181,9877,30304,23353,53657,2021-10-17
3172041001,JAKARTA UTARA,CILINCING,CILINCING,43609,11415,32194,23936,56130,2021-10-17
3175101001,JAKARTA TIMUR,CIPAYUNG,CIPAYUNG,26104,4972,21132,17381,38513,2021-10-17
3174091006,JAKARTA SELATAN,JAGAKARSA,CIPEDAK,38303,7301,31002,24567,55569,2021-10-17
3174061005,JAKARTA SELATAN,CILANDAK,CIPETE SELATAN,26704,5634,21070,17461,38531,2021-10-17
3174071010,JAKARTA SELATAN,KEBAYORAN BARU,CIPETE UTARA,34102,7108,26994,20988,47982,2021-10-17
3175021003,JAKARTA TIMUR,PULO GADUNG,CIPINANG,39306,8192,31114,24517,55631,2021-10-17
3175031007,JAKARTA TIMUR,JATINEGARA,CIPINANG BESAR SELATAN,35212,9186,26026,19245,45271,2021-10-17
3175031008,JAKARTA TIMUR,JATINEGARA,CIPINANG BESAR UTARA,45319,11782,33537,24633,58170,2021-10-17
3175031005,JAKARTA TIMUR,JATINEGARA,CIPINANG CEMPEDAK,32824,7773,25051,19826,44877,2021-10-17
3175081005,JAKARTA TIMUR,MAKASAR,CIPINANG MELAYU,42308,8967,33341,26741,60082,2021-10-17
3175031006,JAKARTA TIMUR,JATINEGARA,CIPINANG MUARA,55243,13182,42061,32500,74561,2021-10-17
3174051003,JAKARTA SELATAN,KEBAYORAN LAMA,CIPULIR,39937,9227,30710,23447,54157,2021-10-17
3175091001,JAKARTA TIMUR,CIRACAS,CIRACAS,64594,12973,51621,40425,92046,2021-10-17
3175041003,JAKARTA TIMUR,KRAMAT JATI,DUKUH,24609,5100,19509,15225,34734,2021-10-17
3175071001,JAKARTA TIMUR,DUREN SAWIT,DUREN SAWIT,61160,14196,46964,36570,83534,2021-10-17
3174081004,JAKARTA SELATAN,PANCORAN,DUREN TIGA,28319,6178,22141,17356,39497,2021-10-17
3173051005,JAKARTA BARAT,KEBON JERUK,DURI KEPA,60138,12862,47276,39513,86789,2021-10-17
3173011002,JAKARTA BARAT,CENGKARENG,DURI KOSAMBI,77923,18890,59033,45180,104213,2021-10-17
3171011006,JAKARTA PUSAT,GAMBIR,DURI PULO,19610,4524,15086,11660,26746,2021-10-17
3173041011,JAKARTA BARAT,TAMBORA,DURI SELATAN,14259,2747,11512,9332,20844,2021-10-17
3173041003,JAKARTA BARAT,TAMBORA,DURI UTARA,19844,4047,15797,12505,28302,2021-10-17
3171081003,JAKARTA PUSAT,JOHAR BARU,GALUR,18243,3916,14327,11208,25535,2021-10-17
3171011001,JAKARTA PUSAT,GAMBIR,GAMBIR,2191,492,1699,1412,3111,2021-10-17
3174061004,JAKARTA SELATAN,CILANDAK,GANDARIA SELATAN,22119,4760,17359,13959,31318,2021-10-17
3174071009,JAKARTA SELATAN,KEBAYORAN BARU,GANDARIA UTARA,39922,8813,31109,24726,55835,2021-10-17
3175051001,JAKARTA TIMUR,PASAR REBO,GEDONG,35755,7805,27950,22498,50448,2021-10-17
3171071001,JAKARTA PUSAT,TANAH ABANG,GELORA,3127,670,2457,2029,4486,2021-10-17
3173031007,JAKARTA BARAT,TAMAN SARI,GLODOK,7837,1346,6491,5646,12137,2021-10-17
3171061004,JAKARTA PUSAT,MENTENG,GONDANGDIA,4100,967,3133,2787,5920,2021-10-17
3173021001,JAKARTA BARAT,GROGOL PETAMBURAN,GROGOL,16876,3679,13197,10625,23822,2021-10-17
3174051005,JAKARTA SELATAN,KEBAYORAN LAMA,GROGOL SELATAN,44251,10053,34198,26764,60962,2021-10-17
3174051004,JAKARTA SELATAN,KEBAYORAN LAMA,GROGOL UTARA,42494,9774,32720,26065,58785,2021-10-17
3174021007,JAKARTA SELATAN,SETIA BUDI,GUNTUR,3985,814,3171,2698,5869,2021-10-17
3174071002,JAKARTA SELATAN,KEBAYORAN BARU,GUNUNG,9436,1897,7539,6308,13847,2021-10-17
3171031005,JAKARTA PUSAT,KEMAYORAN,GUNUNG SAHARI SELATAN,19199,4297,14902,11990,26892,2021-10-17
3171021004,JAKARTA PUSAT,SAWAH BESAR,GUNUNG SAHARI UTARA,16650,3194,13456,11522,24978,2021-10-17
3175081004,JAKARTA TIMUR,MAKASAR,HALIM PERDANA KUSUMAH,28363,4093,24270,21623,45893,2021-10-17
3171031003,JAKARTA PUSAT,KEMAYORAN,HARAPAN MULIA,22557,5024,17533,13533,31066,2021-10-17
3174091001,JAKARTA SELATAN,JAGAKARSA,JAGAKARSA,62389,12017,50372,39883,90255,2021-10-17
3175021007,JAKARTA TIMUR,PULO GADUNG,JATI,32757,6827,25930,21428,47358,2021-10-17
3174041002,JAKARTA SELATAN,PASAR MINGGU,JATI PADANG,37502,8303,29199,23397,52596,2021-10-17
3173071004,JAKARTA BARAT,PALMERAH,JATI PULO,28738,6305,22433,17255,39688,2021-10-17
3175061001,JAKARTA TIMUR,CAKUNG,JATINEGARA,84160,19897,64263,50817,115080,2021-10-17
3175021004,JAKARTA TIMUR,PULO GADUNG,JATINEGARA KAUM,24632,4896,19736,15141,34877,2021-10-17
3173021004,JAKARTA BARAT,GROGOL PETAMBURAN,JELAMBAR,30266,6087,24179,19947,44126,2021-10-17
3173021006,JAKARTA BARAT,GROGOL PETAMBURAN,JELAMBAR BARU,38246,7895,30351,25074,55425,2021-10-17
3173041006,JAKARTA BARAT,TAMBORA,JEMBATAN BESI,29314,7803,21511,16021,37532,2021-10-17
3173041008,JAKARTA BARAT,TAMBORA,JEMBATAN LIMA,21021,5441,15580,11787,27367,2021-10-17
3173081005,JAKARTA BARAT,KEMBANGAN,JOGLO,40839,9120,31719,25832,57551,2021-10-17
3171081001,JAKARTA PUSAT,JOHAR BARU,JOHAR BARU,37488,7485,30003,24385,54388,2021-10-17
3173041002,JAKARTA BARAT,TAMBORA,KALI ANYAR,23856,5292,18564,14042,32606,2021-10-17
3172041004,JAKARTA UTARA,CILINCING,KALIBARU,67684,20311,47373,32653,80026,2021-10-17
3174081002,JAKARTA SELATAN,PANCORAN,KALIBATA,41994,10615,31379,23780,55159,2021-10-17
3173061001,JAKARTA BARAT,KALI DERES,KALIDERES,72447,16640,55807,45469,101276,2021-10-17
3175051004,JAKARTA TIMUR,PASAR REBO,KALISARI,43212,8600,34612,27686,62298,2021-10-17
3173061004,JAKARTA BARAT,KALI DERES,KAMAL,53783,14123,39660,30303,69963,2021-10-17
3172011002,JAKARTA UTARA,PENJARINGAN,KAMAL MUARA,12930,2394,10536,8802,19338,2021-10-17
3171071007,JAKARTA PUSAT,TANAH ABANG,KAMPUNG BALI,11358,2677,8681,6298,14979,2021-10-17
3175031001,JAKARTA TIMUR,JATINEGARA,KAMPUNG MELAYU,25717,6708,19009,14114,33123,2021-10-17
3171081002,JAKARTA PUSAT,JOHAR BARU,KAMPUNG RAWA,21237,3765,17472,13453,30925,2021-10-17
3175041002,JAKARTA TIMUR,KRAMAT JATI,KAMPUNG TENGAH,43993,11887,32106,24182,56288,2021-10-17
3173011005,JAKARTA BARAT,CENGKARENG,KAPUK,134466,35351,99115,76380,175495,2021-10-17
3172011003,JAKARTA UTARA,PENJARINGAN,KAPUK MUARA,35781,7455,28326,24172,52498,2021-10-17
3171021002,JAKARTA PUSAT,SAWAH BESAR,KARANG ANYAR,25761,5411,20350,16348,36698,2021-10-17
3174021004,JAKARTA SELATAN,SETIA BUDI,KARET,9623,2059,7564,6003,13567,2021-10-17
3174021003,JAKARTA SELATAN,SETIA BUDI,KARET KUNINGAN,16055,3450,12605,10286,22891,2021-10-17
3174021002,JAKARTA SELATAN,SETIA BUDI,KARET SEMANGGI,2770,590,2180,1871,4051,2021-10-17
3171071003,JAKARTA PUSAT,TANAH ABANG,KARET TENGSIN,19271,4052,15219,11829,27048,2021-10-17
3171021003,JAKARTA PUSAT,SAWAH BESAR,KARTINI,22292,4728,17564,14322,31886,2021-10-17
3175011003,JAKARTA TIMUR,MATRAMAN,KAYU MANIS,25284,5905,19379,14483,33862,2021-10-17
3175021006,JAKARTA TIMUR,PULO GADUNG,KAYU PUTIH,40696,8384,32312,27194,59506,2021-10-17
3173031006,JAKARTA BARAT,TAMAN SARI,KEAGUNGAN,17387,3656,13731,10773,24504,2021-10-17
3174041007,JAKARTA SELATAN,PASAR MINGGU,KEBAGUSAN,44552,9926,34626,26748,61374,2021-10-17
3174051006,JAKARTA SELATAN,KEBAYORAN LAMA,KEBAYORAN LAMA SELATAN,41212,8470,32742,26197,58939,2021-10-17
3174051001,JAKARTA SELATAN,KEBAYORAN LAMA,KEBAYORAN LAMA UTARA,42422,9978,32444,25543,57987,2021-10-17
3174011004,JAKARTA SELATAN,TEBET,KEBON BARU,35165,7324,27841,21805,49646,2021-10-17
3172021005,JAKARTA UTARA,TANJUNG PRIOK,KEBON BAWANG,50952,11443,39509,31382,70891,2021-10-17
3173051001,JAKARTA BARAT,KEBON JERUK,KEBON JERUK,53887,12808,41079,32221,73300,2021-10-17
3171071006,JAKARTA PUSAT,TANAH ABANG,KEBON KACANG,21531,5662,15869,11993,27862,2021-10-17
3171011005,JAKARTA PUSAT,GAMBIR,KEBON KELAPA,10163,2225,7938,6374,14312,2021-10-17
3171031002,JAKARTA PUSAT,KEMAYORAN,KEBON KOSONG,30019,6623,23396,17818,41214,2021-10-17
3175011005,JAKARTA TIMUR,MATRAMAN,KEBON MANGGIS,16490,3545,12945,10251,23196,2021-10-17
3171071005,JAKARTA PUSAT,TANAH ABANG,KEBON MELATI,32206,9206,23000,16191,39191,2021-10-17
3175081003,JAKARTA TIMUR,MAKASAR,KEBON PALA,46614,10339,36275,28774,65049,2021-10-17
3171061005,JAKARTA PUSAT,MENTENG,KEBON SIRIH,12299,2863,9436,7219,16655,2021-10-17
3173011004,JAKARTA BARAT,CENGKARENG,KEDAUNG KALI ANGKE,32612,6921,25691,20717,46408,2021-10-17
3173051007,JAKARTA BARAT,KEBON JERUK,KEDOYA SELATAN,32165,6512,25653,20368,46021,2021-10-17
3173051006,JAKARTA BARAT,KEBON JERUK,KEDOYA UTARA,45740,9465,36275,29830,66105,2021-10-17
3173051004,JAKARTA BARAT,KEBON JERUK,KELAPA DUA,23565,5345,18220,14515,32735,2021-10-17
3175091003,JAKARTA TIMUR,CIRACAS,KELAPA DUA WETAN,46875,8887,37988,30491,68479,2021-10-17
3172061003,JAKARTA UTARA,KELAPA GADING,KELAPA GADING BARAT,35717,6629,29088,25568,54656,2021-10-17
3172061001,JAKARTA UTARA,KELAPA GADING,KELAPA GADING TIMUR,33592,5520,28072,25225,53297,2021-10-17
3173071005,JAKARTA BARAT,PALMERAH,KEMANGGISAN,32139,6750,25389,20204,45593,2021-10-17
3171031001,JAKARTA PUSAT,KEMAYORAN,KEMAYORAN,20708,4691,16017,12713,28730,2021-10-17
3173081006,JAKARTA BARAT,KEMBANGAN,KEMBANGAN SELATAN,27130,6283,20847,17541,38388,2021-10-17
3173081001,JAKARTA BARAT,KEMBANGAN,KEMBANGAN UTARA,54451,13111,41340,33278,74618,2021-10-17
3171041002,JAKARTA PUSAT,SENEN,KENARI,9579,2063,7516,6173,13689,2021-10-17
3173041005,JAKARTA BARAT,TAMBORA,KERENDANG,19973,4611,15362,11925,27287,2021-10-17
3175071003,JAKARTA TIMUR,DUREN SAWIT,KLENDER,69978,17940,52038,39503,91541,2021-10-17
3172031001,JAKARTA UTARA,KOJA,KOJA,28175,7003,21172,16337,37509,2021-10-17
3173071006,JAKARTA BARAT,PALMERAH,KOTA BAMBU SELATAN,21158,4864,16294,12359,28653,2021-10-17
3173071003,JAKARTA BARAT,PALMERAH,KOTA BAMBU UTARA,24995,5993,19002,14297,33299,2021-10-17
3171041004,JAKARTA PUSAT,SENEN,KRAMAT,28835,7533,21302,15614,36916,2021-10-17
3175041001,JAKARTA TIMUR,KRAMAT JATI,KRAMAT JATI,34144,8092,26052,20088,46140,2021-10-17
3174071003,JAKARTA SELATAN,KEBAYORAN BARU,KRAMAT PELA,14413,3032,11381,9256,20637,2021-10-17
3173031002,JAKARTA BARAT,TAMAN SARI,KRUKUT,19244,4072,15172,11702,26874,2021-10-17
3174031005,JAKARTA SELATAN,MAMPANG PRAPATAN,KUNINGAN BARAT,12785,2601,10184,8104,18288,2021-10-17
3174021008,JAKARTA SELATAN,SETIA BUDI,KUNINGAN TIMUR,6008,1355,4653,3817,8470,2021-10-17
3171041005,JAKARTA PUSAT,SENEN,KWITANG,15486,3848,11638,9092,20730,2021-10-17
3172031003,JAKARTA UTARA,KOJA,LAGOA,59065,15347,43718,33194,76912,2021-10-17
3174061002,JAKARTA SELATAN,CILANDAK,LEBAK BULUS,37626,7831,29795,24393,54188,2021-10-17
3174091004,JAKARTA SELATAN,JAGAKARSA,LENTENG AGUNG,53946,10936,43010,32540,75550,2021-10-17
3175101007,JAKARTA TIMUR,CIPAYUNG,LUBANG BUAYA,63547,13149,50398,40047,90445,2021-10-17
3175081001,JAKARTA TIMUR,MAKASAR,MAKASAR,34390,6974,27416,22046,49462,2021-10-17
3175071006,JAKARTA TIMUR,DUREN SAWIT,MALAKA JAYA,30927,6106,24821,20168,44989,2021-10-17
3175071005,JAKARTA TIMUR,DUREN SAWIT,MALAKA SARI,27530,5109,22421,18440,40861,2021-10-17
3174031001,JAKARTA SELATAN,MAMPANG PRAPATAN,MAMPANG PRAPATAN,18159,4142,14017,10951,24968,2021-10-17
3173031005,JAKARTA BARAT,TAMAN SARI,MANGGA BESAR,7707,1392,6315,5278,11593,2021-10-17
3171021005,JAKARTA PUSAT,SAWAH BESAR,MANGGA DUA SELATAN,27442,6165,21277,17194,38471,2021-10-17
3174011007,JAKARTA SELATAN,TEBET,MANGGARAI,28373,5644,22729,17400,40129,2021-10-17
3174011006,JAKARTA SELATAN,TEBET,MANGGARAI SELATAN,23075,4571,18504,14881,33385,2021-10-17
3173031003,JAKARTA BARAT,TAMAN SARI,MAPHAR,16461,3381,13080,10443,23523,2021-10-17
3172041003,JAKARTA UTARA,CILINCING,MARUNDA,28943,7157,21786,15871,37657,2021-10-17
3174071001,JAKARTA SELATAN,KEBAYORAN BARU,MELAWAI,2627,555,2072,1882,3954,2021-10-17
3171061001,JAKARTA PUSAT,MENTENG,MENTENG,25624,6276,19348,14565,33913,2021-10-17
3174021005,JAKARTA SELATAN,SETIA BUDI,MENTENG ATAS,27816,5602,22214,17504,39718,2021-10-17
3174011003,JAKARTA SELATAN,TEBET,MENTENG DALAM,36028,7738,28290,22520,50810,2021-10-17
3173081003,JAKARTA BARAT,KEMBANGAN,MERUYA SELATAN,32130,7305,24825,19942,44767,2021-10-17
3173081002,JAKARTA BARAT,KEMBANGAN,MERUYA UTARA,43752,10001,33751,28186,61937,2021-10-17
3175101004,JAKARTA TIMUR,CIPAYUNG,MUNJUL,23871,4705,19166,15237,34403,2021-10-17
3172051002,JAKARTA UTARA,PADEMANGAN,PADEMANGAN BARAT,74240,19002,55238,42743,97981,2021-10-17
3172051001,JAKARTA UTARA,PADEMANGAN,PADEMANGAN TIMUR,37736,7264,30472,25505,55977,2021-10-17
3175011004,JAKARTA TIMUR,MATRAMAN,PAL MERIAM,19769,4633,15136,11608,26744,2021-10-17
3173071001,JAKARTA BARAT,PALMERAH,PALMERAH,63011,14965,48046,37410,85456,2021-10-17
3174081001,JAKARTA SELATAN,PANCORAN,PANCORAN,19421,4499,14922,11900,26822,2021-10-17
3172021003,JAKARTA UTARA,TANJUNG PRIOK,PAPANGGO,39097,8628,30469,24070,54539,2021-10-17
3171021001,JAKARTA PUSAT,SAWAH BESAR,PASAR BARU,12035,2499,9536,8225,17761,2021-10-17
3174021006,JAKARTA SELATAN,SETIA BUDI,PASAR MANGGIS,26752,5980,20772,16364,37136,2021-10-17
3174041001,JAKARTA SELATAN,PASAR MINGGU,PASAR MINGGU,24821,5169,19652,15913,35565,2021-10-17
3171041003,JAKARTA PUSAT,SENEN,PASEBAN,23533,5470,18063,14209,32272,2021-10-17
3173061005,JAKARTA BARAT,KALI DERES,PEGADUNGAN,75587,16884,58703,49041,107744,2021-10-17
3171061002,JAKARTA PUSAT,MENTENG,PEGANGSAAN,23455,5643,17812,12990,30802,2021-10-17
3172061002,JAKARTA UTARA,KELAPA GADING,PEGANGSAAN DUA,49976,8839,41137,36280,77417,2021-10-17
3172011004,JAKARTA UTARA,PENJARINGAN,PEJAGALAN,74578,16875,57703,47417,105120,2021-10-17
3174041006,JAKARTA SELATAN,PASAR MINGGU,PEJATEN BARAT,37346,8278,29068,23183,52251,2021-10-17
3174041005,JAKARTA SELATAN,PASAR MINGGU,PEJATEN TIMUR,57656,14367,43289,33924,77213,2021-10-17
3175051005,JAKARTA TIMUR,PASAR REBO,PEKAYON,43250,8748,34502,27316,61818,2021-10-17
3173041009,JAKARTA BARAT,TAMBORA,PEKOJAN,23587,4941,18646,14932,33578,2021-10-17
3174031003,JAKARTA SELATAN,MAMPANG PRAPATAN,PELA MAMPANG,43522,9646,33876,26891,60767,2021-10-17
3174081005,JAKARTA SELATAN,PANCORAN,PENGADEGAN,21478,4304,17174,13764,30938,2021-10-17
3175061003,JAKARTA TIMUR,CAKUNG,PENGGILINGAN,99255,25539,73716,56255,129971,2021-10-17
3172011001,JAKARTA UTARA,PENJARINGAN,PENJARINGAN,88308,24666,63642,46929,110571,2021-10-17
3174101001,JAKARTA SELATAN,PESANGGRAHAN,PESANGGRAHAN,27545,5230,22315,18347,40662,2021-10-17
3171071004,JAKARTA PUSAT,TANAH ABANG,PETAMBURAN,33271,9505,23766,17119,40885,2021-10-17
3174071008,JAKARTA SELATAN,KEBAYORAN BARU,PETOGOGAN,11499,2492,9007,7285,16292,2021-10-17
3171011004,JAKARTA PUSAT,GAMBIR,PETOJO SELATAN,14692,3564,11128,9062,20190,2021-10-17
3171011003,JAKARTA PUSAT,GAMBIR,PETOJO UTARA,17458,4050,13408,10558,23966,2021-10-17
3174101004,JAKARTA SELATAN,PESANGGRAHAN,PETUKANGAN SELATAN,37187,8410,28777,23175,51952,2021-10-17
3174101003,JAKARTA SELATAN,PESANGGRAHAN,PETUKANGAN UTARA,53716,12787,40929,32498,73427,2021-10-17
3175081002,JAKARTA TIMUR,MAKASAR,PINANG RANTI,27198,6516,20682,16488,37170,2021-10-17
3173031008,JAKARTA BARAT,TAMAN SARI,PINANGSIA,10729,2054,8675,6915,15590,2021-10-17
3175011001,JAKARTA TIMUR,MATRAMAN,PISANGAN BARU,31776,7293,24483,18414,42897,2021-10-17
3175021002,JAKARTA TIMUR,PULO GADUNG,PISANGAN TIMUR,41011,8546,32465,26190,58655,2021-10-17
3172011005,JAKARTA UTARA,PENJARINGAN,PLUIT,47783,9927,37856,31972,69828,2021-10-17
3175071002,JAKARTA TIMUR,DUREN SAWIT,PONDOK BAMBU,61550,14326,47224,37001,84225,2021-10-17
3175071004,JAKARTA TIMUR,DUREN SAWIT,PONDOK KELAPA,72015,15636,56379,46326,102705,2021-10-17
3175071007,JAKARTA TIMUR,DUREN SAWIT,PONDOK KOPI,35367,7627,27740,20815,48555,2021-10-17
3174061003,JAKARTA SELATAN,CILANDAK,PONDOK LABU,46464,8869,37595,31262,68857,2021-10-17
3174051002,JAKARTA SELATAN,KEBAYORAN LAMA,PONDOK PINANG,56169,11643,44526,35746,80272,2021-10-17
3175101003,JAKARTA TIMUR,CIPAYUNG,PONDOK RANGGON,25574,5235,20339,15914,36253,2021-10-17
3101011003,KAB.ADM.KEP.SERIBU,KEP. SERIBU UTARA,PULAU HARAPAN,2060,238,1822,1556,3378,2021-10-17
3101011002,KAB.ADM.KEP.SERIBU,KEP. SERIBU UTARA,PULAU KELAPA,5528,644,4884,3935,8819,2021-10-17
3101011001,KAB.ADM.KEP.SERIBU,KEP. SERIBU UTARA,PULAU PANGGANG,5450,485,4965,4358,9323,2021-10-17
3101021003,KAB.ADM.KEP.SERIBU,KEP. SERIBU SELATAN,PULAU PARI,2765,204,2561,2368,4929,2021-10-17
3101021002,KAB.ADM.KEP.SERIBU,KEP. SERIBU SELATAN,PULAU TIDUNG,4553,405,4148,3718,7866,2021-10-17
3101021001,KAB.ADM.KEP.SERIBU,KEP. SERIBU SELATAN,PULAU UNTUNG JAWA,1941,177,1764,1606,3370,2021-10-17
3174071007,JAKARTA SELATAN,KEBAYORAN BARU,PULO,5835,1090,4745,4147,8892,2021-10-17
3175021001,JAKARTA TIMUR,PULO GADUNG,PULO GADUNG,34422,8150,26272,20958,47230,2021-10-17
3175061005,JAKARTA TIMUR,CAKUNG,PULO GEBANG,97301,20587,76714,59587,136301,2021-10-17
3174041004,JAKARTA SELATAN,PASAR MINGGU,RAGUNAN,39616,8215,31401,25544,56945,2021-10-17
3175091005,JAKARTA TIMUR,CIRACAS,RAMBUTAN,36771,9406,27365,20691,48056,2021-10-17
3172031006,JAKARTA UTARA,KOJA,RAWA BADAK SELATAN,42179,10907,31272,23691,54963,2021-10-17
3172031004,JAKARTA UTARA,KOJA,RAWA BADAK UTARA,34408,8447,25961,19964,45925,2021-10-17
3174071005,JAKARTA SELATAN,KEBAYORAN BARU,RAWA BARAT,5625,1065,4560,3875,8435,2021-10-17
3173011003,JAKARTA BARAT,CENGKARENG,RAWA BUAYA,63799,14294,49505,37854,87359,2021-10-17
3175031004,JAKARTA TIMUR,JATINEGARA,RAWA BUNGA,21434,5645,15789,12131,27920,2021-10-17
3174081003,JAKARTA SELATAN,PANCORAN,RAWA JATI,20509,4312,16197,12959,29156,2021-10-17
3175061002,JAKARTA TIMUR,CAKUNG,RAWA TERATE,24637,4991,19646,15487,35133,2021-10-17
3175021005,JAKARTA TIMUR,PULO GADUNG,RAWAMANGUN,37612,8239,29373,23767,53140,2021-10-17
3171051003,JAKARTA PUSAT,CEMPAKA PUTIH,RAWASARI,21967,4933,17034,13821,30855,2021-10-17
3173041010,JAKARTA BARAT,TAMBORA,ROA MALAKA,3484,648,2836,2435,5271,2021-10-17
3172041006,JAKARTA UTARA,CILINCING,ROROTAN,41668,9124,32544,25147,57691,2021-10-17
3174071004,JAKARTA SELATAN,KEBAYORAN BARU,SELONG,2842,577,2265,2024,4289,2021-10-17
3173061002,JAKARTA BARAT,KALI DERES,SEMANAN,71354,17548,53806,42094,95900,2021-10-17
3172041007,JAKARTA UTARA,CILINCING,SEMPER BARAT,68587,14708,53879,43113,96992,2021-10-17
3172041005,JAKARTA UTARA,CILINCING,SEMPER TIMUR,36267,8473,27794,21625,49419,2021-10-17
3174071006,JAKARTA SELATAN,KEBAYORAN BARU,SENAYAN,2771,691,2080,1714,3794,2021-10-17
3171041001,JAKARTA PUSAT,SENEN,SENEN,6804,1606,5198,4225,9423,2021-10-17
3171031004,JAKARTA PUSAT,KEMAYORAN,SERDANG,29668,6482,23186,18388,41574,2021-10-17
3174021001,JAKARTA SELATAN,SETIA BUDI,SETIA BUDI,3023,685,2338,1894,4232,2021-10-17
3175101005,JAKARTA TIMUR,CIPAYUNG,SETU,20572,4563,16009,12272,28281,2021-10-17
3173071002,JAKARTA BARAT,PALMERAH,SLIPI,16591,3302,13289,10677,23966,2021-10-17
3173081004,JAKARTA BARAT,KEMBANGAN,SRENGSENG,45523,11196,34327,27914,62241,2021-10-17
3174091002,JAKARTA SELATAN,JAGAKARSA,SRENGSENG SAWAH,58196,10299,47897,38954,86851,2021-10-17
3173051003,JAKARTA BARAT,KEBON JERUK,SUKABUMI SELATAN,37033,9248,27785,20675,48460,2021-10-17
3173051002,JAKARTA BARAT,KEBON JERUK,SUKABUMI UTARA,38290,9868,28422,21274,49696,2021-10-17
3172041002,JAKARTA UTARA,CILINCING,SUKAPURA,53949,13262,40687,32279,72966,2021-10-17
3171031007,JAKARTA PUSAT,KEMAYORAN,SUMUR BATU,22717,5040,17677,14396,32073,2021-10-17
3172021004,JAKARTA UTARA,TANJUNG PRIOK,SUNGAI BAMBU,29876,6650,23226,18410,41636,2021-10-17
3172021006,JAKARTA UTARA,TANJUNG PRIOK,SUNTER AGUNG,71805,13545,58260,49113,107373,2021-10-17
3172021002,JAKARTA UTARA,TANJUNG PRIOK,SUNTER JAYA,63031,12057,50974,42236,93210,2021-10-17
3175091004,JAKARTA TIMUR,CIRACAS,SUSUKAN,38257,7858,30399,24207,54606,2021-10-17
3173031001,JAKARTA BARAT,TAMAN SARI,TAMAN SARI,14348,2858,11490,9528,21018,2021-10-17
3173041001,JAKARTA BARAT,TAMBORA,TAMBORA,10204,2484,7720,6000,13720,2021-10-17
3173041004,JAKARTA BARAT,TAMBORA,TANAH SEREAL,26387,4864,21523,17370,38893,2021-10-17
3171081004,JAKARTA PUSAT,JOHAR BARU,TANAH TINGGI,37693,7700,29993,23482,53475,2021-10-17
3173031004,JAKARTA BARAT,TAMAN SARI,TANGKI,13324,2461,10863,8693,19556,2021-10-17
3174091005,JAKARTA SELATAN,JAGAKARSA,TANJUNG BARAT,39770,7384,32386,25021,57407,2021-10-17
3173021005,JAKARTA BARAT,GROGOL PETAMBURAN,TANJUNG DUREN SELATAN,25337,5330,20007,16907,36914,2021-10-17
3173021002,JAKARTA BARAT,GROGOL PETAMBURAN,TANJUNG DUREN UTARA,17010,3149,13861,11798,25659,2021-10-17
3172021001,JAKARTA UTARA,TANJUNG PRIOK,TANJUNG PRIOK,34588,7780,26808,21126,47934,2021-10-17
3174011002,JAKARTA SELATAN,TEBET,TEBET BARAT,21194,3829,17365,14663,32028,2021-10-17
3174011001,JAKARTA SELATAN,TEBET,TEBET TIMUR,18199,3198,15001,12932,27933,2021-10-17
3173061003,JAKARTA BARAT,KALI DERES,TEGAL ALUR,83647,19622,64025,50794,114819,2021-10-17
3174031004,JAKARTA SELATAN,MAMPANG PRAPATAN,TEGAL PARANG,32401,7925,24476,17827,42303,2021-10-17
3173021003,JAKARTA BARAT,GROGOL PETAMBURAN,TOMANG,29605,5952,23653,19345,42998,2021-10-17
3172031005,JAKARTA UTARA,KOJA,TUGU SELATAN,39122,9516,29606,22934,52540,2021-10-17
3172031002,JAKARTA UTARA,KOJA,TUGU UTARA,67670,17395,50275,38080,88355,2021-10-17
3175061006,JAKARTA TIMUR,CAKUNG,UJUNG MENTENG,29934,5657,24277,19803,44080,2021-10-17
3174101005,JAKARTA SELATAN,PESANGGRAHAN,ULUJAMI,40544,10148,30396,23688,54084,2021-10-17
3175011006,JAKARTA TIMUR,MATRAMAN,UTAN KAYU SELATAN,33511,6766,26745,20975,47720,2021-10-17
3175011002,JAKARTA TIMUR,MATRAMAN,UTAN KAYU UTARA,28169,6486,21683,16933,38616,2021-10-17
3171031008,JAKARTA PUSAT,KEMAYORAN,UTAN PANJANG,29208,6487,22721,17239,39960,2021-10-17
3172021007,JAKARTA UTARA,TANJUNG PRIOK,WARAKAS,44401,8924,35477,27257,62734,2021-10-17
3173021007,JAKARTA BARAT,GROGOL PETAMBURAN,WIJAYA KUSUMA,38934,9056,29878,24017,53895,2021-10-17
3172051003,JAKARTA UTARA,PADEMANGAN,ANCOL,23947,6223,17724,14033,31757,2021-10-18
3173041007,JAKARTA BARAT,TAMBORA,ANGKE,29381,6925,22456,17511,39967,2021-10-18
3175041005,JAKARTA TIMUR,KRAMAT JATI,BALE KAMBANG,29074,7941,21133,15563,36696,2021-10-18
3175031003,JAKARTA TIMUR,JATINEGARA,BALI MESTER,9752,2244,7508,6006,13514,2021-10-18
3175101006,JAKARTA TIMUR,CIPAYUNG,BAMBU APUS,26285,5314,20971,16240,37211,2021-10-18
3174031002,JAKARTA SELATAN,MAMPANG PRAPATAN,BANGKA,21566,5083,16483,12941,29424,2021-10-18
3175051002,JAKARTA TIMUR,PASAR REBO,BARU,23886,4346,19540,16215,35755,2021-10-18
3175041004,JAKARTA TIMUR,KRAMAT JATI,BATU AMPAR,47898,12796,35102,26497,61599,2021-10-18
3171071002,JAKARTA PUSAT,TANAH ABANG,BENDUNGAN HILIR,21494,4689,16805,13625,30430,2021-10-18
3175031002,JAKARTA TIMUR,JATINEGARA,BIDARA CINA,36689,9611,27078,20486,47564,2021-10-18
3174101002,JAKARTA SELATAN,PESANGGRAHAN,BINTARO,53098,11735,41363,33813,75176,2021-10-18
3174011005,JAKARTA SELATAN,TEBET,BUKIT DURI,34183,7839,26344,20841,47185,2021-10-18
3171041006,JAKARTA PUSAT,SENEN,BUNGUR,18144,4228,13916,11189,25105,2021-10-18
3175061007,JAKARTA TIMUR,CAKUNG,CAKUNG BARAT,57724,13041,44683,35713,80396,2021-10-18
3175061004,JAKARTA TIMUR,CAKUNG,CAKUNG TIMUR,58287,12569,45718,36322,82040,2021-10-18
3175041007,JAKARTA TIMUR,KRAMAT JATI,CAWANG,32762,7945,24817,18815,43632,2021-10-18
3175101008,JAKARTA TIMUR,CIPAYUNG,CEGER,18932,4071,14861,11830,26691,2021-10-18
3171031006,JAKARTA PUSAT,KEMAYORAN,CEMPAKA BARU,32581,7520,25061,18958,44019,2021-10-18
3171051002,JAKARTA PUSAT,CEMPAKA PUTIH,CEMPAKA PUTIH BARAT,35885,8402,27483,22269,49752,2021-10-18
3171051001,JAKARTA PUSAT,CEMPAKA PUTIH,CEMPAKA PUTIH TIMUR,24292,5436,18856,15688,34544,2021-10-18
3173011001,JAKARTA BARAT,CENGKARENG,CENGKARENG BARAT,66284,14956,51328,41592,92920,2021-10-18
3173011006,JAKARTA BARAT,CENGKARENG,CENGKARENG TIMUR,81027,17636,63391,49785,113176,2021-10-18
3175091002,JAKARTA TIMUR,CIRACAS,CIBUBUR,66364,12431,53933,43086,97019,2021-10-18
3171011002,JAKARTA PUSAT,GAMBIR,CIDENG,15390,3220,12170,10213,22383,2021-10-18
3174091003,JAKARTA SELATAN,JAGAKARSA,CIGANJUR,38497,7406,31091,23876,54967,2021-10-18
3175051003,JAKARTA TIMUR,PASAR REBO,CIJANTUNG,41419,8438,32981,26241,59222,2021-10-18
3171061003,JAKARTA PUSAT,MENTENG,CIKINI,8274,1590,6684,5041,11725,2021-10-18
3174081006,JAKARTA SELATAN,PANCORAN,CIKOKO,10547,1981,8566,7073,15639,2021-10-18
3174061001,JAKARTA SELATAN,CILANDAK,CILANDAK BARAT,51752,10287,41465,34234,75699,2021-10-18
3174041003,JAKARTA SELATAN,PASAR MINGGU,CILANDAK TIMUR,25145,5179,19966,16242,36208,2021-10-18
3175101002,JAKARTA TIMUR,CIPAYUNG,CILANGKAP,27635,5315,22320,17720,40040,2021-10-18
3175041006,JAKARTA TIMUR,KRAMAT JATI,CILILITAN,40181,9871,30310,23363,53673,2021-10-18
3172041001,JAKARTA UTARA,CILINCING,CILINCING,43609,11409,32200,23951,56151,2021-10-18
3175101001,JAKARTA TIMUR,CIPAYUNG,CIPAYUNG,26104,4969,21135,17389,38524,2021-10-18
3174091006,JAKARTA SELATAN,JAGAKARSA,CIPEDAK,38303,7283,31020,24739,55759,2021-10-18
3174061005,JAKARTA SELATAN,CILANDAK,CIPETE SELATAN,26704,5626,21078,17470,38548,2021-10-18
3174071010,JAKARTA SELATAN,KEBAYORAN BARU,CIPETE UTARA,34102,7101,27001,21006,48007,2021-10-18
3175021003,JAKARTA TIMUR,PULO GADUNG,CIPINANG,39306,8187,31119,24529,55648,2021-10-18
3175031007,JAKARTA TIMUR,JATINEGARA,CIPINANG BESAR SELATAN,35212,9140,26072,19317,45389,2021-10-18
3175031008,JAKARTA TIMUR,JATINEGARA,CIPINANG BESAR UTARA,45319,11777,33542,24642,58184,2021-10-18
3175031005,JAKARTA TIMUR,JATINEGARA,CIPINANG CEMPEDAK,32824,7770,25054,19831,44885,2021-10-18
3175081005,JAKARTA TIMUR,MAKASAR,CIPINANG MELAYU,42308,8964,33344,26769,60113,2021-10-18
3175031006,JAKARTA TIMUR,JATINEGARA,CIPINANG MUARA,55243,13169,42074,32523,74597,2021-10-18
3174051003,JAKARTA SELATAN,KEBAYORAN LAMA,CIPULIR,39937,9218,30719,23463,54182,2021-10-18
3175091001,JAKARTA TIMUR,CIRACAS,CIRACAS,64594,12962,51632,40454,92086,2021-10-18
3175041003,JAKARTA TIMUR,KRAMAT JATI,DUKUH,24609,5100,19509,15240,34749,2021-10-18
3175071001,JAKARTA TIMUR,DUREN SAWIT,DUREN SAWIT,61160,14192,46968,36583,83551,2021-10-18
3174081004,JAKARTA SELATAN,PANCORAN,DUREN TIGA,28319,6174,22145,17368,39513,2021-10-18
3173051005,JAKARTA BARAT,KEBON JERUK,DURI KEPA,60138,12844,47294,39554,86848,2021-10-18
3173011002,JAKARTA BARAT,CENGKARENG,DURI KOSAMBI,77923,18872,59051,45229,104280,2021-10-18
3171011006,JAKARTA PUSAT,GAMBIR,DURI PULO,19610,4519,15091,11664,26755,2021-10-18
3173041011,JAKARTA BARAT,TAMBORA,DURI SELATAN,14259,2742,11517,9341,20858,2021-10-18
3173041003,JAKARTA BARAT,TAMBORA,DURI UTARA,19844,4045,15799,12514,28313,2021-10-18
3171081003,JAKARTA PUSAT,JOHAR BARU,GALUR,18243,3914,14329,11214,25543,2021-10-18
3171011001,JAKARTA PUSAT,GAMBIR,GAMBIR,2191,490,1701,1412,3113,2021-10-18
3174061004,JAKARTA SELATAN,CILANDAK,GANDARIA SELATAN,22119,4752,17367,13962,31329,2021-10-18
3174071009,JAKARTA SELATAN,KEBAYORAN BARU,GANDARIA UTARA,39922,8793,31129,24761,55890,2021-10-18
3175051001,JAKARTA TIMUR,PASAR REBO,GEDONG,35755,7797,27958,22510,50468,2021-10-18
3171071001,JAKARTA PUSAT,TANAH ABANG,GELORA,3127,669,2458,2031,4489,2021-10-18
3173031007,JAKARTA BARAT,TAMAN SARI,GLODOK,7837,1346,6491,5650,12141,2021-10-18
3171061004,JAKARTA PUSAT,MENTENG,GONDANGDIA,4100,967,3133,2788,5921,2021-10-18
3173021001,JAKARTA BARAT,GROGOL PETAMBURAN,GROGOL,16876,3677,13199,10632,23831,2021-10-18
3174051005,JAKARTA SELATAN,KEBAYORAN LAMA,GROGOL SELATAN,44251,10047,34204,26786,60990,2021-10-18
3174051004,JAKARTA SELATAN,KEBAYORAN LAMA,GROGOL UTARA,42494,9605,32889,26165,59054,2021-10-18
3174021007,JAKARTA SELATAN,SETIA BUDI,GUNTUR,3985,814,3171,2699,5870,2021-10-18
3174071002,JAKARTA SELATAN,KEBAYORAN BARU,GUNUNG,9436,1895,7541,6311,13852,2021-10-18
3171031005,JAKARTA PUSAT,KEMAYORAN,GUNUNG SAHARI SELATAN,19199,4295,14904,11995,26899,2021-10-18
3171021004,JAKARTA PUSAT,SAWAH BESAR,GUNUNG SAHARI UTARA,16650,3193,13457,11523,24980,2021-10-18
3175081004,JAKARTA TIMUR,MAKASAR,HALIM PERDANA KUSUMAH,28363,4093,24270,21625,45895,2021-10-18
3171031003,JAKARTA PUSAT,KEMAYORAN,HARAPAN MULIA,22557,5022,17535,13537,31072,2021-10-18
3174091001,JAKARTA SELATAN,JAGAKARSA,JAGAKARSA,62389,12004,50385,39922,90307,2021-10-18
3175021007,JAKARTA TIMUR,PULO GADUNG,JATI,32757,6821,25936,21442,47378,2021-10-18
3174041002,JAKARTA SELATAN,PASAR MINGGU,JATI PADANG,37502,8294,29208,23416,52624,2021-10-18
3173071004,JAKARTA BARAT,PALMERAH,JATI PULO,28738,6301,22437,17259,39696,2021-10-18
3175061001,JAKARTA TIMUR,CAKUNG,JATINEGARA,84160,19887,64273,50842,115115,2021-10-18
3175021004,JAKARTA TIMUR,PULO GADUNG,JATINEGARA KAUM,24632,4893,19739,15144,34883,2021-10-18
3173021004,JAKARTA BARAT,GROGOL PETAMBURAN,JELAMBAR,30266,6081,24185,19959,44144,2021-10-18
3173021006,JAKARTA BARAT,GROGOL PETAMBURAN,JELAMBAR BARU,38246,7888,30358,25089,55447,2021-10-18
3173041006,JAKARTA BARAT,TAMBORA,JEMBATAN BESI,29314,7792,21522,16036,37558,2021-10-18
3173041008,JAKARTA BARAT,TAMBORA,JEMBATAN LIMA,21021,5431,15590,11805,27395,2021-10-18
3173081005,JAKARTA BARAT,KEMBANGAN,JOGLO,40839,9111,31728,25853,57581,2021-10-18
3171081001,JAKARTA PUSAT,JOHAR BARU,JOHAR BARU,37488,7480,30008,24391,54399,2021-10-18
3173041002,JAKARTA BARAT,TAMBORA,KALI ANYAR,23856,5229,18627,14093,32720,2021-10-18
3172041004,JAKARTA UTARA,CILINCING,KALIBARU,67684,20167,47517,32790,80307,2021-10-18
3174081002,JAKARTA SELATAN,PANCORAN,KALIBATA,41994,10602,31392,23800,55192,2021-10-18
3173061001,JAKARTA BARAT,KALI DERES,KALIDERES,72447,16606,55841,45518,101359,2021-10-18
3175051004,JAKARTA TIMUR,PASAR REBO,KALISARI,43212,8595,34617,27704,62321,2021-10-18
3173061004,JAKARTA BARAT,KALI DERES,KAMAL,53783,14073,39710,30385,70095,2021-10-18
3172011002,JAKARTA UTARA,PENJARINGAN,KAMAL MUARA,12930,2394,10536,8803,19339,2021-10-18
3171071007,JAKARTA PUSAT,TANAH ABANG,KAMPUNG BALI,11358,2670,8688,6299,14987,2021-10-18
3175031001,JAKARTA TIMUR,JATINEGARA,KAMPUNG MELAYU,25717,6703,19014,14122,33136,2021-10-18
3171081002,JAKARTA PUSAT,JOHAR BARU,KAMPUNG RAWA,21237,3762,17475,13457,30932,2021-10-18
3175041002,JAKARTA TIMUR,KRAMAT JATI,KAMPUNG TENGAH,43993,11879,32114,24198,56312,2021-10-18
3173011005,JAKARTA BARAT,CENGKARENG,KAPUK,134466,35308,99158,76483,175641,2021-10-18
3172011003,JAKARTA UTARA,PENJARINGAN,KAPUK MUARA,35781,7450,28331,24175,52506,2021-10-18
3171021002,JAKARTA PUSAT,SAWAH BESAR,KARANG ANYAR,25761,5407,20354,16357,36711,2021-10-18
3174021004,JAKARTA SELATAN,SETIA BUDI,KARET,9623,2053,7570,6011,13581,2021-10-18
3174021003,JAKARTA SELATAN,SETIA BUDI,KARET KUNINGAN,16055,3445,12610,10294,22904,2021-10-18
3174021002,JAKARTA SELATAN,SETIA BUDI,KARET SEMANGGI,2770,590,2180,1872,4052,2021-10-18
3171071003,JAKARTA PUSAT,TANAH ABANG,KARET TENGSIN,19271,4050,15221,11837,27058,2021-10-18
3171021003,JAKARTA PUSAT,SAWAH BESAR,KARTINI,22292,4718,17574,14336,31910,2021-10-18
3175011003,JAKARTA TIMUR,MATRAMAN,KAYU MANIS,25284,5869,19415,14518,33933,2021-10-18
3175021006,JAKARTA TIMUR,PULO GADUNG,KAYU PUTIH,40696,8378,32318,27201,59519,2021-10-18
3173031006,JAKARTA BARAT,TAMAN SARI,KEAGUNGAN,17387,3652,13735,10783,24518,2021-10-18
3174041007,JAKARTA SELATAN,PASAR MINGGU,KEBAGUSAN,44552,9853,34699,27032,61731,2021-10-18
3174051006,JAKARTA SELATAN,KEBAYORAN LAMA,KEBAYORAN LAMA SELATAN,41212,8464,32748,26217,58965,2021-10-18
3174051001,JAKARTA SELATAN,KEBAYORAN LAMA,KEBAYORAN LAMA UTARA,42422,9839,32583,25623,58206,2021-10-18
3174011004,JAKARTA SELATAN,TEBET,KEBON BARU,35165,7318,27847,21839,49686,2021-10-18
3172021005,JAKARTA UTARA,TANJUNG PRIOK,KEBON BAWANG,50952,11290,39662,31549,71211,2021-10-18
3173051001,JAKARTA BARAT,KEBON JERUK,KEBON JERUK,53887,12779,41108,32290,73398,2021-10-18
3171071006,JAKARTA PUSAT,TANAH ABANG,KEBON KACANG,21531,5655,15876,12007,27883,2021-10-18
3171011005,JAKARTA PUSAT,GAMBIR,KEBON KELAPA,10163,2221,7942,6378,14320,2021-10-18
3171031002,JAKARTA PUSAT,KEMAYORAN,KEBON KOSONG,30019,6621,23398,17828,41226,2021-10-18
3175011005,JAKARTA TIMUR,MATRAMAN,KEBON MANGGIS,16490,3542,12948,10265,23213,2021-10-18
3171071005,JAKARTA PUSAT,TANAH ABANG,KEBON MELATI,32206,9198,23008,16209,39217,2021-10-18
3175081003,JAKARTA TIMUR,MAKASAR,KEBON PALA,46614,10332,36282,28792,65074,2021-10-18
3171061005,JAKARTA PUSAT,MENTENG,KEBON SIRIH,12299,2862,9437,7232,16669,2021-10-18
3173011004,JAKARTA BARAT,CENGKARENG,KEDAUNG KALI ANGKE,32612,6917,25695,20729,46424,2021-10-18
3173051007,JAKARTA BARAT,KEBON JERUK,KEDOYA SELATAN,32165,6489,25676,20417,46093,2021-10-18
3173051006,JAKARTA BARAT,KEBON JERUK,KEDOYA UTARA,45740,9445,36295,29859,66154,2021-10-18
3173051004,JAKARTA BARAT,KEBON JERUK,KELAPA DUA,23565,5340,18225,14524,32749,2021-10-18
3175091003,JAKARTA TIMUR,CIRACAS,KELAPA DUA WETAN,46875,8878,37997,30509,68506,2021-10-18
3172061003,JAKARTA UTARA,KELAPA GADING,KELAPA GADING BARAT,35717,6617,29100,25583,54683,2021-10-18
3172061001,JAKARTA UTARA,KELAPA GADING,KELAPA GADING TIMUR,33592,5518,28074,25235,53309,2021-10-18
3173071005,JAKARTA BARAT,PALMERAH,KEMANGGISAN,32139,6744,25395,20218,45613,2021-10-18
3171031001,JAKARTA PUSAT,KEMAYORAN,KEMAYORAN,20708,4686,16022,12726,28748,2021-10-18
3173081006,JAKARTA BARAT,KEMBANGAN,KEMBANGAN SELATAN,27130,6283,20847,17546,38393,2021-10-18
3173081001,JAKARTA BARAT,KEMBANGAN,KEMBANGAN UTARA,54451,13103,41348,33301,74649,2021-10-18
3171041002,JAKARTA PUSAT,SENEN,KENARI,9579,2058,7521,6177,13698,2021-10-18
3173041005,JAKARTA BARAT,TAMBORA,KERENDANG,19973,4610,15363,11933,27296,2021-10-18
3175071003,JAKARTA TIMUR,DUREN SAWIT,KLENDER,69978,17929,52049,39522,91571,2021-10-18
3172031001,JAKARTA UTARA,KOJA,KOJA,28175,6993,21182,16350,37532,2021-10-18
3173071006,JAKARTA BARAT,PALMERAH,KOTA BAMBU SELATAN,21158,4859,16299,12367,28666,2021-10-18
3173071003,JAKARTA BARAT,PALMERAH,KOTA BAMBU UTARA,24995,5987,19008,14309,33317,2021-10-18
3171041004,JAKARTA PUSAT,SENEN,KRAMAT,28835,7525,21310,15631,36941,2021-10-18
3175041001,JAKARTA TIMUR,KRAMAT JATI,KRAMAT JATI,34144,8086,26058,20102,46160,2021-10-18
3174071003,JAKARTA SELATAN,KEBAYORAN BARU,KRAMAT PELA,14413,3030,11383,9260,20643,2021-10-18
3173031002,JAKARTA BARAT,TAMAN SARI,KRUKUT,19244,4069,15175,11711,26886,2021-10-18
3174031005,JAKARTA SELATAN,MAMPANG PRAPATAN,KUNINGAN BARAT,12785,2601,10184,8110,18294,2021-10-18
3174021008,JAKARTA SELATAN,SETIA BUDI,KUNINGAN TIMUR,6008,1353,4655,3820,8475,2021-10-18
3171041005,JAKARTA PUSAT,SENEN,KWITANG,15486,3843,11643,9098,20741,2021-10-18
3172031003,JAKARTA UTARA,KOJA,LAGOA,59065,15341,43724,33213,76937,2021-10-18
3174061002,JAKARTA SELATAN,CILANDAK,LEBAK BULUS,37626,7821,29805,24421,54226,2021-10-18
3174091004,JAKARTA SELATAN,JAGAKARSA,LENTENG AGUNG,53946,10909,43037,32596,75633,2021-10-18
3175101007,JAKARTA TIMUR,CIPAYUNG,LUBANG BUAYA,63547,13134,50413,40066,90479,2021-10-18
3175081001,JAKARTA TIMUR,MAKASAR,MAKASAR,34390,6968,27422,22053,49475,2021-10-18
3175071006,JAKARTA TIMUR,DUREN SAWIT,MALAKA JAYA,30927,6099,24828,20180,45008,2021-10-18
3175071005,JAKARTA TIMUR,DUREN SAWIT,MALAKA SARI,27530,5101,22429,18448,40877,2021-10-18
3174031001,JAKARTA SELATAN,MAMPANG PRAPATAN,MAMPANG PRAPATAN,18159,4136,14023,10959,24982,2021-10-18
3173031005,JAKARTA BARAT,TAMAN SARI,MANGGA BESAR,7707,1391,6316,5284,11600,2021-10-18
3171021005,JAKARTA PUSAT,SAWAH BESAR,MANGGA DUA SELATAN,27442,6156,21286,17204,38490,2021-10-18
3174011007,JAKARTA SELATAN,TEBET,MANGGARAI,28373,5641,22732,17423,40155,2021-10-18
3174011006,JAKARTA SELATAN,TEBET,MANGGARAI SELATAN,23075,4561,18514,14896,33410,2021-10-18
3173031003,JAKARTA BARAT,TAMAN SARI,MAPHAR,16461,3378,13083,10455,23538,2021-10-18
3172041003,JAKARTA UTARA,CILINCING,MARUNDA,28943,7153,21790,15874,37664,2021-10-18
3174071001,JAKARTA SELATAN,KEBAYORAN BARU,MELAWAI,2627,555,2072,1883,3955,2021-10-18
3171061001,JAKARTA PUSAT,MENTENG,MENTENG,25624,6265,19359,14595,33954,2021-10-18
3174021005,JAKARTA SELATAN,SETIA BUDI,MENTENG ATAS,27816,5597,22219,17514,39733,2021-10-18
3174011003,JAKARTA SELATAN,TEBET,MENTENG DALAM,36028,7734,28294,22539,50833,2021-10-18
3173081003,JAKARTA BARAT,KEMBANGAN,MERUYA SELATAN,32130,7299,24831,19955,44786,2021-10-18
3173081002,JAKARTA BARAT,KEMBANGAN,MERUYA UTARA,43752,9992,33760,28201,61961,2021-10-18
3175101004,JAKARTA TIMUR,CIPAYUNG,MUNJUL,23871,4700,19171,15249,34420,2021-10-18
3172051002,JAKARTA UTARA,PADEMANGAN,PADEMANGAN BARAT,74240,18989,55251,42759,98010,2021-10-18
3172051001,JAKARTA UTARA,PADEMANGAN,PADEMANGAN TIMUR,37736,7258,30478,25527,56005,2021-10-18
3175011004,JAKARTA TIMUR,MATRAMAN,PAL MERIAM,19769,4627,15142,11623,26765,2021-10-18
3173071001,JAKARTA BARAT,PALMERAH,PALMERAH,63011,14945,48066,37463,85529,2021-10-18
3174081001,JAKARTA SELATAN,PANCORAN,PANCORAN,19421,4494,14927,11907,26834,2021-10-18
3172021003,JAKARTA UTARA,TANJUNG PRIOK,PAPANGGO,39097,8613,30484,24094,54578,2021-10-18
3171021001,JAKARTA PUSAT,SAWAH BESAR,PASAR BARU,12035,2497,9538,8231,17769,2021-10-18
3174021006,JAKARTA SELATAN,SETIA BUDI,PASAR MANGGIS,26752,5970,20782,16391,37173,2021-10-18
3174041001,JAKARTA SELATAN,PASAR MINGGU,PASAR MINGGU,24821,5160,19661,15922,35583,2021-10-18
3171041003,JAKARTA PUSAT,SENEN,PASEBAN,23533,5468,18065,14218,32283,2021-10-18
3173061005,JAKARTA BARAT,KALI DERES,PEGADUNGAN,75587,16856,58731,49089,107820,2021-10-18
3171061002,JAKARTA PUSAT,MENTENG,PEGANGSAAN,23455,5638,17817,12999,30816,2021-10-18
3172061002,JAKARTA UTARA,KELAPA GADING,PEGANGSAAN DUA,49976,8834,41142,36283,77425,2021-10-18
3172011004,JAKARTA UTARA,PENJARINGAN,PEJAGALAN,74578,16862,57716,47472,105188,2021-10-18
3174041006,JAKARTA SELATAN,PASAR MINGGU,PEJATEN BARAT,37346,8266,29080,23192,52272,2021-10-18
3174041005,JAKARTA SELATAN,PASAR MINGGU,PEJATEN TIMUR,57656,14295,43361,34015,77376,2021-10-18
3175051005,JAKARTA TIMUR,PASAR REBO,PEKAYON,43250,8737,34513,27332,61845,2021-10-18
3173041009,JAKARTA BARAT,TAMBORA,PEKOJAN,23587,4889,18698,15077,33775,2021-10-18
3174031003,JAKARTA SELATAN,MAMPANG PRAPATAN,PELA MAMPANG,43522,9629,33893,26916,60809,2021-10-18
3174081005,JAKARTA SELATAN,PANCORAN,PENGADEGAN,21478,4303,17175,13772,30947,2021-10-18
3175061003,JAKARTA TIMUR,CAKUNG,PENGGILINGAN,99255,25523,73732,56286,130018,2021-10-18
3172011001,JAKARTA UTARA,PENJARINGAN,PENJARINGAN,88308,24644,63664,46989,110653,2021-10-18
3174101001,JAKARTA SELATAN,PESANGGRAHAN,PESANGGRAHAN,27545,5229,22316,18355,40671,2021-10-18
3171071004,JAKARTA PUSAT,TANAH ABANG,PETAMBURAN,33271,9497,23774,17135,40909,2021-10-18
3174071008,JAKARTA SELATAN,KEBAYORAN BARU,PETOGOGAN,11499,2487,9012,7295,16307,2021-10-18
3171011004,JAKARTA PUSAT,GAMBIR,PETOJO SELATAN,14692,3559,11133,9066,20199,2021-10-18
3171011003,JAKARTA PUSAT,GAMBIR,PETOJO UTARA,17458,4046,13412,10566,23978,2021-10-18
3174101004,JAKARTA SELATAN,PESANGGRAHAN,PETUKANGAN SELATAN,37187,8408,28779,23185,51964,2021-10-18
3174101003,JAKARTA SELATAN,PESANGGRAHAN,PETUKANGAN UTARA,53716,12779,40937,32513,73450,2021-10-18
3175081002,JAKARTA TIMUR,MAKASAR,PINANG RANTI,27198,6511,20687,16498,37185,2021-10-18
3173031008,JAKARTA BARAT,TAMAN SARI,PINANGSIA,10729,2053,8676,6919,15595,2021-10-18
3175011001,JAKARTA TIMUR,MATRAMAN,PISANGAN BARU,31776,7231,24545,18479,43024,2021-10-18
3175021002,JAKARTA TIMUR,PULO GADUNG,PISANGAN TIMUR,41011,8541,32470,26215,58685,2021-10-18
3172011005,JAKARTA UTARA,PENJARINGAN,PLUIT,47783,9923,37860,31984,69844,2021-10-18
3175071002,JAKARTA TIMUR,DUREN SAWIT,PONDOK BAMBU,61550,14312,47238,37015,84253,2021-10-18
3175071004,JAKARTA TIMUR,DUREN SAWIT,PONDOK KELAPA,72015,15627,56388,46347,102735,2021-10-18
3175071007,JAKARTA TIMUR,DUREN SAWIT,PONDOK KOPI,35367,7625,27742,20822,48564,2021-10-18
3174061003,JAKARTA SELATAN,CILANDAK,PONDOK LABU,46464,8856,37608,31293,68901,2021-10-18
3174051002,JAKARTA SELATAN,KEBAYORAN LAMA,PONDOK PINANG,56169,11634,44535,35781,80316,2021-10-18
3175101003,JAKARTA TIMUR,CIPAYUNG,PONDOK RANGGON,25574,5231,20343,15918,36261,2021-10-18
3101011003,KAB.ADM.KEP.SERIBU,KEP. SERIBU UTARA,PULAU HARAPAN,2060,238,1822,1556,3378,2021-10-18
3101011002,KAB.ADM.KEP.SERIBU,KEP. SERIBU UTARA,PULAU KELAPA,5528,643,4885,3935,8820,2021-10-18
3101011001,KAB.ADM.KEP.SERIBU,KEP. SERIBU UTARA,PULAU PANGGANG,5450,485,4965,4358,9323,2021-10-18
3101021003,KAB.ADM.KEP.SERIBU,KEP. SERIBU SELATAN,PULAU PARI,2765,204,2561,2368,4929,2021-10-18
3101021002,KAB.ADM.KEP.SERIBU,KEP. SERIBU SELATAN,PULAU TIDUNG,4553,405,4148,3719,7867,2021-10-18
3101021001,KAB.ADM.KEP.SERIBU,KEP. SERIBU SELATAN,PULAU UNTUNG JAWA,1941,177,1764,1606,3370,2021-10-18
3174071007,JAKARTA SELATAN,KEBAYORAN BARU,PULO,5835,1088,4747,4150,8897,2021-10-18
3175021001,JAKARTA TIMUR,PULO GADUNG,PULO GADUNG,34422,8147,26275,20962,47237,2021-10-18
3175061005,JAKARTA TIMUR,CAKUNG,PULO GEBANG,97301,20522,76779,59688,136467,2021-10-18
3174041004,JAKARTA SELATAN,PASAR MINGGU,RAGUNAN,39616,8209,31407,25579,56986,2021-10-18
3175091005,JAKARTA TIMUR,CIRACAS,RAMBUTAN,36771,9398,27373,20709,48082,2021-10-18
3172031006,JAKARTA UTARA,KOJA,RAWA BADAK SELATAN,42179,10901,31278,23699,54977,2021-10-18
3172031004,JAKARTA UTARA,KOJA,RAWA BADAK UTARA,34408,8441,25967,19969,45936,2021-10-18
3174071005,JAKARTA SELATAN,KEBAYORAN BARU,RAWA BARAT,5625,1065,4560,3877,8437,2021-10-18
3173011003,JAKARTA BARAT,CENGKARENG,RAWA BUAYA,63799,14278,49521,37886,87407,2021-10-18
3175031004,JAKARTA TIMUR,JATINEGARA,RAWA BUNGA,21434,5643,15791,12142,27933,2021-10-18
3174081003,JAKARTA SELATAN,PANCORAN,RAWA JATI,20509,4311,16198,12962,29160,2021-10-18
3175061002,JAKARTA TIMUR,CAKUNG,RAWA TERATE,24637,4990,19647,15490,35137,2021-10-18
3175021005,JAKARTA TIMUR,PULO GADUNG,RAWAMANGUN,37612,8233,29379,23784,53163,2021-10-18
3171051003,JAKARTA PUSAT,CEMPAKA PUTIH,RAWASARI,21967,4927,17040,13828,30868,2021-10-18
3173041010,JAKARTA BARAT,TAMBORA,ROA MALAKA,3484,648,2836,2437,5273,2021-10-18
3172041006,JAKARTA UTARA,CILINCING,ROROTAN,41668,9119,32549,25150,57699,2021-10-18
3174071004,JAKARTA SELATAN,KEBAYORAN BARU,SELONG,2842,576,2266,2026,4292,2021-10-18
3173061002,JAKARTA BARAT,KALI DERES,SEMANAN,71354,17508,53846,42182,96028,2021-10-18
3172041007,JAKARTA UTARA,CILINCING,SEMPER BARAT,68587,14695,53892,43139,97031,2021-10-18
3172041005,JAKARTA UTARA,CILINCING,SEMPER TIMUR,36267,8467,27800,21632,49432,2021-10-18
3174071006,JAKARTA SELATAN,KEBAYORAN BARU,SENAYAN,2771,690,2081,1714,3795,2021-10-18
3171041001,JAKARTA PUSAT,SENEN,SENEN,6804,1606,5198,4225,9423,2021-10-18
3171031004,JAKARTA PUSAT,KEMAYORAN,SERDANG,29668,6477,23191,18395,41586,2021-10-18
3174021001,JAKARTA SELATAN,SETIA BUDI,SETIA BUDI,3023,682,2341,1895,4236,2021-10-18
3175101005,JAKARTA TIMUR,CIPAYUNG,SETU,20572,4560,16012,12279,28291,2021-10-18
3173071002,JAKARTA BARAT,PALMERAH,SLIPI,16591,3300,13291,10686,23977,2021-10-18
3173081004,JAKARTA BARAT,KEMBANGAN,SRENGSENG,45523,11186,34337,27929,62266,2021-10-18
3174091002,JAKARTA SELATAN,JAGAKARSA,SRENGSENG SAWAH,58196,10284,47912,38982,86894,2021-10-18
3173051003,JAKARTA BARAT,KEBON JERUK,SUKABUMI SELATAN,37033,9224,27809,20707,48516,2021-10-18
3173051002,JAKARTA BARAT,KEBON JERUK,SUKABUMI UTARA,38290,9859,28431,21309,49740,2021-10-18
3172041002,JAKARTA UTARA,CILINCING,SUKAPURA,53949,13255,40694,32284,72978,2021-10-18
3171031007,JAKARTA PUSAT,KEMAYORAN,SUMUR BATU,22717,5039,17678,14407,32085,2021-10-18
3172021004,JAKARTA UTARA,TANJUNG PRIOK,SUNGAI BAMBU,29876,6640,23236,18425,41661,2021-10-18
3172021006,JAKARTA UTARA,TANJUNG PRIOK,SUNTER AGUNG,71805,13536,58269,49135,107404,2021-10-18
3172021002,JAKARTA UTARA,TANJUNG PRIOK,SUNTER JAYA,63031,12051,50980,42252,93232,2021-10-18
3175091004,JAKARTA TIMUR,CIRACAS,SUSUKAN,38257,7829,30428,24239,54667,2021-10-18
3173031001,JAKARTA BARAT,TAMAN SARI,TAMAN SARI,14348,2850,11498,9545,21043,2021-10-18
3173041001,JAKARTA BARAT,TAMBORA,TAMBORA,10204,2475,7729,6007,13736,2021-10-18
3173041004,JAKARTA BARAT,TAMBORA,TANAH SEREAL,26387,4855,21532,17383,38915,2021-10-18
3171081004,JAKARTA PUSAT,JOHAR BARU,TANAH TINGGI,37693,7697,29996,23490,53486,2021-10-18
3173031004,JAKARTA BARAT,TAMAN SARI,TANGKI,13324,2456,10868,8720,19588,2021-10-18
3174091005,JAKARTA SELATAN,JAGAKARSA,TANJUNG BARAT,39770,7376,32394,25055,57449,2021-10-18
3173021005,JAKARTA BARAT,GROGOL PETAMBURAN,TANJUNG DUREN SELATAN,25337,5328,20009,16921,36930,2021-10-18
3173021002,JAKARTA BARAT,GROGOL PETAMBURAN,TANJUNG DUREN UTARA,17010,3145,13865,11809,25674,2021-10-18
3172021001,JAKARTA UTARA,TANJUNG PRIOK,TANJUNG PRIOK,34588,7770,26818,21137,47955,2021-10-18
3174011002,JAKARTA SELATAN,TEBET,TEBET BARAT,21194,3828,17366,14669,32035,2021-10-18
3174011001,JAKARTA SELATAN,TEBET,TEBET TIMUR,18199,3197,15002,12935,27937,2021-10-18
3173061003,JAKARTA BARAT,KALI DERES,TEGAL ALUR,83647,19560,64087,50907,114994,2021-10-18
3174031004,JAKARTA SELATAN,MAMPANG PRAPATAN,TEGAL PARANG,32401,7895,24506,17855,42361,2021-10-18
3173021003,JAKARTA BARAT,GROGOL PETAMBURAN,TOMANG,29605,5947,23658,19354,43012,2021-10-18
3172031005,JAKARTA UTARA,KOJA,TUGU SELATAN,39122,9488,29634,22963,52597,2021-10-18
3172031002,JAKARTA UTARA,KOJA,TUGU UTARA,67670,17386,50284,38094,88378,2021-10-18
3175061006,JAKARTA TIMUR,CAKUNG,UJUNG MENTENG,29934,5656,24278,19814,44092,2021-10-18
3174101005,JAKARTA SELATAN,PESANGGRAHAN,ULUJAMI,40544,10140,30404,23701,54105,2021-10-18
3175011006,JAKARTA TIMUR,MATRAMAN,UTAN KAYU SELATAN,33511,6748,26763,20997,47760,2021-10-18
3175011002,JAKARTA TIMUR,MATRAMAN,UTAN KAYU UTARA,28169,6481,21688,16948,38636,2021-10-18
3171031008,JAKARTA PUSAT,KEMAYORAN,UTAN PANJANG,29208,6482,22726,17254,39980,2021-10-18
3172021007,JAKARTA UTARA,TANJUNG PRIOK,WARAKAS,44401,8889,35512,27292,62804,2021-10-18
3173021007,JAKARTA BARAT,GROGOL PETAMBURAN,WIJAYA KUSUMA,38934,8994,29940,24054,53994,2021-10-18
3172051003,JAKARTA UTARA,PADEMANGAN,ANCOL,23947,6210,17737,14090,31827,2021-10-19
3173041007,JAKARTA BARAT,TAMBORA,ANGKE,29381,6869,22512,17593,40105,2021-10-19
3175041005,JAKARTA TIMUR,KRAMAT JATI,BALE KAMBANG,29074,7900,21174,15631,36805,2021-10-19
3175031003,JAKARTA TIMUR,JATINEGARA,BALI MESTER,9752,2236,7516,6028,13544,2021-10-19
3175101006,JAKARTA TIMUR,CIPAYUNG,BAMBU APUS,26285,5284,21001,16301,37302,2021-10-19
3174031002,JAKARTA SELATAN,MAMPANG PRAPATAN,BANGKA,21566,5064,16502,12977,29479,2021-10-19
3175051002,JAKARTA TIMUR,PASAR REBO,BARU,23886,4319,19567,16254,35821,2021-10-19
3175041004,JAKARTA TIMUR,KRAMAT JATI,BATU AMPAR,47898,12735,35163,26601,61764,2021-10-19
3171071002,JAKARTA PUSAT,TANAH ABANG,BENDUNGAN HILIR,21494,4679,16815,13662,30477,2021-10-19
3175031002,JAKARTA TIMUR,JATINEGARA,BIDARA CINA,36689,9572,27117,20546,47663,2021-10-19
3174101002,JAKARTA SELATAN,PESANGGRAHAN,BINTARO,53098,11697,41401,33903,75304,2021-10-19
3174011005,JAKARTA SELATAN,TEBET,BUKIT DURI,34183,7788,26395,20961,47356,2021-10-19
3171041006,JAKARTA PUSAT,SENEN,BUNGUR,18144,4203,13941,11226,25167,2021-10-19
3175061007,JAKARTA TIMUR,CAKUNG,CAKUNG BARAT,57724,12996,44728,35795,80523,2021-10-19
3175061004,JAKARTA TIMUR,CAKUNG,CAKUNG TIMUR,58287,12515,45772,36440,82212,2021-10-19
3175041007,JAKARTA TIMUR,KRAMAT JATI,CAWANG,32762,7889,24873,18918,43791,2021-10-19
3175101008,JAKARTA TIMUR,CIPAYUNG,CEGER,18932,4015,14917,11875,26792,2021-10-19
3171031006,JAKARTA PUSAT,KEMAYORAN,CEMPAKA BARU,32581,7477,25104,19044,44148,2021-10-19
3171051002,JAKARTA PUSAT,CEMPAKA PUTIH,CEMPAKA PUTIH BARAT,35885,8366,27519,22365,49884,2021-10-19
3171051001,JAKARTA PUSAT,CEMPAKA PUTIH,CEMPAKA PUTIH TIMUR,24292,5406,18886,15742,34628,2021-10-19
3173011001,JAKARTA BARAT,CENGKARENG,CENGKARENG BARAT,66284,14820,51464,41716,93180,2021-10-19
3173011006,JAKARTA BARAT,CENGKARENG,CENGKARENG TIMUR,81027,17539,63488,49919,113407,2021-10-19
3175091002,JAKARTA TIMUR,CIRACAS,CIBUBUR,66364,12356,54008,43227,97235,2021-10-19
3171011002,JAKARTA PUSAT,GAMBIR,CIDENG,15390,3208,12182,10244,22426,2021-10-19
3174091003,JAKARTA SELATAN,JAGAKARSA,CIGANJUR,38497,7335,31162,24008,55170,2021-10-19
3175051003,JAKARTA TIMUR,PASAR REBO,CIJANTUNG,41419,8389,33030,26305,59335,2021-10-19
3171061003,JAKARTA PUSAT,MENTENG,CIKINI,8274,1585,6689,5055,11744,2021-10-19
3174081006,JAKARTA SELATAN,PANCORAN,CIKOKO,10547,1970,8577,7098,15675,2021-10-19
3174061001,JAKARTA SELATAN,CILANDAK,CILANDAK BARAT,51752,10255,41497,34353,75850,2021-10-19
3174041003,JAKARTA SELATAN,PASAR MINGGU,CILANDAK TIMUR,25145,5154,19991,16301,36292,2021-10-19
3175101002,JAKARTA TIMUR,CIPAYUNG,CILANGKAP,27635,5295,22340,17750,40090,2021-10-19
3175041006,JAKARTA TIMUR,KRAMAT JATI,CILILITAN,40181,9801,30380,23458,53838,2021-10-19
3172041001,JAKARTA UTARA,CILINCING,CILINCING,43609,11374,32235,24020,56255,2021-10-19
3175101001,JAKARTA TIMUR,CIPAYUNG,CIPAYUNG,26104,4945,21159,17412,38571,2021-10-19
3174091006,JAKARTA SELATAN,JAGAKARSA,CIPEDAK,38303,7240,31063,24859,55922,2021-10-19
3174061005,JAKARTA SELATAN,CILANDAK,CIPETE SELATAN,26704,5591,21113,17544,38657,2021-10-19
3174071010,JAKARTA SELATAN,KEBAYORAN BARU,CIPETE UTARA,34102,7082,27020,21071,48091,2021-10-19
3175021003,JAKARTA TIMUR,PULO GADUNG,CIPINANG,39306,8136,31170,24608,55778,2021-10-19
3175031007,JAKARTA TIMUR,JATINEGARA,CIPINANG BESAR SELATAN,35212,9077,26135,19387,45522,2021-10-19
3175031008,JAKARTA TIMUR,JATINEGARA,CIPINANG BESAR UTARA,45319,11710,33609,24705,58314,2021-10-19
3175031005,JAKARTA TIMUR,JATINEGARA,CIPINANG CEMPEDAK,32824,7742,25082,19905,44987,2021-10-19
3175081005,JAKARTA TIMUR,MAKASAR,CIPINANG MELAYU,42308,8922,33386,26822,60208,2021-10-19
3175031006,JAKARTA TIMUR,JATINEGARA,CIPINANG MUARA,55243,13096,42147,32626,74773,2021-10-19
3174051003,JAKARTA SELATAN,KEBAYORAN LAMA,CIPULIR,39937,9194,30743,23531,54274,2021-10-19
3175091001,JAKARTA TIMUR,CIRACAS,CIRACAS,64594,12885,51709,40571,92280,2021-10-19
3175041003,JAKARTA TIMUR,KRAMAT JATI,DUKUH,24609,5076,19533,15289,34822,2021-10-19
3175071001,JAKARTA TIMUR,DUREN SAWIT,DUREN SAWIT,61160,14120,47040,36711,83751,2021-10-19
3174081004,JAKARTA SELATAN,PANCORAN,DUREN TIGA,28319,6122,22197,17479,39676,2021-10-19
3173051005,JAKARTA BARAT,KEBON JERUK,DURI KEPA,60138,12793,47345,39623,86968,2021-10-19
3173011002,JAKARTA BARAT,CENGKARENG,DURI KOSAMBI,77923,18649,59274,45384,104658,2021-10-19
3171011006,JAKARTA PUSAT,GAMBIR,DURI PULO,19610,4499,15111,11686,26797,2021-10-19
3173041011,JAKARTA BARAT,TAMBORA,DURI SELATAN,14259,2738,11521,9364,20885,2021-10-19
3173041003,JAKARTA BARAT,TAMBORA,DURI UTARA,19844,4028,15816,12547,28363,2021-10-19
3171081003,JAKARTA PUSAT,JOHAR BARU,GALUR,18243,3904,14339,11234,25573,2021-10-19
3171011001,JAKARTA PUSAT,GAMBIR,GAMBIR,2191,489,1702,1415,3117,2021-10-19
3174061004,JAKARTA SELATAN,CILANDAK,GANDARIA SELATAN,22119,4727,17392,13993,31385,2021-10-19
3174071009,JAKARTA SELATAN,KEBAYORAN BARU,GANDARIA UTARA,39922,8726,31196,24880,56076,2021-10-19
3175051001,JAKARTA TIMUR,PASAR REBO,GEDONG,35755,7750,28005,22577,50582,2021-10-19
3171071001,JAKARTA PUSAT,TANAH ABANG,GELORA,3127,665,2462,2040,4502,2021-10-19
3173031007,JAKARTA BARAT,TAMAN SARI,GLODOK,7837,1337,6500,5671,12171,2021-10-19
3171061004,JAKARTA PUSAT,MENTENG,GONDANGDIA,4100,967,3133,2791,5924,2021-10-19
3173021001,JAKARTA BARAT,GROGOL PETAMBURAN,GROGOL,16876,3661,13215,10664,23879,2021-10-19
3174051005,JAKARTA SELATAN,KEBAYORAN LAMA,GROGOL SELATAN,44251,9986,34265,26948,61213,2021-10-19
3174051004,JAKARTA SELATAN,KEBAYORAN LAMA,GROGOL UTARA,42494,9574,32920,26258,59178,2021-10-19
3174021007,JAKARTA SELATAN,SETIA BUDI,GUNTUR,3985,811,3174,2702,5876,2021-10-19
3174071002,JAKARTA SELATAN,KEBAYORAN BARU,GUNUNG,9436,1889,7547,6324,13871,2021-10-19
3171031005,JAKARTA PUSAT,KEMAYORAN,GUNUNG SAHARI SELATAN,19199,4262,14937,12044,26981,2021-10-19
3171021004,JAKARTA PUSAT,SAWAH BESAR,GUNUNG SAHARI UTARA,16650,3180,13470,11552,25022,2021-10-19
3175081004,JAKARTA TIMUR,MAKASAR,HALIM PERDANA KUSUMAH,28363,4077,24286,21657,45943,2021-10-19
3171031003,JAKARTA PUSAT,KEMAYORAN,HARAPAN MULIA,22557,4997,17560,13583,31143,2021-10-19
3174091001,JAKARTA SELATAN,JAGAKARSA,JAGAKARSA,62389,11829,50560,40069,90629,2021-10-19
3175021007,JAKARTA TIMUR,PULO GADUNG,JATI,32757,6762,25995,21509,47504,2021-10-19
3174041002,JAKARTA SELATAN,PASAR MINGGU,JATI PADANG,37502,8236,29266,23521,52787,2021-10-19
3173071004,JAKARTA BARAT,PALMERAH,JATI PULO,28738,6271,22467,17320,39787,2021-10-19
3175061001,JAKARTA TIMUR,CAKUNG,JATINEGARA,84160,19735,64425,51031,115456,2021-10-19
3175021004,JAKARTA TIMUR,PULO GADUNG,JATINEGARA KAUM,24632,4868,19764,15204,34968,2021-10-19
3173021004,JAKARTA BARAT,GROGOL PETAMBURAN,JELAMBAR,30266,6040,24226,20040,44266,2021-10-19
3173021006,JAKARTA BARAT,GROGOL PETAMBURAN,JELAMBAR BARU,38246,7827,30419,25217,55636,2021-10-19
3173041006,JAKARTA BARAT,TAMBORA,JEMBATAN BESI,29314,7764,21550,16082,37632,2021-10-19
3173041008,JAKARTA BARAT,TAMBORA,JEMBATAN LIMA,21021,5402,15619,11841,27460,2021-10-19
3173081005,JAKARTA BARAT,KEMBANGAN,JOGLO,40839,9088,31751,25895,57646,2021-10-19
3171081001,JAKARTA PUSAT,JOHAR BARU,JOHAR BARU,37488,7446,30042,24480,54522,2021-10-19
3173041002,JAKARTA BARAT,TAMBORA,KALI ANYAR,23856,5191,18665,14146,32811,2021-10-19
3172041004,JAKARTA UTARA,CILINCING,KALIBARU,67684,20119,47565,32867,80432,2021-10-19
3174081002,JAKARTA SELATAN,PANCORAN,KALIBATA,41994,10528,31466,23913,55379,2021-10-19
3173061001,JAKARTA BARAT,KALI DERES,KALIDERES,72447,16535,55912,45668,101580,2021-10-19
3175051004,JAKARTA TIMUR,PASAR REBO,KALISARI,43212,8542,34670,27784,62454,2021-10-19
3173061004,JAKARTA BARAT,KALI DERES,KAMAL,53783,14029,39754,30539,70293,2021-10-19
3172011002,JAKARTA UTARA,PENJARINGAN,KAMAL MUARA,12930,2390,10540,8823,19363,2021-10-19
3171071007,JAKARTA PUSAT,TANAH ABANG,KAMPUNG BALI,11358,2663,8695,6321,15016,2021-10-19
3175031001,JAKARTA TIMUR,JATINEGARA,KAMPUNG MELAYU,25717,6672,19045,14180,33225,2021-10-19
3171081002,JAKARTA PUSAT,JOHAR BARU,KAMPUNG RAWA,21237,3753,17484,13485,30969,2021-10-19
3175041002,JAKARTA TIMUR,KRAMAT JATI,KAMPUNG TENGAH,43993,11840,32153,24284,56437,2021-10-19
3173011005,JAKARTA BARAT,CENGKARENG,KAPUK,134466,35171,99295,76682,175977,2021-10-19
3172011003,JAKARTA UTARA,PENJARINGAN,KAPUK MUARA,35781,7415,28366,24220,52586,2021-10-19
3171021002,JAKARTA PUSAT,SAWAH BESAR,KARANG ANYAR,25761,5394,20367,16434,36801,2021-10-19
3174021004,JAKARTA SELATAN,SETIA BUDI,KARET,9623,2046,7577,6043,13620,2021-10-19
3174021003,JAKARTA SELATAN,SETIA BUDI,KARET KUNINGAN,16055,3431,12624,10316,22940,2021-10-19
3174021002,JAKARTA SELATAN,SETIA BUDI,KARET SEMANGGI,2770,588,2182,1878,4060,2021-10-19
3171071003,JAKARTA PUSAT,TANAH ABANG,KARET TENGSIN,19271,4036,15235,11875,27110,2021-10-19
3171021003,JAKARTA PUSAT,SAWAH BESAR,KARTINI,22292,4685,17607,14408,32015,2021-10-19
3175011003,JAKARTA TIMUR,MATRAMAN,KAYU MANIS,25284,5845,19439,14575,34014,2021-10-19
3175021006,JAKARTA TIMUR,PULO GADUNG,KAYU PUTIH,40696,8314,32382,27290,59672,2021-10-19
3173031006,JAKARTA BARAT,TAMAN SARI,KEAGUNGAN,17387,3630,13757,10821,24578,2021-10-19
3174041007,JAKARTA SELATAN,PASAR MINGGU,KEBAGUSAN,44552,9725,34827,27359,62186,2021-10-19
3174051006,JAKARTA SELATAN,KEBAYORAN LAMA,KEBAYORAN LAMA SELATAN,41212,8436,32776,26290,59066,2021-10-19
3174051001,JAKARTA SELATAN,KEBAYORAN LAMA,KEBAYORAN LAMA UTARA,42422,9814,32608,25706,58314,2021-10-19
3174011004,JAKARTA SELATAN,TEBET,KEBON BARU,35165,7280,27885,22002,49887,2021-10-19
3172021005,JAKARTA UTARA,TANJUNG PRIOK,KEBON BAWANG,50952,11242,39710,31639,71349,2021-10-19
3173051001,JAKARTA BARAT,KEBON JERUK,KEBON JERUK,53887,12699,41188,32424,73612,2021-10-19
3171071006,JAKARTA PUSAT,TANAH ABANG,KEBON KACANG,21531,5633,15898,12049,27947,2021-10-19
3171011005,JAKARTA PUSAT,GAMBIR,KEBON KELAPA,10163,2217,7946,6394,14340,2021-10-19
3171031002,JAKARTA PUSAT,KEMAYORAN,KEBON KOSONG,30019,6551,23468,17882,41350,2021-10-19
3175011005,JAKARTA TIMUR,MATRAMAN,KEBON MANGGIS,16490,3521,12969,10307,23276,2021-10-19
3171071005,JAKARTA PUSAT,TANAH ABANG,KEBON MELATI,32206,9156,23050,16259,39309,2021-10-19
3175081003,JAKARTA TIMUR,MAKASAR,KEBON PALA,46614,10273,36341,28877,65218,2021-10-19
3171061005,JAKARTA PUSAT,MENTENG,KEBON SIRIH,12299,2853,9446,7249,16695,2021-10-19
3173011004,JAKARTA BARAT,CENGKARENG,KEDAUNG KALI ANGKE,32612,6869,25743,20772,46515,2021-10-19
3173051007,JAKARTA BARAT,KEBON JERUK,KEDOYA SELATAN,32165,6441,25724,20471,46195,2021-10-19
3173051006,JAKARTA BARAT,KEBON JERUK,KEDOYA UTARA,45740,9389,36351,29919,66270,2021-10-19
3173051004,JAKARTA BARAT,KEBON JERUK,KELAPA DUA,23565,5281,18284,14569,32853,2021-10-19
3175091003,JAKARTA TIMUR,CIRACAS,KELAPA DUA WETAN,46875,8822,38053,30595,68648,2021-10-19
3172061003,JAKARTA UTARA,KELAPA GADING,KELAPA GADING BARAT,35717,6583,29134,25619,54753,2021-10-19
3172061001,JAKARTA UTARA,KELAPA GADING,KELAPA GADING TIMUR,33592,5497,28095,25298,53393,2021-10-19
3173071005,JAKARTA BARAT,PALMERAH,KEMANGGISAN,32139,6716,25423,20267,45690,2021-10-19
3171031001,JAKARTA PUSAT,KEMAYORAN,KEMAYORAN,20708,4654,16054,12769,28823,2021-10-19
3173081006,JAKARTA BARAT,KEMBANGAN,KEMBANGAN SELATAN,27130,6232,20898,17584,38482,2021-10-19
3173081001,JAKARTA BARAT,KEMBANGAN,KEMBANGAN UTARA,54451,13050,41401,33383,74784,2021-10-19
3171041002,JAKARTA PUSAT,SENEN,KENARI,9579,2057,7522,6197,13719,2021-10-19
3173041005,JAKARTA BARAT,TAMBORA,KERENDANG,19973,4586,15387,11967,27354,2021-10-19
3175071003,JAKARTA TIMUR,DUREN SAWIT,KLENDER,69978,17793,52185,39694,91879,2021-10-19
3172031001,JAKARTA UTARA,KOJA,KOJA,28175,6965,21210,16474,37684,2021-10-19
3173071006,JAKARTA BARAT,PALMERAH,KOTA BAMBU SELATAN,21158,4827,16331,12418,28749,2021-10-19
3173071003,JAKARTA BARAT,PALMERAH,KOTA BAMBU UTARA,24995,5958,19037,14366,33403,2021-10-19
3171041004,JAKARTA PUSAT,SENEN,KRAMAT,28835,7501,21334,15691,37025,2021-10-19
3175041001,JAKARTA TIMUR,KRAMAT JATI,KRAMAT JATI,34144,8054,26090,20175,46265,2021-10-19
3174071003,JAKARTA SELATAN,KEBAYORAN BARU,KRAMAT PELA,14413,3020,11393,9293,20686,2021-10-19
3173031002,JAKARTA BARAT,TAMAN SARI,KRUKUT,19244,4039,15205,11755,26960,2021-10-19
3174031005,JAKARTA SELATAN,MAMPANG PRAPATAN,KUNINGAN BARAT,12785,2582,10203,8157,18360,2021-10-19
3174021008,JAKARTA SELATAN,SETIA BUDI,KUNINGAN TIMUR,6008,1345,4663,3826,8489,2021-10-19
3171041005,JAKARTA PUSAT,SENEN,KWITANG,15486,3828,11658,9121,20779,2021-10-19
3172031003,JAKARTA UTARA,KOJA,LAGOA,59065,15268,43797,33318,77115,2021-10-19
3174061002,JAKARTA SELATAN,CILANDAK,LEBAK BULUS,37626,7775,29851,24503,54354,2021-10-19
3174091004,JAKARTA SELATAN,JAGAKARSA,LENTENG AGUNG,53946,10834,43112,32784,75896,2021-10-19
3175101007,JAKARTA TIMUR,CIPAYUNG,LUBANG BUAYA,63547,13059,50488,40179,90667,2021-10-19
3175081001,JAKARTA TIMUR,MAKASAR,MAKASAR,34390,6948,27442,22104,49546,2021-10-19
3175071006,JAKARTA TIMUR,DUREN SAWIT,MALAKA JAYA,30927,6064,24863,20253,45116,2021-10-19
3175071005,JAKARTA TIMUR,DUREN SAWIT,MALAKA SARI,27530,5084,22446,18510,40956,2021-10-19
3174031001,JAKARTA SELATAN,MAMPANG PRAPATAN,MAMPANG PRAPATAN,18159,4117,14042,10990,25032,2021-10-19
3173031005,JAKARTA BARAT,TAMAN SARI,MANGGA BESAR,7707,1388,6319,5299,11618,2021-10-19
3171021005,JAKARTA PUSAT,SAWAH BESAR,MANGGA DUA SELATAN,27442,6132,21310,17254,38564,2021-10-19
3174011007,JAKARTA SELATAN,TEBET,MANGGARAI,28373,5597,22776,17520,40296,2021-10-19
3174011006,JAKARTA SELATAN,TEBET,MANGGARAI SELATAN,23075,4530,18545,14955,33500,2021-10-19
3173031003,JAKARTA BARAT,TAMAN SARI,MAPHAR,16461,3356,13105,10485,23590,2021-10-19
3172041003,JAKARTA UTARA,CILINCING,MARUNDA,28943,7116,21827,15911,37738,2021-10-19
3174071001,JAKARTA SELATAN,KEBAYORAN BARU,MELAWAI,2627,554,2073,1886,3959,2021-10-19
3171061001,JAKARTA PUSAT,MENTENG,MENTENG,25624,6244,19380,14631,34011,2021-10-19
3174021005,JAKARTA SELATAN,SETIA BUDI,MENTENG ATAS,27816,5552,22264,17571,39835,2021-10-19
3174011003,JAKARTA SELATAN,TEBET,MENTENG DALAM,36028,7689,28339,22630,50969,2021-10-19
3173081003,JAKARTA BARAT,KEMBANGAN,MERUYA SELATAN,32130,7258,24872,20002,44874,2021-10-19
3173081002,JAKARTA BARAT,KEMBANGAN,MERUYA UTARA,43752,9951,33801,28268,62069,2021-10-19
3175101004,JAKARTA TIMUR,CIPAYUNG,MUNJUL,23871,4684,19187,15310,34497,2021-10-19
3172051002,JAKARTA UTARA,PADEMANGAN,PADEMANGAN BARAT,74240,18905,55335,42880,98215,2021-10-19
3172051001,JAKARTA UTARA,PADEMANGAN,PADEMANGAN TIMUR,37736,7219,30517,25606,56123,2021-10-19
3175011004,JAKARTA TIMUR,MATRAMAN,PAL MERIAM,19769,4612,15157,11657,26814,2021-10-19
3173071001,JAKARTA BARAT,PALMERAH,PALMERAH,63011,14903,48108,37578,85686,2021-10-19
3174081001,JAKARTA SELATAN,PANCORAN,PANCORAN,19421,4472,14949,11932,26881,2021-10-19
3172021003,JAKARTA UTARA,TANJUNG PRIOK,PAPANGGO,39097,8579,30518,24178,54696,2021-10-19
3171021001,JAKARTA PUSAT,SAWAH BESAR,PASAR BARU,12035,2487,9548,8256,17804,2021-10-19
3174021006,JAKARTA SELATAN,SETIA BUDI,PASAR MANGGIS,26752,5902,20850,16514,37364,2021-10-19
3174041001,JAKARTA SELATAN,PASAR MINGGU,PASAR MINGGU,24821,5098,19723,15989,35712,2021-10-19
3171041003,JAKARTA PUSAT,SENEN,PASEBAN,23533,5452,18081,14273,32354,2021-10-19
3173061005,JAKARTA BARAT,KALI DERES,PEGADUNGAN,75587,16791,58796,49221,108017,2021-10-19
3171061002,JAKARTA PUSAT,MENTENG,PEGANGSAAN,23455,5622,17833,13045,30878,2021-10-19
3172061002,JAKARTA UTARA,KELAPA GADING,PEGANGSAAN DUA,49976,8806,41170,36364,77534,2021-10-19
3172011004,JAKARTA UTARA,PENJARINGAN,PEJAGALAN,74578,16773,57805,47617,105422,2021-10-19
3174041006,JAKARTA SELATAN,PASAR MINGGU,PEJATEN BARAT,37346,8218,29128,23272,52400,2021-10-19
3174041005,JAKARTA SELATAN,PASAR MINGGU,PEJATEN TIMUR,57656,14235,43421,34154,77575,2021-10-19
3175051005,JAKARTA TIMUR,PASAR REBO,PEKAYON,43250,8680,34570,27427,61997,2021-10-19
3173041009,JAKARTA BARAT,TAMBORA,PEKOJAN,23587,4873,18714,15107,33821,2021-10-19
3174031003,JAKARTA SELATAN,MAMPANG PRAPATAN,PELA MAMPANG,43522,9587,33935,27017,60952,2021-10-19
3174081005,JAKARTA SELATAN,PANCORAN,PENGADEGAN,21478,4272,17206,13832,31038,2021-10-19
3175061003,JAKARTA TIMUR,CAKUNG,PENGGILINGAN,99255,25422,73833,56514,130347,2021-10-19
3172011001,JAKARTA UTARA,PENJARINGAN,PENJARINGAN,88308,24562,63746,47122,110868,2021-10-19
3174101001,JAKARTA SELATAN,PESANGGRAHAN,PESANGGRAHAN,27545,5202,22343,18394,40737,2021-10-19
3171071004,JAKARTA PUSAT,TANAH ABANG,PETAMBURAN,33271,9458,23813,17202,41015,2021-10-19
3174071008,JAKARTA SELATAN,KEBAYORAN BARU,PETOGOGAN,11499,2475,9024,7326,16350,2021-10-19
3171011004,JAKARTA PUSAT,GAMBIR,PETOJO SELATAN,14692,3549,11143,9096,20239,2021-10-19
3171011003,JAKARTA PUSAT,GAMBIR,PETOJO UTARA,17458,4028,13430,10589,24019,2021-10-19
3174101004,JAKARTA SELATAN,PESANGGRAHAN,PETUKANGAN SELATAN,37187,8349,28838,23254,52092,2021-10-19
3174101003,JAKARTA SELATAN,PESANGGRAHAN,PETUKANGAN UTARA,53716,12737,40979,32610,73589,2021-10-19
3175081002,JAKARTA TIMUR,MAKASAR,PINANG RANTI,27198,6485,20713,16535,37248,2021-10-19
3173031008,JAKARTA BARAT,TAMAN SARI,PINANGSIA,10729,2048,8681,6934,15615,2021-10-19
3175011001,JAKARTA TIMUR,MATRAMAN,PISANGAN BARU,31776,7188,24588,18541,43129,2021-10-19
3175021002,JAKARTA TIMUR,PULO GADUNG,PISANGAN TIMUR,41011,8481,32530,26285,58815,2021-10-19
3172011005,JAKARTA UTARA,PENJARINGAN,PLUIT,47783,9873,37910,32077,69987,2021-10-19
3175071002,JAKARTA TIMUR,DUREN SAWIT,PONDOK BAMBU,61550,14254,47296,37138,84434,2021-10-19
3175071004,JAKARTA TIMUR,DUREN SAWIT,PONDOK KELAPA,72015,15549,56466,46537,103003,2021-10-19
3175071007,JAKARTA TIMUR,DUREN SAWIT,PONDOK KOPI,35367,7568,27799,20913,48712,2021-10-19
3174061003,JAKARTA SELATAN,CILANDAK,PONDOK LABU,46464,8800,37664,31434,69098,2021-10-19
3174051002,JAKARTA SELATAN,KEBAYORAN LAMA,PONDOK PINANG,56169,11602,44567,35861,80428,2021-10-19
3175101003,JAKARTA TIMUR,CIPAYUNG,PONDOK RANGGON,25574,5208,20366,15945,36311,2021-10-19
3101011003,KAB.ADM.KEP.SERIBU,KEP. SERIBU UTARA,PULAU HARAPAN,2060,235,1825,1563,3388,2021-10-19
3101011002,KAB.ADM.KEP.SERIBU,KEP. SERIBU UTARA,PULAU KELAPA,5528,642,4886,3941,8827,2021-10-19
3101011001,KAB.ADM.KEP.SERIBU,KEP. SERIBU UTARA,PULAU PANGGANG,5450,483,4967,4361,9328,2021-10-19
3101021003,KAB.ADM.KEP.SERIBU,KEP. SERIBU SELATAN,PULAU PARI,2765,204,2561,2368,4929,2021-10-19
3101021002,KAB.ADM.KEP.SERIBU,KEP. SERIBU SELATAN,PULAU TIDUNG,4553,404,4149,3723,7872,2021-10-19
3101021001,KAB.ADM.KEP.SERIBU,KEP. SERIBU SELATAN,PULAU UNTUNG JAWA,1941,173,1768,1608,3376,2021-10-19
3174071007,JAKARTA SELATAN,KEBAYORAN BARU,PULO,5835,1081,4754,4162,8916,2021-10-19
3175021001,JAKARTA TIMUR,PULO GADUNG,PULO GADUNG,34422,8099,26323,21020,47343,2021-10-19
3175061005,JAKARTA TIMUR,CAKUNG,PULO GEBANG,97301,20452,76849,59864,136713,2021-10-19
3174041004,JAKARTA SELATAN,PASAR MINGGU,RAGUNAN,39616,8143,31473,25648,57121,2021-10-19
3175091005,JAKARTA TIMUR,CIRACAS,RAMBUTAN,36771,9370,27401,20771,48172,2021-10-19
3172031006,JAKARTA UTARA,KOJA,RAWA BADAK SELATAN,42179,10877,31302,23730,55032,2021-10-19
3172031004,JAKARTA UTARA,KOJA,RAWA BADAK UTARA,34408,8401,26007,20048,46055,2021-10-19
3174071005,JAKARTA SELATAN,KEBAYORAN BARU,RAWA BARAT,5625,1060,4565,3885,8450,2021-10-19
3173011003,JAKARTA BARAT,CENGKARENG,RAWA BUAYA,63799,14153,49646,38073,87719,2021-10-19
3175031004,JAKARTA TIMUR,JATINEGARA,RAWA BUNGA,21434,5623,15811,12189,28000,2021-10-19
3174081003,JAKARTA SELATAN,PANCORAN,RAWA JATI,20509,4232,16277,13038,29315,2021-10-19
3175061002,JAKARTA TIMUR,CAKUNG,RAWA TERATE,24637,4971,19666,15531,35197,2021-10-19
3175021005,JAKARTA TIMUR,PULO GADUNG,RAWAMANGUN,37612,8165,29447,23864,53311,2021-10-19
3171051003,JAKARTA PUSAT,CEMPAKA PUTIH,RAWASARI,21967,4895,17072,13879,30951,2021-10-19
3173041010,JAKARTA BARAT,TAMBORA,ROA MALAKA,3484,647,2837,2440,5277,2021-10-19
3172041006,JAKARTA UTARA,CILINCING,ROROTAN,41668,9075,32593,25195,57788,2021-10-19
3174071004,JAKARTA SELATAN,KEBAYORAN BARU,SELONG,2842,572,2270,2029,4299,2021-10-19
3173061002,JAKARTA BARAT,KALI DERES,SEMANAN,71354,17440,53914,42314,96228,2021-10-19
3172041007,JAKARTA UTARA,CILINCING,SEMPER BARAT,68587,14614,53973,43313,97286,2021-10-19
3172041005,JAKARTA UTARA,CILINCING,SEMPER TIMUR,36267,8412,27855,21705,49560,2021-10-19
3174071006,JAKARTA SELATAN,KEBAYORAN BARU,SENAYAN,2771,687,2084,1718,3802,2021-10-19
3171041001,JAKARTA PUSAT,SENEN,SENEN,6804,1599,5205,4239,9444,2021-10-19
3171031004,JAKARTA PUSAT,KEMAYORAN,SERDANG,29668,6457,23211,18475,41686,2021-10-19
3174021001,JAKARTA SELATAN,SETIA BUDI,SETIA BUDI,3023,681,2342,1904,4246,2021-10-19
3175101005,JAKARTA TIMUR,CIPAYUNG,SETU,20572,4498,16074,12323,28397,2021-10-19
3173071002,JAKARTA BARAT,PALMERAH,SLIPI,16591,3291,13300,10726,24026,2021-10-19
3173081004,JAKARTA BARAT,KEMBANGAN,SRENGSENG,45523,11110,34413,28028,62441,2021-10-19
3174091002,JAKARTA SELATAN,JAGAKARSA,SRENGSENG SAWAH,58196,10172,48024,39110,87134,2021-10-19
3173051003,JAKARTA BARAT,KEBON JERUK,SUKABUMI SELATAN,37033,9172,27861,20765,48626,2021-10-19
3173051002,JAKARTA BARAT,KEBON JERUK,SUKABUMI UTARA,38290,9803,28487,21382,49869,2021-10-19
3172041002,JAKARTA UTARA,CILINCING,SUKAPURA,53949,13201,40748,32382,73130,2021-10-19
3171031007,JAKARTA PUSAT,KEMAYORAN,SUMUR BATU,22717,5004,17713,14470,32183,2021-10-19
3172021004,JAKARTA UTARA,TANJUNG PRIOK,SUNGAI BAMBU,29876,6617,23259,18510,41769,2021-10-19
3172021006,JAKARTA UTARA,TANJUNG PRIOK,SUNTER AGUNG,71805,13490,58315,49266,107581,2021-10-19
3172021002,JAKARTA UTARA,TANJUNG PRIOK,SUNTER JAYA,63031,11989,51042,42364,93406,2021-10-19
3175091004,JAKARTA TIMUR,CIRACAS,SUSUKAN,38257,7813,30444,24296,54740,2021-10-19
3173031001,JAKARTA BARAT,TAMAN SARI,TAMAN SARI,14348,2844,11504,9580,21084,2021-10-19
3173041001,JAKARTA BARAT,TAMBORA,TAMBORA,10204,2464,7740,6017,13757,2021-10-19
3173041004,JAKARTA BARAT,TAMBORA,TANAH SEREAL,26387,4839,21548,17425,38973,2021-10-19
3171081004,JAKARTA PUSAT,JOHAR BARU,TANAH TINGGI,37693,7672,30021,23557,53578,2021-10-19
3173031004,JAKARTA BARAT,TAMAN SARI,TANGKI,13324,2416,10908,8765,19673,2021-10-19
3174091005,JAKARTA SELATAN,JAGAKARSA,TANJUNG BARAT,39770,7337,32433,25161,57594,2021-10-19
3173021005,JAKARTA BARAT,GROGOL PETAMBURAN,TANJUNG DUREN SELATAN,25337,5293,20044,16966,37010,2021-10-19
3173021002,JAKARTA BARAT,GROGOL PETAMBURAN,TANJUNG DUREN UTARA,17010,3120,13890,11840,25730,2021-10-19
3172021001,JAKARTA UTARA,TANJUNG PRIOK,TANJUNG PRIOK,34588,7734,26854,21193,48047,2021-10-19
3174011002,JAKARTA SELATAN,TEBET,TEBET BARAT,21194,3805,17389,14715,32104,2021-10-19
3174011001,JAKARTA SELATAN,TEBET,TEBET TIMUR,18199,3183,15016,12957,27973,2021-10-19
3173061003,JAKARTA BARAT,KALI DERES,TEGAL ALUR,83647,19444,64203,51137,115340,2021-10-19
3174031004,JAKARTA SELATAN,MAMPANG PRAPATAN,TEGAL PARANG,32401,7842,24559,17921,42480,2021-10-19
3173021003,JAKARTA BARAT,GROGOL PETAMBURAN,TOMANG,29605,5918,23687,19403,43090,2021-10-19
3172031005,JAKARTA UTARA,KOJA,TUGU SELATAN,39122,9463,29659,23012,52671,2021-10-19
3172031002,JAKARTA UTARA,KOJA,TUGU UTARA,67670,17317,50353,38252,88605,2021-10-19
3175061006,JAKARTA TIMUR,CAKUNG,UJUNG MENTENG,29934,5639,24295,19854,44149,2021-10-19
3174101005,JAKARTA SELATAN,PESANGGRAHAN,ULUJAMI,40544,10068,30476,23826,54302,2021-10-19
3175011006,JAKARTA TIMUR,MATRAMAN,UTAN KAYU SELATAN,33511,6675,26836,21119,47955,2021-10-19
3175011002,JAKARTA TIMUR,MATRAMAN,UTAN KAYU UTARA,28169,6444,21725,16999,38724,2021-10-19
3171031008,JAKARTA PUSAT,KEMAYORAN,UTAN PANJANG,29208,6457,22751,17346,40097,2021-10-19
3172021007,JAKARTA UTARA,TANJUNG PRIOK,WARAKAS,44401,8833,35568,27412,62980,2021-10-19
3173021007,JAKARTA BARAT,GROGOL PETAMBURAN,WIJAYA KUSUMA,38934,8929,30005,24109,54114,2021-10-19
3172051003,JAKARTA UTARA,PADEMANGAN,ANCOL,23947,6190,17757,14122,31879,2021-10-20
3173041007,JAKARTA BARAT,TAMBORA,ANGKE,29381,6827,22554,17643,40197,2021-10-20
3175041005,JAKARTA TIMUR,KRAMAT JATI,BALE KAMBANG,29074,7872,21202,15705,36907,2021-10-20
3175031003,JAKARTA TIMUR,JATINEGARA,BALI MESTER,9752,2225,7527,6050,13577,2021-10-20
3175101006,JAKARTA TIMUR,CIPAYUNG,BAMBU APUS,26285,5243,21042,16464,37506,2021-10-20
3174031002,JAKARTA SELATAN,MAMPANG PRAPATAN,BANGKA,21566,5040,16526,13017,29543,2021-10-20
3175051002,JAKARTA TIMUR,PASAR REBO,BARU,23886,4292,19594,16305,35899,2021-10-20
3175041004,JAKARTA TIMUR,KRAMAT JATI,BATU AMPAR,47898,12683,35215,26727,61942,2021-10-20
3171071002,JAKARTA PUSAT,TANAH ABANG,BENDUNGAN HILIR,21494,4656,16838,13709,30547,2021-10-20
3175031002,JAKARTA TIMUR,JATINEGARA,BIDARA CINA,36689,9505,27184,20615,47799,2021-10-20
3174101002,JAKARTA SELATAN,PESANGGRAHAN,BINTARO,53098,11645,41453,34034,75487,2021-10-20
3174011005,JAKARTA SELATAN,TEBET,BUKIT DURI,34183,7724,26459,21072,47531,2021-10-20
3171041006,JAKARTA PUSAT,SENEN,BUNGUR,18144,4187,13957,11255,25212,2021-10-20
3175061007,JAKARTA TIMUR,CAKUNG,CAKUNG BARAT,57724,12913,44811,35924,80735,2021-10-20
3175061004,JAKARTA TIMUR,CAKUNG,CAKUNG TIMUR,58287,12456,45831,36558,82389,2021-10-20
3175041007,JAKARTA TIMUR,KRAMAT JATI,CAWANG,32762,7838,24924,19015,43939,2021-10-20
3175101008,JAKARTA TIMUR,CIPAYUNG,CEGER,18932,3999,14933,11913,26846,2021-10-20
3171031006,JAKARTA PUSAT,KEMAYORAN,CEMPAKA BARU,32581,7413,25168,19130,44298,2021-10-20
3171051002,JAKARTA PUSAT,CEMPAKA PUTIH,CEMPAKA PUTIH BARAT,35885,8327,27558,22472,50030,2021-10-20
3171051001,JAKARTA PUSAT,CEMPAKA PUTIH,CEMPAKA PUTIH TIMUR,24292,5385,18907,15781,34688,2021-10-20
3173011001,JAKARTA BARAT,CENGKARENG,CENGKARENG BARAT,66284,14739,51545,41882,93427,2021-10-20
3173011006,JAKARTA BARAT,CENGKARENG,CENGKARENG TIMUR,81027,17434,63593,50109,113702,2021-10-20
3175091002,JAKARTA TIMUR,CIRACAS,CIBUBUR,66364,12296,54068,43307,97375,2021-10-20
3171011002,JAKARTA PUSAT,GAMBIR,CIDENG,15390,3193,12197,10276,22473,2021-10-20
3174091003,JAKARTA SELATAN,JAGAKARSA,CIGANJUR,38497,7218,31279,24164,55443,2021-10-20
3175051003,JAKARTA TIMUR,PASAR REBO,CIJANTUNG,41419,8347,33072,26407,59479,2021-10-20
3171061003,JAKARTA PUSAT,MENTENG,CIKINI,8274,1575,6699,5068,11767,2021-10-20
3174081006,JAKARTA SELATAN,PANCORAN,CIKOKO,10547,1961,8586,7120,15706,2021-10-20
3174061001,JAKARTA SELATAN,CILANDAK,CILANDAK BARAT,51752,10146,41606,34451,76057,2021-10-20
3174041003,JAKARTA SELATAN,PASAR MINGGU,CILANDAK TIMUR,25145,5091,20054,16372,36426,2021-10-20
3175101002,JAKARTA TIMUR,CIPAYUNG,CILANGKAP,27635,5271,22364,17790,40154,2021-10-20
3175041006,JAKARTA TIMUR,KRAMAT JATI,CILILITAN,40181,9762,30419,23555,53974,2021-10-20
3172041001,JAKARTA UTARA,CILINCING,CILINCING,43609,11320,32289,24138,56427,2021-10-20
3175101001,JAKARTA TIMUR,CIPAYUNG,CIPAYUNG,26104,4917,21187,17448,38635,2021-10-20
3174091006,JAKARTA SELATAN,JAGAKARSA,CIPEDAK,38303,7138,31165,24962,56127,2021-10-20
3174061005,JAKARTA SELATAN,CILANDAK,CIPETE SELATAN,26704,5560,21144,17604,38748,2021-10-20
3174071010,JAKARTA SELATAN,KEBAYORAN BARU,CIPETE UTARA,34102,7008,27094,21192,48286,2021-10-20
3175021003,JAKARTA TIMUR,PULO GADUNG,CIPINANG,39306,8086,31220,24698,55918,2021-10-20
3175031007,JAKARTA TIMUR,JATINEGARA,CIPINANG BESAR SELATAN,35212,9030,26182,19469,45651,2021-10-20
3175031008,JAKARTA TIMUR,JATINEGARA,CIPINANG BESAR UTARA,45319,11659,33660,24865,58525,2021-10-20
3175031005,JAKARTA TIMUR,JATINEGARA,CIPINANG CEMPEDAK,32824,7701,25123,19995,45118,2021-10-20
3175081005,JAKARTA TIMUR,MAKASAR,CIPINANG MELAYU,42308,8865,33443,26928,60371,2021-10-20
3175031006,JAKARTA TIMUR,JATINEGARA,CIPINANG MUARA,55243,12979,42264,32807,75071,2021-10-20
3174051003,JAKARTA SELATAN,KEBAYORAN LAMA,CIPULIR,39937,9154,30783,23608,54391,2021-10-20
3175091001,JAKARTA TIMUR,CIRACAS,CIRACAS,64594,12809,51785,40702,92487,2021-10-20
3175041003,JAKARTA TIMUR,KRAMAT JATI,DUKUH,24609,5065,19544,15320,34864,2021-10-20
3175071001,JAKARTA TIMUR,DUREN SAWIT,DUREN SAWIT,61160,14050,47110,36848,83958,2021-10-20
3174081004,JAKARTA SELATAN,PANCORAN,DUREN TIGA,28319,6101,22218,17572,39790,2021-10-20
3173051005,JAKARTA BARAT,KEBON JERUK,DURI KEPA,60138,12746,47392,39709,87101,2021-10-20
3173011002,JAKARTA BARAT,CENGKARENG,DURI KOSAMBI,77923,18472,59451,45611,105062,2021-10-20
3171011006,JAKARTA PUSAT,GAMBIR,DURI PULO,19610,4476,15134,11732,26866,2021-10-20
3173041011,JAKARTA BARAT,TAMBORA,DURI SELATAN,14259,2734,11525,9405,20930,2021-10-20
3173041003,JAKARTA BARAT,TAMBORA,DURI UTARA,19844,4016,15828,12587,28415,2021-10-20
3171081003,JAKARTA PUSAT,JOHAR BARU,GALUR,18243,3892,14351,11263,25614,2021-10-20
3171011001,JAKARTA PUSAT,GAMBIR,GAMBIR,2191,485,1706,1424,3130,2021-10-20
3174061004,JAKARTA SELATAN,CILANDAK,GANDARIA SELATAN,22119,4673,17446,14045,31491,2021-10-20
3174071009,JAKARTA SELATAN,KEBAYORAN BARU,GANDARIA UTARA,39922,8668,31254,24984,56238,2021-10-20
3175051001,JAKARTA TIMUR,PASAR REBO,GEDONG,35755,7730,28025,22639,50664,2021-10-20
3171071001,JAKARTA PUSAT,TANAH ABANG,GELORA,3127,663,2464,2045,4509,2021-10-20
3173031007,JAKARTA BARAT,TAMAN SARI,GLODOK,7837,1322,6515,5692,12207,2021-10-20
3171061004,JAKARTA PUSAT,MENTENG,GONDANGDIA,4100,962,3138,2793,5931,2021-10-20
3173021001,JAKARTA BARAT,GROGOL PETAMBURAN,GROGOL,16876,3643,13233,10721,23954,2021-10-20
3174051005,JAKARTA SELATAN,KEBAYORAN LAMA,GROGOL SELATAN,44251,9871,34380,27116,61496,2021-10-20
3174051004,JAKARTA SELATAN,KEBAYORAN LAMA,GROGOL UTARA,42494,9516,32978,26325,59303,2021-10-20
3174021007,JAKARTA SELATAN,SETIA BUDI,GUNTUR,3985,807,3178,2706,5884,2021-10-20
3174071002,JAKARTA SELATAN,KEBAYORAN BARU,GUNUNG,9436,1873,7563,6346,13909,2021-10-20
3171031005,JAKARTA PUSAT,KEMAYORAN,GUNUNG SAHARI SELATAN,19199,4234,14965,12083,27048,2021-10-20
3171021004,JAKARTA PUSAT,SAWAH BESAR,GUNUNG SAHARI UTARA,16650,3163,13487,11586,25073,2021-10-20
3175081004,JAKARTA TIMUR,MAKASAR,HALIM PERDANA KUSUMAH,28363,4047,24316,21720,46036,2021-10-20
3171031003,JAKARTA PUSAT,KEMAYORAN,HARAPAN MULIA,22557,4971,17586,13641,31227,2021-10-20
3174091001,JAKARTA SELATAN,JAGAKARSA,JAGAKARSA,62389,11629,50760,40224,90984,2021-10-20
3175021007,JAKARTA TIMUR,PULO GADUNG,JATI,32757,6707,26050,21583,47633,2021-10-20
3174041002,JAKARTA SELATAN,PASAR MINGGU,JATI PADANG,37502,8177,29325,23644,52969,2021-10-20
3173071004,JAKARTA BARAT,PALMERAH,JATI PULO,28738,6238,22500,17375,39875,2021-10-20
3175061001,JAKARTA TIMUR,CAKUNG,JATINEGARA,84160,19653,64507,51211,115718,2021-10-20
3175021004,JAKARTA TIMUR,PULO GADUNG,JATINEGARA KAUM,24632,4797,19835,15289,35124,2021-10-20
3173021004,JAKARTA BARAT,GROGOL PETAMBURAN,JELAMBAR,30266,6012,24254,20089,44343,2021-10-20
3173021006,JAKARTA BARAT,GROGOL PETAMBURAN,JELAMBAR BARU,38246,7770,30476,25309,55785,2021-10-20
3173041006,JAKARTA BARAT,TAMBORA,JEMBATAN BESI,29314,7733,21581,16131,37712,2021-10-20
3173041008,JAKARTA BARAT,TAMBORA,JEMBATAN LIMA,21021,5371,15650,11887,27537,2021-10-20
3173081005,JAKARTA BARAT,KEMBANGAN,JOGLO,40839,9032,31807,26009,57816,2021-10-20
3171081001,JAKARTA PUSAT,JOHAR BARU,JOHAR BARU,37488,7402,30086,24545,54631,2021-10-20
3173041002,JAKARTA BARAT,TAMBORA,KALI ANYAR,23856,5162,18694,14203,32897,2021-10-20
3172041004,JAKARTA UTARA,CILINCING,KALIBARU,67684,20048,47636,32994,80630,2021-10-20
3174081002,JAKARTA SELATAN,PANCORAN,KALIBATA,41994,10428,31566,24110,55676,2021-10-20
3173061001,JAKARTA BARAT,KALI DERES,KALIDERES,72447,16468,55979,45810,101789,2021-10-20
3175051004,JAKARTA TIMUR,PASAR REBO,KALISARI,43212,8481,34731,27868,62599,2021-10-20
3173061004,JAKARTA BARAT,KALI DERES,KAMAL,53783,13862,39921,30686,70607,2021-10-20
3172011002,JAKARTA UTARA,PENJARINGAN,KAMAL MUARA,12930,2384,10546,8832,19378,2021-10-20
3171071007,JAKARTA PUSAT,TANAH ABANG,KAMPUNG BALI,11358,2650,8708,6343,15051,2021-10-20
3175031001,JAKARTA TIMUR,JATINEGARA,KAMPUNG MELAYU,25717,6643,19074,14229,33303,2021-10-20
3171081002,JAKARTA PUSAT,JOHAR BARU,KAMPUNG RAWA,21237,3737,17500,13518,31018,2021-10-20
3175041002,JAKARTA TIMUR,KRAMAT JATI,KAMPUNG TENGAH,43993,11802,32191,24384,56575,2021-10-20
3173011005,JAKARTA BARAT,CENGKARENG,KAPUK,134466,35024,99442,76959,176401,2021-10-20
3172011003,JAKARTA UTARA,PENJARINGAN,KAPUK MUARA,35781,7393,28388,24259,52647,2021-10-20
3171021002,JAKARTA PUSAT,SAWAH BESAR,KARANG ANYAR,25761,5367,20394,16495,36889,2021-10-20
3174021004,JAKARTA SELATAN,SETIA BUDI,KARET,9623,2036,7587,6071,13658,2021-10-20
3174021003,JAKARTA SELATAN,SETIA BUDI,KARET KUNINGAN,16055,3394,12661,10358,23019,2021-10-20
3174021002,JAKARTA SELATAN,SETIA BUDI,KARET SEMANGGI,2770,587,2183,1883,4066,2021-10-20
3171071003,JAKARTA PUSAT,TANAH ABANG,KARET TENGSIN,19271,4014,15257,11933,27190,2021-10-20
3171021003,JAKARTA PUSAT,SAWAH BESAR,KARTINI,22292,4656,17636,14475,32111,2021-10-20
3175011003,JAKARTA TIMUR,MATRAMAN,KAYU MANIS,25284,5813,19471,14650,34121,2021-10-20
3175021006,JAKARTA TIMUR,PULO GADUNG,KAYU PUTIH,40696,8263,32433,27389,59822,2021-10-20
3173031006,JAKARTA BARAT,TAMAN SARI,KEAGUNGAN,17387,3567,13820,10851,24671,2021-10-20
3174041007,JAKARTA SELATAN,PASAR MINGGU,KEBAGUSAN,44552,9679,34873,27449,62322,2021-10-20
3174051006,JAKARTA SELATAN,KEBAYORAN LAMA,KEBAYORAN LAMA SELATAN,41212,8375,32837,26371,59208,2021-10-20
3174051001,JAKARTA SELATAN,KEBAYORAN LAMA,KEBAYORAN LAMA UTARA,42422,9739,32683,25776,58459,2021-10-20
3174011004,JAKARTA SELATAN,TEBET,KEBON BARU,35165,7237,27928,22110,50038,2021-10-20
3172021005,JAKARTA UTARA,TANJUNG PRIOK,KEBON BAWANG,50952,11176,39776,31773,71549,2021-10-20
3173051001,JAKARTA BARAT,KEBON JERUK,KEBON JERUK,53887,12623,41264,32529,73793,2021-10-20
3171071006,JAKARTA PUSAT,TANAH ABANG,KEBON KACANG,21531,5599,15932,12088,28020,2021-10-20
3171011005,JAKARTA PUSAT,GAMBIR,KEBON KELAPA,10163,2199,7964,6410,14374,2021-10-20
3171031002,JAKARTA PUSAT,KEMAYORAN,KEBON KOSONG,30019,6511,23508,17947,41455,2021-10-20
3175011005,JAKARTA TIMUR,MATRAMAN,KEBON MANGGIS,16490,3499,12991,10351,23342,2021-10-20
3171071005,JAKARTA PUSAT,TANAH ABANG,KEBON MELATI,32206,9120,23086,16311,39397,2021-10-20
3175081003,JAKARTA TIMUR,MAKASAR,KEBON PALA,46614,10169,36445,29024,65469,2021-10-20
3171061005,JAKARTA PUSAT,MENTENG,KEBON SIRIH,12299,2845,9454,7279,16733,2021-10-20
3173011004,JAKARTA BARAT,CENGKARENG,KEDAUNG KALI ANGKE,32612,6841,25771,20832,46603,2021-10-20
3173051007,JAKARTA BARAT,KEBON JERUK,KEDOYA SELATAN,32165,6386,25779,20525,46304,2021-10-20
3173051006,JAKARTA BARAT,KEBON JERUK,KEDOYA UTARA,45740,9324,36416,29971,66387,2021-10-20
3173051004,JAKARTA BARAT,KEBON JERUK,KELAPA DUA,23565,5224,18341,14609,32950,2021-10-20
3175091003,JAKARTA TIMUR,CIRACAS,KELAPA DUA WETAN,46875,8784,38091,30703,68794,2021-10-20
3172061003,JAKARTA UTARA,KELAPA GADING,KELAPA GADING BARAT,35717,6552,29165,25659,54824,2021-10-20
3172061001,JAKARTA UTARA,KELAPA GADING,KELAPA GADING TIMUR,33592,5467,28125,25354,53479,2021-10-20
3173071005,JAKARTA BARAT,PALMERAH,KEMANGGISAN,32139,6679,25460,20342,45802,2021-10-20
3171031001,JAKARTA PUSAT,KEMAYORAN,KEMAYORAN,20708,4627,16081,12807,28888,2021-10-20
3173081006,JAKARTA BARAT,KEMBANGAN,KEMBANGAN SELATAN,27130,6200,20930,17626,38556,2021-10-20
3173081001,JAKARTA BARAT,KEMBANGAN,KEMBANGAN UTARA,54451,12984,41467,33473,74940,2021-10-20
3171041002,JAKARTA PUSAT,SENEN,KENARI,9579,2035,7544,6227,13771,2021-10-20
3173041005,JAKARTA BARAT,TAMBORA,KERENDANG,19973,4566,15407,12000,27407,2021-10-20
3175071003,JAKARTA TIMUR,DUREN SAWIT,KLENDER,69978,17660,52318,39885,92203,2021-10-20
3172031001,JAKARTA UTARA,KOJA,KOJA,28175,6913,21262,16550,37812,2021-10-20
3173071006,JAKARTA BARAT,PALMERAH,KOTA BAMBU SELATAN,21158,4810,16348,12455,28803,2021-10-20
3173071003,JAKARTA BARAT,PALMERAH,KOTA BAMBU UTARA,24995,5920,19075,14421,33496,2021-10-20
3171041004,JAKARTA PUSAT,SENEN,KRAMAT,28835,7488,21347,15757,37104,2021-10-20
3175041001,JAKARTA TIMUR,KRAMAT JATI,KRAMAT JATI,34144,8016,26128,20236,46364,2021-10-20
3174071003,JAKARTA SELATAN,KEBAYORAN BARU,KRAMAT PELA,14413,3002,11411,9318,20729,2021-10-20
3173031002,JAKARTA BARAT,TAMAN SARI,KRUKUT,19244,4001,15243,11815,27058,2021-10-20
3174031005,JAKARTA SELATAN,MAMPANG PRAPATAN,KUNINGAN BARAT,12785,2572,10213,8192,18405,2021-10-20
3174021008,JAKARTA SELATAN,SETIA BUDI,KUNINGAN TIMUR,6008,1341,4667,3843,8510,2021-10-20
3171041005,JAKARTA PUSAT,SENEN,KWITANG,15486,3810,11676,9153,20829,2021-10-20
3172031003,JAKARTA UTARA,KOJA,LAGOA,59065,15140,43925,33509,77434,2021-10-20
3174061002,JAKARTA SELATAN,CILANDAK,LEBAK BULUS,37626,7732,29894,24618,54512,2021-10-20
3174091004,JAKARTA SELATAN,JAGAKARSA,LENTENG AGUNG,53946,10772,43174,32902,76076,2021-10-20
3175101007,JAKARTA TIMUR,CIPAYUNG,LUBANG BUAYA,63547,12975,50572,40273,90845,2021-10-20
3175081001,JAKARTA TIMUR,MAKASAR,MAKASAR,34390,6864,27526,22217,49743,2021-10-20
3175071006,JAKARTA TIMUR,DUREN SAWIT,MALAKA JAYA,30927,6008,24919,20320,45239,2021-10-20
3175071005,JAKARTA TIMUR,DUREN SAWIT,MALAKA SARI,27530,5035,22495,18572,41067,2021-10-20
3174031001,JAKARTA SELATAN,MAMPANG PRAPATAN,MAMPANG PRAPATAN,18159,4094,14065,11028,25093,2021-10-20
3173031005,JAKARTA BARAT,TAMAN SARI,MANGGA BESAR,7707,1384,6323,5312,11635,2021-10-20
3171021005,JAKARTA PUSAT,SAWAH BESAR,MANGGA DUA SELATAN,27442,6104,21338,17315,38653,2021-10-20
3174011007,JAKARTA SELATAN,TEBET,MANGGARAI,28373,5548,22825,17616,40441,2021-10-20
3174011006,JAKARTA SELATAN,TEBET,MANGGARAI SELATAN,23075,4505,18570,15002,33572,2021-10-20
3173031003,JAKARTA BARAT,TAMAN SARI,MAPHAR,16461,3324,13137,10527,23664,2021-10-20
3172041003,JAKARTA UTARA,CILINCING,MARUNDA,28943,7092,21851,15974,37825,2021-10-20
3174071001,JAKARTA SELATAN,KEBAYORAN BARU,MELAWAI,2627,553,2074,1888,3962,2021-10-20
3171061001,JAKARTA PUSAT,MENTENG,MENTENG,25624,6228,19396,14681,34077,2021-10-20
3174021005,JAKARTA SELATAN,SETIA BUDI,MENTENG ATAS,27816,5532,22284,17634,39918,2021-10-20
3174011003,JAKARTA SELATAN,TEBET,MENTENG DALAM,36028,7660,28368,22722,51090,2021-10-20
3173081003,JAKARTA BARAT,KEMBANGAN,MERUYA SELATAN,32130,7182,24948,20079,45027,2021-10-20
3173081002,JAKARTA BARAT,KEMBANGAN,MERUYA UTARA,43752,9863,33889,28370,62259,2021-10-20
3175101004,JAKARTA TIMUR,CIPAYUNG,MUNJUL,23871,4660,19211,15355,34566,2021-10-20
3172051002,JAKARTA UTARA,PADEMANGAN,PADEMANGAN BARAT,74240,18823,55417,43038,98455,2021-10-20
3172051001,JAKARTA UTARA,PADEMANGAN,PADEMANGAN TIMUR,37736,7180,30556,25690,56246,2021-10-20
3175011004,JAKARTA TIMUR,MATRAMAN,PAL MERIAM,19769,4600,15169,11692,26861,2021-10-20
3173071001,JAKARTA BARAT,PALMERAH,PALMERAH,63011,14842,48169,37705,85874,2021-10-20
3174081001,JAKARTA SELATAN,PANCORAN,PANCORAN,19421,4457,14964,11975,26939,2021-10-20
3172021003,JAKARTA UTARA,TANJUNG PRIOK,PAPANGGO,39097,8520,30577,24252,54829,2021-10-20
3171021001,JAKARTA PUSAT,SAWAH BESAR,PASAR BARU,12035,2476,9559,8276,17835,2021-10-20
3174021006,JAKARTA SELATAN,SETIA BUDI,PASAR MANGGIS,26752,5822,20930,16638,37568,2021-10-20
3174041001,JAKARTA SELATAN,PASAR MINGGU,PASAR MINGGU,24821,5062,19759,16039,35798,2021-10-20
3171041003,JAKARTA PUSAT,SENEN,PASEBAN,23533,5433,18100,14308,32408,2021-10-20
3173061005,JAKARTA BARAT,KALI DERES,PEGADUNGAN,75587,16696,58891,49330,108221,2021-10-20
3171061002,JAKARTA PUSAT,MENTENG,PEGANGSAAN,23455,5589,17866,13095,30961,2021-10-20
3172061002,JAKARTA UTARA,KELAPA GADING,PEGANGSAAN DUA,49976,8765,41211,36432,77643,2021-10-20
3172011004,JAKARTA UTARA,PENJARINGAN,PEJAGALAN,74578,16714,57864,47747,105611,2021-10-20
3174041006,JAKARTA SELATAN,PASAR MINGGU,PEJATEN BARAT,37346,8173,29173,23358,52531,2021-10-20
3174041005,JAKARTA SELATAN,PASAR MINGGU,PEJATEN TIMUR,57656,14176,43480,34301,77781,2021-10-20
3175051005,JAKARTA TIMUR,PASAR REBO,PEKAYON,43250,8630,34620,27518,62138,2021-10-20
3173041009,JAKARTA BARAT,TAMBORA,PEKOJAN,23587,4847,18740,15147,33887,2021-10-20
3174031003,JAKARTA SELATAN,MAMPANG PRAPATAN,PELA MAMPANG,43522,9500,34022,27119,61141,2021-10-20
3174081005,JAKARTA SELATAN,PANCORAN,PENGADEGAN,21478,4250,17228,13878,31106,2021-10-20
3175061003,JAKARTA TIMUR,CAKUNG,PENGGILINGAN,99255,25284,73971,56732,130703,2021-10-20
3172011001,JAKARTA UTARA,PENJARINGAN,PENJARINGAN,88308,24480,63828,47281,111109,2021-10-20
3174101001,JAKARTA SELATAN,PESANGGRAHAN,PESANGGRAHAN,27545,5144,22401,18455,40856,2021-10-20
3171071004,JAKARTA PUSAT,TANAH ABANG,PETAMBURAN,33271,9418,23853,17269,41122,2021-10-20
3174071008,JAKARTA SELATAN,KEBAYORAN BARU,PETOGOGAN,11499,2461,9038,7365,16403,2021-10-20
3171011004,JAKARTA PUSAT,GAMBIR,PETOJO SELATAN,14692,3532,11160,9123,20283,2021-10-20
3171011003,JAKARTA PUSAT,GAMBIR,PETOJO UTARA,17458,4010,13448,10622,24070,2021-10-20
3174101004,JAKARTA SELATAN,PESANGGRAHAN,PETUKANGAN SELATAN,37187,8304,28883,23338,52221,2021-10-20
3174101003,JAKARTA SELATAN,PESANGGRAHAN,PETUKANGAN UTARA,53716,12668,41048,32730,73778,2021-10-20
3175081002,JAKARTA TIMUR,MAKASAR,PINANG RANTI,27198,6429,20769,16609,37378,2021-10-20
3173031008,JAKARTA BARAT,TAMAN SARI,PINANGSIA,10729,2039,8690,6950,15640,2021-10-20
3175011001,JAKARTA TIMUR,MATRAMAN,PISANGAN BARU,31776,7150,24626,18632,43258,2021-10-20
3175021002,JAKARTA TIMUR,PULO GADUNG,PISANGAN TIMUR,41011,8435,32576,26370,58946,2021-10-20
3172011005,JAKARTA UTARA,PENJARINGAN,PLUIT,47783,9795,37988,32148,70136,2021-10-20
3175071002,JAKARTA TIMUR,DUREN SAWIT,PONDOK BAMBU,61550,14122,47428,37283,84711,2021-10-20
3175071004,JAKARTA TIMUR,DUREN SAWIT,PONDOK KELAPA,72015,15451,56564,46689,103253,2021-10-20
3175071007,JAKARTA TIMUR,DUREN SAWIT,PONDOK KOPI,35367,7447,27920,21017,48937,2021-10-20
3174061003,JAKARTA SELATAN,CILANDAK,PONDOK LABU,46464,8769,37695,31531,69226,2021-10-20
3174051002,JAKARTA SELATAN,KEBAYORAN LAMA,PONDOK PINANG,56169,11564,44605,35973,80578,2021-10-20
3175101003,JAKARTA TIMUR,CIPAYUNG,PONDOK RANGGON,25574,5187,20387,15988,36375,2021-10-20
3101011003,KAB.ADM.KEP.SERIBU,KEP. SERIBU UTARA,PULAU HARAPAN,2060,232,1828,1567,3395,2021-10-20
3101011002,KAB.ADM.KEP.SERIBU,KEP. SERIBU UTARA,PULAU KELAPA,5528,638,4890,3959,8849,2021-10-20
3101011001,KAB.ADM.KEP.SERIBU,KEP. SERIBU UTARA,PULAU PANGGANG,5450,479,4971,4367,9338,2021-10-20
3101021003,KAB.ADM.KEP.SERIBU,KEP. SERIBU SELATAN,PULAU PARI,2765,204,2561,2373,4934,2021-10-20
3101021002,KAB.ADM.KEP.SERIBU,KEP. SERIBU SELATAN,PULAU TIDUNG,4553,402,4151,3723,7874,2021-10-20
3101021001,KAB.ADM.KEP.SERIBU,KEP. SERIBU SELATAN,PULAU UNTUNG JAWA,1941,173,1768,1609,3377,2021-10-20
3174071007,JAKARTA SELATAN,KEBAYORAN BARU,PULO,5835,1076,4759,4167,8926,2021-10-20
3175021001,JAKARTA TIMUR,PULO GADUNG,PULO GADUNG,34422,8066,26356,21102,47458,2021-10-20
3175061005,JAKARTA TIMUR,CAKUNG,PULO GEBANG,97301,20327,76974,60084,137058,2021-10-20
3174041004,JAKARTA SELATAN,PASAR MINGGU,RAGUNAN,39616,8077,31539,25771,57310,2021-10-20
3175091005,JAKARTA TIMUR,CIRACAS,RAMBUTAN,36771,9305,27466,20833,48299,2021-10-20
3172031006,JAKARTA UTARA,KOJA,RAWA BADAK SELATAN,42179,10810,31369,23844,55213,2021-10-20
3172031004,JAKARTA UTARA,KOJA,RAWA BADAK UTARA,34408,8357,26051,20120,46171,2021-10-20
3174071005,JAKARTA SELATAN,KEBAYORAN BARU,RAWA BARAT,5625,1057,4568,3898,8466,2021-10-20
3173011003,JAKARTA BARAT,CENGKARENG,RAWA BUAYA,63799,14023,49776,38233,88009,2021-10-20
3175031004,JAKARTA TIMUR,JATINEGARA,RAWA BUNGA,21434,5590,15844,12242,28086,2021-10-20
3174081003,JAKARTA SELATAN,PANCORAN,RAWA JATI,20509,4219,16290,13091,29381,2021-10-20
3175061002,JAKARTA TIMUR,CAKUNG,RAWA TERATE,24637,4932,19705,15587,35292,2021-10-20
3175021005,JAKARTA TIMUR,PULO GADUNG,RAWAMANGUN,37612,8118,29494,23939,53433,2021-10-20
3171051003,JAKARTA PUSAT,CEMPAKA PUTIH,RAWASARI,21967,4859,17108,13914,31022,2021-10-20
3173041010,JAKARTA BARAT,TAMBORA,ROA MALAKA,3484,646,2838,2447,5285,2021-10-20
3172041006,JAKARTA UTARA,CILINCING,ROROTAN,41668,9021,32647,25310,57957,2021-10-20
3174071004,JAKARTA SELATAN,KEBAYORAN BARU,SELONG,2842,569,2273,2036,4309,2021-10-20
3173061002,JAKARTA BARAT,KALI DERES,SEMANAN,71354,17377,53977,42462,96439,2021-10-20
3172041007,JAKARTA UTARA,CILINCING,SEMPER BARAT,68587,14517,54070,43450,97520,2021-10-20
3172041005,JAKARTA UTARA,CILINCING,SEMPER TIMUR,36267,8387,27880,21793,49673,2021-10-20
3174071006,JAKARTA SELATAN,KEBAYORAN BARU,SENAYAN,2771,685,2086,1729,3815,2021-10-20
3171041001,JAKARTA PUSAT,SENEN,SENEN,6804,1589,5215,4247,9462,2021-10-20
3171031004,JAKARTA PUSAT,KEMAYORAN,SERDANG,29668,6431,23237,18538,41775,2021-10-20
3174021001,JAKARTA SELATAN,SETIA BUDI,SETIA BUDI,3023,668,2355,1911,4266,2021-10-20
3175101005,JAKARTA TIMUR,CIPAYUNG,SETU,20572,4481,16091,12402,28493,2021-10-20
3173071002,JAKARTA BARAT,PALMERAH,SLIPI,16591,3274,13317,10752,24069,2021-10-20
3173081004,JAKARTA BARAT,KEMBANGAN,SRENGSENG,45523,11059,34464,28141,62605,2021-10-20
3174091002,JAKARTA SELATAN,JAGAKARSA,SRENGSENG SAWAH,58196,10036,48160,39243,87403,2021-10-20
3173051003,JAKARTA BARAT,KEBON JERUK,SUKABUMI SELATAN,37033,9103,27930,20851,48781,2021-10-20
3173051002,JAKARTA BARAT,KEBON JERUK,SUKABUMI UTARA,38290,9762,28528,21477,50005,2021-10-20
3172041002,JAKARTA UTARA,CILINCING,SUKAPURA,53949,13100,40849,32523,73372,2021-10-20
3171031007,JAKARTA PUSAT,KEMAYORAN,SUMUR BATU,22717,4973,17744,14516,32260,2021-10-20
3172021004,JAKARTA UTARA,TANJUNG PRIOK,SUNGAI BAMBU,29876,6568,23308,18582,41890,2021-10-20
3172021006,JAKARTA UTARA,TANJUNG PRIOK,SUNTER AGUNG,71805,13408,58397,49389,107786,2021-10-20
3172021002,JAKARTA UTARA,TANJUNG PRIOK,SUNTER JAYA,63031,11946,51085,42468,93553,2021-10-20
3175091004,JAKARTA TIMUR,CIRACAS,SUSUKAN,38257,7780,30477,24365,54842,2021-10-20
3173031001,JAKARTA BARAT,TAMAN SARI,TAMAN SARI,14348,2818,11530,9604,21134,2021-10-20
3173041001,JAKARTA BARAT,TAMBORA,TAMBORA,10204,2451,7753,6036,13789,2021-10-20
3173041004,JAKARTA BARAT,TAMBORA,TANAH SEREAL,26387,4817,21570,17491,39061,2021-10-20
3171081004,JAKARTA PUSAT,JOHAR BARU,TANAH TINGGI,37693,7645,30048,23626,53674,2021-10-20
3173031004,JAKARTA BARAT,TAMAN SARI,TANGKI,13324,2391,10933,8793,19726,2021-10-20
3174091005,JAKARTA SELATAN,JAGAKARSA,TANJUNG BARAT,39770,7310,32460,25243,57703,2021-10-20
3173021005,JAKARTA BARAT,GROGOL PETAMBURAN,TANJUNG DUREN SELATAN,25337,5257,20080,17028,37108,2021-10-20
3173021002,JAKARTA BARAT,GROGOL PETAMBURAN,TANJUNG DUREN UTARA,17010,3095,13915,11905,25820,2021-10-20
3172021001,JAKARTA UTARA,TANJUNG PRIOK,TANJUNG PRIOK,34588,7705,26883,21263,48146,2021-10-20
3174011002,JAKARTA SELATAN,TEBET,TEBET BARAT,21194,3789,17405,14776,32181,2021-10-20
3174011001,JAKARTA SELATAN,TEBET,TEBET TIMUR,18199,3174,15025,12999,28024,2021-10-20
3173061003,JAKARTA BARAT,KALI DERES,TEGAL ALUR,83647,19347,64300,51343,115643,2021-10-20
3174031004,JAKARTA SELATAN,MAMPANG PRAPATAN,TEGAL PARANG,32401,7807,24594,18024,42618,2021-10-20
3173021003,JAKARTA BARAT,GROGOL PETAMBURAN,TOMANG,29605,5895,23710,19472,43182,2021-10-20
3172031005,JAKARTA UTARA,KOJA,TUGU SELATAN,39122,9433,29689,23121,52810,2021-10-20
3172031002,JAKARTA UTARA,KOJA,TUGU UTARA,67670,17240,50430,38385,88815,2021-10-20
3175061006,JAKARTA TIMUR,CAKUNG,UJUNG MENTENG,29934,5616,24318,19902,44220,2021-10-20
3174101005,JAKARTA SELATAN,PESANGGRAHAN,ULUJAMI,40544,9981,30563,23948,54511,2021-10-20
3175011006,JAKARTA TIMUR,MATRAMAN,UTAN KAYU SELATAN,33511,6601,26910,21223,48133,2021-10-20
3175011002,JAKARTA TIMUR,MATRAMAN,UTAN KAYU UTARA,28169,6407,21762,17070,38832,2021-10-20
3171031008,JAKARTA PUSAT,KEMAYORAN,UTAN PANJANG,29208,6423,22785,17421,40206,2021-10-20
3172021007,JAKARTA UTARA,TANJUNG PRIOK,WARAKAS,44401,8785,35616,27520,63136,2021-10-20
3173021007,JAKARTA BARAT,GROGOL PETAMBURAN,WIJAYA KUSUMA,38934,8857,30077,24180,54257,2021-10-20
3172051003,JAKARTA UTARA,PADEMANGAN,ANCOL,23947,6184,17763,14130,31893,2021-10-21
3173041007,JAKARTA BARAT,TAMBORA,ANGKE,29381,6825,22556,17647,40203,2021-10-21
3175041005,JAKARTA TIMUR,KRAMAT JATI,BALE KAMBANG,29074,7857,21217,15715,36932,2021-10-21
3175031003,JAKARTA TIMUR,JATINEGARA,BALI MESTER,9752,2223,7529,6058,13587,2021-10-21
3175101006,JAKARTA TIMUR,CIPAYUNG,BAMBU APUS,26285,5240,21045,16469,37514,2021-10-21
3174031002,JAKARTA SELATAN,MAMPANG PRAPATAN,BANGKA,21566,5037,16529,13023,29552,2021-10-21
3175051002,JAKARTA TIMUR,PASAR REBO,BARU,23886,4285,19601,16316,35917,2021-10-21
3175041004,JAKARTA TIMUR,KRAMAT JATI,BATU AMPAR,47898,12674,35224,26748,61972,2021-10-21
3171071002,JAKARTA PUSAT,TANAH ABANG,BENDUNGAN HILIR,21494,4650,16844,13716,30560,2021-10-21
3175031002,JAKARTA TIMUR,JATINEGARA,BIDARA CINA,36689,9494,27195,20639,47834,2021-10-21
3174101002,JAKARTA SELATAN,PESANGGRAHAN,BINTARO,53098,11643,41455,34058,75513,2021-10-21
3174011005,JAKARTA SELATAN,TEBET,BUKIT DURI,34183,7716,26467,21093,47560,2021-10-21
3171041006,JAKARTA PUSAT,SENEN,BUNGUR,18144,4185,13959,11260,25219,2021-10-21
3175061007,JAKARTA TIMUR,CAKUNG,CAKUNG BARAT,57724,12868,44856,35965,80821,2021-10-21
3175061004,JAKARTA TIMUR,CAKUNG,CAKUNG TIMUR,58287,12450,45837,36576,82413,2021-10-21
3175041007,JAKARTA TIMUR,KRAMAT JATI,CAWANG,32762,7837,24925,19029,43954,2021-10-21
3175101008,JAKARTA TIMUR,CIPAYUNG,CEGER,18932,3999,14933,11917,26850,2021-10-21
3171031006,JAKARTA PUSAT,KEMAYORAN,CEMPAKA BARU,32581,7407,25174,19141,44315,2021-10-21
3171051002,JAKARTA PUSAT,CEMPAKA PUTIH,CEMPAKA PUTIH BARAT,35885,8322,27563,22477,50040,2021-10-21
3171051001,JAKARTA PUSAT,CEMPAKA PUTIH,CEMPAKA PUTIH TIMUR,24292,5381,18911,15789,34700,2021-10-21
3173011001,JAKARTA BARAT,CENGKARENG,CENGKARENG BARAT,66284,14722,51562,41891,93453,2021-10-21
3173011006,JAKARTA BARAT,CENGKARENG,CENGKARENG TIMUR,81027,17420,63607,50131,113738,2021-10-21
3175091002,JAKARTA TIMUR,CIRACAS,CIBUBUR,66364,12282,54082,43336,97418,2021-10-21
3171011002,JAKARTA PUSAT,GAMBIR,CIDENG,15390,3187,12203,10277,22480,2021-10-21
3174091003,JAKARTA SELATAN,JAGAKARSA,CIGANJUR,38497,7212,31285,24180,55465,2021-10-21
3175051003,JAKARTA TIMUR,PASAR REBO,CIJANTUNG,41419,8342,33077,26419,59496,2021-10-21
3171061003,JAKARTA PUSAT,MENTENG,CIKINI,8274,1575,6699,5072,11771,2021-10-21
3174081006,JAKARTA SELATAN,PANCORAN,CIKOKO,10547,1961,8586,7131,15717,2021-10-21
3174061001,JAKARTA SELATAN,CILANDAK,CILANDAK BARAT,51752,10131,41621,34489,76110,2021-10-21
3174041003,JAKARTA SELATAN,PASAR MINGGU,CILANDAK TIMUR,25145,5088,20057,16390,36447,2021-10-21
3175101002,JAKARTA TIMUR,CIPAYUNG,CILANGKAP,27635,5266,22369,17797,40166,2021-10-21
3175041006,JAKARTA TIMUR,KRAMAT JATI,CILILITAN,40181,9753,30428,23572,54000,2021-10-21
3172041001,JAKARTA UTARA,CILINCING,CILINCING,43609,11310,32299,24149,56448,2021-10-21
3175101001,JAKARTA TIMUR,CIPAYUNG,CIPAYUNG,26104,4913,21191,17456,38647,2021-10-21
3174091006,JAKARTA SELATAN,JAGAKARSA,CIPEDAK,38303,7132,31171,24983,56154,2021-10-21
3174061005,JAKARTA SELATAN,CILANDAK,CIPETE SELATAN,26704,5558,21146,17614,38760,2021-10-21
3174071010,JAKARTA SELATAN,KEBAYORAN BARU,CIPETE UTARA,34102,7001,27101,21208,48309,2021-10-21
3175021003,JAKARTA TIMUR,PULO GADUNG,CIPINANG,39306,8083,31223,24708,55931,2021-10-21
3175031007,JAKARTA TIMUR,JATINEGARA,CIPINANG BESAR SELATAN,35212,9025,26187,19484,45671,2021-10-21
3175031008,JAKARTA TIMUR,JATINEGARA,CIPINANG BESAR UTARA,45319,11650,33669,24878,58547,2021-10-21
3175031005,JAKARTA TIMUR,JATINEGARA,CIPINANG CEMPEDAK,32824,7694,25130,20006,45136,2021-10-21
3175081005,JAKARTA TIMUR,MAKASAR,CIPINANG MELAYU,42308,8859,33449,26943,60392,2021-10-21
3175031006,JAKARTA TIMUR,JATINEGARA,CIPINANG MUARA,55243,12965,42278,32835,75113,2021-10-21
3174051003,JAKARTA SELATAN,KEBAYORAN LAMA,CIPULIR,39937,9147,30790,23633,54423,2021-10-21
3175091001,JAKARTA TIMUR,CIRACAS,CIRACAS,64594,12793,51801,40726,92527,2021-10-21
3175041003,JAKARTA TIMUR,KRAMAT JATI,DUKUH,24609,5059,19550,15328,34878,2021-10-21
3175071001,JAKARTA TIMUR,DUREN SAWIT,DUREN SAWIT,61160,14032,47128,36871,83999,2021-10-21
3174081004,JAKARTA SELATAN,PANCORAN,DUREN TIGA,28319,6098,22221,17584,39805,2021-10-21
3173051005,JAKARTA BARAT,KEBON JERUK,DURI KEPA,60138,12744,47394,39725,87119,2021-10-21
3173011002,JAKARTA BARAT,CENGKARENG,DURI KOSAMBI,77923,18459,59464,45635,105099,2021-10-21
3171011006,JAKARTA PUSAT,GAMBIR,DURI PULO,19610,4471,15139,11737,26876,2021-10-21
3173041011,JAKARTA BARAT,TAMBORA,DURI SELATAN,14259,2733,11526,9408,20934,2021-10-21
3173041003,JAKARTA BARAT,TAMBORA,DURI UTARA,19844,4014,15830,12595,28425,2021-10-21
3171081003,JAKARTA PUSAT,JOHAR BARU,GALUR,18243,3890,14353,11269,25622,2021-10-21
3171011001,JAKARTA PUSAT,GAMBIR,GAMBIR,2191,485,1706,1426,3132,2021-10-21
3174061004,JAKARTA SELATAN,CILANDAK,GANDARIA SELATAN,22119,4672,17447,14055,31502,2021-10-21
3174071009,JAKARTA SELATAN,KEBAYORAN BARU,GANDARIA UTARA,39922,8662,31260,25008,56268,2021-10-21
3175051001,JAKARTA TIMUR,PASAR REBO,GEDONG,35755,7715,28040,22646,50686,2021-10-21
3171071001,JAKARTA PUSAT,TANAH ABANG,GELORA,3127,663,2464,2046,4510,2021-10-21
3173031007,JAKARTA BARAT,TAMAN SARI,GLODOK,7837,1321,6516,5693,12209,2021-10-21
3171061004,JAKARTA PUSAT,MENTENG,GONDANGDIA,4100,962,3138,2794,5932,2021-10-21
3173021001,JAKARTA BARAT,GROGOL PETAMBURAN,GROGOL,16876,3643,13233,10724,23957,2021-10-21
3174051005,JAKARTA SELATAN,KEBAYORAN LAMA,GROGOL SELATAN,44251,9861,34390,27139,61529,2021-10-21
3174051004,JAKARTA SELATAN,KEBAYORAN LAMA,GROGOL UTARA,42494,9510,32984,26349,59333,2021-10-21
3174021007,JAKARTA SELATAN,SETIA BUDI,GUNTUR,3985,807,3178,2710,5888,2021-10-21
3174071002,JAKARTA SELATAN,KEBAYORAN BARU,GUNUNG,9436,1869,7567,6353,13920,2021-10-21
3171031005,JAKARTA PUSAT,KEMAYORAN,GUNUNG SAHARI SELATAN,19199,4229,14970,12094,27064,2021-10-21
3171021004,JAKARTA PUSAT,SAWAH BESAR,GUNUNG SAHARI UTARA,16650,3161,13489,11593,25082,2021-10-21
3175081004,JAKARTA TIMUR,MAKASAR,HALIM PERDANA KUSUMAH,28363,4043,24320,21726,46046,2021-10-21
3171031003,JAKARTA PUSAT,KEMAYORAN,HARAPAN MULIA,22557,4970,17587,13655,31242,2021-10-21
3174091001,JAKARTA SELATAN,JAGAKARSA,JAGAKARSA,62389,11622,50767,40246,91013,2021-10-21
3175021007,JAKARTA TIMUR,PULO GADUNG,JATI,32757,6703,26054,21592,47646,2021-10-21
3174041002,JAKARTA SELATAN,PASAR MINGGU,JATI PADANG,37502,8171,29331,23663,52994,2021-10-21
3173071004,JAKARTA BARAT,PALMERAH,JATI PULO,28738,6231,22507,17388,39895,2021-10-21
3175061001,JAKARTA TIMUR,CAKUNG,JATINEGARA,84160,19638,64522,51242,115764,2021-10-21
3175021004,JAKARTA TIMUR,PULO GADUNG,JATINEGARA KAUM,24632,4791,19841,15294,35135,2021-10-21
3173021004,JAKARTA BARAT,GROGOL PETAMBURAN,JELAMBAR,30266,6007,24259,20109,44368,2021-10-21
3173021006,JAKARTA BARAT,GROGOL PETAMBURAN,JELAMBAR BARU,38246,7766,30480,25314,55794,2021-10-21
3173041006,JAKARTA BARAT,TAMBORA,JEMBATAN BESI,29314,7725,21589,16153,37742,2021-10-21
3173041008,JAKARTA BARAT,TAMBORA,JEMBATAN LIMA,21021,5368,15653,11896,27549,2021-10-21
3173081005,JAKARTA BARAT,KEMBANGAN,JOGLO,40839,9022,31817,26026,57843,2021-10-21
3171081001,JAKARTA PUSAT,JOHAR BARU,JOHAR BARU,37488,7400,30088,24556,54644,2021-10-21
3173041002,JAKARTA BARAT,TAMBORA,KALI ANYAR,23856,5151,18705,14215,32920,2021-10-21
3172041004,JAKARTA UTARA,CILINCING,KALIBARU,67684,20003,47681,33025,80706,2021-10-21
3174081002,JAKARTA SELATAN,PANCORAN,KALIBATA,41994,10415,31579,24134,55713,2021-10-21
3173061001,JAKARTA BARAT,KALI DERES,KALIDERES,72447,16453,55994,45831,101825,2021-10-21
3175051004,JAKARTA TIMUR,PASAR REBO,KALISARI,43212,8472,34740,27885,62625,2021-10-21
3173061004,JAKARTA BARAT,KALI DERES,KAMAL,53783,13851,39932,30700,70632,2021-10-21
3172011002,JAKARTA UTARA,PENJARINGAN,KAMAL MUARA,12930,2380,10550,8833,19383,2021-10-21
3171071007,JAKARTA PUSAT,TANAH ABANG,KAMPUNG BALI,11358,2647,8711,6347,15058,2021-10-21
3175031001,JAKARTA TIMUR,JATINEGARA,KAMPUNG MELAYU,25717,6640,19077,14233,33310,2021-10-21
3171081002,JAKARTA PUSAT,JOHAR BARU,KAMPUNG RAWA,21237,3734,17503,13524,31027,2021-10-21
3175041002,JAKARTA TIMUR,KRAMAT JATI,KAMPUNG TENGAH,43993,11791,32202,24405,56607,2021-10-21
3173011005,JAKARTA BARAT,CENGKARENG,KAPUK,134466,34999,99467,76985,176452,2021-10-21
3172011003,JAKARTA UTARA,PENJARINGAN,KAPUK MUARA,35781,7391,28390,24262,52652,2021-10-21
3171021002,JAKARTA PUSAT,SAWAH BESAR,KARANG ANYAR,25761,5365,20396,16507,36903,2021-10-21
3174021004,JAKARTA SELATAN,SETIA BUDI,KARET,9623,2036,7587,6079,13666,2021-10-21
3174021003,JAKARTA SELATAN,SETIA BUDI,KARET KUNINGAN,16055,3387,12668,10362,23030,2021-10-21
3174021002,JAKARTA SELATAN,SETIA BUDI,KARET SEMANGGI,2770,587,2183,1883,4066,2021-10-21
3171071003,JAKARTA PUSAT,TANAH ABANG,KARET TENGSIN,19271,4011,15260,11936,27196,2021-10-21
3171021003,JAKARTA PUSAT,SAWAH BESAR,KARTINI,22292,4652,17640,14479,32119,2021-10-21
3175011003,JAKARTA TIMUR,MATRAMAN,KAYU MANIS,25284,5808,19476,14672,34148,2021-10-21
3175021006,JAKARTA TIMUR,PULO GADUNG,KAYU PUTIH,40696,8250,32446,27402,59848,2021-10-21
3173031006,JAKARTA BARAT,TAMAN SARI,KEAGUNGAN,17387,3562,13825,10855,24680,2021-10-21
3174041007,JAKARTA SELATAN,PASAR MINGGU,KEBAGUSAN,44552,9673,34879,27468,62347,2021-10-21
3174051006,JAKARTA SELATAN,KEBAYORAN LAMA,KEBAYORAN LAMA SELATAN,41212,8367,32845,26388,59233,2021-10-21
3174051001,JAKARTA SELATAN,KEBAYORAN LAMA,KEBAYORAN LAMA UTARA,42422,9732,32690,25792,58482,2021-10-21
3174011004,JAKARTA SELATAN,TEBET,KEBON BARU,35165,7233,27932,22126,50058,2021-10-21
3172021005,JAKARTA UTARA,TANJUNG PRIOK,KEBON BAWANG,50952,11169,39783,31780,71563,2021-10-21
3173051001,JAKARTA BARAT,KEBON JERUK,KEBON JERUK,53887,12613,41274,32539,73813,2021-10-21
3171071006,JAKARTA PUSAT,TANAH ABANG,KEBON KACANG,21531,5593,15938,12098,28036,2021-10-21
3171011005,JAKARTA PUSAT,GAMBIR,KEBON KELAPA,10163,2197,7966,6414,14380,2021-10-21
3171031002,JAKARTA PUSAT,KEMAYORAN,KEBON KOSONG,30019,6507,23512,17953,41465,2021-10-21
3175011005,JAKARTA TIMUR,MATRAMAN,KEBON MANGGIS,16490,3493,12997,10357,23354,2021-10-21
3171071005,JAKARTA PUSAT,TANAH ABANG,KEBON MELATI,32206,9105,23101,16334,39435,2021-10-21
3175081003,JAKARTA TIMUR,MAKASAR,KEBON PALA,46614,10165,36449,29035,65484,2021-10-21
3171061005,JAKARTA PUSAT,MENTENG,KEBON SIRIH,12299,2844,9455,7287,16742,2021-10-21
3173011004,JAKARTA BARAT,CENGKARENG,KEDAUNG KALI ANGKE,32612,6839,25773,20840,46613,2021-10-21
3173051007,JAKARTA BARAT,KEBON JERUK,KEDOYA SELATAN,32165,6380,25785,20532,46317,2021-10-21
3173051006,JAKARTA BARAT,KEBON JERUK,KEDOYA UTARA,45740,9313,36427,29977,66404,2021-10-21
3173051004,JAKARTA BARAT,KEBON JERUK,KELAPA DUA,23565,5213,18352,14618,32970,2021-10-21
3175091003,JAKARTA TIMUR,CIRACAS,KELAPA DUA WETAN,46875,8776,38099,30720,68819,2021-10-21
3172061003,JAKARTA UTARA,KELAPA GADING,KELAPA GADING BARAT,35717,6548,29169,25666,54835,2021-10-21
3172061001,JAKARTA UTARA,KELAPA GADING,KELAPA GADING TIMUR,33592,5464,28128,25355,53483,2021-10-21
3173071005,JAKARTA BARAT,PALMERAH,KEMANGGISAN,32139,6675,25464,20352,45816,2021-10-21
3171031001,JAKARTA PUSAT,KEMAYORAN,KEMAYORAN,20708,4623,16085,12811,28896,2021-10-21
3173081006,JAKARTA BARAT,KEMBANGAN,KEMBANGAN SELATAN,27130,6197,20933,17632,38565,2021-10-21
3173081001,JAKARTA BARAT,KEMBANGAN,KEMBANGAN UTARA,54451,12976,41475,33483,74958,2021-10-21
3171041002,JAKARTA PUSAT,SENEN,KENARI,9579,2033,7546,6237,13783,2021-10-21
3173041005,JAKARTA BARAT,TAMBORA,KERENDANG,19973,4562,15411,12003,27414,2021-10-21
3175071003,JAKARTA TIMUR,DUREN SAWIT,KLENDER,69978,17646,52332,39912,92244,2021-10-21
3172031001,JAKARTA UTARA,KOJA,KOJA,28175,6907,21268,16556,37824,2021-10-21
3173071006,JAKARTA BARAT,PALMERAH,KOTA BAMBU SELATAN,21158,4804,16354,12460,28814,2021-10-21
3173071003,JAKARTA BARAT,PALMERAH,KOTA BAMBU UTARA,24995,5917,19078,14429,33507,2021-10-21
3171041004,JAKARTA PUSAT,SENEN,KRAMAT,28835,7474,21361,15772,37133,2021-10-21
3175041001,JAKARTA TIMUR,KRAMAT JATI,KRAMAT JATI,34144,8011,26133,20247,46380,2021-10-21
3174071003,JAKARTA SELATAN,KEBAYORAN BARU,KRAMAT PELA,14413,3002,11411,9322,20733,2021-10-21
3173031002,JAKARTA BARAT,TAMAN SARI,KRUKUT,19244,3976,15268,11846,27114,2021-10-21
3174031005,JAKARTA SELATAN,MAMPANG PRAPATAN,KUNINGAN BARAT,12785,2568,10217,8198,18415,2021-10-21
3174021008,JAKARTA SELATAN,SETIA BUDI,KUNINGAN TIMUR,6008,1341,4667,3846,8513,2021-10-21
3171041005,JAKARTA PUSAT,SENEN,KWITANG,15486,3807,11679,9158,20837,2021-10-21
3172031003,JAKARTA UTARA,KOJA,LAGOA,59065,15128,43937,33525,77462,2021-10-21
3174061002,JAKARTA SELATAN,CILANDAK,LEBAK BULUS,37626,7725,29901,24647,54548,2021-10-21
3174091004,JAKARTA SELATAN,JAGAKARSA,LENTENG AGUNG,53946,10758,43188,32930,76118,2021-10-21
3175101007,JAKARTA TIMUR,CIPAYUNG,LUBANG BUAYA,63547,12945,50602,40326,90928,2021-10-21
3175081001,JAKARTA TIMUR,MAKASAR,MAKASAR,34390,6850,27540,22224,49764,2021-10-21
3175071006,JAKARTA TIMUR,DUREN SAWIT,MALAKA JAYA,30927,5996,24931,20341,45272,2021-10-21
3175071005,JAKARTA TIMUR,DUREN SAWIT,MALAKA SARI,27530,5023,22507,18586,41093,2021-10-21
3174031001,JAKARTA SELATAN,MAMPANG PRAPATAN,MAMPANG PRAPATAN,18159,4093,14066,11037,25103,2021-10-21
3173031005,JAKARTA BARAT,TAMAN SARI,MANGGA BESAR,7707,1383,6324,5315,11639,2021-10-21
3171021005,JAKARTA PUSAT,SAWAH BESAR,MANGGA DUA SELATAN,27442,6099,21343,17327,38670,2021-10-21
3174011007,JAKARTA SELATAN,TEBET,MANGGARAI,28373,5540,22833,17640,40473,2021-10-21
3174011006,JAKARTA SELATAN,TEBET,MANGGARAI SELATAN,23075,4503,18572,15019,33591,2021-10-21
3173031003,JAKARTA BARAT,TAMAN SARI,MAPHAR,16461,3311,13150,10535,23685,2021-10-21
3172041003,JAKARTA UTARA,CILINCING,MARUNDA,28943,7090,21853,15979,37832,2021-10-21
3174071001,JAKARTA SELATAN,KEBAYORAN BARU,MELAWAI,2627,553,2074,1888,3962,2021-10-21
3171061001,JAKARTA PUSAT,MENTENG,MENTENG,25624,6220,19404,14694,34098,2021-10-21
3174021005,JAKARTA SELATAN,SETIA BUDI,MENTENG ATAS,27816,5527,22289,17637,39926,2021-10-21
3174011003,JAKARTA SELATAN,TEBET,MENTENG DALAM,36028,7652,28376,22735,51111,2021-10-21
3173081003,JAKARTA BARAT,KEMBANGAN,MERUYA SELATAN,32130,7176,24954,20088,45042,2021-10-21
3173081002,JAKARTA BARAT,KEMBANGAN,MERUYA UTARA,43752,9859,33893,28383,62276,2021-10-21
3175101004,JAKARTA TIMUR,CIPAYUNG,MUNJUL,23871,4656,19215,15359,34574,2021-10-21
3172051002,JAKARTA UTARA,PADEMANGAN,PADEMANGAN BARAT,74240,18809,55431,43050,98481,2021-10-21
3172051001,JAKARTA UTARA,PADEMANGAN,PADEMANGAN TIMUR,37736,7175,30561,25699,56260,2021-10-21
3175011004,JAKARTA TIMUR,MATRAMAN,PAL MERIAM,19769,4528,15241,11737,26978,2021-10-21
3173071001,JAKARTA BARAT,PALMERAH,PALMERAH,63011,14837,48174,37726,85900,2021-10-21
3174081001,JAKARTA SELATAN,PANCORAN,PANCORAN,19421,4451,14970,11985,26955,2021-10-21
3172021003,JAKARTA UTARA,TANJUNG PRIOK,PAPANGGO,39097,8511,30586,24257,54843,2021-10-21
3171021001,JAKARTA PUSAT,SAWAH BESAR,PASAR BARU,12035,2473,9562,8282,17844,2021-10-21
3174021006,JAKARTA SELATAN,SETIA BUDI,PASAR MANGGIS,26752,5811,20941,16664,37605,2021-10-21
3174041001,JAKARTA SELATAN,PASAR MINGGU,PASAR MINGGU,24821,5059,19762,16046,35808,2021-10-21
3171041003,JAKARTA PUSAT,SENEN,PASEBAN,23533,5424,18109,14317,32426,2021-10-21
3173061005,JAKARTA BARAT,KALI DERES,PEGADUNGAN,75587,16684,58903,49338,108241,2021-10-21
3171061002,JAKARTA PUSAT,MENTENG,PEGANGSAAN,23455,5584,17871,13106,30977,2021-10-21
3172061002,JAKARTA UTARA,KELAPA GADING,PEGANGSAAN DUA,49976,8761,41215,36438,77653,2021-10-21
3172011004,JAKARTA UTARA,PENJARINGAN,PEJAGALAN,74578,16704,57874,47768,105642,2021-10-21
3174041006,JAKARTA SELATAN,PASAR MINGGU,PEJATEN BARAT,37346,8165,29181,23370,52551,2021-10-21
3174041005,JAKARTA SELATAN,PASAR MINGGU,PEJATEN TIMUR,57656,14167,43489,34327,77816,2021-10-21
3175051005,JAKARTA TIMUR,PASAR REBO,PEKAYON,43250,8617,34633,27532,62165,2021-10-21
3173041009,JAKARTA BARAT,TAMBORA,PEKOJAN,23587,4844,18743,15152,33895,2021-10-21
3174031003,JAKARTA SELATAN,MAMPANG PRAPATAN,PELA MAMPANG,43522,9490,34032,27139,61171,2021-10-21
3174081005,JAKARTA SELATAN,PANCORAN,PENGADEGAN,21478,4247,17231,13890,31121,2021-10-21
3175061003,JAKARTA TIMUR,CAKUNG,PENGGILINGAN,99255,25209,74046,56834,130880,2021-10-21
3172011001,JAKARTA UTARA,PENJARINGAN,PENJARINGAN,88308,24470,63838,47298,111136,2021-10-21
3174101001,JAKARTA SELATAN,PESANGGRAHAN,PESANGGRAHAN,27545,5133,22412,18468,40880,2021-10-21
3171071004,JAKARTA PUSAT,TANAH ABANG,PETAMBURAN,33271,9412,23859,17296,41155,2021-10-21
3174071008,JAKARTA SELATAN,KEBAYORAN BARU,PETOGOGAN,11499,2458,9041,7370,16411,2021-10-21
3171011004,JAKARTA PUSAT,GAMBIR,PETOJO SELATAN,14692,3528,11164,9131,20295,2021-10-21
3171011003,JAKARTA PUSAT,GAMBIR,PETOJO UTARA,17458,4009,13449,10630,24079,2021-10-21
3174101004,JAKARTA SELATAN,PESANGGRAHAN,PETUKANGAN SELATAN,37187,8295,28892,23352,52244,2021-10-21
3174101003,JAKARTA SELATAN,PESANGGRAHAN,PETUKANGAN UTARA,53716,12655,41061,32758,73819,2021-10-21
3175081002,JAKARTA TIMUR,MAKASAR,PINANG RANTI,27198,6424,20774,16615,37389,2021-10-21
3173031008,JAKARTA BARAT,TAMAN SARI,PINANGSIA,10729,2039,8690,6952,15642,2021-10-21
3175011001,JAKARTA TIMUR,MATRAMAN,PISANGAN BARU,31776,7146,24630,18641,43271,2021-10-21
3175021002,JAKARTA TIMUR,PULO GADUNG,PISANGAN TIMUR,41011,8414,32597,26405,59002,2021-10-21
3172011005,JAKARTA UTARA,PENJARINGAN,PLUIT,47783,9792,37991,32160,70151,2021-10-21
3175071002,JAKARTA TIMUR,DUREN SAWIT,PONDOK BAMBU,61550,14108,47442,37297,84739,2021-10-21
3175071004,JAKARTA TIMUR,DUREN SAWIT,PONDOK KELAPA,72015,15432,56583,46734,103317,2021-10-21
3175071007,JAKARTA TIMUR,DUREN SAWIT,PONDOK KOPI,35367,7368,27999,21075,49074,2021-10-21
3174061003,JAKARTA SELATAN,CILANDAK,PONDOK LABU,46464,8763,37701,31547,69248,2021-10-21
3174051002,JAKARTA SELATAN,KEBAYORAN LAMA,PONDOK PINANG,56169,11559,44610,35999,80609,2021-10-21
3175101003,JAKARTA TIMUR,CIPAYUNG,PONDOK RANGGON,25574,5187,20387,15991,36378,2021-10-21
3101011003,KAB.ADM.KEP.SERIBU,KEP. SERIBU UTARA,PULAU HARAPAN,2060,232,1828,1567,3395,2021-10-21
3101011002,KAB.ADM.KEP.SERIBU,KEP. SERIBU UTARA,PULAU KELAPA,5528,638,4890,3959,8849,2021-10-21
3101011001,KAB.ADM.KEP.SERIBU,KEP. SERIBU UTARA,PULAU PANGGANG,5450,479,4971,4368,9339,2021-10-21
3101021003,KAB.ADM.KEP.SERIBU,KEP. SERIBU SELATAN,PULAU PARI,2765,204,2561,2375,4936,2021-10-21
3101021002,KAB.ADM.KEP.SERIBU,KEP. SERIBU SELATAN,PULAU TIDUNG,4553,398,4155,3725,7880,2021-10-21
3101021001,KAB.ADM.KEP.SERIBU,KEP. SERIBU SELATAN,PULAU UNTUNG JAWA,1941,173,1768,1609,3377,2021-10-21
3174071007,JAKARTA SELATAN,KEBAYORAN BARU,PULO,5835,1075,4760,4167,8927,2021-10-21
3175021001,JAKARTA TIMUR,PULO GADUNG,PULO GADUNG,34422,8059,26363,21113,47476,2021-10-21
3175061005,JAKARTA TIMUR,CAKUNG,PULO GEBANG,97301,20307,76994,60117,137111,2021-10-21
3174041004,JAKARTA SELATAN,PASAR MINGGU,RAGUNAN,39616,8071,31545,25791,57336,2021-10-21
3175091005,JAKARTA TIMUR,CIRACAS,RAMBUTAN,36771,9298,27473,20845,48318,2021-10-21
3172031006,JAKARTA UTARA,KOJA,RAWA BADAK SELATAN,42179,10808,31371,23854,55225,2021-10-21
3172031004,JAKARTA UTARA,KOJA,RAWA BADAK UTARA,34408,8353,26055,20134,46189,2021-10-21
3174071005,JAKARTA SELATAN,KEBAYORAN BARU,RAWA BARAT,5625,1057,4568,3899,8467,2021-10-21
3173011003,JAKARTA BARAT,CENGKARENG,RAWA BUAYA,63799,14016,49783,38245,88028,2021-10-21
3175031004,JAKARTA TIMUR,JATINEGARA,RAWA BUNGA,21434,5585,15849,12250,28099,2021-10-21
3174081003,JAKARTA SELATAN,PANCORAN,RAWA JATI,20509,4218,16291,13098,29389,2021-10-21
3175061002,JAKARTA TIMUR,CAKUNG,RAWA TERATE,24637,4930,19707,15591,35298,2021-10-21
3175021005,JAKARTA TIMUR,PULO GADUNG,RAWAMANGUN,37612,8116,29496,23946,53442,2021-10-21
3171051003,JAKARTA PUSAT,CEMPAKA PUTIH,RAWASARI,21967,4858,17109,13930,31039,2021-10-21
3173041010,JAKARTA BARAT,TAMBORA,ROA MALAKA,3484,646,2838,2448,5286,2021-10-21
3172041006,JAKARTA UTARA,CILINCING,ROROTAN,41668,9018,32650,25319,57969,2021-10-21
3174071004,JAKARTA SELATAN,KEBAYORAN BARU,SELONG,2842,569,2273,2036,4309,2021-10-21
3173061002,JAKARTA BARAT,KALI DERES,SEMANAN,71354,17364,53990,42479,96469,2021-10-21
3172041007,JAKARTA UTARA,CILINCING,SEMPER BARAT,68587,14508,54079,43466,97545,2021-10-21
3172041005,JAKARTA UTARA,CILINCING,SEMPER TIMUR,36267,8383,27884,21798,49682,2021-10-21
3174071006,JAKARTA SELATAN,KEBAYORAN BARU,SENAYAN,2771,685,2086,1731,3817,2021-10-21
3171041001,JAKARTA PUSAT,SENEN,SENEN,6804,1587,5217,4247,9464,2021-10-21
3171031004,JAKARTA PUSAT,KEMAYORAN,SERDANG,29668,6427,23241,18542,41783,2021-10-21
3174021001,JAKARTA SELATAN,SETIA BUDI,SETIA BUDI,3023,668,2355,1914,4269,2021-10-21
3175101005,JAKARTA TIMUR,CIPAYUNG,SETU,20572,4474,16098,12413,28511,2021-10-21
3173071002,JAKARTA BARAT,PALMERAH,SLIPI,16591,3269,13322,10753,24075,2021-10-21
3173081004,JAKARTA BARAT,KEMBANGAN,SRENGSENG,45523,11048,34475,28157,62632,2021-10-21
3174091002,JAKARTA SELATAN,JAGAKARSA,SRENGSENG SAWAH,58196,10031,48165,39274,87439,2021-10-21
3173051003,JAKARTA BARAT,KEBON JERUK,SUKABUMI SELATAN,37033,9095,27938,20865,48803,2021-10-21
3173051002,JAKARTA BARAT,KEBON JERUK,SUKABUMI UTARA,38290,9733,28557,21501,50058,2021-10-21
3172041002,JAKARTA UTARA,CILINCING,SUKAPURA,53949,13090,40859,32531,73390,2021-10-21
3171031007,JAKARTA PUSAT,KEMAYORAN,SUMUR BATU,22717,4972,17745,14535,32280,2021-10-21
3172021004,JAKARTA UTARA,TANJUNG PRIOK,SUNGAI BAMBU,29876,6537,23339,18602,41941,2021-10-21
3172021006,JAKARTA UTARA,TANJUNG PRIOK,SUNTER AGUNG,71805,13402,58403,49410,107813,2021-10-21
3172021002,JAKARTA UTARA,TANJUNG PRIOK,SUNTER JAYA,63031,11941,51090,42486,93576,2021-10-21
3175091004,JAKARTA TIMUR,CIRACAS,SUSUKAN,38257,7772,30485,24382,54867,2021-10-21
3173031001,JAKARTA BARAT,TAMAN SARI,TAMAN SARI,14348,2809,11539,9614,21153,2021-10-21
3173041001,JAKARTA BARAT,TAMBORA,TAMBORA,10204,2450,7754,6041,13795,2021-10-21
3173041004,JAKARTA BARAT,TAMBORA,TANAH SEREAL,26387,4814,21573,17500,39073,2021-10-21
3171081004,JAKARTA PUSAT,JOHAR BARU,TANAH TINGGI,37693,7642,30051,23643,53694,2021-10-21
3173031004,JAKARTA BARAT,TAMAN SARI,TANGKI,13324,2389,10935,8795,19730,2021-10-21
3174091005,JAKARTA SELATAN,JAGAKARSA,TANJUNG BARAT,39770,7306,32464,25269,57733,2021-10-21
3173021005,JAKARTA BARAT,GROGOL PETAMBURAN,TANJUNG DUREN SELATAN,25337,5253,20084,17035,37119,2021-10-21
3173021002,JAKARTA BARAT,GROGOL PETAMBURAN,TANJUNG DUREN UTARA,17010,3095,13915,11907,25822,2021-10-21
3172021001,JAKARTA UTARA,TANJUNG PRIOK,TANJUNG PRIOK,34588,7700,26888,21267,48155,2021-10-21
3174011002,JAKARTA SELATAN,TEBET,TEBET BARAT,21194,3785,17409,14786,32195,2021-10-21
3174011001,JAKARTA SELATAN,TEBET,TEBET TIMUR,18199,3171,15028,13003,28031,2021-10-21
3173061003,JAKARTA BARAT,KALI DERES,TEGAL ALUR,83647,19328,64319,51364,115683,2021-10-21
3174031004,JAKARTA SELATAN,MAMPANG PRAPATAN,TEGAL PARANG,32401,7805,24596,18035,42631,2021-10-21
3173021003,JAKARTA BARAT,GROGOL PETAMBURAN,TOMANG,29605,5891,23714,19484,43198,2021-10-21
3172031005,JAKARTA UTARA,KOJA,TUGU SELATAN,39122,9426,29696,23131,52827,2021-10-21
3172031002,JAKARTA UTARA,KOJA,TUGU UTARA,67670,17238,50432,38416,88848,2021-10-21
3175061006,JAKARTA TIMUR,CAKUNG,UJUNG MENTENG,29934,5613,24321,19913,44234,2021-10-21
3174101005,JAKARTA SELATAN,PESANGGRAHAN,ULUJAMI,40544,9971,30573,23961,54534,2021-10-21
3175011006,JAKARTA TIMUR,MATRAMAN,UTAN KAYU SELATAN,33511,6594,26917,21245,48162,2021-10-21
3175011002,JAKARTA TIMUR,MATRAMAN,UTAN KAYU UTARA,28169,6402,21767,17082,38849,2021-10-21
3171031008,JAKARTA PUSAT,KEMAYORAN,UTAN PANJANG,29208,6421,22787,17427,40214,2021-10-21
3172021007,JAKARTA UTARA,TANJUNG PRIOK,WARAKAS,44401,8780,35621,27536,63157,2021-10-21
3173021007,JAKARTA BARAT,GROGOL PETAMBURAN,WIJAYA KUSUMA,38934,8855,30079,24193,54272,2021-10-21
3172051003,JAKARTA UTARA,PADEMANGAN,ANCOL,23947,6178,17769,14146,31915,2021-10-22
3173041007,JAKARTA BARAT,TAMBORA,ANGKE,29381,6815,22566,17667,40233,2021-10-22
3175041005,JAKARTA TIMUR,KRAMAT JATI,BALE KAMBANG,29074,7841,21233,15735,36968,2021-10-22
3175031003,JAKARTA TIMUR,JATINEGARA,BALI MESTER,9752,2214,7538,6070,13608,2021-10-22
3175101006,JAKARTA TIMUR,CIPAYUNG,BAMBU APUS,26285,5220,21065,16657,37722,2021-10-22
3174031002,JAKARTA SELATAN,MAMPANG PRAPATAN,BANGKA,21566,5018,16548,13067,29615,2021-10-22
3175051002,JAKARTA TIMUR,PASAR REBO,BARU,23886,4267,19619,16350,35969,2021-10-22
3175041004,JAKARTA TIMUR,KRAMAT JATI,BATU AMPAR,47898,12623,35275,26820,62095,2021-10-22
3171071002,JAKARTA PUSAT,TANAH ABANG,BENDUNGAN HILIR,21494,4643,16851,13737,30588,2021-10-22
3175031002,JAKARTA TIMUR,JATINEGARA,BIDARA CINA,36689,9463,27226,20679,47905,2021-10-22
3174101002,JAKARTA SELATAN,PESANGGRAHAN,BINTARO,53098,11572,41526,34157,75683,2021-10-22
3174011005,JAKARTA SELATAN,TEBET,BUKIT DURI,34183,7682,26501,21152,47653,2021-10-22
3171041006,JAKARTA PUSAT,SENEN,BUNGUR,18144,4163,13981,11291,25272,2021-10-22
3175061007,JAKARTA TIMUR,CAKUNG,CAKUNG BARAT,57724,12840,44884,36008,80892,2021-10-22
3175061004,JAKARTA TIMUR,CAKUNG,CAKUNG TIMUR,58287,12428,45859,36614,82473,2021-10-22
3175041007,JAKARTA TIMUR,KRAMAT JATI,CAWANG,32762,7808,24954,19082,44036,2021-10-22
3175101008,JAKARTA TIMUR,CIPAYUNG,CEGER,18932,3986,14946,11948,26894,2021-10-22
3171031006,JAKARTA PUSAT,KEMAYORAN,CEMPAKA BARU,32581,7351,25230,19225,44455,2021-10-22
3171051002,JAKARTA PUSAT,CEMPAKA PUTIH,CEMPAKA PUTIH BARAT,35885,8288,27597,22562,50159,2021-10-22
3171051001,JAKARTA PUSAT,CEMPAKA PUTIH,CEMPAKA PUTIH TIMUR,24292,5361,18931,15820,34751,2021-10-22
3173011001,JAKARTA BARAT,CENGKARENG,CENGKARENG BARAT,66284,14690,51594,41971,93565,2021-10-22
3173011006,JAKARTA BARAT,CENGKARENG,CENGKARENG TIMUR,81027,17369,63658,50227,113885,2021-10-22
3175091002,JAKARTA TIMUR,CIRACAS,CIBUBUR,66364,12253,54111,43391,97502,2021-10-22
3171011002,JAKARTA PUSAT,GAMBIR,CIDENG,15390,3179,12211,10284,22495,2021-10-22
3174091003,JAKARTA SELATAN,JAGAKARSA,CIGANJUR,38497,7173,31324,24228,55552,2021-10-22
3175051003,JAKARTA TIMUR,PASAR REBO,CIJANTUNG,41419,8319,33100,26471,59571,2021-10-22
3171061003,JAKARTA PUSAT,MENTENG,CIKINI,8274,1567,6707,5075,11782,2021-10-22
3174081006,JAKARTA SELATAN,PANCORAN,CIKOKO,10547,1952,8595,7139,15734,2021-10-22
3174061001,JAKARTA SELATAN,CILANDAK,CILANDAK BARAT,51752,9938,41814,34573,76387,2021-10-22
3174041003,JAKARTA SELATAN,PASAR MINGGU,CILANDAK TIMUR,25145,5067,20078,16447,36525,2021-10-22
3175101002,JAKARTA TIMUR,CIPAYUNG,CILANGKAP,27635,5253,22382,17820,40202,2021-10-22
3175041006,JAKARTA TIMUR,KRAMAT JATI,CILILITAN,40181,9723,30458,23622,54080,2021-10-22
3172041001,JAKARTA UTARA,CILINCING,CILINCING,43609,11293,32316,24172,56488,2021-10-22
3175101001,JAKARTA TIMUR,CIPAYUNG,CIPAYUNG,26104,4900,21204,17492,38696,2021-10-22
3174091006,JAKARTA SELATAN,JAGAKARSA,CIPEDAK,38303,7057,31246,25022,56268,2021-10-22
3174061005,JAKARTA SELATAN,CILANDAK,CIPETE SELATAN,26704,5535,21169,17666,38835,2021-10-22
3174071010,JAKARTA SELATAN,KEBAYORAN BARU,CIPETE UTARA,34102,6980,27122,21319,48441,2021-10-22
3175021003,JAKARTA TIMUR,PULO GADUNG,CIPINANG,39306,8046,31260,24754,56014,2021-10-22
3175031007,JAKARTA TIMUR,JATINEGARA,CIPINANG BESAR SELATAN,35212,8999,26213,19518,45731,2021-10-22
3175031008,JAKARTA TIMUR,JATINEGARA,CIPINANG BESAR UTARA,45319,11602,33717,24913,58630,2021-10-22
3175031005,JAKARTA TIMUR,JATINEGARA,CIPINANG CEMPEDAK,32824,7665,25159,20041,45200,2021-10-22
3175081005,JAKARTA TIMUR,MAKASAR,CIPINANG MELAYU,42308,8838,33470,26979,60449,2021-10-22
3175031006,JAKARTA TIMUR,JATINEGARA,CIPINANG MUARA,55243,12906,42337,32894,75231,2021-10-22
3174051003,JAKARTA SELATAN,KEBAYORAN LAMA,CIPULIR,39937,9064,30873,23903,54776,2021-10-22
3175091001,JAKARTA TIMUR,CIRACAS,CIRACAS,64594,12773,51821,40788,92609,2021-10-22
3175041003,JAKARTA TIMUR,KRAMAT JATI,DUKUH,24609,5047,19562,15340,34902,2021-10-22
3175071001,JAKARTA TIMUR,DUREN SAWIT,DUREN SAWIT,61160,13997,47163,36937,84100,2021-10-22
3174081004,JAKARTA SELATAN,PANCORAN,DUREN TIGA,28319,6071,22248,17617,39865,2021-10-22
3173051005,JAKARTA BARAT,KEBON JERUK,DURI KEPA,60138,12722,47416,39774,87190,2021-10-22
3173011002,JAKARTA BARAT,CENGKARENG,DURI KOSAMBI,77923,18348,59575,45757,105332,2021-10-22
3171011006,JAKARTA PUSAT,GAMBIR,DURI PULO,19610,4462,15148,11752,26900,2021-10-22
3173041011,JAKARTA BARAT,TAMBORA,DURI SELATAN,14259,2727,11532,9419,20951,2021-10-22
3173041003,JAKARTA BARAT,TAMBORA,DURI UTARA,19844,3995,15849,12610,28459,2021-10-22
3171081003,JAKARTA PUSAT,JOHAR BARU,GALUR,18243,3884,14359,11284,25643,2021-10-22
3171011001,JAKARTA PUSAT,GAMBIR,GAMBIR,2191,485,1706,1426,3132,2021-10-22
3174061004,JAKARTA SELATAN,CILANDAK,GANDARIA SELATAN,22119,4640,17479,14104,31583,2021-10-22
3174071009,JAKARTA SELATAN,KEBAYORAN BARU,GANDARIA UTARA,39922,8612,31310,25124,56434,2021-10-22
3175051001,JAKARTA TIMUR,PASAR REBO,GEDONG,35755,7692,28063,22688,50751,2021-10-22
3171071001,JAKARTA PUSAT,TANAH ABANG,GELORA,3127,661,2466,2051,4517,2021-10-22
3173031007,JAKARTA BARAT,TAMAN SARI,GLODOK,7837,1316,6521,5700,12221,2021-10-22
3171061004,JAKARTA PUSAT,MENTENG,GONDANGDIA,4100,961,3139,2799,5938,2021-10-22
3173021001,JAKARTA BARAT,GROGOL PETAMBURAN,GROGOL,16876,3638,13238,10742,23980,2021-10-22
3174051005,JAKARTA SELATAN,KEBAYORAN LAMA,GROGOL SELATAN,44251,9710,34541,27246,61787,2021-10-22
3174051004,JAKARTA SELATAN,KEBAYORAN LAMA,GROGOL UTARA,42494,9413,33081,26417,59498,2021-10-22
3174021007,JAKARTA SELATAN,SETIA BUDI,GUNTUR,3985,806,3179,2712,5891,2021-10-22
3174071002,JAKARTA SELATAN,KEBAYORAN BARU,GUNUNG,9436,1858,7578,6389,13967,2021-10-22
3171031005,JAKARTA PUSAT,KEMAYORAN,GUNUNG SAHARI SELATAN,19199,4212,14987,12135,27122,2021-10-22
3171021004,JAKARTA PUSAT,SAWAH BESAR,GUNUNG SAHARI UTARA,16650,3159,13491,11610,25101,2021-10-22
3175081004,JAKARTA TIMUR,MAKASAR,HALIM PERDANA KUSUMAH,28363,4022,24341,21753,46094,2021-10-22
3171031003,JAKARTA PUSAT,KEMAYORAN,HARAPAN MULIA,22557,4952,17605,13700,31305,2021-10-22
3174091001,JAKARTA SELATAN,JAGAKARSA,JAGAKARSA,62389,11354,51035,40344,91379,2021-10-22
3175021007,JAKARTA TIMUR,PULO GADUNG,JATI,32757,6639,26118,21651,47769,2021-10-22
3174041002,JAKARTA SELATAN,PASAR MINGGU,JATI PADANG,37502,8139,29363,23778,53141,2021-10-22
3173071004,JAKARTA BARAT,PALMERAH,JATI PULO,28738,6213,22525,17417,39942,2021-10-22
3175061001,JAKARTA TIMUR,CAKUNG,JATINEGARA,84160,19560,64600,51339,115939,2021-10-22
3175021004,JAKARTA TIMUR,PULO GADUNG,JATINEGARA KAUM,24632,4777,19855,15317,35172,2021-10-22
3173021004,JAKARTA BARAT,GROGOL PETAMBURAN,JELAMBAR,30266,5995,24271,20167,44438,2021-10-22
3173021006,JAKARTA BARAT,GROGOL PETAMBURAN,JELAMBAR BARU,38246,7730,30516,25394,55910,2021-10-22
3173041006,JAKARTA BARAT,TAMBORA,JEMBATAN BESI,29314,7707,21607,16175,37782,2021-10-22
3173041008,JAKARTA BARAT,TAMBORA,JEMBATAN LIMA,21021,5355,15666,11920,27586,2021-10-22
3173081005,JAKARTA BARAT,KEMBANGAN,JOGLO,40839,8998,31841,26054,57895,2021-10-22
3171081001,JAKARTA PUSAT,JOHAR BARU,JOHAR BARU,37488,7370,30118,24642,54760,2021-10-22
3173041002,JAKARTA BARAT,TAMBORA,KALI ANYAR,23856,5139,18717,14237,32954,2021-10-22
3172041004,JAKARTA UTARA,CILINCING,KALIBARU,67684,19963,47721,33081,80802,2021-10-22
3174081002,JAKARTA SELATAN,PANCORAN,KALIBATA,41994,10363,31631,24171,55802,2021-10-22
3173061001,JAKARTA BARAT,KALI DERES,KALIDERES,72447,16416,56031,45934,101965,2021-10-22
3175051004,JAKARTA TIMUR,PASAR REBO,KALISARI,43212,8446,34766,27937,62703,2021-10-22
3173061004,JAKARTA BARAT,KALI DERES,KAMAL,53783,13813,39970,30805,70775,2021-10-22
3172011002,JAKARTA UTARA,PENJARINGAN,KAMAL MUARA,12930,2377,10553,8843,19396,2021-10-22
3171071007,JAKARTA PUSAT,TANAH ABANG,KAMPUNG BALI,11358,2644,8714,6358,15072,2021-10-22
3175031001,JAKARTA TIMUR,JATINEGARA,KAMPUNG MELAYU,25717,6596,19121,14280,33401,2021-10-22
3171081002,JAKARTA PUSAT,JOHAR BARU,KAMPUNG RAWA,21237,3725,17512,13561,31073,2021-10-22
3175041002,JAKARTA TIMUR,KRAMAT JATI,KAMPUNG TENGAH,43993,11770,32223,24463,56686,2021-10-22
3173011005,JAKARTA BARAT,CENGKARENG,KAPUK,134466,34928,99538,77145,176683,2021-10-22
3172011003,JAKARTA UTARA,PENJARINGAN,KAPUK MUARA,35781,7370,28411,24289,52700,2021-10-22
3171021002,JAKARTA PUSAT,SAWAH BESAR,KARANG ANYAR,25761,5354,20407,16545,36952,2021-10-22
3174021004,JAKARTA SELATAN,SETIA BUDI,KARET,9623,2031,7592,6086,13678,2021-10-22
3174021003,JAKARTA SELATAN,SETIA BUDI,KARET KUNINGAN,16055,3379,12676,10371,23047,2021-10-22
3174021002,JAKARTA SELATAN,SETIA BUDI,KARET SEMANGGI,2770,587,2183,1885,4068,2021-10-22
3171071003,JAKARTA PUSAT,TANAH ABANG,KARET TENGSIN,19271,3993,15278,11946,27224,2021-10-22
3171021003,JAKARTA PUSAT,SAWAH BESAR,KARTINI,22292,4632,17660,14524,32184,2021-10-22
3175011003,JAKARTA TIMUR,MATRAMAN,KAYU MANIS,25284,5779,19505,14705,34210,2021-10-22
3175021006,JAKARTA TIMUR,PULO GADUNG,KAYU PUTIH,40696,8222,32474,27439,59913,2021-10-22
3173031006,JAKARTA BARAT,TAMAN SARI,KEAGUNGAN,17387,3520,13867,10903,24770,2021-10-22
3174041007,JAKARTA SELATAN,PASAR MINGGU,KEBAGUSAN,44552,9644,34908,27543,62451,2021-10-22
3174051006,JAKARTA SELATAN,KEBAYORAN LAMA,KEBAYORAN LAMA SELATAN,41212,8337,32875,26458,59333,2021-10-22
3174051001,JAKARTA SELATAN,KEBAYORAN LAMA,KEBAYORAN LAMA UTARA,42422,9662,32760,25879,58639,2021-10-22
3174011004,JAKARTA SELATAN,TEBET,KEBON BARU,35165,7189,27976,22310,50286,2021-10-22
3172021005,JAKARTA UTARA,TANJUNG PRIOK,KEBON BAWANG,50952,11139,39813,31849,71662,2021-10-22
3173051001,JAKARTA BARAT,KEBON JERUK,KEBON JERUK,53887,12583,41304,32577,73881,2021-10-22
3171071006,JAKARTA PUSAT,TANAH ABANG,KEBON KACANG,21531,5580,15951,12105,28056,2021-10-22
3171011005,JAKARTA PUSAT,GAMBIR,KEBON KELAPA,10163,2186,7977,6436,14413,2021-10-22
3171031002,JAKARTA PUSAT,KEMAYORAN,KEBON KOSONG,30019,6493,23526,18111,41637,2021-10-22
3175011005,JAKARTA TIMUR,MATRAMAN,KEBON MANGGIS,16490,3480,13010,10380,23390,2021-10-22
3171071005,JAKARTA PUSAT,TANAH ABANG,KEBON MELATI,32206,9090,23116,16362,39478,2021-10-22
3175081003,JAKARTA TIMUR,MAKASAR,KEBON PALA,46614,10115,36499,29132,65631,2021-10-22
3171061005,JAKARTA PUSAT,MENTENG,KEBON SIRIH,12299,2833,9466,7296,16762,2021-10-22
3173011004,JAKARTA BARAT,CENGKARENG,KEDAUNG KALI ANGKE,32612,6823,25789,20859,46648,2021-10-22
3173051007,JAKARTA BARAT,KEBON JERUK,KEDOYA SELATAN,32165,6369,25796,20562,46358,2021-10-22
3173051006,JAKARTA BARAT,KEBON JERUK,KEDOYA UTARA,45740,9270,36470,30017,66487,2021-10-22
3173051004,JAKARTA BARAT,KEBON JERUK,KELAPA DUA,23565,5207,18358,14649,33007,2021-10-22
3175091003,JAKARTA TIMUR,CIRACAS,KELAPA DUA WETAN,46875,8749,38126,30766,68892,2021-10-22
3172061003,JAKARTA UTARA,KELAPA GADING,KELAPA GADING BARAT,35717,6536,29181,25689,54870,2021-10-22
3172061001,JAKARTA UTARA,KELAPA GADING,KELAPA GADING TIMUR,33592,5456,28136,25378,53514,2021-10-22
3173071005,JAKARTA BARAT,PALMERAH,KEMANGGISAN,32139,6664,25475,20383,45858,2021-10-22
3171031001,JAKARTA PUSAT,KEMAYORAN,KEMAYORAN,20708,4612,16096,12858,28954,2021-10-22
3173081006,JAKARTA BARAT,KEMBANGAN,KEMBANGAN SELATAN,27130,6187,20943,17650,38593,2021-10-22
3173081001,JAKARTA BARAT,KEMBANGAN,KEMBANGAN UTARA,54451,12964,41487,33533,75020,2021-10-22
3171041002,JAKARTA PUSAT,SENEN,KENARI,9579,2020,7559,6258,13817,2021-10-22
3173041005,JAKARTA BARAT,TAMBORA,KERENDANG,19973,4552,15421,12024,27445,2021-10-22
3175071003,JAKARTA TIMUR,DUREN SAWIT,KLENDER,69978,17571,52407,39969,92376,2021-10-22
3172031001,JAKARTA UTARA,KOJA,KOJA,28175,6894,21281,16579,37860,2021-10-22
3173071006,JAKARTA BARAT,PALMERAH,KOTA BAMBU SELATAN,21158,4795,16363,12476,28839,2021-10-22
3173071003,JAKARTA BARAT,PALMERAH,KOTA BAMBU UTARA,24995,5901,19094,14447,33541,2021-10-22
3171041004,JAKARTA PUSAT,SENEN,KRAMAT,28835,7461,21374,15809,37183,2021-10-22
3175041001,JAKARTA TIMUR,KRAMAT JATI,KRAMAT JATI,34144,7988,26156,20283,46439,2021-10-22
3174071003,JAKARTA SELATAN,KEBAYORAN BARU,KRAMAT PELA,14413,2991,11422,9343,20765,2021-10-22
3173031002,JAKARTA BARAT,TAMAN SARI,KRUKUT,19244,3965,15279,11862,27141,2021-10-22
3174031005,JAKARTA SELATAN,MAMPANG PRAPATAN,KUNINGAN BARAT,12785,2554,10231,8238,18469,2021-10-22
3174021008,JAKARTA SELATAN,SETIA BUDI,KUNINGAN TIMUR,6008,1328,4680,3855,8535,2021-10-22
3171041005,JAKARTA PUSAT,SENEN,KWITANG,15486,3798,11688,9180,20868,2021-10-22
3172031003,JAKARTA UTARA,KOJA,LAGOA,59065,15102,43963,33568,77531,2021-10-22
3174061002,JAKARTA SELATAN,CILANDAK,LEBAK BULUS,37626,7704,29922,24774,54696,2021-10-22
3174091004,JAKARTA SELATAN,JAGAKARSA,LENTENG AGUNG,53946,10688,43258,33046,76304,2021-10-22
3175101007,JAKARTA TIMUR,CIPAYUNG,LUBANG BUAYA,63547,12919,50628,40377,91005,2021-10-22
3175081001,JAKARTA TIMUR,MAKASAR,MAKASAR,34390,6825,27565,22298,49863,2021-10-22
3175071006,JAKARTA TIMUR,DUREN SAWIT,MALAKA JAYA,30927,5924,25003,20370,45373,2021-10-22
3175071005,JAKARTA TIMUR,DUREN SAWIT,MALAKA SARI,27530,4996,22534,18618,41152,2021-10-22
3174031001,JAKARTA SELATAN,MAMPANG PRAPATAN,MAMPANG PRAPATAN,18159,4049,14110,11092,25202,2021-10-22
3173031005,JAKARTA BARAT,TAMAN SARI,MANGGA BESAR,7707,1382,6325,5323,11648,2021-10-22
3171021005,JAKARTA PUSAT,SAWAH BESAR,MANGGA DUA SELATAN,27442,6084,21358,17392,38750,2021-10-22
3174011007,JAKARTA SELATAN,TEBET,MANGGARAI,28373,5517,22856,17714,40570,2021-10-22
3174011006,JAKARTA SELATAN,TEBET,MANGGARAI SELATAN,23075,4478,18597,15068,33665,2021-10-22
3173031003,JAKARTA BARAT,TAMAN SARI,MAPHAR,16461,3306,13155,10550,23705,2021-10-22
3172041003,JAKARTA UTARA,CILINCING,MARUNDA,28943,7084,21859,15989,37848,2021-10-22
3174071001,JAKARTA SELATAN,KEBAYORAN BARU,MELAWAI,2627,552,2075,1890,3965,2021-10-22
3171061001,JAKARTA PUSAT,MENTENG,MENTENG,25624,6207,19417,14721,34138,2021-10-22
3174021005,JAKARTA SELATAN,SETIA BUDI,MENTENG ATAS,27816,5515,22301,17658,39959,2021-10-22
3174011003,JAKARTA SELATAN,TEBET,MENTENG DALAM,36028,7618,28410,22830,51240,2021-10-22
3173081003,JAKARTA BARAT,KEMBANGAN,MERUYA SELATAN,32130,7161,24969,20123,45092,2021-10-22
3173081002,JAKARTA BARAT,KEMBANGAN,MERUYA UTARA,43752,9684,34068,28442,62510,2021-10-22
3175101004,JAKARTA TIMUR,CIPAYUNG,MUNJUL,23871,4645,19226,15374,34600,2021-10-22
3172051002,JAKARTA UTARA,PADEMANGAN,PADEMANGAN BARAT,74240,18782,55458,43101,98559,2021-10-22
3172051001,JAKARTA UTARA,PADEMANGAN,PADEMANGAN TIMUR,37736,7160,30576,25731,56307,2021-10-22
3175011004,JAKARTA TIMUR,MATRAMAN,PAL MERIAM,19769,4453,15316,11794,27110,2021-10-22
3173071001,JAKARTA BARAT,PALMERAH,PALMERAH,63011,14812,48199,37776,85975,2021-10-22
3174081001,JAKARTA SELATAN,PANCORAN,PANCORAN,19421,4445,14976,12005,26981,2021-10-22
3172021003,JAKARTA UTARA,TANJUNG PRIOK,PAPANGGO,39097,8505,30592,24283,54875,2021-10-22
3171021001,JAKARTA PUSAT,SAWAH BESAR,PASAR BARU,12035,2464,9571,8303,17874,2021-10-22
3174021006,JAKARTA SELATAN,SETIA BUDI,PASAR MANGGIS,26752,5791,20961,16689,37650,2021-10-22
3174041001,JAKARTA SELATAN,PASAR MINGGU,PASAR MINGGU,24821,5035,19786,16126,35912,2021-10-22
3171041003,JAKARTA PUSAT,SENEN,PASEBAN,23533,5387,18146,14391,32537,2021-10-22
3173061005,JAKARTA BARAT,KALI DERES,PEGADUNGAN,75587,16636,58951,49498,108449,2021-10-22
3171061002,JAKARTA PUSAT,MENTENG,PEGANGSAAN,23455,5570,17885,13137,31022,2021-10-22
3172061002,JAKARTA UTARA,KELAPA GADING,PEGANGSAAN DUA,49976,8741,41235,36465,77700,2021-10-22
3172011004,JAKARTA UTARA,PENJARINGAN,PEJAGALAN,74578,16681,57897,47814,105711,2021-10-22
3174041006,JAKARTA SELATAN,PASAR MINGGU,PEJATEN BARAT,37346,8123,29223,23480,52703,2021-10-22
3174041005,JAKARTA SELATAN,PASAR MINGGU,PEJATEN TIMUR,57656,14077,43579,34492,78071,2021-10-22
3175051005,JAKARTA TIMUR,PASAR REBO,PEKAYON,43250,8594,34656,27593,62249,2021-10-22
3173041009,JAKARTA BARAT,TAMBORA,PEKOJAN,23587,4834,18753,15163,33916,2021-10-22
3174031003,JAKARTA SELATAN,MAMPANG PRAPATAN,PELA MAMPANG,43522,9442,34080,27235,61315,2021-10-22
3174081005,JAKARTA SELATAN,PANCORAN,PENGADEGAN,21478,4234,17244,13905,31149,2021-10-22
3175061003,JAKARTA TIMUR,CAKUNG,PENGGILINGAN,99255,25165,74090,56919,131009,2021-10-22
3172011001,JAKARTA UTARA,PENJARINGAN,PENJARINGAN,88308,24434,63874,47360,111234,2021-10-22
3174101001,JAKARTA SELATAN,PESANGGRAHAN,PESANGGRAHAN,27545,5120,22425,18504,40929,2021-10-22
3171071004,JAKARTA PUSAT,TANAH ABANG,PETAMBURAN,33271,9372,23899,17360,41259,2021-10-22
3174071008,JAKARTA SELATAN,KEBAYORAN BARU,PETOGOGAN,11499,2447,9052,7392,16444,2021-10-22
3171011004,JAKARTA PUSAT,GAMBIR,PETOJO SELATAN,14692,3518,11174,9152,20326,2021-10-22
3171011003,JAKARTA PUSAT,GAMBIR,PETOJO UTARA,17458,3994,13464,10653,24117,2021-10-22
3174101004,JAKARTA SELATAN,PESANGGRAHAN,PETUKANGAN SELATAN,37187,8247,28940,23395,52335,2021-10-22
3174101003,JAKARTA SELATAN,PESANGGRAHAN,PETUKANGAN UTARA,53716,12609,41107,32831,73938,2021-10-22
3175081002,JAKARTA TIMUR,MAKASAR,PINANG RANTI,27198,6404,20794,16648,37442,2021-10-22
3173031008,JAKARTA BARAT,TAMAN SARI,PINANGSIA,10729,2033,8696,6965,15661,2021-10-22
3175011001,JAKARTA TIMUR,MATRAMAN,PISANGAN BARU,31776,7114,24662,18697,43359,2021-10-22
3175021002,JAKARTA TIMUR,PULO GADUNG,PISANGAN TIMUR,41011,8381,32630,26437,59067,2021-10-22
3172011005,JAKARTA UTARA,PENJARINGAN,PLUIT,47783,9779,38004,32202,70206,2021-10-22
3175071002,JAKARTA TIMUR,DUREN SAWIT,PONDOK BAMBU,61550,14046,47504,37345,84849,2021-10-22
3175071004,JAKARTA TIMUR,DUREN SAWIT,PONDOK KELAPA,72015,15366,56649,46832,103481,2021-10-22
3175071007,JAKARTA TIMUR,DUREN SAWIT,PONDOK KOPI,35367,7260,28107,21150,49257,2021-10-22
3174061003,JAKARTA SELATAN,CILANDAK,PONDOK LABU,46464,8716,37748,31669,69417,2021-10-22
3174051002,JAKARTA SELATAN,KEBAYORAN LAMA,PONDOK PINANG,56169,11488,44681,36089,80770,2021-10-22
3175101003,JAKARTA TIMUR,CIPAYUNG,PONDOK RANGGON,25574,5172,20402,16027,36429,2021-10-22
3101011003,KAB.ADM.KEP.SERIBU,KEP. SERIBU UTARA,PULAU HARAPAN,2060,230,1830,1571,3401,2021-10-22
3101011002,KAB.ADM.KEP.SERIBU,KEP. SERIBU UTARA,PULAU KELAPA,5528,638,4890,3968,8858,2021-10-22
3101011001,KAB.ADM.KEP.SERIBU,KEP. SERIBU UTARA,PULAU PANGGANG,5450,479,4971,4369,9340,2021-10-22
3101021003,KAB.ADM.KEP.SERIBU,KEP. SERIBU SELATAN,PULAU PARI,2765,204,2561,2375,4936,2021-10-22
3101021002,KAB.ADM.KEP.SERIBU,KEP. SERIBU SELATAN,PULAU TIDUNG,4553,395,4158,3743,7901,2021-10-22
3101021001,KAB.ADM.KEP.SERIBU,KEP. SERIBU SELATAN,PULAU UNTUNG JAWA,1941,173,1768,1609,3377,2021-10-22
3174071007,JAKARTA SELATAN,KEBAYORAN BARU,PULO,5835,1071,4764,4189,8953,2021-10-22
3175021001,JAKARTA TIMUR,PULO GADUNG,PULO GADUNG,34422,8039,26383,21146,47529,2021-10-22
3175061005,JAKARTA TIMUR,CAKUNG,PULO GEBANG,97301,20246,77055,60192,137247,2021-10-22
3174041004,JAKARTA SELATAN,PASAR MINGGU,RAGUNAN,39616,8028,31588,25919,57507,2021-10-22
3175091005,JAKARTA TIMUR,CIRACAS,RAMBUTAN,36771,9286,27485,20871,48356,2021-10-22
3172031006,JAKARTA UTARA,KOJA,RAWA BADAK SELATAN,42179,10777,31402,23950,55352,2021-10-22
3172031004,JAKARTA UTARA,KOJA,RAWA BADAK UTARA,34408,8340,26068,20172,46240,2021-10-22
3174071005,JAKARTA SELATAN,KEBAYORAN BARU,RAWA BARAT,5625,1055,4570,3910,8480,2021-10-22
3173011003,JAKARTA BARAT,CENGKARENG,RAWA BUAYA,63799,13985,49814,38366,88180,2021-10-22
3175031004,JAKARTA TIMUR,JATINEGARA,RAWA BUNGA,21434,5563,15871,12268,28139,2021-10-22
3174081003,JAKARTA SELATAN,PANCORAN,RAWA JATI,20509,4153,16356,13125,29481,2021-10-22
3175061002,JAKARTA TIMUR,CAKUNG,RAWA TERATE,24637,4916,19721,15612,35333,2021-10-22
3175021005,JAKARTA TIMUR,PULO GADUNG,RAWAMANGUN,37612,8091,29521,23994,53515,2021-10-22
3171051003,JAKARTA PUSAT,CEMPAKA PUTIH,RAWASARI,21967,4844,17123,13981,31104,2021-10-22
3173041010,JAKARTA BARAT,TAMBORA,ROA MALAKA,3484,645,2839,2449,5288,2021-10-22
3172041006,JAKARTA UTARA,CILINCING,ROROTAN,41668,9008,32660,25353,58013,2021-10-22
3174071004,JAKARTA SELATAN,KEBAYORAN BARU,SELONG,2842,569,2273,2047,4320,2021-10-22
3173061002,JAKARTA BARAT,KALI DERES,SEMANAN,71354,17202,54152,42656,96808,2021-10-22
3172041007,JAKARTA UTARA,CILINCING,SEMPER BARAT,68587,14491,54096,43491,97587,2021-10-22
3172041005,JAKARTA UTARA,CILINCING,SEMPER TIMUR,36267,8369,27898,21827,49725,2021-10-22
3174071006,JAKARTA SELATAN,KEBAYORAN BARU,SENAYAN,2771,684,2087,1733,3820,2021-10-22
3171041001,JAKARTA PUSAT,SENEN,SENEN,6804,1582,5222,4250,9472,2021-10-22
3171031004,JAKARTA PUSAT,KEMAYORAN,SERDANG,29668,6401,23267,18603,41870,2021-10-22
3174021001,JAKARTA SELATAN,SETIA BUDI,SETIA BUDI,3023,661,2362,1918,4280,2021-10-22
3175101005,JAKARTA TIMUR,CIPAYUNG,SETU,20572,4468,16104,12433,28537,2021-10-22
3173071002,JAKARTA BARAT,PALMERAH,SLIPI,16591,3262,13329,10767,24096,2021-10-22
3173081004,JAKARTA BARAT,KEMBANGAN,SRENGSENG,45523,11022,34501,28223,62724,2021-10-22
3174091002,JAKARTA SELATAN,JAGAKARSA,SRENGSENG SAWAH,58196,9922,48274,39344,87618,2021-10-22
3173051003,JAKARTA BARAT,KEBON JERUK,SUKABUMI SELATAN,37033,9043,27990,20894,48884,2021-10-22
3173051002,JAKARTA BARAT,KEBON JERUK,SUKABUMI UTARA,38290,9716,28574,21536,50110,2021-10-22
3172041002,JAKARTA UTARA,CILINCING,SUKAPURA,53949,13076,40873,32564,73437,2021-10-22
3171031007,JAKARTA PUSAT,KEMAYORAN,SUMUR BATU,22717,4944,17773,14583,32356,2021-10-22
3172021004,JAKARTA UTARA,TANJUNG PRIOK,SUNGAI BAMBU,29876,6493,23383,18645,42028,2021-10-22
3172021006,JAKARTA UTARA,TANJUNG PRIOK,SUNTER AGUNG,71805,13376,58429,49466,107895,2021-10-22
3172021002,JAKARTA UTARA,TANJUNG PRIOK,SUNTER JAYA,63031,11919,51112,42554,93666,2021-10-22
3175091004,JAKARTA TIMUR,CIRACAS,SUSUKAN,38257,7750,30507,24425,54932,2021-10-22
3173031001,JAKARTA BARAT,TAMAN SARI,TAMAN SARI,14348,2807,11541,9622,21163,2021-10-22
3173041001,JAKARTA BARAT,TAMBORA,TAMBORA,10204,2445,7759,6050,13809,2021-10-22
3173041004,JAKARTA BARAT,TAMBORA,TANAH SEREAL,26387,4806,21581,17520,39101,2021-10-22
3171081004,JAKARTA PUSAT,JOHAR BARU,TANAH TINGGI,37693,7623,30070,23688,53758,2021-10-22
3173031004,JAKARTA BARAT,TAMAN SARI,TANGKI,13324,2379,10945,8814,19759,2021-10-22
3174091005,JAKARTA SELATAN,JAGAKARSA,TANJUNG BARAT,39770,7264,32506,25341,57847,2021-10-22
3173021005,JAKARTA BARAT,GROGOL PETAMBURAN,TANJUNG DUREN SELATAN,25337,5236,20101,17065,37166,2021-10-22
3173021002,JAKARTA BARAT,GROGOL PETAMBURAN,TANJUNG DUREN UTARA,17010,3090,13920,11922,25842,2021-10-22
3172021001,JAKARTA UTARA,TANJUNG PRIOK,TANJUNG PRIOK,34588,7689,26899,21289,48188,2021-10-22
3174011002,JAKARTA SELATAN,TEBET,TEBET BARAT,21194,3761,17433,14835,32268,2021-10-22
3174011001,JAKARTA SELATAN,TEBET,TEBET TIMUR,18199,3150,15049,13066,28115,2021-10-22
3173061003,JAKARTA BARAT,KALI DERES,TEGAL ALUR,83647,19260,64387,51536,115923,2021-10-22
3174031004,JAKARTA SELATAN,MAMPANG PRAPATAN,TEGAL PARANG,32401,7751,24650,18148,42798,2021-10-22
3173021003,JAKARTA BARAT,GROGOL PETAMBURAN,TOMANG,29605,5885,23720,19516,43236,2021-10-22
3172031005,JAKARTA UTARA,KOJA,TUGU SELATAN,39122,9411,29711,23173,52884,2021-10-22
3172031002,JAKARTA UTARA,KOJA,TUGU UTARA,67670,17190,50480,38547,89027,2021-10-22
3175061006,JAKARTA TIMUR,CAKUNG,UJUNG MENTENG,29934,5603,24331,19938,44269,2021-10-22
3174101005,JAKARTA SELATAN,PESANGGRAHAN,ULUJAMI,40544,9923,30621,24000,54621,2021-10-22
3175011006,JAKARTA TIMUR,MATRAMAN,UTAN KAYU SELATAN,33511,6566,26945,21298,48243,2021-10-22
3175011002,JAKARTA TIMUR,MATRAMAN,UTAN KAYU UTARA,28169,6379,21790,17122,38912,2021-10-22
3171031008,JAKARTA PUSAT,KEMAYORAN,UTAN PANJANG,29208,6407,22801,17498,40299,2021-10-22
3172021007,JAKARTA UTARA,TANJUNG PRIOK,WARAKAS,44401,8771,35630,27565,63195,2021-10-22
3173021007,JAKARTA BARAT,GROGOL PETAMBURAN,WIJAYA KUSUMA,38934,8821,30113,24264,54377,2021-10-22
3172051003,JAKARTA UTARA,PADEMANGAN,ANCOL,23947,6159,17788,14201,31989,2021-10-23
3173041007,JAKARTA BARAT,TAMBORA,ANGKE,29381,6744,22637,17792,40429,2021-10-23
3175041005,JAKARTA TIMUR,KRAMAT JATI,BALE KAMBANG,29074,7802,21272,15894,37166,2021-10-23
3175031003,JAKARTA TIMUR,JATINEGARA,BALI MESTER,9752,2205,7547,6116,13663,2021-10-23
3175101006,JAKARTA TIMUR,CIPAYUNG,BAMBU APUS,26285,5179,21106,16918,38024,2021-10-23
3174031002,JAKARTA SELATAN,MAMPANG PRAPATAN,BANGKA,21566,5004,16562,13124,29686,2021-10-23
3175051002,JAKARTA TIMUR,PASAR REBO,BARU,23886,4243,19643,16414,36057,2021-10-23
3175041004,JAKARTA TIMUR,KRAMAT JATI,BATU AMPAR,47898,12526,35372,27070,62442,2021-10-23
3171071002,JAKARTA PUSAT,TANAH ABANG,BENDUNGAN HILIR,21494,4614,16880,13822,30702,2021-10-23
3175031002,JAKARTA TIMUR,JATINEGARA,BIDARA CINA,36689,9416,27273,20811,48084,2021-10-23
3174101002,JAKARTA SELATAN,PESANGGRAHAN,BINTARO,53098,11443,41655,34282,75937,2021-10-23
3174011005,JAKARTA SELATAN,TEBET,BUKIT DURI,34183,7651,26532,21238,47770,2021-10-23
3171041006,JAKARTA PUSAT,SENEN,BUNGUR,18144,4146,13998,11323,25321,2021-10-23
3175061007,JAKARTA TIMUR,CAKUNG,CAKUNG BARAT,57724,12777,44947,36066,81013,2021-10-23
3175061004,JAKARTA TIMUR,CAKUNG,CAKUNG TIMUR,58287,12360,45927,36809,82736,2021-10-23
3175041007,JAKARTA TIMUR,KRAMAT JATI,CAWANG,32762,7771,24991,19216,44207,2021-10-23
3175101008,JAKARTA TIMUR,CIPAYUNG,CEGER,18932,3969,14963,12004,26967,2021-10-23
3171031006,JAKARTA PUSAT,KEMAYORAN,CEMPAKA BARU,32581,7217,25364,19316,44680,2021-10-23
3171051002,JAKARTA PUSAT,CEMPAKA PUTIH,CEMPAKA PUTIH BARAT,35885,8254,27631,22656,50287,2021-10-23
3171051001,JAKARTA PUSAT,CEMPAKA PUTIH,CEMPAKA PUTIH TIMUR,24292,5341,18951,15874,34825,2021-10-23
3173011001,JAKARTA BARAT,CENGKARENG,CENGKARENG BARAT,66284,14488,51796,42340,94136,2021-10-23
3173011006,JAKARTA BARAT,CENGKARENG,CENGKARENG TIMUR,81027,17251,63776,50563,114339,2021-10-23
3175091002,JAKARTA TIMUR,CIRACAS,CIBUBUR,66364,12179,54185,43642,97827,2021-10-23
3171011002,JAKARTA PUSAT,GAMBIR,CIDENG,15390,3161,12229,10324,22553,2021-10-23
3174091003,JAKARTA SELATAN,JAGAKARSA,CIGANJUR,38497,7146,31351,24498,55849,2021-10-23
3175051003,JAKARTA TIMUR,PASAR REBO,CIJANTUNG,41419,8278,33141,26632,59773,2021-10-23
3171061003,JAKARTA PUSAT,MENTENG,CIKINI,8274,1563,6711,5095,11806,2021-10-23
3174081006,JAKARTA SELATAN,PANCORAN,CIKOKO,10547,1943,8604,7171,15775,2021-10-23
3174061001,JAKARTA SELATAN,CILANDAK,CILANDAK BARAT,51752,9890,41862,34709,76571,2021-10-23
3174041003,JAKARTA SELATAN,PASAR MINGGU,CILANDAK TIMUR,25145,5002,20143,16503,36646,2021-10-23
3175101002,JAKARTA TIMUR,CIPAYUNG,CILANGKAP,27635,5235,22400,17880,40280,2021-10-23
3175041006,JAKARTA TIMUR,KRAMAT JATI,CILILITAN,40181,9655,30526,23791,54317,2021-10-23
3172041001,JAKARTA UTARA,CILINCING,CILINCING,43609,11210,32399,24318,56717,2021-10-23
3175101001,JAKARTA TIMUR,CIPAYUNG,CIPAYUNG,26104,4874,21230,17633,38863,2021-10-23
3174091006,JAKARTA SELATAN,JAGAKARSA,CIPEDAK,38303,6965,31338,25129,56467,2021-10-23
3174061005,JAKARTA SELATAN,CILANDAK,CIPETE SELATAN,26704,5512,21192,17740,38932,2021-10-23
3174071010,JAKARTA SELATAN,KEBAYORAN BARU,CIPETE UTARA,34102,6939,27163,21405,48568,2021-10-23
3175021003,JAKARTA TIMUR,PULO GADUNG,CIPINANG,39306,7987,31319,24911,56230,2021-10-23
3175031007,JAKARTA TIMUR,JATINEGARA,CIPINANG BESAR SELATAN,35212,8945,26267,19650,45917,2021-10-23
3175031008,JAKARTA TIMUR,JATINEGARA,CIPINANG BESAR UTARA,45319,11531,33788,25075,58863,2021-10-23
3175031005,JAKARTA TIMUR,JATINEGARA,CIPINANG CEMPEDAK,32824,7622,25202,20180,45382,2021-10-23
3175081005,JAKARTA TIMUR,MAKASAR,CIPINANG MELAYU,42308,8771,33537,27100,60637,2021-10-23
3175031006,JAKARTA TIMUR,JATINEGARA,CIPINANG MUARA,55243,12757,42486,33115,75601,2021-10-23
3174051003,JAKARTA SELATAN,KEBAYORAN LAMA,CIPULIR,39937,9033,30904,24017,54921,2021-10-23
3175091001,JAKARTA TIMUR,CIRACAS,CIRACAS,64594,12691,51903,41018,92921,2021-10-23
3175041003,JAKARTA TIMUR,KRAMAT JATI,DUKUH,24609,5018,19591,15468,35059,2021-10-23
3175071001,JAKARTA TIMUR,DUREN SAWIT,DUREN SAWIT,61160,13930,47230,37141,84371,2021-10-23
3174081004,JAKARTA SELATAN,PANCORAN,DUREN TIGA,28319,6060,22259,17724,39983,2021-10-23
3173051005,JAKARTA BARAT,KEBON JERUK,DURI KEPA,60138,12616,47522,40007,87529,2021-10-23
3173011002,JAKARTA BARAT,CENGKARENG,DURI KOSAMBI,77923,18223,59700,45990,105690,2021-10-23
3171011006,JAKARTA PUSAT,GAMBIR,DURI PULO,19610,4452,15158,11795,26953,2021-10-23
3173041011,JAKARTA BARAT,TAMBORA,DURI SELATAN,14259,2706,11553,9463,21016,2021-10-23
3173041003,JAKARTA BARAT,TAMBORA,DURI UTARA,19844,3879,15965,12691,28656,2021-10-23
3171081003,JAKARTA PUSAT,JOHAR BARU,GALUR,18243,3830,14413,11320,25733,2021-10-23
3171011001,JAKARTA PUSAT,GAMBIR,GAMBIR,2191,483,1708,1430,3138,2021-10-23
3174061004,JAKARTA SELATAN,CILANDAK,GANDARIA SELATAN,22119,4601,17518,14183,31701,2021-10-23
3174071009,JAKARTA SELATAN,KEBAYORAN BARU,GANDARIA UTARA,39922,8573,31349,25225,56574,2021-10-23
3175051001,JAKARTA TIMUR,PASAR REBO,GEDONG,35755,7638,28117,22843,50960,2021-10-23
3171071001,JAKARTA PUSAT,TANAH ABANG,GELORA,3127,655,2472,2061,4533,2021-10-23
3173031007,JAKARTA BARAT,TAMAN SARI,GLODOK,7837,1290,6547,5724,12271,2021-10-23
3171061004,JAKARTA PUSAT,MENTENG,GONDANGDIA,4100,960,3140,2809,5949,2021-10-23
3173021001,JAKARTA BARAT,GROGOL PETAMBURAN,GROGOL,16876,3604,13272,10813,24085,2021-10-23
3174051005,JAKARTA SELATAN,KEBAYORAN LAMA,GROGOL SELATAN,44251,9670,34581,27365,61946,2021-10-23
3174051004,JAKARTA SELATAN,KEBAYORAN LAMA,GROGOL UTARA,42494,9370,33124,26522,59646,2021-10-23
3174021007,JAKARTA SELATAN,SETIA BUDI,GUNTUR,3985,792,3193,2727,5920,2021-10-23
3174071002,JAKARTA SELATAN,KEBAYORAN BARU,GUNUNG,9436,1854,7582,6409,13991,2021-10-23
3171031005,JAKARTA PUSAT,KEMAYORAN,GUNUNG SAHARI SELATAN,19199,4176,15023,12192,27215,2021-10-23
3171021004,JAKARTA PUSAT,SAWAH BESAR,GUNUNG SAHARI UTARA,16650,3139,13511,11666,25177,2021-10-23
3175081004,JAKARTA TIMUR,MAKASAR,HALIM PERDANA KUSUMAH,28363,3986,24377,21818,46195,2021-10-23
3171031003,JAKARTA PUSAT,KEMAYORAN,HARAPAN MULIA,22557,4932,17625,13752,31377,2021-10-23
3174091001,JAKARTA SELATAN,JAGAKARSA,JAGAKARSA,62389,11269,51120,40561,91681,2021-10-23
3175021007,JAKARTA TIMUR,PULO GADUNG,JATI,32757,6567,26190,21771,47961,2021-10-23
3174041002,JAKARTA SELATAN,PASAR MINGGU,JATI PADANG,37502,8056,29446,23886,53332,2021-10-23
3173071004,JAKARTA BARAT,PALMERAH,JATI PULO,28738,6175,22563,17499,40062,2021-10-23
3175061001,JAKARTA TIMUR,CAKUNG,JATINEGARA,84160,19401,64759,51564,116323,2021-10-23
3175021004,JAKARTA TIMUR,PULO GADUNG,JATINEGARA KAUM,24632,4741,19891,15424,35315,2021-10-23
3173021004,JAKARTA BARAT,GROGOL PETAMBURAN,JELAMBAR,30266,5926,24340,20287,44627,2021-10-23
3173021006,JAKARTA BARAT,GROGOL PETAMBURAN,JELAMBAR BARU,38246,7691,30555,25541,56096,2021-10-23
3173041006,JAKARTA BARAT,TAMBORA,JEMBATAN BESI,29314,7673,21641,16272,37913,2021-10-23
3173041008,JAKARTA BARAT,TAMBORA,JEMBATAN LIMA,21021,5324,15697,11980,27677,2021-10-23
3173081005,JAKARTA BARAT,KEMBANGAN,JOGLO,40839,8928,31911,26231,58142,2021-10-23
3171081001,JAKARTA PUSAT,JOHAR BARU,JOHAR BARU,37488,7341,30147,24720,54867,2021-10-23
3173041002,JAKARTA BARAT,TAMBORA,KALI ANYAR,23856,5116,18740,14297,33037,2021-10-23
3172041004,JAKARTA UTARA,CILINCING,KALIBARU,67684,19842,47842,33215,81057,2021-10-23
3174081002,JAKARTA SELATAN,PANCORAN,KALIBATA,41994,10319,31675,24381,56056,2021-10-23
3173061001,JAKARTA BARAT,KALI DERES,KALIDERES,72447,16286,56161,46134,102295,2021-10-23
3175051004,JAKARTA TIMUR,PASAR REBO,KALISARI,43212,8382,34830,28145,62975,2021-10-23
3173061004,JAKARTA BARAT,KALI DERES,KAMAL,53783,13747,40036,30905,70941,2021-10-23
3172011002,JAKARTA UTARA,PENJARINGAN,KAMAL MUARA,12930,2369,10561,8868,19429,2021-10-23
3171071007,JAKARTA PUSAT,TANAH ABANG,KAMPUNG BALI,11358,2634,8724,6383,15107,2021-10-23
3175031001,JAKARTA TIMUR,JATINEGARA,KAMPUNG MELAYU,25717,6510,19207,14560,33767,2021-10-23
3171081002,JAKARTA PUSAT,JOHAR BARU,KAMPUNG RAWA,21237,3715,17522,13609,31131,2021-10-23
3175041002,JAKARTA TIMUR,KRAMAT JATI,KAMPUNG TENGAH,43993,11723,32270,24627,56897,2021-10-23
3173011005,JAKARTA BARAT,CENGKARENG,KAPUK,134466,34710,99756,77635,177391,2021-10-23
3172011003,JAKARTA UTARA,PENJARINGAN,KAPUK MUARA,35781,7307,28474,24372,52846,2021-10-23
3171021002,JAKARTA PUSAT,SAWAH BESAR,KARANG ANYAR,25761,5321,20440,16632,37072,2021-10-23
3174021004,JAKARTA SELATAN,SETIA BUDI,KARET,9623,1978,7645,6151,13796,2021-10-23
3174021003,JAKARTA SELATAN,SETIA BUDI,KARET KUNINGAN,16055,3353,12702,10417,23119,2021-10-23
3174021002,JAKARTA SELATAN,SETIA BUDI,KARET SEMANGGI,2770,581,2189,1894,4083,2021-10-23
3171071003,JAKARTA PUSAT,TANAH ABANG,KARET TENGSIN,19271,3977,15294,11992,27286,2021-10-23
3171021003,JAKARTA PUSAT,SAWAH BESAR,KARTINI,22292,4616,17676,14613,32289,2021-10-23
3175011003,JAKARTA TIMUR,MATRAMAN,KAYU MANIS,25284,5757,19527,14796,34323,2021-10-23
3175021006,JAKARTA TIMUR,PULO GADUNG,KAYU PUTIH,40696,8139,32557,27589,60146,2021-10-23
3173031006,JAKARTA BARAT,TAMAN SARI,KEAGUNGAN,17387,3492,13895,10939,24834,2021-10-23
3174041007,JAKARTA SELATAN,PASAR MINGGU,KEBAGUSAN,44552,9558,34994,27712,62706,2021-10-23
3174051006,JAKARTA SELATAN,KEBAYORAN LAMA,KEBAYORAN LAMA SELATAN,41212,8312,32900,26541,59441,2021-10-23
3174051001,JAKARTA SELATAN,KEBAYORAN LAMA,KEBAYORAN LAMA UTARA,42422,9602,32820,25962,58782,2021-10-23
3174011004,JAKARTA SELATAN,TEBET,KEBON BARU,35165,7152,28013,22436,50449,2021-10-23
3172021005,JAKARTA UTARA,TANJUNG PRIOK,KEBON BAWANG,50952,11087,39865,32013,71878,2021-10-23
3173051001,JAKARTA BARAT,KEBON JERUK,KEBON JERUK,53887,12450,41437,32813,74250,2021-10-23
3171071006,JAKARTA PUSAT,TANAH ABANG,KEBON KACANG,21531,5539,15992,12177,28169,2021-10-23
3171011005,JAKARTA PUSAT,GAMBIR,KEBON KELAPA,10163,2175,7988,6469,14457,2021-10-23
3171031002,JAKARTA PUSAT,KEMAYORAN,KEBON KOSONG,30019,6462,23557,18261,41818,2021-10-23
3175011005,JAKARTA TIMUR,MATRAMAN,KEBON MANGGIS,16490,3461,13029,10420,23449,2021-10-23
3171071005,JAKARTA PUSAT,TANAH ABANG,KEBON MELATI,32206,9060,23146,16459,39605,2021-10-23
3175081003,JAKARTA TIMUR,MAKASAR,KEBON PALA,46614,10050,36564,29287,65851,2021-10-23
3171061005,JAKARTA PUSAT,MENTENG,KEBON SIRIH,12299,2821,9478,7324,16802,2021-10-23
3173011004,JAKARTA BARAT,CENGKARENG,KEDAUNG KALI ANGKE,32612,6798,25814,20922,46736,2021-10-23
3173051007,JAKARTA BARAT,KEBON JERUK,KEDOYA SELATAN,32165,6309,25856,20661,46517,2021-10-23
3173051006,JAKARTA BARAT,KEBON JERUK,KEDOYA UTARA,45740,9195,36545,30130,66675,2021-10-23
3173051004,JAKARTA BARAT,KEBON JERUK,KELAPA DUA,23565,5162,18403,14784,33187,2021-10-23
3175091003,JAKARTA TIMUR,CIRACAS,KELAPA DUA WETAN,46875,8665,38210,30949,69159,2021-10-23
3172061003,JAKARTA UTARA,KELAPA GADING,KELAPA GADING BARAT,35717,6523,29194,25757,54951,2021-10-23
3172061001,JAKARTA UTARA,KELAPA GADING,KELAPA GADING TIMUR,33592,5421,28171,25468,53639,2021-10-23
3173071005,JAKARTA BARAT,PALMERAH,KEMANGGISAN,32139,6631,25508,20478,45986,2021-10-23
3171031001,JAKARTA PUSAT,KEMAYORAN,KEMAYORAN,20708,4589,16119,12912,29031,2021-10-23
3173081006,JAKARTA BARAT,KEMBANGAN,KEMBANGAN SELATAN,27130,6127,21003,17744,38747,2021-10-23
3173081001,JAKARTA BARAT,KEMBANGAN,KEMBANGAN UTARA,54451,12859,41592,33721,75313,2021-10-23
3171041002,JAKARTA PUSAT,SENEN,KENARI,9579,2014,7565,6277,13842,2021-10-23
3173041005,JAKARTA BARAT,TAMBORA,KERENDANG,19973,4520,15453,12120,27573,2021-10-23
3175071003,JAKARTA TIMUR,DUREN SAWIT,KLENDER,69978,17452,52526,40182,92708,2021-10-23
3172031001,JAKARTA UTARA,KOJA,KOJA,28175,6855,21320,16670,37990,2021-10-23
3173071006,JAKARTA BARAT,PALMERAH,KOTA BAMBU SELATAN,21158,4736,16422,12537,28959,2021-10-23
3173071003,JAKARTA BARAT,PALMERAH,KOTA BAMBU UTARA,24995,5877,19118,14520,33638,2021-10-23
3171041004,JAKARTA PUSAT,SENEN,KRAMAT,28835,7425,21410,15867,37277,2021-10-23
3175041001,JAKARTA TIMUR,KRAMAT JATI,KRAMAT JATI,34144,7946,26198,20400,46598,2021-10-23
3174071003,JAKARTA SELATAN,KEBAYORAN BARU,KRAMAT PELA,14413,2981,11432,9367,20799,2021-10-23
3173031002,JAKARTA BARAT,TAMAN SARI,KRUKUT,19244,3922,15322,11921,27243,2021-10-23
3174031005,JAKARTA SELATAN,MAMPANG PRAPATAN,KUNINGAN BARAT,12785,2546,10239,8268,18507,2021-10-23
3174021008,JAKARTA SELATAN,SETIA BUDI,KUNINGAN TIMUR,6008,1322,4686,3866,8552,2021-10-23
3171041005,JAKARTA PUSAT,SENEN,KWITANG,15486,3785,11701,9225,20926,2021-10-23
3172031003,JAKARTA UTARA,KOJA,LAGOA,59065,14960,44105,33868,77973,2021-10-23
3174061002,JAKARTA SELATAN,CILANDAK,LEBAK BULUS,37626,7666,29960,24874,54834,2021-10-23
3174091004,JAKARTA SELATAN,JAGAKARSA,LENTENG AGUNG,53946,10577,43369,33311,76680,2021-10-23
3175101007,JAKARTA TIMUR,CIPAYUNG,LUBANG BUAYA,63547,12856,50691,40660,91351,2021-10-23
3175081001,JAKARTA TIMUR,MAKASAR,MAKASAR,34390,6795,27595,22471,50066,2021-10-23
3175071006,JAKARTA TIMUR,DUREN SAWIT,MALAKA JAYA,30927,5842,25085,20488,45573,2021-10-23
3175071005,JAKARTA TIMUR,DUREN SAWIT,MALAKA SARI,27530,4974,22556,18705,41261,2021-10-23
3174031001,JAKARTA SELATAN,MAMPANG PRAPATAN,MAMPANG PRAPATAN,18159,4033,14126,11130,25256,2021-10-23
3173031005,JAKARTA BARAT,TAMAN SARI,MANGGA BESAR,7707,1378,6329,5348,11677,2021-10-23
3171021005,JAKARTA PUSAT,SAWAH BESAR,MANGGA DUA SELATAN,27442,6073,21369,17470,38839,2021-10-23
3174011007,JAKARTA SELATAN,TEBET,MANGGARAI,28373,5471,22902,17827,40729,2021-10-23
3174011006,JAKARTA SELATAN,TEBET,MANGGARAI SELATAN,23075,4460,18615,15128,33743,2021-10-23
3173031003,JAKARTA BARAT,TAMAN SARI,MAPHAR,16461,3282,13179,10605,23784,2021-10-23
3172041003,JAKARTA UTARA,CILINCING,MARUNDA,28943,7029,21914,16071,37985,2021-10-23
3174071001,JAKARTA SELATAN,KEBAYORAN BARU,MELAWAI,2627,547,2080,1896,3976,2021-10-23
3171061001,JAKARTA PUSAT,MENTENG,MENTENG,25624,6152,19472,14808,34280,2021-10-23
3174021005,JAKARTA SELATAN,SETIA BUDI,MENTENG ATAS,27816,5474,22342,17770,40112,2021-10-23
3174011003,JAKARTA SELATAN,TEBET,MENTENG DALAM,36028,7565,28463,22942,51405,2021-10-23
3173081003,JAKARTA BARAT,KEMBANGAN,MERUYA SELATAN,32130,7070,25060,20244,45304,2021-10-23
3173081002,JAKARTA BARAT,KEMBANGAN,MERUYA UTARA,43752,9615,34137,28585,62722,2021-10-23
3175101004,JAKARTA TIMUR,CIPAYUNG,MUNJUL,23871,4612,19259,15541,34800,2021-10-23
3172051002,JAKARTA UTARA,PADEMANGAN,PADEMANGAN BARAT,74240,18713,55527,43274,98801,2021-10-23
3172051001,JAKARTA UTARA,PADEMANGAN,PADEMANGAN TIMUR,37736,7109,30627,25866,56493,2021-10-23
3175011004,JAKARTA TIMUR,MATRAMAN,PAL MERIAM,19769,4429,15340,11853,27193,2021-10-23
3173071001,JAKARTA BARAT,PALMERAH,PALMERAH,63011,14740,48271,37996,86267,2021-10-23
3174081001,JAKARTA SELATAN,PANCORAN,PANCORAN,19421,4432,14989,12062,27051,2021-10-23
3172021003,JAKARTA UTARA,TANJUNG PRIOK,PAPANGGO,39097,8431,30666,24401,55067,2021-10-23
3171021001,JAKARTA PUSAT,SAWAH BESAR,PASAR BARU,12035,2456,9579,8331,17910,2021-10-23
3174021006,JAKARTA SELATAN,SETIA BUDI,PASAR MANGGIS,26752,5745,21007,16779,37786,2021-10-23
3174041001,JAKARTA SELATAN,PASAR MINGGU,PASAR MINGGU,24821,5000,19821,16200,36021,2021-10-23
3171041003,JAKARTA PUSAT,SENEN,PASEBAN,23533,5369,18164,14440,32604,2021-10-23
3173061005,JAKARTA BARAT,KALI DERES,PEGADUNGAN,75587,16483,59104,49669,108773,2021-10-23
3171061002,JAKARTA PUSAT,MENTENG,PEGANGSAAN,23455,5551,17904,13185,31089,2021-10-23
3172061002,JAKARTA UTARA,KELAPA GADING,PEGANGSAAN DUA,49976,8682,41294,36602,77896,2021-10-23
3172011004,JAKARTA UTARA,PENJARINGAN,PEJAGALAN,74578,16574,58004,48049,106053,2021-10-23
3174041006,JAKARTA SELATAN,PASAR MINGGU,PEJATEN BARAT,37346,8067,29279,23600,52879,2021-10-23
3174041005,JAKARTA SELATAN,PASAR MINGGU,PEJATEN TIMUR,57656,14031,43625,34591,78216,2021-10-23
3175051005,JAKARTA TIMUR,PASAR REBO,PEKAYON,43250,8552,34698,27766,62464,2021-10-23
3173041009,JAKARTA BARAT,TAMBORA,PEKOJAN,23587,4794,18793,15241,34034,2021-10-23
3174031003,JAKARTA SELATAN,MAMPANG PRAPATAN,PELA MAMPANG,43522,9404,34118,27365,61483,2021-10-23
3174081005,JAKARTA SELATAN,PANCORAN,PENGADEGAN,21478,4210,17268,14042,31310,2021-10-23
3175061003,JAKARTA TIMUR,CAKUNG,PENGGILINGAN,99255,24944,74311,57367,131678,2021-10-23
3172011001,JAKARTA UTARA,PENJARINGAN,PENJARINGAN,88308,24327,63981,47639,111620,2021-10-23
3174101001,JAKARTA SELATAN,PESANGGRAHAN,PESANGGRAHAN,27545,5088,22457,18586,41043,2021-10-23
3171071004,JAKARTA PUSAT,TANAH ABANG,PETAMBURAN,33271,9330,23941,17444,41385,2021-10-23
3174071008,JAKARTA SELATAN,KEBAYORAN BARU,PETOGOGAN,11499,2439,9060,7405,16465,2021-10-23
3171011004,JAKARTA PUSAT,GAMBIR,PETOJO SELATAN,14692,3506,11186,9216,20402,2021-10-23
3171011003,JAKARTA PUSAT,GAMBIR,PETOJO UTARA,17458,3984,13474,10692,24166,2021-10-23
3174101004,JAKARTA SELATAN,PESANGGRAHAN,PETUKANGAN SELATAN,37187,8193,28994,23509,52503,2021-10-23
3174101003,JAKARTA SELATAN,PESANGGRAHAN,PETUKANGAN UTARA,53716,12549,41167,33019,74186,2021-10-23
3175081002,JAKARTA TIMUR,MAKASAR,PINANG RANTI,27198,6375,20823,16732,37555,2021-10-23
3173031008,JAKARTA BARAT,TAMAN SARI,PINANGSIA,10729,2018,8711,6999,15710,2021-10-23
3175011001,JAKARTA TIMUR,MATRAMAN,PISANGAN BARU,31776,7083,24693,18812,43505,2021-10-23
3175021002,JAKARTA TIMUR,PULO GADUNG,PISANGAN TIMUR,41011,8337,32674,26566,59240,2021-10-23
3172011005,JAKARTA UTARA,PENJARINGAN,PLUIT,47783,9668,38115,32352,70467,2021-10-23
3175071002,JAKARTA TIMUR,DUREN SAWIT,PONDOK BAMBU,61550,13964,47586,37544,85130,2021-10-23
3175071004,JAKARTA TIMUR,DUREN SAWIT,PONDOK KELAPA,72015,15293,56722,47050,103772,2021-10-23
3175071007,JAKARTA TIMUR,DUREN SAWIT,PONDOK KOPI,35367,7184,28183,21272,49455,2021-10-23
3174061003,JAKARTA SELATAN,CILANDAK,PONDOK LABU,46464,8636,37828,31853,69681,2021-10-23
3174051002,JAKARTA SELATAN,KEBAYORAN LAMA,PONDOK PINANG,56169,11460,44709,36173,80882,2021-10-23
3175101003,JAKARTA TIMUR,CIPAYUNG,PONDOK RANGGON,25574,5156,20418,16067,36485,2021-10-23
3101011003,KAB.ADM.KEP.SERIBU,KEP. SERIBU UTARA,PULAU HARAPAN,2060,230,1830,1572,3402,2021-10-23
3101011002,KAB.ADM.KEP.SERIBU,KEP. SERIBU UTARA,PULAU KELAPA,5528,638,4890,3976,8866,2021-10-23
3101011001,KAB.ADM.KEP.SERIBU,KEP. SERIBU UTARA,PULAU PANGGANG,5450,478,4972,4377,9349,2021-10-23
3101021003,KAB.ADM.KEP.SERIBU,KEP. SERIBU SELATAN,PULAU PARI,2765,204,2561,2376,4937,2021-10-23
3101021002,KAB.ADM.KEP.SERIBU,KEP. SERIBU SELATAN,PULAU TIDUNG,4553,395,4158,3744,7902,2021-10-23
3101021001,KAB.ADM.KEP.SERIBU,KEP. SERIBU SELATAN,PULAU UNTUNG JAWA,1941,169,1772,1617,3389,2021-10-23
3174071007,JAKARTA SELATAN,KEBAYORAN BARU,PULO,5835,1068,4767,4200,8967,2021-10-23
3175021001,JAKARTA TIMUR,PULO GADUNG,PULO GADUNG,34422,8001,26421,21265,47686,2021-10-23
3175061005,JAKARTA TIMUR,CAKUNG,PULO GEBANG,97301,20132,77169,60525,137694,2021-10-23
3174041004,JAKARTA SELATAN,PASAR MINGGU,RAGUNAN,39616,7985,31631,26043,57674,2021-10-23
3175091005,JAKARTA TIMUR,CIRACAS,RAMBUTAN,36771,9198,27573,21000,48573,2021-10-23
3172031006,JAKARTA UTARA,KOJA,RAWA BADAK SELATAN,42179,10672,31507,24100,55607,2021-10-23
3172031004,JAKARTA UTARA,KOJA,RAWA BADAK UTARA,34408,8254,26154,20289,46443,2021-10-23
3174071005,JAKARTA SELATAN,KEBAYORAN BARU,RAWA BARAT,5625,1050,4575,3928,8503,2021-10-23
3173011003,JAKARTA BARAT,CENGKARENG,RAWA BUAYA,63799,13886,49913,38620,88533,2021-10-23
3175031004,JAKARTA TIMUR,JATINEGARA,RAWA BUNGA,21434,5537,15897,12341,28238,2021-10-23
3174081003,JAKARTA SELATAN,PANCORAN,RAWA JATI,20509,4139,16370,13286,29656,2021-10-23
3175061002,JAKARTA TIMUR,CAKUNG,RAWA TERATE,24637,4859,19778,15646,35424,2021-10-23
3175021005,JAKARTA TIMUR,PULO GADUNG,RAWAMANGUN,37612,8047,29565,24154,53719,2021-10-23
3171051003,JAKARTA PUSAT,CEMPAKA PUTIH,RAWASARI,21967,4820,17147,14044,31191,2021-10-23
3173041010,JAKARTA BARAT,TAMBORA,ROA MALAKA,3484,640,2844,2463,5307,2021-10-23
3172041006,JAKARTA UTARA,CILINCING,ROROTAN,41668,8943,32725,25464,58189,2021-10-23
3174071004,JAKARTA SELATAN,KEBAYORAN BARU,SELONG,2842,567,2275,2057,4332,2021-10-23
3173061002,JAKARTA BARAT,KALI DERES,SEMANAN,71354,17081,54273,42812,97085,2021-10-23
3172041007,JAKARTA UTARA,CILINCING,SEMPER BARAT,68587,14388,54199,43679,97878,2021-10-23
3172041005,JAKARTA UTARA,CILINCING,SEMPER TIMUR,36267,8326,27941,21973,49914,2021-10-23
3174071006,JAKARTA SELATAN,KEBAYORAN BARU,SENAYAN,2771,681,2090,1744,3834,2021-10-23
3171041001,JAKARTA PUSAT,SENEN,SENEN,6804,1562,5242,4262,9504,2021-10-23
3171031004,JAKARTA PUSAT,KEMAYORAN,SERDANG,29668,6371,23297,18734,42031,2021-10-23
3174021001,JAKARTA SELATAN,SETIA BUDI,SETIA BUDI,3023,651,2372,1928,4300,2021-10-23
3175101005,JAKARTA TIMUR,CIPAYUNG,SETU,20572,4419,16153,12544,28697,2021-10-23
3173071002,JAKARTA BARAT,PALMERAH,SLIPI,16591,3244,13347,10830,24177,2021-10-23
3173081004,JAKARTA BARAT,KEMBANGAN,SRENGSENG,45523,10939,34584,28362,62946,2021-10-23
3174091002,JAKARTA SELATAN,JAGAKARSA,SRENGSENG SAWAH,58196,9843,48353,39501,87854,2021-10-23
3173051003,JAKARTA BARAT,KEBON JERUK,SUKABUMI SELATAN,37033,8993,28040,20994,49034,2021-10-23
3173051002,JAKARTA BARAT,KEBON JERUK,SUKABUMI UTARA,38290,9663,28627,21654,50281,2021-10-23
3172041002,JAKARTA UTARA,CILINCING,SUKAPURA,53949,12999,40950,32693,73643,2021-10-23
3171031007,JAKARTA PUSAT,KEMAYORAN,SUMUR BATU,22717,4921,17796,14639,32435,2021-10-23
3172021004,JAKARTA UTARA,TANJUNG PRIOK,SUNGAI BAMBU,29876,6455,23421,18743,42164,2021-10-23
3172021006,JAKARTA UTARA,TANJUNG PRIOK,SUNTER AGUNG,71805,13297,58508,49673,108181,2021-10-23
3172021002,JAKARTA UTARA,TANJUNG PRIOK,SUNTER JAYA,63031,11851,51180,42759,93939,2021-10-23
3175091004,JAKARTA TIMUR,CIRACAS,SUSUKAN,38257,7694,30563,24534,55097,2021-10-23
3173031001,JAKARTA BARAT,TAMAN SARI,TAMAN SARI,14348,2801,11547,9663,21210,2021-10-23
3173041001,JAKARTA BARAT,TAMBORA,TAMBORA,10204,2413,7791,6083,13874,2021-10-23
3173041004,JAKARTA BARAT,TAMBORA,TANAH SEREAL,26387,4770,21617,17588,39205,2021-10-23
3171081004,JAKARTA PUSAT,JOHAR BARU,TANAH TINGGI,37693,7600,30093,23760,53853,2021-10-23
3173031004,JAKARTA BARAT,TAMAN SARI,TANGKI,13324,2370,10954,8850,19804,2021-10-23
3174091005,JAKARTA SELATAN,JAGAKARSA,TANJUNG BARAT,39770,7235,32535,25451,57986,2021-10-23
3173021005,JAKARTA BARAT,GROGOL PETAMBURAN,TANJUNG DUREN SELATAN,25337,5194,20143,17176,37319,2021-10-23
3173021002,JAKARTA BARAT,GROGOL PETAMBURAN,TANJUNG DUREN UTARA,17010,3057,13953,12023,25976,2021-10-23
3172021001,JAKARTA UTARA,TANJUNG PRIOK,TANJUNG PRIOK,34588,7648,26940,21358,48298,2021-10-23
3174011002,JAKARTA SELATAN,TEBET,TEBET BARAT,21194,3753,17441,14871,32312,2021-10-23
3174011001,JAKARTA SELATAN,TEBET,TEBET TIMUR,18199,3135,15064,13113,28177,2021-10-23
3173061003,JAKARTA BARAT,KALI DERES,TEGAL ALUR,83647,19135,64512,51735,116247,2021-10-23
3174031004,JAKARTA SELATAN,MAMPANG PRAPATAN,TEGAL PARANG,32401,7720,24681,18223,42904,2021-10-23
3173021003,JAKARTA BARAT,GROGOL PETAMBURAN,TOMANG,29605,5841,23764,19659,43423,2021-10-23
3172031005,JAKARTA UTARA,KOJA,TUGU SELATAN,39122,9342,29780,23366,53146,2021-10-23
3172031002,JAKARTA UTARA,KOJA,TUGU UTARA,67670,17100,50570,38746,89316,2021-10-23
3175061006,JAKARTA TIMUR,CAKUNG,UJUNG MENTENG,29934,5588,24346,20007,44353,2021-10-23
3174101005,JAKARTA SELATAN,PESANGGRAHAN,ULUJAMI,40544,9863,30681,24225,54906,2021-10-23
3175011006,JAKARTA TIMUR,MATRAMAN,UTAN KAYU SELATAN,33511,6534,26977,21413,48390,2021-10-23
3175011002,JAKARTA TIMUR,MATRAMAN,UTAN KAYU UTARA,28169,6346,21823,17234,39057,2021-10-23
3171031008,JAKARTA PUSAT,KEMAYORAN,UTAN PANJANG,29208,6378,22830,17560,40390,2021-10-23
3172021007,JAKARTA UTARA,TANJUNG PRIOK,WARAKAS,44401,8706,35695,27672,63367,2021-10-23
3173021007,JAKARTA BARAT,GROGOL PETAMBURAN,WIJAYA KUSUMA,38934,8747,30187,24408,54595,2021-10-23
3172051003,JAKARTA UTARA,PADEMANGAN,ANCOL,23947,6146,17801,14224,32025,2021-10-24
3173041007,JAKARTA BARAT,TAMBORA,ANGKE,29381,6730,22651,17809,40460,2021-10-24
3175041005,JAKARTA TIMUR,KRAMAT JATI,BALE KAMBANG,29074,7799,21275,15906,37181,2021-10-24
3175031003,JAKARTA TIMUR,JATINEGARA,BALI MESTER,9752,2199,7553,6118,13671,2021-10-24
3175101006,JAKARTA TIMUR,CIPAYUNG,BAMBU APUS,26285,5184,21101,16890,37991,2021-10-24
3174031002,JAKARTA SELATAN,MAMPANG PRAPATAN,BANGKA,21566,5001,16565,13127,29692,2021-10-24
3175051002,JAKARTA TIMUR,PASAR REBO,BARU,23886,4236,19650,16421,36071,2021-10-24
3175041004,JAKARTA TIMUR,KRAMAT JATI,BATU AMPAR,47898,12509,35389,27086,62475,2021-10-24
3171071002,JAKARTA PUSAT,TANAH ABANG,BENDUNGAN HILIR,21494,4615,16879,13841,30720,2021-10-24
3175031002,JAKARTA TIMUR,JATINEGARA,BIDARA CINA,36689,9404,27285,20823,48108,2021-10-24
3174101002,JAKARTA SELATAN,PESANGGRAHAN,BINTARO,53098,11449,41649,34311,75960,2021-10-24
3174011005,JAKARTA SELATAN,TEBET,BUKIT DURI,34183,7637,26546,21287,47833,2021-10-24
3171041006,JAKARTA PUSAT,SENEN,BUNGUR,18144,4145,13999,11339,25338,2021-10-24
3175061007,JAKARTA TIMUR,CAKUNG,CAKUNG BARAT,57724,12755,44969,36119,81088,2021-10-24
3175061004,JAKARTA TIMUR,CAKUNG,CAKUNG TIMUR,58287,12340,45947,36843,82790,2021-10-24
3175041007,JAKARTA TIMUR,KRAMAT JATI,CAWANG,32762,7767,24995,19237,44232,2021-10-24
3175101008,JAKARTA TIMUR,CIPAYUNG,CEGER,18932,3964,14968,12010,26978,2021-10-24
3171031006,JAKARTA PUSAT,KEMAYORAN,CEMPAKA BARU,32581,7221,25360,19330,44690,2021-10-24
3171051002,JAKARTA PUSAT,CEMPAKA PUTIH,CEMPAKA PUTIH BARAT,35885,8251,27634,22659,50293,2021-10-24
3171051001,JAKARTA PUSAT,CEMPAKA PUTIH,CEMPAKA PUTIH TIMUR,24292,5332,18960,15869,34829,2021-10-24
3173011001,JAKARTA BARAT,CENGKARENG,CENGKARENG BARAT,66284,14492,51792,42326,94118,2021-10-24
3173011006,JAKARTA BARAT,CENGKARENG,CENGKARENG TIMUR,81027,17243,63784,50597,114381,2021-10-24
3175091002,JAKARTA TIMUR,CIRACAS,CIBUBUR,66364,12168,54196,43657,97853,2021-10-24
3171011002,JAKARTA PUSAT,GAMBIR,CIDENG,15390,3156,12234,10334,22568,2021-10-24
3174091003,JAKARTA SELATAN,JAGAKARSA,CIGANJUR,38497,7154,31343,24480,55823,2021-10-24
3175051003,JAKARTA TIMUR,PASAR REBO,CIJANTUNG,41419,8264,33155,26659,59814,2021-10-24
3171061003,JAKARTA PUSAT,MENTENG,CIKINI,8274,1567,6707,5103,11810,2021-10-24
3174081006,JAKARTA SELATAN,PANCORAN,CIKOKO,10547,1938,8609,7181,15790,2021-10-24
3174061001,JAKARTA SELATAN,CILANDAK,CILANDAK BARAT,51752,9890,41862,34730,76592,2021-10-24
3174041003,JAKARTA SELATAN,PASAR MINGGU,CILANDAK TIMUR,25145,5014,20131,16513,36644,2021-10-24
3175101002,JAKARTA TIMUR,CIPAYUNG,CILANGKAP,27635,5224,22411,17889,40300,2021-10-24
3175041006,JAKARTA TIMUR,KRAMAT JATI,CILILITAN,40181,9652,30529,23797,54326,2021-10-24
3172041001,JAKARTA UTARA,CILINCING,CILINCING,43609,11197,32412,24332,56744,2021-10-24
3175101001,JAKARTA TIMUR,CIPAYUNG,CIPAYUNG,26104,4863,21241,17637,38878,2021-10-24
3174091006,JAKARTA SELATAN,JAGAKARSA,CIPEDAK,38303,6991,31312,25142,56454,2021-10-24
3174061005,JAKARTA SELATAN,CILANDAK,CIPETE SELATAN,26704,5509,21195,17746,38941,2021-10-24
3174071010,JAKARTA SELATAN,KEBAYORAN BARU,CIPETE UTARA,34102,6939,27163,21399,48562,2021-10-24
3175021003,JAKARTA TIMUR,PULO GADUNG,CIPINANG,39306,7982,31324,24966,56290,2021-10-24
3175031007,JAKARTA TIMUR,JATINEGARA,CIPINANG BESAR SELATAN,35212,8935,26277,19671,45948,2021-10-24
3175031008,JAKARTA TIMUR,JATINEGARA,CIPINANG BESAR UTARA,45319,11518,33801,25111,58912,2021-10-24
3175031005,JAKARTA TIMUR,JATINEGARA,CIPINANG CEMPEDAK,32824,7617,25207,20192,45399,2021-10-24
3175081005,JAKARTA TIMUR,MAKASAR,CIPINANG MELAYU,42308,8754,33554,27138,60692,2021-10-24
3175031006,JAKARTA TIMUR,JATINEGARA,CIPINANG MUARA,55243,12750,42493,33154,75647,2021-10-24
3174051003,JAKARTA SELATAN,KEBAYORAN LAMA,CIPULIR,39937,9029,30908,24025,54933,2021-10-24
3175091001,JAKARTA TIMUR,CIRACAS,CIRACAS,64594,12676,51918,41048,92966,2021-10-24
3175041003,JAKARTA TIMUR,KRAMAT JATI,DUKUH,24609,5018,19591,15463,35054,2021-10-24
3175071001,JAKARTA TIMUR,DUREN SAWIT,DUREN SAWIT,61160,13932,47228,37160,84388,2021-10-24
3174081004,JAKARTA SELATAN,PANCORAN,DUREN TIGA,28319,6052,22267,17725,39992,2021-10-24
3173051005,JAKARTA BARAT,KEBON JERUK,DURI KEPA,60138,12603,47535,40017,87552,2021-10-24
3173011002,JAKARTA BARAT,CENGKARENG,DURI KOSAMBI,77923,18218,59705,46020,105725,2021-10-24
3171011006,JAKARTA PUSAT,GAMBIR,DURI PULO,19610,4443,15167,11806,26973,2021-10-24
3173041011,JAKARTA BARAT,TAMBORA,DURI SELATAN,14259,2705,11554,9470,21024,2021-10-24
3173041003,JAKARTA BARAT,TAMBORA,DURI UTARA,19844,3887,15957,12697,28654,2021-10-24
3171081003,JAKARTA PUSAT,JOHAR BARU,GALUR,18243,3823,14420,11347,25767,2021-10-24
3171011001,JAKARTA PUSAT,GAMBIR,GAMBIR,2191,481,1710,1434,3144,2021-10-24
3174061004,JAKARTA SELATAN,CILANDAK,GANDARIA SELATAN,22119,4594,17525,14183,31708,2021-10-24
3174071009,JAKARTA SELATAN,KEBAYORAN BARU,GANDARIA UTARA,39922,8566,31356,25238,56594,2021-10-24
3175051001,JAKARTA TIMUR,PASAR REBO,GEDONG,35755,7638,28117,22832,50949,2021-10-24
3171071001,JAKARTA PUSAT,TANAH ABANG,GELORA,3127,654,2473,2066,4539,2021-10-24
3173031007,JAKARTA BARAT,TAMAN SARI,GLODOK,7837,1292,6545,5729,12274,2021-10-24
3171061004,JAKARTA PUSAT,MENTENG,GONDANGDIA,4100,959,3141,2807,5948,2021-10-24
3173021001,JAKARTA BARAT,GROGOL PETAMBURAN,GROGOL,16876,3600,13276,10818,24094,2021-10-24
3174051005,JAKARTA SELATAN,KEBAYORAN LAMA,GROGOL SELATAN,44251,9694,34557,27378,61935,2021-10-24
3174051004,JAKARTA SELATAN,KEBAYORAN LAMA,GROGOL UTARA,42494,9350,33144,26548,59692,2021-10-24
3174021007,JAKARTA SELATAN,SETIA BUDI,GUNTUR,3985,792,3193,2730,5923,2021-10-24
3174071002,JAKARTA SELATAN,KEBAYORAN BARU,GUNUNG,9436,1853,7583,6412,13995,2021-10-24
3171031005,JAKARTA PUSAT,KEMAYORAN,GUNUNG SAHARI SELATAN,19199,4168,15031,12197,27228,2021-10-24
3171021004,JAKARTA PUSAT,SAWAH BESAR,GUNUNG SAHARI UTARA,16650,3141,13509,11674,25183,2021-10-24
3175081004,JAKARTA TIMUR,MAKASAR,HALIM PERDANA KUSUMAH,28363,3984,24379,21823,46202,2021-10-24
3171031003,JAKARTA PUSAT,KEMAYORAN,HARAPAN MULIA,22557,4921,17636,13769,31405,2021-10-24
3174091001,JAKARTA SELATAN,JAGAKARSA,JAGAKARSA,62389,11311,51078,40544,91622,2021-10-24
3175021007,JAKARTA TIMUR,PULO GADUNG,JATI,32757,6566,26191,21774,47965,2021-10-24
3174041002,JAKARTA SELATAN,PASAR MINGGU,JATI PADANG,37502,8063,29439,23902,53341,2021-10-24
3173071004,JAKARTA BARAT,PALMERAH,JATI PULO,28738,6155,22583,17516,40099,2021-10-24
3175061001,JAKARTA TIMUR,CAKUNG,JATINEGARA,84160,19377,64783,51626,116409,2021-10-24
3175021004,JAKARTA TIMUR,PULO GADUNG,JATINEGARA KAUM,24632,4735,19897,15442,35339,2021-10-24
3173021004,JAKARTA BARAT,GROGOL PETAMBURAN,JELAMBAR,30266,5921,24345,20300,44645,2021-10-24
3173021006,JAKARTA BARAT,GROGOL PETAMBURAN,JELAMBAR BARU,38246,7690,30556,25559,56115,2021-10-24
3173041006,JAKARTA BARAT,TAMBORA,JEMBATAN BESI,29314,7665,21649,16299,37948,2021-10-24
3173041008,JAKARTA BARAT,TAMBORA,JEMBATAN LIMA,21021,5310,15711,11994,27705,2021-10-24
3173081005,JAKARTA BARAT,KEMBANGAN,JOGLO,40839,8926,31913,26219,58132,2021-10-24
3171081001,JAKARTA PUSAT,JOHAR BARU,JOHAR BARU,37488,7325,30163,24748,54911,2021-10-24
3173041002,JAKARTA BARAT,TAMBORA,KALI ANYAR,23856,5105,18751,14303,33054,2021-10-24
3172041004,JAKARTA UTARA,CILINCING,KALIBARU,67684,19812,47872,33248,81120,2021-10-24
3174081002,JAKARTA SELATAN,PANCORAN,KALIBATA,41994,10312,31682,24379,56061,2021-10-24
3173061001,JAKARTA BARAT,KALI DERES,KALIDERES,72447,16271,56176,46158,102334,2021-10-24
3175051004,JAKARTA TIMUR,PASAR REBO,KALISARI,43212,8373,34839,28145,62984,2021-10-24
3173061004,JAKARTA BARAT,KALI DERES,KAMAL,53783,13749,40034,30936,70970,2021-10-24
3172011002,JAKARTA UTARA,PENJARINGAN,KAMAL MUARA,12930,2367,10563,8868,19431,2021-10-24
3171071007,JAKARTA PUSAT,TANAH ABANG,KAMPUNG BALI,11358,2624,8734,6396,15130,2021-10-24
3175031001,JAKARTA TIMUR,JATINEGARA,KAMPUNG MELAYU,25717,6501,19216,14567,33783,2021-10-24
3171081002,JAKARTA PUSAT,JOHAR BARU,KAMPUNG RAWA,21237,3708,17529,13617,31146,2021-10-24
3175041002,JAKARTA TIMUR,KRAMAT JATI,KAMPUNG TENGAH,43993,11719,32274,24647,56921,2021-10-24
3173011005,JAKARTA BARAT,CENGKARENG,KAPUK,134466,34666,99800,77688,177488,2021-10-24
3172011003,JAKARTA UTARA,PENJARINGAN,KAPUK MUARA,35781,7308,28473,24380,52853,2021-10-24
3171021002,JAKARTA PUSAT,SAWAH BESAR,KARANG ANYAR,25761,5301,20460,16654,37114,2021-10-24
3174021004,JAKARTA SELATAN,SETIA BUDI,KARET,9623,1976,7647,6154,13801,2021-10-24
3174021003,JAKARTA SELATAN,SETIA BUDI,KARET KUNINGAN,16055,3355,12700,10424,23124,2021-10-24
3174021002,JAKARTA SELATAN,SETIA BUDI,KARET SEMANGGI,2770,581,2189,1895,4084,2021-10-24
3171071003,JAKARTA PUSAT,TANAH ABANG,KARET TENGSIN,19271,3983,15288,11999,27287,2021-10-24
3171021003,JAKARTA PUSAT,SAWAH BESAR,KARTINI,22292,4614,17678,14629,32307,2021-10-24
3175011003,JAKARTA TIMUR,MATRAMAN,KAYU MANIS,25284,5748,19536,14818,34354,2021-10-24
3175021006,JAKARTA TIMUR,PULO GADUNG,KAYU PUTIH,40696,8141,32555,27593,60148,2021-10-24
3173031006,JAKARTA BARAT,TAMAN SARI,KEAGUNGAN,17387,3492,13895,10947,24842,2021-10-24
3174041007,JAKARTA SELATAN,PASAR MINGGU,KEBAGUSAN,44552,9548,35004,27730,62734,2021-10-24
3174051006,JAKARTA SELATAN,KEBAYORAN LAMA,KEBAYORAN LAMA SELATAN,41212,8301,32911,26556,59467,2021-10-24
3174051001,JAKARTA SELATAN,KEBAYORAN LAMA,KEBAYORAN LAMA UTARA,42422,9590,32832,26000,58832,2021-10-24
3174011004,JAKARTA SELATAN,TEBET,KEBON BARU,35165,7148,28017,22452,50469,2021-10-24
3172021005,JAKARTA UTARA,TANJUNG PRIOK,KEBON BAWANG,50952,11067,39885,32035,71920,2021-10-24
3173051001,JAKARTA BARAT,KEBON JERUK,KEBON JERUK,53887,12460,41427,32830,74257,2021-10-24
3171071006,JAKARTA PUSAT,TANAH ABANG,KEBON KACANG,21531,5535,15996,12187,28183,2021-10-24
3171011005,JAKARTA PUSAT,GAMBIR,KEBON KELAPA,10163,2171,7992,6476,14468,2021-10-24
3171031002,JAKARTA PUSAT,KEMAYORAN,KEBON KOSONG,30019,6454,23565,18241,41806,2021-10-24
3175011005,JAKARTA TIMUR,MATRAMAN,KEBON MANGGIS,16490,3453,13037,10428,23465,2021-10-24
3171071005,JAKARTA PUSAT,TANAH ABANG,KEBON MELATI,32206,9044,23162,16484,39646,2021-10-24
3175081003,JAKARTA TIMUR,MAKASAR,KEBON PALA,46614,10041,36573,29294,65867,2021-10-24
3171061005,JAKARTA PUSAT,MENTENG,KEBON SIRIH,12299,2817,9482,7343,16825,2021-10-24
3173011004,JAKARTA BARAT,CENGKARENG,KEDAUNG KALI ANGKE,32612,6788,25824,20945,46769,2021-10-24
3173051007,JAKARTA BARAT,KEBON JERUK,KEDOYA SELATAN,32165,6305,25860,20681,46541,2021-10-24
3173051006,JAKARTA BARAT,KEBON JERUK,KEDOYA UTARA,45740,9194,36546,30152,66698,2021-10-24
3173051004,JAKARTA BARAT,KEBON JERUK,KELAPA DUA,23565,5163,18402,14793,33195,2021-10-24
3175091003,JAKARTA TIMUR,CIRACAS,KELAPA DUA WETAN,46875,8665,38210,30951,69161,2021-10-24
3172061003,JAKARTA UTARA,KELAPA GADING,KELAPA GADING BARAT,35717,6510,29207,25762,54969,2021-10-24
3172061001,JAKARTA UTARA,KELAPA GADING,KELAPA GADING TIMUR,33592,5421,28171,25467,53638,2021-10-24
3173071005,JAKARTA BARAT,PALMERAH,KEMANGGISAN,32139,6620,25519,20498,46017,2021-10-24
3171031001,JAKARTA PUSAT,KEMAYORAN,KEMAYORAN,20708,4581,16127,12921,29048,2021-10-24
3173081006,JAKARTA BARAT,KEMBANGAN,KEMBANGAN SELATAN,27130,6129,21001,17750,38751,2021-10-24
3173081001,JAKARTA BARAT,KEMBANGAN,KEMBANGAN UTARA,54451,12851,41600,33737,75337,2021-10-24
3171041002,JAKARTA PUSAT,SENEN,KENARI,9579,2009,7570,6281,13851,2021-10-24
3173041005,JAKARTA BARAT,TAMBORA,KERENDANG,19973,4520,15453,12121,27574,2021-10-24
3175071003,JAKARTA TIMUR,DUREN SAWIT,KLENDER,69978,17430,52548,40218,92766,2021-10-24
3172031001,JAKARTA UTARA,KOJA,KOJA,28175,6848,21327,16697,38024,2021-10-24
3173071006,JAKARTA BARAT,PALMERAH,KOTA BAMBU SELATAN,21158,4730,16428,12549,28977,2021-10-24
3173071003,JAKARTA BARAT,PALMERAH,KOTA BAMBU UTARA,24995,5867,19128,14535,33663,2021-10-24
3171041004,JAKARTA PUSAT,SENEN,KRAMAT,28835,7418,21417,15889,37306,2021-10-24
3175041001,JAKARTA TIMUR,KRAMAT JATI,KRAMAT JATI,34144,7945,26199,20422,46621,2021-10-24
3174071003,JAKARTA SELATAN,KEBAYORAN BARU,KRAMAT PELA,14413,2974,11439,9370,20809,2021-10-24
3173031002,JAKARTA BARAT,TAMAN SARI,KRUKUT,19244,3920,15324,11936,27260,2021-10-24
3174031005,JAKARTA SELATAN,MAMPANG PRAPATAN,KUNINGAN BARAT,12785,2542,10243,8276,18519,2021-10-24
3174021008,JAKARTA SELATAN,SETIA BUDI,KUNINGAN TIMUR,6008,1319,4689,3872,8561,2021-10-24
3171041005,JAKARTA PUSAT,SENEN,KWITANG,15486,3778,11708,9250,20958,2021-10-24
3172031003,JAKARTA UTARA,KOJA,LAGOA,59065,14955,44110,33884,77994,2021-10-24
3174061002,JAKARTA SELATAN,CILANDAK,LEBAK BULUS,37626,7653,29973,24868,54841,2021-10-24
3174091004,JAKARTA SELATAN,JAGAKARSA,LENTENG AGUNG,53946,10557,43389,33320,76709,2021-10-24
3175101007,JAKARTA TIMUR,CIPAYUNG,LUBANG BUAYA,63547,12827,50720,40688,91408,2021-10-24
3175081001,JAKARTA TIMUR,MAKASAR,MAKASAR,34390,6796,27594,22475,50069,2021-10-24
3175071006,JAKARTA TIMUR,DUREN SAWIT,MALAKA JAYA,30927,5830,25097,20518,45615,2021-10-24
3175071005,JAKARTA TIMUR,DUREN SAWIT,MALAKA SARI,27530,4969,22561,18715,41276,2021-10-24
3174031001,JAKARTA SELATAN,MAMPANG PRAPATAN,MAMPANG PRAPATAN,18159,4027,14132,11129,25261,2021-10-24
3173031005,JAKARTA BARAT,TAMAN SARI,MANGGA BESAR,7707,1375,6332,5357,11689,2021-10-24
3171021005,JAKARTA PUSAT,SAWAH BESAR,MANGGA DUA SELATAN,27442,6061,21381,17493,38874,2021-10-24
3174011007,JAKARTA SELATAN,TEBET,MANGGARAI,28373,5468,22905,17843,40748,2021-10-24
3174011006,JAKARTA SELATAN,TEBET,MANGGARAI SELATAN,23075,4456,18619,15150,33769,2021-10-24
3173031003,JAKARTA BARAT,TAMAN SARI,MAPHAR,16461,3280,13181,10627,23808,2021-10-24
3172041003,JAKARTA UTARA,CILINCING,MARUNDA,28943,7027,21916,16060,37976,2021-10-24
3174071001,JAKARTA SELATAN,KEBAYORAN BARU,MELAWAI,2627,545,2082,1895,3977,2021-10-24
3171061001,JAKARTA PUSAT,MENTENG,MENTENG,25624,6149,19475,14833,34308,2021-10-24
3174021005,JAKARTA SELATAN,SETIA BUDI,MENTENG ATAS,27816,5469,22347,17780,40127,2021-10-24
3174011003,JAKARTA SELATAN,TEBET,MENTENG DALAM,36028,7555,28473,22957,51430,2021-10-24
3173081003,JAKARTA BARAT,KEMBANGAN,MERUYA SELATAN,32130,7076,25054,20238,45292,2021-10-24
3173081002,JAKARTA BARAT,KEMBANGAN,MERUYA UTARA,43752,9641,34111,28608,62719,2021-10-24
3175101004,JAKARTA TIMUR,CIPAYUNG,MUNJUL,23871,4607,19264,15536,34800,2021-10-24
3172051002,JAKARTA UTARA,PADEMANGAN,PADEMANGAN BARAT,74240,18684,55556,43346,98902,2021-10-24
3172051001,JAKARTA UTARA,PADEMANGAN,PADEMANGAN TIMUR,37736,7108,30628,25884,56512,2021-10-24
3175011004,JAKARTA TIMUR,MATRAMAN,PAL MERIAM,19769,4432,15337,11873,27210,2021-10-24
3173071001,JAKARTA BARAT,PALMERAH,PALMERAH,63011,14732,48279,38027,86306,2021-10-24
3174081001,JAKARTA SELATAN,PANCORAN,PANCORAN,19421,4427,14994,12075,27069,2021-10-24
3172021003,JAKARTA UTARA,TANJUNG PRIOK,PAPANGGO,39097,8422,30675,24416,55091,2021-10-24
3171021001,JAKARTA PUSAT,SAWAH BESAR,PASAR BARU,12035,2457,9578,8337,17915,2021-10-24
3174021006,JAKARTA SELATAN,SETIA BUDI,PASAR MANGGIS,26752,5739,21013,16793,37806,2021-10-24
3174041001,JAKARTA SELATAN,PASAR MINGGU,PASAR MINGGU,24821,5001,19820,16194,36014,2021-10-24
3171041003,JAKARTA PUSAT,SENEN,PASEBAN,23533,5361,18172,14446,32618,2021-10-24
3173061005,JAKARTA BARAT,KALI DERES,PEGADUNGAN,75587,16467,59120,49675,108795,2021-10-24
3171061002,JAKARTA PUSAT,MENTENG,PEGANGSAAN,23455,5537,17918,13209,31127,2021-10-24
3172061002,JAKARTA UTARA,KELAPA GADING,PEGANGSAAN DUA,49976,8679,41297,36613,77910,2021-10-24
3172011004,JAKARTA UTARA,PENJARINGAN,PEJAGALAN,74578,16557,58021,48090,106111,2021-10-24
3174041006,JAKARTA SELATAN,PASAR MINGGU,PEJATEN BARAT,37346,8065,29281,23604,52885,2021-10-24
3174041005,JAKARTA SELATAN,PASAR MINGGU,PEJATEN TIMUR,57656,14023,43633,34625,78258,2021-10-24
3175051005,JAKARTA TIMUR,PASAR REBO,PEKAYON,43250,8545,34705,27786,62491,2021-10-24
3173041009,JAKARTA BARAT,TAMBORA,PEKOJAN,23587,4789,18798,15262,34060,2021-10-24
3174031003,JAKARTA SELATAN,MAMPANG PRAPATAN,PELA MAMPANG,43522,9389,34133,27365,61498,2021-10-24
3174081005,JAKARTA SELATAN,PANCORAN,PENGADEGAN,21478,4212,17266,14043,31309,2021-10-24
3175061003,JAKARTA TIMUR,CAKUNG,PENGGILINGAN,99255,24960,74295,57372,131667,2021-10-24
3172011001,JAKARTA UTARA,PENJARINGAN,PENJARINGAN,88308,24280,64028,47692,111720,2021-10-24
3174101001,JAKARTA SELATAN,PESANGGRAHAN,PESANGGRAHAN,27545,5091,22454,18617,41071,2021-10-24
3171071004,JAKARTA PUSAT,TANAH ABANG,PETAMBURAN,33271,9323,23948,17470,41418,2021-10-24
3174071008,JAKARTA SELATAN,KEBAYORAN BARU,PETOGOGAN,11499,2430,9069,7412,16481,2021-10-24
3171011004,JAKARTA PUSAT,GAMBIR,PETOJO SELATAN,14692,3504,11188,9233,20421,2021-10-24
3171011003,JAKARTA PUSAT,GAMBIR,PETOJO UTARA,17458,3975,13483,10705,24188,2021-10-24
3174101004,JAKARTA SELATAN,PESANGGRAHAN,PETUKANGAN SELATAN,37187,8188,28999,23511,52510,2021-10-24
3174101003,JAKARTA SELATAN,PESANGGRAHAN,PETUKANGAN UTARA,53716,12540,41176,33056,74232,2021-10-24
3175081002,JAKARTA TIMUR,MAKASAR,PINANG RANTI,27198,6371,20827,16740,37567,2021-10-24
3173031008,JAKARTA BARAT,TAMAN SARI,PINANGSIA,10729,2015,8714,6999,15713,2021-10-24
3175011001,JAKARTA TIMUR,MATRAMAN,PISANGAN BARU,31776,7083,24693,18831,43524,2021-10-24
3175021002,JAKARTA TIMUR,PULO GADUNG,PISANGAN TIMUR,41011,8331,32680,26569,59249,2021-10-24
3172011005,JAKARTA UTARA,PENJARINGAN,PLUIT,47783,9703,38080,32328,70408,2021-10-24
3175071002,JAKARTA TIMUR,DUREN SAWIT,PONDOK BAMBU,61550,13946,47604,37573,85177,2021-10-24
3175071004,JAKARTA TIMUR,DUREN SAWIT,PONDOK KELAPA,72015,15292,56723,47052,103775,2021-10-24
3175071007,JAKARTA TIMUR,DUREN SAWIT,PONDOK KOPI,35367,7200,28167,21270,49437,2021-10-24
3174061003,JAKARTA SELATAN,CILANDAK,PONDOK LABU,46464,8630,37834,31842,69676,2021-10-24
3174051002,JAKARTA SELATAN,KEBAYORAN LAMA,PONDOK PINANG,56169,11445,44724,36216,80940,2021-10-24
3175101003,JAKARTA TIMUR,CIPAYUNG,PONDOK RANGGON,25574,5150,20424,16078,36502,2021-10-24
3101011003,KAB.ADM.KEP.SERIBU,KEP. SERIBU UTARA,PULAU HARAPAN,2060,229,1831,1571,3402,2021-10-24
3101011002,KAB.ADM.KEP.SERIBU,KEP. SERIBU UTARA,PULAU KELAPA,5528,636,4892,3979,8871,2021-10-24
3101011001,KAB.ADM.KEP.SERIBU,KEP. SERIBU UTARA,PULAU PANGGANG,5450,478,4972,4379,9351,2021-10-24
3101021003,KAB.ADM.KEP.SERIBU,KEP. SERIBU SELATAN,PULAU PARI,2765,202,2563,2378,4941,2021-10-24
3101021002,KAB.ADM.KEP.SERIBU,KEP. SERIBU SELATAN,PULAU TIDUNG,4553,393,4160,3746,7906,2021-10-24
3101021001,KAB.ADM.KEP.SERIBU,KEP. SERIBU SELATAN,PULAU UNTUNG JAWA,1941,168,1773,1617,3390,2021-10-24
3174071007,JAKARTA SELATAN,KEBAYORAN BARU,PULO,5835,1069,4766,4205,8971,2021-10-24
3175021001,JAKARTA TIMUR,PULO GADUNG,PULO GADUNG,34422,7989,26433,21284,47717,2021-10-24
3175061005,JAKARTA TIMUR,CAKUNG,PULO GEBANG,97301,20110,77191,60604,137795,2021-10-24
3174041004,JAKARTA SELATAN,PASAR MINGGU,RAGUNAN,39616,7977,31639,26038,57677,2021-10-24
3175091005,JAKARTA TIMUR,CIRACAS,RAMBUTAN,36771,9194,27577,21002,48579,2021-10-24
3172031006,JAKARTA UTARA,KOJA,RAWA BADAK SELATAN,42179,10661,31518,24102,55620,2021-10-24
3172031004,JAKARTA UTARA,KOJA,RAWA BADAK UTARA,34408,8230,26178,20315,46493,2021-10-24
3174071005,JAKARTA SELATAN,KEBAYORAN BARU,RAWA BARAT,5625,1050,4575,3921,8496,2021-10-24
3173011003,JAKARTA BARAT,CENGKARENG,RAWA BUAYA,63799,13883,49916,38627,88543,2021-10-24
3175031004,JAKARTA TIMUR,JATINEGARA,RAWA BUNGA,21434,5527,15907,12348,28255,2021-10-24
3174081003,JAKARTA SELATAN,PANCORAN,RAWA JATI,20509,4147,16362,13258,29620,2021-10-24
3175061002,JAKARTA TIMUR,CAKUNG,RAWA TERATE,24637,4847,19790,15681,35471,2021-10-24
3175021005,JAKARTA TIMUR,PULO GADUNG,RAWAMANGUN,37612,8034,29578,24193,53771,2021-10-24
3171051003,JAKARTA PUSAT,CEMPAKA PUTIH,RAWASARI,21967,4809,17158,14062,31220,2021-10-24
3173041010,JAKARTA BARAT,TAMBORA,ROA MALAKA,3484,640,2844,2464,5308,2021-10-24
3172041006,JAKARTA UTARA,CILINCING,ROROTAN,41668,8947,32721,25472,58193,2021-10-24
3174071004,JAKARTA SELATAN,KEBAYORAN BARU,SELONG,2842,564,2278,2057,4335,2021-10-24
3173061002,JAKARTA BARAT,KALI DERES,SEMANAN,71354,17053,54301,42846,97147,2021-10-24
3172041007,JAKARTA UTARA,CILINCING,SEMPER BARAT,68587,14368,54219,43728,97947,2021-10-24
3172041005,JAKARTA UTARA,CILINCING,SEMPER TIMUR,36267,8307,27960,21987,49947,2021-10-24
3174071006,JAKARTA SELATAN,KEBAYORAN BARU,SENAYAN,2771,680,2091,1742,3833,2021-10-24
3171041001,JAKARTA PUSAT,SENEN,SENEN,6804,1567,5237,4268,9505,2021-10-24
3171031004,JAKARTA PUSAT,KEMAYORAN,SERDANG,29668,6361,23307,18737,42044,2021-10-24
3174021001,JAKARTA SELATAN,SETIA BUDI,SETIA BUDI,3023,652,2371,1927,4298,2021-10-24
3175101005,JAKARTA TIMUR,CIPAYUNG,SETU,20572,4425,16147,12539,28686,2021-10-24
3173071002,JAKARTA BARAT,PALMERAH,SLIPI,16591,3235,13356,10832,24188,2021-10-24
3173081004,JAKARTA BARAT,KEMBANGAN,SRENGSENG,45523,10923,34600,28370,62970,2021-10-24
3174091002,JAKARTA SELATAN,JAGAKARSA,SRENGSENG SAWAH,58196,9862,48334,39502,87836,2021-10-24
3173051003,JAKARTA BARAT,KEBON JERUK,SUKABUMI SELATAN,37033,8990,28043,21008,49051,2021-10-24
3173051002,JAKARTA BARAT,KEBON JERUK,SUKABUMI UTARA,38290,9655,28635,21669,50304,2021-10-24
3172041002,JAKARTA UTARA,CILINCING,SUKAPURA,53949,12968,40981,32722,73703,2021-10-24
3171031007,JAKARTA PUSAT,KEMAYORAN,SUMUR BATU,22717,4920,17797,14650,32447,2021-10-24
3172021004,JAKARTA UTARA,TANJUNG PRIOK,SUNGAI BAMBU,29876,6452,23424,18770,42194,2021-10-24
3172021006,JAKARTA UTARA,TANJUNG PRIOK,SUNTER AGUNG,71805,13288,58517,49691,108208,2021-10-24
3172021002,JAKARTA UTARA,TANJUNG PRIOK,SUNTER JAYA,63031,11846,51185,42767,93952,2021-10-24
3175091004,JAKARTA TIMUR,CIRACAS,SUSUKAN,38257,7694,30563,24545,55108,2021-10-24
3173031001,JAKARTA BARAT,TAMAN SARI,TAMAN SARI,14348,2792,11556,9671,21227,2021-10-24
3173041001,JAKARTA BARAT,TAMBORA,TAMBORA,10204,2410,7794,6089,13883,2021-10-24
3173041004,JAKARTA BARAT,TAMBORA,TANAH SEREAL,26387,4770,21617,17603,39220,2021-10-24
3171081004,JAKARTA PUSAT,JOHAR BARU,TANAH TINGGI,37693,7576,30117,23790,53907,2021-10-24
3173031004,JAKARTA BARAT,TAMAN SARI,TANGKI,13324,2364,10960,8869,19829,2021-10-24
3174091005,JAKARTA SELATAN,JAGAKARSA,TANJUNG BARAT,39770,7235,32535,25457,57992,2021-10-24
3173021005,JAKARTA BARAT,GROGOL PETAMBURAN,TANJUNG DUREN SELATAN,25337,5200,20137,17172,37309,2021-10-24
3173021002,JAKARTA BARAT,GROGOL PETAMBURAN,TANJUNG DUREN UTARA,17010,3056,13954,12022,25976,2021-10-24
3172021001,JAKARTA UTARA,TANJUNG PRIOK,TANJUNG PRIOK,34588,7627,26961,21392,48353,2021-10-24
3174011002,JAKARTA SELATAN,TEBET,TEBET BARAT,21194,3743,17451,14868,32319,2021-10-24
3174011001,JAKARTA SELATAN,TEBET,TEBET TIMUR,18199,3134,15065,13128,28193,2021-10-24
3173061003,JAKARTA BARAT,KALI DERES,TEGAL ALUR,83647,19122,64525,51794,116319,2021-10-24
3174031004,JAKARTA SELATAN,MAMPANG PRAPATAN,TEGAL PARANG,32401,7711,24690,18237,42927,2021-10-24
3173021003,JAKARTA BARAT,GROGOL PETAMBURAN,TOMANG,29605,5839,23766,19680,43446,2021-10-24
3172031005,JAKARTA UTARA,KOJA,TUGU SELATAN,39122,9326,29796,23370,53166,2021-10-24
3172031002,JAKARTA UTARA,KOJA,TUGU UTARA,67670,17073,50597,38778,89375,2021-10-24
3175061006,JAKARTA TIMUR,CAKUNG,UJUNG MENTENG,29934,5577,24357,20034,44391,2021-10-24
3174101005,JAKARTA SELATAN,PESANGGRAHAN,ULUJAMI,40544,9871,30673,24244,54917,2021-10-24
3175011006,JAKARTA TIMUR,MATRAMAN,UTAN KAYU SELATAN,33511,6536,26975,21427,48402,2021-10-24
3175011002,JAKARTA TIMUR,MATRAMAN,UTAN KAYU UTARA,28169,6337,21832,17258,39090,2021-10-24
3171031008,JAKARTA PUSAT,KEMAYORAN,UTAN PANJANG,29208,6359,22849,17578,40427,2021-10-24
3172021007,JAKARTA UTARA,TANJUNG PRIOK,WARAKAS,44401,8696,35705,27700,63405,2021-10-24
3173021007,JAKARTA BARAT,GROGOL PETAMBURAN,WIJAYA KUSUMA,38934,8740,30194,24421,54615,2021-10-24
3172051003,JAKARTA UTARA,PADEMANGAN,ANCOL,23947,6117,17830,14266,32096,2021-10-25
3173041007,JAKARTA BARAT,TAMBORA,ANGKE,29381,6703,22678,17871,40549,2021-10-25
3175041005,JAKARTA TIMUR,KRAMAT JATI,BALE KAMBANG,29074,7768,21306,15963,37269,2021-10-25
3175031003,JAKARTA TIMUR,JATINEGARA,BALI MESTER,9752,2183,7569,6142,13711,2021-10-25
3175101006,JAKARTA TIMUR,CIPAYUNG,BAMBU APUS,26285,5153,21132,16970,38102,2021-10-25
3174031002,JAKARTA SELATAN,MAMPANG PRAPATAN,BANGKA,21566,4975,16591,13173,29764,2021-10-25
3175051002,JAKARTA TIMUR,PASAR REBO,BARU,23886,4195,19691,16470,36161,2021-10-25
3175041004,JAKARTA TIMUR,KRAMAT JATI,BATU AMPAR,47898,12448,35450,27194,62644,2021-10-25
3171071002,JAKARTA PUSAT,TANAH ABANG,BENDUNGAN HILIR,21494,4585,16909,13887,30796,2021-10-25
3175031002,JAKARTA TIMUR,JATINEGARA,BIDARA CINA,36689,9349,27340,20918,48258,2021-10-25
3174101002,JAKARTA SELATAN,PESANGGRAHAN,BINTARO,53098,11368,41730,34461,76191,2021-10-25
3174011005,JAKARTA SELATAN,TEBET,BUKIT DURI,34183,7607,26576,21377,47953,2021-10-25
3171041006,JAKARTA PUSAT,SENEN,BUNGUR,18144,4121,14023,11375,25398,2021-10-25
3175061007,JAKARTA TIMUR,CAKUNG,CAKUNG BARAT,57724,12706,45018,36206,81224,2021-10-25
3175061004,JAKARTA TIMUR,CAKUNG,CAKUNG TIMUR,58287,12297,45990,36966,82956,2021-10-25
3175041007,JAKARTA TIMUR,KRAMAT JATI,CAWANG,32762,7737,25025,19298,44323,2021-10-25
3175101008,JAKARTA TIMUR,CIPAYUNG,CEGER,18932,3950,14982,12035,27017,2021-10-25
3171031006,JAKARTA PUSAT,KEMAYORAN,CEMPAKA BARU,32581,7173,25408,19417,44825,2021-10-25
3171051002,JAKARTA PUSAT,CEMPAKA PUTIH,CEMPAKA PUTIH BARAT,35885,8113,27772,22774,50546,2021-10-25
3171051001,JAKARTA PUSAT,CEMPAKA PUTIH,CEMPAKA PUTIH TIMUR,24292,5252,19040,15965,35005,2021-10-25
3173011001,JAKARTA BARAT,CENGKARENG,CENGKARENG BARAT,66284,14407,51877,42461,94338,2021-10-25
3173011006,JAKARTA BARAT,CENGKARENG,CENGKARENG TIMUR,81027,17154,63873,50753,114626,2021-10-25
3175091002,JAKARTA TIMUR,CIRACAS,CIBUBUR,66364,12068,54296,43847,98143,2021-10-25
3171011002,JAKARTA PUSAT,GAMBIR,CIDENG,15390,3147,12243,10360,22603,2021-10-25
3174091003,JAKARTA SELATAN,JAGAKARSA,CIGANJUR,38497,7111,31386,24596,55982,2021-10-25
3175051003,JAKARTA TIMUR,PASAR REBO,CIJANTUNG,41419,8201,33218,26774,59992,2021-10-25
3171061003,JAKARTA PUSAT,MENTENG,CIKINI,8274,1555,6719,5126,11845,2021-10-25
3174081006,JAKARTA SELATAN,PANCORAN,CIKOKO,10547,1929,8618,7197,15815,2021-10-25
3174061001,JAKARTA SELATAN,CILANDAK,CILANDAK BARAT,51752,9804,41948,34901,76849,2021-10-25
3174041003,JAKARTA SELATAN,PASAR MINGGU,CILANDAK TIMUR,25145,4968,20177,16604,36781,2021-10-25
3175101002,JAKARTA TIMUR,CIPAYUNG,CILANGKAP,27635,5200,22435,17957,40392,2021-10-25
3175041006,JAKARTA TIMUR,KRAMAT JATI,CILILITAN,40181,9616,30565,23877,54442,2021-10-25
3172041001,JAKARTA UTARA,CILINCING,CILINCING,43609,11148,32461,24416,56877,2021-10-25
3175101001,JAKARTA TIMUR,CIPAYUNG,CIPAYUNG,26104,4838,21266,17690,38956,2021-10-25
3174091006,JAKARTA SELATAN,JAGAKARSA,CIPEDAK,38303,6934,31369,25222,56591,2021-10-25
3174061005,JAKARTA SELATAN,CILANDAK,CIPETE SELATAN,26704,5472,21232,17910,39142,2021-10-25
3174071010,JAKARTA SELATAN,KEBAYORAN BARU,CIPETE UTARA,34102,6883,27219,21515,48734,2021-10-25
3175021003,JAKARTA TIMUR,PULO GADUNG,CIPINANG,39306,7900,31406,25104,56510,2021-10-25
3175031007,JAKARTA TIMUR,JATINEGARA,CIPINANG BESAR SELATAN,35212,8882,26330,19756,46086,2021-10-25
3175031008,JAKARTA TIMUR,JATINEGARA,CIPINANG BESAR UTARA,45319,11465,33854,25207,59061,2021-10-25
3175031005,JAKARTA TIMUR,JATINEGARA,CIPINANG CEMPEDAK,32824,7578,25246,20287,45533,2021-10-25
3175081005,JAKARTA TIMUR,MAKASAR,CIPINANG MELAYU,42308,8704,33604,27253,60857,2021-10-25
3175031006,JAKARTA TIMUR,JATINEGARA,CIPINANG MUARA,55243,12642,42601,33313,75914,2021-10-25
3174051003,JAKARTA SELATAN,KEBAYORAN LAMA,CIPULIR,39937,8989,30948,24139,55087,2021-10-25
3175091001,JAKARTA TIMUR,CIRACAS,CIRACAS,64594,12630,51964,41148,93112,2021-10-25
3175041003,JAKARTA TIMUR,KRAMAT JATI,DUKUH,24609,4983,19626,15519,35145,2021-10-25
3175071001,JAKARTA TIMUR,DUREN SAWIT,DUREN SAWIT,61160,13858,47302,37306,84608,2021-10-25
3174081004,JAKARTA SELATAN,PANCORAN,DUREN TIGA,28319,6024,22295,17786,40081,2021-10-25
3173051005,JAKARTA BARAT,KEBON JERUK,DURI KEPA,60138,12542,47596,40127,87723,2021-10-25
3173011002,JAKARTA BARAT,CENGKARENG,DURI KOSAMBI,77923,18138,59785,46166,105951,2021-10-25
3171011006,JAKARTA PUSAT,GAMBIR,DURI PULO,19610,4426,15184,11842,27026,2021-10-25
3173041011,JAKARTA BARAT,TAMBORA,DURI SELATAN,14259,2692,11567,9501,21068,2021-10-25
3173041003,JAKARTA BARAT,TAMBORA,DURI UTARA,19844,3859,15985,12742,28727,2021-10-25
3171081003,JAKARTA PUSAT,JOHAR BARU,GALUR,18243,3806,14437,11366,25803,2021-10-25
3171011001,JAKARTA PUSAT,GAMBIR,GAMBIR,2191,480,1711,1439,3150,2021-10-25
3174061004,JAKARTA SELATAN,CILANDAK,GANDARIA SELATAN,22119,4567,17552,14263,31815,2021-10-25
3174071009,JAKARTA SELATAN,KEBAYORAN BARU,GANDARIA UTARA,39922,8518,31404,25343,56747,2021-10-25
3175051001,JAKARTA TIMUR,PASAR REBO,GEDONG,35755,7608,28147,22931,51078,2021-10-25
3171071001,JAKARTA PUSAT,TANAH ABANG,GELORA,3127,645,2482,2075,4557,2021-10-25
3173031007,JAKARTA BARAT,TAMAN SARI,GLODOK,7837,1283,6554,5751,12305,2021-10-25
3171061004,JAKARTA PUSAT,MENTENG,GONDANGDIA,4100,957,3143,2813,5956,2021-10-25
3173021001,JAKARTA BARAT,GROGOL PETAMBURAN,GROGOL,16876,3583,13293,10851,24144,2021-10-25
3174051005,JAKARTA SELATAN,KEBAYORAN LAMA,GROGOL SELATAN,44251,9627,34624,27456,62080,2021-10-25
3174051004,JAKARTA SELATAN,KEBAYORAN LAMA,GROGOL UTARA,42494,9218,33276,26693,59969,2021-10-25
3174021007,JAKARTA SELATAN,SETIA BUDI,GUNTUR,3985,789,3196,2737,5933,2021-10-25
3174071002,JAKARTA SELATAN,KEBAYORAN BARU,GUNUNG,9436,1847,7589,6438,14027,2021-10-25
3171031005,JAKARTA PUSAT,KEMAYORAN,GUNUNG SAHARI SELATAN,19199,4138,15061,12246,27307,2021-10-25
3171021004,JAKARTA PUSAT,SAWAH BESAR,GUNUNG SAHARI UTARA,16650,3119,13531,11700,25231,2021-10-25
3175081004,JAKARTA TIMUR,MAKASAR,HALIM PERDANA KUSUMAH,28363,3960,24403,21866,46269,2021-10-25
3171031003,JAKARTA PUSAT,KEMAYORAN,HARAPAN MULIA,22557,4900,17657,13822,31479,2021-10-25
3174091001,JAKARTA SELATAN,JAGAKARSA,JAGAKARSA,62389,11184,51205,40712,91917,2021-10-25
3175021007,JAKARTA TIMUR,PULO GADUNG,JATI,32757,6521,26236,21842,48078,2021-10-25
3174041002,JAKARTA SELATAN,PASAR MINGGU,JATI PADANG,37502,8000,29502,23980,53482,2021-10-25
3173071004,JAKARTA BARAT,PALMERAH,JATI PULO,28738,6129,22609,17570,40179,2021-10-25
3175061001,JAKARTA TIMUR,CAKUNG,JATINEGARA,84160,19277,64883,51798,116681,2021-10-25
3175021004,JAKARTA TIMUR,PULO GADUNG,JATINEGARA KAUM,24632,4713,19919,15480,35399,2021-10-25
3173021004,JAKARTA BARAT,GROGOL PETAMBURAN,JELAMBAR,30266,5882,24384,20362,44746,2021-10-25
3173021006,JAKARTA BARAT,GROGOL PETAMBURAN,JELAMBAR BARU,38246,7654,30592,25641,56233,2021-10-25
3173041006,JAKARTA BARAT,TAMBORA,JEMBATAN BESI,29314,7623,21691,16364,38055,2021-10-25
3173041008,JAKARTA BARAT,TAMBORA,JEMBATAN LIMA,21021,5280,15741,12047,27788,2021-10-25
3173081005,JAKARTA BARAT,KEMBANGAN,JOGLO,40839,8874,31965,26343,58308,2021-10-25
3171081001,JAKARTA PUSAT,JOHAR BARU,JOHAR BARU,37488,7299,30189,24814,55003,2021-10-25
3173041002,JAKARTA BARAT,TAMBORA,KALI ANYAR,23856,5070,18786,14360,33146,2021-10-25
3172041004,JAKARTA UTARA,CILINCING,KALIBARU,67684,19717,47967,33347,81314,2021-10-25
3174081002,JAKARTA SELATAN,PANCORAN,KALIBATA,41994,10207,31787,24516,56303,2021-10-25
3173061001,JAKARTA BARAT,KALI DERES,KALIDERES,72447,16162,56285,46330,102615,2021-10-25
3175051004,JAKARTA TIMUR,PASAR REBO,KALISARI,43212,8276,34936,28259,63195,2021-10-25
3173061004,JAKARTA BARAT,KALI DERES,KAMAL,53783,13678,40105,31030,71135,2021-10-25
3172011002,JAKARTA UTARA,PENJARINGAN,KAMAL MUARA,12930,2362,10568,8883,19451,2021-10-25
3171071007,JAKARTA PUSAT,TANAH ABANG,KAMPUNG BALI,11358,2610,8748,6428,15176,2021-10-25
3175031001,JAKARTA TIMUR,JATINEGARA,KAMPUNG MELAYU,25717,6269,19448,14623,34071,2021-10-25
3171081002,JAKARTA PUSAT,JOHAR BARU,KAMPUNG RAWA,21237,3682,17555,13651,31206,2021-10-25
3175041002,JAKARTA TIMUR,KRAMAT JATI,KAMPUNG TENGAH,43993,11675,32318,24721,57039,2021-10-25
3173011005,JAKARTA BARAT,CENGKARENG,KAPUK,134466,34537,99929,77939,177868,2021-10-25
3172011003,JAKARTA UTARA,PENJARINGAN,KAPUK MUARA,35781,7245,28536,24441,52977,2021-10-25
3171021002,JAKARTA PUSAT,SAWAH BESAR,KARANG ANYAR,25761,5286,20475,16700,37175,2021-10-25
3174021004,JAKARTA SELATAN,SETIA BUDI,KARET,9623,1956,7667,6183,13850,2021-10-25
3174021003,JAKARTA SELATAN,SETIA BUDI,KARET KUNINGAN,16055,3326,12729,10465,23194,2021-10-25
3174021002,JAKARTA SELATAN,SETIA BUDI,KARET SEMANGGI,2770,581,2189,1900,4089,2021-10-25
3171071003,JAKARTA PUSAT,TANAH ABANG,KARET TENGSIN,19271,3953,15318,12037,27355,2021-10-25
3171021003,JAKARTA PUSAT,SAWAH BESAR,KARTINI,22292,4596,17696,14670,32366,2021-10-25
3175011003,JAKARTA TIMUR,MATRAMAN,KAYU MANIS,25284,5698,19586,14886,34472,2021-10-25
3175021006,JAKARTA TIMUR,PULO GADUNG,KAYU PUTIH,40696,8092,32604,27669,60273,2021-10-25
3173031006,JAKARTA BARAT,TAMAN SARI,KEAGUNGAN,17387,3434,13953,11000,24953,2021-10-25
3174041007,JAKARTA SELATAN,PASAR MINGGU,KEBAGUSAN,44552,9399,35153,27913,63066,2021-10-25
3174051006,JAKARTA SELATAN,KEBAYORAN LAMA,KEBAYORAN LAMA SELATAN,41212,8238,32974,26767,59741,2021-10-25
3174051001,JAKARTA SELATAN,KEBAYORAN LAMA,KEBAYORAN LAMA UTARA,42422,9525,32897,26116,59013,2021-10-25
3174011004,JAKARTA SELATAN,TEBET,KEBON BARU,35165,7112,28053,22531,50584,2021-10-25
3172021005,JAKARTA UTARA,TANJUNG PRIOK,KEBON BAWANG,50952,11011,39941,32154,72095,2021-10-25
3173051001,JAKARTA BARAT,KEBON JERUK,KEBON JERUK,53887,12388,41499,32935,74434,2021-10-25
3171071006,JAKARTA PUSAT,TANAH ABANG,KEBON KACANG,21531,5492,16039,12253,28292,2021-10-25
3171011005,JAKARTA PUSAT,GAMBIR,KEBON KELAPA,10163,2159,8004,6517,14521,2021-10-25
3171031002,JAKARTA PUSAT,KEMAYORAN,KEBON KOSONG,30019,6416,23603,18336,41939,2021-10-25
3175011005,JAKARTA TIMUR,MATRAMAN,KEBON MANGGIS,16490,3438,13052,10464,23516,2021-10-25
3171071005,JAKARTA PUSAT,TANAH ABANG,KEBON MELATI,32206,9006,23200,16550,39750,2021-10-25
3175081003,JAKARTA TIMUR,MAKASAR,KEBON PALA,46614,9914,36700,29476,66176,2021-10-25
3171061005,JAKARTA PUSAT,MENTENG,KEBON SIRIH,12299,2805,9494,7384,16878,2021-10-25
3173011004,JAKARTA BARAT,CENGKARENG,KEDAUNG KALI ANGKE,32612,6731,25881,21076,46957,2021-10-25
3173051007,JAKARTA BARAT,KEBON JERUK,KEDOYA SELATAN,32165,6273,25892,20735,46627,2021-10-25
3173051006,JAKARTA BARAT,KEBON JERUK,KEDOYA UTARA,45740,9124,36616,30251,66867,2021-10-25
3173051004,JAKARTA BARAT,KEBON JERUK,KELAPA DUA,23565,5140,18425,14856,33281,2021-10-25
3175091003,JAKARTA TIMUR,CIRACAS,KELAPA DUA WETAN,46875,8604,38271,31036,69307,2021-10-25
3172061003,JAKARTA UTARA,KELAPA GADING,KELAPA GADING BARAT,35717,6484,29233,25820,55053,2021-10-25
3172061001,JAKARTA UTARA,KELAPA GADING,KELAPA GADING TIMUR,33592,5379,28213,25516,53729,2021-10-25
3173071005,JAKARTA BARAT,PALMERAH,KEMANGGISAN,32139,6435,25704,20645,46349,2021-10-25
3171031001,JAKARTA PUSAT,KEMAYORAN,KEMAYORAN,20708,4556,16152,12963,29115,2021-10-25
3173081006,JAKARTA BARAT,KEMBANGAN,KEMBANGAN SELATAN,27130,6092,21038,17791,38829,2021-10-25
3173081001,JAKARTA BARAT,KEMBANGAN,KEMBANGAN UTARA,54451,12773,41678,33873,75551,2021-10-25
3171041002,JAKARTA PUSAT,SENEN,KENARI,9579,1992,7587,6313,13900,2021-10-25
3173041005,JAKARTA BARAT,TAMBORA,KERENDANG,19973,4486,15487,12195,27682,2021-10-25
3175071003,JAKARTA TIMUR,DUREN SAWIT,KLENDER,69978,17275,52703,40460,93163,2021-10-25
3172031001,JAKARTA UTARA,KOJA,KOJA,28175,6803,21372,16787,38159,2021-10-25
3173071006,JAKARTA BARAT,PALMERAH,KOTA BAMBU SELATAN,21158,4700,16458,12598,29056,2021-10-25
3173071003,JAKARTA BARAT,PALMERAH,KOTA BAMBU UTARA,24995,5843,19152,14589,33741,2021-10-25
3171041004,JAKARTA PUSAT,SENEN,KRAMAT,28835,7381,21454,15938,37392,2021-10-25
3175041001,JAKARTA TIMUR,KRAMAT JATI,KRAMAT JATI,34144,7914,26230,20478,46708,2021-10-25
3174071003,JAKARTA SELATAN,KEBAYORAN BARU,KRAMAT PELA,14413,2957,11456,9404,20860,2021-10-25
3173031002,JAKARTA BARAT,TAMAN SARI,KRUKUT,19244,3868,15376,11998,27374,2021-10-25
3174031005,JAKARTA SELATAN,MAMPANG PRAPATAN,KUNINGAN BARAT,12785,2521,10264,8302,18566,2021-10-25
3174021008,JAKARTA SELATAN,SETIA BUDI,KUNINGAN TIMUR,6008,1315,4693,3889,8582,2021-10-25
3171041005,JAKARTA PUSAT,SENEN,KWITANG,15486,3762,11724,9285,21009,2021-10-25
3172031003,JAKARTA UTARA,KOJA,LAGOA,59065,14892,44173,33994,78167,2021-10-25
3174061002,JAKARTA SELATAN,CILANDAK,LEBAK BULUS,37626,7620,30006,24977,54983,2021-10-25
3174091004,JAKARTA SELATAN,JAGAKARSA,LENTENG AGUNG,53946,10450,43496,33517,77013,2021-10-25
3175101007,JAKARTA TIMUR,CIPAYUNG,LUBANG BUAYA,63547,12758,50789,40794,91583,2021-10-25
3175081001,JAKARTA TIMUR,MAKASAR,MAKASAR,34390,6751,27639,22577,50216,2021-10-25
3175071006,JAKARTA TIMUR,DUREN SAWIT,MALAKA JAYA,30927,5792,25135,20596,45731,2021-10-25
3175071005,JAKARTA TIMUR,DUREN SAWIT,MALAKA SARI,27530,4936,22594,18790,41384,2021-10-25
3174031001,JAKARTA SELATAN,MAMPANG PRAPATAN,MAMPANG PRAPATAN,18159,3994,14165,11188,25353,2021-10-25
3173031005,JAKARTA BARAT,TAMAN SARI,MANGGA BESAR,7707,1365,6342,5370,11712,2021-10-25
3171021005,JAKARTA PUSAT,SAWAH BESAR,MANGGA DUA SELATAN,27442,6024,21418,17558,38976,2021-10-25
3174011007,JAKARTA SELATAN,TEBET,MANGGARAI,28373,5421,22952,17913,40865,2021-10-25
3174011006,JAKARTA SELATAN,TEBET,MANGGARAI SELATAN,23075,4429,18646,15206,33852,2021-10-25
3173031003,JAKARTA BARAT,TAMAN SARI,MAPHAR,16461,3241,13220,10668,23888,2021-10-25
3172041003,JAKARTA UTARA,CILINCING,MARUNDA,28943,6992,21951,16111,38062,2021-10-25
3174071001,JAKARTA SELATAN,KEBAYORAN BARU,MELAWAI,2627,541,2086,1901,3987,2021-10-25
3171061001,JAKARTA PUSAT,MENTENG,MENTENG,25624,6108,19516,14896,34412,2021-10-25
3174021005,JAKARTA SELATAN,SETIA BUDI,MENTENG ATAS,27816,5444,22372,17853,40225,2021-10-25
3174011003,JAKARTA SELATAN,TEBET,MENTENG DALAM,36028,7519,28509,23032,51541,2021-10-25
3173081003,JAKARTA BARAT,KEMBANGAN,MERUYA SELATAN,32130,7037,25093,20318,45411,2021-10-25
3173081002,JAKARTA BARAT,KEMBANGAN,MERUYA UTARA,43752,9517,34235,28822,63057,2021-10-25
3175101004,JAKARTA TIMUR,CIPAYUNG,MUNJUL,23871,4555,19316,15619,34935,2021-10-25
3172051002,JAKARTA UTARA,PADEMANGAN,PADEMANGAN BARAT,74240,18586,55654,43545,99199,2021-10-25
3172051001,JAKARTA UTARA,PADEMANGAN,PADEMANGAN TIMUR,37736,7071,30665,25955,56620,2021-10-25
3175011004,JAKARTA TIMUR,MATRAMAN,PAL MERIAM,19769,4391,15378,11929,27307,2021-10-25
3173071001,JAKARTA BARAT,PALMERAH,PALMERAH,63011,14210,48801,38168,86969,2021-10-25
3174081001,JAKARTA SELATAN,PANCORAN,PANCORAN,19421,4332,15089,12122,27211,2021-10-25
3172021003,JAKARTA UTARA,TANJUNG PRIOK,PAPANGGO,39097,8379,30718,24503,55221,2021-10-25
3171021001,JAKARTA PUSAT,SAWAH BESAR,PASAR BARU,12035,2441,9594,8371,17965,2021-10-25
3174021006,JAKARTA SELATAN,SETIA BUDI,PASAR MANGGIS,26752,5697,21055,16854,37909,2021-10-25
3174041001,JAKARTA SELATAN,PASAR MINGGU,PASAR MINGGU,24821,4963,19858,16279,36137,2021-10-25
3171041003,JAKARTA PUSAT,SENEN,PASEBAN,23533,5319,18214,14526,32740,2021-10-25
3173061005,JAKARTA BARAT,KALI DERES,PEGADUNGAN,75587,16378,59209,49820,109029,2021-10-25
3171061002,JAKARTA PUSAT,MENTENG,PEGANGSAAN,23455,5282,18173,13336,31509,2021-10-25
3172061002,JAKARTA UTARA,KELAPA GADING,PEGANGSAAN DUA,49976,8639,41337,36706,78043,2021-10-25
3172011004,JAKARTA UTARA,PENJARINGAN,PEJAGALAN,74578,16473,58105,48214,106319,2021-10-25
3174041006,JAKARTA SELATAN,PASAR MINGGU,PEJATEN BARAT,37346,8022,29324,23713,53037,2021-10-25
3174041005,JAKARTA SELATAN,PASAR MINGGU,PEJATEN TIMUR,57656,13888,43768,34930,78698,2021-10-25
3175051005,JAKARTA TIMUR,PASAR REBO,PEKAYON,43250,8476,34774,27883,62657,2021-10-25
3173041009,JAKARTA BARAT,TAMBORA,PEKOJAN,23587,4768,18819,15310,34129,2021-10-25
3174031003,JAKARTA SELATAN,MAMPANG PRAPATAN,PELA MAMPANG,43522,9330,34192,27506,61698,2021-10-25
3174081005,JAKARTA SELATAN,PANCORAN,PENGADEGAN,21478,4193,17285,14090,31375,2021-10-25
3175061003,JAKARTA TIMUR,CAKUNG,PENGGILINGAN,99255,24805,74450,57612,132062,2021-10-25
3172011001,JAKARTA UTARA,PENJARINGAN,PENJARINGAN,88308,24169,64139,47867,112006,2021-10-25
3174101001,JAKARTA SELATAN,PESANGGRAHAN,PESANGGRAHAN,27545,5064,22481,18685,41166,2021-10-25
3171071004,JAKARTA PUSAT,TANAH ABANG,PETAMBURAN,33271,9258,24013,17566,41579,2021-10-25
3174071008,JAKARTA SELATAN,KEBAYORAN BARU,PETOGOGAN,11499,2421,9078,7442,16520,2021-10-25
3171011004,JAKARTA PUSAT,GAMBIR,PETOJO SELATAN,14692,3486,11206,9258,20464,2021-10-25
3171011003,JAKARTA PUSAT,GAMBIR,PETOJO UTARA,17458,3962,13496,10741,24237,2021-10-25
3174101004,JAKARTA SELATAN,PESANGGRAHAN,PETUKANGAN SELATAN,37187,8137,29050,23601,52651,2021-10-25
3174101003,JAKARTA SELATAN,PESANGGRAHAN,PETUKANGAN UTARA,53716,12467,41249,33193,74442,2021-10-25
3175081002,JAKARTA TIMUR,MAKASAR,PINANG RANTI,27198,6339,20859,16794,37653,2021-10-25
3173031008,JAKARTA BARAT,TAMAN SARI,PINANGSIA,10729,2004,8725,7013,15738,2021-10-25
3175011001,JAKARTA TIMUR,MATRAMAN,PISANGAN BARU,31776,6998,24778,18954,43732,2021-10-25
3175021002,JAKARTA TIMUR,PULO GADUNG,PISANGAN TIMUR,41011,8287,32724,26651,59375,2021-10-25
3172011005,JAKARTA UTARA,PENJARINGAN,PLUIT,47783,9580,38203,32424,70627,2021-10-25
3175071002,JAKARTA TIMUR,DUREN SAWIT,PONDOK BAMBU,61550,13860,47690,37693,85383,2021-10-25
3175071004,JAKARTA TIMUR,DUREN SAWIT,PONDOK KELAPA,72015,15207,56808,47229,104037,2021-10-25
3175071007,JAKARTA TIMUR,DUREN SAWIT,PONDOK KOPI,35367,6972,28395,21428,49823,2021-10-25
3174061003,JAKARTA SELATAN,CILANDAK,PONDOK LABU,46464,8584,37880,32001,69881,2021-10-25
3174051002,JAKARTA SELATAN,KEBAYORAN LAMA,PONDOK PINANG,56169,11386,44783,36426,81209,2021-10-25
3175101003,JAKARTA TIMUR,CIPAYUNG,PONDOK RANGGON,25574,5132,20442,16136,36578,2021-10-25
3101011003,KAB.ADM.KEP.SERIBU,KEP. SERIBU UTARA,PULAU HARAPAN,2060,228,1832,1576,3408,2021-10-25
3101011002,KAB.ADM.KEP.SERIBU,KEP. SERIBU UTARA,PULAU KELAPA,5528,636,4892,3983,8875,2021-10-25
3101011001,KAB.ADM.KEP.SERIBU,KEP. SERIBU UTARA,PULAU PANGGANG,5450,478,4972,4385,9357,2021-10-25
3101021003,KAB.ADM.KEP.SERIBU,KEP. SERIBU SELATAN,PULAU PARI,2765,201,2564,2378,4942,2021-10-25
3101021002,KAB.ADM.KEP.SERIBU,KEP. SERIBU SELATAN,PULAU TIDUNG,4553,390,4163,3748,7911,2021-10-25
3101021001,KAB.ADM.KEP.SERIBU,KEP. SERIBU SELATAN,PULAU UNTUNG JAWA,1941,168,1773,1622,3395,2021-10-25
3174071007,JAKARTA SELATAN,KEBAYORAN BARU,PULO,5835,1066,4769,4216,8985,2021-10-25
3175021001,JAKARTA TIMUR,PULO GADUNG,PULO GADUNG,34422,7954,26468,21354,47822,2021-10-25
3175061005,JAKARTA TIMUR,CAKUNG,PULO GEBANG,97301,19961,77340,60859,138199,2021-10-25
3174041004,JAKARTA SELATAN,PASAR MINGGU,RAGUNAN,39616,7917,31699,26174,57873,2021-10-25
3175091005,JAKARTA TIMUR,CIRACAS,RAMBUTAN,36771,9128,27643,21084,48727,2021-10-25
3172031006,JAKARTA UTARA,KOJA,RAWA BADAK SELATAN,42179,10625,31554,24191,55745,2021-10-25
3172031004,JAKARTA UTARA,KOJA,RAWA BADAK UTARA,34408,8195,26213,20379,46592,2021-10-25
3174071005,JAKARTA SELATAN,KEBAYORAN BARU,RAWA BARAT,5625,1049,4576,3933,8509,2021-10-25
3173011003,JAKARTA BARAT,CENGKARENG,RAWA BUAYA,63799,13809,49990,38748,88738,2021-10-25
3175031004,JAKARTA TIMUR,JATINEGARA,RAWA BUNGA,21434,5501,15933,12402,28335,2021-10-25
3174081003,JAKARTA SELATAN,PANCORAN,RAWA JATI,20509,4113,16396,13338,29734,2021-10-25
3175061002,JAKARTA TIMUR,CAKUNG,RAWA TERATE,24637,4824,19813,15736,35549,2021-10-25
3175021005,JAKARTA TIMUR,PULO GADUNG,RAWAMANGUN,37612,7984,29628,24288,53916,2021-10-25
3171051003,JAKARTA PUSAT,CEMPAKA PUTIH,RAWASARI,21967,4758,17209,14138,31347,2021-10-25
3173041010,JAKARTA BARAT,TAMBORA,ROA MALAKA,3484,638,2846,2467,5313,2021-10-25
3172041006,JAKARTA UTARA,CILINCING,ROROTAN,41668,8880,32788,25563,58351,2021-10-25
3174071004,JAKARTA SELATAN,KEBAYORAN BARU,SELONG,2842,559,2283,2059,4342,2021-10-25
3173061002,JAKARTA BARAT,KALI DERES,SEMANAN,71354,16987,54367,42971,97338,2021-10-25
3172041007,JAKARTA UTARA,CILINCING,SEMPER BARAT,68587,14312,54275,43816,98091,2021-10-25
3172041005,JAKARTA UTARA,CILINCING,SEMPER TIMUR,36267,8281,27986,22054,50040,2021-10-25
3174071006,JAKARTA SELATAN,KEBAYORAN BARU,SENAYAN,2771,678,2093,1747,3840,2021-10-25
3171041001,JAKARTA PUSAT,SENEN,SENEN,6804,1554,5250,4273,9523,2021-10-25
3171031004,JAKARTA PUSAT,KEMAYORAN,SERDANG,29668,6335,23333,18816,42149,2021-10-25
3174021001,JAKARTA SELATAN,SETIA BUDI,SETIA BUDI,3023,647,2376,1934,4310,2021-10-25
3175101005,JAKARTA TIMUR,CIPAYUNG,SETU,20572,4389,16183,12578,28761,2021-10-25
3173071002,JAKARTA BARAT,PALMERAH,SLIPI,16591,3210,13381,10877,24258,2021-10-25
3173081004,JAKARTA BARAT,KEMBANGAN,SRENGSENG,45523,10893,34630,28471,63101,2021-10-25
3174091002,JAKARTA SELATAN,JAGAKARSA,SRENGSENG SAWAH,58196,9683,48513,39687,88200,2021-10-25
3173051003,JAKARTA BARAT,KEBON JERUK,SUKABUMI SELATAN,37033,8955,28078,21070,49148,2021-10-25
3173051002,JAKARTA BARAT,KEBON JERUK,SUKABUMI UTARA,38290,9610,28680,21748,50428,2021-10-25
3172041002,JAKARTA UTARA,CILINCING,SUKAPURA,53949,12928,41021,32842,73863,2021-10-25
3171031007,JAKARTA PUSAT,KEMAYORAN,SUMUR BATU,22717,4890,17827,14698,32525,2021-10-25
3172021004,JAKARTA UTARA,TANJUNG PRIOK,SUNGAI BAMBU,29876,6419,23457,18823,42280,2021-10-25
3172021006,JAKARTA UTARA,TANJUNG PRIOK,SUNTER AGUNG,71805,13208,58597,49826,108423,2021-10-25
3172021002,JAKARTA UTARA,TANJUNG PRIOK,SUNTER JAYA,63031,11780,51251,42893,94144,2021-10-25
3175091004,JAKARTA TIMUR,CIRACAS,SUSUKAN,38257,7648,30609,24636,55245,2021-10-25
3173031001,JAKARTA BARAT,TAMAN SARI,TAMAN SARI,14348,2778,11570,9712,21282,2021-10-25
3173041001,JAKARTA BARAT,TAMBORA,TAMBORA,10204,2395,7809,6111,13920,2021-10-25
3173041004,JAKARTA BARAT,TAMBORA,TANAH SEREAL,26387,4744,21643,17675,39318,2021-10-25
3171081004,JAKARTA PUSAT,JOHAR BARU,TANAH TINGGI,37693,7552,30141,23852,53993,2021-10-25
3173031004,JAKARTA BARAT,TAMAN SARI,TANGKI,13324,2347,10977,8923,19900,2021-10-25
3174091005,JAKARTA SELATAN,JAGAKARSA,TANJUNG BARAT,39770,7192,32578,25556,58134,2021-10-25
3173021005,JAKARTA BARAT,GROGOL PETAMBURAN,TANJUNG DUREN SELATAN,25337,5166,20171,17229,37400,2021-10-25
3173021002,JAKARTA BARAT,GROGOL PETAMBURAN,TANJUNG DUREN UTARA,17010,3043,13967,12059,26026,2021-10-25
3172021001,JAKARTA UTARA,TANJUNG PRIOK,TANJUNG PRIOK,34588,7552,27036,21471,48507,2021-10-25
3174011002,JAKARTA SELATAN,TEBET,TEBET BARAT,21194,3712,17482,14926,32408,2021-10-25
3174011001,JAKARTA SELATAN,TEBET,TEBET TIMUR,18199,3107,15092,13167,28259,2021-10-25
3173061003,JAKARTA BARAT,KALI DERES,TEGAL ALUR,83647,18944,64703,51991,116694,2021-10-25
3174031004,JAKARTA SELATAN,MAMPANG PRAPATAN,TEGAL PARANG,32401,7669,24732,18335,43067,2021-10-25
3173021003,JAKARTA BARAT,GROGOL PETAMBURAN,TOMANG,29605,5800,23805,19755,43560,2021-10-25
3172031005,JAKARTA UTARA,KOJA,TUGU SELATAN,39122,9284,29838,23457,53295,2021-10-25
3172031002,JAKARTA UTARA,KOJA,TUGU UTARA,67670,16990,50680,38895,89575,2021-10-25
3175061006,JAKARTA TIMUR,CAKUNG,UJUNG MENTENG,29934,5558,24376,20093,44469,2021-10-25
3174101005,JAKARTA SELATAN,PESANGGRAHAN,ULUJAMI,40544,9805,30739,24397,55136,2021-10-25
3175011006,JAKARTA TIMUR,MATRAMAN,UTAN KAYU SELATAN,33511,6482,27029,21517,48546,2021-10-25
3175011002,JAKARTA TIMUR,MATRAMAN,UTAN KAYU UTARA,28169,6287,21882,17339,39221,2021-10-25
3171031008,JAKARTA PUSAT,KEMAYORAN,UTAN PANJANG,29208,6329,22879,17651,40530,2021-10-25
3172021007,JAKARTA UTARA,TANJUNG PRIOK,WARAKAS,44401,8664,35737,27775,63512,2021-10-25
3173021007,JAKARTA BARAT,GROGOL PETAMBURAN,WIJAYA KUSUMA,38934,8657,30277,24530,54807,2021-10-25
3172051003,JAKARTA UTARA,PADEMANGAN,ANCOL,23947,6078,17869,14334,32203,2021-10-26
3173041007,JAKARTA BARAT,TAMBORA,ANGKE,29381,6661,22720,17937,40657,2021-10-26
3175041005,JAKARTA TIMUR,KRAMAT JATI,BALE KAMBANG,29074,7724,21350,16049,37399,2021-10-26
3175031003,JAKARTA TIMUR,JATINEGARA,BALI MESTER,9752,2169,7583,6166,13749,2021-10-26
3175101006,JAKARTA TIMUR,CIPAYUNG,BAMBU APUS,26285,5115,21170,17059,38229,2021-10-26
3174031002,JAKARTA SELATAN,MAMPANG PRAPATAN,BANGKA,21566,4951,16615,13244,29859,2021-10-26
3175051002,JAKARTA TIMUR,PASAR REBO,BARU,23886,4165,19721,16512,36233,2021-10-26
3175041004,JAKARTA TIMUR,KRAMAT JATI,BATU AMPAR,47898,12388,35510,27428,62938,2021-10-26
3171071002,JAKARTA PUSAT,TANAH ABANG,BENDUNGAN HILIR,21494,4570,16924,13951,30875,2021-10-26
3175031002,JAKARTA TIMUR,JATINEGARA,BIDARA CINA,36689,9300,27389,21033,48422,2021-10-26
3174101002,JAKARTA SELATAN,PESANGGRAHAN,BINTARO,53098,11255,41843,34714,76557,2021-10-26
3174011005,JAKARTA SELATAN,TEBET,BUKIT DURI,34183,7543,26640,21520,48160,2021-10-26
3171041006,JAKARTA PUSAT,SENEN,BUNGUR,18144,4080,14064,11417,25481,2021-10-26
3175061007,JAKARTA TIMUR,CAKUNG,CAKUNG BARAT,57724,12644,45080,36340,81420,2021-10-26
3175061004,JAKARTA TIMUR,CAKUNG,CAKUNG TIMUR,58287,12219,46068,37196,83264,2021-10-26
3175041007,JAKARTA TIMUR,KRAMAT JATI,CAWANG,32762,7688,25074,19434,44508,2021-10-26
3175101008,JAKARTA TIMUR,CIPAYUNG,CEGER,18932,3934,14998,12152,27150,2021-10-26
3171031006,JAKARTA PUSAT,KEMAYORAN,CEMPAKA BARU,32581,7061,25520,19529,45049,2021-10-26
3171051002,JAKARTA PUSAT,CEMPAKA PUTIH,CEMPAKA PUTIH BARAT,35885,8049,27836,22881,50717,2021-10-26
3171051001,JAKARTA PUSAT,CEMPAKA PUTIH,CEMPAKA PUTIH TIMUR,24292,5211,19081,16051,35132,2021-10-26
3173011001,JAKARTA BARAT,CENGKARENG,CENGKARENG BARAT,66284,14283,52001,42644,94645,2021-10-26
3173011006,JAKARTA BARAT,CENGKARENG,CENGKARENG TIMUR,81027,17029,63998,51018,115016,2021-10-26
3175091002,JAKARTA TIMUR,CIRACAS,CIBUBUR,66364,12007,54357,44007,98364,2021-10-26
3171011002,JAKARTA PUSAT,GAMBIR,CIDENG,15390,3128,12262,10408,22670,2021-10-26
3174091003,JAKARTA SELATAN,JAGAKARSA,CIGANJUR,38497,7061,31436,24756,56192,2021-10-26
3175051003,JAKARTA TIMUR,PASAR REBO,CIJANTUNG,41419,8150,33269,26914,60183,2021-10-26
3171061003,JAKARTA PUSAT,MENTENG,CIKINI,8274,1548,6726,5144,11870,2021-10-26
3174081006,JAKARTA SELATAN,PANCORAN,CIKOKO,10547,1918,8629,7219,15848,2021-10-26
3174061001,JAKARTA SELATAN,CILANDAK,CILANDAK BARAT,51752,9753,41999,35054,77053,2021-10-26
3174041003,JAKARTA SELATAN,PASAR MINGGU,CILANDAK TIMUR,25145,4944,20201,16644,36845,2021-10-26
3175101002,JAKARTA TIMUR,CIPAYUNG,CILANGKAP,27635,5177,22458,18020,40478,2021-10-26
3175041006,JAKARTA TIMUR,KRAMAT JATI,CILILITAN,40181,9562,30619,23991,54610,2021-10-26
3172041001,JAKARTA UTARA,CILINCING,CILINCING,43609,11045,32564,24526,57090,2021-10-26
3175101001,JAKARTA TIMUR,CIPAYUNG,CIPAYUNG,26104,4807,21297,17769,39066,2021-10-26
3174091006,JAKARTA SELATAN,JAGAKARSA,CIPEDAK,38303,6843,31460,25346,56806,2021-10-26
3174061005,JAKARTA SELATAN,CILANDAK,CIPETE SELATAN,26704,5439,21265,17986,39251,2021-10-26
3174071010,JAKARTA SELATAN,KEBAYORAN BARU,CIPETE UTARA,34102,6845,27257,21658,48915,2021-10-26
3175021003,JAKARTA TIMUR,PULO GADUNG,CIPINANG,39306,7831,31475,25260,56735,2021-10-26
3175031007,JAKARTA TIMUR,JATINEGARA,CIPINANG BESAR SELATAN,35212,8807,26405,19868,46273,2021-10-26
3175031008,JAKARTA TIMUR,JATINEGARA,CIPINANG BESAR UTARA,45319,11378,33941,25325,59266,2021-10-26
3175031005,JAKARTA TIMUR,JATINEGARA,CIPINANG CEMPEDAK,32824,7540,25284,20392,45676,2021-10-26
3175081005,JAKARTA TIMUR,MAKASAR,CIPINANG MELAYU,42308,8640,33668,27367,61035,2021-10-26
3175031006,JAKARTA TIMUR,JATINEGARA,CIPINANG MUARA,55243,12565,42678,33489,76167,2021-10-26
3174051003,JAKARTA SELATAN,KEBAYORAN LAMA,CIPULIR,39937,8951,30986,24257,55243,2021-10-26
3175091001,JAKARTA TIMUR,CIRACAS,CIRACAS,64594,12535,52059,41314,93373,2021-10-26
3175041003,JAKARTA TIMUR,KRAMAT JATI,DUKUH,24609,4941,19668,15650,35318,2021-10-26
3175071001,JAKARTA TIMUR,DUREN SAWIT,DUREN SAWIT,61160,13707,47453,37553,85006,2021-10-26
3174081004,JAKARTA SELATAN,PANCORAN,DUREN TIGA,28319,6001,22318,17884,40202,2021-10-26
3173051005,JAKARTA BARAT,KEBON JERUK,DURI KEPA,60138,12424,47714,40249,87963,2021-10-26
3173011002,JAKARTA BARAT,CENGKARENG,DURI KOSAMBI,77923,17999,59924,46422,106346,2021-10-26
3171011006,JAKARTA PUSAT,GAMBIR,DURI PULO,19610,4403,15207,11871,27078,2021-10-26
3173041011,JAKARTA BARAT,TAMBORA,DURI SELATAN,14259,2674,11585,9538,21123,2021-10-26
3173041003,JAKARTA BARAT,TAMBORA,DURI UTARA,19844,3834,16010,12798,28808,2021-10-26
3171081003,JAKARTA PUSAT,JOHAR BARU,GALUR,18243,3773,14470,11403,25873,2021-10-26
3171011001,JAKARTA PUSAT,GAMBIR,GAMBIR,2191,477,1714,1446,3160,2021-10-26
3174061004,JAKARTA SELATAN,CILANDAK,GANDARIA SELATAN,22119,4536,17583,14317,31900,2021-10-26
3174071009,JAKARTA SELATAN,KEBAYORAN BARU,GANDARIA UTARA,39922,8458,31464,25455,56919,2021-10-26
3175051001,JAKARTA TIMUR,PASAR REBO,GEDONG,35755,7559,28196,23040,51236,2021-10-26
3171071001,JAKARTA PUSAT,TANAH ABANG,GELORA,3127,640,2487,2082,4569,2021-10-26
3173031007,JAKARTA BARAT,TAMAN SARI,GLODOK,7837,1256,6581,5763,12344,2021-10-26
3171061004,JAKARTA PUSAT,MENTENG,GONDANGDIA,4100,952,3148,2818,5966,2021-10-26
3173021001,JAKARTA BARAT,GROGOL PETAMBURAN,GROGOL,16876,3566,13310,10894,24204,2021-10-26
3174051005,JAKARTA SELATAN,KEBAYORAN LAMA,GROGOL SELATAN,44251,9567,34684,27609,62293,2021-10-26
3174051004,JAKARTA SELATAN,KEBAYORAN LAMA,GROGOL UTARA,42494,9172,33322,26826,60148,2021-10-26
3174021007,JAKARTA SELATAN,SETIA BUDI,GUNTUR,3985,783,3202,2741,5943,2021-10-26
3174071002,JAKARTA SELATAN,KEBAYORAN BARU,GUNUNG,9436,1841,7595,6473,14068,2021-10-26
3171031005,JAKARTA PUSAT,KEMAYORAN,GUNUNG SAHARI SELATAN,19199,4114,15085,12303,27388,2021-10-26
3171021004,JAKARTA PUSAT,SAWAH BESAR,GUNUNG SAHARI UTARA,16650,3097,13553,11749,25302,2021-10-26
3175081004,JAKARTA TIMUR,MAKASAR,HALIM PERDANA KUSUMAH,28363,3941,24422,21907,46329,2021-10-26
3171031003,JAKARTA PUSAT,KEMAYORAN,HARAPAN MULIA,22557,4857,17700,13882,31582,2021-10-26
3174091001,JAKARTA SELATAN,JAGAKARSA,JAGAKARSA,62389,11113,51276,40917,92193,2021-10-26
3175021007,JAKARTA TIMUR,PULO GADUNG,JATI,32757,6487,26270,21973,48243,2021-10-26
3174041002,JAKARTA SELATAN,PASAR MINGGU,JATI PADANG,37502,7960,29542,24102,53644,2021-10-26
3173071004,JAKARTA BARAT,PALMERAH,JATI PULO,28738,6094,22644,17632,40276,2021-10-26
3175061001,JAKARTA TIMUR,CAKUNG,JATINEGARA,84160,19171,64989,51992,116981,2021-10-26
3175021004,JAKARTA TIMUR,PULO GADUNG,JATINEGARA KAUM,24632,4681,19951,15569,35520,2021-10-26
3173021004,JAKARTA BARAT,GROGOL PETAMBURAN,JELAMBAR,30266,5843,24423,20487,44910,2021-10-26
3173021006,JAKARTA BARAT,GROGOL PETAMBURAN,JELAMBAR BARU,38246,7600,30646,25749,56395,2021-10-26
3173041006,JAKARTA BARAT,TAMBORA,JEMBATAN BESI,29314,7527,21787,16433,38220,2021-10-26
3173041008,JAKARTA BARAT,TAMBORA,JEMBATAN LIMA,21021,5254,15767,12104,27871,2021-10-26
3173081005,JAKARTA BARAT,KEMBANGAN,JOGLO,40839,8829,32010,26391,58401,2021-10-26
3171081001,JAKARTA PUSAT,JOHAR BARU,JOHAR BARU,37488,7266,30222,24911,55133,2021-10-26
3173041002,JAKARTA BARAT,TAMBORA,KALI ANYAR,23856,5029,18827,14515,33342,2021-10-26
3172041004,JAKARTA UTARA,CILINCING,KALIBARU,67684,19573,48111,33485,81596,2021-10-26
3174081002,JAKARTA SELATAN,PANCORAN,KALIBATA,41994,10138,31856,24650,56506,2021-10-26
3173061001,JAKARTA BARAT,KALI DERES,KALIDERES,72447,16080,56367,46619,102986,2021-10-26
3175051004,JAKARTA TIMUR,PASAR REBO,KALISARI,43212,8214,34998,28370,63368,2021-10-26
3173061004,JAKARTA BARAT,KALI DERES,KAMAL,53783,13598,40185,31181,71366,2021-10-26
3172011002,JAKARTA UTARA,PENJARINGAN,KAMAL MUARA,12930,2355,10575,8893,19468,2021-10-26
3171071007,JAKARTA PUSAT,TANAH ABANG,KAMPUNG BALI,11358,2592,8766,6452,15218,2021-10-26
3175031001,JAKARTA TIMUR,JATINEGARA,KAMPUNG MELAYU,25717,6241,19476,14701,34177,2021-10-26
3171081002,JAKARTA PUSAT,JOHAR BARU,KAMPUNG RAWA,21237,3671,17566,13691,31257,2021-10-26
3175041002,JAKARTA TIMUR,KRAMAT JATI,KAMPUNG TENGAH,43993,11621,32372,24866,57238,2021-10-26
3173011005,JAKARTA BARAT,CENGKARENG,KAPUK,134466,34361,100105,78284,178389,2021-10-26
3172011003,JAKARTA UTARA,PENJARINGAN,KAPUK MUARA,35781,7211,28570,24507,53077,2021-10-26
3171021002,JAKARTA PUSAT,SAWAH BESAR,KARANG ANYAR,25761,5260,20501,16790,37291,2021-10-26
3174021004,JAKARTA SELATAN,SETIA BUDI,KARET,9623,1948,7675,6206,13881,2021-10-26
3174021003,JAKARTA SELATAN,SETIA BUDI,KARET KUNINGAN,16055,3316,12739,10493,23232,2021-10-26
3174021002,JAKARTA SELATAN,SETIA BUDI,KARET SEMANGGI,2770,578,2192,1913,4105,2021-10-26
3171071003,JAKARTA PUSAT,TANAH ABANG,KARET TENGSIN,19271,3922,15349,12084,27433,2021-10-26
3171021003,JAKARTA PUSAT,SAWAH BESAR,KARTINI,22292,4545,17747,14770,32517,2021-10-26
3175011003,JAKARTA TIMUR,MATRAMAN,KAYU MANIS,25284,5664,19620,14956,34576,2021-10-26
3175021006,JAKARTA TIMUR,PULO GADUNG,KAYU PUTIH,40696,8048,32648,27783,60431,2021-10-26
3173031006,JAKARTA BARAT,TAMAN SARI,KEAGUNGAN,17387,3409,13978,11040,25018,2021-10-26
3174041007,JAKARTA SELATAN,PASAR MINGGU,KEBAGUSAN,44552,9351,35201,28041,63242,2021-10-26
3174051006,JAKARTA SELATAN,KEBAYORAN LAMA,KEBAYORAN LAMA SELATAN,41212,8182,33030,26878,59908,2021-10-26
3174051001,JAKARTA SELATAN,KEBAYORAN LAMA,KEBAYORAN LAMA UTARA,42422,9454,32968,26233,59201,2021-10-26
3174011004,JAKARTA SELATAN,TEBET,KEBON BARU,35165,7046,28119,22656,50775,2021-10-26
3172021005,JAKARTA UTARA,TANJUNG PRIOK,KEBON BAWANG,50952,10949,40003,32288,72291,2021-10-26
3173051001,JAKARTA BARAT,KEBON JERUK,KEBON JERUK,53887,12309,41578,33078,74656,2021-10-26
3171071006,JAKARTA PUSAT,TANAH ABANG,KEBON KACANG,21531,5444,16087,12310,28397,2021-10-26
3171011005,JAKARTA PUSAT,GAMBIR,KEBON KELAPA,10163,2149,8014,6545,14559,2021-10-26
3171031002,JAKARTA PUSAT,KEMAYORAN,KEBON KOSONG,30019,6369,23650,18419,42069,2021-10-26
3175011005,JAKARTA TIMUR,MATRAMAN,KEBON MANGGIS,16490,3416,13074,10510,23584,2021-10-26
3171071005,JAKARTA PUSAT,TANAH ABANG,KEBON MELATI,32206,8959,23247,16609,39856,2021-10-26
3175081003,JAKARTA TIMUR,MAKASAR,KEBON PALA,46614,9860,36754,29583,66337,2021-10-26
3171061005,JAKARTA PUSAT,MENTENG,KEBON SIRIH,12299,2791,9508,7416,16924,2021-10-26
3173011004,JAKARTA BARAT,CENGKARENG,KEDAUNG KALI ANGKE,32612,6686,25926,21178,47104,2021-10-26
3173051007,JAKARTA BARAT,KEBON JERUK,KEDOYA SELATAN,32165,6196,25969,20855,46824,2021-10-26
3173051006,JAKARTA BARAT,KEBON JERUK,KEDOYA UTARA,45740,9058,36682,30372,67054,2021-10-26
3173051004,JAKARTA BARAT,KEBON JERUK,KELAPA DUA,23565,5096,18469,14945,33414,2021-10-26
3175091003,JAKARTA TIMUR,CIRACAS,KELAPA DUA WETAN,46875,8520,38355,31171,69526,2021-10-26
3172061003,JAKARTA UTARA,KELAPA GADING,KELAPA GADING BARAT,35717,6457,29260,25865,55125,2021-10-26
3172061001,JAKARTA UTARA,KELAPA GADING,KELAPA GADING TIMUR,33592,5349,28243,25595,53838,2021-10-26
3173071005,JAKARTA BARAT,PALMERAH,KEMANGGISAN,32139,6407,25732,20720,46452,2021-10-26
3171031001,JAKARTA PUSAT,KEMAYORAN,KEMAYORAN,20708,4527,16181,13021,29202,2021-10-26
3173081006,JAKARTA BARAT,KEMBANGAN,KEMBANGAN SELATAN,27130,6042,21088,17832,38920,2021-10-26
3173081001,JAKARTA BARAT,KEMBANGAN,KEMBANGAN UTARA,54451,12638,41813,34027,75840,2021-10-26
3171041002,JAKARTA PUSAT,SENEN,KENARI,9579,1989,7590,6330,13920,2021-10-26
3173041005,JAKARTA BARAT,TAMBORA,KERENDANG,19973,4408,15565,12278,27843,2021-10-26
3175071003,JAKARTA TIMUR,DUREN SAWIT,KLENDER,69978,17196,52782,40649,93431,2021-10-26
3172031001,JAKARTA UTARA,KOJA,KOJA,28175,6751,21424,16861,38285,2021-10-26
3173071006,JAKARTA BARAT,PALMERAH,KOTA BAMBU SELATAN,21158,4631,16527,12668,29195,2021-10-26
3173071003,JAKARTA BARAT,PALMERAH,KOTA BAMBU UTARA,24995,5805,19190,14655,33845,2021-10-26
3171041004,JAKARTA PUSAT,SENEN,KRAMAT,28835,7321,21514,16003,37517,2021-10-26
3175041001,JAKARTA TIMUR,KRAMAT JATI,KRAMAT JATI,34144,7887,26257,20642,46899,2021-10-26
3174071003,JAKARTA SELATAN,KEBAYORAN BARU,KRAMAT PELA,14413,2937,11476,9442,20918,2021-10-26
3173031002,JAKARTA BARAT,TAMAN SARI,KRUKUT,19244,3812,15432,12062,27494,2021-10-26
3174031005,JAKARTA SELATAN,MAMPANG PRAPATAN,KUNINGAN BARAT,12785,2507,10278,8344,18622,2021-10-26
3174021008,JAKARTA SELATAN,SETIA BUDI,KUNINGAN TIMUR,6008,1302,4706,3897,8603,2021-10-26
3171041005,JAKARTA PUSAT,SENEN,KWITANG,15486,3743,11743,9319,21062,2021-10-26
3172031003,JAKARTA UTARA,KOJA,LAGOA,59065,14793,44272,34116,78388,2021-10-26
3174061002,JAKARTA SELATAN,CILANDAK,LEBAK BULUS,37626,7569,30057,25119,55176,2021-10-26
3174091004,JAKARTA SELATAN,JAGAKARSA,LENTENG AGUNG,53946,10395,43551,33807,77358,2021-10-26
3175101007,JAKARTA TIMUR,CIPAYUNG,LUBANG BUAYA,63547,12657,50890,40926,91816,2021-10-26
3175081001,JAKARTA TIMUR,MAKASAR,MAKASAR,34390,6737,27653,22646,50299,2021-10-26
3175071006,JAKARTA TIMUR,DUREN SAWIT,MALAKA JAYA,30927,5759,25168,20676,45844,2021-10-26
3175071005,JAKARTA TIMUR,DUREN SAWIT,MALAKA SARI,27530,4908,22622,18853,41475,2021-10-26
3174031001,JAKARTA SELATAN,MAMPANG PRAPATAN,MAMPANG PRAPATAN,18159,3954,14205,11231,25436,2021-10-26
3173031005,JAKARTA BARAT,TAMAN SARI,MANGGA BESAR,7707,1363,6344,5401,11745,2021-10-26
3171021005,JAKARTA PUSAT,SAWAH BESAR,MANGGA DUA SELATAN,27442,5989,21453,17640,39093,2021-10-26
3174011007,JAKARTA SELATAN,TEBET,MANGGARAI,28373,5382,22991,17999,40990,2021-10-26
3174011006,JAKARTA SELATAN,TEBET,MANGGARAI SELATAN,23075,4404,18671,15257,33928,2021-10-26
3173031003,JAKARTA BARAT,TAMAN SARI,MAPHAR,16461,3217,13244,10705,23949,2021-10-26
3172041003,JAKARTA UTARA,CILINCING,MARUNDA,28943,6941,22002,16165,38167,2021-10-26
3174071001,JAKARTA SELATAN,KEBAYORAN BARU,MELAWAI,2627,536,2091,1905,3996,2021-10-26
3171061001,JAKARTA PUSAT,MENTENG,MENTENG,25624,6088,19536,14934,34470,2021-10-26
3174021005,JAKARTA SELATAN,SETIA BUDI,MENTENG ATAS,27816,5395,22421,17951,40372,2021-10-26
3174011003,JAKARTA SELATAN,TEBET,MENTENG DALAM,36028,7488,28540,23146,51686,2021-10-26
3173081003,JAKARTA BARAT,KEMBANGAN,MERUYA SELATAN,32130,6991,25139,20411,45550,2021-10-26
3173081002,JAKARTA BARAT,KEMBANGAN,MERUYA UTARA,43752,9462,34290,28910,63200,2021-10-26
3175101004,JAKARTA TIMUR,CIPAYUNG,MUNJUL,23871,4537,19334,15662,34996,2021-10-26
3172051002,JAKARTA UTARA,PADEMANGAN,PADEMANGAN BARAT,74240,18490,55750,43743,99493,2021-10-26
3172051001,JAKARTA UTARA,PADEMANGAN,PADEMANGAN TIMUR,37736,7028,30708,26061,56769,2021-10-26
3175011004,JAKARTA TIMUR,MATRAMAN,PAL MERIAM,19769,4375,15394,11987,27381,2021-10-26
3173071001,JAKARTA BARAT,PALMERAH,PALMERAH,63011,14109,48902,38406,87308,2021-10-26
3174081001,JAKARTA SELATAN,PANCORAN,PANCORAN,19421,4325,15096,12161,27257,2021-10-26
3172021003,JAKARTA UTARA,TANJUNG PRIOK,PAPANGGO,39097,8300,30797,24620,55417,2021-10-26
3171021001,JAKARTA PUSAT,SAWAH BESAR,PASAR BARU,12035,2430,9605,8404,18009,2021-10-26
3174021006,JAKARTA SELATAN,SETIA BUDI,PASAR MANGGIS,26752,5671,21081,16901,37982,2021-10-26
3174041001,JAKARTA SELATAN,PASAR MINGGU,PASAR MINGGU,24821,4923,19898,16394,36292,2021-10-26
3171041003,JAKARTA PUSAT,SENEN,PASEBAN,23533,5293,18240,14600,32840,2021-10-26
3173061005,JAKARTA BARAT,KALI DERES,PEGADUNGAN,75587,16312,59275,50026,109301,2021-10-26
3171061002,JAKARTA PUSAT,MENTENG,PEGANGSAAN,23455,5263,18192,13409,31601,2021-10-26
3172061002,JAKARTA UTARA,KELAPA GADING,PEGANGSAAN DUA,49976,8601,41375,36807,78182,2021-10-26
3172011004,JAKARTA UTARA,PENJARINGAN,PEJAGALAN,74578,16371,58207,48394,106601,2021-10-26
3174041006,JAKARTA SELATAN,PASAR MINGGU,PEJATEN BARAT,37346,7939,29407,23840,53247,2021-10-26
3174041005,JAKARTA SELATAN,PASAR MINGGU,PEJATEN TIMUR,57656,13812,43844,35150,78994,2021-10-26
3175051005,JAKARTA TIMUR,PASAR REBO,PEKAYON,43250,8354,34896,28020,62916,2021-10-26
3173041009,JAKARTA BARAT,TAMBORA,PEKOJAN,23587,4738,18849,15367,34216,2021-10-26
3174031003,JAKARTA SELATAN,MAMPANG PRAPATAN,PELA MAMPANG,43522,9261,34261,27693,61954,2021-10-26
3174081005,JAKARTA SELATAN,PANCORAN,PENGADEGAN,21478,4168,17310,14174,31484,2021-10-26
3175061003,JAKARTA TIMUR,CAKUNG,PENGGILINGAN,99255,24661,74594,57945,132539,2021-10-26
3172011001,JAKARTA UTARA,PENJARINGAN,PENJARINGAN,88308,24025,64283,48089,112372,2021-10-26
3174101001,JAKARTA SELATAN,PESANGGRAHAN,PESANGGRAHAN,27545,5030,22515,18772,41287,2021-10-26
3171071004,JAKARTA PUSAT,TANAH ABANG,PETAMBURAN,33271,9221,24050,17637,41687,2021-10-26
3174071008,JAKARTA SELATAN,KEBAYORAN BARU,PETOGOGAN,11499,2399,9100,7475,16575,2021-10-26
3171011004,JAKARTA PUSAT,GAMBIR,PETOJO SELATAN,14692,3462,11230,9290,20520,2021-10-26
3171011003,JAKARTA PUSAT,GAMBIR,PETOJO UTARA,17458,3944,13514,10794,24308,2021-10-26
3174101004,JAKARTA SELATAN,PESANGGRAHAN,PETUKANGAN SELATAN,37187,8083,29104,23697,52801,2021-10-26
3174101003,JAKARTA SELATAN,PESANGGRAHAN,PETUKANGAN UTARA,53716,12346,41370,33312,74682,2021-10-26
3175081002,JAKARTA TIMUR,MAKASAR,PINANG RANTI,27198,6316,20882,16839,37721,2021-10-26
3173031008,JAKARTA BARAT,TAMAN SARI,PINANGSIA,10729,1981,8748,7044,15792,2021-10-26
3175011001,JAKARTA TIMUR,MATRAMAN,PISANGAN BARU,31776,6959,24817,19043,43860,2021-10-26
3175021002,JAKARTA TIMUR,PULO GADUNG,PISANGAN TIMUR,41011,8216,32795,26809,59604,2021-10-26
3172011005,JAKARTA UTARA,PENJARINGAN,PLUIT,47783,9531,38252,32528,70780,2021-10-26
3175071002,JAKARTA TIMUR,DUREN SAWIT,PONDOK BAMBU,61550,13744,47806,37844,85650,2021-10-26
3175071004,JAKARTA TIMUR,DUREN SAWIT,PONDOK KELAPA,72015,15015,57000,47412,104412,2021-10-26
3175071007,JAKARTA TIMUR,DUREN SAWIT,PONDOK KOPI,35367,6942,28425,21484,49909,2021-10-26
3174061003,JAKARTA SELATAN,CILANDAK,PONDOK LABU,46464,8544,37920,32104,70024,2021-10-26
3174051002,JAKARTA SELATAN,KEBAYORAN LAMA,PONDOK PINANG,56169,11275,44894,37109,82003,2021-10-26
3175101003,JAKARTA TIMUR,CIPAYUNG,PONDOK RANGGON,25574,5104,20470,16239,36709,2021-10-26
3101011003,KAB.ADM.KEP.SERIBU,KEP. SERIBU UTARA,PULAU HARAPAN,2060,228,1832,1577,3409,2021-10-26
3101011002,KAB.ADM.KEP.SERIBU,KEP. SERIBU UTARA,PULAU KELAPA,5528,635,4893,3996,8889,2021-10-26
3101011001,KAB.ADM.KEP.SERIBU,KEP. SERIBU UTARA,PULAU PANGGANG,5450,477,4973,4387,9360,2021-10-26
3101021003,KAB.ADM.KEP.SERIBU,KEP. SERIBU SELATAN,PULAU PARI,2765,201,2564,2378,4942,2021-10-26
3101021002,KAB.ADM.KEP.SERIBU,KEP. SERIBU SELATAN,PULAU TIDUNG,4553,389,4164,3766,7930,2021-10-26
3101021001,KAB.ADM.KEP.SERIBU,KEP. SERIBU SELATAN,PULAU UNTUNG JAWA,1941,168,1773,1624,3397,2021-10-26
3174071007,JAKARTA SELATAN,KEBAYORAN BARU,PULO,5835,1062,4773,4227,9000,2021-10-26
3175021001,JAKARTA TIMUR,PULO GADUNG,PULO GADUNG,34422,7910,26512,21458,47970,2021-10-26
3175061005,JAKARTA TIMUR,CAKUNG,PULO GEBANG,97301,19817,77484,61161,138645,2021-10-26
3174041004,JAKARTA SELATAN,PASAR MINGGU,RAGUNAN,39616,7850,31766,26288,58054,2021-10-26
3175091005,JAKARTA TIMUR,CIRACAS,RAMBUTAN,36771,9086,27685,21168,48853,2021-10-26
3172031006,JAKARTA UTARA,KOJA,RAWA BADAK SELATAN,42179,10559,31620,24272,55892,2021-10-26
3172031004,JAKARTA UTARA,KOJA,RAWA BADAK UTARA,34408,8106,26302,20480,46782,2021-10-26
3174071005,JAKARTA SELATAN,KEBAYORAN BARU,RAWA BARAT,5625,1046,4579,3945,8524,2021-10-26
3173011003,JAKARTA BARAT,CENGKARENG,RAWA BUAYA,63799,13711,50088,38975,89063,2021-10-26
3175031004,JAKARTA TIMUR,JATINEGARA,RAWA BUNGA,21434,5464,15970,12477,28447,2021-10-26
3174081003,JAKARTA SELATAN,PANCORAN,RAWA JATI,20509,4092,16417,13441,29858,2021-10-26
3175061002,JAKARTA TIMUR,CAKUNG,RAWA TERATE,24637,4804,19833,15790,35623,2021-10-26
3175021005,JAKARTA TIMUR,PULO GADUNG,RAWAMANGUN,37612,7925,29687,24411,54098,2021-10-26
3171051003,JAKARTA PUSAT,CEMPAKA PUTIH,RAWASARI,21967,4731,17236,14194,31430,2021-10-26
3173041010,JAKARTA BARAT,TAMBORA,ROA MALAKA,3484,635,2849,2474,5323,2021-10-26
3172041006,JAKARTA UTARA,CILINCING,ROROTAN,41668,8800,32868,25613,58481,2021-10-26
3174071004,JAKARTA SELATAN,KEBAYORAN BARU,SELONG,2842,556,2286,2067,4353,2021-10-26
3173061002,JAKARTA BARAT,KALI DERES,SEMANAN,71354,16895,54459,43118,97577,2021-10-26
3172041007,JAKARTA UTARA,CILINCING,SEMPER BARAT,68587,14216,54371,43944,98315,2021-10-26
3172041005,JAKARTA UTARA,CILINCING,SEMPER TIMUR,36267,8220,28047,22127,50174,2021-10-26
3174071006,JAKARTA SELATAN,KEBAYORAN BARU,SENAYAN,2771,677,2094,1751,3845,2021-10-26
3171041001,JAKARTA PUSAT,SENEN,SENEN,6804,1545,5259,4293,9552,2021-10-26
3171031004,JAKARTA PUSAT,KEMAYORAN,SERDANG,29668,6284,23384,18920,42304,2021-10-26
3174021001,JAKARTA SELATAN,SETIA BUDI,SETIA BUDI,3023,641,2382,1945,4327,2021-10-26
3175101005,JAKARTA TIMUR,CIPAYUNG,SETU,20572,4333,16239,12666,28905,2021-10-26
3173071002,JAKARTA BARAT,PALMERAH,SLIPI,16591,3185,13406,10917,24323,2021-10-26
3173081004,JAKARTA BARAT,KEMBANGAN,SRENGSENG,45523,10832,34691,28627,63318,2021-10-26
3174091002,JAKARTA SELATAN,JAGAKARSA,SRENGSENG SAWAH,58196,9602,48594,39914,88508,2021-10-26
3173051003,JAKARTA BARAT,KEBON JERUK,SUKABUMI SELATAN,37033,8883,28150,21169,49319,2021-10-26
3173051002,JAKARTA BARAT,KEBON JERUK,SUKABUMI UTARA,38290,9533,28757,21845,50602,2021-10-26
3172041002,JAKARTA UTARA,CILINCING,SUKAPURA,53949,12848,41101,32953,74054,2021-10-26
3171031007,JAKARTA PUSAT,KEMAYORAN,SUMUR BATU,22717,4857,17860,14765,32625,2021-10-26
3172021004,JAKARTA UTARA,TANJUNG PRIOK,SUNGAI BAMBU,29876,6377,23499,18910,42409,2021-10-26
3172021006,JAKARTA UTARA,TANJUNG PRIOK,SUNTER AGUNG,71805,13135,58670,49953,108623,2021-10-26
3172021002,JAKARTA UTARA,TANJUNG PRIOK,SUNTER JAYA,63031,11707,51324,43096,94420,2021-10-26
3175091004,JAKARTA TIMUR,CIRACAS,SUSUKAN,38257,7602,30655,24719,55374,2021-10-26
3173031001,JAKARTA BARAT,TAMAN SARI,TAMAN SARI,14348,2761,11587,9737,21324,2021-10-26
3173041001,JAKARTA BARAT,TAMBORA,TAMBORA,10204,2380,7824,6151,13975,2021-10-26
3173041004,JAKARTA BARAT,TAMBORA,TANAH SEREAL,26387,4715,21672,17737,39409,2021-10-26
3171081004,JAKARTA PUSAT,JOHAR BARU,TANAH TINGGI,37693,7504,30189,23935,54124,2021-10-26
3173031004,JAKARTA BARAT,TAMAN SARI,TANGKI,13324,2332,10992,8979,19971,2021-10-26
3174091005,JAKARTA SELATAN,JAGAKARSA,TANJUNG BARAT,39770,7148,32622,25674,58296,2021-10-26
3173021005,JAKARTA BARAT,GROGOL PETAMBURAN,TANJUNG DUREN SELATAN,25337,5132,20205,17309,37514,2021-10-26
3173021002,JAKARTA BARAT,GROGOL PETAMBURAN,TANJUNG DUREN UTARA,17010,3016,13994,12106,26100,2021-10-26
3172021001,JAKARTA UTARA,TANJUNG PRIOK,TANJUNG PRIOK,34588,7505,27083,21569,48652,2021-10-26
3174011002,JAKARTA SELATAN,TEBET,TEBET BARAT,21194,3685,17509,14989,32498,2021-10-26
3174011001,JAKARTA SELATAN,TEBET,TEBET TIMUR,18199,3080,15119,13216,28335,2021-10-26
3173061003,JAKARTA BARAT,KALI DERES,TEGAL ALUR,83647,18825,64822,52228,117050,2021-10-26
3174031004,JAKARTA SELATAN,MAMPANG PRAPATAN,TEGAL PARANG,32401,7619,24782,18431,43213,2021-10-26
3173021003,JAKARTA BARAT,GROGOL PETAMBURAN,TOMANG,29605,5755,23850,19811,43661,2021-10-26
3172031005,JAKARTA UTARA,KOJA,TUGU SELATAN,39122,9215,29907,23537,53444,2021-10-26
3172031002,JAKARTA UTARA,KOJA,TUGU UTARA,67670,16897,50773,39039,89812,2021-10-26
3175061006,JAKARTA TIMUR,CAKUNG,UJUNG MENTENG,29934,5529,24405,20186,44591,2021-10-26
3174101005,JAKARTA SELATAN,PESANGGRAHAN,ULUJAMI,40544,9737,30807,24530,55337,2021-10-26
3175011006,JAKARTA TIMUR,MATRAMAN,UTAN KAYU SELATAN,33511,6443,27068,21639,48707,2021-10-26
3175011002,JAKARTA TIMUR,MATRAMAN,UTAN KAYU UTARA,28169,6242,21927,17404,39331,2021-10-26
3171031008,JAKARTA PUSAT,KEMAYORAN,UTAN PANJANG,29208,6287,22921,17800,40721,2021-10-26
3172021007,JAKARTA UTARA,TANJUNG PRIOK,WARAKAS,44401,8603,35798,27954,63752,2021-10-26
3173021007,JAKARTA BARAT,GROGOL PETAMBURAN,WIJAYA KUSUMA,38934,8601,30333,24684,55017,2021-10-26
3172051003,JAKARTA UTARA,PADEMANGAN,ANCOL,23947,5487,18460,15381,33841,2021-10-27
3173041007,JAKARTA BARAT,TAMBORA,ANGKE,29381,5647,23734,19704,43438,2021-10-27
3175041005,JAKARTA TIMUR,KRAMAT JATI,BALE KAMBANG,29074,6603,22471,18193,40664,2021-10-27
3175031003,JAKARTA TIMUR,JATINEGARA,BALI MESTER,9752,1803,7949,6789,14738,2021-10-27
3175101006,JAKARTA TIMUR,CIPAYUNG,BAMBU APUS,26285,3653,22632,19625,42257,2021-10-27
3174031002,JAKARTA SELATAN,MAMPANG PRAPATAN,BANGKA,21566,3650,17916,14636,32552,2021-10-27
3175051002,JAKARTA TIMUR,PASAR REBO,BARU,23886,3460,20426,17555,37981,2021-10-27
3175041004,JAKARTA TIMUR,KRAMAT JATI,BATU AMPAR,47898,10437,37461,30882,68343,2021-10-27
3171071002,JAKARTA PUSAT,TANAH ABANG,BENDUNGAN HILIR,21494,3992,17502,15216,32718,2021-10-27
3175031002,JAKARTA TIMUR,JATINEGARA,BIDARA CINA,36689,7880,28809,23175,51984,2021-10-27
3174101002,JAKARTA SELATAN,PESANGGRAHAN,BINTARO,53098,9595,43503,37632,81135,2021-10-27
3174011005,JAKARTA SELATAN,TEBET,BUKIT DURI,34183,5935,28248,24241,52489,2021-10-27
3171041006,JAKARTA PUSAT,SENEN,BUNGUR,18144,3434,14710,12216,26926,2021-10-27
3175061007,JAKARTA TIMUR,CAKUNG,CAKUNG BARAT,57724,11256,46468,38448,84916,2021-10-27
3175061004,JAKARTA TIMUR,CAKUNG,CAKUNG TIMUR,58287,10289,47998,40499,88497,2021-10-27
3175041007,JAKARTA TIMUR,KRAMAT JATI,CAWANG,32762,6597,26165,21505,47670,2021-10-27
3175101008,JAKARTA TIMUR,CIPAYUNG,CEGER,18932,3217,15715,13314,29029,2021-10-27
3171031006,JAKARTA PUSAT,KEMAYORAN,CEMPAKA BARU,32581,5189,27392,21603,48995,2021-10-27
3171051002,JAKARTA PUSAT,CEMPAKA PUTIH,CEMPAKA PUTIH BARAT,35885,6532,29353,25347,54700,2021-10-27
3171051001,JAKARTA PUSAT,CEMPAKA PUTIH,CEMPAKA PUTIH TIMUR,24292,4400,19892,17489,37381,2021-10-27
3173011001,JAKARTA BARAT,CENGKARENG,CENGKARENG BARAT,66284,11408,54876,47237,102113,2021-10-27
3173011006,JAKARTA BARAT,CENGKARENG,CENGKARENG TIMUR,81027,14331,66696,56063,122759,2021-10-27
3175091002,JAKARTA TIMUR,CIRACAS,CIBUBUR,66364,9918,56446,47109,103555,2021-10-27
3171011002,JAKARTA PUSAT,GAMBIR,CIDENG,15390,2694,12696,11182,23878,2021-10-27
3174091003,JAKARTA SELATAN,JAGAKARSA,CIGANJUR,38497,5005,33492,27719,61211,2021-10-27
3175051003,JAKARTA TIMUR,PASAR REBO,CIJANTUNG,41419,6722,34697,29310,64007,2021-10-27
3171061003,JAKARTA PUSAT,MENTENG,CIKINI,8274,1361,6913,5589,12502,2021-10-27
3174081006,JAKARTA SELATAN,PANCORAN,CIKOKO,10547,1535,9012,8044,17056,2021-10-27
3174061001,JAKARTA SELATAN,CILANDAK,CILANDAK BARAT,51752,7300,44452,38244,82696,2021-10-27
3174041003,JAKARTA SELATAN,PASAR MINGGU,CILANDAK TIMUR,25145,3968,21177,18001,39178,2021-10-27
3175101002,JAKARTA TIMUR,CIPAYUNG,CILANGKAP,27635,4039,23596,19515,43111,2021-10-27
3175041006,JAKARTA TIMUR,KRAMAT JATI,CILILITAN,40181,7988,32193,26477,58670,2021-10-27
3172041001,JAKARTA UTARA,CILINCING,CILINCING,43609,9536,34073,26817,60890,2021-10-27
3175101001,JAKARTA TIMUR,CIPAYUNG,CIPAYUNG,26104,3896,22208,19220,41428,2021-10-27
3174091006,JAKARTA SELATAN,JAGAKARSA,CIPEDAK,38303,4728,33575,27535,61110,2021-10-27
3174061005,JAKARTA SELATAN,CILANDAK,CIPETE SELATAN,26704,4520,22184,20072,42256,2021-10-27
3174071010,JAKARTA SELATAN,KEBAYORAN BARU,CIPETE UTARA,34102,5633,28469,23913,52382,2021-10-27
3175021003,JAKARTA TIMUR,PULO GADUNG,CIPINANG,39306,6114,33192,28074,61266,2021-10-27
3175031007,JAKARTA TIMUR,JATINEGARA,CIPINANG BESAR SELATAN,35212,7389,27823,22023,49846,2021-10-27
3175031008,JAKARTA TIMUR,JATINEGARA,CIPINANG BESAR UTARA,45319,9320,35999,28221,64220,2021-10-27
3175031005,JAKARTA TIMUR,JATINEGARA,CIPINANG CEMPEDAK,32824,5966,26858,22518,49376,2021-10-27
3175081005,JAKARTA TIMUR,MAKASAR,CIPINANG MELAYU,42308,6921,35387,30094,65481,2021-10-27
3175031006,JAKARTA TIMUR,JATINEGARA,CIPINANG MUARA,55243,9935,45308,37342,82650,2021-10-27
3174051003,JAKARTA SELATAN,KEBAYORAN LAMA,CIPULIR,39937,7663,32274,27094,59368,2021-10-27
3175091001,JAKARTA TIMUR,CIRACAS,CIRACAS,64594,10269,54325,44503,98828,2021-10-27
3175041003,JAKARTA TIMUR,KRAMAT JATI,DUKUH,24609,4173,20436,17234,37670,2021-10-27
3175071001,JAKARTA TIMUR,DUREN SAWIT,DUREN SAWIT,61160,10666,50494,41543,92037,2021-10-27
3174081004,JAKARTA SELATAN,PANCORAN,DUREN TIGA,28319,5075,23244,21196,44440,2021-10-27
3173051005,JAKARTA BARAT,KEBON JERUK,DURI KEPA,60138,10486,49652,43401,93053,2021-10-27
3173011002,JAKARTA BARAT,CENGKARENG,DURI KOSAMBI,77923,13439,64484,51305,115789,2021-10-27
3171011006,JAKARTA PUSAT,GAMBIR,DURI PULO,19610,3861,15749,12731,28480,2021-10-27
3173041011,JAKARTA BARAT,TAMBORA,DURI SELATAN,14259,2165,12094,10387,22481,2021-10-27
3173041003,JAKARTA BARAT,TAMBORA,DURI UTARA,19844,2774,17070,14304,31374,2021-10-27
3171081003,JAKARTA PUSAT,JOHAR BARU,GALUR,18243,3240,15003,12137,27140,2021-10-27
3171011001,JAKARTA PUSAT,GAMBIR,GAMBIR,2191,435,1756,1557,3313,2021-10-27
3174061004,JAKARTA SELATAN,CILANDAK,GANDARIA SELATAN,22119,3536,18583,15750,34333,2021-10-27
3174071009,JAKARTA SELATAN,KEBAYORAN BARU,GANDARIA UTARA,39922,6817,33105,27959,61064,2021-10-27
3175051001,JAKARTA TIMUR,PASAR REBO,GEDONG,35755,6455,29300,25013,54313,2021-10-27
3171071001,JAKARTA PUSAT,TANAH ABANG,GELORA,3127,522,2605,2315,4920,2021-10-27
3173031007,JAKARTA BARAT,TAMAN SARI,GLODOK,7837,867,6970,6253,13223,2021-10-27
3171061004,JAKARTA PUSAT,MENTENG,GONDANGDIA,4100,876,3224,2976,6200,2021-10-27
3173021001,JAKARTA BARAT,GROGOL PETAMBURAN,GROGOL,16876,3063,13813,11852,25665,2021-10-27
3174051005,JAKARTA SELATAN,KEBAYORAN LAMA,GROGOL SELATAN,44251,7333,36918,30629,67547,2021-10-27
3174051004,JAKARTA SELATAN,KEBAYORAN LAMA,GROGOL UTARA,42494,7452,35042,29348,64390,2021-10-27
3174021007,JAKARTA SELATAN,SETIA BUDI,GUNTUR,3985,633,3352,2930,6282,2021-10-27
3174071002,JAKARTA SELATAN,KEBAYORAN BARU,GUNUNG,9436,1547,7889,7091,14980,2021-10-27
3171031005,JAKARTA PUSAT,KEMAYORAN,GUNUNG SAHARI SELATAN,19199,3326,15873,13436,29309,2021-10-27
3171021004,JAKARTA PUSAT,SAWAH BESAR,GUNUNG SAHARI UTARA,16650,2600,14050,12630,26680,2021-10-27
3175081004,JAKARTA TIMUR,MAKASAR,HALIM PERDANA KUSUMAH,28363,3257,25106,22998,48104,2021-10-27
3171031003,JAKARTA PUSAT,KEMAYORAN,HARAPAN MULIA,22557,4015,18542,15065,33607,2021-10-27
3174091001,JAKARTA SELATAN,JAGAKARSA,JAGAKARSA,62389,7122,55267,44595,99862,2021-10-27
3175021007,JAKARTA TIMUR,PULO GADUNG,JATI,32757,5133,27624,24267,51891,2021-10-27
3174041002,JAKARTA SELATAN,PASAR MINGGU,JATI PADANG,37502,6116,31386,26655,58041,2021-10-27
3173071004,JAKARTA BARAT,PALMERAH,JATI PULO,28738,5295,23443,18955,42398,2021-10-27
3175061001,JAKARTA TIMUR,CAKUNG,JATINEGARA,84160,16340,67820,56148,123968,2021-10-27
3175021004,JAKARTA TIMUR,PULO GADUNG,JATINEGARA KAUM,24632,3537,21095,17436,38531,2021-10-27
3173021004,JAKARTA BARAT,GROGOL PETAMBURAN,JELAMBAR,30266,4628,25638,22683,48321,2021-10-27
3173021006,JAKARTA BARAT,GROGOL PETAMBURAN,JELAMBAR BARU,38246,6156,32090,28398,60488,2021-10-27
3173041006,JAKARTA BARAT,TAMBORA,JEMBATAN BESI,29314,6250,23064,18503,41567,2021-10-27
3173041008,JAKARTA BARAT,TAMBORA,JEMBATAN LIMA,21021,4512,16509,13380,29889,2021-10-27
3173081005,JAKARTA BARAT,KEMBANGAN,JOGLO,40839,7529,33310,28854,62164,2021-10-27
3171081001,JAKARTA PUSAT,JOHAR BARU,JOHAR BARU,37488,6139,31349,26999,58348,2021-10-27
3173041002,JAKARTA BARAT,TAMBORA,KALI ANYAR,23856,4147,19709,16040,35749,2021-10-27
3172041004,JAKARTA UTARA,CILINCING,KALIBARU,67684,16410,51274,36889,88163,2021-10-27
3174081002,JAKARTA SELATAN,PANCORAN,KALIBATA,41994,7924,34070,29356,63426,2021-10-27
3173061001,JAKARTA BARAT,KALI DERES,KALIDERES,72447,13552,58895,50686,109581,2021-10-27
3175051004,JAKARTA TIMUR,PASAR REBO,KALISARI,43212,6396,36816,30889,67705,2021-10-27
3173061004,JAKARTA BARAT,KALI DERES,KAMAL,53783,11344,42439,34152,76591,2021-10-27
3172011002,JAKARTA UTARA,PENJARINGAN,KAMAL MUARA,12930,2188,10742,9274,20016,2021-10-27
3171071007,JAKARTA PUSAT,TANAH ABANG,KAMPUNG BALI,11358,2185,9173,7094,16267,2021-10-27
3175031001,JAKARTA TIMUR,JATINEGARA,KAMPUNG MELAYU,25717,4106,21611,16945,38556,2021-10-27
3171081002,JAKARTA PUSAT,JOHAR BARU,KAMPUNG RAWA,21237,3215,18022,14588,32610,2021-10-27
3175041002,JAKARTA TIMUR,KRAMAT JATI,KAMPUNG TENGAH,43993,10031,33962,27553,61515,2021-10-27
3173011005,JAKARTA BARAT,CENGKARENG,KAPUK,134466,29736,104730,86302,191032,2021-10-27
3172011003,JAKARTA UTARA,PENJARINGAN,KAPUK MUARA,35781,6320,29461,25980,55441,2021-10-27
3171021002,JAKARTA PUSAT,SAWAH BESAR,KARANG ANYAR,25761,4598,21163,18325,39488,2021-10-27
3174021004,JAKARTA SELATAN,SETIA BUDI,KARET,9623,1614,8009,6741,14750,2021-10-27
3174021003,JAKARTA SELATAN,SETIA BUDI,KARET KUNINGAN,16055,2804,13251,11217,24468,2021-10-27
3174021002,JAKARTA SELATAN,SETIA BUDI,KARET SEMANGGI,2770,515,2255,2035,4290,2021-10-27
3171071003,JAKARTA PUSAT,TANAH ABANG,KARET TENGSIN,19271,3295,15976,13137,29113,2021-10-27
3171021003,JAKARTA PUSAT,SAWAH BESAR,KARTINI,22292,3727,18565,16262,34827,2021-10-27
3175011003,JAKARTA TIMUR,MATRAMAN,KAYU MANIS,25284,4557,20727,16679,37406,2021-10-27
3175021006,JAKARTA TIMUR,PULO GADUNG,KAYU PUTIH,40696,6603,34093,30172,64265,2021-10-27
3173031006,JAKARTA BARAT,TAMAN SARI,KEAGUNGAN,17387,2403,14984,12044,27028,2021-10-27
3174041007,JAKARTA SELATAN,PASAR MINGGU,KEBAGUSAN,44552,6802,37750,31437,69187,2021-10-27
3174051006,JAKARTA SELATAN,KEBAYORAN LAMA,KEBAYORAN LAMA SELATAN,41212,6787,34425,29226,63651,2021-10-27
3174051001,JAKARTA SELATAN,KEBAYORAN LAMA,KEBAYORAN LAMA UTARA,42422,7693,34729,28445,63174,2021-10-27
3174011004,JAKARTA SELATAN,TEBET,KEBON BARU,35165,5512,29653,25384,55037,2021-10-27
3172021005,JAKARTA UTARA,TANJUNG PRIOK,KEBON BAWANG,50952,9300,41652,35080,76732,2021-10-27
3173051001,JAKARTA BARAT,KEBON JERUK,KEBON JERUK,53887,9809,44078,36710,80788,2021-10-27
3171071006,JAKARTA PUSAT,TANAH ABANG,KEBON KACANG,21531,4497,17034,13452,30486,2021-10-27
3171011005,JAKARTA PUSAT,GAMBIR,KEBON KELAPA,10163,1798,8365,7077,15442,2021-10-27
3171031002,JAKARTA PUSAT,KEMAYORAN,KEBON KOSONG,30019,4816,25203,20516,45719,2021-10-27
3175011005,JAKARTA TIMUR,MATRAMAN,KEBON MANGGIS,16490,2912,13578,11439,25017,2021-10-27
3171071005,JAKARTA PUSAT,TANAH ABANG,KEBON MELATI,32206,8176,24030,17972,42002,2021-10-27
3175081003,JAKARTA TIMUR,MAKASAR,KEBON PALA,46614,7840,38774,32486,71260,2021-10-27
3171061005,JAKARTA PUSAT,MENTENG,KEBON SIRIH,12299,2466,9833,7989,17822,2021-10-27
3173011004,JAKARTA BARAT,CENGKARENG,KEDAUNG KALI ANGKE,32612,5849,26763,22976,49739,2021-10-27
3173051007,JAKARTA BARAT,KEBON JERUK,KEDOYA SELATAN,32165,4682,27483,23036,50519,2021-10-27
3173051006,JAKARTA BARAT,KEBON JERUK,KEDOYA UTARA,45740,7457,38283,32498,70781,2021-10-27
3173051004,JAKARTA BARAT,KEBON JERUK,KELAPA DUA,23565,3683,19882,16652,36534,2021-10-27
3175091003,JAKARTA TIMUR,CIRACAS,KELAPA DUA WETAN,46875,6941,39934,33695,73629,2021-10-27
3172061003,JAKARTA UTARA,KELAPA GADING,KELAPA GADING BARAT,35717,5806,29911,27096,57007,2021-10-27
3172061001,JAKARTA UTARA,KELAPA GADING,KELAPA GADING TIMUR,33592,4558,29034,27223,56257,2021-10-27
3173071005,JAKARTA BARAT,PALMERAH,KEMANGGISAN,32139,4952,27187,22912,50099,2021-10-27
3171031001,JAKARTA PUSAT,KEMAYORAN,KEMAYORAN,20708,3839,16869,14117,30986,2021-10-27
3173081006,JAKARTA BARAT,KEMBANGAN,KEMBANGAN SELATAN,27130,5212,21918,19241,41159,2021-10-27
3173081001,JAKARTA BARAT,KEMBANGAN,KEMBANGAN UTARA,54451,10928,43523,36888,80411,2021-10-27
3171041002,JAKARTA PUSAT,SENEN,KENARI,9579,1716,7863,6782,14645,2021-10-27
3173041005,JAKARTA BARAT,TAMBORA,KERENDANG,19973,3493,16480,13706,30186,2021-10-27
3175071003,JAKARTA TIMUR,DUREN SAWIT,KLENDER,69978,14109,55869,44750,100619,2021-10-27
3172031001,JAKARTA UTARA,KOJA,KOJA,28175,5482,22693,18383,41076,2021-10-27
3173071006,JAKARTA BARAT,PALMERAH,KOTA BAMBU SELATAN,21158,3661,17497,13811,31308,2021-10-27
3173071003,JAKARTA BARAT,PALMERAH,KOTA BAMBU UTARA,24995,5053,19942,15910,35852,2021-10-27
3171041004,JAKARTA PUSAT,SENEN,KRAMAT,28835,6512,22323,17298,39621,2021-10-27
3175041001,JAKARTA TIMUR,KRAMAT JATI,KRAMAT JATI,34144,6705,27439,22567,50006,2021-10-27
3174071003,JAKARTA SELATAN,KEBAYORAN BARU,KRAMAT PELA,14413,2526,11887,10118,22005,2021-10-27
3173031002,JAKARTA BARAT,TAMAN SARI,KRUKUT,19244,2670,16574,13503,30077,2021-10-27
3174031005,JAKARTA SELATAN,MAMPANG PRAPATAN,KUNINGAN BARAT,12785,1995,10790,9226,20016,2021-10-27
3174021008,JAKARTA SELATAN,SETIA BUDI,KUNINGAN TIMUR,6008,1064,4944,4149,9093,2021-10-27
3171041005,JAKARTA PUSAT,SENEN,KWITANG,15486,3356,12130,10032,22162,2021-10-27
3172031003,JAKARTA UTARA,KOJA,LAGOA,59065,12365,46700,37878,84578,2021-10-27
3174061002,JAKARTA SELATAN,CILANDAK,LEBAK BULUS,37626,6085,31541,27974,59515,2021-10-27
3174091004,JAKARTA SELATAN,JAGAKARSA,LENTENG AGUNG,53946,7174,46772,38213,84985,2021-10-27
3175101007,JAKARTA TIMUR,CIPAYUNG,LUBANG BUAYA,63547,10487,53060,44139,97199,2021-10-27
3175081001,JAKARTA TIMUR,MAKASAR,MAKASAR,34390,5123,29267,24911,54178,2021-10-27
3175071006,JAKARTA TIMUR,DUREN SAWIT,MALAKA JAYA,30927,4181,26746,22641,49387,2021-10-27
3175071005,JAKARTA TIMUR,DUREN SAWIT,MALAKA SARI,27530,3824,23706,20500,44206,2021-10-27
3174031001,JAKARTA SELATAN,MAMPANG PRAPATAN,MAMPANG PRAPATAN,18159,3078,15081,12214,27295,2021-10-27
3173031005,JAKARTA BARAT,TAMAN SARI,MANGGA BESAR,7707,1158,6549,5861,12410,2021-10-27
3171021005,JAKARTA PUSAT,SAWAH BESAR,MANGGA DUA SELATAN,27442,5439,22003,19137,41140,2021-10-27
3174011007,JAKARTA SELATAN,TEBET,MANGGARAI,28373,4343,24030,19647,43677,2021-10-27
3174011006,JAKARTA SELATAN,TEBET,MANGGARAI SELATAN,23075,3610,19465,16622,36087,2021-10-27
3173031003,JAKARTA BARAT,TAMAN SARI,MAPHAR,16461,2483,13978,11653,25631,2021-10-27
3172041003,JAKARTA UTARA,CILINCING,MARUNDA,28943,6020,22923,17518,40441,2021-10-27
3174071001,JAKARTA SELATAN,KEBAYORAN BARU,MELAWAI,2627,473,2154,2025,4179,2021-10-27
3171061001,JAKARTA PUSAT,MENTENG,MENTENG,25624,5216,20408,16068,36476,2021-10-27
3174021005,JAKARTA SELATAN,SETIA BUDI,MENTENG ATAS,27816,4463,23353,19432,42785,2021-10-27
3174011003,JAKARTA SELATAN,TEBET,MENTENG DALAM,36028,6024,30004,25419,55423,2021-10-27
3173081003,JAKARTA BARAT,KEMBANGAN,MERUYA SELATAN,32130,5666,26464,22340,48804,2021-10-27
3173081002,JAKARTA BARAT,KEMBANGAN,MERUYA UTARA,43752,7361,36391,31692,68083,2021-10-27
3175101004,JAKARTA TIMUR,CIPAYUNG,MUNJUL,23871,3455,20416,17034,37450,2021-10-27
3172051002,JAKARTA UTARA,PADEMANGAN,PADEMANGAN BARAT,74240,16054,58186,47591,105777,2021-10-27
3172051001,JAKARTA UTARA,PADEMANGAN,PADEMANGAN TIMUR,37736,5931,31805,28104,59909,2021-10-27
3175011004,JAKARTA TIMUR,MATRAMAN,PAL MERIAM,19769,3224,16545,13201,29746,2021-10-27
3173071001,JAKARTA BARAT,PALMERAH,PALMERAH,63011,10774,52237,42048,94285,2021-10-27
3174081001,JAKARTA SELATAN,PANCORAN,PANCORAN,19421,3379,16042,13713,29755,2021-10-27
3172021003,JAKARTA UTARA,TANJUNG PRIOK,PAPANGGO,39097,6977,32120,26452,58572,2021-10-27
3171021001,JAKARTA PUSAT,SAWAH BESAR,PASAR BARU,12035,2124,9911,8942,18853,2021-10-27
3174021006,JAKARTA SELATAN,SETIA BUDI,PASAR MANGGIS,26752,4601,22151,18349,40500,2021-10-27
3174041001,JAKARTA SELATAN,PASAR MINGGU,PASAR MINGGU,24821,3976,20845,17906,38751,2021-10-27
3171041003,JAKARTA PUSAT,SENEN,PASEBAN,23533,4533,19000,16042,35042,2021-10-27
3173061005,JAKARTA BARAT,KALI DERES,PEGADUNGAN,75587,14075,61512,53802,115314,2021-10-27
3171061002,JAKARTA PUSAT,MENTENG,PEGANGSAAN,23455,3911,19544,14730,34274,2021-10-27
3172061002,JAKARTA UTARA,KELAPA GADING,PEGANGSAAN DUA,49976,7592,42384,38793,81177,2021-10-27
3172011004,JAKARTA UTARA,PENJARINGAN,PEJAGALAN,74578,13951,60627,52447,113074,2021-10-27
3174041006,JAKARTA SELATAN,PASAR MINGGU,PEJATEN BARAT,37346,6024,31322,26472,57794,2021-10-27
3174041005,JAKARTA SELATAN,PASAR MINGGU,PEJATEN TIMUR,57656,11578,46078,39449,85527,2021-10-27
3175051005,JAKARTA TIMUR,PASAR REBO,PEKAYON,43250,6701,36549,30386,66935,2021-10-27
3173041009,JAKARTA BARAT,TAMBORA,PEKOJAN,23587,3909,19678,16805,36483,2021-10-27
3174031003,JAKARTA SELATAN,MAMPANG PRAPATAN,PELA MAMPANG,43522,7220,36302,30335,66637,2021-10-27
3174081005,JAKARTA SELATAN,PANCORAN,PENGADEGAN,21478,3501,17977,16210,34187,2021-10-27
3175061003,JAKARTA TIMUR,CAKUNG,PENGGILINGAN,99255,20490,78765,65014,143779,2021-10-27
3172011001,JAKARTA UTARA,PENJARINGAN,PENJARINGAN,88308,21343,66965,52150,119115,2021-10-27
3174101001,JAKARTA SELATAN,PESANGGRAHAN,PESANGGRAHAN,27545,4174,23371,20257,43628,2021-10-27
3171071004,JAKARTA PUSAT,TANAH ABANG,PETAMBURAN,33271,8074,25197,19579,44776,2021-10-27
3174071008,JAKARTA SELATAN,KEBAYORAN BARU,PETOGOGAN,11499,2001,9498,8368,17866,2021-10-27
3171011004,JAKARTA PUSAT,GAMBIR,PETOJO SELATAN,14692,3008,11684,10091,21775,2021-10-27
3171011003,JAKARTA PUSAT,GAMBIR,PETOJO UTARA,17458,3463,13995,11687,25682,2021-10-27
3174101004,JAKARTA SELATAN,PESANGGRAHAN,PETUKANGAN SELATAN,37187,6731,30456,25522,55978,2021-10-27
3174101003,JAKARTA SELATAN,PESANGGRAHAN,PETUKANGAN UTARA,53716,10435,43281,36109,79390,2021-10-27
3175081002,JAKARTA TIMUR,MAKASAR,PINANG RANTI,27198,5371,21827,18196,40023,2021-10-27
3173031008,JAKARTA BARAT,TAMAN SARI,PINANGSIA,10729,1559,9170,7573,16743,2021-10-27
3175011001,JAKARTA TIMUR,MATRAMAN,PISANGAN BARU,31776,5437,26339,21627,47966,2021-10-27
3175021002,JAKARTA TIMUR,PULO GADUNG,PISANGAN TIMUR,41011,6646,34365,29255,63620,2021-10-27
3172011005,JAKARTA UTARA,PENJARINGAN,PLUIT,47783,8081,39702,34628,74330,2021-10-27
3175071002,JAKARTA TIMUR,DUREN SAWIT,PONDOK BAMBU,61550,10711,50839,41290,92129,2021-10-27
3175071004,JAKARTA TIMUR,DUREN SAWIT,PONDOK KELAPA,72015,12395,59620,51575,111195,2021-10-27
3175071007,JAKARTA TIMUR,DUREN SAWIT,PONDOK KOPI,35367,4211,31156,23889,55045,2021-10-27
3174061003,JAKARTA SELATAN,CILANDAK,PONDOK LABU,46464,6967,39497,35342,74839,2021-10-27
3174051002,JAKARTA SELATAN,KEBAYORAN LAMA,PONDOK PINANG,56169,9460,46709,41606,88315,2021-10-27
3175101003,JAKARTA TIMUR,CIPAYUNG,PONDOK RANGGON,25574,3906,21668,17573,39241,2021-10-27
3101011003,KAB.ADM.KEP.SERIBU,KEP. SERIBU UTARA,PULAU HARAPAN,2060,186,1874,1753,3627,2021-10-27
3101011002,KAB.ADM.KEP.SERIBU,KEP. SERIBU UTARA,PULAU KELAPA,5528,575,4953,4662,9615,2021-10-27
3101011001,KAB.ADM.KEP.SERIBU,KEP. SERIBU UTARA,PULAU PANGGANG,5450,332,5118,5289,10407,2021-10-27
3101021003,KAB.ADM.KEP.SERIBU,KEP. SERIBU SELATAN,PULAU PARI,2765,181,2584,2494,5078,2021-10-27
3101021002,KAB.ADM.KEP.SERIBU,KEP. SERIBU SELATAN,PULAU TIDUNG,4553,346,4207,3962,8169,2021-10-27
3101021001,KAB.ADM.KEP.SERIBU,KEP. SERIBU SELATAN,PULAU UNTUNG JAWA,1941,113,1828,1733,3561,2021-10-27
3174071007,JAKARTA SELATAN,KEBAYORAN BARU,PULO,5835,903,4932,4556,9488,2021-10-27
3175021001,JAKARTA TIMUR,PULO GADUNG,PULO GADUNG,34422,7051,27371,23206,50577,2021-10-27
3175061005,JAKARTA TIMUR,CAKUNG,PULO GEBANG,97301,16515,80786,67514,148300,2021-10-27
3174041004,JAKARTA SELATAN,PASAR MINGGU,RAGUNAN,39616,6118,33498,29037,62535,2021-10-27
3175091005,JAKARTA TIMUR,CIRACAS,RAMBUTAN,36771,7627,29144,22957,52101,2021-10-27
3172031006,JAKARTA UTARA,KOJA,RAWA BADAK SELATAN,42179,8912,33267,26861,60128,2021-10-27
3172031004,JAKARTA UTARA,KOJA,RAWA BADAK UTARA,34408,6685,27723,22447,50170,2021-10-27
3174071005,JAKARTA SELATAN,KEBAYORAN BARU,RAWA BARAT,5625,863,4762,4368,9130,2021-10-27
3173011003,JAKARTA BARAT,CENGKARENG,RAWA BUAYA,63799,11214,52585,43582,96167,2021-10-27
3175031004,JAKARTA TIMUR,JATINEGARA,RAWA BUNGA,21434,4696,16738,13698,30436,2021-10-27
3174081003,JAKARTA SELATAN,PANCORAN,RAWA JATI,20509,3228,17281,15596,32877,2021-10-27
3175061002,JAKARTA TIMUR,CAKUNG,RAWA TERATE,24637,4090,20547,16792,37339,2021-10-27
3175021005,JAKARTA TIMUR,PULO GADUNG,RAWAMANGUN,37612,6423,31189,26937,58126,2021-10-27
3171051003,JAKARTA PUSAT,CEMPAKA PUTIH,RAWASARI,21967,3883,18084,15532,33616,2021-10-27
3173041010,JAKARTA BARAT,TAMBORA,ROA MALAKA,3484,550,2934,2645,5579,2021-10-27
3172041006,JAKARTA UTARA,CILINCING,ROROTAN,41668,7248,34420,27538,61958,2021-10-27
3174071004,JAKARTA SELATAN,KEBAYORAN BARU,SELONG,2842,501,2341,2255,4596,2021-10-27
3173061002,JAKARTA BARAT,KALI DERES,SEMANAN,71354,14447,56907,46633,103540,2021-10-27
3172041007,JAKARTA UTARA,CILINCING,SEMPER BARAT,68587,12011,56576,46970,103546,2021-10-27
3172041005,JAKARTA UTARA,CILINCING,SEMPER TIMUR,36267,7102,29165,23990,53155,2021-10-27
3174071006,JAKARTA SELATAN,KEBAYORAN BARU,SENAYAN,2771,600,2171,1920,4091,2021-10-27
3171041001,JAKARTA PUSAT,SENEN,SENEN,6804,1360,5444,4518,9962,2021-10-27
3171031004,JAKARTA PUSAT,KEMAYORAN,SERDANG,29668,5152,24516,20845,45361,2021-10-27
3174021001,JAKARTA SELATAN,SETIA BUDI,SETIA BUDI,3023,496,2527,2109,4636,2021-10-27
3175101005,JAKARTA TIMUR,CIPAYUNG,SETU,20572,3278,17294,13953,31247,2021-10-27
3173071002,JAKARTA BARAT,PALMERAH,SLIPI,16591,2604,13987,11821,25808,2021-10-27
3173081004,JAKARTA BARAT,KEMBANGAN,SRENGSENG,45523,9125,36398,31656,68054,2021-10-27
3174091002,JAKARTA SELATAN,JAGAKARSA,SRENGSENG SAWAH,58196,6790,51406,43066,94472,2021-10-27
3173051003,JAKARTA BARAT,KEBON JERUK,SUKABUMI SELATAN,37033,6962,30071,23261,53332,2021-10-27
3173051002,JAKARTA BARAT,KEBON JERUK,SUKABUMI UTARA,38290,7946,30344,24541,54885,2021-10-27
3172041002,JAKARTA UTARA,CILINCING,SUKAPURA,53949,11144,42805,35317,78122,2021-10-27
3171031007,JAKARTA PUSAT,KEMAYORAN,SUMUR BATU,22717,4016,18701,16138,34839,2021-10-27
3172021004,JAKARTA UTARA,TANJUNG PRIOK,SUNGAI BAMBU,29876,5239,24637,20499,45136,2021-10-27
3172021006,JAKARTA UTARA,TANJUNG PRIOK,SUNTER AGUNG,71805,11120,60685,53292,113977,2021-10-27
3172021002,JAKARTA UTARA,TANJUNG PRIOK,SUNTER JAYA,63031,9501,53530,46399,99929,2021-10-27
3175091004,JAKARTA TIMUR,CIRACAS,SUSUKAN,38257,6408,31849,26490,58339,2021-10-27
3173031001,JAKARTA BARAT,TAMAN SARI,TAMAN SARI,14348,2298,12050,10580,22630,2021-10-27
3173041001,JAKARTA BARAT,TAMBORA,TAMBORA,10204,2019,8185,6769,14954,2021-10-27
3173041004,JAKARTA BARAT,TAMBORA,TANAH SEREAL,26387,4014,22373,19221,41594,2021-10-27
3171081004,JAKARTA PUSAT,JOHAR BARU,TANAH TINGGI,37693,6642,31051,25601,56652,2021-10-27
3173031004,JAKARTA BARAT,TAMAN SARI,TANGKI,13324,1747,11577,9983,21560,2021-10-27
3174091005,JAKARTA SELATAN,JAGAKARSA,TANJUNG BARAT,39770,5056,34714,28439,63153,2021-10-27
3173021005,JAKARTA BARAT,GROGOL PETAMBURAN,TANJUNG DUREN SELATAN,25337,4240,21097,18932,40029,2021-10-27
3173021002,JAKARTA BARAT,GROGOL PETAMBURAN,TANJUNG DUREN UTARA,17010,2355,14655,13329,27984,2021-10-27
3172021001,JAKARTA UTARA,TANJUNG PRIOK,TANJUNG PRIOK,34588,6490,28098,23093,51191,2021-10-27
3174011002,JAKARTA SELATAN,TEBET,TEBET BARAT,21194,3002,18192,16405,34597,2021-10-27
3174011001,JAKARTA SELATAN,TEBET,TEBET TIMUR,18199,2519,15680,14477,30157,2021-10-27
3173061003,JAKARTA BARAT,KALI DERES,TEGAL ALUR,83647,15413,68234,57523,125757,2021-10-27
3174031004,JAKARTA SELATAN,MAMPANG PRAPATAN,TEGAL PARANG,32401,5970,26431,20542,46973,2021-10-27
3173021003,JAKARTA BARAT,GROGOL PETAMBURAN,TOMANG,29605,4858,24747,21531,46278,2021-10-27
3172031005,JAKARTA UTARA,KOJA,TUGU SELATAN,39122,7855,31267,26168,57435,2021-10-27
3172031002,JAKARTA UTARA,KOJA,TUGU UTARA,67670,14368,53302,42752,96054,2021-10-27
3175061006,JAKARTA TIMUR,CAKUNG,UJUNG MENTENG,29934,4779,25155,21707,46862,2021-10-27
3174101005,JAKARTA SELATAN,PESANGGRAHAN,ULUJAMI,40544,8049,32495,27120,59615,2021-10-27
3175011006,JAKARTA TIMUR,MATRAMAN,UTAN KAYU SELATAN,33511,4979,28532,24034,52566,2021-10-27
3175011002,JAKARTA TIMUR,MATRAMAN,UTAN KAYU UTARA,28169,5075,23094,19062,42156,2021-10-27
3171031008,JAKARTA PUSAT,KEMAYORAN,UTAN PANJANG,29208,4980,24228,19632,43860,2021-10-27
3172021007,JAKARTA UTARA,TANJUNG PRIOK,WARAKAS,44401,6996,37405,30282,67687,2021-10-27
3173021007,JAKARTA BARAT,GROGOL PETAMBURAN,WIJAYA KUSUMA,38934,6964,31970,27115,59085,2021-10-27
3172051003,JAKARTA UTARA,PADEMANGAN,ANCOL,23947,6048,17899,14409,32308,2021-10-28
3173041007,JAKARTA BARAT,TAMBORA,ANGKE,29381,6627,22754,18038,40792,2021-10-28
3175041005,JAKARTA TIMUR,KRAMAT JATI,BALE KAMBANG,29074,7668,21406,16180,37586,2021-10-28
3175031003,JAKARTA TIMUR,JATINEGARA,BALI MESTER,9752,2155,7597,6197,13794,2021-10-28
3175101006,JAKARTA TIMUR,CIPAYUNG,BAMBU APUS,26285,5072,21213,17156,38369,2021-10-28
3174031002,JAKARTA SELATAN,MAMPANG PRAPATAN,BANGKA,21566,4820,16746,13402,30148,2021-10-28
3175051002,JAKARTA TIMUR,PASAR REBO,BARU,23886,4134,19752,16582,36334,2021-10-28
3175041004,JAKARTA TIMUR,KRAMAT JATI,BATU AMPAR,47898,12329,35569,27620,63189,2021-10-28
3171071002,JAKARTA PUSAT,TANAH ABANG,BENDUNGAN HILIR,21494,4548,16946,14014,30960,2021-10-28
3175031002,JAKARTA TIMUR,JATINEGARA,BIDARA CINA,36689,9228,27461,21179,48640,2021-10-28
3174101002,JAKARTA SELATAN,PESANGGRAHAN,BINTARO,53098,11189,41909,34969,76878,2021-10-28
3174011005,JAKARTA SELATAN,TEBET,BUKIT DURI,34183,7372,26811,21750,48561,2021-10-28
3171041006,JAKARTA PUSAT,SENEN,BUNGUR,18144,4021,14123,11482,25605,2021-10-28
3175061007,JAKARTA TIMUR,CAKUNG,CAKUNG BARAT,57724,12538,45186,36517,81703,2021-10-28
3175061004,JAKARTA TIMUR,CAKUNG,CAKUNG TIMUR,58287,12112,46175,37437,83612,2021-10-28
3175041007,JAKARTA TIMUR,KRAMAT JATI,CAWANG,32762,7570,25192,19545,44737,2021-10-28
3175101008,JAKARTA TIMUR,CIPAYUNG,CEGER,18932,3895,15037,12217,27254,2021-10-28
3171031006,JAKARTA PUSAT,KEMAYORAN,CEMPAKA BARU,32581,6914,25667,19707,45374,2021-10-28
3171051002,JAKARTA PUSAT,CEMPAKA PUTIH,CEMPAKA PUTIH BARAT,35885,7989,27896,23029,50925,2021-10-28
3171051001,JAKARTA PUSAT,CEMPAKA PUTIH,CEMPAKA PUTIH TIMUR,24292,5191,19101,16104,35205,2021-10-28
3173011001,JAKARTA BARAT,CENGKARENG,CENGKARENG BARAT,66284,14114,52170,42881,95051,2021-10-28
3173011006,JAKARTA BARAT,CENGKARENG,CENGKARENG TIMUR,81027,16903,64124,51301,115425,2021-10-28
3175091002,JAKARTA TIMUR,CIRACAS,CIBUBUR,66364,11958,54406,44130,98536,2021-10-28
3171011002,JAKARTA PUSAT,GAMBIR,CIDENG,15390,3115,12275,10448,22723,2021-10-28
3174091003,JAKARTA SELATAN,JAGAKARSA,CIGANJUR,38497,6967,31530,25026,56556,2021-10-28
3175051003,JAKARTA TIMUR,PASAR REBO,CIJANTUNG,41419,8079,33340,27046,60386,2021-10-28
3171061003,JAKARTA PUSAT,MENTENG,CIKINI,8274,1542,6732,5164,11896,2021-10-28
3174081006,JAKARTA SELATAN,PANCORAN,CIKOKO,10547,1904,8643,7281,15924,2021-10-28
3174061001,JAKARTA SELATAN,CILANDAK,CILANDAK BARAT,51752,9694,42058,35298,77356,2021-10-28
3174041003,JAKARTA SELATAN,PASAR MINGGU,CILANDAK TIMUR,25145,4914,20231,16740,36971,2021-10-28
3175101002,JAKARTA TIMUR,CIPAYUNG,CILANGKAP,27635,5138,22497,18156,40653,2021-10-28
3175041006,JAKARTA TIMUR,KRAMAT JATI,CILILITAN,40181,9510,30671,24122,54793,2021-10-28
3172041001,JAKARTA UTARA,CILINCING,CILINCING,43609,10950,32659,24662,57321,2021-10-28
3175101001,JAKARTA TIMUR,CIPAYUNG,CIPAYUNG,26104,4760,21344,17874,39218,2021-10-28
3174091006,JAKARTA SELATAN,JAGAKARSA,CIPEDAK,38303,6723,31580,25547,57127,2021-10-28
3174061005,JAKARTA SELATAN,CILANDAK,CIPETE SELATAN,26704,5392,21312,18097,39409,2021-10-28
3174071010,JAKARTA SELATAN,KEBAYORAN BARU,CIPETE UTARA,34102,6802,27300,21787,49087,2021-10-28
3175021003,JAKARTA TIMUR,PULO GADUNG,CIPINANG,39306,7749,31557,25403,56960,2021-10-28
3175031007,JAKARTA TIMUR,JATINEGARA,CIPINANG BESAR SELATAN,35212,8730,26482,20025,46507,2021-10-28
3175031008,JAKARTA TIMUR,JATINEGARA,CIPINANG BESAR UTARA,45319,11262,34057,25553,59610,2021-10-28
3175031005,JAKARTA TIMUR,JATINEGARA,CIPINANG CEMPEDAK,32824,7484,25340,20572,45912,2021-10-28
3175081005,JAKARTA TIMUR,MAKASAR,CIPINANG MELAYU,42308,8573,33735,27670,61405,2021-10-28
3175031006,JAKARTA TIMUR,JATINEGARA,CIPINANG MUARA,55243,12440,42803,33728,76531,2021-10-28
3174051003,JAKARTA SELATAN,KEBAYORAN LAMA,CIPULIR,39937,8897,31040,24382,55422,2021-10-28
3175091001,JAKARTA TIMUR,CIRACAS,CIRACAS,64594,12423,52171,41514,93685,2021-10-28
3175041003,JAKARTA TIMUR,KRAMAT JATI,DUKUH,24609,4893,19716,15752,35468,2021-10-28
3175071001,JAKARTA TIMUR,DUREN SAWIT,DUREN SAWIT,61160,13552,47608,37807,85415,2021-10-28
3174081004,JAKARTA SELATAN,PANCORAN,DUREN TIGA,28319,5943,22376,18056,40432,2021-10-28
3173051005,JAKARTA BARAT,KEBON JERUK,DURI KEPA,60138,12337,47801,40458,88259,2021-10-28
3173011002,JAKARTA BARAT,CENGKARENG,DURI KOSAMBI,77923,17625,60298,46723,107021,2021-10-28
3171011006,JAKARTA PUSAT,GAMBIR,DURI PULO,19610,4369,15241,11918,27159,2021-10-28
3173041011,JAKARTA BARAT,TAMBORA,DURI SELATAN,14259,2661,11598,9568,21166,2021-10-28
3173041003,JAKARTA BARAT,TAMBORA,DURI UTARA,19844,3798,16046,12877,28923,2021-10-28
3171081003,JAKARTA PUSAT,JOHAR BARU,GALUR,18243,3748,14495,11448,25943,2021-10-28
3171011001,JAKARTA PUSAT,GAMBIR,GAMBIR,2191,477,1714,1451,3165,2021-10-28
3174061004,JAKARTA SELATAN,CILANDAK,GANDARIA SELATAN,22119,4480,17639,14416,32055,2021-10-28
3174071009,JAKARTA SELATAN,KEBAYORAN BARU,GANDARIA UTARA,39922,8390,31532,25571,57103,2021-10-28
3175051001,JAKARTA TIMUR,PASAR REBO,GEDONG,35755,7499,28256,23159,51415,2021-10-28
3171071001,JAKARTA PUSAT,TANAH ABANG,GELORA,3127,638,2489,2094,4583,2021-10-28
3173031007,JAKARTA BARAT,TAMAN SARI,GLODOK,7837,1247,6590,5777,12367,2021-10-28
3171061004,JAKARTA PUSAT,MENTENG,GONDANGDIA,4100,950,3150,2828,5978,2021-10-28
3173021001,JAKARTA BARAT,GROGOL PETAMBURAN,GROGOL,16876,3544,13332,10956,24288,2021-10-28
3174051005,JAKARTA SELATAN,KEBAYORAN LAMA,GROGOL SELATAN,44251,9465,34786,27762,62548,2021-10-28
3174051004,JAKARTA SELATAN,KEBAYORAN LAMA,GROGOL UTARA,42494,9108,33386,26919,60305,2021-10-28
3174021007,JAKARTA SELATAN,SETIA BUDI,GUNTUR,3985,780,3205,2757,5962,2021-10-28
3174071002,JAKARTA SELATAN,KEBAYORAN BARU,GUNUNG,9436,1834,7602,6506,14108,2021-10-28
3171031005,JAKARTA PUSAT,KEMAYORAN,GUNUNG SAHARI SELATAN,19199,4079,15120,12390,27510,2021-10-28
3171021004,JAKARTA PUSAT,SAWAH BESAR,GUNUNG SAHARI UTARA,16650,3069,13581,11803,25384,2021-10-28
3175081004,JAKARTA TIMUR,MAKASAR,HALIM PERDANA KUSUMAH,28363,3907,24456,21993,46449,2021-10-28
3171031003,JAKARTA PUSAT,KEMAYORAN,HARAPAN MULIA,22557,4817,17740,13962,31702,2021-10-28
3174091001,JAKARTA SELATAN,JAGAKARSA,JAGAKARSA,62389,11025,51364,41135,92499,2021-10-28
3175021007,JAKARTA TIMUR,PULO GADUNG,JATI,32757,6433,26324,22099,48423,2021-10-28
3174041002,JAKARTA SELATAN,PASAR MINGGU,JATI PADANG,37502,7889,29613,24214,53827,2021-10-28
3173071004,JAKARTA BARAT,PALMERAH,JATI PULO,28738,6063,22675,17706,40381,2021-10-28
3175061001,JAKARTA TIMUR,CAKUNG,JATINEGARA,84160,18953,65207,52280,117487,2021-10-28
3175021004,JAKARTA TIMUR,PULO GADUNG,JATINEGARA KAUM,24632,4645,19987,15656,35643,2021-10-28
3173021004,JAKARTA BARAT,GROGOL PETAMBURAN,JELAMBAR,30266,5803,24463,20654,45117,2021-10-28
3173021006,JAKARTA BARAT,GROGOL PETAMBURAN,JELAMBAR BARU,38246,7534,30712,25895,56607,2021-10-28
3173041006,JAKARTA BARAT,TAMBORA,JEMBATAN BESI,29314,7439,21875,16527,38402,2021-10-28
3173041008,JAKARTA BARAT,TAMBORA,JEMBATAN LIMA,21021,5221,15800,12186,27986,2021-10-28
3173081005,JAKARTA BARAT,KEMBANGAN,JOGLO,40839,8744,32095,26553,58648,2021-10-28
3171081001,JAKARTA PUSAT,JOHAR BARU,JOHAR BARU,37488,7224,30264,25000,55264,2021-10-28
3173041002,JAKARTA BARAT,TAMBORA,KALI ANYAR,23856,4997,18859,14607,33466,2021-10-28
3172041004,JAKARTA UTARA,CILINCING,KALIBARU,67684,19323,48361,33769,82130,2021-10-28
3174081002,JAKARTA SELATAN,PANCORAN,KALIBATA,41994,10034,31960,24909,56869,2021-10-28
3173061001,JAKARTA BARAT,KALI DERES,KALIDERES,72447,15940,56507,46886,103393,2021-10-28
3175051004,JAKARTA TIMUR,PASAR REBO,KALISARI,43212,8154,35058,28541,63599,2021-10-28
3173061004,JAKARTA BARAT,KALI DERES,KAMAL,53783,13408,40375,31377,71752,2021-10-28
3172011002,JAKARTA UTARA,PENJARINGAN,KAMAL MUARA,12930,2342,10588,8914,19502,2021-10-28
3171071007,JAKARTA PUSAT,TANAH ABANG,KAMPUNG BALI,11358,2568,8790,6523,15313,2021-10-28
3175031001,JAKARTA TIMUR,JATINEGARA,KAMPUNG MELAYU,25717,6207,19510,14801,34311,2021-10-28
3171081002,JAKARTA PUSAT,JOHAR BARU,KAMPUNG RAWA,21237,3649,17588,13761,31349,2021-10-28
3175041002,JAKARTA TIMUR,KRAMAT JATI,KAMPUNG TENGAH,43993,11563,32430,25044,57474,2021-10-28
3173011005,JAKARTA BARAT,CENGKARENG,KAPUK,134466,34109,100357,78825,179182,2021-10-28
3172011003,JAKARTA UTARA,PENJARINGAN,KAPUK MUARA,35781,7165,28616,24607,53223,2021-10-28
3171021002,JAKARTA PUSAT,SAWAH BESAR,KARANG ANYAR,25761,5221,20540,16879,37419,2021-10-28
3174021004,JAKARTA SELATAN,SETIA BUDI,KARET,9623,1936,7687,6230,13917,2021-10-28
3174021003,JAKARTA SELATAN,SETIA BUDI,KARET KUNINGAN,16055,3287,12768,10537,23305,2021-10-28
3174021002,JAKARTA SELATAN,SETIA BUDI,KARET SEMANGGI,2770,576,2194,1920,4114,2021-10-28
3171071003,JAKARTA PUSAT,TANAH ABANG,KARET TENGSIN,19271,3892,15379,12158,27537,2021-10-28
3171021003,JAKARTA PUSAT,SAWAH BESAR,KARTINI,22292,4507,17785,14850,32635,2021-10-28
3175011003,JAKARTA TIMUR,MATRAMAN,KAYU MANIS,25284,5617,19667,15066,34733,2021-10-28
3175021006,JAKARTA TIMUR,PULO GADUNG,KAYU PUTIH,40696,8006,32690,27900,60590,2021-10-28
3173031006,JAKARTA BARAT,TAMAN SARI,KEAGUNGAN,17387,3382,14005,11101,25106,2021-10-28
3174041007,JAKARTA SELATAN,PASAR MINGGU,KEBAGUSAN,44552,9296,35256,28161,63417,2021-10-28
3174051006,JAKARTA SELATAN,KEBAYORAN LAMA,KEBAYORAN LAMA SELATAN,41212,8121,33091,27031,60122,2021-10-28
3174051001,JAKARTA SELATAN,KEBAYORAN LAMA,KEBAYORAN LAMA UTARA,42422,9347,33075,26383,59458,2021-10-28
3174011004,JAKARTA SELATAN,TEBET,KEBON BARU,35165,6987,28178,22820,50998,2021-10-28
3172021005,JAKARTA UTARA,TANJUNG PRIOK,KEBON BAWANG,50952,10870,40082,32460,72542,2021-10-28
3173051001,JAKARTA BARAT,KEBON JERUK,KEBON JERUK,53887,12216,41671,33301,74972,2021-10-28
3171071006,JAKARTA PUSAT,TANAH ABANG,KEBON KACANG,21531,5369,16162,12376,28538,2021-10-28
3171011005,JAKARTA PUSAT,GAMBIR,KEBON KELAPA,10163,2133,8030,6575,14605,2021-10-28
3171031002,JAKARTA PUSAT,KEMAYORAN,KEBON KOSONG,30019,6325,23694,18588,42282,2021-10-28
3175011005,JAKARTA TIMUR,MATRAMAN,KEBON MANGGIS,16490,3390,13100,10561,23661,2021-10-28
3171071005,JAKARTA PUSAT,TANAH ABANG,KEBON MELATI,32206,8928,23278,16683,39961,2021-10-28
3175081003,JAKARTA TIMUR,MAKASAR,KEBON PALA,46614,9764,36850,29801,66651,2021-10-28
3171061005,JAKARTA PUSAT,MENTENG,KEBON SIRIH,12299,2770,9529,7451,16980,2021-10-28
3173011004,JAKARTA BARAT,CENGKARENG,KEDAUNG KALI ANGKE,32612,6649,25963,21255,47218,2021-10-28
3173051007,JAKARTA BARAT,KEBON JERUK,KEDOYA SELATAN,32165,6144,26021,21052,47073,2021-10-28
3173051006,JAKARTA BARAT,KEBON JERUK,KEDOYA UTARA,45740,9000,36740,30497,67237,2021-10-28
3173051004,JAKARTA BARAT,KEBON JERUK,KELAPA DUA,23565,5034,18531,15058,33589,2021-10-28
3175091003,JAKARTA TIMUR,CIRACAS,KELAPA DUA WETAN,46875,8445,38430,31339,69769,2021-10-28
3172061003,JAKARTA UTARA,KELAPA GADING,KELAPA GADING BARAT,35717,6437,29280,25948,55228,2021-10-28
3172061001,JAKARTA UTARA,KELAPA GADING,KELAPA GADING TIMUR,33592,5323,28269,25689,53958,2021-10-28
3173071005,JAKARTA BARAT,PALMERAH,KEMANGGISAN,32139,6370,25769,20809,46578,2021-10-28
3171031001,JAKARTA PUSAT,KEMAYORAN,KEMAYORAN,20708,4494,16214,13077,29291,2021-10-28
3173081006,JAKARTA BARAT,KEMBANGAN,KEMBANGAN SELATAN,27130,5975,21155,17930,39085,2021-10-28
3173081001,JAKARTA BARAT,KEMBANGAN,KEMBANGAN UTARA,54451,12524,41927,34220,76147,2021-10-28
3171041002,JAKARTA PUSAT,SENEN,KENARI,9579,1966,7613,6362,13975,2021-10-28
3173041005,JAKARTA BARAT,TAMBORA,KERENDANG,19973,4329,15644,12372,28016,2021-10-28
3175071003,JAKARTA TIMUR,DUREN SAWIT,KLENDER,69978,17064,52914,40850,93764,2021-10-28
3172031001,JAKARTA UTARA,KOJA,KOJA,28175,6702,21473,16930,38403,2021-10-28
3173071006,JAKARTA BARAT,PALMERAH,KOTA BAMBU SELATAN,21158,4573,16585,12714,29299,2021-10-28
3173071003,JAKARTA BARAT,PALMERAH,KOTA BAMBU UTARA,24995,5754,19241,14734,33975,2021-10-28
3171041004,JAKARTA PUSAT,SENEN,KRAMAT,28835,7264,21571,16085,37656,2021-10-28
3175041001,JAKARTA TIMUR,KRAMAT JATI,KRAMAT JATI,34144,7840,26304,20788,47092,2021-10-28
3174071003,JAKARTA SELATAN,KEBAYORAN BARU,KRAMAT PELA,14413,2921,11492,9470,20962,2021-10-28
3173031002,JAKARTA BARAT,TAMAN SARI,KRUKUT,19244,3785,15459,12159,27618,2021-10-28
3174031005,JAKARTA SELATAN,MAMPANG PRAPATAN,KUNINGAN BARAT,12785,2487,10298,8398,18696,2021-10-28
3174021008,JAKARTA SELATAN,SETIA BUDI,KUNINGAN TIMUR,6008,1284,4724,3908,8632,2021-10-28
3171041005,JAKARTA PUSAT,SENEN,KWITANG,15486,3687,11799,9368,21167,2021-10-28
3172031003,JAKARTA UTARA,KOJA,LAGOA,59065,14669,44396,34271,78667,2021-10-28
3174061002,JAKARTA SELATAN,CILANDAK,LEBAK BULUS,37626,7509,30117,25279,55396,2021-10-28
3174091004,JAKARTA SELATAN,JAGAKARSA,LENTENG AGUNG,53946,10291,43655,34141,77796,2021-10-28
3175101007,JAKARTA TIMUR,CIPAYUNG,LUBANG BUAYA,63547,12485,51062,41153,92215,2021-10-28
3175081001,JAKARTA TIMUR,MAKASAR,MAKASAR,34390,6668,27722,22765,50487,2021-10-28
3175071006,JAKARTA TIMUR,DUREN SAWIT,MALAKA JAYA,30927,5684,25243,20855,46098,2021-10-28
3175071005,JAKARTA TIMUR,DUREN SAWIT,MALAKA SARI,27530,4860,22670,18998,41668,2021-10-28
3174031001,JAKARTA SELATAN,MAMPANG PRAPATAN,MAMPANG PRAPATAN,18159,3892,14267,11338,25605,2021-10-28
3173031005,JAKARTA BARAT,TAMAN SARI,MANGGA BESAR,7707,1354,6353,5415,11768,2021-10-28
3171021005,JAKARTA PUSAT,SAWAH BESAR,MANGGA DUA SELATAN,27442,5956,21486,17733,39219,2021-10-28
3174011007,JAKARTA SELATAN,TEBET,MANGGARAI,28373,5324,23049,18116,41165,2021-10-28
3174011006,JAKARTA SELATAN,TEBET,MANGGARAI SELATAN,23075,4355,18720,15368,34088,2021-10-28
3173031003,JAKARTA BARAT,TAMAN SARI,MAPHAR,16461,3196,13265,10745,24010,2021-10-28
3172041003,JAKARTA UTARA,CILINCING,MARUNDA,28943,6907,22036,16216,38252,2021-10-28
3174071001,JAKARTA SELATAN,KEBAYORAN BARU,MELAWAI,2627,535,2092,1911,4003,2021-10-28
3171061001,JAKARTA PUSAT,MENTENG,MENTENG,25624,6057,19567,15008,34575,2021-10-28
3174021005,JAKARTA SELATAN,SETIA BUDI,MENTENG ATAS,27816,5336,22480,18042,40522,2021-10-28
3174011003,JAKARTA SELATAN,TEBET,MENTENG DALAM,36028,7390,28638,23321,51959,2021-10-28
3173081003,JAKARTA BARAT,KEMBANGAN,MERUYA SELATAN,32130,6931,25199,20536,45735,2021-10-28
3173081002,JAKARTA BARAT,KEMBANGAN,MERUYA UTARA,43752,9399,34353,29087,63440,2021-10-28
3175101004,JAKARTA TIMUR,CIPAYUNG,MUNJUL,23871,4519,19352,15932,35284,2021-10-28
3172051002,JAKARTA UTARA,PADEMANGAN,PADEMANGAN BARAT,74240,18404,55836,43970,99806,2021-10-28
3172051001,JAKARTA UTARA,PADEMANGAN,PADEMANGAN TIMUR,37736,6977,30759,26201,56960,2021-10-28
3175011004,JAKARTA TIMUR,MATRAMAN,PAL MERIAM,19769,4349,15420,12049,27469,2021-10-28
3173071001,JAKARTA BARAT,PALMERAH,PALMERAH,63011,14034,48977,38575,87552,2021-10-28
3174081001,JAKARTA SELATAN,PANCORAN,PANCORAN,19421,4208,15213,12264,27477,2021-10-28
3172021003,JAKARTA UTARA,TANJUNG PRIOK,PAPANGGO,39097,8204,30893,24765,55658,2021-10-28
3171021001,JAKARTA PUSAT,SAWAH BESAR,PASAR BARU,12035,2387,9648,8428,18076,2021-10-28
3174021006,JAKARTA SELATAN,SETIA BUDI,PASAR MANGGIS,26752,5623,21129,16988,38117,2021-10-28
3174041001,JAKARTA SELATAN,PASAR MINGGU,PASAR MINGGU,24821,4888,19933,16486,36419,2021-10-28
3171041003,JAKARTA PUSAT,SENEN,PASEBAN,23533,5231,18302,14690,32992,2021-10-28
3173061005,JAKARTA BARAT,KALI DERES,PEGADUNGAN,75587,16188,59399,50194,109593,2021-10-28
3171061002,JAKARTA PUSAT,MENTENG,PEGANGSAAN,23455,5232,18223,13491,31714,2021-10-28
3172061002,JAKARTA UTARA,KELAPA GADING,PEGANGSAAN DUA,49976,8556,41420,36905,78325,2021-10-28
3172011004,JAKARTA UTARA,PENJARINGAN,PEJAGALAN,74578,16249,58329,48724,107053,2021-10-28
3174041006,JAKARTA SELATAN,PASAR MINGGU,PEJATEN BARAT,37346,7845,29501,24023,53524,2021-10-28
3174041005,JAKARTA SELATAN,PASAR MINGGU,PEJATEN TIMUR,57656,13730,43926,35349,79275,2021-10-28
3175051005,JAKARTA TIMUR,PASAR REBO,PEKAYON,43250,8237,35013,28221,63234,2021-10-28
3173041009,JAKARTA BARAT,TAMBORA,PEKOJAN,23587,4703,18884,15437,34321,2021-10-28
3174031003,JAKARTA SELATAN,MAMPANG PRAPATAN,PELA MAMPANG,43522,9130,34392,27872,62264,2021-10-28
3174081005,JAKARTA SELATAN,PANCORAN,PENGADEGAN,21478,4135,17343,14315,31658,2021-10-28
3175061003,JAKARTA TIMUR,CAKUNG,PENGGILINGAN,99255,24375,74880,58442,133322,2021-10-28
3172011001,JAKARTA UTARA,PENJARINGAN,PENJARINGAN,88308,23796,64512,48520,113032,2021-10-28
3174101001,JAKARTA SELATAN,PESANGGRAHAN,PESANGGRAHAN,27545,4988,22557,18881,41438,2021-10-28
3171071004,JAKARTA PUSAT,TANAH ABANG,PETAMBURAN,33271,9151,24120,17753,41873,2021-10-28
3174071008,JAKARTA SELATAN,KEBAYORAN BARU,PETOGOGAN,11499,2382,9117,7521,16638,2021-10-28
3171011004,JAKARTA PUSAT,GAMBIR,PETOJO SELATAN,14692,3443,11249,9329,20578,2021-10-28
3171011003,JAKARTA PUSAT,GAMBIR,PETOJO UTARA,17458,3920,13538,10843,24381,2021-10-28
3174101004,JAKARTA SELATAN,PESANGGRAHAN,PETUKANGAN SELATAN,37187,8016,29171,23837,53008,2021-10-28
3174101003,JAKARTA SELATAN,PESANGGRAHAN,PETUKANGAN UTARA,53716,12213,41503,33505,75008,2021-10-28
3175081002,JAKARTA TIMUR,MAKASAR,PINANG RANTI,27198,6233,20965,16964,37929,2021-10-28
3173031008,JAKARTA BARAT,TAMAN SARI,PINANGSIA,10729,1969,8760,7067,15827,2021-10-28
3175011001,JAKARTA TIMUR,MATRAMAN,PISANGAN BARU,31776,6904,24872,19171,44043,2021-10-28
3175021002,JAKARTA TIMUR,PULO GADUNG,PISANGAN TIMUR,41011,8138,32873,27062,59935,2021-10-28
3172011005,JAKARTA UTARA,PENJARINGAN,PLUIT,47783,9465,38318,32701,71019,2021-10-28
3175071002,JAKARTA TIMUR,DUREN SAWIT,PONDOK BAMBU,61550,13633,47917,38067,85984,2021-10-28
3175071004,JAKARTA TIMUR,DUREN SAWIT,PONDOK KELAPA,72015,14866,57149,47729,104878,2021-10-28
3175071007,JAKARTA TIMUR,DUREN SAWIT,PONDOK KOPI,35367,6889,28478,21666,50144,2021-10-28
3174061003,JAKARTA SELATAN,CILANDAK,PONDOK LABU,46464,8448,38016,32288,70304,2021-10-28
3174051002,JAKARTA SELATAN,KEBAYORAN LAMA,PONDOK PINANG,56169,11240,44929,37258,82187,2021-10-28
3175101003,JAKARTA TIMUR,CIPAYUNG,PONDOK RANGGON,25574,5032,20542,16465,37007,2021-10-28
3101011003,KAB.ADM.KEP.SERIBU,KEP. SERIBU UTARA,PULAU HARAPAN,2060,228,1832,1578,3410,2021-10-28
3101011002,KAB.ADM.KEP.SERIBU,KEP. SERIBU UTARA,PULAU KELAPA,5528,630,4898,4004,8902,2021-10-28
3101011001,KAB.ADM.KEP.SERIBU,KEP. SERIBU UTARA,PULAU PANGGANG,5450,468,4982,4421,9403,2021-10-28
3101021003,KAB.ADM.KEP.SERIBU,KEP. SERIBU SELATAN,PULAU PARI,2765,201,2564,2381,4945,2021-10-28
3101021002,KAB.ADM.KEP.SERIBU,KEP. SERIBU SELATAN,PULAU TIDUNG,4553,387,4166,3770,7936,2021-10-28
3101021001,KAB.ADM.KEP.SERIBU,KEP. SERIBU SELATAN,PULAU UNTUNG JAWA,1941,165,1776,1627,3403,2021-10-28
3174071007,JAKARTA SELATAN,KEBAYORAN BARU,PULO,5835,1056,4779,4260,9039,2021-10-28
3175021001,JAKARTA TIMUR,PULO GADUNG,PULO GADUNG,34422,7862,26560,21558,48118,2021-10-28
3175061005,JAKARTA TIMUR,CAKUNG,PULO GEBANG,97301,19608,77693,61599,139292,2021-10-28
3174041004,JAKARTA SELATAN,PASAR MINGGU,RAGUNAN,39616,7754,31862,26458,58320,2021-10-28
3175091005,JAKARTA TIMUR,CIRACAS,RAMBUTAN,36771,9008,27763,21349,49112,2021-10-28
3172031006,JAKARTA UTARA,KOJA,RAWA BADAK SELATAN,42179,10483,31696,24404,56100,2021-10-28
3172031004,JAKARTA UTARA,KOJA,RAWA BADAK UTARA,34408,8049,26359,20583,46942,2021-10-28
3174071005,JAKARTA SELATAN,KEBAYORAN BARU,RAWA BARAT,5625,1040,4585,3978,8563,2021-10-28
3173011003,JAKARTA BARAT,CENGKARENG,RAWA BUAYA,63799,13598,50201,39235,89436,2021-10-28
3175031004,JAKARTA TIMUR,JATINEGARA,RAWA BUNGA,21434,5419,16015,12574,28589,2021-10-28
3174081003,JAKARTA SELATAN,PANCORAN,RAWA JATI,20509,4061,16448,13569,30017,2021-10-28
3175061002,JAKARTA TIMUR,CAKUNG,RAWA TERATE,24637,4746,19891,15859,35750,2021-10-28
3175021005,JAKARTA TIMUR,PULO GADUNG,RAWAMANGUN,37612,7819,29793,24559,54352,2021-10-28
3171051003,JAKARTA PUSAT,CEMPAKA PUTIH,RAWASARI,21967,4694,17273,14262,31535,2021-10-28
3173041010,JAKARTA BARAT,TAMBORA,ROA MALAKA,3484,630,2854,2485,5339,2021-10-28
3172041006,JAKARTA UTARA,CILINCING,ROROTAN,41668,8745,32923,25668,58591,2021-10-28
3174071004,JAKARTA SELATAN,KEBAYORAN BARU,SELONG,2842,555,2287,2075,4362,2021-10-28
3173061002,JAKARTA BARAT,KALI DERES,SEMANAN,71354,16596,54758,43427,98185,2021-10-28
3172041007,JAKARTA UTARA,CILINCING,SEMPER BARAT,68587,14106,54481,44097,98578,2021-10-28
3172041005,JAKARTA UTARA,CILINCING,SEMPER TIMUR,36267,8166,28101,22217,50318,2021-10-28
3174071006,JAKARTA SELATAN,KEBAYORAN BARU,SENAYAN,2771,675,2096,1757,3853,2021-10-28
3171041001,JAKARTA PUSAT,SENEN,SENEN,6804,1541,5263,4309,9572,2021-10-28
3171031004,JAKARTA PUSAT,KEMAYORAN,SERDANG,29668,6224,23444,19062,42506,2021-10-28
3174021001,JAKARTA SELATAN,SETIA BUDI,SETIA BUDI,3023,638,2385,1953,4338,2021-10-28
3175101005,JAKARTA TIMUR,CIPAYUNG,SETU,20572,4305,16267,12777,29044,2021-10-28
3173071002,JAKARTA BARAT,PALMERAH,SLIPI,16591,3160,13431,10962,24393,2021-10-28
3173081004,JAKARTA BARAT,KEMBANGAN,SRENGSENG,45523,10719,34804,28846,63650,2021-10-28
3174091002,JAKARTA SELATAN,JAGAKARSA,SRENGSENG SAWAH,58196,9533,48663,40121,88784,2021-10-28
3173051003,JAKARTA BARAT,KEBON JERUK,SUKABUMI SELATAN,37033,8737,28296,21285,49581,2021-10-28
3173051002,JAKARTA BARAT,KEBON JERUK,SUKABUMI UTARA,38290,9481,28809,21967,50776,2021-10-28
3172041002,JAKARTA UTARA,CILINCING,SUKAPURA,53949,12774,41175,33095,74270,2021-10-28
3171031007,JAKARTA PUSAT,KEMAYORAN,SUMUR BATU,22717,4832,17885,14874,32759,2021-10-28
3172021004,JAKARTA UTARA,TANJUNG PRIOK,SUNGAI BAMBU,29876,6321,23555,19001,42556,2021-10-28
3172021006,JAKARTA UTARA,TANJUNG PRIOK,SUNTER AGUNG,71805,13055,58750,50137,108887,2021-10-28
3172021002,JAKARTA UTARA,TANJUNG PRIOK,SUNTER JAYA,63031,11630,51401,43317,94718,2021-10-28
3175091004,JAKARTA TIMUR,CIRACAS,SUSUKAN,38257,7558,30699,24817,55516,2021-10-28
3173031001,JAKARTA BARAT,TAMAN SARI,TAMAN SARI,14348,2751,11597,9770,21367,2021-10-28
3173041001,JAKARTA BARAT,TAMBORA,TAMBORA,10204,2365,7839,6183,14022,2021-10-28
3173041004,JAKARTA BARAT,TAMBORA,TANAH SEREAL,26387,4697,21690,17817,39507,2021-10-28
3171081004,JAKARTA PUSAT,JOHAR BARU,TANAH TINGGI,37693,7452,30241,24038,54279,2021-10-28
3173031004,JAKARTA BARAT,TAMAN SARI,TANGKI,13324,2324,11000,9023,20023,2021-10-28
3174091005,JAKARTA SELATAN,JAGAKARSA,TANJUNG BARAT,39770,7097,32673,25921,58594,2021-10-28
3173021005,JAKARTA BARAT,GROGOL PETAMBURAN,TANJUNG DUREN SELATAN,25337,5077,20260,17406,37666,2021-10-28
3173021002,JAKARTA BARAT,GROGOL PETAMBURAN,TANJUNG DUREN UTARA,17010,2994,14016,12197,26213,2021-10-28
3172021001,JAKARTA UTARA,TANJUNG PRIOK,TANJUNG PRIOK,34588,7449,27139,21652,48791,2021-10-28
3174011002,JAKARTA SELATAN,TEBET,TEBET BARAT,21194,3657,17537,15095,32632,2021-10-28
3174011001,JAKARTA SELATAN,TEBET,TEBET TIMUR,18199,3064,15135,13301,28436,2021-10-28
3173061003,JAKARTA BARAT,KALI DERES,TEGAL ALUR,83647,18664,64983,52501,117484,2021-10-28
3174031004,JAKARTA SELATAN,MAMPANG PRAPATAN,TEGAL PARANG,32401,7561,24840,18588,43428,2021-10-28
3173021003,JAKARTA BARAT,GROGOL PETAMBURAN,TOMANG,29605,5710,23895,19931,43826,2021-10-28
3172031005,JAKARTA UTARA,KOJA,TUGU SELATAN,39122,9144,29978,23662,53640,2021-10-28
3172031002,JAKARTA UTARA,KOJA,TUGU UTARA,67670,16752,50918,39266,90184,2021-10-28
3175061006,JAKARTA TIMUR,CAKUNG,UJUNG MENTENG,29934,5471,24463,20311,44774,2021-10-28
3174101005,JAKARTA SELATAN,PESANGGRAHAN,ULUJAMI,40544,9654,30890,24689,55579,2021-10-28
3175011006,JAKARTA TIMUR,MATRAMAN,UTAN KAYU SELATAN,33511,6388,27123,21764,48887,2021-10-28
3175011002,JAKARTA TIMUR,MATRAMAN,UTAN KAYU UTARA,28169,6180,21989,17489,39478,2021-10-28
3171031008,JAKARTA PUSAT,KEMAYORAN,UTAN PANJANG,29208,6245,22963,17963,40926,2021-10-28
3172021007,JAKARTA UTARA,TANJUNG PRIOK,WARAKAS,44401,8532,35869,28083,63952,2021-10-28
3173021007,JAKARTA BARAT,GROGOL PETAMBURAN,WIJAYA KUSUMA,38934,8557,30377,24849,55226,2021-10-28
3172051003,JAKARTA UTARA,PADEMANGAN,ANCOL,23947,6023,17924,14457,32381,2021-10-29
3173041007,JAKARTA BARAT,TAMBORA,ANGKE,29381,6596,22785,18106,40891,2021-10-29
3175041005,JAKARTA TIMUR,KRAMAT JATI,BALE KAMBANG,29074,7623,21451,16360,37811,2021-10-29
3175031003,JAKARTA TIMUR,JATINEGARA,BALI MESTER,9752,2141,7611,6228,13839,2021-10-29
3175101006,JAKARTA TIMUR,CIPAYUNG,BAMBU APUS,26285,5039,21246,17212,38458,2021-10-29
3174031002,JAKARTA SELATAN,MAMPANG PRAPATAN,BANGKA,21566,4786,16780,13486,30266,2021-10-29
3175051002,JAKARTA TIMUR,PASAR REBO,BARU,23886,4113,19773,16629,36402,2021-10-29
3175041004,JAKARTA TIMUR,KRAMAT JATI,BATU AMPAR,47898,12254,35644,27786,63430,2021-10-29
3171071002,JAKARTA PUSAT,TANAH ABANG,BENDUNGAN HILIR,21494,4524,16970,14093,31063,2021-10-29
3175031002,JAKARTA TIMUR,JATINEGARA,BIDARA CINA,36689,9169,27520,21319,48839,2021-10-29
3174101002,JAKARTA SELATAN,PESANGGRAHAN,BINTARO,53098,11122,41976,35121,77097,2021-10-29
3174011005,JAKARTA SELATAN,TEBET,BUKIT DURI,34183,7324,26859,21886,48745,2021-10-29
3171041006,JAKARTA PUSAT,SENEN,BUNGUR,18144,3983,14161,11538,25699,2021-10-29
3175061007,JAKARTA TIMUR,CAKUNG,CAKUNG BARAT,57724,12438,45286,36699,81985,2021-10-29
3175061004,JAKARTA TIMUR,CAKUNG,CAKUNG TIMUR,58287,12044,46243,37553,83796,2021-10-29
3175041007,JAKARTA TIMUR,KRAMAT JATI,CAWANG,32762,7441,25321,19664,44985,2021-10-29
3175101008,JAKARTA TIMUR,CIPAYUNG,CEGER,18932,3847,15085,12268,27353,2021-10-29
3171031006,JAKARTA PUSAT,KEMAYORAN,CEMPAKA BARU,32581,6821,25760,19811,45571,2021-10-29
3171051002,JAKARTA PUSAT,CEMPAKA PUTIH,CEMPAKA PUTIH BARAT,35885,7941,27944,23170,51114,2021-10-29
3171051001,JAKARTA PUSAT,CEMPAKA PUTIH,CEMPAKA PUTIH TIMUR,24292,5175,19117,16181,35298,2021-10-29
3173011001,JAKARTA BARAT,CENGKARENG,CENGKARENG BARAT,66284,13919,52365,43062,95427,2021-10-29
3173011006,JAKARTA BARAT,CENGKARENG,CENGKARENG TIMUR,81027,16801,64226,51521,115747,2021-10-29
3175091002,JAKARTA TIMUR,CIRACAS,CIBUBUR,66364,11849,54515,44380,98895,2021-10-29
3171011002,JAKARTA PUSAT,GAMBIR,CIDENG,15390,3096,12294,10492,22786,2021-10-29
3174091003,JAKARTA SELATAN,JAGAKARSA,CIGANJUR,38497,6918,31579,25163,56742,2021-10-29
3175051003,JAKARTA TIMUR,PASAR REBO,CIJANTUNG,41419,8030,33389,27157,60546,2021-10-29
3171061003,JAKARTA PUSAT,MENTENG,CIKINI,8274,1536,6738,5192,11930,2021-10-29
3174081006,JAKARTA SELATAN,PANCORAN,CIKOKO,10547,1899,8648,7313,15961,2021-10-29
3174061001,JAKARTA SELATAN,CILANDAK,CILANDAK BARAT,51752,9625,42127,35565,77692,2021-10-29
3174041003,JAKARTA SELATAN,PASAR MINGGU,CILANDAK TIMUR,25145,4834,20311,16827,37138,2021-10-29
3175101002,JAKARTA TIMUR,CIPAYUNG,CILANGKAP,27635,5093,22542,18368,40910,2021-10-29
3175041006,JAKARTA TIMUR,KRAMAT JATI,CILILITAN,40181,9420,30761,24269,55030,2021-10-29
3172041001,JAKARTA UTARA,CILINCING,CILINCING,43609,10871,32738,24770,57508,2021-10-29
3175101001,JAKARTA TIMUR,CIPAYUNG,CIPAYUNG,26104,4739,21365,17948,39313,2021-10-29
3174091006,JAKARTA SELATAN,JAGAKARSA,CIPEDAK,38303,6673,31630,25702,57332,2021-10-29
3174061005,JAKARTA SELATAN,CILANDAK,CIPETE SELATAN,26704,5370,21334,18189,39523,2021-10-29
3174071010,JAKARTA SELATAN,KEBAYORAN BARU,CIPETE UTARA,34102,6764,27338,21887,49225,2021-10-29
3175021003,JAKARTA TIMUR,PULO GADUNG,CIPINANG,39306,7683,31623,25557,57180,2021-10-29
3175031007,JAKARTA TIMUR,JATINEGARA,CIPINANG BESAR SELATAN,35212,8707,26505,20112,46617,2021-10-29
3175031008,JAKARTA TIMUR,JATINEGARA,CIPINANG BESAR UTARA,45319,11213,34106,25713,59819,2021-10-29
3175031005,JAKARTA TIMUR,JATINEGARA,CIPINANG CEMPEDAK,32824,7434,25390,20667,46057,2021-10-29
3175081005,JAKARTA TIMUR,MAKASAR,CIPINANG MELAYU,42308,8518,33790,27930,61720,2021-10-29
3175031006,JAKARTA TIMUR,JATINEGARA,CIPINANG MUARA,55243,12355,42888,33899,76787,2021-10-29
3174051003,JAKARTA SELATAN,KEBAYORAN LAMA,CIPULIR,39937,8796,31141,24493,55634,2021-10-29
3175091001,JAKARTA TIMUR,CIRACAS,CIRACAS,64594,12344,52250,41720,93970,2021-10-29
3175041003,JAKARTA TIMUR,KRAMAT JATI,DUKUH,24609,4866,19743,15811,35554,2021-10-29
3175071001,JAKARTA TIMUR,DUREN SAWIT,DUREN SAWIT,61160,13476,47684,38016,85700,2021-10-29
3174081004,JAKARTA SELATAN,PANCORAN,DUREN TIGA,28319,5908,22411,18221,40632,2021-10-29
3173051005,JAKARTA BARAT,KEBON JERUK,DURI KEPA,60138,12201,47937,40606,88543,2021-10-29
3173011002,JAKARTA BARAT,CENGKARENG,DURI KOSAMBI,77923,17515,60408,47008,107416,2021-10-29
3171011006,JAKARTA PUSAT,GAMBIR,DURI PULO,19610,4346,15264,11987,27251,2021-10-29
3173041011,JAKARTA BARAT,TAMBORA,DURI SELATAN,14259,2642,11617,9604,21221,2021-10-29
3173041003,JAKARTA BARAT,TAMBORA,DURI UTARA,19844,3763,16081,12934,29015,2021-10-29
3171081003,JAKARTA PUSAT,JOHAR BARU,GALUR,18243,3737,14506,11501,26007,2021-10-29
3171011001,JAKARTA PUSAT,GAMBIR,GAMBIR,2191,473,1718,1458,3176,2021-10-29
3174061004,JAKARTA SELATAN,CILANDAK,GANDARIA SELATAN,22119,4445,17674,14512,32186,2021-10-29
3174071009,JAKARTA SELATAN,KEBAYORAN BARU,GANDARIA UTARA,39922,8334,31588,25750,57338,2021-10-29
3175051001,JAKARTA TIMUR,PASAR REBO,GEDONG,35755,7465,28290,23242,51532,2021-10-29
3171071001,JAKARTA PUSAT,TANAH ABANG,GELORA,3127,634,2493,2108,4601,2021-10-29
3173031007,JAKARTA BARAT,TAMAN SARI,GLODOK,7837,1240,6597,5794,12391,2021-10-29
3171061004,JAKARTA PUSAT,MENTENG,GONDANGDIA,4100,946,3154,2841,5995,2021-10-29
3173021001,JAKARTA BARAT,GROGOL PETAMBURAN,GROGOL,16876,3525,13351,11000,24351,2021-10-29
3174051005,JAKARTA SELATAN,KEBAYORAN LAMA,GROGOL SELATAN,44251,9273,34978,27896,62874,2021-10-29
3174051004,JAKARTA SELATAN,KEBAYORAN LAMA,GROGOL UTARA,42494,9010,33484,27057,60541,2021-10-29
3174021007,JAKARTA SELATAN,SETIA BUDI,GUNTUR,3985,777,3208,2766,5974,2021-10-29
3174071002,JAKARTA SELATAN,KEBAYORAN BARU,GUNUNG,9436,1828,7608,6536,14144,2021-10-29
3171031005,JAKARTA PUSAT,KEMAYORAN,GUNUNG SAHARI SELATAN,19199,4053,15146,12449,27595,2021-10-29
3171021004,JAKARTA PUSAT,SAWAH BESAR,GUNUNG SAHARI UTARA,16650,3052,13598,11867,25465,2021-10-29
3175081004,JAKARTA TIMUR,MAKASAR,HALIM PERDANA KUSUMAH,28363,3821,24542,22064,46606,2021-10-29
3171031003,JAKARTA PUSAT,KEMAYORAN,HARAPAN MULIA,22557,4778,17779,14045,31824,2021-10-29
3174091001,JAKARTA SELATAN,JAGAKARSA,JAGAKARSA,62389,10956,51433,41354,92787,2021-10-29
3175021007,JAKARTA TIMUR,PULO GADUNG,JATI,32757,6400,26357,22196,48553,2021-10-29
3174041002,JAKARTA SELATAN,PASAR MINGGU,JATI PADANG,37502,7842,29660,24325,53985,2021-10-29
3173071004,JAKARTA BARAT,PALMERAH,JATI PULO,28738,6020,22718,17782,40500,2021-10-29
3175061001,JAKARTA TIMUR,CAKUNG,JATINEGARA,84160,18867,65293,52473,117766,2021-10-29
3175021004,JAKARTA TIMUR,PULO GADUNG,JATINEGARA KAUM,24632,4624,20008,15738,35746,2021-10-29
3173021004,JAKARTA BARAT,GROGOL PETAMBURAN,JELAMBAR,30266,5765,24501,20754,45255,2021-10-29
3173021006,JAKARTA BARAT,GROGOL PETAMBURAN,JELAMBAR BARU,38246,7479,30767,26014,56781,2021-10-29
3173041006,JAKARTA BARAT,TAMBORA,JEMBATAN BESI,29314,7393,21921,16625,38546,2021-10-29
3173041008,JAKARTA BARAT,TAMBORA,JEMBATAN LIMA,21021,5184,15837,12252,28089,2021-10-29
3173081005,JAKARTA BARAT,KEMBANGAN,JOGLO,40839,8702,32137,26653,58790,2021-10-29
3171081001,JAKARTA PUSAT,JOHAR BARU,JOHAR BARU,37488,7189,30299,25098,55397,2021-10-29
3173041002,JAKARTA BARAT,TAMBORA,KALI ANYAR,23856,4957,18899,14709,33608,2021-10-29
3172041004,JAKARTA UTARA,CILINCING,KALIBARU,67684,19226,48458,33895,82353,2021-10-29
3174081002,JAKARTA SELATAN,PANCORAN,KALIBATA,41994,9975,32019,25112,57131,2021-10-29
3173061001,JAKARTA BARAT,KALI DERES,KALIDERES,72447,15707,56740,47058,103798,2021-10-29
3175051004,JAKARTA TIMUR,PASAR REBO,KALISARI,43212,8105,35107,28672,63779,2021-10-29
3173061004,JAKARTA BARAT,KALI DERES,KAMAL,53783,13274,40509,31549,72058,2021-10-29
3172011002,JAKARTA UTARA,PENJARINGAN,KAMAL MUARA,12930,2335,10595,8920,19515,2021-10-29
3171071007,JAKARTA PUSAT,TANAH ABANG,KAMPUNG BALI,11358,2557,8801,6556,15357,2021-10-29
3175031001,JAKARTA TIMUR,JATINEGARA,KAMPUNG MELAYU,25717,6185,19532,14891,34423,2021-10-29
3171081002,JAKARTA PUSAT,JOHAR BARU,KAMPUNG RAWA,21237,3634,17603,13828,31431,2021-10-29
3175041002,JAKARTA TIMUR,KRAMAT JATI,KAMPUNG TENGAH,43993,11483,32510,25196,57706,2021-10-29
3173011005,JAKARTA BARAT,CENGKARENG,KAPUK,134466,33918,100548,79200,179748,2021-10-29
3172011003,JAKARTA UTARA,PENJARINGAN,KAPUK MUARA,35781,7144,28637,24653,53290,2021-10-29
3171021002,JAKARTA PUSAT,SAWAH BESAR,KARANG ANYAR,25761,5186,20575,16975,37550,2021-10-29
3174021004,JAKARTA SELATAN,SETIA BUDI,KARET,9623,1925,7698,6244,13942,2021-10-29
3174021003,JAKARTA SELATAN,SETIA BUDI,KARET KUNINGAN,16055,3277,12778,10571,23349,2021-10-29
3174021002,JAKARTA SELATAN,SETIA BUDI,KARET SEMANGGI,2770,574,2196,1925,4121,2021-10-29
3171071003,JAKARTA PUSAT,TANAH ABANG,KARET TENGSIN,19271,3869,15402,12216,27618,2021-10-29
3171021003,JAKARTA PUSAT,SAWAH BESAR,KARTINI,22292,4481,17811,14930,32741,2021-10-29
3175011003,JAKARTA TIMUR,MATRAMAN,KAYU MANIS,25284,5589,19695,15158,34853,2021-10-29
3175021006,JAKARTA TIMUR,PULO GADUNG,KAYU PUTIH,40696,7968,32728,27995,60723,2021-10-29
3173031006,JAKARTA BARAT,TAMAN SARI,KEAGUNGAN,17387,3360,14027,11172,25199,2021-10-29
3174041007,JAKARTA SELATAN,PASAR MINGGU,KEBAGUSAN,44552,9246,35306,28281,63587,2021-10-29
3174051006,JAKARTA SELATAN,KEBAYORAN LAMA,KEBAYORAN LAMA SELATAN,41212,8024,33188,27159,60347,2021-10-29
3174051001,JAKARTA SELATAN,KEBAYORAN LAMA,KEBAYORAN LAMA UTARA,42422,9257,33165,26509,59674,2021-10-29
3174011004,JAKARTA SELATAN,TEBET,KEBON BARU,35165,6937,28228,22970,51198,2021-10-29
3172021005,JAKARTA UTARA,TANJUNG PRIOK,KEBON BAWANG,50952,10791,40161,32583,72744,2021-10-29
3173051001,JAKARTA BARAT,KEBON JERUK,KEBON JERUK,53887,12130,41757,33428,75185,2021-10-29
3171071006,JAKARTA PUSAT,TANAH ABANG,KEBON KACANG,21531,5333,16198,12448,28646,2021-10-29
3171011005,JAKARTA PUSAT,GAMBIR,KEBON KELAPA,10163,2115,8048,6613,14661,2021-10-29
3171031002,JAKARTA PUSAT,KEMAYORAN,KEBON KOSONG,30019,6285,23734,18699,42433,2021-10-29
3175011005,JAKARTA TIMUR,MATRAMAN,KEBON MANGGIS,16490,3369,13121,10609,23730,2021-10-29
3171071005,JAKARTA PUSAT,TANAH ABANG,KEBON MELATI,32206,8899,23307,16784,40091,2021-10-29
3175081003,JAKARTA TIMUR,MAKASAR,KEBON PALA,46614,9707,36907,29953,66860,2021-10-29
3171061005,JAKARTA PUSAT,MENTENG,KEBON SIRIH,12299,2752,9547,7498,17045,2021-10-29
3173011004,JAKARTA BARAT,CENGKARENG,KEDAUNG KALI ANGKE,32612,6618,25994,21324,47318,2021-10-29
3173051007,JAKARTA BARAT,KEBON JERUK,KEDOYA SELATAN,32165,6086,26079,21197,47276,2021-10-29
3173051006,JAKARTA BARAT,KEBON JERUK,KEDOYA UTARA,45740,8954,36786,30611,67397,2021-10-29
3173051004,JAKARTA BARAT,KEBON JERUK,KELAPA DUA,23565,4986,18579,15148,33727,2021-10-29
3175091003,JAKARTA TIMUR,CIRACAS,KELAPA DUA WETAN,46875,8385,38490,31511,70001,2021-10-29
3172061003,JAKARTA UTARA,KELAPA GADING,KELAPA GADING BARAT,35717,6410,29307,26022,55329,2021-10-29
3172061001,JAKARTA UTARA,KELAPA GADING,KELAPA GADING TIMUR,33592,5296,28296,25755,54051,2021-10-29
3173071005,JAKARTA BARAT,PALMERAH,KEMANGGISAN,32139,6343,25796,20944,46740,2021-10-29
3171031001,JAKARTA PUSAT,KEMAYORAN,KEMAYORAN,20708,4475,16233,13149,29382,2021-10-29
3173081006,JAKARTA BARAT,KEMBANGAN,KEMBANGAN SELATAN,27130,5929,21201,18019,39220,2021-10-29
3173081001,JAKARTA BARAT,KEMBANGAN,KEMBANGAN UTARA,54451,12431,42020,34373,76393,2021-10-29
3171041002,JAKARTA PUSAT,SENEN,KENARI,9579,1950,7629,6386,14015,2021-10-29
3173041005,JAKARTA BARAT,TAMBORA,KERENDANG,19973,4276,15697,12449,28146,2021-10-29
3175071003,JAKARTA TIMUR,DUREN SAWIT,KLENDER,69978,17007,52971,41020,93991,2021-10-29
3172031001,JAKARTA UTARA,KOJA,KOJA,28175,6673,21502,16997,38499,2021-10-29
3173071006,JAKARTA BARAT,PALMERAH,KOTA BAMBU SELATAN,21158,4503,16655,12783,29438,2021-10-29
3173071003,JAKARTA BARAT,PALMERAH,KOTA BAMBU UTARA,24995,5725,19270,14813,34083,2021-10-29
3171041004,JAKARTA PUSAT,SENEN,KRAMAT,28835,7212,21623,16166,37789,2021-10-29
3175041001,JAKARTA TIMUR,KRAMAT JATI,KRAMAT JATI,34144,7817,26327,20893,47220,2021-10-29
3174071003,JAKARTA SELATAN,KEBAYORAN BARU,KRAMAT PELA,14413,2896,11517,9521,21038,2021-10-29
3173031002,JAKARTA BARAT,TAMAN SARI,KRUKUT,19244,3762,15482,12209,27691,2021-10-29
3174031005,JAKARTA SELATAN,MAMPANG PRAPATAN,KUNINGAN BARAT,12785,2470,10315,8429,18744,2021-10-29
3174021008,JAKARTA SELATAN,SETIA BUDI,KUNINGAN TIMUR,6008,1263,4745,3926,8671,2021-10-29
3171041005,JAKARTA PUSAT,SENEN,KWITANG,15486,3646,11840,9406,21246,2021-10-29
3172031003,JAKARTA UTARA,KOJA,LAGOA,59065,14574,44491,34462,78953,2021-10-29
3174061002,JAKARTA SELATAN,CILANDAK,LEBAK BULUS,37626,7468,30158,25395,55553,2021-10-29
3174091004,JAKARTA SELATAN,JAGAKARSA,LENTENG AGUNG,53946,10237,43709,34296,78005,2021-10-29
3175101007,JAKARTA TIMUR,CIPAYUNG,LUBANG BUAYA,63547,12408,51139,41256,92395,2021-10-29
3175081001,JAKARTA TIMUR,MAKASAR,MAKASAR,34390,6611,27779,22884,50663,2021-10-29
3175071006,JAKARTA TIMUR,DUREN SAWIT,MALAKA JAYA,30927,5629,25298,21033,46331,2021-10-29
3175071005,JAKARTA TIMUR,DUREN SAWIT,MALAKA SARI,27530,4813,22717,19093,41810,2021-10-29
3174031001,JAKARTA SELATAN,MAMPANG PRAPATAN,MAMPANG PRAPATAN,18159,3878,14281,11430,25711,2021-10-29
3173031005,JAKARTA BARAT,TAMAN SARI,MANGGA BESAR,7707,1349,6358,5439,11797,2021-10-29
3171021005,JAKARTA PUSAT,SAWAH BESAR,MANGGA DUA SELATAN,27442,5925,21517,17823,39340,2021-10-29
3174011007,JAKARTA SELATAN,TEBET,MANGGARAI,28373,5275,23098,18235,41333,2021-10-29
3174011006,JAKARTA SELATAN,TEBET,MANGGARAI SELATAN,23075,4286,18789,15462,34251,2021-10-29
3173031003,JAKARTA BARAT,TAMAN SARI,MAPHAR,16461,3180,13281,10800,24081,2021-10-29
3172041003,JAKARTA UTARA,CILINCING,MARUNDA,28943,6824,22119,16275,38394,2021-10-29
3174071001,JAKARTA SELATAN,KEBAYORAN BARU,MELAWAI,2627,528,2099,1919,4018,2021-10-29
3171061001,JAKARTA PUSAT,MENTENG,MENTENG,25624,5979,19645,15093,34738,2021-10-29
3174021005,JAKARTA SELATAN,SETIA BUDI,MENTENG ATAS,27816,5307,22509,18127,40636,2021-10-29
3174011003,JAKARTA SELATAN,TEBET,MENTENG DALAM,36028,7351,28677,23444,52121,2021-10-29
3173081003,JAKARTA BARAT,KEMBANGAN,MERUYA SELATAN,32130,6892,25238,20642,45880,2021-10-29
3173081002,JAKARTA BARAT,KEMBANGAN,MERUYA UTARA,43752,9341,34411,29253,63664,2021-10-29
3175101004,JAKARTA TIMUR,CIPAYUNG,MUNJUL,23871,4497,19374,15972,35346,2021-10-29
3172051002,JAKARTA UTARA,PADEMANGAN,PADEMANGAN BARAT,74240,18315,55925,44135,100060,2021-10-29
3172051001,JAKARTA UTARA,PADEMANGAN,PADEMANGAN TIMUR,37736,6947,30789,26294,57083,2021-10-29
3175011004,JAKARTA TIMUR,MATRAMAN,PAL MERIAM,19769,4323,15446,12112,27558,2021-10-29
3173071001,JAKARTA BARAT,PALMERAH,PALMERAH,63011,13936,49075,38823,87898,2021-10-29
3174081001,JAKARTA SELATAN,PANCORAN,PANCORAN,19421,4183,15238,12340,27578,2021-10-29
3172021003,JAKARTA UTARA,TANJUNG PRIOK,PAPANGGO,39097,8091,31006,24883,55889,2021-10-29
3171021001,JAKARTA PUSAT,SAWAH BESAR,PASAR BARU,12035,2379,9656,8471,18127,2021-10-29
3174021006,JAKARTA SELATAN,SETIA BUDI,PASAR MANGGIS,26752,5573,21179,17076,38255,2021-10-29
3174041001,JAKARTA SELATAN,PASAR MINGGU,PASAR MINGGU,24821,4860,19961,16561,36522,2021-10-29
3171041003,JAKARTA PUSAT,SENEN,PASEBAN,23533,5186,18347,14793,33140,2021-10-29
3173061005,JAKARTA BARAT,KALI DERES,PEGADUNGAN,75587,16112,59475,50360,109835,2021-10-29
3171061002,JAKARTA PUSAT,MENTENG,PEGANGSAAN,23455,5213,18242,13576,31818,2021-10-29
3172061002,JAKARTA UTARA,KELAPA GADING,PEGANGSAAN DUA,49976,8526,41450,36984,78434,2021-10-29
3172011004,JAKARTA UTARA,PENJARINGAN,PEJAGALAN,74578,16148,58430,48938,107368,2021-10-29
3174041006,JAKARTA SELATAN,PASAR MINGGU,PEJATEN BARAT,37346,7790,29556,24146,53702,2021-10-29
3174041005,JAKARTA SELATAN,PASAR MINGGU,PEJATEN TIMUR,57656,13670,43986,35522,79508,2021-10-29
3175051005,JAKARTA TIMUR,PASAR REBO,PEKAYON,43250,8178,35072,28385,63457,2021-10-29
3173041009,JAKARTA BARAT,TAMBORA,PEKOJAN,23587,4676,18911,15499,34410,2021-10-29
3174031003,JAKARTA SELATAN,MAMPANG PRAPATAN,PELA MAMPANG,43522,9075,34447,28041,62488,2021-10-29
3174081005,JAKARTA SELATAN,PANCORAN,PENGADEGAN,21478,4112,17366,14410,31776,2021-10-29
3175061003,JAKARTA TIMUR,CAKUNG,PENGGILINGAN,99255,24246,75009,58785,133794,2021-10-29
3172011001,JAKARTA UTARA,PENJARINGAN,PENJARINGAN,88308,23634,64674,48767,113441,2021-10-29
3174101001,JAKARTA SELATAN,PESANGGRAHAN,PESANGGRAHAN,27545,4954,22591,18957,41548,2021-10-29
3171071004,JAKARTA PUSAT,TANAH ABANG,PETAMBURAN,33271,9099,24172,17865,42037,2021-10-29
3174071008,JAKARTA SELATAN,KEBAYORAN BARU,PETOGOGAN,11499,2368,9131,7567,16698,2021-10-29
3171011004,JAKARTA PUSAT,GAMBIR,PETOJO SELATAN,14692,3419,11273,9377,20650,2021-10-29
3171011003,JAKARTA PUSAT,GAMBIR,PETOJO UTARA,17458,3899,13559,10897,24456,2021-10-29
3174101004,JAKARTA SELATAN,PESANGGRAHAN,PETUKANGAN SELATAN,37187,7975,29212,23946,53158,2021-10-29
3174101003,JAKARTA SELATAN,PESANGGRAHAN,PETUKANGAN UTARA,53716,12108,41608,33673,75281,2021-10-29
3175081002,JAKARTA TIMUR,MAKASAR,PINANG RANTI,27198,6189,21009,17038,38047,2021-10-29
3173031008,JAKARTA BARAT,TAMAN SARI,PINANGSIA,10729,1945,8784,7111,15895,2021-10-29
3175011001,JAKARTA TIMUR,MATRAMAN,PISANGAN BARU,31776,6858,24918,19277,44195,2021-10-29
3175021002,JAKARTA TIMUR,PULO GADUNG,PISANGAN TIMUR,41011,8064,32947,27209,60156,2021-10-29
3172011005,JAKARTA UTARA,PENJARINGAN,PLUIT,47783,9431,38352,32831,71183,2021-10-29
3175071002,JAKARTA TIMUR,DUREN SAWIT,PONDOK BAMBU,61550,13552,47998,38240,86238,2021-10-29
3175071004,JAKARTA TIMUR,DUREN SAWIT,PONDOK KELAPA,72015,14764,57251,47997,105248,2021-10-29
3175071007,JAKARTA TIMUR,DUREN SAWIT,PONDOK KOPI,35367,6846,28521,21830,50351,2021-10-29
3174061003,JAKARTA SELATAN,CILANDAK,PONDOK LABU,46464,8366,38098,32440,70538,2021-10-29
3174051002,JAKARTA SELATAN,KEBAYORAN LAMA,PONDOK PINANG,56169,11190,44979,37434,82413,2021-10-29
3175101003,JAKARTA TIMUR,CIPAYUNG,PONDOK RANGGON,25574,4991,20583,16744,37327,2021-10-29
3101011003,KAB.ADM.KEP.SERIBU,KEP. SERIBU UTARA,PULAU HARAPAN,2060,227,1833,1588,3421,2021-10-29
3101011002,KAB.ADM.KEP.SERIBU,KEP. SERIBU UTARA,PULAU KELAPA,5528,628,4900,4010,8910,2021-10-29
3101011001,KAB.ADM.KEP.SERIBU,KEP. SERIBU UTARA,PULAU PANGGANG,5450,462,4988,4424,9412,2021-10-29
3101021003,KAB.ADM.KEP.SERIBU,KEP. SERIBU SELATAN,PULAU PARI,2765,201,2564,2381,4945,2021-10-29
3101021002,KAB.ADM.KEP.SERIBU,KEP. SERIBU SELATAN,PULAU TIDUNG,4553,375,4178,3800,7978,2021-10-29
3101021001,KAB.ADM.KEP.SERIBU,KEP. SERIBU SELATAN,PULAU UNTUNG JAWA,1941,163,1778,1629,3407,2021-10-29
3174071007,JAKARTA SELATAN,KEBAYORAN BARU,PULO,5835,1054,4781,4272,9053,2021-10-29
3175021001,JAKARTA TIMUR,PULO GADUNG,PULO GADUNG,34422,7823,26599,21671,48270,2021-10-29
3175061005,JAKARTA TIMUR,CAKUNG,PULO GEBANG,97301,19516,77785,61872,139657,2021-10-29
3174041004,JAKARTA SELATAN,PASAR MINGGU,RAGUNAN,39616,7706,31910,26574,58484,2021-10-29
3175091005,JAKARTA TIMUR,CIRACAS,RAMBUTAN,36771,8959,27812,21512,49324,2021-10-29
3172031006,JAKARTA UTARA,KOJA,RAWA BADAK SELATAN,42179,10414,31765,24546,56311,2021-10-29
3172031004,JAKARTA UTARA,KOJA,RAWA BADAK UTARA,34408,8008,26400,20674,47074,2021-10-29
3174071005,JAKARTA SELATAN,KEBAYORAN BARU,RAWA BARAT,5625,1035,4590,3990,8580,2021-10-29
3173011003,JAKARTA BARAT,CENGKARENG,RAWA BUAYA,63799,13490,50309,39608,89917,2021-10-29
3175031004,JAKARTA TIMUR,JATINEGARA,RAWA BUNGA,21434,5393,16041,12642,28683,2021-10-29
3174081003,JAKARTA SELATAN,PANCORAN,RAWA JATI,20509,4044,16465,13679,30144,2021-10-29
3175061002,JAKARTA TIMUR,CAKUNG,RAWA TERATE,24637,4712,19925,15939,35864,2021-10-29
3175021005,JAKARTA TIMUR,PULO GADUNG,RAWAMANGUN,37612,7760,29852,24696,54548,2021-10-29
3171051003,JAKARTA PUSAT,CEMPAKA PUTIH,RAWASARI,21967,4676,17291,14344,31635,2021-10-29
3173041010,JAKARTA BARAT,TAMBORA,ROA MALAKA,3484,628,2856,2487,5343,2021-10-29
3172041006,JAKARTA UTARA,CILINCING,ROROTAN,41668,8689,32979,25768,58747,2021-10-29
3174071004,JAKARTA SELATAN,KEBAYORAN BARU,SELONG,2842,553,2289,2079,4368,2021-10-29
3173061002,JAKARTA BARAT,KALI DERES,SEMANAN,71354,16409,54945,43667,98612,2021-10-29
3172041007,JAKARTA UTARA,CILINCING,SEMPER BARAT,68587,14012,54575,44228,98803,2021-10-29
3172041005,JAKARTA UTARA,CILINCING,SEMPER TIMUR,36267,8128,28139,22288,50427,2021-10-29
3174071006,JAKARTA SELATAN,KEBAYORAN BARU,SENAYAN,2771,673,2098,1763,3861,2021-10-29
3171041001,JAKARTA PUSAT,SENEN,SENEN,6804,1525,5279,4332,9611,2021-10-29
3171031004,JAKARTA PUSAT,KEMAYORAN,SERDANG,29668,6168,23500,19155,42655,2021-10-29
3174021001,JAKARTA SELATAN,SETIA BUDI,SETIA BUDI,3023,633,2390,1961,4351,2021-10-29
3175101005,JAKARTA TIMUR,CIPAYUNG,SETU,20572,4264,16308,12832,29140,2021-10-29
3173071002,JAKARTA BARAT,PALMERAH,SLIPI,16591,3141,13450,11025,24475,2021-10-29
3173081004,JAKARTA BARAT,KEMBANGAN,SRENGSENG,45523,10630,34893,28977,63870,2021-10-29
3174091002,JAKARTA SELATAN,JAGAKARSA,SRENGSENG SAWAH,58196,9478,48718,40282,89000,2021-10-29
3173051003,JAKARTA BARAT,KEBON JERUK,SUKABUMI SELATAN,37033,8705,28328,21400,49728,2021-10-29
3173051002,JAKARTA BARAT,KEBON JERUK,SUKABUMI UTARA,38290,9436,28854,22101,50955,2021-10-29
3172041002,JAKARTA UTARA,CILINCING,SUKAPURA,53949,12697,41252,33202,74454,2021-10-29
3171031007,JAKARTA PUSAT,KEMAYORAN,SUMUR BATU,22717,4803,17914,14950,32864,2021-10-29
3172021004,JAKARTA UTARA,TANJUNG PRIOK,SUNGAI BAMBU,29876,6276,23600,19080,42680,2021-10-29
3172021006,JAKARTA UTARA,TANJUNG PRIOK,SUNTER AGUNG,71805,12973,58832,50299,109131,2021-10-29
3172021002,JAKARTA UTARA,TANJUNG PRIOK,SUNTER JAYA,63031,11575,51456,43516,94972,2021-10-29
3175091004,JAKARTA TIMUR,CIRACAS,SUSUKAN,38257,7518,30739,24924,55663,2021-10-29
3173031001,JAKARTA BARAT,TAMAN SARI,TAMAN SARI,14348,2738,11610,9813,21423,2021-10-29
3173041001,JAKARTA BARAT,TAMBORA,TAMBORA,10204,2356,7848,6204,14052,2021-10-29
3173041004,JAKARTA BARAT,TAMBORA,TANAH SEREAL,26387,4666,21721,17906,39627,2021-10-29
3171081004,JAKARTA PUSAT,JOHAR BARU,TANAH TINGGI,37693,7413,30280,24152,54432,2021-10-29
3173031004,JAKARTA BARAT,TAMAN SARI,TANGKI,13324,2306,11018,9079,20097,2021-10-29
3174091005,JAKARTA SELATAN,JAGAKARSA,TANJUNG BARAT,39770,7055,32715,26062,58777,2021-10-29
3173021005,JAKARTA BARAT,GROGOL PETAMBURAN,TANJUNG DUREN SELATAN,25337,5029,20308,17466,37774,2021-10-29
3173021002,JAKARTA BARAT,GROGOL PETAMBURAN,TANJUNG DUREN UTARA,17010,2985,14025,12259,26284,2021-10-29
3172021001,JAKARTA UTARA,TANJUNG PRIOK,TANJUNG PRIOK,34588,7409,27179,21716,48895,2021-10-29
3174011002,JAKARTA SELATAN,TEBET,TEBET BARAT,21194,3628,17566,15165,32731,2021-10-29
3174011001,JAKARTA SELATAN,TEBET,TEBET TIMUR,18199,3047,15152,13373,28525,2021-10-29
3173061003,JAKARTA BARAT,KALI DERES,TEGAL ALUR,83647,18543,65104,52727,117831,2021-10-29
3174031004,JAKARTA SELATAN,MAMPANG PRAPATAN,TEGAL PARANG,32401,7521,24880,18714,43594,2021-10-29
3173021003,JAKARTA BARAT,GROGOL PETAMBURAN,TOMANG,29605,5684,23921,20014,43935,2021-10-29
3172031005,JAKARTA UTARA,KOJA,TUGU SELATAN,39122,9094,30028,23793,53821,2021-10-29
3172031002,JAKARTA UTARA,KOJA,TUGU UTARA,67670,16652,51018,39412,90430,2021-10-29
3175061006,JAKARTA TIMUR,CAKUNG,UJUNG MENTENG,29934,5428,24506,20375,44881,2021-10-29
3174101005,JAKARTA SELATAN,PESANGGRAHAN,ULUJAMI,40544,9593,30951,24808,55759,2021-10-29
3175011006,JAKARTA TIMUR,MATRAMAN,UTAN KAYU SELATAN,33511,6361,27150,21901,49051,2021-10-29
3175011002,JAKARTA TIMUR,MATRAMAN,UTAN KAYU UTARA,28169,6143,22026,17608,39634,2021-10-29
3171031008,JAKARTA PUSAT,KEMAYORAN,UTAN PANJANG,29208,6183,23025,18153,41178,2021-10-29
3172021007,JAKARTA UTARA,TANJUNG PRIOK,WARAKAS,44401,8485,35916,28237,64153,2021-10-29
3173021007,JAKARTA BARAT,GROGOL PETAMBURAN,WIJAYA KUSUMA,38934,8491,30443,24960,55403,2021-10-29
3172051003,JAKARTA UTARA,PADEMANGAN,ANCOL,23947,6006,17941,14489,32430,2021-10-30
3173041007,JAKARTA BARAT,TAMBORA,ANGKE,29381,6566,22815,18161,40976,2021-10-30
3175041005,JAKARTA TIMUR,KRAMAT JATI,BALE KAMBANG,29074,7600,21474,16407,37881,2021-10-30
3175031003,JAKARTA TIMUR,JATINEGARA,BALI MESTER,9752,2132,7620,6268,13888,2021-10-30
3175101006,JAKARTA TIMUR,CIPAYUNG,BAMBU APUS,26285,5020,21265,17269,38534,2021-10-30
3174031002,JAKARTA SELATAN,MAMPANG PRAPATAN,BANGKA,21566,4751,16815,13562,30377,2021-10-30
3175051002,JAKARTA TIMUR,PASAR REBO,BARU,23886,4098,19788,16685,36473,2021-10-30
3175041004,JAKARTA TIMUR,KRAMAT JATI,BATU AMPAR,47898,12218,35680,27899,63579,2021-10-30
3171071002,JAKARTA PUSAT,TANAH ABANG,BENDUNGAN HILIR,21494,4507,16987,14156,31143,2021-10-30
3175031002,JAKARTA TIMUR,JATINEGARA,BIDARA CINA,36689,9129,27560,21420,48980,2021-10-30
3174101002,JAKARTA SELATAN,PESANGGRAHAN,BINTARO,53098,11081,42017,35259,77276,2021-10-30
3174011005,JAKARTA SELATAN,TEBET,BUKIT DURI,34183,7281,26902,21966,48868,2021-10-30
3171041006,JAKARTA PUSAT,SENEN,BUNGUR,18144,3966,14178,11576,25754,2021-10-30
3175061007,JAKARTA TIMUR,CAKUNG,CAKUNG BARAT,57724,12357,45367,36817,82184,2021-10-30
3175061004,JAKARTA TIMUR,CAKUNG,CAKUNG TIMUR,58287,11970,46317,37648,83965,2021-10-30
3175041007,JAKARTA TIMUR,KRAMAT JATI,CAWANG,32762,7421,25341,19733,45074,2021-10-30
3175101008,JAKARTA TIMUR,CIPAYUNG,CEGER,18932,3831,15101,12320,27421,2021-10-30
3171031006,JAKARTA PUSAT,KEMAYORAN,CEMPAKA BARU,32581,6709,25872,19938,45810,2021-10-30
3171051002,JAKARTA PUSAT,CEMPAKA PUTIH,CEMPAKA PUTIH BARAT,35885,7903,27982,23243,51225,2021-10-30
3171051001,JAKARTA PUSAT,CEMPAKA PUTIH,CEMPAKA PUTIH TIMUR,24292,5156,19136,16237,35373,2021-10-30
3173011001,JAKARTA BARAT,CENGKARENG,CENGKARENG BARAT,66284,13825,52459,43237,95696,2021-10-30
3173011006,JAKARTA BARAT,CENGKARENG,CENGKARENG TIMUR,81027,16717,64310,51753,116063,2021-10-30
3175091002,JAKARTA TIMUR,CIRACAS,CIBUBUR,66364,11826,54538,44501,99039,2021-10-30
3171011002,JAKARTA PUSAT,GAMBIR,CIDENG,15390,3080,12310,10528,22838,2021-10-30
3174091003,JAKARTA SELATAN,JAGAKARSA,CIGANJUR,38497,6895,31602,25259,56861,2021-10-30
3175051003,JAKARTA TIMUR,PASAR REBO,CIJANTUNG,41419,7991,33428,27260,60688,2021-10-30
3171061003,JAKARTA PUSAT,MENTENG,CIKINI,8274,1533,6741,5210,11951,2021-10-30
3174081006,JAKARTA SELATAN,PANCORAN,CIKOKO,10547,1892,8655,7339,15994,2021-10-30
3174061001,JAKARTA SELATAN,CILANDAK,CILANDAK BARAT,51752,9583,42169,35695,77864,2021-10-30
3174041003,JAKARTA SELATAN,PASAR MINGGU,CILANDAK TIMUR,25145,4806,20339,16884,37223,2021-10-30
3175101002,JAKARTA TIMUR,CIPAYUNG,CILANGKAP,27635,5065,22570,18563,41133,2021-10-30
3175041006,JAKARTA TIMUR,KRAMAT JATI,CILILITAN,40181,9358,30823,24439,55262,2021-10-30
3172041001,JAKARTA UTARA,CILINCING,CILINCING,43609,10827,32782,24847,57629,2021-10-30
3175101001,JAKARTA TIMUR,CIPAYUNG,CIPAYUNG,26104,4715,21389,18013,39402,2021-10-30
3174091006,JAKARTA SELATAN,JAGAKARSA,CIPEDAK,38303,6623,31680,25836,57516,2021-10-30
3174061005,JAKARTA SELATAN,CILANDAK,CIPETE SELATAN,26704,5349,21355,18262,39617,2021-10-30
3174071010,JAKARTA SELATAN,KEBAYORAN BARU,CIPETE UTARA,34102,6714,27388,21956,49344,2021-10-30
3175021003,JAKARTA TIMUR,PULO GADUNG,CIPINANG,39306,7645,31661,25673,57334,2021-10-30
3175031007,JAKARTA TIMUR,JATINEGARA,CIPINANG BESAR SELATAN,35212,8657,26555,20217,46772,2021-10-30
3175031008,JAKARTA TIMUR,JATINEGARA,CIPINANG BESAR UTARA,45319,11166,34153,25782,59935,2021-10-30
3175031005,JAKARTA TIMUR,JATINEGARA,CIPINANG CEMPEDAK,32824,7387,25437,20771,46208,2021-10-30
3175081005,JAKARTA TIMUR,MAKASAR,CIPINANG MELAYU,42308,8485,33823,28016,61839,2021-10-30
3175031006,JAKARTA TIMUR,JATINEGARA,CIPINANG MUARA,55243,12314,42929,34003,76932,2021-10-30
3174051003,JAKARTA SELATAN,KEBAYORAN LAMA,CIPULIR,39937,8760,31177,24574,55751,2021-10-30
3175091001,JAKARTA TIMUR,CIRACAS,CIRACAS,64594,12292,52302,41844,94146,2021-10-30
3175041003,JAKARTA TIMUR,KRAMAT JATI,DUKUH,24609,4828,19781,15894,35675,2021-10-30
3175071001,JAKARTA TIMUR,DUREN SAWIT,DUREN SAWIT,61160,13415,47745,38187,85932,2021-10-30
3174081004,JAKARTA SELATAN,PANCORAN,DUREN TIGA,28319,5897,22422,18295,40717,2021-10-30
3173051005,JAKARTA BARAT,KEBON JERUK,DURI KEPA,60138,12165,47973,40727,88700,2021-10-30
3173011002,JAKARTA BARAT,CENGKARENG,DURI KOSAMBI,77923,17404,60519,47282,107801,2021-10-30
3171011006,JAKARTA PUSAT,GAMBIR,DURI PULO,19610,4333,15277,12023,27300,2021-10-30
3173041011,JAKARTA BARAT,TAMBORA,DURI SELATAN,14259,2629,11630,9639,21269,2021-10-30
3173041003,JAKARTA BARAT,TAMBORA,DURI UTARA,19844,3749,16095,12987,29082,2021-10-30
3171081003,JAKARTA PUSAT,JOHAR BARU,GALUR,18243,3712,14531,11551,26082,2021-10-30
3171011001,JAKARTA PUSAT,GAMBIR,GAMBIR,2191,472,1719,1461,3180,2021-10-30
3174061004,JAKARTA SELATAN,CILANDAK,GANDARIA SELATAN,22119,4419,17700,14583,32283,2021-10-30
3174071009,JAKARTA SELATAN,KEBAYORAN BARU,GANDARIA UTARA,39922,8279,31643,25826,57469,2021-10-30
3175051001,JAKARTA TIMUR,PASAR REBO,GEDONG,35755,7441,28314,23316,51630,2021-10-30
3171071001,JAKARTA PUSAT,TANAH ABANG,GELORA,3127,632,2495,2113,4608,2021-10-30
3173031007,JAKARTA BARAT,TAMAN SARI,GLODOK,7837,1234,6603,5803,12406,2021-10-30
3171061004,JAKARTA PUSAT,MENTENG,GONDANGDIA,4100,945,3155,2852,6007,2021-10-30
3173021001,JAKARTA BARAT,GROGOL PETAMBURAN,GROGOL,16876,3506,13370,11033,24403,2021-10-30
3174051005,JAKARTA SELATAN,KEBAYORAN LAMA,GROGOL SELATAN,44251,9240,35011,27986,62997,2021-10-30
3174051004,JAKARTA SELATAN,KEBAYORAN LAMA,GROGOL UTARA,42494,8975,33519,27161,60680,2021-10-30
3174021007,JAKARTA SELATAN,SETIA BUDI,GUNTUR,3985,772,3213,2774,5987,2021-10-30
3174071002,JAKARTA SELATAN,KEBAYORAN BARU,GUNUNG,9436,1826,7610,6547,14157,2021-10-30
3171031005,JAKARTA PUSAT,KEMAYORAN,GUNUNG SAHARI SELATAN,19199,4032,15167,12484,27651,2021-10-30
3171021004,JAKARTA PUSAT,SAWAH BESAR,GUNUNG SAHARI UTARA,16650,3043,13607,11894,25501,2021-10-30
3175081004,JAKARTA TIMUR,MAKASAR,HALIM PERDANA KUSUMAH,28363,3802,24561,22099,46660,2021-10-30
3171031003,JAKARTA PUSAT,KEMAYORAN,HARAPAN MULIA,22557,4754,17803,14114,31917,2021-10-30
3174091001,JAKARTA SELATAN,JAGAKARSA,JAGAKARSA,62389,10850,51539,41532,93071,2021-10-30
3175021007,JAKARTA TIMUR,PULO GADUNG,JATI,32757,6376,26381,22272,48653,2021-10-30
3174041002,JAKARTA SELATAN,PASAR MINGGU,JATI PADANG,37502,7804,29698,24446,54144,2021-10-30
3173071004,JAKARTA BARAT,PALMERAH,JATI PULO,28738,6002,22736,17839,40575,2021-10-30
3175061001,JAKARTA TIMUR,CAKUNG,JATINEGARA,84160,18760,65400,52688,118088,2021-10-30
3175021004,JAKARTA TIMUR,PULO GADUNG,JATINEGARA KAUM,24632,4607,20025,15795,35820,2021-10-30
3173021004,JAKARTA BARAT,GROGOL PETAMBURAN,JELAMBAR,30266,5734,24532,20846,45378,2021-10-30
3173021006,JAKARTA BARAT,GROGOL PETAMBURAN,JELAMBAR BARU,38246,7443,30803,26115,56918,2021-10-30
3173041006,JAKARTA BARAT,TAMBORA,JEMBATAN BESI,29314,7368,21946,16693,38639,2021-10-30
3173041008,JAKARTA BARAT,TAMBORA,JEMBATAN LIMA,21021,5166,15855,12297,28152,2021-10-30
3173081005,JAKARTA BARAT,KEMBANGAN,JOGLO,40839,8661,32178,26777,58955,2021-10-30
3171081001,JAKARTA PUSAT,JOHAR BARU,JOHAR BARU,37488,7163,30325,25159,55484,2021-10-30
3173041002,JAKARTA BARAT,TAMBORA,KALI ANYAR,23856,4926,18930,14769,33699,2021-10-30
3172041004,JAKARTA UTARA,CILINCING,KALIBARU,67684,19171,48513,33959,82472,2021-10-30
3174081002,JAKARTA SELATAN,PANCORAN,KALIBATA,41994,9937,32057,25238,57295,2021-10-30
3173061001,JAKARTA BARAT,KALI DERES,KALIDERES,72447,15595,56852,47187,104039,2021-10-30
3175051004,JAKARTA TIMUR,PASAR REBO,KALISARI,43212,8082,35130,28796,63926,2021-10-30
3173061004,JAKARTA BARAT,KALI DERES,KAMAL,53783,13089,40694,31679,72373,2021-10-30
3172011002,JAKARTA UTARA,PENJARINGAN,KAMAL MUARA,12930,2333,10597,8933,19530,2021-10-30
3171071007,JAKARTA PUSAT,TANAH ABANG,KAMPUNG BALI,11358,2551,8807,6595,15402,2021-10-30
3175031001,JAKARTA TIMUR,JATINEGARA,KAMPUNG MELAYU,25717,6169,19548,14952,34500,2021-10-30
3171081002,JAKARTA PUSAT,JOHAR BARU,KAMPUNG RAWA,21237,3625,17612,13874,31486,2021-10-30
3175041002,JAKARTA TIMUR,KRAMAT JATI,KAMPUNG TENGAH,43993,11447,32546,25285,57831,2021-10-30
3173011005,JAKARTA BARAT,CENGKARENG,KAPUK,134466,33801,100665,79468,180133,2021-10-30
3172011003,JAKARTA UTARA,PENJARINGAN,KAPUK MUARA,35781,7115,28666,24732,53398,2021-10-30
3171021002,JAKARTA PUSAT,SAWAH BESAR,KARANG ANYAR,25761,5173,20588,17050,37638,2021-10-30
3174021004,JAKARTA SELATAN,SETIA BUDI,KARET,9623,1904,7719,6266,13985,2021-10-30
3174021003,JAKARTA SELATAN,SETIA BUDI,KARET KUNINGAN,16055,3243,12812,10614,23426,2021-10-30
3174021002,JAKARTA SELATAN,SETIA BUDI,KARET SEMANGGI,2770,570,2200,1930,4130,2021-10-30
3171071003,JAKARTA PUSAT,TANAH ABANG,KARET TENGSIN,19271,3840,15431,12260,27691,2021-10-30
3171021003,JAKARTA PUSAT,SAWAH BESAR,KARTINI,22292,4444,17848,15015,32863,2021-10-30
3175011003,JAKARTA TIMUR,MATRAMAN,KAYU MANIS,25284,5564,19720,15226,34946,2021-10-30
3175021006,JAKARTA TIMUR,PULO GADUNG,KAYU PUTIH,40696,7941,32755,28084,60839,2021-10-30
3173031006,JAKARTA BARAT,TAMAN SARI,KEAGUNGAN,17387,3349,14038,11230,25268,2021-10-30
3174041007,JAKARTA SELATAN,PASAR MINGGU,KEBAGUSAN,44552,9204,35348,28381,63729,2021-10-30
3174051006,JAKARTA SELATAN,KEBAYORAN LAMA,KEBAYORAN LAMA SELATAN,41212,7981,33231,27253,60484,2021-10-30
3174051001,JAKARTA SELATAN,KEBAYORAN LAMA,KEBAYORAN LAMA UTARA,42422,9215,33207,26584,59791,2021-10-30
3174011004,JAKARTA SELATAN,TEBET,KEBON BARU,35165,6901,28264,23083,51347,2021-10-30
3172021005,JAKARTA UTARA,TANJUNG PRIOK,KEBON BAWANG,50952,10760,40192,32682,72874,2021-10-30
3173051001,JAKARTA BARAT,KEBON JERUK,KEBON JERUK,53887,12084,41803,33553,75356,2021-10-30
3171071006,JAKARTA PUSAT,TANAH ABANG,KEBON KACANG,21531,5309,16222,12514,28736,2021-10-30
3171011005,JAKARTA PUSAT,GAMBIR,KEBON KELAPA,10163,2103,8060,6637,14697,2021-10-30
3171031002,JAKARTA PUSAT,KEMAYORAN,KEBON KOSONG,30019,6252,23767,18817,42584,2021-10-30
3175011005,JAKARTA TIMUR,MATRAMAN,KEBON MANGGIS,16490,3357,13133,10644,23777,2021-10-30
3171071005,JAKARTA PUSAT,TANAH ABANG,KEBON MELATI,32206,8877,23329,16872,40201,2021-10-30
3175081003,JAKARTA TIMUR,MAKASAR,KEBON PALA,46614,9670,36944,30024,66968,2021-10-30
3171061005,JAKARTA PUSAT,MENTENG,KEBON SIRIH,12299,2744,9555,7528,17083,2021-10-30
3173011004,JAKARTA BARAT,CENGKARENG,KEDAUNG KALI ANGKE,32612,6582,26030,21378,47408,2021-10-30
3173051007,JAKARTA BARAT,KEBON JERUK,KEDOYA SELATAN,32165,6060,26105,21252,47357,2021-10-30
3173051006,JAKARTA BARAT,KEBON JERUK,KEDOYA UTARA,45740,8928,36812,30678,67490,2021-10-30
3173051004,JAKARTA BARAT,KEBON JERUK,KELAPA DUA,23565,4975,18590,15204,33794,2021-10-30
3175091003,JAKARTA TIMUR,CIRACAS,KELAPA DUA WETAN,46875,8336,38539,31638,70177,2021-10-30
3172061003,JAKARTA UTARA,KELAPA GADING,KELAPA GADING BARAT,35717,6392,29325,26068,55393,2021-10-30
3172061001,JAKARTA UTARA,KELAPA GADING,KELAPA GADING TIMUR,33592,5284,28308,25820,54128,2021-10-30
3173071005,JAKARTA BARAT,PALMERAH,KEMANGGISAN,32139,6323,25816,21029,46845,2021-10-30
3171031001,JAKARTA PUSAT,KEMAYORAN,KEMAYORAN,20708,4461,16247,13187,29434,2021-10-30
3173081006,JAKARTA BARAT,KEMBANGAN,KEMBANGAN SELATAN,27130,5862,21268,18054,39322,2021-10-30
3173081001,JAKARTA BARAT,KEMBANGAN,KEMBANGAN UTARA,54451,12381,42070,34461,76531,2021-10-30
3171041002,JAKARTA PUSAT,SENEN,KENARI,9579,1943,7636,6399,14035,2021-10-30
3173041005,JAKARTA BARAT,TAMBORA,KERENDANG,19973,4262,15711,12510,28221,2021-10-30
3175071003,JAKARTA TIMUR,DUREN SAWIT,KLENDER,69978,16951,53027,41142,94169,2021-10-30
3172031001,JAKARTA UTARA,KOJA,KOJA,28175,6644,21531,17065,38596,2021-10-30
3173071006,JAKARTA BARAT,PALMERAH,KOTA BAMBU SELATAN,21158,4485,16673,12822,29495,2021-10-30
3173071003,JAKARTA BARAT,PALMERAH,KOTA BAMBU UTARA,24995,5703,19292,14852,34144,2021-10-30
3171041004,JAKARTA PUSAT,SENEN,KRAMAT,28835,7176,21659,16216,37875,2021-10-30
3175041001,JAKARTA TIMUR,KRAMAT JATI,KRAMAT JATI,34144,7787,26357,20962,47319,2021-10-30
3174071003,JAKARTA SELATAN,KEBAYORAN BARU,KRAMAT PELA,14413,2888,11525,9554,21079,2021-10-30
3173031002,JAKARTA BARAT,TAMAN SARI,KRUKUT,19244,3746,15498,12230,27728,2021-10-30
3174031005,JAKARTA SELATAN,MAMPANG PRAPATAN,KUNINGAN BARAT,12785,2463,10322,8448,18770,2021-10-30
3174021008,JAKARTA SELATAN,SETIA BUDI,KUNINGAN TIMUR,6008,1243,4765,3939,8704,2021-10-30
3171041005,JAKARTA PUSAT,SENEN,KWITANG,15486,3631,11855,9429,21284,2021-10-30
3172031003,JAKARTA UTARA,KOJA,LAGOA,59065,14481,44584,34582,79166,2021-10-30
3174061002,JAKARTA SELATAN,CILANDAK,LEBAK BULUS,37626,7447,30179,25468,55647,2021-10-30
3174091004,JAKARTA SELATAN,JAGAKARSA,LENTENG AGUNG,53946,10176,43770,34400,78170,2021-10-30
3175101007,JAKARTA TIMUR,CIPAYUNG,LUBANG BUAYA,63547,12365,51182,41454,92636,2021-10-30
3175081001,JAKARTA TIMUR,MAKASAR,MAKASAR,34390,6593,27797,22974,50771,2021-10-30
3175071006,JAKARTA TIMUR,DUREN SAWIT,MALAKA JAYA,30927,5595,25332,21158,46490,2021-10-30
3175071005,JAKARTA TIMUR,DUREN SAWIT,MALAKA SARI,27530,4800,22730,19155,41885,2021-10-30
3174031001,JAKARTA SELATAN,MAMPANG PRAPATAN,MAMPANG PRAPATAN,18159,3852,14307,11491,25798,2021-10-30
3173031005,JAKARTA BARAT,TAMAN SARI,MANGGA BESAR,7707,1344,6363,5458,11821,2021-10-30
3171021005,JAKARTA PUSAT,SAWAH BESAR,MANGGA DUA SELATAN,27442,5903,21539,17885,39424,2021-10-30
3174011007,JAKARTA SELATAN,TEBET,MANGGARAI,28373,5248,23125,18304,41429,2021-10-30
3174011006,JAKARTA SELATAN,TEBET,MANGGARAI SELATAN,23075,4258,18817,15512,34329,2021-10-30
3173031003,JAKARTA BARAT,TAMAN SARI,MAPHAR,16461,3174,13287,10836,24123,2021-10-30
3172041003,JAKARTA UTARA,CILINCING,MARUNDA,28943,6796,22147,16301,38448,2021-10-30
3174071001,JAKARTA SELATAN,KEBAYORAN BARU,MELAWAI,2627,527,2100,1921,4021,2021-10-30
3171061001,JAKARTA PUSAT,MENTENG,MENTENG,25624,5958,19666,15136,34802,2021-10-30
3174021005,JAKARTA SELATAN,SETIA BUDI,MENTENG ATAS,27816,5267,22549,18226,40775,2021-10-30
3174011003,JAKARTA SELATAN,TEBET,MENTENG DALAM,36028,7274,28754,23597,52351,2021-10-30
3173081003,JAKARTA BARAT,KEMBANGAN,MERUYA SELATAN,32130,6861,25269,20722,45991,2021-10-30
3173081002,JAKARTA BARAT,KEMBANGAN,MERUYA UTARA,43752,9310,34442,29354,63796,2021-10-30
3175101004,JAKARTA TIMUR,CIPAYUNG,MUNJUL,23871,4485,19386,16013,35399,2021-10-30
3172051002,JAKARTA UTARA,PADEMANGAN,PADEMANGAN BARAT,74240,18265,55975,44270,100245,2021-10-30
3172051001,JAKARTA UTARA,PADEMANGAN,PADEMANGAN TIMUR,37736,6912,30824,26373,57197,2021-10-30
3175011004,JAKARTA TIMUR,MATRAMAN,PAL MERIAM,19769,4304,15465,12159,27624,2021-10-30
3173071001,JAKARTA BARAT,PALMERAH,PALMERAH,63011,13866,49145,39013,88158,2021-10-30
3174081001,JAKARTA SELATAN,PANCORAN,PANCORAN,19421,4168,15253,12380,27633,2021-10-30
3172021003,JAKARTA UTARA,TANJUNG PRIOK,PAPANGGO,39097,8035,31062,24966,56028,2021-10-30
3171021001,JAKARTA PUSAT,SAWAH BESAR,PASAR BARU,12035,2370,9665,8493,18158,2021-10-30
3174021006,JAKARTA SELATAN,SETIA BUDI,PASAR MANGGIS,26752,5527,21225,17137,38362,2021-10-30
3174041001,JAKARTA SELATAN,PASAR MINGGU,PASAR MINGGU,24821,4839,19982,16621,36603,2021-10-30
3171041003,JAKARTA PUSAT,SENEN,PASEBAN,23533,5155,18378,14840,33218,2021-10-30
3173061005,JAKARTA BARAT,KALI DERES,PEGADUNGAN,75587,16045,59542,50515,110057,2021-10-30
3171061002,JAKARTA PUSAT,MENTENG,PEGANGSAAN,23455,5196,18259,13631,31890,2021-10-30
3172061002,JAKARTA UTARA,KELAPA GADING,PEGANGSAAN DUA,49976,8493,41483,37072,78555,2021-10-30
3172011004,JAKARTA UTARA,PENJARINGAN,PEJAGALAN,74578,16087,58491,49236,107727,2021-10-30
3174041006,JAKARTA SELATAN,PASAR MINGGU,PEJATEN BARAT,37346,7741,29605,24264,53869,2021-10-30
3174041005,JAKARTA SELATAN,PASAR MINGGU,PEJATEN TIMUR,57656,13618,44038,35601,79639,2021-10-30
3175051005,JAKARTA TIMUR,PASAR REBO,PEKAYON,43250,8129,35121,28503,63624,2021-10-30
3173041009,JAKARTA BARAT,TAMBORA,PEKOJAN,23587,4655,18932,15546,34478,2021-10-30
3174031003,JAKARTA SELATAN,MAMPANG PRAPATAN,PELA MAMPANG,43522,9012,34510,28152,62662,2021-10-30
3174081005,JAKARTA SELATAN,PANCORAN,PENGADEGAN,21478,4101,17377,14469,31846,2021-10-30
3175061003,JAKARTA TIMUR,CAKUNG,PENGGILINGAN,99255,24075,75180,59016,134196,2021-10-30
3172011001,JAKARTA UTARA,PENJARINGAN,PENJARINGAN,88308,23484,64824,48963,113787,2021-10-30
3174101001,JAKARTA SELATAN,PESANGGRAHAN,PESANGGRAHAN,27545,4932,22613,19032,41645,2021-10-30
3171071004,JAKARTA PUSAT,TANAH ABANG,PETAMBURAN,33271,9065,24206,17962,42168,2021-10-30
3174071008,JAKARTA SELATAN,KEBAYORAN BARU,PETOGOGAN,11499,2355,9144,7585,16729,2021-10-30
3171011004,JAKARTA PUSAT,GAMBIR,PETOJO SELATAN,14692,3409,11283,9407,20690,2021-10-30
3171011003,JAKARTA PUSAT,GAMBIR,PETOJO UTARA,17458,3887,13571,10939,24510,2021-10-30
3174101004,JAKARTA SELATAN,PESANGGRAHAN,PETUKANGAN SELATAN,37187,7943,29244,24031,53275,2021-10-30
3174101003,JAKARTA SELATAN,PESANGGRAHAN,PETUKANGAN UTARA,53716,12080,41636,33785,75421,2021-10-30
3175081002,JAKARTA TIMUR,MAKASAR,PINANG RANTI,27198,6139,21059,17087,38146,2021-10-30
3173031008,JAKARTA BARAT,TAMAN SARI,PINANGSIA,10729,1938,8791,7139,15930,2021-10-30
3175011001,JAKARTA TIMUR,MATRAMAN,PISANGAN BARU,31776,6833,24943,19344,44287,2021-10-30
3175021002,JAKARTA TIMUR,PULO GADUNG,PISANGAN TIMUR,41011,8038,32973,27329,60302,2021-10-30
3172011005,JAKARTA UTARA,PENJARINGAN,PLUIT,47783,9393,38390,33000,71390,2021-10-30
3175071002,JAKARTA TIMUR,DUREN SAWIT,PONDOK BAMBU,61550,13510,48040,38376,86416,2021-10-30
3175071004,JAKARTA TIMUR,DUREN SAWIT,PONDOK KELAPA,72015,14711,57304,48162,105466,2021-10-30
3175071007,JAKARTA TIMUR,DUREN SAWIT,PONDOK KOPI,35367,6835,28532,21893,50425,2021-10-30
3174061003,JAKARTA SELATAN,CILANDAK,PONDOK LABU,46464,8316,38148,32568,70716,2021-10-30
3174051002,JAKARTA SELATAN,KEBAYORAN LAMA,PONDOK PINANG,56169,11160,45009,37526,82535,2021-10-30
3175101003,JAKARTA TIMUR,CIPAYUNG,PONDOK RANGGON,25574,4950,20624,16918,37542,2021-10-30
3101011003,KAB.ADM.KEP.SERIBU,KEP. SERIBU UTARA,PULAU HARAPAN,2060,227,1833,1590,3423,2021-10-30
3101011002,KAB.ADM.KEP.SERIBU,KEP. SERIBU UTARA,PULAU KELAPA,5528,623,4905,4015,8920,2021-10-30
3101011001,KAB.ADM.KEP.SERIBU,KEP. SERIBU UTARA,PULAU PANGGANG,5450,457,4993,4431,9424,2021-10-30
3101021003,KAB.ADM.KEP.SERIBU,KEP. SERIBU SELATAN,PULAU PARI,2765,200,2565,2388,4953,2021-10-30
3101021002,KAB.ADM.KEP.SERIBU,KEP. SERIBU SELATAN,PULAU TIDUNG,4553,375,4178,3805,7983,2021-10-30
3101021001,KAB.ADM.KEP.SERIBU,KEP. SERIBU SELATAN,PULAU UNTUNG JAWA,1941,163,1778,1630,3408,2021-10-30
3174071007,JAKARTA SELATAN,KEBAYORAN BARU,PULO,5835,1051,4784,4287,9071,2021-10-30
3175021001,JAKARTA TIMUR,PULO GADUNG,PULO GADUNG,34422,7797,26625,21752,48377,2021-10-30
3175061005,JAKARTA TIMUR,CAKUNG,PULO GEBANG,97301,19430,77871,62124,139995,2021-10-30
3174041004,JAKARTA SELATAN,PASAR MINGGU,RAGUNAN,39616,7670,31946,26669,58615,2021-10-30
3175091005,JAKARTA TIMUR,CIRACAS,RAMBUTAN,36771,8924,27847,21630,49477,2021-10-30
3172031006,JAKARTA UTARA,KOJA,RAWA BADAK SELATAN,42179,10365,31814,24627,56441,2021-10-30
3172031004,JAKARTA UTARA,KOJA,RAWA BADAK UTARA,34408,7970,26438,20752,47190,2021-10-30
3174071005,JAKARTA SELATAN,KEBAYORAN BARU,RAWA BARAT,5625,1031,4594,4002,8596,2021-10-30
3173011003,JAKARTA BARAT,CENGKARENG,RAWA BUAYA,63799,13389,50410,39827,90237,2021-10-30
3175031004,JAKARTA TIMUR,JATINEGARA,RAWA BUNGA,21434,5372,16062,12693,28755,2021-10-30
3174081003,JAKARTA SELATAN,PANCORAN,RAWA JATI,20509,4031,16478,13752,30230,2021-10-30
3175061002,JAKARTA TIMUR,CAKUNG,RAWA TERATE,24637,4655,19982,15982,35964,2021-10-30
3175021005,JAKARTA TIMUR,PULO GADUNG,RAWAMANGUN,37612,7713,29899,24785,54684,2021-10-30
3171051003,JAKARTA PUSAT,CEMPAKA PUTIH,RAWASARI,21967,4646,17321,14401,31722,2021-10-30
3173041010,JAKARTA BARAT,TAMBORA,ROA MALAKA,3484,627,2857,2494,5351,2021-10-30
3172041006,JAKARTA UTARA,CILINCING,ROROTAN,41668,8663,33005,25853,58858,2021-10-30
3174071004,JAKARTA SELATAN,KEBAYORAN BARU,SELONG,2842,552,2290,2081,4371,2021-10-30
3173061002,JAKARTA BARAT,KALI DERES,SEMANAN,71354,16308,55046,43793,98839,2021-10-30
3172041007,JAKARTA UTARA,CILINCING,SEMPER BARAT,68587,13950,54637,44345,98982,2021-10-30
3172041005,JAKARTA UTARA,CILINCING,SEMPER TIMUR,36267,8088,28179,22351,50530,2021-10-30
3174071006,JAKARTA SELATAN,KEBAYORAN BARU,SENAYAN,2771,672,2099,1775,3874,2021-10-30
3171041001,JAKARTA PUSAT,SENEN,SENEN,6804,1520,5284,4343,9627,2021-10-30
3171031004,JAKARTA PUSAT,KEMAYORAN,SERDANG,29668,6131,23537,19259,42796,2021-10-30
3174021001,JAKARTA SELATAN,SETIA BUDI,SETIA BUDI,3023,633,2390,1970,4360,2021-10-30
3175101005,JAKARTA TIMUR,CIPAYUNG,SETU,20572,4246,16326,12876,29202,2021-10-30
3173071002,JAKARTA BARAT,PALMERAH,SLIPI,16591,3112,13479,11076,24555,2021-10-30
3173081004,JAKARTA BARAT,KEMBANGAN,SRENGSENG,45523,10594,34929,29081,64010,2021-10-30
3174091002,JAKARTA SELATAN,JAGAKARSA,SRENGSENG SAWAH,58196,9372,48824,40427,89251,2021-10-30
3173051003,JAKARTA BARAT,KEBON JERUK,SUKABUMI SELATAN,37033,8678,28355,21461,49816,2021-10-30
3173051002,JAKARTA BARAT,KEBON JERUK,SUKABUMI UTARA,38290,9307,28983,22189,51172,2021-10-30
3172041002,JAKARTA UTARA,CILINCING,SUKAPURA,53949,12632,41317,33305,74622,2021-10-30
3171031007,JAKARTA PUSAT,KEMAYORAN,SUMUR BATU,22717,4773,17944,15006,32950,2021-10-30
3172021004,JAKARTA UTARA,TANJUNG PRIOK,SUNGAI BAMBU,29876,6248,23628,19140,42768,2021-10-30
3172021006,JAKARTA UTARA,TANJUNG PRIOK,SUNTER AGUNG,71805,12928,58877,50418,109295,2021-10-30
3172021002,JAKARTA UTARA,TANJUNG PRIOK,SUNTER JAYA,63031,11535,51496,43652,95148,2021-10-30
3175091004,JAKARTA TIMUR,CIRACAS,SUSUKAN,38257,7499,30758,25024,55782,2021-10-30
3173031001,JAKARTA BARAT,TAMAN SARI,TAMAN SARI,14348,2728,11620,9837,21457,2021-10-30
3173041001,JAKARTA BARAT,TAMBORA,TAMBORA,10204,2345,7859,6218,14077,2021-10-30
3173041004,JAKARTA BARAT,TAMBORA,TANAH SEREAL,26387,4648,21739,17957,39696,2021-10-30
3171081004,JAKARTA PUSAT,JOHAR BARU,TANAH TINGGI,37693,7383,30310,24202,54512,2021-10-30
3173031004,JAKARTA BARAT,TAMAN SARI,TANGKI,13324,2292,11032,9111,20143,2021-10-30
3174091005,JAKARTA SELATAN,JAGAKARSA,TANJUNG BARAT,39770,7030,32740,26156,58896,2021-10-30
3173021005,JAKARTA BARAT,GROGOL PETAMBURAN,TANJUNG DUREN SELATAN,25337,5001,20336,17512,37848,2021-10-30
3173021002,JAKARTA BARAT,GROGOL PETAMBURAN,TANJUNG DUREN UTARA,17010,2972,14038,12295,26333,2021-10-30
3172021001,JAKARTA UTARA,TANJUNG PRIOK,TANJUNG PRIOK,34588,7382,27206,21757,48963,2021-10-30
3174011002,JAKARTA SELATAN,TEBET,TEBET BARAT,21194,3617,17577,15197,32774,2021-10-30
3174011001,JAKARTA SELATAN,TEBET,TEBET TIMUR,18199,3038,15161,13411,28572,2021-10-30
3173061003,JAKARTA BARAT,KALI DERES,TEGAL ALUR,83647,18419,65228,52910,118138,2021-10-30
3174031004,JAKARTA SELATAN,MAMPANG PRAPATAN,TEGAL PARANG,32401,7494,24907,18825,43732,2021-10-30
3173021003,JAKARTA BARAT,GROGOL PETAMBURAN,TOMANG,29605,5662,23943,20094,44037,2021-10-30
3172031005,JAKARTA UTARA,KOJA,TUGU SELATAN,39122,9042,30080,23852,53932,2021-10-30
3172031002,JAKARTA UTARA,KOJA,TUGU UTARA,67670,16580,51090,39583,90673,2021-10-30
3175061006,JAKARTA TIMUR,CAKUNG,UJUNG MENTENG,29934,5402,24532,20443,44975,2021-10-30
3174101005,JAKARTA SELATAN,PESANGGRAHAN,ULUJAMI,40544,9562,30982,24902,55884,2021-10-30
3175011006,JAKARTA TIMUR,MATRAMAN,UTAN KAYU SELATAN,33511,6325,27186,22011,49197,2021-10-30
3175011002,JAKARTA TIMUR,MATRAMAN,UTAN KAYU UTARA,28169,6117,22052,17695,39747,2021-10-30
3171031008,JAKARTA PUSAT,KEMAYORAN,UTAN PANJANG,29208,6162,23046,18264,41310,2021-10-30
3172021007,JAKARTA UTARA,TANJUNG PRIOK,WARAKAS,44401,8443,35958,28362,64320,2021-10-30
3173021007,JAKARTA BARAT,GROGOL PETAMBURAN,WIJAYA KUSUMA,38934,8437,30497,25062,55559,2021-10-30
3172051003,JAKARTA UTARA,PADEMANGAN,ANCOL,23947,5991,17956,14504,32460,2021-10-31
3173041007,JAKARTA BARAT,TAMBORA,ANGKE,29381,6557,22824,18185,41009,2021-10-31
3175041005,JAKARTA TIMUR,KRAMAT JATI,BALE KAMBANG,29074,7586,21488,16444,37932,2021-10-31
3175031003,JAKARTA TIMUR,JATINEGARA,BALI MESTER,9752,2125,7627,6277,13904,2021-10-31
3175101006,JAKARTA TIMUR,CIPAYUNG,BAMBU APUS,26285,5014,21271,17291,38562,2021-10-31
3174031002,JAKARTA SELATAN,MAMPANG PRAPATAN,BANGKA,21566,4742,16824,13579,30403,2021-10-31
3175051002,JAKARTA TIMUR,PASAR REBO,BARU,23886,4089,19797,16697,36494,2021-10-31
3175041004,JAKARTA TIMUR,KRAMAT JATI,BATU AMPAR,47898,12196,35702,27942,63644,2021-10-31
3171071002,JAKARTA PUSAT,TANAH ABANG,BENDUNGAN HILIR,21494,4492,17002,14176,31178,2021-10-31
3175031002,JAKARTA TIMUR,JATINEGARA,BIDARA CINA,36689,9111,27578,21447,49025,2021-10-31
3174101002,JAKARTA SELATAN,PESANGGRAHAN,BINTARO,53098,11045,42053,35340,77393,2021-10-31
3174011005,JAKARTA SELATAN,TEBET,BUKIT DURI,34183,7267,26916,21996,48912,2021-10-31
3171041006,JAKARTA PUSAT,SENEN,BUNGUR,18144,3957,14187,11595,25782,2021-10-31
3175061007,JAKARTA TIMUR,CAKUNG,CAKUNG BARAT,57724,12342,45382,36858,82240,2021-10-31
3175061004,JAKARTA TIMUR,CAKUNG,CAKUNG TIMUR,58287,11957,46330,37682,84012,2021-10-31
3175041007,JAKARTA TIMUR,KRAMAT JATI,CAWANG,32762,7407,25355,19771,45126,2021-10-31
3175101008,JAKARTA TIMUR,CIPAYUNG,CEGER,18932,3827,15105,12329,27434,2021-10-31
3171031006,JAKARTA PUSAT,KEMAYORAN,CEMPAKA BARU,32581,6699,25882,19962,45844,2021-10-31
3171051002,JAKARTA PUSAT,CEMPAKA PUTIH,CEMPAKA PUTIH BARAT,35885,7894,27991,23268,51259,2021-10-31
3171051001,JAKARTA PUSAT,CEMPAKA PUTIH,CEMPAKA PUTIH TIMUR,24292,5150,19142,16259,35401,2021-10-31
3173011001,JAKARTA BARAT,CENGKARENG,CENGKARENG BARAT,66284,13802,52482,43274,95756,2021-10-31
3173011006,JAKARTA BARAT,CENGKARENG,CENGKARENG TIMUR,81027,16686,64341,51820,116161,2021-10-31
3175091002,JAKARTA TIMUR,CIRACAS,CIBUBUR,66364,11782,54582,44625,99207,2021-10-31
3171011002,JAKARTA PUSAT,GAMBIR,CIDENG,15390,3076,12314,10547,22861,2021-10-31
3174091003,JAKARTA SELATAN,JAGAKARSA,CIGANJUR,38497,6878,31619,25283,56902,2021-10-31
3175051003,JAKARTA TIMUR,PASAR REBO,CIJANTUNG,41419,7984,33435,27297,60732,2021-10-31
3171061003,JAKARTA PUSAT,MENTENG,CIKINI,8274,1532,6742,5215,11957,2021-10-31
3174081006,JAKARTA SELATAN,PANCORAN,CIKOKO,10547,1891,8656,7348,16004,2021-10-31
3174061001,JAKARTA SELATAN,CILANDAK,CILANDAK BARAT,51752,9549,42203,35775,77978,2021-10-31
3174041003,JAKARTA SELATAN,PASAR MINGGU,CILANDAK TIMUR,25145,4792,20353,16909,37262,2021-10-31
3175101002,JAKARTA TIMUR,CIPAYUNG,CILANGKAP,27635,5055,22580,18579,41159,2021-10-31
3175041006,JAKARTA TIMUR,KRAMAT JATI,CILILITAN,40181,9340,30841,24479,55320,2021-10-31
3172041001,JAKARTA UTARA,CILINCING,CILINCING,43609,10809,32800,24868,57668,2021-10-31
3175101001,JAKARTA TIMUR,CIPAYUNG,CIPAYUNG,26104,4710,21394,18028,39422,2021-10-31
3174091006,JAKARTA SELATAN,JAGAKARSA,CIPEDAK,38303,6611,31692,25870,57562,2021-10-31
3174061005,JAKARTA SELATAN,CILANDAK,CIPETE SELATAN,26704,5332,21372,18288,39660,2021-10-31
3174071010,JAKARTA SELATAN,KEBAYORAN BARU,CIPETE UTARA,34102,6699,27403,22008,49411,2021-10-31
3175021003,JAKARTA TIMUR,PULO GADUNG,CIPINANG,39306,7632,31674,25699,57373,2021-10-31
3175031007,JAKARTA TIMUR,JATINEGARA,CIPINANG BESAR SELATAN,35212,8644,26568,20240,46808,2021-10-31
3175031008,JAKARTA TIMUR,JATINEGARA,CIPINANG BESAR UTARA,45319,11149,34170,25812,59982,2021-10-31
3175031005,JAKARTA TIMUR,JATINEGARA,CIPINANG CEMPEDAK,32824,7363,25461,20829,46290,2021-10-31
3175081005,JAKARTA TIMUR,MAKASAR,CIPINANG MELAYU,42308,8474,33834,28049,61883,2021-10-31
3175031006,JAKARTA TIMUR,JATINEGARA,CIPINANG MUARA,55243,12302,42941,34049,76990,2021-10-31
3174051003,JAKARTA SELATAN,KEBAYORAN LAMA,CIPULIR,39937,8685,31252,24755,56007,2021-10-31
3175091001,JAKARTA TIMUR,CIRACAS,CIRACAS,64594,12271,52323,41904,94227,2021-10-31
3175041003,JAKARTA TIMUR,KRAMAT JATI,DUKUH,24609,4824,19785,15909,35694,2021-10-31
3175071001,JAKARTA TIMUR,DUREN SAWIT,DUREN SAWIT,61160,13390,47770,38230,86000,2021-10-31
3174081004,JAKARTA SELATAN,PANCORAN,DUREN TIGA,28319,5875,22444,18324,40768,2021-10-31
3173051005,JAKARTA BARAT,KEBON JERUK,DURI KEPA,60138,12134,48004,40781,88785,2021-10-31
3173011002,JAKARTA BARAT,CENGKARENG,DURI KOSAMBI,77923,17340,60583,47492,108075,2021-10-31
3171011006,JAKARTA PUSAT,GAMBIR,DURI PULO,19610,4318,15292,12075,27367,2021-10-31
3173041011,JAKARTA BARAT,TAMBORA,DURI SELATAN,14259,2625,11634,9661,21295,2021-10-31
3173041003,JAKARTA BARAT,TAMBORA,DURI UTARA,19844,3738,16106,13017,29123,2021-10-31
3171081003,JAKARTA PUSAT,JOHAR BARU,GALUR,18243,3706,14537,11570,26107,2021-10-31
3171011001,JAKARTA PUSAT,GAMBIR,GAMBIR,2191,471,1720,1461,3181,2021-10-31
3174061004,JAKARTA SELATAN,CILANDAK,GANDARIA SELATAN,22119,4412,17707,14614,32321,2021-10-31
3174071009,JAKARTA SELATAN,KEBAYORAN BARU,GANDARIA UTARA,39922,8260,31662,25862,57524,2021-10-31
3175051001,JAKARTA TIMUR,PASAR REBO,GEDONG,35755,7432,28323,23338,51661,2021-10-31
3171071001,JAKARTA PUSAT,TANAH ABANG,GELORA,3127,631,2496,2114,4610,2021-10-31
3173031007,JAKARTA BARAT,TAMAN SARI,GLODOK,7837,1231,6606,5812,12418,2021-10-31
3171061004,JAKARTA PUSAT,MENTENG,GONDANGDIA,4100,943,3157,2854,6011,2021-10-31
3173021001,JAKARTA BARAT,GROGOL PETAMBURAN,GROGOL,16876,3498,13378,11042,24420,2021-10-31
3174051005,JAKARTA SELATAN,KEBAYORAN LAMA,GROGOL SELATAN,44251,9220,35031,28031,63062,2021-10-31
3174051004,JAKARTA SELATAN,KEBAYORAN LAMA,GROGOL UTARA,42494,8961,33533,27200,60733,2021-10-31
3174021007,JAKARTA SELATAN,SETIA BUDI,GUNTUR,3985,772,3213,2775,5988,2021-10-31
3174071002,JAKARTA SELATAN,KEBAYORAN BARU,GUNUNG,9436,1812,7624,6552,14176,2021-10-31
3171031005,JAKARTA PUSAT,KEMAYORAN,GUNUNG SAHARI SELATAN,19199,4010,15189,12503,27692,2021-10-31
3171021004,JAKARTA PUSAT,SAWAH BESAR,GUNUNG SAHARI UTARA,16650,3037,13613,11910,25523,2021-10-31
3175081004,JAKARTA TIMUR,MAKASAR,HALIM PERDANA KUSUMAH,28363,3800,24563,22120,46683,2021-10-31
3171031003,JAKARTA PUSAT,KEMAYORAN,HARAPAN MULIA,22557,4747,17810,14128,31938,2021-10-31
3174091001,JAKARTA SELATAN,JAGAKARSA,JAGAKARSA,62389,10824,51565,41587,93152,2021-10-31
3175021007,JAKARTA TIMUR,PULO GADUNG,JATI,32757,6361,26396,22308,48704,2021-10-31
3174041002,JAKARTA SELATAN,PASAR MINGGU,JATI PADANG,37502,7781,29721,24470,54191,2021-10-31
3173071004,JAKARTA BARAT,PALMERAH,JATI PULO,28738,5979,22759,17877,40636,2021-10-31
3175061001,JAKARTA TIMUR,CAKUNG,JATINEGARA,84160,18727,65433,52763,118196,2021-10-31
3175021004,JAKARTA TIMUR,PULO GADUNG,JATINEGARA KAUM,24632,4603,20029,15822,35851,2021-10-31
3173021004,JAKARTA BARAT,GROGOL PETAMBURAN,JELAMBAR,30266,5721,24545,20861,45406,2021-10-31
3173021006,JAKARTA BARAT,GROGOL PETAMBURAN,JELAMBAR BARU,38246,7421,30825,26152,56977,2021-10-31
3173041006,JAKARTA BARAT,TAMBORA,JEMBATAN BESI,29314,7352,21962,16728,38690,2021-10-31
3173041008,JAKARTA BARAT,TAMBORA,JEMBATAN LIMA,21021,5145,15876,12318,28194,2021-10-31
3173081005,JAKARTA BARAT,KEMBANGAN,JOGLO,40839,8647,32192,26803,58995,2021-10-31
3171081001,JAKARTA PUSAT,JOHAR BARU,JOHAR BARU,37488,7151,30337,25176,55513,2021-10-31
3173041002,JAKARTA BARAT,TAMBORA,KALI ANYAR,23856,4915,18941,14790,33731,2021-10-31
3172041004,JAKARTA UTARA,CILINCING,KALIBARU,67684,19116,48568,34004,82572,2021-10-31
3174081002,JAKARTA SELATAN,PANCORAN,KALIBATA,41994,9921,32073,25267,57340,2021-10-31
3173061001,JAKARTA BARAT,KALI DERES,KALIDERES,72447,15565,56882,47237,104119,2021-10-31
3175051004,JAKARTA TIMUR,PASAR REBO,KALISARI,43212,8034,35178,28860,64038,2021-10-31
3173061004,JAKARTA BARAT,KALI DERES,KAMAL,53783,13071,40712,31701,72413,2021-10-31
3172011002,JAKARTA UTARA,PENJARINGAN,KAMAL MUARA,12930,2328,10602,8945,19547,2021-10-31
3171071007,JAKARTA PUSAT,TANAH ABANG,KAMPUNG BALI,11358,2536,8822,6608,15430,2021-10-31
3175031001,JAKARTA TIMUR,JATINEGARA,KAMPUNG MELAYU,25717,6022,19695,15042,34737,2021-10-31
3171081002,JAKARTA PUSAT,JOHAR BARU,KAMPUNG RAWA,21237,3621,17616,13883,31499,2021-10-31
3175041002,JAKARTA TIMUR,KRAMAT JATI,KAMPUNG TENGAH,43993,11432,32561,25319,57880,2021-10-31
3173011005,JAKARTA BARAT,CENGKARENG,KAPUK,134466,33764,100702,79536,180238,2021-10-31
3172011003,JAKARTA UTARA,PENJARINGAN,KAPUK MUARA,35781,7104,28677,24748,53425,2021-10-31
3171021002,JAKARTA PUSAT,SAWAH BESAR,KARANG ANYAR,25761,5159,20602,17065,37667,2021-10-31
3174021004,JAKARTA SELATAN,SETIA BUDI,KARET,9623,1899,7724,6280,14004,2021-10-31
3174021003,JAKARTA SELATAN,SETIA BUDI,KARET KUNINGAN,16055,3235,12820,10626,23446,2021-10-31
3174021002,JAKARTA SELATAN,SETIA BUDI,KARET SEMANGGI,2770,567,2203,1932,4135,2021-10-31
3171071003,JAKARTA PUSAT,TANAH ABANG,KARET TENGSIN,19271,3836,15435,12274,27709,2021-10-31
3171021003,JAKARTA PUSAT,SAWAH BESAR,KARTINI,22292,4438,17854,15032,32886,2021-10-31
3175011003,JAKARTA TIMUR,MATRAMAN,KAYU MANIS,25284,5554,19730,15252,34982,2021-10-31
3175021006,JAKARTA TIMUR,PULO GADUNG,KAYU PUTIH,40696,7929,32767,28115,60882,2021-10-31
3173031006,JAKARTA BARAT,TAMAN SARI,KEAGUNGAN,17387,3344,14043,11241,25284,2021-10-31
3174041007,JAKARTA SELATAN,PASAR MINGGU,KEBAGUSAN,44552,9154,35398,28449,63847,2021-10-31
3174051006,JAKARTA SELATAN,KEBAYORAN LAMA,KEBAYORAN LAMA SELATAN,41212,7963,33249,27309,60558,2021-10-31
3174051001,JAKARTA SELATAN,KEBAYORAN LAMA,KEBAYORAN LAMA UTARA,42422,9191,33231,26649,59880,2021-10-31
3174011004,JAKARTA SELATAN,TEBET,KEBON BARU,35165,6894,28271,23104,51375,2021-10-31
3172021005,JAKARTA UTARA,TANJUNG PRIOK,KEBON BAWANG,50952,10742,40210,32702,72912,2021-10-31
3173051001,JAKARTA BARAT,KEBON JERUK,KEBON JERUK,53887,12059,41828,33593,75421,2021-10-31
3171071006,JAKARTA PUSAT,TANAH ABANG,KEBON KACANG,21531,5305,16226,12533,28759,2021-10-31
3171011005,JAKARTA PUSAT,GAMBIR,KEBON KELAPA,10163,2100,8063,6651,14714,2021-10-31
3171031002,JAKARTA PUSAT,KEMAYORAN,KEBON KOSONG,30019,6235,23784,18842,42626,2021-10-31
3175011005,JAKARTA TIMUR,MATRAMAN,KEBON MANGGIS,16490,3353,13137,10658,23795,2021-10-31
3171071005,JAKARTA PUSAT,TANAH ABANG,KEBON MELATI,32206,8853,23353,16902,40255,2021-10-31
3175081003,JAKARTA TIMUR,MAKASAR,KEBON PALA,46614,9647,36967,30078,67045,2021-10-31
3171061005,JAKARTA PUSAT,MENTENG,KEBON SIRIH,12299,2737,9562,7542,17104,2021-10-31
3173011004,JAKARTA BARAT,CENGKARENG,KEDAUNG KALI ANGKE,32612,6578,26034,21402,47436,2021-10-31
3173051007,JAKARTA BARAT,KEBON JERUK,KEDOYA SELATAN,32165,6049,26116,21268,47384,2021-10-31
3173051006,JAKARTA BARAT,KEBON JERUK,KEDOYA UTARA,45740,8915,36825,30700,67525,2021-10-31
3173051004,JAKARTA BARAT,KEBON JERUK,KELAPA DUA,23565,4964,18601,15221,33822,2021-10-31
3175091003,JAKARTA TIMUR,CIRACAS,KELAPA DUA WETAN,46875,8322,38553,31660,70213,2021-10-31
3172061003,JAKARTA UTARA,KELAPA GADING,KELAPA GADING BARAT,35717,6383,29334,26091,55425,2021-10-31
3172061001,JAKARTA UTARA,KELAPA GADING,KELAPA GADING TIMUR,33592,5270,28322,25846,54168,2021-10-31
3173071005,JAKARTA BARAT,PALMERAH,KEMANGGISAN,32139,6310,25829,21061,46890,2021-10-31
3171031001,JAKARTA PUSAT,KEMAYORAN,KEMAYORAN,20708,4458,16250,13210,29460,2021-10-31
3173081006,JAKARTA BARAT,KEMBANGAN,KEMBANGAN SELATAN,27130,5861,21269,18069,39338,2021-10-31
3173081001,JAKARTA BARAT,KEMBANGAN,KEMBANGAN UTARA,54451,12368,42083,34484,76567,2021-10-31
3171041002,JAKARTA PUSAT,SENEN,KENARI,9579,1940,7639,6406,14045,2021-10-31
3173041005,JAKARTA BARAT,TAMBORA,KERENDANG,19973,4255,15718,12531,28249,2021-10-31
3175071003,JAKARTA TIMUR,DUREN SAWIT,KLENDER,69978,16929,53049,41206,94255,2021-10-31
3172031001,JAKARTA UTARA,KOJA,KOJA,28175,6632,21543,17091,38634,2021-10-31
3173071006,JAKARTA BARAT,PALMERAH,KOTA BAMBU SELATAN,21158,4467,16691,12850,29541,2021-10-31
3173071003,JAKARTA BARAT,PALMERAH,KOTA BAMBU UTARA,24995,5374,19621,14977,34598,2021-10-31
3171041004,JAKARTA PUSAT,SENEN,KRAMAT,28835,7163,21672,16231,37903,2021-10-31
3175041001,JAKARTA TIMUR,KRAMAT JATI,KRAMAT JATI,34144,7768,26376,20991,47367,2021-10-31
3174071003,JAKARTA SELATAN,KEBAYORAN BARU,KRAMAT PELA,14413,2883,11530,9565,21095,2021-10-31
3173031002,JAKARTA BARAT,TAMAN SARI,KRUKUT,19244,3744,15500,12244,27744,2021-10-31
3174031005,JAKARTA SELATAN,MAMPANG PRAPATAN,KUNINGAN BARAT,12785,2458,10327,8458,18785,2021-10-31
3174021008,JAKARTA SELATAN,SETIA BUDI,KUNINGAN TIMUR,6008,1238,4770,3941,8711,2021-10-31
3171041005,JAKARTA PUSAT,SENEN,KWITANG,15486,3623,11863,9439,21302,2021-10-31
3172031003,JAKARTA UTARA,KOJA,LAGOA,59065,14457,44608,34619,79227,2021-10-31
3174061002,JAKARTA SELATAN,CILANDAK,LEBAK BULUS,37626,7429,30197,25520,55717,2021-10-31
3174091004,JAKARTA SELATAN,JAGAKARSA,LENTENG AGUNG,53946,10114,43832,34475,78307,2021-10-31
3175101007,JAKARTA TIMUR,CIPAYUNG,LUBANG BUAYA,63547,12336,51211,41499,92710,2021-10-31
3175081001,JAKARTA TIMUR,MAKASAR,MAKASAR,34390,6572,27818,23011,50829,2021-10-31
3175071006,JAKARTA TIMUR,DUREN SAWIT,MALAKA JAYA,30927,5581,25346,21189,46535,2021-10-31
3175071005,JAKARTA TIMUR,DUREN SAWIT,MALAKA SARI,27530,4787,22743,19185,41928,2021-10-31
3174031001,JAKARTA SELATAN,MAMPANG PRAPATAN,MAMPANG PRAPATAN,18159,3843,14316,11513,25829,2021-10-31
3173031005,JAKARTA BARAT,TAMAN SARI,MANGGA BESAR,7707,1341,6366,5466,11832,2021-10-31
3171021005,JAKARTA PUSAT,SAWAH BESAR,MANGGA DUA SELATAN,27442,5895,21547,17907,39454,2021-10-31
3174011007,JAKARTA SELATAN,TEBET,MANGGARAI,28373,5238,23135,18333,41468,2021-10-31
3174011006,JAKARTA SELATAN,TEBET,MANGGARAI SELATAN,23075,4250,18825,15538,34363,2021-10-31
3173031003,JAKARTA BARAT,TAMAN SARI,MAPHAR,16461,3167,13294,10849,24143,2021-10-31
3172041003,JAKARTA UTARA,CILINCING,MARUNDA,28943,6783,22160,16317,38477,2021-10-31
3174071001,JAKARTA SELATAN,KEBAYORAN BARU,MELAWAI,2627,525,2102,1924,4026,2021-10-31
3171061001,JAKARTA PUSAT,MENTENG,MENTENG,25624,5916,19708,15183,34891,2021-10-31
3174021005,JAKARTA SELATAN,SETIA BUDI,MENTENG ATAS,27816,5261,22555,18251,40806,2021-10-31
3174011003,JAKARTA SELATAN,TEBET,MENTENG DALAM,36028,7253,28775,23623,52398,2021-10-31
3173081003,JAKARTA BARAT,KEMBANGAN,MERUYA SELATAN,32130,6856,25274,20743,46017,2021-10-31
3173081002,JAKARTA BARAT,KEMBANGAN,MERUYA UTARA,43752,9289,34463,29375,63838,2021-10-31
3175101004,JAKARTA TIMUR,CIPAYUNG,MUNJUL,23871,4478,19393,16032,35425,2021-10-31
3172051002,JAKARTA UTARA,PADEMANGAN,PADEMANGAN BARAT,74240,18233,56007,44337,100344,2021-10-31
3172051001,JAKARTA UTARA,PADEMANGAN,PADEMANGAN TIMUR,37736,6892,30844,26411,57255,2021-10-31
3175011004,JAKARTA TIMUR,MATRAMAN,PAL MERIAM,19769,4294,15475,12175,27650,2021-10-31
3173071001,JAKARTA BARAT,PALMERAH,PALMERAH,63011,13838,49173,39065,88238,2021-10-31
3174081001,JAKARTA SELATAN,PANCORAN,PANCORAN,19421,4157,15264,12397,27661,2021-10-31
3172021003,JAKARTA UTARA,TANJUNG PRIOK,PAPANGGO,39097,7983,31114,25023,56137,2021-10-31
3171021001,JAKARTA PUSAT,SAWAH BESAR,PASAR BARU,12035,2363,9672,8507,18179,2021-10-31
3174021006,JAKARTA SELATAN,SETIA BUDI,PASAR MANGGIS,26752,5514,21238,17157,38395,2021-10-31
3174041001,JAKARTA SELATAN,PASAR MINGGU,PASAR MINGGU,24821,4836,19985,16653,36638,2021-10-31
3171041003,JAKARTA PUSAT,SENEN,PASEBAN,23533,5142,18391,14871,33262,2021-10-31
3173061005,JAKARTA BARAT,KALI DERES,PEGADUNGAN,75587,16030,59557,50560,110117,2021-10-31
3171061002,JAKARTA PUSAT,MENTENG,PEGANGSAAN,23455,5187,18268,13655,31923,2021-10-31
3172061002,JAKARTA UTARA,KELAPA GADING,PEGANGSAAN DUA,49976,8481,41495,37106,78601,2021-10-31
3172011004,JAKARTA UTARA,PENJARINGAN,PEJAGALAN,74578,16047,58531,49302,107833,2021-10-31
3174041006,JAKARTA SELATAN,PASAR MINGGU,PEJATEN BARAT,37346,7731,29615,24289,53904,2021-10-31
3174041005,JAKARTA SELATAN,PASAR MINGGU,PEJATEN TIMUR,57656,13595,44061,35654,79715,2021-10-31
3175051005,JAKARTA TIMUR,PASAR REBO,PEKAYON,43250,8118,35132,28530,63662,2021-10-31
3173041009,JAKARTA BARAT,TAMBORA,PEKOJAN,23587,4649,18938,15561,34499,2021-10-31
3174031003,JAKARTA SELATAN,MAMPANG PRAPATAN,PELA MAMPANG,43522,8988,34534,28212,62746,2021-10-31
3174081005,JAKARTA SELATAN,PANCORAN,PENGADEGAN,21478,4090,17388,14479,31867,2021-10-31
3175061003,JAKARTA TIMUR,CAKUNG,PENGGILINGAN,99255,24039,75216,59100,134316,2021-10-31
3172011001,JAKARTA UTARA,PENJARINGAN,PENJARINGAN,88308,23356,64952,49070,114022,2021-10-31
3174101001,JAKARTA SELATAN,PESANGGRAHAN,PESANGGRAHAN,27545,4914,22631,19063,41694,2021-10-31
3171071004,JAKARTA PUSAT,TANAH ABANG,PETAMBURAN,33271,9045,24226,17983,42209,2021-10-31
3174071008,JAKARTA SELATAN,KEBAYORAN BARU,PETOGOGAN,11499,2351,9148,7602,16750,2021-10-31
3171011004,JAKARTA PUSAT,GAMBIR,PETOJO SELATAN,14692,3404,11288,9419,20707,2021-10-31
3171011003,JAKARTA PUSAT,GAMBIR,PETOJO UTARA,17458,3878,13580,10960,24540,2021-10-31
3174101004,JAKARTA SELATAN,PESANGGRAHAN,PETUKANGAN SELATAN,37187,7927,29260,24070,53330,2021-10-31
3174101003,JAKARTA SELATAN,PESANGGRAHAN,PETUKANGAN UTARA,53716,12056,41660,33875,75535,2021-10-31
3175081002,JAKARTA TIMUR,MAKASAR,PINANG RANTI,27198,6113,21085,17123,38208,2021-10-31
3173031008,JAKARTA BARAT,TAMAN SARI,PINANGSIA,10729,1938,8791,7146,15937,2021-10-31
3175011001,JAKARTA TIMUR,MATRAMAN,PISANGAN BARU,31776,6818,24958,19383,44341,2021-10-31
3175021002,JAKARTA TIMUR,PULO GADUNG,PISANGAN TIMUR,41011,8026,32985,27365,60350,2021-10-31
3172011005,JAKARTA UTARA,PENJARINGAN,PLUIT,47783,9384,38399,33026,71425,2021-10-31
3175071002,JAKARTA TIMUR,DUREN SAWIT,PONDOK BAMBU,61550,13478,48072,38415,86487,2021-10-31
3175071004,JAKARTA TIMUR,DUREN SAWIT,PONDOK KELAPA,72015,14688,57327,48216,105543,2021-10-31
3175071007,JAKARTA TIMUR,DUREN SAWIT,PONDOK KOPI,35367,6829,28538,21918,50456,2021-10-31
3174061003,JAKARTA SELATAN,CILANDAK,PONDOK LABU,46464,8285,38179,32616,70795,2021-10-31
3174051002,JAKARTA SELATAN,KEBAYORAN LAMA,PONDOK PINANG,56169,11135,45034,37570,82604,2021-10-31
3175101003,JAKARTA TIMUR,CIPAYUNG,PONDOK RANGGON,25574,4942,20632,16933,37565,2021-10-31
3101011003,KAB.ADM.KEP.SERIBU,KEP. SERIBU UTARA,PULAU HARAPAN,2060,227,1833,1591,3424,2021-10-31
3101011002,KAB.ADM.KEP.SERIBU,KEP. SERIBU UTARA,PULAU KELAPA,5528,622,4906,4015,8921,2021-10-31
3101011001,KAB.ADM.KEP.SERIBU,KEP. SERIBU UTARA,PULAU PANGGANG,5450,455,4995,4436,9431,2021-10-31
3101021003,KAB.ADM.KEP.SERIBU,KEP. SERIBU SELATAN,PULAU PARI,2765,200,2565,2388,4953,2021-10-31
3101021002,KAB.ADM.KEP.SERIBU,KEP. SERIBU SELATAN,PULAU TIDUNG,4553,375,4178,3806,7984,2021-10-31
3101021001,KAB.ADM.KEP.SERIBU,KEP. SERIBU SELATAN,PULAU UNTUNG JAWA,1941,163,1778,1630,3408,2021-10-31
3174071007,JAKARTA SELATAN,KEBAYORAN BARU,PULO,5835,1041,4794,4301,9095,2021-10-31
3175021001,JAKARTA TIMUR,PULO GADUNG,PULO GADUNG,34422,7774,26648,21806,48454,2021-10-31
3175061005,JAKARTA TIMUR,CAKUNG,PULO GEBANG,97301,19389,77912,62237,140149,2021-10-31
3174041004,JAKARTA SELATAN,PASAR MINGGU,RAGUNAN,39616,7656,31960,26724,58684,2021-10-31
3175091005,JAKARTA TIMUR,CIRACAS,RAMBUTAN,36771,8907,27864,21656,49520,2021-10-31
3172031006,JAKARTA UTARA,KOJA,RAWA BADAK SELATAN,42179,10350,31829,24648,56477,2021-10-31
3172031004,JAKARTA UTARA,KOJA,RAWA BADAK UTARA,34408,7963,26445,20776,47221,2021-10-31
3174071005,JAKARTA SELATAN,KEBAYORAN BARU,RAWA BARAT,5625,1028,4597,4014,8611,2021-10-31
3173011003,JAKARTA BARAT,CENGKARENG,RAWA BUAYA,63799,13364,50435,39854,90289,2021-10-31
3175031004,JAKARTA TIMUR,JATINEGARA,RAWA BUNGA,21434,5356,16078,12702,28780,2021-10-31
3174081003,JAKARTA SELATAN,PANCORAN,RAWA JATI,20509,4017,16492,13767,30259,2021-10-31
3175061002,JAKARTA TIMUR,CAKUNG,RAWA TERATE,24637,4644,19993,16001,35994,2021-10-31
3175021005,JAKARTA TIMUR,PULO GADUNG,RAWAMANGUN,37612,7704,29908,24813,54721,2021-10-31
3171051003,JAKARTA PUSAT,CEMPAKA PUTIH,RAWASARI,21967,4639,17328,14419,31747,2021-10-31
3173041010,JAKARTA BARAT,TAMBORA,ROA MALAKA,3484,627,2857,2496,5353,2021-10-31
3172041006,JAKARTA UTARA,CILINCING,ROROTAN,41668,8636,33032,25911,58943,2021-10-31
3174071004,JAKARTA SELATAN,KEBAYORAN BARU,SELONG,2842,551,2291,2082,4373,2021-10-31
3173061002,JAKARTA BARAT,KALI DERES,SEMANAN,71354,16280,55074,43834,98908,2021-10-31
3172041007,JAKARTA UTARA,CILINCING,SEMPER BARAT,68587,13930,54657,44390,99047,2021-10-31
3172041005,JAKARTA UTARA,CILINCING,SEMPER TIMUR,36267,8075,28192,22375,50567,2021-10-31
3174071006,JAKARTA SELATAN,KEBAYORAN BARU,SENAYAN,2771,671,2100,1777,3877,2021-10-31
3171041001,JAKARTA PUSAT,SENEN,SENEN,6804,1520,5284,4346,9630,2021-10-31
3171031004,JAKARTA PUSAT,KEMAYORAN,SERDANG,29668,6125,23543,19285,42828,2021-10-31
3174021001,JAKARTA SELATAN,SETIA BUDI,SETIA BUDI,3023,632,2391,1974,4365,2021-10-31
3175101005,JAKARTA TIMUR,CIPAYUNG,SETU,20572,4243,16329,12895,29224,2021-10-31
3173071002,JAKARTA BARAT,PALMERAH,SLIPI,16591,3106,13485,11085,24570,2021-10-31
3173081004,JAKARTA BARAT,KEMBANGAN,SRENGSENG,45523,10575,34948,29091,64039,2021-10-31
3174091002,JAKARTA SELATAN,JAGAKARSA,SRENGSENG SAWAH,58196,9356,48840,40488,89328,2021-10-31
3173051003,JAKARTA BARAT,KEBON JERUK,SUKABUMI SELATAN,37033,8658,28375,21496,49871,2021-10-31
3173051002,JAKARTA BARAT,KEBON JERUK,SUKABUMI UTARA,38290,9284,29006,22219,51225,2021-10-31
3172041002,JAKARTA UTARA,CILINCING,SUKAPURA,53949,12611,41338,33343,74681,2021-10-31
3171031007,JAKARTA PUSAT,KEMAYORAN,SUMUR BATU,22717,4767,17950,15031,32981,2021-10-31
3172021004,JAKARTA UTARA,TANJUNG PRIOK,SUNGAI BAMBU,29876,6240,23636,19159,42795,2021-10-31
3172021006,JAKARTA UTARA,TANJUNG PRIOK,SUNTER AGUNG,71805,12884,58921,50490,109411,2021-10-31
3172021002,JAKARTA UTARA,TANJUNG PRIOK,SUNTER JAYA,63031,11520,51511,43694,95205,2021-10-31
3175091004,JAKARTA TIMUR,CIRACAS,SUSUKAN,38257,7486,30771,25060,55831,2021-10-31
3173031001,JAKARTA BARAT,TAMAN SARI,TAMAN SARI,14348,2722,11626,9847,21473,2021-10-31
3173041001,JAKARTA BARAT,TAMBORA,TAMBORA,10204,2340,7864,6224,14088,2021-10-31
3173041004,JAKARTA BARAT,TAMBORA,TANAH SEREAL,26387,4633,21754,17990,39744,2021-10-31
3171081004,JAKARTA PUSAT,JOHAR BARU,TANAH TINGGI,37693,7374,30319,24227,54546,2021-10-31
3173031004,JAKARTA BARAT,TAMAN SARI,TANGKI,13324,2287,11037,9132,20169,2021-10-31
3174091005,JAKARTA SELATAN,JAGAKARSA,TANJUNG BARAT,39770,7015,32755,26187,58942,2021-10-31
3173021005,JAKARTA BARAT,GROGOL PETAMBURAN,TANJUNG DUREN SELATAN,25337,4990,20347,17534,37881,2021-10-31
3173021002,JAKARTA BARAT,GROGOL PETAMBURAN,TANJUNG DUREN UTARA,17010,2966,14044,12316,26360,2021-10-31
3172021001,JAKARTA UTARA,TANJUNG PRIOK,TANJUNG PRIOK,34588,7359,27229,21789,49018,2021-10-31
3174011002,JAKARTA SELATAN,TEBET,TEBET BARAT,21194,3611,17583,15220,32803,2021-10-31
3174011001,JAKARTA SELATAN,TEBET,TEBET TIMUR,18199,3029,15170,13422,28592,2021-10-31
3173061003,JAKARTA BARAT,KALI DERES,TEGAL ALUR,83647,18359,65288,53097,118385,2021-10-31
3174031004,JAKARTA SELATAN,MAMPANG PRAPATAN,TEGAL PARANG,32401,7478,24923,18869,43792,2021-10-31
3173021003,JAKARTA BARAT,GROGOL PETAMBURAN,TOMANG,29605,5659,23946,20120,44066,2021-10-31
3172031005,JAKARTA UTARA,KOJA,TUGU SELATAN,39122,9035,30087,23874,53961,2021-10-31
3172031002,JAKARTA UTARA,KOJA,TUGU UTARA,67670,16560,51110,39619,90729,2021-10-31
3175061006,JAKARTA TIMUR,CAKUNG,UJUNG MENTENG,29934,5398,24536,20459,44995,2021-10-31
3174101005,JAKARTA SELATAN,PESANGGRAHAN,ULUJAMI,40544,9539,31005,24966,55971,2021-10-31
3175011006,JAKARTA TIMUR,MATRAMAN,UTAN KAYU SELATAN,33511,6294,27217,22059,49276,2021-10-31
3175011002,JAKARTA TIMUR,MATRAMAN,UTAN KAYU UTARA,28169,6107,22062,17720,39782,2021-10-31
3171031008,JAKARTA PUSAT,KEMAYORAN,UTAN PANJANG,29208,6151,23057,18288,41345,2021-10-31
3172021007,JAKARTA UTARA,TANJUNG PRIOK,WARAKAS,44401,8425,35976,28389,64365,2021-10-31
3173021007,JAKARTA BARAT,GROGOL PETAMBURAN,WIJAYA KUSUMA,38934,8427,30507,25096,55603,2021-10-31
3172051003,JAKARTA UTARA,PADEMANGAN,ANCOL,23947,5965,17982,14518,32500,2021-11-01
3173041007,JAKARTA BARAT,TAMBORA,ANGKE,29381,6538,22843,18195,41038,2021-11-01
3175041005,JAKARTA TIMUR,KRAMAT JATI,BALE KAMBANG,29074,7561,21513,16465,37978,2021-11-01
3175031003,JAKARTA TIMUR,JATINEGARA,BALI MESTER,9752,2118,7634,6290,13924,2021-11-01
3175101006,JAKARTA TIMUR,CIPAYUNG,BAMBU APUS,26285,5002,21283,17298,38581,2021-11-01
3174031002,JAKARTA SELATAN,MAMPANG PRAPATAN,BANGKA,21566,4732,16834,13587,30421,2021-11-01
3175051002,JAKARTA TIMUR,PASAR REBO,BARU,23886,4080,19806,16707,36513,2021-11-01
3175041004,JAKARTA TIMUR,KRAMAT JATI,BATU AMPAR,47898,12177,35721,27978,63699,2021-11-01
3171071002,JAKARTA PUSAT,TANAH ABANG,BENDUNGAN HILIR,21494,4486,17008,14194,31202,2021-11-01
3175031002,JAKARTA TIMUR,JATINEGARA,BIDARA CINA,36689,9080,27609,21466,49075,2021-11-01
3174101002,JAKARTA SELATAN,PESANGGRAHAN,BINTARO,53098,11022,42076,35397,77473,2021-11-01
3174011005,JAKARTA SELATAN,TEBET,BUKIT DURI,34183,7256,26927,22010,48937,2021-11-01
3171041006,JAKARTA PUSAT,SENEN,BUNGUR,18144,3953,14191,11608,25799,2021-11-01
3175061007,JAKARTA TIMUR,CAKUNG,CAKUNG BARAT,57724,12297,45427,36898,82325,2021-11-01
3175061004,JAKARTA TIMUR,CAKUNG,CAKUNG TIMUR,58287,11918,46369,37717,84086,2021-11-01
3175041007,JAKARTA TIMUR,KRAMAT JATI,CAWANG,32762,7392,25370,19789,45159,2021-11-01
3175101008,JAKARTA TIMUR,CIPAYUNG,CEGER,18932,3821,15111,12336,27447,2021-11-01
3171031006,JAKARTA PUSAT,KEMAYORAN,CEMPAKA BARU,32581,6672,25909,19984,45893,2021-11-01
3171051002,JAKARTA PUSAT,CEMPAKA PUTIH,CEMPAKA PUTIH BARAT,35885,7876,28009,23295,51304,2021-11-01
3171051001,JAKARTA PUSAT,CEMPAKA PUTIH,CEMPAKA PUTIH TIMUR,24292,5145,19147,16273,35420,2021-11-01
3173011001,JAKARTA BARAT,CENGKARENG,CENGKARENG BARAT,66284,13778,52506,43315,95821,2021-11-01
3173011006,JAKARTA BARAT,CENGKARENG,CENGKARENG TIMUR,81027,16642,64385,51911,116296,2021-11-01
3175091002,JAKARTA TIMUR,CIRACAS,CIBUBUR,66364,11770,54594,44659,99253,2021-11-01
3171011002,JAKARTA PUSAT,GAMBIR,CIDENG,15390,3073,12317,10553,22870,2021-11-01
3174091003,JAKARTA SELATAN,JAGAKARSA,CIGANJUR,38497,6867,31630,25305,56935,2021-11-01
3175051003,JAKARTA TIMUR,PASAR REBO,CIJANTUNG,41419,7966,33453,27322,60775,2021-11-01
3171061003,JAKARTA PUSAT,MENTENG,CIKINI,8274,1532,6742,5216,11958,2021-11-01
3174081006,JAKARTA SELATAN,PANCORAN,CIKOKO,10547,1883,8664,7354,16018,2021-11-01
3174061001,JAKARTA SELATAN,CILANDAK,CILANDAK BARAT,51752,9520,42232,35843,78075,2021-11-01
3174041003,JAKARTA SELATAN,PASAR MINGGU,CILANDAK TIMUR,25145,4780,20365,16934,37299,2021-11-01
3175101002,JAKARTA TIMUR,CIPAYUNG,CILANGKAP,27635,5046,22589,18588,41177,2021-11-01
3175041006,JAKARTA TIMUR,KRAMAT JATI,CILILITAN,40181,9321,30860,24504,55364,2021-11-01
3172041001,JAKARTA UTARA,CILINCING,CILINCING,43609,10787,32822,24897,57719,2021-11-01
3175101001,JAKARTA TIMUR,CIPAYUNG,CIPAYUNG,26104,4700,21404,18042,39446,2021-11-01
3174091006,JAKARTA SELATAN,JAGAKARSA,CIPEDAK,38303,6591,31712,25887,57599,2021-11-01
3174061005,JAKARTA SELATAN,CILANDAK,CIPETE SELATAN,26704,5316,21388,18306,39694,2021-11-01
3174071010,JAKARTA SELATAN,KEBAYORAN BARU,CIPETE UTARA,34102,6683,27419,22037,49456,2021-11-01
3175021003,JAKARTA TIMUR,PULO GADUNG,CIPINANG,39306,7620,31686,25724,57410,2021-11-01
3175031007,JAKARTA TIMUR,JATINEGARA,CIPINANG BESAR SELATAN,35212,8621,26591,20257,46848,2021-11-01
3175031008,JAKARTA TIMUR,JATINEGARA,CIPINANG BESAR UTARA,45319,11111,34208,25888,60096,2021-11-01
3175031005,JAKARTA TIMUR,JATINEGARA,CIPINANG CEMPEDAK,32824,7340,25484,20874,46358,2021-11-01
3175081005,JAKARTA TIMUR,MAKASAR,CIPINANG MELAYU,42308,8420,33888,28213,62101,2021-11-01
3175031006,JAKARTA TIMUR,JATINEGARA,CIPINANG MUARA,55243,12268,42975,34073,77048,2021-11-01
3174051003,JAKARTA SELATAN,KEBAYORAN LAMA,CIPULIR,39937,8670,31267,24773,56040,2021-11-01
3175091001,JAKARTA TIMUR,CIRACAS,CIRACAS,64594,12247,52347,41963,94310,2021-11-01
3175041003,JAKARTA TIMUR,KRAMAT JATI,DUKUH,24609,4810,19799,15923,35722,2021-11-01
3175071001,JAKARTA TIMUR,DUREN SAWIT,DUREN SAWIT,61160,13365,47795,38260,86055,2021-11-01
3174081004,JAKARTA SELATAN,PANCORAN,DUREN TIGA,28319,5865,22454,18342,40796,2021-11-01
3173051005,JAKARTA BARAT,KEBON JERUK,DURI KEPA,60138,12102,48036,40825,88861,2021-11-01
3173011002,JAKARTA BARAT,CENGKARENG,DURI KOSAMBI,77923,17291,60632,47545,108177,2021-11-01
3171011006,JAKARTA PUSAT,GAMBIR,DURI PULO,19610,4304,15306,12086,27392,2021-11-01
3173041011,JAKARTA BARAT,TAMBORA,DURI SELATAN,14259,2621,11638,9674,21312,2021-11-01
3173041003,JAKARTA BARAT,TAMBORA,DURI UTARA,19844,3727,16117,13033,29150,2021-11-01
3171081003,JAKARTA PUSAT,JOHAR BARU,GALUR,18243,3703,14540,11578,26118,2021-11-01
3171011001,JAKARTA PUSAT,GAMBIR,GAMBIR,2191,462,1729,1473,3202,2021-11-01
3174061004,JAKARTA SELATAN,CILANDAK,GANDARIA SELATAN,22119,4392,17727,14639,32366,2021-11-01
3174071009,JAKARTA SELATAN,KEBAYORAN BARU,GANDARIA UTARA,39922,8239,31683,25895,57578,2021-11-01
3175051001,JAKARTA TIMUR,PASAR REBO,GEDONG,35755,7418,28337,23361,51698,2021-11-01
3171071001,JAKARTA PUSAT,TANAH ABANG,GELORA,3127,629,2498,2117,4615,2021-11-01
3173031007,JAKARTA BARAT,TAMAN SARI,GLODOK,7837,1229,6608,5815,12423,2021-11-01
3171061004,JAKARTA PUSAT,MENTENG,GONDANGDIA,4100,943,3157,2854,6011,2021-11-01
3173021001,JAKARTA BARAT,GROGOL PETAMBURAN,GROGOL,16876,3491,13385,11058,24443,2021-11-01
3174051005,JAKARTA SELATAN,KEBAYORAN LAMA,GROGOL SELATAN,44251,9196,35055,28065,63120,2021-11-01
3174051004,JAKARTA SELATAN,KEBAYORAN LAMA,GROGOL UTARA,42494,8934,33560,27234,60794,2021-11-01
3174021007,JAKARTA SELATAN,SETIA BUDI,GUNTUR,3985,768,3217,2777,5994,2021-11-01
3174071002,JAKARTA SELATAN,KEBAYORAN BARU,GUNUNG,9436,1805,7631,6559,14190,2021-11-01
3171031005,JAKARTA PUSAT,KEMAYORAN,GUNUNG SAHARI SELATAN,19199,4008,15191,12514,27705,2021-11-01
3171021004,JAKARTA PUSAT,SAWAH BESAR,GUNUNG SAHARI UTARA,16650,3032,13618,11918,25536,2021-11-01
3175081004,JAKARTA TIMUR,MAKASAR,HALIM PERDANA KUSUMAH,28363,3794,24569,22138,46707,2021-11-01
3171031003,JAKARTA PUSAT,KEMAYORAN,HARAPAN MULIA,22557,4735,17822,14152,31974,2021-11-01
3174091001,JAKARTA SELATAN,JAGAKARSA,JAGAKARSA,62389,10749,51640,41702,93342,2021-11-01
3175021007,JAKARTA TIMUR,PULO GADUNG,JATI,32757,6343,26414,22328,48742,2021-11-01
3174041002,JAKARTA SELATAN,PASAR MINGGU,JATI PADANG,37502,7768,29734,24498,54232,2021-11-01
3173071004,JAKARTA BARAT,PALMERAH,JATI PULO,28738,5961,22777,17887,40664,2021-11-01
3175061001,JAKARTA TIMUR,CAKUNG,JATINEGARA,84160,18673,65487,52833,118320,2021-11-01
3175021004,JAKARTA TIMUR,PULO GADUNG,JATINEGARA KAUM,24632,4584,20048,15841,35889,2021-11-01
3173021004,JAKARTA BARAT,GROGOL PETAMBURAN,JELAMBAR,30266,5710,24556,20875,45431,2021-11-01
3173021006,JAKARTA BARAT,GROGOL PETAMBURAN,JELAMBAR BARU,38246,7401,30845,26173,57018,2021-11-01
3173041006,JAKARTA BARAT,TAMBORA,JEMBATAN BESI,29314,7328,21986,16746,38732,2021-11-01
3173041008,JAKARTA BARAT,TAMBORA,JEMBATAN LIMA,21021,5129,15892,12327,28219,2021-11-01
3173081005,JAKARTA BARAT,KEMBANGAN,JOGLO,40839,8626,32213,26824,59037,2021-11-01
3171081001,JAKARTA PUSAT,JOHAR BARU,JOHAR BARU,37488,7144,30344,25195,55539,2021-11-01
3173041002,JAKARTA BARAT,TAMBORA,KALI ANYAR,23856,4898,18958,14807,33765,2021-11-01
3172041004,JAKARTA UTARA,CILINCING,KALIBARU,67684,19080,48604,34055,82659,2021-11-01
3174081002,JAKARTA SELATAN,PANCORAN,KALIBATA,41994,9906,32088,25299,57387,2021-11-01
3173061001,JAKARTA BARAT,KALI DERES,KALIDERES,72447,15524,56923,47298,104221,2021-11-01
3175051004,JAKARTA TIMUR,PASAR REBO,KALISARI,43212,8017,35195,28879,64074,2021-11-01
3173061004,JAKARTA BARAT,KALI DERES,KAMAL,53783,13038,40745,31731,72476,2021-11-01
3172011002,JAKARTA UTARA,PENJARINGAN,KAMAL MUARA,12930,2327,10603,8949,19552,2021-11-01
3171071007,JAKARTA PUSAT,TANAH ABANG,KAMPUNG BALI,11358,2532,8826,6611,15437,2021-11-01
3175031001,JAKARTA TIMUR,JATINEGARA,KAMPUNG MELAYU,25717,6015,19702,15049,34751,2021-11-01
3171081002,JAKARTA PUSAT,JOHAR BARU,KAMPUNG RAWA,21237,3612,17625,13893,31518,2021-11-01
3175041002,JAKARTA TIMUR,KRAMAT JATI,KAMPUNG TENGAH,43993,11416,32577,25336,57913,2021-11-01
3173011005,JAKARTA BARAT,CENGKARENG,KAPUK,134466,33688,100778,79655,180433,2021-11-01
3172011003,JAKARTA UTARA,PENJARINGAN,KAPUK MUARA,35781,7090,28691,24766,53457,2021-11-01
3171021002,JAKARTA PUSAT,SAWAH BESAR,KARANG ANYAR,25761,5139,20622,17082,37704,2021-11-01
3174021004,JAKARTA SELATAN,SETIA BUDI,KARET,9623,1897,7726,6287,14013,2021-11-01
3174021003,JAKARTA SELATAN,SETIA BUDI,KARET KUNINGAN,16055,3227,12828,10632,23460,2021-11-01
3174021002,JAKARTA SELATAN,SETIA BUDI,KARET SEMANGGI,2770,567,2203,1932,4135,2021-11-01
3171071003,JAKARTA PUSAT,TANAH ABANG,KARET TENGSIN,19271,3826,15445,12284,27729,2021-11-01
3171021003,JAKARTA PUSAT,SAWAH BESAR,KARTINI,22292,4427,17865,15042,32907,2021-11-01
3175011003,JAKARTA TIMUR,MATRAMAN,KAYU MANIS,25284,5541,19743,15272,35015,2021-11-01
3175021006,JAKARTA TIMUR,PULO GADUNG,KAYU PUTIH,40696,7912,32784,28142,60926,2021-11-01
3173031006,JAKARTA BARAT,TAMAN SARI,KEAGUNGAN,17387,3339,14048,11247,25295,2021-11-01
3174041007,JAKARTA SELATAN,PASAR MINGGU,KEBAGUSAN,44552,9103,35449,28548,63997,2021-11-01
3174051006,JAKARTA SELATAN,KEBAYORAN LAMA,KEBAYORAN LAMA SELATAN,41212,7946,33266,27341,60607,2021-11-01
3174051001,JAKARTA SELATAN,KEBAYORAN LAMA,KEBAYORAN LAMA UTARA,42422,9159,33263,26682,59945,2021-11-01
3174011004,JAKARTA SELATAN,TEBET,KEBON BARU,35165,6885,28280,23120,51400,2021-11-01
3172021005,JAKARTA UTARA,TANJUNG PRIOK,KEBON BAWANG,50952,10661,40291,32810,73101,2021-11-01
3173051001,JAKARTA BARAT,KEBON JERUK,KEBON JERUK,53887,12016,41871,33633,75504,2021-11-01
3171071006,JAKARTA PUSAT,TANAH ABANG,KEBON KACANG,21531,5298,16233,12545,28778,2021-11-01
3171011005,JAKARTA PUSAT,GAMBIR,KEBON KELAPA,10163,2092,8071,6658,14729,2021-11-01
3171031002,JAKARTA PUSAT,KEMAYORAN,KEBON KOSONG,30019,6216,23803,18860,42663,2021-11-01
3175011005,JAKARTA TIMUR,MATRAMAN,KEBON MANGGIS,16490,3346,13144,10667,23811,2021-11-01
3171071005,JAKARTA PUSAT,TANAH ABANG,KEBON MELATI,32206,8833,23373,16933,40306,2021-11-01
3175081003,JAKARTA TIMUR,MAKASAR,KEBON PALA,46614,9632,36982,30098,67080,2021-11-01
3171061005,JAKARTA PUSAT,MENTENG,KEBON SIRIH,12299,2734,9565,7550,17115,2021-11-01
3173011004,JAKARTA BARAT,CENGKARENG,KEDAUNG KALI ANGKE,32612,6552,26060,21431,47491,2021-11-01
3173051007,JAKARTA BARAT,KEBON JERUK,KEDOYA SELATAN,32165,6026,26139,21287,47426,2021-11-01
3173051006,JAKARTA BARAT,KEBON JERUK,KEDOYA UTARA,45740,8898,36842,30724,67566,2021-11-01
3173051004,JAKARTA BARAT,KEBON JERUK,KELAPA DUA,23565,4951,18614,15232,33846,2021-11-01
3175091003,JAKARTA TIMUR,CIRACAS,KELAPA DUA WETAN,46875,8311,38564,31690,70254,2021-11-01
3172061003,JAKARTA UTARA,KELAPA GADING,KELAPA GADING BARAT,35717,6372,29345,26106,55451,2021-11-01
3172061001,JAKARTA UTARA,KELAPA GADING,KELAPA GADING TIMUR,33592,5266,28326,25857,54183,2021-11-01
3173071005,JAKARTA BARAT,PALMERAH,KEMANGGISAN,32139,6302,25837,21081,46918,2021-11-01
3171031001,JAKARTA PUSAT,KEMAYORAN,KEMAYORAN,20708,4448,16260,13224,29484,2021-11-01
3173081006,JAKARTA BARAT,KEMBANGAN,KEMBANGAN SELATAN,27130,5852,21278,18081,39359,2021-11-01
3173081001,JAKARTA BARAT,KEMBANGAN,KEMBANGAN UTARA,54451,12346,42105,34514,76619,2021-11-01
3171041002,JAKARTA PUSAT,SENEN,KENARI,9579,1934,7645,6408,14053,2021-11-01
3173041005,JAKARTA BARAT,TAMBORA,KERENDANG,19973,4249,15724,12537,28261,2021-11-01
3175071003,JAKARTA TIMUR,DUREN SAWIT,KLENDER,69978,16896,53082,41242,94324,2021-11-01
3172031001,JAKARTA UTARA,KOJA,KOJA,28175,6615,21560,17103,38663,2021-11-01
3173071006,JAKARTA BARAT,PALMERAH,KOTA BAMBU SELATAN,21158,4454,16704,12865,29569,2021-11-01
3173071003,JAKARTA BARAT,PALMERAH,KOTA BAMBU UTARA,24995,5365,19630,14984,34614,2021-11-01
3171041004,JAKARTA PUSAT,SENEN,KRAMAT,28835,7148,21687,16236,37923,2021-11-01
3175041001,JAKARTA TIMUR,KRAMAT JATI,KRAMAT JATI,34144,7747,26397,21001,47398,2021-11-01
3174071003,JAKARTA SELATAN,KEBAYORAN BARU,KRAMAT PELA,14413,2874,11539,9576,21115,2021-11-01
3173031002,JAKARTA BARAT,TAMAN SARI,KRUKUT,19244,3736,15508,12254,27762,2021-11-01
3174031005,JAKARTA SELATAN,MAMPANG PRAPATAN,KUNINGAN BARAT,12785,2452,10333,8466,18799,2021-11-01
3174021008,JAKARTA SELATAN,SETIA BUDI,KUNINGAN TIMUR,6008,1237,4771,3944,8715,2021-11-01
3171041005,JAKARTA PUSAT,SENEN,KWITANG,15486,3610,11876,9443,21319,2021-11-01
3172031003,JAKARTA UTARA,KOJA,LAGOA,59065,14420,44645,34647,79292,2021-11-01
3174061002,JAKARTA SELATAN,CILANDAK,LEBAK BULUS,37626,7409,30217,25541,55758,2021-11-01
3174091004,JAKARTA SELATAN,JAGAKARSA,LENTENG AGUNG,53946,10093,43853,34496,78349,2021-11-01
3175101007,JAKARTA TIMUR,CIPAYUNG,LUBANG BUAYA,63547,12320,51227,41538,92765,2021-11-01
3175081001,JAKARTA TIMUR,MAKASAR,MAKASAR,34390,6554,27836,23020,50856,2021-11-01
3175071006,JAKARTA TIMUR,DUREN SAWIT,MALAKA JAYA,30927,5570,25357,21205,46562,2021-11-01
3175071005,JAKARTA TIMUR,DUREN SAWIT,MALAKA SARI,27530,4774,22756,19194,41950,2021-11-01
3174031001,JAKARTA SELATAN,MAMPANG PRAPATAN,MAMPANG PRAPATAN,18159,3836,14323,11520,25843,2021-11-01
3173031005,JAKARTA BARAT,TAMAN SARI,MANGGA BESAR,7707,1341,6366,5469,11835,2021-11-01
3171021005,JAKARTA PUSAT,SAWAH BESAR,MANGGA DUA SELATAN,27442,5875,21567,17918,39485,2021-11-01
3174011007,JAKARTA SELATAN,TEBET,MANGGARAI,28373,5231,23142,18342,41484,2021-11-01
3174011006,JAKARTA SELATAN,TEBET,MANGGARAI SELATAN,23075,4241,18834,15559,34393,2021-11-01
3173031003,JAKARTA BARAT,TAMAN SARI,MAPHAR,16461,3162,13299,10858,24157,2021-11-01
3172041003,JAKARTA UTARA,CILINCING,MARUNDA,28943,6770,22173,16329,38502,2021-11-01
3174071001,JAKARTA SELATAN,KEBAYORAN BARU,MELAWAI,2627,525,2102,1924,4026,2021-11-01
3171061001,JAKARTA PUSAT,MENTENG,MENTENG,25624,5892,19732,15204,34936,2021-11-01
3174021005,JAKARTA SELATAN,SETIA BUDI,MENTENG ATAS,27816,5248,22568,18294,40862,2021-11-01
3174011003,JAKARTA SELATAN,TEBET,MENTENG DALAM,36028,7237,28791,23637,52428,2021-11-01
3173081003,JAKARTA BARAT,KEMBANGAN,MERUYA SELATAN,32130,6845,25285,20757,46042,2021-11-01
3173081002,JAKARTA BARAT,KEMBANGAN,MERUYA UTARA,43752,9261,34491,29404,63895,2021-11-01
3175101004,JAKARTA TIMUR,CIPAYUNG,MUNJUL,23871,4466,19405,16039,35444,2021-11-01
3172051002,JAKARTA UTARA,PADEMANGAN,PADEMANGAN BARAT,74240,18186,56054,44397,100451,2021-11-01
3172051001,JAKARTA UTARA,PADEMANGAN,PADEMANGAN TIMUR,37736,6872,30864,26434,57298,2021-11-01
3175011004,JAKARTA TIMUR,MATRAMAN,PAL MERIAM,19769,4281,15488,12196,27684,2021-11-01
3173071001,JAKARTA BARAT,PALMERAH,PALMERAH,63011,13803,49208,39101,88309,2021-11-01
3174081001,JAKARTA SELATAN,PANCORAN,PANCORAN,19421,4147,15274,12409,27683,2021-11-01
3172021003,JAKARTA UTARA,TANJUNG PRIOK,PAPANGGO,39097,7918,31179,25066,56245,2021-11-01
3171021001,JAKARTA PUSAT,SAWAH BESAR,PASAR BARU,12035,2360,9675,8509,18184,2021-11-01
3174021006,JAKARTA SELATAN,SETIA BUDI,PASAR MANGGIS,26752,5507,21245,17171,38416,2021-11-01
3174041001,JAKARTA SELATAN,PASAR MINGGU,PASAR MINGGU,24821,4826,19995,16674,36669,2021-11-01
3171041003,JAKARTA PUSAT,SENEN,PASEBAN,23533,5120,18413,14885,33298,2021-11-01
3173061005,JAKARTA BARAT,KALI DERES,PEGADUNGAN,75587,15979,59608,50611,110219,2021-11-01
3171061002,JAKARTA PUSAT,MENTENG,PEGANGSAAN,23455,5177,18278,13669,31947,2021-11-01
3172061002,JAKARTA UTARA,KELAPA GADING,PEGANGSAAN DUA,49976,8462,41514,37139,78653,2021-11-01
3172011004,JAKARTA UTARA,PENJARINGAN,PEJAGALAN,74578,16006,58572,49348,107920,2021-11-01
3174041006,JAKARTA SELATAN,PASAR MINGGU,PEJATEN BARAT,37346,7717,29629,24311,53940,2021-11-01
3174041005,JAKARTA SELATAN,PASAR MINGGU,PEJATEN TIMUR,57656,13508,44148,35767,79915,2021-11-01
3175051005,JAKARTA TIMUR,PASAR REBO,PEKAYON,43250,8108,35142,28552,63694,2021-11-01
3173041009,JAKARTA BARAT,TAMBORA,PEKOJAN,23587,4637,18950,15572,34522,2021-11-01
3174031003,JAKARTA SELATAN,MAMPANG PRAPATAN,PELA MAMPANG,43522,8956,34566,28243,62809,2021-11-01
3174081005,JAKARTA SELATAN,PANCORAN,PENGADEGAN,21478,4081,17397,14495,31892,2021-11-01
3175061003,JAKARTA TIMUR,CAKUNG,PENGGILINGAN,99255,23988,75267,59168,134435,2021-11-01
3172011001,JAKARTA UTARA,PENJARINGAN,PENJARINGAN,88308,23243,65065,49168,114233,2021-11-01
3174101001,JAKARTA SELATAN,PESANGGRAHAN,PESANGGRAHAN,27545,4904,22641,19079,41720,2021-11-01
3171071004,JAKARTA PUSAT,TANAH ABANG,PETAMBURAN,33271,9029,24242,18010,42252,2021-11-01
3174071008,JAKARTA SELATAN,KEBAYORAN BARU,PETOGOGAN,11499,2341,9158,7611,16769,2021-11-01
3171011004,JAKARTA PUSAT,GAMBIR,PETOJO SELATAN,14692,3398,11294,9423,20717,2021-11-01
3171011003,JAKARTA PUSAT,GAMBIR,PETOJO UTARA,17458,3871,13587,10966,24553,2021-11-01
3174101004,JAKARTA SELATAN,PESANGGRAHAN,PETUKANGAN SELATAN,37187,7903,29284,24090,53374,2021-11-01
3174101003,JAKARTA SELATAN,PESANGGRAHAN,PETUKANGAN UTARA,53716,12027,41689,33914,75603,2021-11-01
3175081002,JAKARTA TIMUR,MAKASAR,PINANG RANTI,27198,6099,21099,17140,38239,2021-11-01
3173031008,JAKARTA BARAT,TAMAN SARI,PINANGSIA,10729,1936,8793,7153,15946,2021-11-01
3175011001,JAKARTA TIMUR,MATRAMAN,PISANGAN BARU,31776,6787,24989,19410,44399,2021-11-01
3175021002,JAKARTA TIMUR,PULO GADUNG,PISANGAN TIMUR,41011,8002,33009,27392,60401,2021-11-01
3172011005,JAKARTA UTARA,PENJARINGAN,PLUIT,47783,9368,38415,33036,71451,2021-11-01
3175071002,JAKARTA TIMUR,DUREN SAWIT,PONDOK BAMBU,61550,13447,48103,38456,86559,2021-11-01
3175071004,JAKARTA TIMUR,DUREN SAWIT,PONDOK KELAPA,72015,14667,57348,48249,105597,2021-11-01
3175071007,JAKARTA TIMUR,DUREN SAWIT,PONDOK KOPI,35367,6820,28547,21942,50489,2021-11-01
3174061003,JAKARTA SELATAN,CILANDAK,PONDOK LABU,46464,8254,38210,32648,70858,2021-11-01
3174051002,JAKARTA SELATAN,KEBAYORAN LAMA,PONDOK PINANG,56169,11114,45055,37609,82664,2021-11-01
3175101003,JAKARTA TIMUR,CIPAYUNG,PONDOK RANGGON,25574,4937,20637,16948,37585,2021-11-01
3101011003,KAB.ADM.KEP.SERIBU,KEP. SERIBU UTARA,PULAU HARAPAN,2060,227,1833,1592,3425,2021-11-01
3101011002,KAB.ADM.KEP.SERIBU,KEP. SERIBU UTARA,PULAU KELAPA,5528,621,4907,4016,8923,2021-11-01
3101011001,KAB.ADM.KEP.SERIBU,KEP. SERIBU UTARA,PULAU PANGGANG,5450,454,4996,4438,9434,2021-11-01
3101021003,KAB.ADM.KEP.SERIBU,KEP. SERIBU SELATAN,PULAU PARI,2765,200,2565,2388,4953,2021-11-01
3101021002,KAB.ADM.KEP.SERIBU,KEP. SERIBU SELATAN,PULAU TIDUNG,4553,374,4179,3806,7985,2021-11-01
3101021001,KAB.ADM.KEP.SERIBU,KEP. SERIBU SELATAN,PULAU UNTUNG JAWA,1941,163,1778,1631,3409,2021-11-01
3174071007,JAKARTA SELATAN,KEBAYORAN BARU,PULO,5835,1040,4795,4301,9096,2021-11-01
3175021001,JAKARTA TIMUR,PULO GADUNG,PULO GADUNG,34422,7761,26661,21825,48486,2021-11-01
3175061005,JAKARTA TIMUR,CAKUNG,PULO GEBANG,97301,19352,77949,62297,140246,2021-11-01
3174041004,JAKARTA SELATAN,PASAR MINGGU,RAGUNAN,39616,7639,31977,26743,58720,2021-11-01
3175091005,JAKARTA TIMUR,CIRACAS,RAMBUTAN,36771,8894,27877,21689,49566,2021-11-01
3172031006,JAKARTA UTARA,KOJA,RAWA BADAK SELATAN,42179,10320,31859,24677,56536,2021-11-01
3172031004,JAKARTA UTARA,KOJA,RAWA BADAK UTARA,34408,7951,26457,20797,47254,2021-11-01
3174071005,JAKARTA SELATAN,KEBAYORAN BARU,RAWA BARAT,5625,1025,4600,4018,8618,2021-11-01
3173011003,JAKARTA BARAT,CENGKARENG,RAWA BUAYA,63799,13313,50486,39895,90381,2021-11-01
3175031004,JAKARTA TIMUR,JATINEGARA,RAWA BUNGA,21434,5344,16090,12717,28807,2021-11-01
3174081003,JAKARTA SELATAN,PANCORAN,RAWA JATI,20509,4011,16498,13775,30273,2021-11-01
3175061002,JAKARTA TIMUR,CAKUNG,RAWA TERATE,24637,4625,20012,16024,36036,2021-11-01
3175021005,JAKARTA TIMUR,PULO GADUNG,RAWAMANGUN,37612,7689,29923,24838,54761,2021-11-01
3171051003,JAKARTA PUSAT,CEMPAKA PUTIH,RAWASARI,21967,4626,17341,14437,31778,2021-11-01
3173041010,JAKARTA BARAT,TAMBORA,ROA MALAKA,3484,627,2857,2496,5353,2021-11-01
3172041006,JAKARTA UTARA,CILINCING,ROROTAN,41668,8621,33047,25935,58982,2021-11-01
3174071004,JAKARTA SELATAN,KEBAYORAN BARU,SELONG,2842,551,2291,2085,4376,2021-11-01
3173061002,JAKARTA BARAT,KALI DERES,SEMANAN,71354,16219,55135,43893,99028,2021-11-01
3172041007,JAKARTA UTARA,CILINCING,SEMPER BARAT,68587,13887,54700,44436,99136,2021-11-01
3172041005,JAKARTA UTARA,CILINCING,SEMPER TIMUR,36267,8060,28207,22401,50608,2021-11-01
3174071006,JAKARTA SELATAN,KEBAYORAN BARU,SENAYAN,2771,667,2104,1778,3882,2021-11-01
3171041001,JAKARTA PUSAT,SENEN,SENEN,6804,1516,5288,4349,9637,2021-11-01
3171031004,JAKARTA PUSAT,KEMAYORAN,SERDANG,29668,6107,23561,19301,42862,2021-11-01
3174021001,JAKARTA SELATAN,SETIA BUDI,SETIA BUDI,3023,632,2391,1977,4368,2021-11-01
3175101005,JAKARTA TIMUR,CIPAYUNG,SETU,20572,4229,16343,12898,29241,2021-11-01
3173071002,JAKARTA BARAT,PALMERAH,SLIPI,16591,3100,13491,11093,24584,2021-11-01
3173081004,JAKARTA BARAT,KEMBANGAN,SRENGSENG,45523,10557,34966,29117,64083,2021-11-01
3174091002,JAKARTA SELATAN,JAGAKARSA,SRENGSENG SAWAH,58196,9340,48856,40524,89380,2021-11-01
3173051003,JAKARTA BARAT,KEBON JERUK,SUKABUMI SELATAN,37033,8631,28402,21510,49912,2021-11-01
3173051002,JAKARTA BARAT,KEBON JERUK,SUKABUMI UTARA,38290,9259,29031,22264,51295,2021-11-01
3172041002,JAKARTA UTARA,CILINCING,SUKAPURA,53949,12569,41380,33385,74765,2021-11-01
3171031007,JAKARTA PUSAT,KEMAYORAN,SUMUR BATU,22717,4758,17959,15048,33007,2021-11-01
3172021004,JAKARTA UTARA,TANJUNG PRIOK,SUNGAI BAMBU,29876,6218,23658,19176,42834,2021-11-01
3172021006,JAKARTA UTARA,TANJUNG PRIOK,SUNTER AGUNG,71805,12849,58956,50547,109503,2021-11-01
3172021002,JAKARTA UTARA,TANJUNG PRIOK,SUNTER JAYA,63031,11493,51538,43730,95268,2021-11-01
3175091004,JAKARTA TIMUR,CIRACAS,SUSUKAN,38257,7453,30804,25106,55910,2021-11-01
3173031001,JAKARTA BARAT,TAMAN SARI,TAMAN SARI,14348,2712,11636,9850,21486,2021-11-01
3173041001,JAKARTA BARAT,TAMBORA,TAMBORA,10204,2335,7869,6231,14100,2021-11-01
3173041004,JAKARTA BARAT,TAMBORA,TANAH SEREAL,26387,4625,21762,18003,39765,2021-11-01
3171081004,JAKARTA PUSAT,JOHAR BARU,TANAH TINGGI,37693,7352,30341,24247,54588,2021-11-01
3173031004,JAKARTA BARAT,TAMAN SARI,TANGKI,13324,2282,11042,9143,20185,2021-11-01
3174091005,JAKARTA SELATAN,JAGAKARSA,TANJUNG BARAT,39770,6998,32772,26211,58983,2021-11-01
3173021005,JAKARTA BARAT,GROGOL PETAMBURAN,TANJUNG DUREN SELATAN,25337,4980,20357,17549,37906,2021-11-01
3173021002,JAKARTA BARAT,GROGOL PETAMBURAN,TANJUNG DUREN UTARA,17010,2963,14047,12323,26370,2021-11-01
3172021001,JAKARTA UTARA,TANJUNG PRIOK,TANJUNG PRIOK,34588,7337,27251,21834,49085,2021-11-01
3174011002,JAKARTA SELATAN,TEBET,TEBET BARAT,21194,3602,17592,15232,32824,2021-11-01
3174011001,JAKARTA SELATAN,TEBET,TEBET TIMUR,18199,3018,15181,13433,28614,2021-11-01
3173061003,JAKARTA BARAT,KALI DERES,TEGAL ALUR,83647,18313,65334,53164,118498,2021-11-01
3174031004,JAKARTA SELATAN,MAMPANG PRAPATAN,TEGAL PARANG,32401,7456,24945,18886,43831,2021-11-01
3173021003,JAKARTA BARAT,GROGOL PETAMBURAN,TOMANG,29605,5639,23966,20138,44104,2021-11-01
3172031005,JAKARTA UTARA,KOJA,TUGU SELATAN,39122,9013,30109,23892,54001,2021-11-01
3172031002,JAKARTA UTARA,KOJA,TUGU UTARA,67670,16507,51163,39669,90832,2021-11-01
3175061006,JAKARTA TIMUR,CAKUNG,UJUNG MENTENG,29934,5385,24549,20481,45030,2021-11-01
3174101005,JAKARTA SELATAN,PESANGGRAHAN,ULUJAMI,40544,9515,31029,24989,56018,2021-11-01
3175011006,JAKARTA TIMUR,MATRAMAN,UTAN KAYU SELATAN,33511,6271,27240,22086,49326,2021-11-01
3175011002,JAKARTA TIMUR,MATRAMAN,UTAN KAYU UTARA,28169,6089,22080,17739,39819,2021-11-01
3171031008,JAKARTA PUSAT,KEMAYORAN,UTAN PANJANG,29208,6139,23069,18312,41381,2021-11-01
3172021007,JAKARTA UTARA,TANJUNG PRIOK,WARAKAS,44401,8388,36013,28434,64447,2021-11-01
3173021007,JAKARTA BARAT,GROGOL PETAMBURAN,WIJAYA KUSUMA,38934,8406,30528,25122,55650,2021-11-01
3172051003,JAKARTA UTARA,PADEMANGAN,ANCOL,23947,5953,17994,14587,32581,2021-11-02
3173041007,JAKARTA BARAT,TAMBORA,ANGKE,29381,6521,22860,18263,41123,2021-11-02
3175041005,JAKARTA TIMUR,KRAMAT JATI,BALE KAMBANG,29074,7538,21536,16524,38060,2021-11-02
3175031003,JAKARTA TIMUR,JATINEGARA,BALI MESTER,9752,2111,7641,6318,13959,2021-11-02
3175101006,JAKARTA TIMUR,CIPAYUNG,BAMBU APUS,26285,4981,21304,17376,38680,2021-11-02
3174031002,JAKARTA SELATAN,MAMPANG PRAPATAN,BANGKA,21566,4723,16843,13663,30506,2021-11-02
3175051002,JAKARTA TIMUR,PASAR REBO,BARU,23886,4057,19829,16758,36587,2021-11-02
3175041004,JAKARTA TIMUR,KRAMAT JATI,BATU AMPAR,47898,12126,35772,28077,63849,2021-11-02
3171071002,JAKARTA PUSAT,TANAH ABANG,BENDUNGAN HILIR,21494,4474,17020,14238,31258,2021-11-02
3175031002,JAKARTA TIMUR,JATINEGARA,BIDARA CINA,36689,9054,27635,21563,49198,2021-11-02
3174101002,JAKARTA SELATAN,PESANGGRAHAN,BINTARO,53098,11007,42091,35525,77616,2021-11-02
3174011005,JAKARTA SELATAN,TEBET,BUKIT DURI,34183,7185,26998,22062,49060,2021-11-02
3171041006,JAKARTA PUSAT,SENEN,BUNGUR,18144,3946,14198,11637,25835,2021-11-02
3175061007,JAKARTA TIMUR,CAKUNG,CAKUNG BARAT,57724,12271,45453,37000,82453,2021-11-02
3175061004,JAKARTA TIMUR,CAKUNG,CAKUNG TIMUR,58287,11857,46430,37904,84334,2021-11-02
3175041007,JAKARTA TIMUR,KRAMAT JATI,CAWANG,32762,7374,25388,19871,45259,2021-11-02
3175101008,JAKARTA TIMUR,CIPAYUNG,CEGER,18932,3817,15115,12396,27511,2021-11-02
3171031006,JAKARTA PUSAT,KEMAYORAN,CEMPAKA BARU,32581,6596,25985,20042,46027,2021-11-02
3171051002,JAKARTA PUSAT,CEMPAKA PUTIH,CEMPAKA PUTIH BARAT,35885,7848,28037,23395,51432,2021-11-02
3171051001,JAKARTA PUSAT,CEMPAKA PUTIH,CEMPAKA PUTIH TIMUR,24292,5129,19163,16350,35513,2021-11-02
3173011001,JAKARTA BARAT,CENGKARENG,CENGKARENG BARAT,66284,13730,52554,43564,96118,2021-11-02
3173011006,JAKARTA BARAT,CENGKARENG,CENGKARENG TIMUR,81027,16551,64476,52177,116653,2021-11-02
3175091002,JAKARTA TIMUR,CIRACAS,CIBUBUR,66364,11739,54625,44811,99436,2021-11-02
3171011002,JAKARTA PUSAT,GAMBIR,CIDENG,15390,3070,12320,10574,22894,2021-11-02
3174091003,JAKARTA SELATAN,JAGAKARSA,CIGANJUR,38497,6834,31663,25425,57088,2021-11-02
3175051003,JAKARTA TIMUR,PASAR REBO,CIJANTUNG,41419,7938,33481,27415,60896,2021-11-02
3171061003,JAKARTA PUSAT,MENTENG,CIKINI,8274,1527,6747,5225,11972,2021-11-02
3174081006,JAKARTA SELATAN,PANCORAN,CIKOKO,10547,1879,8668,7379,16047,2021-11-02
3174061001,JAKARTA SELATAN,CILANDAK,CILANDAK BARAT,51752,9483,42269,35957,78226,2021-11-02
3174041003,JAKARTA SELATAN,PASAR MINGGU,CILANDAK TIMUR,25145,4756,20389,16988,37377,2021-11-02
3175101002,JAKARTA TIMUR,CIPAYUNG,CILANGKAP,27635,5033,22602,18661,41263,2021-11-02
3175041006,JAKARTA TIMUR,KRAMAT JATI,CILILITAN,40181,9271,30910,24588,55498,2021-11-02
3172041001,JAKARTA UTARA,CILINCING,CILINCING,43609,10754,32855,25002,57857,2021-11-02
3175101001,JAKARTA TIMUR,CIPAYUNG,CIPAYUNG,26104,4689,21415,18088,39503,2021-11-02
3174091006,JAKARTA SELATAN,JAGAKARSA,CIPEDAK,38303,6559,31744,25996,57740,2021-11-02
3174061005,JAKARTA SELATAN,CILANDAK,CIPETE SELATAN,26704,5292,21412,18342,39754,2021-11-02
3174071010,JAKARTA SELATAN,KEBAYORAN BARU,CIPETE UTARA,34102,6670,27432,22108,49540,2021-11-02
3175021003,JAKARTA TIMUR,PULO GADUNG,CIPINANG,39306,7581,31725,25806,57531,2021-11-02
3175031007,JAKARTA TIMUR,JATINEGARA,CIPINANG BESAR SELATAN,35212,8594,26618,20352,46970,2021-11-02
3175031008,JAKARTA TIMUR,JATINEGARA,CIPINANG BESAR UTARA,45319,11016,34303,26049,60352,2021-11-02
3175031005,JAKARTA TIMUR,JATINEGARA,CIPINANG CEMPEDAK,32824,7328,25496,20938,46434,2021-11-02
3175081005,JAKARTA TIMUR,MAKASAR,CIPINANG MELAYU,42308,8402,33906,28283,62189,2021-11-02
3175031006,JAKARTA TIMUR,JATINEGARA,CIPINANG MUARA,55243,12232,43011,34209,77220,2021-11-02
3174051003,JAKARTA SELATAN,KEBAYORAN LAMA,CIPULIR,39937,8651,31286,24836,56122,2021-11-02
3175091001,JAKARTA TIMUR,CIRACAS,CIRACAS,64594,12193,52401,42226,94627,2021-11-02
3175041003,JAKARTA TIMUR,KRAMAT JATI,DUKUH,24609,4791,19818,16003,35821,2021-11-02
3175071001,JAKARTA TIMUR,DUREN SAWIT,DUREN SAWIT,61160,13314,47846,38419,86265,2021-11-02
3174081004,JAKARTA SELATAN,PANCORAN,DUREN TIGA,28319,5855,22464,18394,40858,2021-11-02
3173051005,JAKARTA BARAT,KEBON JERUK,DURI KEPA,60138,12057,48081,40916,88997,2021-11-02
3173011002,JAKARTA BARAT,CENGKARENG,DURI KOSAMBI,77923,17208,60715,47713,108428,2021-11-02
3171011006,JAKARTA PUSAT,GAMBIR,DURI PULO,19610,4294,15316,12114,27430,2021-11-02
3173041011,JAKARTA BARAT,TAMBORA,DURI SELATAN,14259,2614,11645,9689,21334,2021-11-02
3173041003,JAKARTA BARAT,TAMBORA,DURI UTARA,19844,3715,16129,13061,29190,2021-11-02
3171081003,JAKARTA PUSAT,JOHAR BARU,GALUR,18243,3692,14551,11597,26148,2021-11-02
3171011001,JAKARTA PUSAT,GAMBIR,GAMBIR,2191,462,1729,1480,3209,2021-11-02
3174061004,JAKARTA SELATAN,CILANDAK,GANDARIA SELATAN,22119,4379,17740,14691,32431,2021-11-02
3174071009,JAKARTA SELATAN,KEBAYORAN BARU,GANDARIA UTARA,39922,8221,31701,25985,57686,2021-11-02
3175051001,JAKARTA TIMUR,PASAR REBO,GEDONG,35755,7396,28359,23464,51823,2021-11-02
3171071001,JAKARTA PUSAT,TANAH ABANG,GELORA,3127,628,2499,2121,4620,2021-11-02
3173031007,JAKARTA BARAT,TAMAN SARI,GLODOK,7837,1225,6612,5822,12434,2021-11-02
3171061004,JAKARTA PUSAT,MENTENG,GONDANGDIA,4100,943,3157,2855,6012,2021-11-02
3173021001,JAKARTA BARAT,GROGOL PETAMBURAN,GROGOL,16876,3485,13391,11106,24497,2021-11-02
3174051005,JAKARTA SELATAN,KEBAYORAN LAMA,GROGOL SELATAN,44251,9155,35096,28212,63308,2021-11-02
3174051004,JAKARTA SELATAN,KEBAYORAN LAMA,GROGOL UTARA,42494,8897,33597,27317,60914,2021-11-02
3174021007,JAKARTA SELATAN,SETIA BUDI,GUNTUR,3985,766,3219,2787,6006,2021-11-02
3174071002,JAKARTA SELATAN,KEBAYORAN BARU,GUNUNG,9436,1801,7635,6571,14206,2021-11-02
3171031005,JAKARTA PUSAT,KEMAYORAN,GUNUNG SAHARI SELATAN,19199,3998,15201,12559,27760,2021-11-02
3171021004,JAKARTA PUSAT,SAWAH BESAR,GUNUNG SAHARI UTARA,16650,3021,13629,11951,25580,2021-11-02
3175081004,JAKARTA TIMUR,MAKASAR,HALIM PERDANA KUSUMAH,28363,3782,24581,22173,46754,2021-11-02
3171031003,JAKARTA PUSAT,KEMAYORAN,HARAPAN MULIA,22557,4721,17836,14200,32036,2021-11-02
3174091001,JAKARTA SELATAN,JAGAKARSA,JAGAKARSA,62389,10712,51677,41863,93540,2021-11-02
3175021007,JAKARTA TIMUR,PULO GADUNG,JATI,32757,6322,26435,22393,48828,2021-11-02
3174041002,JAKARTA SELATAN,PASAR MINGGU,JATI PADANG,37502,7745,29757,24553,54310,2021-11-02
3173071004,JAKARTA BARAT,PALMERAH,JATI PULO,28738,5935,22803,17938,40741,2021-11-02
3175061001,JAKARTA TIMUR,CAKUNG,JATINEGARA,84160,18603,65557,52988,118545,2021-11-02
3175021004,JAKARTA TIMUR,PULO GADUNG,JATINEGARA KAUM,24632,4555,20077,15938,36015,2021-11-02
3173021004,JAKARTA BARAT,GROGOL PETAMBURAN,JELAMBAR,30266,5687,24579,20982,45561,2021-11-02
3173021006,JAKARTA BARAT,GROGOL PETAMBURAN,JELAMBAR BARU,38246,7366,30880,26299,57179,2021-11-02
3173041006,JAKARTA BARAT,TAMBORA,JEMBATAN BESI,29314,7303,22011,16817,38828,2021-11-02
3173041008,JAKARTA BARAT,TAMBORA,JEMBATAN LIMA,21021,5105,15916,12400,28316,2021-11-02
3173081005,JAKARTA BARAT,KEMBANGAN,JOGLO,40839,8607,32232,26902,59134,2021-11-02
3171081001,JAKARTA PUSAT,JOHAR BARU,JOHAR BARU,37488,7115,30373,25268,55641,2021-11-02
3173041002,JAKARTA BARAT,TAMBORA,KALI ANYAR,23856,4876,18980,14887,33867,2021-11-02
3172041004,JAKARTA UTARA,CILINCING,KALIBARU,67684,19041,48643,34130,82773,2021-11-02
3174081002,JAKARTA SELATAN,PANCORAN,KALIBATA,41994,9869,32125,25430,57555,2021-11-02
3173061001,JAKARTA BARAT,KALI DERES,KALIDERES,72447,15416,57031,47441,104472,2021-11-02
3175051004,JAKARTA TIMUR,PASAR REBO,KALISARI,43212,7977,35235,28999,64234,2021-11-02
3173061004,JAKARTA BARAT,KALI DERES,KAMAL,53783,12932,40851,31827,72678,2021-11-02
3172011002,JAKARTA UTARA,PENJARINGAN,KAMAL MUARA,12930,2322,10608,8964,19572,2021-11-02
3171071007,JAKARTA PUSAT,TANAH ABANG,KAMPUNG BALI,11358,2522,8836,6627,15463,2021-11-02
3175031001,JAKARTA TIMUR,JATINEGARA,KAMPUNG MELAYU,25717,5994,19723,15096,34819,2021-11-02
3171081002,JAKARTA PUSAT,JOHAR BARU,KAMPUNG RAWA,21237,3601,17636,13928,31564,2021-11-02
3175041002,JAKARTA TIMUR,KRAMAT JATI,KAMPUNG TENGAH,43993,11366,32627,25485,58112,2021-11-02
3173011005,JAKARTA BARAT,CENGKARENG,KAPUK,134466,33573,100893,79968,180861,2021-11-02
3172011003,JAKARTA UTARA,PENJARINGAN,KAPUK MUARA,35781,7065,28716,24808,53524,2021-11-02
3171021002,JAKARTA PUSAT,SAWAH BESAR,KARANG ANYAR,25761,5123,20638,17133,37771,2021-11-02
3174021004,JAKARTA SELATAN,SETIA BUDI,KARET,9623,1894,7729,6320,14049,2021-11-02
3174021003,JAKARTA SELATAN,SETIA BUDI,KARET KUNINGAN,16055,3222,12833,10652,23485,2021-11-02
3174021002,JAKARTA SELATAN,SETIA BUDI,KARET SEMANGGI,2770,566,2204,1936,4140,2021-11-02
3171071003,JAKARTA PUSAT,TANAH ABANG,KARET TENGSIN,19271,3812,15459,12313,27772,2021-11-02
3171021003,JAKARTA PUSAT,SAWAH BESAR,KARTINI,22292,4399,17893,15089,32982,2021-11-02
3175011003,JAKARTA TIMUR,MATRAMAN,KAYU MANIS,25284,5501,19783,15347,35130,2021-11-02
3175021006,JAKARTA TIMUR,PULO GADUNG,KAYU PUTIH,40696,7889,32807,28197,61004,2021-11-02
3173031006,JAKARTA BARAT,TAMAN SARI,KEAGUNGAN,17387,3327,14060,11286,25346,2021-11-02
3174041007,JAKARTA SELATAN,PASAR MINGGU,KEBAGUSAN,44552,9084,35468,28660,64128,2021-11-02
3174051006,JAKARTA SELATAN,KEBAYORAN LAMA,KEBAYORAN LAMA SELATAN,41212,7922,33290,27418,60708,2021-11-02
3174051001,JAKARTA SELATAN,KEBAYORAN LAMA,KEBAYORAN LAMA UTARA,42422,9143,33279,26755,60034,2021-11-02
3174011004,JAKARTA SELATAN,TEBET,KEBON BARU,35165,6872,28293,23161,51454,2021-11-02
3172021005,JAKARTA UTARA,TANJUNG PRIOK,KEBON BAWANG,50952,10615,40337,32909,73246,2021-11-02
3173051001,JAKARTA BARAT,KEBON JERUK,KEBON JERUK,53887,11958,41929,33781,75710,2021-11-02
3171071006,JAKARTA PUSAT,TANAH ABANG,KEBON KACANG,21531,5280,16251,12586,28837,2021-11-02
3171011005,JAKARTA PUSAT,GAMBIR,KEBON KELAPA,10163,2089,8074,6684,14758,2021-11-02
3171031002,JAKARTA PUSAT,KEMAYORAN,KEBON KOSONG,30019,6193,23826,18966,42792,2021-11-02
3175011005,JAKARTA TIMUR,MATRAMAN,KEBON MANGGIS,16490,3329,13161,10695,23856,2021-11-02
3171071005,JAKARTA PUSAT,TANAH ABANG,KEBON MELATI,32206,8808,23398,16991,40389,2021-11-02
3175081003,JAKARTA TIMUR,MAKASAR,KEBON PALA,46614,9589,37025,30260,67285,2021-11-02
3171061005,JAKARTA PUSAT,MENTENG,KEBON SIRIH,12299,2725,9574,7567,17141,2021-11-02
3173011004,JAKARTA BARAT,CENGKARENG,KEDAUNG KALI ANGKE,32612,6512,26100,21551,47651,2021-11-02
3173051007,JAKARTA BARAT,KEBON JERUK,KEDOYA SELATAN,32165,6009,26156,21332,47488,2021-11-02
3173051006,JAKARTA BARAT,KEBON JERUK,KEDOYA UTARA,45740,8883,36857,30772,67629,2021-11-02
3173051004,JAKARTA BARAT,KEBON JERUK,KELAPA DUA,23565,4909,18656,15378,34034,2021-11-02
3175091003,JAKARTA TIMUR,CIRACAS,KELAPA DUA WETAN,46875,8275,38600,31777,70377,2021-11-02
3172061003,JAKARTA UTARA,KELAPA GADING,KELAPA GADING BARAT,35717,6356,29361,26149,55510,2021-11-02
3172061001,JAKARTA UTARA,KELAPA GADING,KELAPA GADING TIMUR,33592,5251,28341,25894,54235,2021-11-02
3173071005,JAKARTA BARAT,PALMERAH,KEMANGGISAN,32139,6278,25861,21210,47071,2021-11-02
3171031001,JAKARTA PUSAT,KEMAYORAN,KEMAYORAN,20708,4434,16274,13261,29535,2021-11-02
3173081006,JAKARTA BARAT,KEMBANGAN,KEMBANGAN SELATAN,27130,5841,21289,18119,39408,2021-11-02
3173081001,JAKARTA BARAT,KEMBANGAN,KEMBANGAN UTARA,54451,12313,42138,34603,76741,2021-11-02
3171041002,JAKARTA PUSAT,SENEN,KENARI,9579,1922,7657,6435,14092,2021-11-02
3173041005,JAKARTA BARAT,TAMBORA,KERENDANG,19973,4240,15733,12573,28306,2021-11-02
3175071003,JAKARTA TIMUR,DUREN SAWIT,KLENDER,69978,16860,53118,41339,94457,2021-11-02
3172031001,JAKARTA UTARA,KOJA,KOJA,28175,6594,21581,17154,38735,2021-11-02
3173071006,JAKARTA BARAT,PALMERAH,KOTA BAMBU SELATAN,21158,4426,16732,12918,29650,2021-11-02
3173071003,JAKARTA BARAT,PALMERAH,KOTA BAMBU UTARA,24995,5337,19658,15035,34693,2021-11-02
3171041004,JAKARTA PUSAT,SENEN,KRAMAT,28835,7110,21725,16277,38002,2021-11-02
3175041001,JAKARTA TIMUR,KRAMAT JATI,KRAMAT JATI,34144,7719,26425,21065,47490,2021-11-02
3174071003,JAKARTA SELATAN,KEBAYORAN BARU,KRAMAT PELA,14413,2866,11547,9610,21157,2021-11-02
3173031002,JAKARTA BARAT,TAMAN SARI,KRUKUT,19244,3721,15523,12298,27821,2021-11-02
3174031005,JAKARTA SELATAN,MAMPANG PRAPATAN,KUNINGAN BARAT,12785,2444,10341,8489,18830,2021-11-02
3174021008,JAKARTA SELATAN,SETIA BUDI,KUNINGAN TIMUR,6008,1227,4781,3965,8746,2021-11-02
3171041005,JAKARTA PUSAT,SENEN,KWITANG,15486,3594,11892,9480,21372,2021-11-02
3172031003,JAKARTA UTARA,KOJA,LAGOA,59065,14382,44683,34764,79447,2021-11-02
3174061002,JAKARTA SELATAN,CILANDAK,LEBAK BULUS,37626,7382,30244,25652,55896,2021-11-02
3174091004,JAKARTA SELATAN,JAGAKARSA,LENTENG AGUNG,53946,10058,43888,34696,78584,2021-11-02
3175101007,JAKARTA TIMUR,CIPAYUNG,LUBANG BUAYA,63547,12293,51254,41617,92871,2021-11-02
3175081001,JAKARTA TIMUR,MAKASAR,MAKASAR,34390,6529,27861,23069,50930,2021-11-02
3175071006,JAKARTA TIMUR,DUREN SAWIT,MALAKA JAYA,30927,5527,25400,21291,46691,2021-11-02
3175071005,JAKARTA TIMUR,DUREN SAWIT,MALAKA SARI,27530,4761,22769,19241,42010,2021-11-02
3174031001,JAKARTA SELATAN,MAMPANG PRAPATAN,MAMPANG PRAPATAN,18159,3829,14330,11558,25888,2021-11-02
3173031005,JAKARTA BARAT,TAMAN SARI,MANGGA BESAR,7707,1336,6371,5484,11855,2021-11-02
3171021005,JAKARTA PUSAT,SAWAH BESAR,MANGGA DUA SELATAN,27442,5861,21581,17989,39570,2021-11-02
3174011007,JAKARTA SELATAN,TEBET,MANGGARAI,28373,5211,23162,18413,41575,2021-11-02
3174011006,JAKARTA SELATAN,TEBET,MANGGARAI SELATAN,23075,4224,18851,15609,34460,2021-11-02
3173031003,JAKARTA BARAT,TAMAN SARI,MAPHAR,16461,3152,13309,10900,24209,2021-11-02
3172041003,JAKARTA UTARA,CILINCING,MARUNDA,28943,6751,22192,16369,38561,2021-11-02
3174071001,JAKARTA SELATAN,KEBAYORAN BARU,MELAWAI,2627,521,2106,1925,4031,2021-11-02
3171061001,JAKARTA PUSAT,MENTENG,MENTENG,25624,5876,19748,15245,34993,2021-11-02
3174021005,JAKARTA SELATAN,SETIA BUDI,MENTENG ATAS,27816,5217,22599,18347,40946,2021-11-02
3174011003,JAKARTA SELATAN,TEBET,MENTENG DALAM,36028,7222,28806,23742,52548,2021-11-02
3173081003,JAKARTA BARAT,KEMBANGAN,MERUYA SELATAN,32130,6822,25308,20860,46168,2021-11-02
3173081002,JAKARTA BARAT,KEMBANGAN,MERUYA UTARA,43752,9238,34514,29477,63991,2021-11-02
3175101004,JAKARTA TIMUR,CIPAYUNG,MUNJUL,23871,4450,19421,16067,35488,2021-11-02
3172051002,JAKARTA UTARA,PADEMANGAN,PADEMANGAN BARAT,74240,18144,56096,44571,100667,2021-11-02
3172051001,JAKARTA UTARA,PADEMANGAN,PADEMANGAN TIMUR,37736,6865,30871,26511,57382,2021-11-02
3175011004,JAKARTA TIMUR,MATRAMAN,PAL MERIAM,19769,4269,15500,12225,27725,2021-11-02
3173071001,JAKARTA BARAT,PALMERAH,PALMERAH,63011,13755,49256,39271,88527,2021-11-02
3174081001,JAKARTA SELATAN,PANCORAN,PANCORAN,19421,4138,15283,12430,27713,2021-11-02
3172021003,JAKARTA UTARA,TANJUNG PRIOK,PAPANGGO,39097,7890,31207,25163,56370,2021-11-02
3171021001,JAKARTA PUSAT,SAWAH BESAR,PASAR BARU,12035,2352,9683,8529,18212,2021-11-02
3174021006,JAKARTA SELATAN,SETIA BUDI,PASAR MANGGIS,26752,5493,21259,17218,38477,2021-11-02
3174041001,JAKARTA SELATAN,PASAR MINGGU,PASAR MINGGU,24821,4810,20011,16753,36764,2021-11-02
3171041003,JAKARTA PUSAT,SENEN,PASEBAN,23533,5108,18425,14936,33361,2021-11-02
3173061005,JAKARTA BARAT,KALI DERES,PEGADUNGAN,75587,15851,59736,50734,110470,2021-11-02
3171061002,JAKARTA PUSAT,MENTENG,PEGANGSAAN,23455,5160,18295,13712,32007,2021-11-02
3172061002,JAKARTA UTARA,KELAPA GADING,PEGANGSAAN DUA,49976,8449,41527,37178,78705,2021-11-02
3172011004,JAKARTA UTARA,PENJARINGAN,PEJAGALAN,74578,15944,58634,49532,108166,2021-11-02
3174041006,JAKARTA SELATAN,PASAR MINGGU,PEJATEN BARAT,37346,7679,29667,24411,54078,2021-11-02
3174041005,JAKARTA SELATAN,PASAR MINGGU,PEJATEN TIMUR,57656,13469,44187,35895,80082,2021-11-02
3175051005,JAKARTA TIMUR,PASAR REBO,PEKAYON,43250,8081,35169,28705,63874,2021-11-02
3173041009,JAKARTA BARAT,TAMBORA,PEKOJAN,23587,4622,18965,15608,34573,2021-11-02
3174031003,JAKARTA SELATAN,MAMPANG PRAPATAN,PELA MAMPANG,43522,8929,34593,28396,62989,2021-11-02
3174081005,JAKARTA SELATAN,PANCORAN,PENGADEGAN,21478,4067,17411,14540,31951,2021-11-02
3175061003,JAKARTA TIMUR,CAKUNG,PENGGILINGAN,99255,23913,75342,59387,134729,2021-11-02
3172011001,JAKARTA UTARA,PENJARINGAN,PENJARINGAN,88308,23178,65130,49297,114427,2021-11-02
3174101001,JAKARTA SELATAN,PESANGGRAHAN,PESANGGRAHAN,27545,4895,22650,19113,41763,2021-11-02
3171071004,JAKARTA PUSAT,TANAH ABANG,PETAMBURAN,33271,9014,24257,18046,42303,2021-11-02
3174071008,JAKARTA SELATAN,KEBAYORAN BARU,PETOGOGAN,11499,2336,9163,7633,16796,2021-11-02
3171011004,JAKARTA PUSAT,GAMBIR,PETOJO SELATAN,14692,3387,11305,9452,20757,2021-11-02
3171011003,JAKARTA PUSAT,GAMBIR,PETOJO UTARA,17458,3859,13599,10995,24594,2021-11-02
3174101004,JAKARTA SELATAN,PESANGGRAHAN,PETUKANGAN SELATAN,37187,7886,29301,24154,53455,2021-11-02
3174101003,JAKARTA SELATAN,PESANGGRAHAN,PETUKANGAN UTARA,53716,11986,41730,34023,75753,2021-11-02
3175081002,JAKARTA TIMUR,MAKASAR,PINANG RANTI,27198,6084,21114,17169,38283,2021-11-02
3173031008,JAKARTA BARAT,TAMAN SARI,PINANGSIA,10729,1928,8801,7169,15970,2021-11-02
3175011001,JAKARTA TIMUR,MATRAMAN,PISANGAN BARU,31776,6766,25010,19480,44490,2021-11-02
3175021002,JAKARTA TIMUR,PULO GADUNG,PISANGAN TIMUR,41011,7964,33047,27473,60520,2021-11-02
3172011005,JAKARTA UTARA,PENJARINGAN,PLUIT,47783,9347,38436,33113,71549,2021-11-02
3175071002,JAKARTA TIMUR,DUREN SAWIT,PONDOK BAMBU,61550,13407,48143,38618,86761,2021-11-02
3175071004,JAKARTA TIMUR,DUREN SAWIT,PONDOK KELAPA,72015,14628,57387,48372,105759,2021-11-02
3175071007,JAKARTA TIMUR,DUREN SAWIT,PONDOK KOPI,35367,6793,28574,21994,50568,2021-11-02
3174061003,JAKARTA SELATAN,CILANDAK,PONDOK LABU,46464,8213,38251,32730,70981,2021-11-02
3174051002,JAKARTA SELATAN,KEBAYORAN LAMA,PONDOK PINANG,56169,11088,45081,37727,82808,2021-11-02
3175101003,JAKARTA TIMUR,CIPAYUNG,PONDOK RANGGON,25574,4919,20655,17003,37658,2021-11-02
3101011003,KAB.ADM.KEP.SERIBU,KEP. SERIBU UTARA,PULAU HARAPAN,2060,227,1833,1592,3425,2021-11-02
3101011002,KAB.ADM.KEP.SERIBU,KEP. SERIBU UTARA,PULAU KELAPA,5528,620,4908,4018,8926,2021-11-02
3101011001,KAB.ADM.KEP.SERIBU,KEP. SERIBU UTARA,PULAU PANGGANG,5450,453,4997,4440,9437,2021-11-02
3101021003,KAB.ADM.KEP.SERIBU,KEP. SERIBU SELATAN,PULAU PARI,2765,199,2566,2394,4960,2021-11-02
3101021002,KAB.ADM.KEP.SERIBU,KEP. SERIBU SELATAN,PULAU TIDUNG,4553,373,4180,3806,7986,2021-11-02
3101021001,KAB.ADM.KEP.SERIBU,KEP. SERIBU SELATAN,PULAU UNTUNG JAWA,1941,163,1778,1631,3409,2021-11-02
3174071007,JAKARTA SELATAN,KEBAYORAN BARU,PULO,5835,1038,4797,4318,9115,2021-11-02
3175021001,JAKARTA TIMUR,PULO GADUNG,PULO GADUNG,34422,7743,26679,21886,48565,2021-11-02
3175061005,JAKARTA TIMUR,CAKUNG,PULO GEBANG,97301,19304,77997,62449,140446,2021-11-02
3174041004,JAKARTA SELATAN,PASAR MINGGU,RAGUNAN,39616,7606,32010,26820,58830,2021-11-02
3175091005,JAKARTA TIMUR,CIRACAS,RAMBUTAN,36771,8868,27903,21776,49679,2021-11-02
3172031006,JAKARTA UTARA,KOJA,RAWA BADAK SELATAN,42179,10281,31898,24723,56621,2021-11-02
3172031004,JAKARTA UTARA,KOJA,RAWA BADAK UTARA,34408,7923,26485,20861,47346,2021-11-02
3174071005,JAKARTA SELATAN,KEBAYORAN BARU,RAWA BARAT,5625,1023,4602,4028,8630,2021-11-02
3173011003,JAKARTA BARAT,CENGKARENG,RAWA BUAYA,63799,13236,50563,40155,90718,2021-11-02
3175031004,JAKARTA TIMUR,JATINEGARA,RAWA BUNGA,21434,5321,16113,12776,28889,2021-11-02
3174081003,JAKARTA SELATAN,PANCORAN,RAWA JATI,20509,4002,16507,13807,30314,2021-11-02
3175061002,JAKARTA TIMUR,CAKUNG,RAWA TERATE,24637,4592,20045,16109,36154,2021-11-02
3175021005,JAKARTA TIMUR,PULO GADUNG,RAWAMANGUN,37612,7669,29943,24909,54852,2021-11-02
3171051003,JAKARTA PUSAT,CEMPAKA PUTIH,RAWASARI,21967,4613,17354,14488,31842,2021-11-02
3173041010,JAKARTA BARAT,TAMBORA,ROA MALAKA,3484,626,2858,2500,5358,2021-11-02
3172041006,JAKARTA UTARA,CILINCING,ROROTAN,41668,8591,33077,25996,59073,2021-11-02
3174071004,JAKARTA SELATAN,KEBAYORAN BARU,SELONG,2842,551,2291,2089,4380,2021-11-02
3173061002,JAKARTA BARAT,KALI DERES,SEMANAN,71354,16042,55312,44025,99337,2021-11-02
3172041007,JAKARTA UTARA,CILINCING,SEMPER BARAT,68587,13842,54745,44568,99313,2021-11-02
3172041005,JAKARTA UTARA,CILINCING,SEMPER TIMUR,36267,8023,28244,22472,50716,2021-11-02
3174071006,JAKARTA SELATAN,KEBAYORAN BARU,SENAYAN,2771,666,2105,1782,3887,2021-11-02
3171041001,JAKARTA PUSAT,SENEN,SENEN,6804,1512,5292,4356,9648,2021-11-02
3171031004,JAKARTA PUSAT,KEMAYORAN,SERDANG,29668,6083,23585,19359,42944,2021-11-02
3174021001,JAKARTA SELATAN,SETIA BUDI,SETIA BUDI,3023,631,2392,1986,4378,2021-11-02
3175101005,JAKARTA TIMUR,CIPAYUNG,SETU,20572,4207,16365,12967,29332,2021-11-02
3173071002,JAKARTA BARAT,PALMERAH,SLIPI,16591,3090,13501,11145,24646,2021-11-02
3173081004,JAKARTA BARAT,KEMBANGAN,SRENGSENG,45523,10526,34997,29194,64191,2021-11-02
3174091002,JAKARTA SELATAN,JAGAKARSA,SRENGSENG SAWAH,58196,9315,48881,40640,89521,2021-11-02
3173051003,JAKARTA BARAT,KEBON JERUK,SUKABUMI SELATAN,37033,8583,28450,21667,50117,2021-11-02
3173051002,JAKARTA BARAT,KEBON JERUK,SUKABUMI UTARA,38290,9228,29062,22390,51452,2021-11-02
3172041002,JAKARTA UTARA,CILINCING,SUKAPURA,53949,12524,41425,33494,74919,2021-11-02
3171031007,JAKARTA PUSAT,KEMAYORAN,SUMUR BATU,22717,4737,17980,15091,33071,2021-11-02
3172021004,JAKARTA UTARA,TANJUNG PRIOK,SUNGAI BAMBU,29876,6186,23690,19230,42920,2021-11-02
3172021006,JAKARTA UTARA,TANJUNG PRIOK,SUNTER AGUNG,71805,12828,58977,50691,109668,2021-11-02
3172021002,JAKARTA UTARA,TANJUNG PRIOK,SUNTER JAYA,63031,11458,51573,43845,95418,2021-11-02
3175091004,JAKARTA TIMUR,CIRACAS,SUSUKAN,38257,7427,30830,25196,56026,2021-11-02
3173031001,JAKARTA BARAT,TAMAN SARI,TAMAN SARI,14348,2703,11645,9877,21522,2021-11-02
3173041001,JAKARTA BARAT,TAMBORA,TAMBORA,10204,2321,7883,6256,14139,2021-11-02
3173041004,JAKARTA BARAT,TAMBORA,TANAH SEREAL,26387,4607,21780,18064,39844,2021-11-02
3171081004,JAKARTA PUSAT,JOHAR BARU,TANAH TINGGI,37693,7339,30354,24309,54663,2021-11-02
3173031004,JAKARTA BARAT,TAMAN SARI,TANGKI,13324,2261,11063,9178,20241,2021-11-02
3174091005,JAKARTA SELATAN,JAGAKARSA,TANJUNG BARAT,39770,6976,32794,26283,59077,2021-11-02
3173021005,JAKARTA BARAT,GROGOL PETAMBURAN,TANJUNG DUREN SELATAN,25337,4957,20380,17627,38007,2021-11-02
3173021002,JAKARTA BARAT,GROGOL PETAMBURAN,TANJUNG DUREN UTARA,17010,2955,14055,12364,26419,2021-11-02
3172021001,JAKARTA UTARA,TANJUNG PRIOK,TANJUNG PRIOK,34588,7310,27278,21922,49200,2021-11-02
3174011002,JAKARTA SELATAN,TEBET,TEBET BARAT,21194,3595,17599,15262,32861,2021-11-02
3174011001,JAKARTA SELATAN,TEBET,TEBET TIMUR,18199,3008,15191,13458,28649,2021-11-02
3173061003,JAKARTA BARAT,KALI DERES,TEGAL ALUR,83647,18202,65445,53325,118770,2021-11-02
3174031004,JAKARTA SELATAN,MAMPANG PRAPATAN,TEGAL PARANG,32401,7436,24965,18959,43924,2021-11-02
3173021003,JAKARTA BARAT,GROGOL PETAMBURAN,TOMANG,29605,5616,23989,20223,44212,2021-11-02
3172031005,JAKARTA UTARA,KOJA,TUGU SELATAN,39122,8979,30143,23962,54105,2021-11-02
3172031002,JAKARTA UTARA,KOJA,TUGU UTARA,67670,16446,51224,39811,91035,2021-11-02
3175061006,JAKARTA TIMUR,CAKUNG,UJUNG MENTENG,29934,5364,24570,20560,45130,2021-11-02
3174101005,JAKARTA SELATAN,PESANGGRAHAN,ULUJAMI,40544,9488,31056,25061,56117,2021-11-02
3175011006,JAKARTA TIMUR,MATRAMAN,UTAN KAYU SELATAN,33511,6254,27257,22153,49410,2021-11-02
3175011002,JAKARTA TIMUR,MATRAMAN,UTAN KAYU UTARA,28169,6071,22098,17789,39887,2021-11-02
3171031008,JAKARTA PUSAT,KEMAYORAN,UTAN PANJANG,29208,6119,23089,18388,41477,2021-11-02
3172021007,JAKARTA UTARA,TANJUNG PRIOK,WARAKAS,44401,8358,36043,28522,64565,2021-11-02
3173021007,JAKARTA BARAT,GROGOL PETAMBURAN,WIJAYA KUSUMA,38934,8389,30545,25201,55746,2021-11-02
3172051003,JAKARTA UTARA,PADEMANGAN,ANCOL,23947,5943,18004,14636,32640,2021-11-03
3173041007,JAKARTA BARAT,TAMBORA,ANGKE,29381,6509,22872,18303,41175,2021-11-03
3175041005,JAKARTA TIMUR,KRAMAT JATI,BALE KAMBANG,29074,7508,21566,16583,38149,2021-11-03
3175031003,JAKARTA TIMUR,JATINEGARA,BALI MESTER,9752,2096,7656,6354,14010,2021-11-03
3175101006,JAKARTA TIMUR,CIPAYUNG,BAMBU APUS,26285,4967,21318,17458,38776,2021-11-03
3174031002,JAKARTA SELATAN,MAMPANG PRAPATAN,BANGKA,21566,4707,16859,13724,30583,2021-11-03
3175051002,JAKARTA TIMUR,PASAR REBO,BARU,23886,4046,19840,16811,36651,2021-11-03
3175041004,JAKARTA TIMUR,KRAMAT JATI,BATU AMPAR,47898,12067,35831,28221,64052,2021-11-03
3171071002,JAKARTA PUSAT,TANAH ABANG,BENDUNGAN HILIR,21494,4461,17033,14288,31321,2021-11-03
3175031002,JAKARTA TIMUR,JATINEGARA,BIDARA CINA,36689,9030,27659,21694,49353,2021-11-03
3174101002,JAKARTA SELATAN,PESANGGRAHAN,BINTARO,53098,10923,42175,35658,77833,2021-11-03
3174011005,JAKARTA SELATAN,TEBET,BUKIT DURI,34183,7127,27056,22106,49162,2021-11-03
3171041006,JAKARTA PUSAT,SENEN,BUNGUR,18144,3924,14220,11663,25883,2021-11-03
3175061007,JAKARTA TIMUR,CAKUNG,CAKUNG BARAT,57724,12196,45528,37108,82636,2021-11-03
3175061004,JAKARTA TIMUR,CAKUNG,CAKUNG TIMUR,58287,11802,46485,38033,84518,2021-11-03
3175041007,JAKARTA TIMUR,KRAMAT JATI,CAWANG,32762,7348,25414,19953,45367,2021-11-03
3175101008,JAKARTA TIMUR,CIPAYUNG,CEGER,18932,3805,15127,12436,27563,2021-11-03
3171031006,JAKARTA PUSAT,KEMAYORAN,CEMPAKA BARU,32581,6553,26028,20121,46149,2021-11-03
3171051002,JAKARTA PUSAT,CEMPAKA PUTIH,CEMPAKA PUTIH BARAT,35885,7822,28063,23479,51542,2021-11-03
3171051001,JAKARTA PUSAT,CEMPAKA PUTIH,CEMPAKA PUTIH TIMUR,24292,5114,19178,16434,35612,2021-11-03
3173011001,JAKARTA BARAT,CENGKARENG,CENGKARENG BARAT,66284,13640,52644,43786,96430,2021-11-03
3173011006,JAKARTA BARAT,CENGKARENG,CENGKARENG TIMUR,81027,16493,64534,52417,116951,2021-11-03
3175091002,JAKARTA TIMUR,CIRACAS,CIBUBUR,66364,11717,54647,44890,99537,2021-11-03
3171011002,JAKARTA PUSAT,GAMBIR,CIDENG,15390,3059,12331,10601,22932,2021-11-03
3174091003,JAKARTA SELATAN,JAGAKARSA,CIGANJUR,38497,6801,31696,25550,57246,2021-11-03
3175051003,JAKARTA TIMUR,PASAR REBO,CIJANTUNG,41419,7909,33510,27497,61007,2021-11-03
3171061003,JAKARTA PUSAT,MENTENG,CIKINI,8274,1520,6754,5241,11995,2021-11-03
3174081006,JAKARTA SELATAN,PANCORAN,CIKOKO,10547,1873,8674,7409,16083,2021-11-03
3174061001,JAKARTA SELATAN,CILANDAK,CILANDAK BARAT,51752,9458,42294,36106,78400,2021-11-03
3174041003,JAKARTA SELATAN,PASAR MINGGU,CILANDAK TIMUR,25145,4740,20405,17065,37470,2021-11-03
3175101002,JAKARTA TIMUR,CIPAYUNG,CILANGKAP,27635,5015,22620,18734,41354,2021-11-03
3175041006,JAKARTA TIMUR,KRAMAT JATI,CILILITAN,40181,9199,30982,24740,55722,2021-11-03
3172041001,JAKARTA UTARA,CILINCING,CILINCING,43609,10712,32897,25096,57993,2021-11-03
3175101001,JAKARTA TIMUR,CIPAYUNG,CIPAYUNG,26104,4670,21434,18134,39568,2021-11-03
3174091006,JAKARTA SELATAN,JAGAKARSA,CIPEDAK,38303,6515,31788,26190,57978,2021-11-03
3174061005,JAKARTA SELATAN,CILANDAK,CIPETE SELATAN,26704,5276,21428,18398,39826,2021-11-03
3174071010,JAKARTA SELATAN,KEBAYORAN BARU,CIPETE UTARA,34102,6660,27442,22179,49621,2021-11-03
3175021003,JAKARTA TIMUR,PULO GADUNG,CIPINANG,39306,7546,31760,25908,57668,2021-11-03
3175031007,JAKARTA TIMUR,JATINEGARA,CIPINANG BESAR SELATAN,35212,8556,26656,20416,47072,2021-11-03
3175031008,JAKARTA TIMUR,JATINEGARA,CIPINANG BESAR UTARA,45319,10978,34341,26190,60531,2021-11-03
3175031005,JAKARTA TIMUR,JATINEGARA,CIPINANG CEMPEDAK,32824,7304,25520,21069,46589,2021-11-03
3175081005,JAKARTA TIMUR,MAKASAR,CIPINANG MELAYU,42308,8391,33917,28323,62240,2021-11-03
3175031006,JAKARTA TIMUR,JATINEGARA,CIPINANG MUARA,55243,12153,43090,34332,77422,2021-11-03
3174051003,JAKARTA SELATAN,KEBAYORAN LAMA,CIPULIR,39937,8618,31319,24914,56233,2021-11-03
3175091001,JAKARTA TIMUR,CIRACAS,CIRACAS,64594,12156,52438,42425,94863,2021-11-03
3175041003,JAKARTA TIMUR,KRAMAT JATI,DUKUH,24609,4773,19836,16082,35918,2021-11-03
3175071001,JAKARTA TIMUR,DUREN SAWIT,DUREN SAWIT,61160,13270,47890,38594,86484,2021-11-03
3174081004,JAKARTA SELATAN,PANCORAN,DUREN TIGA,28319,5848,22471,18459,40930,2021-11-03
3173051005,JAKARTA BARAT,KEBON JERUK,DURI KEPA,60138,12010,48128,41002,89130,2021-11-03
3173011002,JAKARTA BARAT,CENGKARENG,DURI KOSAMBI,77923,17146,60777,47909,108686,2021-11-03
3171011006,JAKARTA PUSAT,GAMBIR,DURI PULO,19610,4283,15327,12130,27457,2021-11-03
3173041011,JAKARTA BARAT,TAMBORA,DURI SELATAN,14259,2605,11654,9709,21363,2021-11-03
3173041003,JAKARTA BARAT,TAMBORA,DURI UTARA,19844,3707,16137,13096,29233,2021-11-03
3171081003,JAKARTA PUSAT,JOHAR BARU,GALUR,18243,3681,14562,11618,26180,2021-11-03
3171011001,JAKARTA PUSAT,GAMBIR,GAMBIR,2191,462,1729,1481,3210,2021-11-03
3174061004,JAKARTA SELATAN,CILANDAK,GANDARIA SELATAN,22119,4364,17755,14790,32545,2021-11-03
3174071009,JAKARTA SELATAN,KEBAYORAN BARU,GANDARIA UTARA,39922,8191,31731,26095,57826,2021-11-03
3175051001,JAKARTA TIMUR,PASAR REBO,GEDONG,35755,7365,28390,23595,51985,2021-11-03
3171071001,JAKARTA PUSAT,TANAH ABANG,GELORA,3127,627,2500,2123,4623,2021-11-03
3173031007,JAKARTA BARAT,TAMAN SARI,GLODOK,7837,1222,6615,5835,12450,2021-11-03
3171061004,JAKARTA PUSAT,MENTENG,GONDANGDIA,4100,943,3157,2858,6015,2021-11-03
3173021001,JAKARTA BARAT,GROGOL PETAMBURAN,GROGOL,16876,3462,13414,11146,24560,2021-11-03
3174051005,JAKARTA SELATAN,KEBAYORAN LAMA,GROGOL SELATAN,44251,9065,35186,28411,63597,2021-11-03
3174051004,JAKARTA SELATAN,KEBAYORAN LAMA,GROGOL UTARA,42494,8863,33631,27419,61050,2021-11-03
3174021007,JAKARTA SELATAN,SETIA BUDI,GUNTUR,3985,763,3222,2791,6013,2021-11-03
3174071002,JAKARTA SELATAN,KEBAYORAN BARU,GUNUNG,9436,1791,7645,6654,14299,2021-11-03
3171031005,JAKARTA PUSAT,KEMAYORAN,GUNUNG SAHARI SELATAN,19199,3978,15221,12605,27826,2021-11-03
3171021004,JAKARTA PUSAT,SAWAH BESAR,GUNUNG SAHARI UTARA,16650,3015,13635,11986,25621,2021-11-03
3175081004,JAKARTA TIMUR,MAKASAR,HALIM PERDANA KUSUMAH,28363,3775,24588,22216,46804,2021-11-03
3171031003,JAKARTA PUSAT,KEMAYORAN,HARAPAN MULIA,22557,4694,17863,14252,32115,2021-11-03
3174091001,JAKARTA SELATAN,JAGAKARSA,JAGAKARSA,62389,10603,51786,42046,93832,2021-11-03
3175021007,JAKARTA TIMUR,PULO GADUNG,JATI,32757,6273,26484,22473,48957,2021-11-03
3174041002,JAKARTA SELATAN,PASAR MINGGU,JATI PADANG,37502,7719,29783,24644,54427,2021-11-03
3173071004,JAKARTA BARAT,PALMERAH,JATI PULO,28738,5909,22829,17993,40822,2021-11-03
3175061001,JAKARTA TIMUR,CAKUNG,JATINEGARA,84160,18496,65664,53128,118792,2021-11-03
3175021004,JAKARTA TIMUR,PULO GADUNG,JATINEGARA KAUM,24632,4540,20092,15998,36090,2021-11-03
3173021004,JAKARTA BARAT,GROGOL PETAMBURAN,JELAMBAR,30266,5666,24600,21042,45642,2021-11-03
3173021006,JAKARTA BARAT,GROGOL PETAMBURAN,JELAMBAR BARU,38246,7331,30915,26379,57294,2021-11-03
3173041006,JAKARTA BARAT,TAMBORA,JEMBATAN BESI,29314,7287,22027,16877,38904,2021-11-03
3173041008,JAKARTA BARAT,TAMBORA,JEMBATAN LIMA,21021,5084,15937,12432,28369,2021-11-03
3173081005,JAKARTA BARAT,KEMBANGAN,JOGLO,40839,8577,32262,26995,59257,2021-11-03
3171081001,JAKARTA PUSAT,JOHAR BARU,JOHAR BARU,37488,7091,30397,25348,55745,2021-11-03
3173041002,JAKARTA BARAT,TAMBORA,KALI ANYAR,23856,4856,19000,14928,33928,2021-11-03
3172041004,JAKARTA UTARA,CILINCING,KALIBARU,67684,19005,48679,34222,82901,2021-11-03
3174081002,JAKARTA SELATAN,PANCORAN,KALIBATA,41994,9835,32159,25542,57701,2021-11-03
3173061001,JAKARTA BARAT,KALI DERES,KALIDERES,72447,15328,57119,47601,104720,2021-11-03
3175051004,JAKARTA TIMUR,PASAR REBO,KALISARI,43212,7946,35266,29099,64365,2021-11-03
3173061004,JAKARTA BARAT,KALI DERES,KAMAL,53783,12869,40914,31904,72818,2021-11-03
3172011002,JAKARTA UTARA,PENJARINGAN,KAMAL MUARA,12930,2320,10610,8972,19582,2021-11-03
3171071007,JAKARTA PUSAT,TANAH ABANG,KAMPUNG BALI,11358,2515,8843,6654,15497,2021-11-03
3175031001,JAKARTA TIMUR,JATINEGARA,KAMPUNG MELAYU,25717,5976,19741,15139,34880,2021-11-03
3171081002,JAKARTA PUSAT,JOHAR BARU,KAMPUNG RAWA,21237,3592,17645,13958,31603,2021-11-03
3175041002,JAKARTA TIMUR,KRAMAT JATI,KAMPUNG TENGAH,43993,11336,32657,25615,58272,2021-11-03
3173011005,JAKARTA BARAT,CENGKARENG,KAPUK,134466,33427,101039,80253,181292,2021-11-03
3172011003,JAKARTA UTARA,PENJARINGAN,KAPUK MUARA,35781,7026,28755,24873,53628,2021-11-03
3171021002,JAKARTA PUSAT,SAWAH BESAR,KARANG ANYAR,25761,5110,20651,17192,37843,2021-11-03
3174021004,JAKARTA SELATAN,SETIA BUDI,KARET,9623,1888,7735,6341,14076,2021-11-03
3174021003,JAKARTA SELATAN,SETIA BUDI,KARET KUNINGAN,16055,3197,12858,10690,23548,2021-11-03
3174021002,JAKARTA SELATAN,SETIA BUDI,KARET SEMANGGI,2770,560,2210,1938,4148,2021-11-03
3171071003,JAKARTA PUSAT,TANAH ABANG,KARET TENGSIN,19271,3799,15472,12349,27821,2021-11-03
3171021003,JAKARTA PUSAT,SAWAH BESAR,KARTINI,22292,4379,17913,15144,33057,2021-11-03
3175011003,JAKARTA TIMUR,MATRAMAN,KAYU MANIS,25284,5486,19798,15421,35219,2021-11-03
3175021006,JAKARTA TIMUR,PULO GADUNG,KAYU PUTIH,40696,7868,32828,28290,61118,2021-11-03
3173031006,JAKARTA BARAT,TAMAN SARI,KEAGUNGAN,17387,3310,14077,11315,25392,2021-11-03
3174041007,JAKARTA SELATAN,PASAR MINGGU,KEBAGUSAN,44552,9062,35490,28759,64249,2021-11-03
3174051006,JAKARTA SELATAN,KEBAYORAN LAMA,KEBAYORAN LAMA SELATAN,41212,7906,33306,27532,60838,2021-11-03
3174051001,JAKARTA SELATAN,KEBAYORAN LAMA,KEBAYORAN LAMA UTARA,42422,9115,33307,26827,60134,2021-11-03
3174011004,JAKARTA SELATAN,TEBET,KEBON BARU,35165,6837,28328,23287,51615,2021-11-03
3172021005,JAKARTA UTARA,TANJUNG PRIOK,KEBON BAWANG,50952,10575,40377,33035,73412,2021-11-03
3173051001,JAKARTA BARAT,KEBON JERUK,KEBON JERUK,53887,11907,41980,33912,75892,2021-11-03
3171071006,JAKARTA PUSAT,TANAH ABANG,KEBON KACANG,21531,5263,16268,12629,28897,2021-11-03
3171011005,JAKARTA PUSAT,GAMBIR,KEBON KELAPA,10163,2085,8078,6700,14778,2021-11-03
3171031002,JAKARTA PUSAT,KEMAYORAN,KEBON KOSONG,30019,6175,23844,19129,42973,2021-11-03
3175011005,JAKARTA TIMUR,MATRAMAN,KEBON MANGGIS,16490,3317,13173,10721,23894,2021-11-03
3171071005,JAKARTA PUSAT,TANAH ABANG,KEBON MELATI,32206,8780,23426,17045,40471,2021-11-03
3175081003,JAKARTA TIMUR,MAKASAR,KEBON PALA,46614,9516,37098,30364,67462,2021-11-03
3171061005,JAKARTA PUSAT,MENTENG,KEBON SIRIH,12299,2717,9582,7586,17168,2021-11-03
3173011004,JAKARTA BARAT,CENGKARENG,KEDAUNG KALI ANGKE,32612,6491,26121,21588,47709,2021-11-03
3173051007,JAKARTA BARAT,KEBON JERUK,KEDOYA SELATAN,32165,5998,26167,21372,47539,2021-11-03
3173051006,JAKARTA BARAT,KEBON JERUK,KEDOYA UTARA,45740,8868,36872,30826,67698,2021-11-03
3173051004,JAKARTA BARAT,KEBON JERUK,KELAPA DUA,23565,4865,18700,15421,34121,2021-11-03
3175091003,JAKARTA TIMUR,CIRACAS,KELAPA DUA WETAN,46875,8237,38638,31895,70533,2021-11-03
3172061003,JAKARTA UTARA,KELAPA GADING,KELAPA GADING BARAT,35717,6343,29374,26190,55564,2021-11-03
3172061001,JAKARTA UTARA,KELAPA GADING,KELAPA GADING TIMUR,33592,5241,28351,25937,54288,2021-11-03
3173071005,JAKARTA BARAT,PALMERAH,KEMANGGISAN,32139,6253,25886,21308,47194,2021-11-03
3171031001,JAKARTA PUSAT,KEMAYORAN,KEMAYORAN,20708,4420,16288,13300,29588,2021-11-03
3173081006,JAKARTA BARAT,KEMBANGAN,KEMBANGAN SELATAN,27130,5829,21301,18179,39480,2021-11-03
3173081001,JAKARTA BARAT,KEMBANGAN,KEMBANGAN UTARA,54451,12279,42172,34704,76876,2021-11-03
3171041002,JAKARTA PUSAT,SENEN,KENARI,9579,1911,7668,6451,14119,2021-11-03
3173041005,JAKARTA BARAT,TAMBORA,KERENDANG,19973,4225,15748,12619,28367,2021-11-03
3175071003,JAKARTA TIMUR,DUREN SAWIT,KLENDER,69978,16808,53170,41462,94632,2021-11-03
3172031001,JAKARTA UTARA,KOJA,KOJA,28175,6577,21598,17218,38816,2021-11-03
3173071006,JAKARTA BARAT,PALMERAH,KOTA BAMBU SELATAN,21158,4390,16768,12958,29726,2021-11-03
3173071003,JAKARTA BARAT,PALMERAH,KOTA BAMBU UTARA,24995,5311,19684,15087,34771,2021-11-03
3171041004,JAKARTA PUSAT,SENEN,KRAMAT,28835,7080,21755,16338,38093,2021-11-03
3175041001,JAKARTA TIMUR,KRAMAT JATI,KRAMAT JATI,34144,7698,26446,21125,47571,2021-11-03
3174071003,JAKARTA SELATAN,KEBAYORAN BARU,KRAMAT PELA,14413,2859,11554,9652,21206,2021-11-03
3173031002,JAKARTA BARAT,TAMAN SARI,KRUKUT,19244,3708,15536,12352,27888,2021-11-03
3174031005,JAKARTA SELATAN,MAMPANG PRAPATAN,KUNINGAN BARAT,12785,2437,10348,8505,18853,2021-11-03
3174021008,JAKARTA SELATAN,SETIA BUDI,KUNINGAN TIMUR,6008,1221,4787,3977,8764,2021-11-03
3171041005,JAKARTA PUSAT,SENEN,KWITANG,15486,3584,11902,9500,21402,2021-11-03
3172031003,JAKARTA UTARA,KOJA,LAGOA,59065,14329,44736,34842,79578,2021-11-03
3174061002,JAKARTA SELATAN,CILANDAK,LEBAK BULUS,37626,7294,30332,25804,56136,2021-11-03
3174091004,JAKARTA SELATAN,JAGAKARSA,LENTENG AGUNG,53946,10025,43921,34880,78801,2021-11-03
3175101007,JAKARTA TIMUR,CIPAYUNG,LUBANG BUAYA,63547,12251,51296,41745,93041,2021-11-03
3175081001,JAKARTA TIMUR,MAKASAR,MAKASAR,34390,6493,27897,23140,51037,2021-11-03
3175071006,JAKARTA TIMUR,DUREN SAWIT,MALAKA JAYA,30927,5512,25415,21412,46827,2021-11-03
3175071005,JAKARTA TIMUR,DUREN SAWIT,MALAKA SARI,27530,4722,22808,19354,42162,2021-11-03
3174031001,JAKARTA SELATAN,MAMPANG PRAPATAN,MAMPANG PRAPATAN,18159,3821,14338,11600,25938,2021-11-03
3173031005,JAKARTA BARAT,TAMAN SARI,MANGGA BESAR,7707,1332,6375,5498,11873,2021-11-03
3171021005,JAKARTA PUSAT,SAWAH BESAR,MANGGA DUA SELATAN,27442,5844,21598,18048,39646,2021-11-03
3174011007,JAKARTA SELATAN,TEBET,MANGGARAI,28373,5197,23176,18492,41668,2021-11-03
3174011006,JAKARTA SELATAN,TEBET,MANGGARAI SELATAN,23075,4175,18900,15682,34582,2021-11-03
3173031003,JAKARTA BARAT,TAMAN SARI,MAPHAR,16461,3144,13317,10942,24259,2021-11-03
3172041003,JAKARTA UTARA,CILINCING,MARUNDA,28943,6734,22209,16402,38611,2021-11-03
3174071001,JAKARTA SELATAN,KEBAYORAN BARU,MELAWAI,2627,519,2108,1926,4034,2021-11-03
3171061001,JAKARTA PUSAT,MENTENG,MENTENG,25624,5832,19792,15334,35126,2021-11-03
3174021005,JAKARTA SELATAN,SETIA BUDI,MENTENG ATAS,27816,5190,22626,18465,41091,2021-11-03
3174011003,JAKARTA SELATAN,TEBET,MENTENG DALAM,36028,7195,28833,23882,52715,2021-11-03
3173081003,JAKARTA BARAT,KEMBANGAN,MERUYA SELATAN,32130,6789,25341,20975,46316,2021-11-03
3173081002,JAKARTA BARAT,KEMBANGAN,MERUYA UTARA,43752,9196,34556,29628,64184,2021-11-03
3175101004,JAKARTA TIMUR,CIPAYUNG,MUNJUL,23871,4440,19431,16099,35530,2021-11-03
3172051002,JAKARTA UTARA,PADEMANGAN,PADEMANGAN BARAT,74240,18088,56152,44717,100869,2021-11-03
3172051001,JAKARTA UTARA,PADEMANGAN,PADEMANGAN TIMUR,37736,6846,30890,26606,57496,2021-11-03
3175011004,JAKARTA TIMUR,MATRAMAN,PAL MERIAM,19769,4253,15516,12290,27806,2021-11-03
3173071001,JAKARTA BARAT,PALMERAH,PALMERAH,63011,13694,49317,39440,88757,2021-11-03
3174081001,JAKARTA SELATAN,PANCORAN,PANCORAN,19421,4130,15291,12462,27753,2021-11-03
3172021003,JAKARTA UTARA,TANJUNG PRIOK,PAPANGGO,39097,7867,31230,25240,56470,2021-11-03
3171021001,JAKARTA PUSAT,SAWAH BESAR,PASAR BARU,12035,2347,9688,8551,18239,2021-11-03
3174021006,JAKARTA SELATAN,SETIA BUDI,PASAR MANGGIS,26752,5471,21281,17285,38566,2021-11-03
3174041001,JAKARTA SELATAN,PASAR MINGGU,PASAR MINGGU,24821,4796,20025,16826,36851,2021-11-03
3171041003,JAKARTA PUSAT,SENEN,PASEBAN,23533,5071,18462,14983,33445,2021-11-03
3173061005,JAKARTA BARAT,KALI DERES,PEGADUNGAN,75587,15714,59873,50879,110752,2021-11-03
3171061002,JAKARTA PUSAT,MENTENG,PEGANGSAAN,23455,5147,18308,13759,32067,2021-11-03
3172061002,JAKARTA UTARA,KELAPA GADING,PEGANGSAAN DUA,49976,8427,41549,37226,78775,2021-11-03
3172011004,JAKARTA UTARA,PENJARINGAN,PEJAGALAN,74578,15887,58691,49731,108422,2021-11-03
3174041006,JAKARTA SELATAN,PASAR MINGGU,PEJATEN BARAT,37346,7617,29729,24538,54267,2021-11-03
3174041005,JAKARTA SELATAN,PASAR MINGGU,PEJATEN TIMUR,57656,13432,44224,35993,80217,2021-11-03
3175051005,JAKARTA TIMUR,PASAR REBO,PEKAYON,43250,8055,35195,28814,64009,2021-11-03
3173041009,JAKARTA BARAT,TAMBORA,PEKOJAN,23587,4603,18984,15649,34633,2021-11-03
3174031003,JAKARTA SELATAN,MAMPANG PRAPATAN,PELA MAMPANG,43522,8871,34651,28523,63174,2021-11-03
3174081005,JAKARTA SELATAN,PANCORAN,PENGADEGAN,21478,4047,17431,14627,32058,2021-11-03
3175061003,JAKARTA TIMUR,CAKUNG,PENGGILINGAN,99255,23747,75508,59600,135108,2021-11-03
3172011001,JAKARTA UTARA,PENJARINGAN,PENJARINGAN,88308,23117,65191,49432,114623,2021-11-03
3174101001,JAKARTA SELATAN,PESANGGRAHAN,PESANGGRAHAN,27545,4873,22672,19163,41835,2021-11-03
3171071004,JAKARTA PUSAT,TANAH ABANG,PETAMBURAN,33271,8984,24287,18120,42407,2021-11-03
3174071008,JAKARTA SELATAN,KEBAYORAN BARU,PETOGOGAN,11499,2322,9177,7656,16833,2021-11-03
3171011004,JAKARTA PUSAT,GAMBIR,PETOJO SELATAN,14692,3377,11315,9493,20808,2021-11-03
3171011003,JAKARTA PUSAT,GAMBIR,PETOJO UTARA,17458,3839,13619,11060,24679,2021-11-03
3174101004,JAKARTA SELATAN,PESANGGRAHAN,PETUKANGAN SELATAN,37187,7869,29318,24228,53546,2021-11-03
3174101003,JAKARTA SELATAN,PESANGGRAHAN,PETUKANGAN UTARA,53716,11901,41815,34205,76020,2021-11-03
3175081002,JAKARTA TIMUR,MAKASAR,PINANG RANTI,27198,6056,21142,17198,38340,2021-11-03
3173031008,JAKARTA BARAT,TAMAN SARI,PINANGSIA,10729,1921,8808,7188,15996,2021-11-03
3175011001,JAKARTA TIMUR,MATRAMAN,PISANGAN BARU,31776,6739,25037,19548,44585,2021-11-03
3175021002,JAKARTA TIMUR,PULO GADUNG,PISANGAN TIMUR,41011,7797,33214,27731,60945,2021-11-03
3172011005,JAKARTA UTARA,PENJARINGAN,PLUIT,47783,9338,38445,33194,71639,2021-11-03
3175071002,JAKARTA TIMUR,DUREN SAWIT,PONDOK BAMBU,61550,13361,48189,38801,86990,2021-11-03
3175071004,JAKARTA TIMUR,DUREN SAWIT,PONDOK KELAPA,72015,14590,57425,48517,105942,2021-11-03
3175071007,JAKARTA TIMUR,DUREN SAWIT,PONDOK KOPI,35367,6771,28596,22176,50772,2021-11-03
3174061003,JAKARTA SELATAN,CILANDAK,PONDOK LABU,46464,8179,38285,32840,71125,2021-11-03
3174051002,JAKARTA SELATAN,KEBAYORAN LAMA,PONDOK PINANG,56169,11070,45099,37824,82923,2021-11-03
3175101003,JAKARTA TIMUR,CIPAYUNG,PONDOK RANGGON,25574,4910,20664,17033,37697,2021-11-03
3101011003,KAB.ADM.KEP.SERIBU,KEP. SERIBU UTARA,PULAU HARAPAN,2060,223,1837,1598,3435,2021-11-03
3101011002,KAB.ADM.KEP.SERIBU,KEP. SERIBU UTARA,PULAU KELAPA,5528,616,4912,4034,8946,2021-11-03
3101011001,KAB.ADM.KEP.SERIBU,KEP. SERIBU UTARA,PULAU PANGGANG,5450,447,5003,4452,9455,2021-11-03
3101021003,KAB.ADM.KEP.SERIBU,KEP. SERIBU SELATAN,PULAU PARI,2765,199,2566,2397,4963,2021-11-03
3101021002,KAB.ADM.KEP.SERIBU,KEP. SERIBU SELATAN,PULAU TIDUNG,4553,372,4181,3810,7991,2021-11-03
3101021001,KAB.ADM.KEP.SERIBU,KEP. SERIBU SELATAN,PULAU UNTUNG JAWA,1941,163,1778,1631,3409,2021-11-03
3174071007,JAKARTA SELATAN,KEBAYORAN BARU,PULO,5835,1036,4799,4330,9129,2021-11-03
3175021001,JAKARTA TIMUR,PULO GADUNG,PULO GADUNG,34422,7719,26703,21956,48659,2021-11-03
3175061005,JAKARTA TIMUR,CAKUNG,PULO GEBANG,97301,19226,78075,62611,140686,2021-11-03
3174041004,JAKARTA SELATAN,PASAR MINGGU,RAGUNAN,39616,7575,32041,26905,58946,2021-11-03
3175091005,JAKARTA TIMUR,CIRACAS,RAMBUTAN,36771,8827,27944,21971,49915,2021-11-03
3172031006,JAKARTA UTARA,KOJA,RAWA BADAK SELATAN,42179,10244,31935,24819,56754,2021-11-03
3172031004,JAKARTA UTARA,KOJA,RAWA BADAK UTARA,34408,7884,26524,20949,47473,2021-11-03
3174071005,JAKARTA SELATAN,KEBAYORAN BARU,RAWA BARAT,5625,1021,4604,4035,8639,2021-11-03
3173011003,JAKARTA BARAT,CENGKARENG,RAWA BUAYA,63799,13160,50639,40366,91005,2021-11-03
3175031004,JAKARTA TIMUR,JATINEGARA,RAWA BUNGA,21434,5304,16130,12808,28938,2021-11-03
3174081003,JAKARTA SELATAN,PANCORAN,RAWA JATI,20509,3989,16520,13864,30384,2021-11-03
3175061002,JAKARTA TIMUR,CAKUNG,RAWA TERATE,24637,4579,20058,16167,36225,2021-11-03
3175021005,JAKARTA TIMUR,PULO GADUNG,RAWAMANGUN,37612,7637,29975,24996,54971,2021-11-03
3171051003,JAKARTA PUSAT,CEMPAKA PUTIH,RAWASARI,21967,4593,17374,14546,31920,2021-11-03
3173041010,JAKARTA BARAT,TAMBORA,ROA MALAKA,3484,626,2858,2502,5360,2021-11-03
3172041006,JAKARTA UTARA,CILINCING,ROROTAN,41668,8568,33100,26072,59172,2021-11-03
3174071004,JAKARTA SELATAN,KEBAYORAN BARU,SELONG,2842,551,2291,2094,4385,2021-11-03
3173061002,JAKARTA BARAT,KALI DERES,SEMANAN,71354,15869,55485,44195,99680,2021-11-03
3172041007,JAKARTA UTARA,CILINCING,SEMPER BARAT,68587,13787,54800,44686,99486,2021-11-03
3172041005,JAKARTA UTARA,CILINCING,SEMPER TIMUR,36267,7996,28271,22539,50810,2021-11-03
3174071006,JAKARTA SELATAN,KEBAYORAN BARU,SENAYAN,2771,663,2108,1797,3905,2021-11-03
3171041001,JAKARTA PUSAT,SENEN,SENEN,6804,1510,5294,4365,9659,2021-11-03
3171031004,JAKARTA PUSAT,KEMAYORAN,SERDANG,29668,6065,23603,19412,43015,2021-11-03
3174021001,JAKARTA SELATAN,SETIA BUDI,SETIA BUDI,3023,630,2393,1992,4385,2021-11-03
3175101005,JAKARTA TIMUR,CIPAYUNG,SETU,20572,4198,16374,13001,29375,2021-11-03
3173071002,JAKARTA BARAT,PALMERAH,SLIPI,16591,3074,13517,11189,24706,2021-11-03
3173081004,JAKARTA BARAT,KEMBANGAN,SRENGSENG,45523,10494,35029,29318,64347,2021-11-03
3174091002,JAKARTA SELATAN,JAGAKARSA,SRENGSENG SAWAH,58196,9275,48921,40824,89745,2021-11-03
3173051003,JAKARTA BARAT,KEBON JERUK,SUKABUMI SELATAN,37033,8503,28530,21804,50334,2021-11-03
3173051002,JAKARTA BARAT,KEBON JERUK,SUKABUMI UTARA,38290,9180,29110,22476,51586,2021-11-03
3172041002,JAKARTA UTARA,CILINCING,SUKAPURA,53949,12479,41470,33585,75055,2021-11-03
3171031007,JAKARTA PUSAT,KEMAYORAN,SUMUR BATU,22717,4718,17999,15151,33150,2021-11-03
3172021004,JAKARTA UTARA,TANJUNG PRIOK,SUNGAI BAMBU,29876,6162,23714,19294,43008,2021-11-03
3172021006,JAKARTA UTARA,TANJUNG PRIOK,SUNTER AGUNG,71805,12786,59019,50808,109827,2021-11-03
3172021002,JAKARTA UTARA,TANJUNG PRIOK,SUNTER JAYA,63031,11413,51618,44010,95628,2021-11-03
3175091004,JAKARTA TIMUR,CIRACAS,SUSUKAN,38257,7400,30857,25304,56161,2021-11-03
3173031001,JAKARTA BARAT,TAMAN SARI,TAMAN SARI,14348,2692,11656,9898,21554,2021-11-03
3173041001,JAKARTA BARAT,TAMBORA,TAMBORA,10204,2314,7890,6272,14162,2021-11-03
3173041004,JAKARTA BARAT,TAMBORA,TANAH SEREAL,26387,4591,21796,18118,39914,2021-11-03
3171081004,JAKARTA PUSAT,JOHAR BARU,TANAH TINGGI,37693,7316,30377,24356,54733,2021-11-03
3173031004,JAKARTA BARAT,TAMAN SARI,TANGKI,13324,2240,11084,9212,20296,2021-11-03
3174091005,JAKARTA SELATAN,JAGAKARSA,TANJUNG BARAT,39770,6952,32818,26390,59208,2021-11-03
3173021005,JAKARTA BARAT,GROGOL PETAMBURAN,TANJUNG DUREN SELATAN,25337,4942,20395,17699,38094,2021-11-03
3173021002,JAKARTA BARAT,GROGOL PETAMBURAN,TANJUNG DUREN UTARA,17010,2947,14063,12442,26505,2021-11-03
3172021001,JAKARTA UTARA,TANJUNG PRIOK,TANJUNG PRIOK,34588,7295,27293,21978,49271,2021-11-03
3174011002,JAKARTA SELATAN,TEBET,TEBET BARAT,21194,3554,17640,15308,32948,2021-11-03
3174011001,JAKARTA SELATAN,TEBET,TEBET TIMUR,18199,2995,15204,13507,28711,2021-11-03
3173061003,JAKARTA BARAT,KALI DERES,TEGAL ALUR,83647,18061,65586,53508,119094,2021-11-03
3174031004,JAKARTA SELATAN,MAMPANG PRAPATAN,TEGAL PARANG,32401,7420,24981,19000,43981,2021-11-03
3173021003,JAKARTA BARAT,GROGOL PETAMBURAN,TOMANG,29605,5595,24010,20276,44286,2021-11-03
3172031005,JAKARTA UTARA,KOJA,TUGU SELATAN,39122,8953,30169,24034,54203,2021-11-03
3172031002,JAKARTA UTARA,KOJA,TUGU UTARA,67670,16384,51286,39950,91236,2021-11-03
3175061006,JAKARTA TIMUR,CAKUNG,UJUNG MENTENG,29934,5323,24611,20626,45237,2021-11-03
3174101005,JAKARTA SELATAN,PESANGGRAHAN,ULUJAMI,40544,9438,31106,25213,56319,2021-11-03
3175011006,JAKARTA TIMUR,MATRAMAN,UTAN KAYU SELATAN,33511,6221,27290,22210,49500,2021-11-03
3175011002,JAKARTA TIMUR,MATRAMAN,UTAN KAYU UTARA,28169,6036,22133,17855,39988,2021-11-03
3171031008,JAKARTA PUSAT,KEMAYORAN,UTAN PANJANG,29208,6110,23098,18443,41541,2021-11-03
3172021007,JAKARTA UTARA,TANJUNG PRIOK,WARAKAS,44401,8331,36070,28618,64688,2021-11-03
3173021007,JAKARTA BARAT,GROGOL PETAMBURAN,WIJAYA KUSUMA,38934,8355,30579,25292,55871,2021-11-03
3172051003,JAKARTA UTARA,PADEMANGAN,ANCOL,23947,5914,18033,14673,32706,2021-11-04
3173041007,JAKARTA BARAT,TAMBORA,ANGKE,29381,6486,22895,18362,41257,2021-11-04
3175041005,JAKARTA TIMUR,KRAMAT JATI,BALE KAMBANG,29074,7477,21597,16673,38270,2021-11-04
3175031003,JAKARTA TIMUR,JATINEGARA,BALI MESTER,9752,2092,7660,6389,14049,2021-11-04
3175101006,JAKARTA TIMUR,CIPAYUNG,BAMBU APUS,26285,4946,21339,17516,38855,2021-11-04
3174031002,JAKARTA SELATAN,MAMPANG PRAPATAN,BANGKA,21566,4667,16899,13787,30686,2021-11-04
3175051002,JAKARTA TIMUR,PASAR REBO,BARU,23886,4030,19856,16861,36717,2021-11-04
3175041004,JAKARTA TIMUR,KRAMAT JATI,BATU AMPAR,47898,11956,35942,28377,64319,2021-11-04
3171071002,JAKARTA PUSAT,TANAH ABANG,BENDUNGAN HILIR,21494,4441,17053,14336,31389,2021-11-04
3175031002,JAKARTA TIMUR,JATINEGARA,BIDARA CINA,36689,8998,27691,21791,49482,2021-11-04
3174101002,JAKARTA SELATAN,PESANGGRAHAN,BINTARO,53098,10884,42214,35788,78002,2021-11-04
3174011005,JAKARTA SELATAN,TEBET,BUKIT DURI,34183,7083,27100,22165,49265,2021-11-04
3171041006,JAKARTA PUSAT,SENEN,BUNGUR,18144,3897,14247,11688,25935,2021-11-04
3175061007,JAKARTA TIMUR,CAKUNG,CAKUNG BARAT,57724,12114,45610,37241,82851,2021-11-04
3175061004,JAKARTA TIMUR,CAKUNG,CAKUNG TIMUR,58287,11754,46533,38169,84702,2021-11-04
3175041007,JAKARTA TIMUR,KRAMAT JATI,CAWANG,32762,7327,25435,20043,45478,2021-11-04
3175101008,JAKARTA TIMUR,CIPAYUNG,CEGER,18932,3795,15137,12486,27623,2021-11-04
3171031006,JAKARTA PUSAT,KEMAYORAN,CEMPAKA BARU,32581,6498,26083,20186,46269,2021-11-04
3171051002,JAKARTA PUSAT,CEMPAKA PUTIH,CEMPAKA PUTIH BARAT,35885,7801,28084,23571,51655,2021-11-04
3171051001,JAKARTA PUSAT,CEMPAKA PUTIH,CEMPAKA PUTIH TIMUR,24292,5101,19191,16475,35666,2021-11-04
3173011001,JAKARTA BARAT,CENGKARENG,CENGKARENG BARAT,66284,13585,52699,43920,96619,2021-11-04
3173011006,JAKARTA BARAT,CENGKARENG,CENGKARENG TIMUR,81027,16351,64676,52641,117317,2021-11-04
3175091002,JAKARTA TIMUR,CIRACAS,CIBUBUR,66364,11650,54714,45047,99761,2021-11-04
3171011002,JAKARTA PUSAT,GAMBIR,CIDENG,15390,3054,12336,10621,22957,2021-11-04
3174091003,JAKARTA SELATAN,JAGAKARSA,CIGANJUR,38497,6772,31725,25642,57367,2021-11-04
3175051003,JAKARTA TIMUR,PASAR REBO,CIJANTUNG,41419,7886,33533,27549,61082,2021-11-04
3171061003,JAKARTA PUSAT,MENTENG,CIKINI,8274,1514,6760,5254,12014,2021-11-04
3174081006,JAKARTA SELATAN,PANCORAN,CIKOKO,10547,1866,8681,7431,16112,2021-11-04
3174061001,JAKARTA SELATAN,CILANDAK,CILANDAK BARAT,51752,9399,42353,36215,78568,2021-11-04
3174041003,JAKARTA SELATAN,PASAR MINGGU,CILANDAK TIMUR,25145,4718,20427,17132,37559,2021-11-04
3175101002,JAKARTA TIMUR,CIPAYUNG,CILANGKAP,27635,5003,22632,18865,41497,2021-11-04
3175041006,JAKARTA TIMUR,KRAMAT JATI,CILILITAN,40181,9125,31056,24878,55934,2021-11-04
3172041001,JAKARTA UTARA,CILINCING,CILINCING,43609,10658,32951,25199,58150,2021-11-04
3175101001,JAKARTA TIMUR,CIPAYUNG,CIPAYUNG,26104,4655,21449,18175,39624,2021-11-04
3174091006,JAKARTA SELATAN,JAGAKARSA,CIPEDAK,38303,6493,31810,26311,58121,2021-11-04
3174061005,JAKARTA SELATAN,CILANDAK,CIPETE SELATAN,26704,5254,21450,18440,39890,2021-11-04
3174071010,JAKARTA SELATAN,KEBAYORAN BARU,CIPETE UTARA,34102,6648,27454,22250,49704,2021-11-04
3175021003,JAKARTA TIMUR,PULO GADUNG,CIPINANG,39306,7466,31840,26060,57900,2021-11-04
3175031007,JAKARTA TIMUR,JATINEGARA,CIPINANG BESAR SELATAN,35212,8524,26688,20536,47224,2021-11-04
3175031008,JAKARTA TIMUR,JATINEGARA,CIPINANG BESAR UTARA,45319,10926,34393,26321,60714,2021-11-04
3175031005,JAKARTA TIMUR,JATINEGARA,CIPINANG CEMPEDAK,32824,7282,25542,21134,46676,2021-11-04
3175081005,JAKARTA TIMUR,MAKASAR,CIPINANG MELAYU,42308,8345,33963,28407,62370,2021-11-04
3175031006,JAKARTA TIMUR,JATINEGARA,CIPINANG MUARA,55243,12083,43160,34497,77657,2021-11-04
3174051003,JAKARTA SELATAN,KEBAYORAN LAMA,CIPULIR,39937,8602,31335,24976,56311,2021-11-04
3175091001,JAKARTA TIMUR,CIRACAS,CIRACAS,64594,12109,52485,42634,95119,2021-11-04
3175041003,JAKARTA TIMUR,KRAMAT JATI,DUKUH,24609,4763,19846,16144,35990,2021-11-04
3175071001,JAKARTA TIMUR,DUREN SAWIT,DUREN SAWIT,61160,13193,47967,38739,86706,2021-11-04
3174081004,JAKARTA SELATAN,PANCORAN,DUREN TIGA,28319,5780,22539,18595,41134,2021-11-04
3173051005,JAKARTA BARAT,KEBON JERUK,DURI KEPA,60138,11983,48155,41106,89261,2021-11-04
3173011002,JAKARTA BARAT,CENGKARENG,DURI KOSAMBI,77923,17080,60843,48048,108891,2021-11-04
3171011006,JAKARTA PUSAT,GAMBIR,DURI PULO,19610,4253,15357,12203,27560,2021-11-04
3173041011,JAKARTA BARAT,TAMBORA,DURI SELATAN,14259,2593,11666,9738,21404,2021-11-04
3173041003,JAKARTA BARAT,TAMBORA,DURI UTARA,19844,3688,16156,13160,29316,2021-11-04
3171081003,JAKARTA PUSAT,JOHAR BARU,GALUR,18243,3664,14579,11635,26214,2021-11-04
3171011001,JAKARTA PUSAT,GAMBIR,GAMBIR,2191,460,1731,1485,3216,2021-11-04
3174061004,JAKARTA SELATAN,CILANDAK,GANDARIA SELATAN,22119,4341,17778,14849,32627,2021-11-04
3174071009,JAKARTA SELATAN,KEBAYORAN BARU,GANDARIA UTARA,39922,8146,31776,26177,57953,2021-11-04
3175051001,JAKARTA TIMUR,PASAR REBO,GEDONG,35755,7329,28426,23693,52119,2021-11-04
3171071001,JAKARTA PUSAT,TANAH ABANG,GELORA,3127,623,2504,2124,4628,2021-11-04
3173031007,JAKARTA BARAT,TAMAN SARI,GLODOK,7837,1219,6618,5853,12471,2021-11-04
3171061004,JAKARTA PUSAT,MENTENG,GONDANGDIA,4100,935,3165,2863,6028,2021-11-04
3173021001,JAKARTA BARAT,GROGOL PETAMBURAN,GROGOL,16876,3452,13424,11184,24608,2021-11-04
3174051005,JAKARTA SELATAN,KEBAYORAN LAMA,GROGOL SELATAN,44251,9048,35203,28539,63742,2021-11-04
3174051004,JAKARTA SELATAN,KEBAYORAN LAMA,GROGOL UTARA,42494,8836,33658,27502,61160,2021-11-04
3174021007,JAKARTA SELATAN,SETIA BUDI,GUNTUR,3985,760,3225,2794,6019,2021-11-04
3174071002,JAKARTA SELATAN,KEBAYORAN BARU,GUNUNG,9436,1787,7649,6675,14324,2021-11-04
3171031005,JAKARTA PUSAT,KEMAYORAN,GUNUNG SAHARI SELATAN,19199,3965,15234,12651,27885,2021-11-04
3171021004,JAKARTA PUSAT,SAWAH BESAR,GUNUNG SAHARI UTARA,16650,2996,13654,12019,25673,2021-11-04
3175081004,JAKARTA TIMUR,MAKASAR,HALIM PERDANA KUSUMAH,28363,3764,24599,22260,46859,2021-11-04
3171031003,JAKARTA PUSAT,KEMAYORAN,HARAPAN MULIA,22557,4672,17885,14304,32189,2021-11-04
3174091001,JAKARTA SELATAN,JAGAKARSA,JAGAKARSA,62389,10555,51834,42216,94050,2021-11-04
3175021007,JAKARTA TIMUR,PULO GADUNG,JATI,32757,6243,26514,22543,49057,2021-11-04
3174041002,JAKARTA SELATAN,PASAR MINGGU,JATI PADANG,37502,7667,29835,24771,54606,2021-11-04
3173071004,JAKARTA BARAT,PALMERAH,JATI PULO,28738,5875,22863,18041,40904,2021-11-04
3175061001,JAKARTA TIMUR,CAKUNG,JATINEGARA,84160,18458,65702,53272,118974,2021-11-04
3175021004,JAKARTA TIMUR,PULO GADUNG,JATINEGARA KAUM,24632,4513,20119,16077,36196,2021-11-04
3173021004,JAKARTA BARAT,GROGOL PETAMBURAN,JELAMBAR,30266,5636,24630,21118,45748,2021-11-04
3173021006,JAKARTA BARAT,GROGOL PETAMBURAN,JELAMBAR BARU,38246,7292,30954,26485,57439,2021-11-04
3173041006,JAKARTA BARAT,TAMBORA,JEMBATAN BESI,29314,7264,22050,16943,38993,2021-11-04
3173041008,JAKARTA BARAT,TAMBORA,JEMBATAN LIMA,21021,5048,15973,12477,28450,2021-11-04
3173081005,JAKARTA BARAT,KEMBANGAN,JOGLO,40839,8528,32311,27125,59436,2021-11-04
3171081001,JAKARTA PUSAT,JOHAR BARU,JOHAR BARU,37488,7073,30415,25412,55827,2021-11-04
3173041002,JAKARTA BARAT,TAMBORA,KALI ANYAR,23856,4839,19017,14965,33982,2021-11-04
3172041004,JAKARTA UTARA,CILINCING,KALIBARU,67684,18975,48709,34294,83003,2021-11-04
3174081002,JAKARTA SELATAN,PANCORAN,KALIBATA,41994,9792,32202,25668,57870,2021-11-04
3173061001,JAKARTA BARAT,KALI DERES,KALIDERES,72447,15154,57293,47778,105071,2021-11-04
3175051004,JAKARTA TIMUR,PASAR REBO,KALISARI,43212,7918,35294,29207,64501,2021-11-04
3173061004,JAKARTA BARAT,KALI DERES,KAMAL,53783,12817,40966,32006,72972,2021-11-04
3172011002,JAKARTA UTARA,PENJARINGAN,KAMAL MUARA,12930,2317,10613,8985,19598,2021-11-04
3171071007,JAKARTA PUSAT,TANAH ABANG,KAMPUNG BALI,11358,2503,8855,6679,15534,2021-11-04
3175031001,JAKARTA TIMUR,JATINEGARA,KAMPUNG MELAYU,25717,5956,19761,15212,34973,2021-11-04
3171081002,JAKARTA PUSAT,JOHAR BARU,KAMPUNG RAWA,21237,3585,17652,13986,31638,2021-11-04
3175041002,JAKARTA TIMUR,KRAMAT JATI,KAMPUNG TENGAH,43993,11302,32691,25699,58390,2021-11-04
3173011005,JAKARTA BARAT,CENGKARENG,KAPUK,134466,33254,101212,80504,181716,2021-11-04
3172011003,JAKARTA UTARA,PENJARINGAN,KAPUK MUARA,35781,6996,28785,24925,53710,2021-11-04
3171021002,JAKARTA PUSAT,SAWAH BESAR,KARANG ANYAR,25761,5080,20681,17234,37915,2021-11-04
3174021004,JAKARTA SELATAN,SETIA BUDI,KARET,9623,1882,7741,6367,14108,2021-11-04
3174021003,JAKARTA SELATAN,SETIA BUDI,KARET KUNINGAN,16055,3189,12866,10710,23576,2021-11-04
3174021002,JAKARTA SELATAN,SETIA BUDI,KARET SEMANGGI,2770,558,2212,1945,4157,2021-11-04
3171071003,JAKARTA PUSAT,TANAH ABANG,KARET TENGSIN,19271,3787,15484,12403,27887,2021-11-04
3171021003,JAKARTA PUSAT,SAWAH BESAR,KARTINI,22292,4347,17945,15214,33159,2021-11-04
3175011003,JAKARTA TIMUR,MATRAMAN,KAYU MANIS,25284,5457,19827,15517,35344,2021-11-04
3175021006,JAKARTA TIMUR,PULO GADUNG,KAYU PUTIH,40696,7839,32857,28356,61213,2021-11-04
3173031006,JAKARTA BARAT,TAMAN SARI,KEAGUNGAN,17387,3301,14086,11366,25452,2021-11-04
3174041007,JAKARTA SELATAN,PASAR MINGGU,KEBAGUSAN,44552,9039,35513,28885,64398,2021-11-04
3174051006,JAKARTA SELATAN,KEBAYORAN LAMA,KEBAYORAN LAMA SELATAN,41212,7876,33336,27619,60955,2021-11-04
3174051001,JAKARTA SELATAN,KEBAYORAN LAMA,KEBAYORAN LAMA UTARA,42422,9061,33361,26974,60335,2021-11-04
3174011004,JAKARTA SELATAN,TEBET,KEBON BARU,35165,6803,28362,23411,51773,2021-11-04
3172021005,JAKARTA UTARA,TANJUNG PRIOK,KEBON BAWANG,50952,10538,40414,33141,73555,2021-11-04
3173051001,JAKARTA BARAT,KEBON JERUK,KEBON JERUK,53887,11850,42037,34035,76072,2021-11-04
3171071006,JAKARTA PUSAT,TANAH ABANG,KEBON KACANG,21531,5235,16296,12688,28984,2021-11-04
3171011005,JAKARTA PUSAT,GAMBIR,KEBON KELAPA,10163,2082,8081,6710,14791,2021-11-04
3171031002,JAKARTA PUSAT,KEMAYORAN,KEBON KOSONG,30019,6129,23890,19228,43118,2021-11-04
3175011005,JAKARTA TIMUR,MATRAMAN,KEBON MANGGIS,16490,3296,13194,10776,23970,2021-11-04
3171071005,JAKARTA PUSAT,TANAH ABANG,KEBON MELATI,32206,8748,23458,17121,40579,2021-11-04
3175081003,JAKARTA TIMUR,MAKASAR,KEBON PALA,46614,9425,37189,30521,67710,2021-11-04
3171061005,JAKARTA PUSAT,MENTENG,KEBON SIRIH,12299,2703,9596,7608,17204,2021-11-04
3173011004,JAKARTA BARAT,CENGKARENG,KEDAUNG KALI ANGKE,32612,6471,26141,21625,47766,2021-11-04
3173051007,JAKARTA BARAT,KEBON JERUK,KEDOYA SELATAN,32165,5977,26188,21422,47610,2021-11-04
3173051006,JAKARTA BARAT,KEBON JERUK,KEDOYA UTARA,45740,8854,36886,30878,67764,2021-11-04
3173051004,JAKARTA BARAT,KEBON JERUK,KELAPA DUA,23565,4854,18711,15491,34202,2021-11-04
3175091003,JAKARTA TIMUR,CIRACAS,KELAPA DUA WETAN,46875,8215,38660,32006,70666,2021-11-04
3172061003,JAKARTA UTARA,KELAPA GADING,KELAPA GADING BARAT,35717,6332,29385,26254,55639,2021-11-04
3172061001,JAKARTA UTARA,KELAPA GADING,KELAPA GADING TIMUR,33592,5231,28361,25974,54335,2021-11-04
3173071005,JAKARTA BARAT,PALMERAH,KEMANGGISAN,32139,6226,25913,21396,47309,2021-11-04
3171031001,JAKARTA PUSAT,KEMAYORAN,KEMAYORAN,20708,4396,16312,13335,29647,2021-11-04
3173081006,JAKARTA BARAT,KEMBANGAN,KEMBANGAN SELATAN,27130,5792,21338,18218,39556,2021-11-04
3173081001,JAKARTA BARAT,KEMBANGAN,KEMBANGAN UTARA,54451,12216,42235,34811,77046,2021-11-04
3171041002,JAKARTA PUSAT,SENEN,KENARI,9579,1902,7677,6467,14144,2021-11-04
3173041005,JAKARTA BARAT,TAMBORA,KERENDANG,19973,4209,15764,12667,28431,2021-11-04
3175071003,JAKARTA TIMUR,DUREN SAWIT,KLENDER,69978,16752,53226,41650,94876,2021-11-04
3172031001,JAKARTA UTARA,KOJA,KOJA,28175,6554,21621,17274,38895,2021-11-04
3173071006,JAKARTA BARAT,PALMERAH,KOTA BAMBU SELATAN,21158,4338,16820,13000,29820,2021-11-04
3173071003,JAKARTA BARAT,PALMERAH,KOTA BAMBU UTARA,24995,5291,19704,15143,34847,2021-11-04
3171041004,JAKARTA PUSAT,SENEN,KRAMAT,28835,7052,21783,16376,38159,2021-11-04
3175041001,JAKARTA TIMUR,KRAMAT JATI,KRAMAT JATI,34144,7668,26476,21212,47688,2021-11-04
3174071003,JAKARTA SELATAN,KEBAYORAN BARU,KRAMAT PELA,14413,2849,11564,9683,21247,2021-11-04
3173031002,JAKARTA BARAT,TAMAN SARI,KRUKUT,19244,3695,15549,12440,27989,2021-11-04
3174031005,JAKARTA SELATAN,MAMPANG PRAPATAN,KUNINGAN BARAT,12785,2413,10372,8541,18913,2021-11-04
3174021008,JAKARTA SELATAN,SETIA BUDI,KUNINGAN TIMUR,6008,1218,4790,3991,8781,2021-11-04
3171041005,JAKARTA PUSAT,SENEN,KWITANG,15486,3558,11928,9544,21472,2021-11-04
3172031003,JAKARTA UTARA,KOJA,LAGOA,59065,14277,44788,34922,79710,2021-11-04
3174061002,JAKARTA SELATAN,CILANDAK,LEBAK BULUS,37626,7263,30363,25898,56261,2021-11-04
3174091004,JAKARTA SELATAN,JAGAKARSA,LENTENG AGUNG,53946,9953,43993,35089,79082,2021-11-04
3175101007,JAKARTA TIMUR,CIPAYUNG,LUBANG BUAYA,63547,12189,51358,41880,93238,2021-11-04
3175081001,JAKARTA TIMUR,MAKASAR,MAKASAR,34390,6465,27925,23197,51122,2021-11-04
3175071006,JAKARTA TIMUR,DUREN SAWIT,MALAKA JAYA,30927,5454,25473,21497,46970,2021-11-04
3175071005,JAKARTA TIMUR,DUREN SAWIT,MALAKA SARI,27530,4699,22831,19403,42234,2021-11-04
3174031001,JAKARTA SELATAN,MAMPANG PRAPATAN,MAMPANG PRAPATAN,18159,3791,14368,11682,26050,2021-11-04
3173031005,JAKARTA BARAT,TAMAN SARI,MANGGA BESAR,7707,1321,6386,5511,11897,2021-11-04
3171021005,JAKARTA PUSAT,SAWAH BESAR,MANGGA DUA SELATAN,27442,5835,21607,18101,39708,2021-11-04
3174011007,JAKARTA SELATAN,TEBET,MANGGARAI,28373,5173,23200,18568,41768,2021-11-04
3174011006,JAKARTA SELATAN,TEBET,MANGGARAI SELATAN,23075,4154,18921,15741,34662,2021-11-04
3173031003,JAKARTA BARAT,TAMAN SARI,MAPHAR,16461,3135,13326,10984,24310,2021-11-04
3172041003,JAKARTA UTARA,CILINCING,MARUNDA,28943,6700,22243,16450,38693,2021-11-04
3174071001,JAKARTA SELATAN,KEBAYORAN BARU,MELAWAI,2627,519,2108,1928,4036,2021-11-04
3171061001,JAKARTA PUSAT,MENTENG,MENTENG,25624,5800,19824,15420,35244,2021-11-04
3174021005,JAKARTA SELATAN,SETIA BUDI,MENTENG ATAS,27816,5154,22662,18528,41190,2021-11-04
3174011003,JAKARTA SELATAN,TEBET,MENTENG DALAM,36028,7166,28862,23955,52817,2021-11-04
3173081003,JAKARTA BARAT,KEMBANGAN,MERUYA SELATAN,32130,6760,25370,21082,46452,2021-11-04
3173081002,JAKARTA BARAT,KEMBANGAN,MERUYA UTARA,43752,9164,34588,29699,64287,2021-11-04
3175101004,JAKARTA TIMUR,CIPAYUNG,MUNJUL,23871,4420,19451,16259,35710,2021-11-04
3172051002,JAKARTA UTARA,PADEMANGAN,PADEMANGAN BARAT,74240,18007,56233,44826,101059,2021-11-04
3172051001,JAKARTA UTARA,PADEMANGAN,PADEMANGAN TIMUR,37736,6823,30913,26672,57585,2021-11-04
3175011004,JAKARTA TIMUR,MATRAMAN,PAL MERIAM,19769,4231,15538,12346,27884,2021-11-04
3173071001,JAKARTA BARAT,PALMERAH,PALMERAH,63011,13648,49363,39606,88969,2021-11-04
3174081001,JAKARTA SELATAN,PANCORAN,PANCORAN,19421,4116,15305,12496,27801,2021-11-04
3172021003,JAKARTA UTARA,TANJUNG PRIOK,PAPANGGO,39097,7837,31260,25302,56562,2021-11-04
3171021001,JAKARTA PUSAT,SAWAH BESAR,PASAR BARU,12035,2339,9696,8570,18266,2021-11-04
3174021006,JAKARTA SELATAN,SETIA BUDI,PASAR MANGGIS,26752,5441,21311,17358,38669,2021-11-04
3174041001,JAKARTA SELATAN,PASAR MINGGU,PASAR MINGGU,24821,4765,20056,16895,36951,2021-11-04
3171041003,JAKARTA PUSAT,SENEN,PASEBAN,23533,5032,18501,15044,33545,2021-11-04
3173061005,JAKARTA BARAT,KALI DERES,PEGADUNGAN,75587,15553,60034,51092,111126,2021-11-04
3171061002,JAKARTA PUSAT,MENTENG,PEGANGSAAN,23455,5136,18319,13814,32133,2021-11-04
3172061002,JAKARTA UTARA,KELAPA GADING,PEGANGSAAN DUA,49976,8399,41577,37295,78872,2021-11-04
3172011004,JAKARTA UTARA,PENJARINGAN,PEJAGALAN,74578,15816,58762,49879,108641,2021-11-04
3174041006,JAKARTA SELATAN,PASAR MINGGU,PEJATEN BARAT,37346,7519,29827,24634,54461,2021-11-04
3174041005,JAKARTA SELATAN,PASAR MINGGU,PEJATEN TIMUR,57656,13386,44270,36098,80368,2021-11-04
3175051005,JAKARTA TIMUR,PASAR REBO,PEKAYON,43250,8013,35237,28916,64153,2021-11-04
3173041009,JAKARTA BARAT,TAMBORA,PEKOJAN,23587,4589,18998,15701,34699,2021-11-04
3174031003,JAKARTA SELATAN,MAMPANG PRAPATAN,PELA MAMPANG,43522,8792,34730,28679,63409,2021-11-04
3174081005,JAKARTA SELATAN,PANCORAN,PENGADEGAN,21478,4023,17455,14672,32127,2021-11-04
3175061003,JAKARTA TIMUR,CAKUNG,PENGGILINGAN,99255,23613,75642,59797,135439,2021-11-04
3172011001,JAKARTA UTARA,PENJARINGAN,PENJARINGAN,88308,23039,65269,49605,114874,2021-11-04
3174101001,JAKARTA SELATAN,PESANGGRAHAN,PESANGGRAHAN,27545,4839,22706,19212,41918,2021-11-04
3171071004,JAKARTA PUSAT,TANAH ABANG,PETAMBURAN,33271,8947,24324,18195,42519,2021-11-04
3174071008,JAKARTA SELATAN,KEBAYORAN BARU,PETOGOGAN,11499,2296,9203,7753,16956,2021-11-04
3171011004,JAKARTA PUSAT,GAMBIR,PETOJO SELATAN,14692,3369,11323,9520,20843,2021-11-04
3171011003,JAKARTA PUSAT,GAMBIR,PETOJO UTARA,17458,3827,13631,11104,24735,2021-11-04
3174101004,JAKARTA SELATAN,PESANGGRAHAN,PETUKANGAN SELATAN,37187,7830,29357,24343,53700,2021-11-04
3174101003,JAKARTA SELATAN,PESANGGRAHAN,PETUKANGAN UTARA,53716,11836,41880,34325,76205,2021-11-04
3175081002,JAKARTA TIMUR,MAKASAR,PINANG RANTI,27198,6030,21168,17261,38429,2021-11-04
3173031008,JAKARTA BARAT,TAMAN SARI,PINANGSIA,10729,1912,8817,7218,16035,2021-11-04
3175011001,JAKARTA TIMUR,MATRAMAN,PISANGAN BARU,31776,6683,25093,19657,44750,2021-11-04
3175021002,JAKARTA TIMUR,PULO GADUNG,PISANGAN TIMUR,41011,7743,33268,27793,61061,2021-11-04
3172011005,JAKARTA UTARA,PENJARINGAN,PLUIT,47783,9316,38467,33293,71760,2021-11-04
3175071002,JAKARTA TIMUR,DUREN SAWIT,PONDOK BAMBU,61550,13305,48245,38962,87207,2021-11-04
3175071004,JAKARTA TIMUR,DUREN SAWIT,PONDOK KELAPA,72015,14541,57474,48652,106126,2021-11-04
3175071007,JAKARTA TIMUR,DUREN SAWIT,PONDOK KOPI,35367,6751,28616,22215,50831,2021-11-04
3174061003,JAKARTA SELATAN,CILANDAK,PONDOK LABU,46464,8147,38317,32949,71266,2021-11-04
3174051002,JAKARTA SELATAN,KEBAYORAN LAMA,PONDOK PINANG,56169,11001,45168,38055,83223,2021-11-04
3175101003,JAKARTA TIMUR,CIPAYUNG,PONDOK RANGGON,25574,4891,20683,17065,37748,2021-11-04
3101011003,KAB.ADM.KEP.SERIBU,KEP. SERIBU UTARA,PULAU HARAPAN,2060,223,1837,1600,3437,2021-11-04
3101011002,KAB.ADM.KEP.SERIBU,KEP. SERIBU UTARA,PULAU KELAPA,5528,611,4917,4044,8961,2021-11-04
3101011001,KAB.ADM.KEP.SERIBU,KEP. SERIBU UTARA,PULAU PANGGANG,5450,444,5006,4459,9465,2021-11-04
3101021003,KAB.ADM.KEP.SERIBU,KEP. SERIBU SELATAN,PULAU PARI,2765,199,2566,2397,4963,2021-11-04
3101021002,KAB.ADM.KEP.SERIBU,KEP. SERIBU SELATAN,PULAU TIDUNG,4553,371,4182,3812,7994,2021-11-04
3101021001,KAB.ADM.KEP.SERIBU,KEP. SERIBU SELATAN,PULAU UNTUNG JAWA,1941,163,1778,1632,3410,2021-11-04
3174071007,JAKARTA SELATAN,KEBAYORAN BARU,PULO,5835,1031,4804,4341,9145,2021-11-04
3175021001,JAKARTA TIMUR,PULO GADUNG,PULO GADUNG,34422,7685,26737,22047,48784,2021-11-04
3175061005,JAKARTA TIMUR,CAKUNG,PULO GEBANG,97301,19153,78148,62782,140930,2021-11-04
3174041004,JAKARTA SELATAN,PASAR MINGGU,RAGUNAN,39616,7518,32098,27024,59122,2021-11-04
3175091005,JAKARTA TIMUR,CIRACAS,RAMBUTAN,36771,8785,27986,22065,50051,2021-11-04
3172031006,JAKARTA UTARA,KOJA,RAWA BADAK SELATAN,42179,10197,31982,24958,56940,2021-11-04
3172031004,JAKARTA UTARA,KOJA,RAWA BADAK UTARA,34408,7863,26545,21004,47549,2021-11-04
3174071005,JAKARTA SELATAN,KEBAYORAN BARU,RAWA BARAT,5625,1018,4607,4042,8649,2021-11-04
3173011003,JAKARTA BARAT,CENGKARENG,RAWA BUAYA,63799,13082,50717,40471,91188,2021-11-04
3175031004,JAKARTA TIMUR,JATINEGARA,RAWA BUNGA,21434,5278,16156,12858,29014,2021-11-04
3174081003,JAKARTA SELATAN,PANCORAN,RAWA JATI,20509,3969,16540,13921,30461,2021-11-04
3175061002,JAKARTA TIMUR,CAKUNG,RAWA TERATE,24637,4567,20070,16204,36274,2021-11-04
3175021005,JAKARTA TIMUR,PULO GADUNG,RAWAMANGUN,37612,7607,30005,25068,55073,2021-11-04
3171051003,JAKARTA PUSAT,CEMPAKA PUTIH,RAWASARI,21967,4565,17402,14596,31998,2021-11-04
3173041010,JAKARTA BARAT,TAMBORA,ROA MALAKA,3484,624,2860,2506,5366,2021-11-04
3172041006,JAKARTA UTARA,CILINCING,ROROTAN,41668,8536,33132,26184,59316,2021-11-04
3174071004,JAKARTA SELATAN,KEBAYORAN BARU,SELONG,2842,551,2291,2100,4391,2021-11-04
3173061002,JAKARTA BARAT,KALI DERES,SEMANAN,71354,15783,55571,44351,99922,2021-11-04
3172041007,JAKARTA UTARA,CILINCING,SEMPER BARAT,68587,13689,54898,44915,99813,2021-11-04
3172041005,JAKARTA UTARA,CILINCING,SEMPER TIMUR,36267,7963,28304,22612,50916,2021-11-04
3174071006,JAKARTA SELATAN,KEBAYORAN BARU,SENAYAN,2771,663,2108,1800,3908,2021-11-04
3171041001,JAKARTA PUSAT,SENEN,SENEN,6804,1498,5306,4379,9685,2021-11-04
3171031004,JAKARTA PUSAT,KEMAYORAN,SERDANG,29668,6040,23628,19475,43103,2021-11-04
3174021001,JAKARTA SELATAN,SETIA BUDI,SETIA BUDI,3023,628,2395,1996,4391,2021-11-04
3175101005,JAKARTA TIMUR,CIPAYUNG,SETU,20572,4181,16391,13081,29472,2021-11-04
3173071002,JAKARTA BARAT,PALMERAH,SLIPI,16591,3053,13538,11213,24751,2021-11-04
3173081004,JAKARTA BARAT,KEMBANGAN,SRENGSENG,45523,10449,35074,29430,64504,2021-11-04
3174091002,JAKARTA SELATAN,JAGAKARSA,SRENGSENG SAWAH,58196,9246,48950,40994,89944,2021-11-04
3173051003,JAKARTA BARAT,KEBON JERUK,SUKABUMI SELATAN,37033,8479,28554,21966,50520,2021-11-04
3173051002,JAKARTA BARAT,KEBON JERUK,SUKABUMI UTARA,38290,9138,29152,22577,51729,2021-11-04
3172041002,JAKARTA UTARA,CILINCING,SUKAPURA,53949,12436,41513,33666,75179,2021-11-04
3171031007,JAKARTA PUSAT,KEMAYORAN,SUMUR BATU,22717,4703,18014,15192,33206,2021-11-04
3172021004,JAKARTA UTARA,TANJUNG PRIOK,SUNGAI BAMBU,29876,6139,23737,19362,43099,2021-11-04
3172021006,JAKARTA UTARA,TANJUNG PRIOK,SUNTER AGUNG,71805,12754,59051,50913,109964,2021-11-04
3172021002,JAKARTA UTARA,TANJUNG PRIOK,SUNTER JAYA,63031,11388,51643,44143,95786,2021-11-04
3175091004,JAKARTA TIMUR,CIRACAS,SUSUKAN,38257,7376,30881,25389,56270,2021-11-04
3173031001,JAKARTA BARAT,TAMAN SARI,TAMAN SARI,14348,2679,11669,9923,21592,2021-11-04
3173041001,JAKARTA BARAT,TAMBORA,TAMBORA,10204,2304,7900,6289,14189,2021-11-04
3173041004,JAKARTA BARAT,TAMBORA,TANAH SEREAL,26387,4588,21799,18159,39958,2021-11-04
3171081004,JAKARTA PUSAT,JOHAR BARU,TANAH TINGGI,37693,7300,30393,24416,54809,2021-11-04
3173031004,JAKARTA BARAT,TAMAN SARI,TANGKI,13324,2235,11089,9244,20333,2021-11-04
3174091005,JAKARTA SELATAN,JAGAKARSA,TANJUNG BARAT,39770,6911,32859,26697,59556,2021-11-04
3173021005,JAKARTA BARAT,GROGOL PETAMBURAN,TANJUNG DUREN SELATAN,25337,4929,20408,17751,38159,2021-11-04
3173021002,JAKARTA BARAT,GROGOL PETAMBURAN,TANJUNG DUREN UTARA,17010,2935,14075,12474,26549,2021-11-04
3172021001,JAKARTA UTARA,TANJUNG PRIOK,TANJUNG PRIOK,34588,7278,27310,22025,49335,2021-11-04
3174011002,JAKARTA SELATAN,TEBET,TEBET BARAT,21194,3534,17660,15368,33028,2021-11-04
3174011001,JAKARTA SELATAN,TEBET,TEBET TIMUR,18199,2979,15220,13551,28771,2021-11-04
3173061003,JAKARTA BARAT,KALI DERES,TEGAL ALUR,83647,17880,65767,53746,119513,2021-11-04
3174031004,JAKARTA SELATAN,MAMPANG PRAPATAN,TEGAL PARANG,32401,7277,25124,19357,44481,2021-11-04
3173021003,JAKARTA BARAT,GROGOL PETAMBURAN,TOMANG,29605,5578,24027,20334,44361,2021-11-04
3172031005,JAKARTA UTARA,KOJA,TUGU SELATAN,39122,8926,30196,24099,54295,2021-11-04
3172031002,JAKARTA UTARA,KOJA,TUGU UTARA,67670,16310,51360,40115,91475,2021-11-04
3175061006,JAKARTA TIMUR,CAKUNG,UJUNG MENTENG,29934,5309,24625,20662,45287,2021-11-04
3174101005,JAKARTA SELATAN,PESANGGRAHAN,ULUJAMI,40544,9371,31173,25311,56484,2021-11-04
3175011006,JAKARTA TIMUR,MATRAMAN,UTAN KAYU SELATAN,33511,6190,27321,22286,49607,2021-11-04
3175011002,JAKARTA TIMUR,MATRAMAN,UTAN KAYU UTARA,28169,6004,22165,17922,40087,2021-11-04
3171031008,JAKARTA PUSAT,KEMAYORAN,UTAN PANJANG,29208,6074,23134,18506,41640,2021-11-04
3172021007,JAKARTA UTARA,TANJUNG PRIOK,WARAKAS,44401,8317,36084,28692,64776,2021-11-04
3173021007,JAKARTA BARAT,GROGOL PETAMBURAN,WIJAYA KUSUMA,38934,8333,30601,25403,56004,2021-11-04
3172051003,JAKARTA UTARA,PADEMANGAN,ANCOL,23947,5889,18058,14704,32762,2021-11-05
3173041007,JAKARTA BARAT,TAMBORA,ANGKE,29381,6459,22922,18428,41350,2021-11-05
3175041005,JAKARTA TIMUR,KRAMAT JATI,BALE KAMBANG,29074,7421,21653,16764,38417,2021-11-05
3175031003,JAKARTA TIMUR,JATINEGARA,BALI MESTER,9752,2082,7670,6417,14087,2021-11-05
3175101006,JAKARTA TIMUR,CIPAYUNG,BAMBU APUS,26285,4919,21366,17596,38962,2021-11-05
3174031002,JAKARTA SELATAN,MAMPANG PRAPATAN,BANGKA,21566,4653,16913,13845,30758,2021-11-05
3175051002,JAKARTA TIMUR,PASAR REBO,BARU,23886,4008,19878,16902,36780,2021-11-05
3175041004,JAKARTA TIMUR,KRAMAT JATI,BATU AMPAR,47898,11897,36001,28514,64515,2021-11-05
3171071002,JAKARTA PUSAT,TANAH ABANG,BENDUNGAN HILIR,21494,4409,17085,14396,31481,2021-11-05
3175031002,JAKARTA TIMUR,JATINEGARA,BIDARA CINA,36689,8945,27744,21915,49659,2021-11-05
3174101002,JAKARTA SELATAN,PESANGGRAHAN,BINTARO,53098,10833,42265,35902,78167,2021-11-05
3174011005,JAKARTA SELATAN,TEBET,BUKIT DURI,34183,7056,27127,22318,49445,2021-11-05
3171041006,JAKARTA PUSAT,SENEN,BUNGUR,18144,3867,14277,11725,26002,2021-11-05
3175061007,JAKARTA TIMUR,CAKUNG,CAKUNG BARAT,57724,12063,45661,37346,83007,2021-11-05
3175061004,JAKARTA TIMUR,CAKUNG,CAKUNG TIMUR,58287,11703,46584,38248,84832,2021-11-05
3175041007,JAKARTA TIMUR,KRAMAT JATI,CAWANG,32762,7230,25532,20183,45715,2021-11-05
3175101008,JAKARTA TIMUR,CIPAYUNG,CEGER,18932,3783,15149,12523,27672,2021-11-05
3171031006,JAKARTA PUSAT,KEMAYORAN,CEMPAKA BARU,32581,6358,26223,20277,46500,2021-11-05
3171051002,JAKARTA PUSAT,CEMPAKA PUTIH,CEMPAKA PUTIH BARAT,35885,7774,28111,23685,51796,2021-11-05
3171051001,JAKARTA PUSAT,CEMPAKA PUTIH,CEMPAKA PUTIH TIMUR,24292,5081,19211,16550,35761,2021-11-05
3173011001,JAKARTA BARAT,CENGKARENG,CENGKARENG BARAT,66284,13511,52773,44114,96887,2021-11-05
3173011006,JAKARTA BARAT,CENGKARENG,CENGKARENG TIMUR,81027,16273,64754,52881,117635,2021-11-05
3175091002,JAKARTA TIMUR,CIRACAS,CIBUBUR,66364,11613,54751,45164,99915,2021-11-05
3171011002,JAKARTA PUSAT,GAMBIR,CIDENG,15390,3048,12342,10659,23001,2021-11-05
3174091003,JAKARTA SELATAN,JAGAKARSA,CIGANJUR,38497,6731,31766,25786,57552,2021-11-05
3175051003,JAKARTA TIMUR,PASAR REBO,CIJANTUNG,41419,7838,33581,27641,61222,2021-11-05
3171061003,JAKARTA PUSAT,MENTENG,CIKINI,8274,1510,6764,5271,12035,2021-11-05
3174081006,JAKARTA SELATAN,PANCORAN,CIKOKO,10547,1863,8684,7454,16138,2021-11-05
3174061001,JAKARTA SELATAN,CILANDAK,CILANDAK BARAT,51752,9330,42422,36356,78778,2021-11-05
3174041003,JAKARTA SELATAN,PASAR MINGGU,CILANDAK TIMUR,25145,4697,20448,17192,37640,2021-11-05
3175101002,JAKARTA TIMUR,CIPAYUNG,CILANGKAP,27635,4975,22660,18938,41598,2021-11-05
3175041006,JAKARTA TIMUR,KRAMAT JATI,CILILITAN,40181,9021,31160,25076,56236,2021-11-05
3172041001,JAKARTA UTARA,CILINCING,CILINCING,43609,10624,32985,25287,58272,2021-11-05
3175101001,JAKARTA TIMUR,CIPAYUNG,CIPAYUNG,26104,4633,21471,18218,39689,2021-11-05
3174091006,JAKARTA SELATAN,JAGAKARSA,CIPEDAK,38303,6457,31846,26425,58271,2021-11-05
3174061005,JAKARTA SELATAN,CILANDAK,CIPETE SELATAN,26704,5234,21470,18561,40031,2021-11-05
3174071010,JAKARTA SELATAN,KEBAYORAN BARU,CIPETE UTARA,34102,6625,27477,22369,49846,2021-11-05
3175021003,JAKARTA TIMUR,PULO GADUNG,CIPINANG,39306,7440,31866,26175,58041,2021-11-05
3175031007,JAKARTA TIMUR,JATINEGARA,CIPINANG BESAR SELATAN,35212,8490,26722,20640,47362,2021-11-05
3175031008,JAKARTA TIMUR,JATINEGARA,CIPINANG BESAR UTARA,45319,10866,34453,26437,60890,2021-11-05
3175031005,JAKARTA TIMUR,JATINEGARA,CIPINANG CEMPEDAK,32824,7244,25580,21278,46858,2021-11-05
3175081005,JAKARTA TIMUR,MAKASAR,CIPINANG MELAYU,42308,8301,34007,28519,62526,2021-11-05
3175031006,JAKARTA TIMUR,JATINEGARA,CIPINANG MUARA,55243,12031,43212,34659,77871,2021-11-05
3174051003,JAKARTA SELATAN,KEBAYORAN LAMA,CIPULIR,39937,8572,31365,25079,56444,2021-11-05
3175091001,JAKARTA TIMUR,CIRACAS,CIRACAS,64594,12047,52547,42852,95399,2021-11-05
3175041003,JAKARTA TIMUR,KRAMAT JATI,DUKUH,24609,4740,19869,16222,36091,2021-11-05
3175071001,JAKARTA TIMUR,DUREN SAWIT,DUREN SAWIT,61160,13099,48061,38918,86979,2021-11-05
3174081004,JAKARTA SELATAN,PANCORAN,DUREN TIGA,28319,5751,22568,18685,41253,2021-11-05
3173051005,JAKARTA BARAT,KEBON JERUK,DURI KEPA,60138,11943,48195,41188,89383,2021-11-05
3173011002,JAKARTA BARAT,CENGKARENG,DURI KOSAMBI,77923,17014,60909,48205,109114,2021-11-05
3171011006,JAKARTA PUSAT,GAMBIR,DURI PULO,19610,4228,15382,12255,27637,2021-11-05
3173041011,JAKARTA BARAT,TAMBORA,DURI SELATAN,14259,2584,11675,9760,21435,2021-11-05
3173041003,JAKARTA BARAT,TAMBORA,DURI UTARA,19844,3671,16173,13188,29361,2021-11-05
3171081003,JAKARTA PUSAT,JOHAR BARU,GALUR,18243,3649,14594,11661,26255,2021-11-05
3171011001,JAKARTA PUSAT,GAMBIR,GAMBIR,2191,459,1732,1487,3219,2021-11-05
3174061004,JAKARTA SELATAN,CILANDAK,GANDARIA SELATAN,22119,4322,17797,14915,32712,2021-11-05
3174071009,JAKARTA SELATAN,KEBAYORAN BARU,GANDARIA UTARA,39922,8098,31824,26344,58168,2021-11-05
3175051001,JAKARTA TIMUR,PASAR REBO,GEDONG,35755,7301,28454,23786,52240,2021-11-05
3171071001,JAKARTA PUSAT,TANAH ABANG,GELORA,3127,622,2505,2131,4636,2021-11-05
3173031007,JAKARTA BARAT,TAMAN SARI,GLODOK,7837,1215,6622,5862,12484,2021-11-05
3171061004,JAKARTA PUSAT,MENTENG,GONDANGDIA,4100,934,3166,2869,6035,2021-11-05
3173021001,JAKARTA BARAT,GROGOL PETAMBURAN,GROGOL,16876,3437,13439,11227,24666,2021-11-05
3174051005,JAKARTA SELATAN,KEBAYORAN LAMA,GROGOL SELATAN,44251,8952,35299,28647,63946,2021-11-05
3174051004,JAKARTA SELATAN,KEBAYORAN LAMA,GROGOL UTARA,42494,8797,33697,27597,61294,2021-11-05
3174021007,JAKARTA SELATAN,SETIA BUDI,GUNTUR,3985,757,3228,2803,6031,2021-11-05
3174071002,JAKARTA SELATAN,KEBAYORAN BARU,GUNUNG,9436,1767,7669,6729,14398,2021-11-05
3171031005,JAKARTA PUSAT,KEMAYORAN,GUNUNG SAHARI SELATAN,19199,3951,15248,12699,27947,2021-11-05
3171021004,JAKARTA PUSAT,SAWAH BESAR,GUNUNG SAHARI UTARA,16650,2986,13664,12055,25719,2021-11-05
3175081004,JAKARTA TIMUR,MAKASAR,HALIM PERDANA KUSUMAH,28363,3754,24609,22297,46906,2021-11-05
3171031003,JAKARTA PUSAT,KEMAYORAN,HARAPAN MULIA,22557,4648,17909,14366,32275,2021-11-05
3174091001,JAKARTA SELATAN,JAGAKARSA,JAGAKARSA,62389,10507,51882,42380,94262,2021-11-05
3175021007,JAKARTA TIMUR,PULO GADUNG,JATI,32757,6219,26538,22639,49177,2021-11-05
3174041002,JAKARTA SELATAN,PASAR MINGGU,JATI PADANG,37502,7626,29876,24845,54721,2021-11-05
3173071004,JAKARTA BARAT,PALMERAH,JATI PULO,28738,5835,22903,18120,41023,2021-11-05
3175061001,JAKARTA TIMUR,CAKUNG,JATINEGARA,84160,18361,65799,53474,119273,2021-11-05
3175021004,JAKARTA TIMUR,PULO GADUNG,JATINEGARA KAUM,24632,4499,20133,16173,36306,2021-11-05
3173021004,JAKARTA BARAT,GROGOL PETAMBURAN,JELAMBAR,30266,5622,24644,21193,45837,2021-11-05
3173021006,JAKARTA BARAT,GROGOL PETAMBURAN,JELAMBAR BARU,38246,7246,31000,26598,57598,2021-11-05
3173041006,JAKARTA BARAT,TAMBORA,JEMBATAN BESI,29314,7226,22088,17006,39094,2021-11-05
3173041008,JAKARTA BARAT,TAMBORA,JEMBATAN LIMA,21021,5026,15995,12525,28520,2021-11-05
3173081005,JAKARTA BARAT,KEMBANGAN,JOGLO,40839,8492,32347,27205,59552,2021-11-05
3171081001,JAKARTA PUSAT,JOHAR BARU,JOHAR BARU,37488,7039,30449,25471,55920,2021-11-05
3173041002,JAKARTA BARAT,TAMBORA,KALI ANYAR,23856,4809,19047,15014,34061,2021-11-05
3172041004,JAKARTA UTARA,CILINCING,KALIBARU,67684,18898,48786,34363,83149,2021-11-05
3174081002,JAKARTA SELATAN,PANCORAN,KALIBATA,41994,9742,32252,25833,58085,2021-11-05
3173061001,JAKARTA BARAT,KALI DERES,KALIDERES,72447,15034,57413,47994,105407,2021-11-05
3175051004,JAKARTA TIMUR,PASAR REBO,KALISARI,43212,7871,35341,29341,64682,2021-11-05
3173061004,JAKARTA BARAT,KALI DERES,KAMAL,53783,12758,41025,32151,73176,2021-11-05
3172011002,JAKARTA UTARA,PENJARINGAN,KAMAL MUARA,12930,2312,10618,8997,19615,2021-11-05
3171071007,JAKARTA PUSAT,TANAH ABANG,KAMPUNG BALI,11358,2494,8864,6704,15568,2021-11-05
3175031001,JAKARTA TIMUR,JATINEGARA,KAMPUNG MELAYU,25717,5946,19771,15262,35033,2021-11-05
3171081002,JAKARTA PUSAT,JOHAR BARU,KAMPUNG RAWA,21237,3571,17666,14016,31682,2021-11-05
3175041002,JAKARTA TIMUR,KRAMAT JATI,KAMPUNG TENGAH,43993,11255,32738,25799,58537,2021-11-05
3173011005,JAKARTA BARAT,CENGKARENG,KAPUK,134466,33039,101427,80858,182285,2021-11-05
3172011003,JAKARTA UTARA,PENJARINGAN,KAPUK MUARA,35781,6971,28810,24991,53801,2021-11-05
3171021002,JAKARTA PUSAT,SAWAH BESAR,KARANG ANYAR,25761,5060,20701,17281,37982,2021-11-05
3174021004,JAKARTA SELATAN,SETIA BUDI,KARET,9623,1876,7747,6386,14133,2021-11-05
3174021003,JAKARTA SELATAN,SETIA BUDI,KARET KUNINGAN,16055,3183,12872,10733,23605,2021-11-05
3174021002,JAKARTA SELATAN,SETIA BUDI,KARET SEMANGGI,2770,558,2212,1950,4162,2021-11-05
3171071003,JAKARTA PUSAT,TANAH ABANG,KARET TENGSIN,19271,3770,15501,12490,27991,2021-11-05
3171021003,JAKARTA PUSAT,SAWAH BESAR,KARTINI,22292,4301,17991,15281,33272,2021-11-05
3175011003,JAKARTA TIMUR,MATRAMAN,KAYU MANIS,25284,5437,19847,15588,35435,2021-11-05
3175021006,JAKARTA TIMUR,PULO GADUNG,KAYU PUTIH,40696,7810,32886,28449,61335,2021-11-05
3173031006,JAKARTA BARAT,TAMAN SARI,KEAGUNGAN,17387,3289,14098,11404,25502,2021-11-05
3174041007,JAKARTA SELATAN,PASAR MINGGU,KEBAGUSAN,44552,9001,35551,28982,64533,2021-11-05
3174051006,JAKARTA SELATAN,KEBAYORAN LAMA,KEBAYORAN LAMA SELATAN,41212,7816,33396,27753,61149,2021-11-05
3174051001,JAKARTA SELATAN,KEBAYORAN LAMA,KEBAYORAN LAMA UTARA,42422,9020,33402,27062,60464,2021-11-05
3174011004,JAKARTA SELATAN,TEBET,KEBON BARU,35165,6758,28407,23547,51954,2021-11-05
3172021005,JAKARTA UTARA,TANJUNG PRIOK,KEBON BAWANG,50952,10486,40466,33258,73724,2021-11-05
3173051001,JAKARTA BARAT,KEBON JERUK,KEBON JERUK,53887,11777,42110,34142,76252,2021-11-05
3171071006,JAKARTA PUSAT,TANAH ABANG,KEBON KACANG,21531,5210,16321,12740,29061,2021-11-05
3171011005,JAKARTA PUSAT,GAMBIR,KEBON KELAPA,10163,2076,8087,6735,14822,2021-11-05
3171031002,JAKARTA PUSAT,KEMAYORAN,KEBON KOSONG,30019,6085,23934,19300,43234,2021-11-05
3175011005,JAKARTA TIMUR,MATRAMAN,KEBON MANGGIS,16490,3281,13209,10828,24037,2021-11-05
3171071005,JAKARTA PUSAT,TANAH ABANG,KEBON MELATI,32206,8716,23490,17197,40687,2021-11-05
3175081003,JAKARTA TIMUR,MAKASAR,KEBON PALA,46614,9345,37269,30698,67967,2021-11-05
3171061005,JAKARTA PUSAT,MENTENG,KEBON SIRIH,12299,2694,9605,7634,17239,2021-11-05
3173011004,JAKARTA BARAT,CENGKARENG,KEDAUNG KALI ANGKE,32612,6434,26178,21704,47882,2021-11-05
3173051007,JAKARTA BARAT,KEBON JERUK,KEDOYA SELATAN,32165,5956,26209,21478,47687,2021-11-05
3173051006,JAKARTA BARAT,KEBON JERUK,KEDOYA UTARA,45740,8812,36928,30977,67905,2021-11-05
3173051004,JAKARTA BARAT,KEBON JERUK,KELAPA DUA,23565,4817,18748,15539,34287,2021-11-05
3175091003,JAKARTA TIMUR,CIRACAS,KELAPA DUA WETAN,46875,8141,38734,32181,70915,2021-11-05
3172061003,JAKARTA UTARA,KELAPA GADING,KELAPA GADING BARAT,35717,6312,29405,26307,55712,2021-11-05
3172061001,JAKARTA UTARA,KELAPA GADING,KELAPA GADING TIMUR,33592,5207,28385,26034,54419,2021-11-05
3173071005,JAKARTA BARAT,PALMERAH,KEMANGGISAN,32139,6181,25958,21488,47446,2021-11-05
3171031001,JAKARTA PUSAT,KEMAYORAN,KEMAYORAN,20708,4377,16331,13374,29705,2021-11-05
3173081006,JAKARTA BARAT,KEMBANGAN,KEMBANGAN SELATAN,27130,5773,21357,18273,39630,2021-11-05
3173081001,JAKARTA BARAT,KEMBANGAN,KEMBANGAN UTARA,54451,12147,42304,34919,77223,2021-11-05
3171041002,JAKARTA PUSAT,SENEN,KENARI,9579,1894,7685,6485,14170,2021-11-05
3173041005,JAKARTA BARAT,TAMBORA,KERENDANG,19973,4171,15802,12718,28520,2021-11-05
3175071003,JAKARTA TIMUR,DUREN SAWIT,KLENDER,69978,16680,53298,41821,95119,2021-11-05
3172031001,JAKARTA UTARA,KOJA,KOJA,28175,6518,21657,17311,38968,2021-11-05
3173071006,JAKARTA BARAT,PALMERAH,KOTA BAMBU SELATAN,21158,4294,16864,13047,29911,2021-11-05
3173071003,JAKARTA BARAT,PALMERAH,KOTA BAMBU UTARA,24995,5268,19727,15183,34910,2021-11-05
3171041004,JAKARTA PUSAT,SENEN,KRAMAT,28835,7019,21816,16426,38242,2021-11-05
3175041001,JAKARTA TIMUR,KRAMAT JATI,KRAMAT JATI,34144,7627,26517,21336,47853,2021-11-05
3174071003,JAKARTA SELATAN,KEBAYORAN BARU,KRAMAT PELA,14413,2840,11573,9767,21340,2021-11-05
3173031002,JAKARTA BARAT,TAMAN SARI,KRUKUT,19244,3675,15569,12476,28045,2021-11-05
3174031005,JAKARTA SELATAN,MAMPANG PRAPATAN,KUNINGAN BARAT,12785,2398,10387,8575,18962,2021-11-05
3174021008,JAKARTA SELATAN,SETIA BUDI,KUNINGAN TIMUR,6008,1209,4799,4003,8802,2021-11-05
3171041005,JAKARTA PUSAT,SENEN,KWITANG,15486,3535,11951,9566,21517,2021-11-05
3172031003,JAKARTA UTARA,KOJA,LAGOA,59065,14213,44852,35054,79906,2021-11-05
3174061002,JAKARTA SELATAN,CILANDAK,LEBAK BULUS,37626,7211,30415,26089,56504,2021-11-05
3174091004,JAKARTA SELATAN,JAGAKARSA,LENTENG AGUNG,53946,9912,44034,35231,79265,2021-11-05
3175101007,JAKARTA TIMUR,CIPAYUNG,LUBANG BUAYA,63547,12129,51418,42028,93446,2021-11-05
3175081001,JAKARTA TIMUR,MAKASAR,MAKASAR,34390,6427,27963,23260,51223,2021-11-05
3175071006,JAKARTA TIMUR,DUREN SAWIT,MALAKA JAYA,30927,5422,25505,21582,47087,2021-11-05
3175071005,JAKARTA TIMUR,DUREN SAWIT,MALAKA SARI,27530,4662,22868,19470,42338,2021-11-05
3174031001,JAKARTA SELATAN,MAMPANG PRAPATAN,MAMPANG PRAPATAN,18159,3780,14379,11721,26100,2021-11-05
3173031005,JAKARTA BARAT,TAMAN SARI,MANGGA BESAR,7707,1316,6391,5527,11918,2021-11-05
3171021005,JAKARTA PUSAT,SAWAH BESAR,MANGGA DUA SELATAN,27442,5806,21636,18157,39793,2021-11-05
3174011007,JAKARTA SELATAN,TEBET,MANGGARAI,28373,5151,23222,18635,41857,2021-11-05
3174011006,JAKARTA SELATAN,TEBET,MANGGARAI SELATAN,23075,4104,18971,15822,34793,2021-11-05
3173031003,JAKARTA BARAT,TAMAN SARI,MAPHAR,16461,3115,13346,11019,24365,2021-11-05
3172041003,JAKARTA UTARA,CILINCING,MARUNDA,28943,6674,22269,16514,38783,2021-11-05
3174071001,JAKARTA SELATAN,KEBAYORAN BARU,MELAWAI,2627,514,2113,1934,4047,2021-11-05
3171061001,JAKARTA PUSAT,MENTENG,MENTENG,25624,5757,19867,15498,35365,2021-11-05
3174021005,JAKARTA SELATAN,SETIA BUDI,MENTENG ATAS,27816,5113,22703,18621,41324,2021-11-05
3174011003,JAKARTA SELATAN,TEBET,MENTENG DALAM,36028,7117,28911,24066,52977,2021-11-05
3173081003,JAKARTA BARAT,KEMBANGAN,MERUYA SELATAN,32130,6722,25408,21175,46583,2021-11-05
3173081002,JAKARTA BARAT,KEMBANGAN,MERUYA UTARA,43752,9124,34628,29819,64447,2021-11-05
3175101004,JAKARTA TIMUR,CIPAYUNG,MUNJUL,23871,4411,19460,16291,35751,2021-11-05
3172051002,JAKARTA UTARA,PADEMANGAN,PADEMANGAN BARAT,74240,17919,56321,44967,101288,2021-11-05
3172051001,JAKARTA UTARA,PADEMANGAN,PADEMANGAN TIMUR,37736,6793,30943,26785,57728,2021-11-05
3175011004,JAKARTA TIMUR,MATRAMAN,PAL MERIAM,19769,4166,15603,12392,27995,2021-11-05
3173071001,JAKARTA BARAT,PALMERAH,PALMERAH,63011,13569,49442,39804,89246,2021-11-05
3174081001,JAKARTA SELATAN,PANCORAN,PANCORAN,19421,4038,15383,12601,27984,2021-11-05
3172021003,JAKARTA UTARA,TANJUNG PRIOK,PAPANGGO,39097,7799,31298,25397,56695,2021-11-05
3171021001,JAKARTA PUSAT,SAWAH BESAR,PASAR BARU,12035,2337,9698,8593,18291,2021-11-05
3174021006,JAKARTA SELATAN,SETIA BUDI,PASAR MANGGIS,26752,5402,21350,17431,38781,2021-11-05
3174041001,JAKARTA SELATAN,PASAR MINGGU,PASAR MINGGU,24821,4742,20079,16958,37037,2021-11-05
3171041003,JAKARTA PUSAT,SENEN,PASEBAN,23533,4986,18547,15106,33653,2021-11-05
3173061005,JAKARTA BARAT,KALI DERES,PEGADUNGAN,75587,15398,60189,51281,111470,2021-11-05
3171061002,JAKARTA PUSAT,MENTENG,PEGANGSAAN,23455,5119,18336,13895,32231,2021-11-05
3172061002,JAKARTA UTARA,KELAPA GADING,PEGANGSAAN DUA,49976,8362,41614,37366,78980,2021-11-05
3172011004,JAKARTA UTARA,PENJARINGAN,PEJAGALAN,74578,15747,58831,50092,108923,2021-11-05
3174041006,JAKARTA SELATAN,PASAR MINGGU,PEJATEN BARAT,37346,7467,29879,24742,54621,2021-11-05
3174041005,JAKARTA SELATAN,PASAR MINGGU,PEJATEN TIMUR,57656,13303,44353,36267,80620,2021-11-05
3175051005,JAKARTA TIMUR,PASAR REBO,PEKAYON,43250,7975,35275,28995,64270,2021-11-05
3173041009,JAKARTA BARAT,TAMBORA,PEKOJAN,23587,4571,19016,15742,34758,2021-11-05
3174031003,JAKARTA SELATAN,MAMPANG PRAPATAN,PELA MAMPANG,43522,8745,34777,28779,63556,2021-11-05
3174081005,JAKARTA SELATAN,PANCORAN,PENGADEGAN,21478,4007,17471,14719,32190,2021-11-05
3175061003,JAKARTA TIMUR,CAKUNG,PENGGILINGAN,99255,23520,75735,60053,135788,2021-11-05
3172011001,JAKARTA UTARA,PENJARINGAN,PENJARINGAN,88308,22955,65353,49820,115173,2021-11-05
3174101001,JAKARTA SELATAN,PESANGGRAHAN,PESANGGRAHAN,27545,4819,22726,19289,42015,2021-11-05
3171071004,JAKARTA PUSAT,TANAH ABANG,PETAMBURAN,33271,8903,24368,18282,42650,2021-11-05
3174071008,JAKARTA SELATAN,KEBAYORAN BARU,PETOGOGAN,11499,2274,9225,7793,17018,2021-11-05
3171011004,JAKARTA PUSAT,GAMBIR,PETOJO SELATAN,14692,3355,11337,9549,20886,2021-11-05
3171011003,JAKARTA PUSAT,GAMBIR,PETOJO UTARA,17458,3816,13642,11132,24774,2021-11-05
3174101004,JAKARTA SELATAN,PESANGGRAHAN,PETUKANGAN SELATAN,37187,7804,29383,24425,53808,2021-11-05
3174101003,JAKARTA SELATAN,PESANGGRAHAN,PETUKANGAN UTARA,53716,11746,41970,34489,76459,2021-11-05
3175081002,JAKARTA TIMUR,MAKASAR,PINANG RANTI,27198,6003,21195,17330,38525,2021-11-05
3173031008,JAKARTA BARAT,TAMAN SARI,PINANGSIA,10729,1901,8828,7254,16082,2021-11-05
3175011001,JAKARTA TIMUR,MATRAMAN,PISANGAN BARU,31776,6628,25148,19769,44917,2021-11-05
3175021002,JAKARTA TIMUR,PULO GADUNG,PISANGAN TIMUR,41011,7698,33313,27912,61225,2021-11-05
3172011005,JAKARTA UTARA,PENJARINGAN,PLUIT,47783,9273,38510,33447,71957,2021-11-05
3175071002,JAKARTA TIMUR,DUREN SAWIT,PONDOK BAMBU,61550,13205,48345,39278,87623,2021-11-05
3175071004,JAKARTA TIMUR,DUREN SAWIT,PONDOK KELAPA,72015,14482,57533,48790,106323,2021-11-05
3175071007,JAKARTA TIMUR,DUREN SAWIT,PONDOK KOPI,35367,6696,28671,22429,51100,2021-11-05
3174061003,JAKARTA SELATAN,CILANDAK,PONDOK LABU,46464,8059,38405,33110,71515,2021-11-05
3174051002,JAKARTA SELATAN,KEBAYORAN LAMA,PONDOK PINANG,56169,10969,45200,38177,83377,2021-11-05
3175101003,JAKARTA TIMUR,CIPAYUNG,PONDOK RANGGON,25574,4867,20707,17168,37875,2021-11-05
3101011003,KAB.ADM.KEP.SERIBU,KEP. SERIBU UTARA,PULAU HARAPAN,2060,223,1837,1600,3437,2021-11-05
3101011002,KAB.ADM.KEP.SERIBU,KEP. SERIBU UTARA,PULAU KELAPA,5528,608,4920,4048,8968,2021-11-05
3101011001,KAB.ADM.KEP.SERIBU,KEP. SERIBU UTARA,PULAU PANGGANG,5450,443,5007,4461,9468,2021-11-05
3101021003,KAB.ADM.KEP.SERIBU,KEP. SERIBU SELATAN,PULAU PARI,2765,196,2569,2410,4979,2021-11-05
3101021002,KAB.ADM.KEP.SERIBU,KEP. SERIBU SELATAN,PULAU TIDUNG,4553,370,4183,3813,7996,2021-11-05
3101021001,KAB.ADM.KEP.SERIBU,KEP. SERIBU SELATAN,PULAU UNTUNG JAWA,1941,163,1778,1633,3411,2021-11-05
3174071007,JAKARTA SELATAN,KEBAYORAN BARU,PULO,5835,1021,4814,4360,9174,2021-11-05
3175021001,JAKARTA TIMUR,PULO GADUNG,PULO GADUNG,34422,7643,26779,22152,48931,2021-11-05
3175061005,JAKARTA TIMUR,CAKUNG,PULO GEBANG,97301,19056,78245,63056,141301,2021-11-05
3174041004,JAKARTA SELATAN,PASAR MINGGU,RAGUNAN,39616,7471,32145,27112,59257,2021-11-05
3175091005,JAKARTA TIMUR,CIRACAS,RAMBUTAN,36771,8757,28014,22167,50181,2021-11-05
3172031006,JAKARTA UTARA,KOJA,RAWA BADAK SELATAN,42179,10169,32010,25032,57042,2021-11-05
3172031004,JAKARTA UTARA,KOJA,RAWA BADAK UTARA,34408,7812,26596,21070,47666,2021-11-05
3174071005,JAKARTA SELATAN,KEBAYORAN BARU,RAWA BARAT,5625,1012,4613,4050,8663,2021-11-05
3173011003,JAKARTA BARAT,CENGKARENG,RAWA BUAYA,63799,12981,50818,40667,91485,2021-11-05
3175031004,JAKARTA TIMUR,JATINEGARA,RAWA BUNGA,21434,5260,16174,12914,29088,2021-11-05
3174081003,JAKARTA SELATAN,PANCORAN,RAWA JATI,20509,3953,16556,13985,30541,2021-11-05
3175061002,JAKARTA TIMUR,CAKUNG,RAWA TERATE,24637,4547,20090,16262,36352,2021-11-05
3175021005,JAKARTA TIMUR,PULO GADUNG,RAWAMANGUN,37612,7574,30038,25154,55192,2021-11-05
3171051003,JAKARTA PUSAT,CEMPAKA PUTIH,RAWASARI,21967,4542,17425,14657,32082,2021-11-05
3173041010,JAKARTA BARAT,TAMBORA,ROA MALAKA,3484,623,2861,2514,5375,2021-11-05
3172041006,JAKARTA UTARA,CILINCING,ROROTAN,41668,8477,33191,26283,59474,2021-11-05
3174071004,JAKARTA SELATAN,KEBAYORAN BARU,SELONG,2842,551,2291,2102,4393,2021-11-05
3173061002,JAKARTA BARAT,KALI DERES,SEMANAN,71354,15629,55725,44613,100338,2021-11-05
3172041007,JAKARTA UTARA,CILINCING,SEMPER BARAT,68587,13607,54980,45081,100061,2021-11-05
3172041005,JAKARTA UTARA,CILINCING,SEMPER TIMUR,36267,7910,28357,22742,51099,2021-11-05
3174071006,JAKARTA SELATAN,KEBAYORAN BARU,SENAYAN,2771,661,2110,1805,3915,2021-11-05
3171041001,JAKARTA PUSAT,SENEN,SENEN,6804,1487,5317,4389,9706,2021-11-05
3171031004,JAKARTA PUSAT,KEMAYORAN,SERDANG,29668,5990,23678,19529,43207,2021-11-05
3174021001,JAKARTA SELATAN,SETIA BUDI,SETIA BUDI,3023,627,2396,2008,4404,2021-11-05
3175101005,JAKARTA TIMUR,CIPAYUNG,SETU,20572,4167,16405,13137,29542,2021-11-05
3173071002,JAKARTA BARAT,PALMERAH,SLIPI,16591,3039,13552,11265,24817,2021-11-05
3173081004,JAKARTA BARAT,KEMBANGAN,SRENGSENG,45523,10381,35142,29535,64677,2021-11-05
3174091002,JAKARTA SELATAN,JAGAKARSA,SRENGSENG SAWAH,58196,9197,48999,41127,90126,2021-11-05
3173051003,JAKARTA BARAT,KEBON JERUK,SUKABUMI SELATAN,37033,8437,28596,22031,50627,2021-11-05
3173051002,JAKARTA BARAT,KEBON JERUK,SUKABUMI UTARA,38290,9090,29200,22675,51875,2021-11-05
3172041002,JAKARTA UTARA,CILINCING,SUKAPURA,53949,12362,41587,33805,75392,2021-11-05
3171031007,JAKARTA PUSAT,KEMAYORAN,SUMUR BATU,22717,4639,18078,15243,33321,2021-11-05
3172021004,JAKARTA UTARA,TANJUNG PRIOK,SUNGAI BAMBU,29876,6111,23765,19441,43206,2021-11-05
3172021006,JAKARTA UTARA,TANJUNG PRIOK,SUNTER AGUNG,71805,12686,59119,51102,110221,2021-11-05
3172021002,JAKARTA UTARA,TANJUNG PRIOK,SUNTER JAYA,63031,11337,51694,44303,95997,2021-11-05
3175091004,JAKARTA TIMUR,CIRACAS,SUSUKAN,38257,7337,30920,25513,56433,2021-11-05
3173031001,JAKARTA BARAT,TAMAN SARI,TAMAN SARI,14348,2665,11683,9948,21631,2021-11-05
3173041001,JAKARTA BARAT,TAMBORA,TAMBORA,10204,2301,7903,6309,14212,2021-11-05
3173041004,JAKARTA BARAT,TAMBORA,TANAH SEREAL,26387,4564,21823,18220,40043,2021-11-05
3171081004,JAKARTA PUSAT,JOHAR BARU,TANAH TINGGI,37693,7274,30419,24492,54911,2021-11-05
3173031004,JAKARTA BARAT,TAMAN SARI,TANGKI,13324,2224,11100,9276,20376,2021-11-05
3174091005,JAKARTA SELATAN,JAGAKARSA,TANJUNG BARAT,39770,6873,32897,26972,59869,2021-11-05
3173021005,JAKARTA BARAT,GROGOL PETAMBURAN,TANJUNG DUREN SELATAN,25337,4904,20433,17845,38278,2021-11-05
3173021002,JAKARTA BARAT,GROGOL PETAMBURAN,TANJUNG DUREN UTARA,17010,2925,14085,12518,26603,2021-11-05
3172021001,JAKARTA UTARA,TANJUNG PRIOK,TANJUNG PRIOK,34588,7233,27355,22103,49458,2021-11-05
3174011002,JAKARTA SELATAN,TEBET,TEBET BARAT,21194,3517,17677,15420,33097,2021-11-05
3174011001,JAKARTA SELATAN,TEBET,TEBET TIMUR,18199,2970,15229,13599,28828,2021-11-05
3173061003,JAKARTA BARAT,KALI DERES,TEGAL ALUR,83647,17690,65957,53972,119929,2021-11-05
3174031004,JAKARTA SELATAN,MAMPANG PRAPATAN,TEGAL PARANG,32401,7238,25163,19444,44607,2021-11-05
3173021003,JAKARTA BARAT,GROGOL PETAMBURAN,TOMANG,29605,5549,24056,20403,44459,2021-11-05
3172031005,JAKARTA UTARA,KOJA,TUGU SELATAN,39122,8876,30246,24158,54404,2021-11-05
3172031002,JAKARTA UTARA,KOJA,TUGU UTARA,67670,16238,51432,40221,91653,2021-11-05
3175061006,JAKARTA TIMUR,CAKUNG,UJUNG MENTENG,29934,5288,24646,20710,45356,2021-11-05
3174101005,JAKARTA SELATAN,PESANGGRAHAN,ULUJAMI,40544,9281,31263,25456,56719,2021-11-05
3175011006,JAKARTA TIMUR,MATRAMAN,UTAN KAYU SELATAN,33511,6154,27357,22366,49723,2021-11-05
3175011002,JAKARTA TIMUR,MATRAMAN,UTAN KAYU UTARA,28169,5956,22213,17978,40191,2021-11-05
3171031008,JAKARTA PUSAT,KEMAYORAN,UTAN PANJANG,29208,6046,23162,18569,41731,2021-11-05
3172021007,JAKARTA UTARA,TANJUNG PRIOK,WARAKAS,44401,8270,36131,28797,64928,2021-11-05
3173021007,JAKARTA BARAT,GROGOL PETAMBURAN,WIJAYA KUSUMA,38934,8275,30659,25541,56200,2021-11-05
3172051003,JAKARTA UTARA,PADEMANGAN,ANCOL,23947,5875,18072,14735,32807,2021-11-06
3173041007,JAKARTA BARAT,TAMBORA,ANGKE,29381,6367,23014,18484,41498,2021-11-06
3175041005,JAKARTA TIMUR,KRAMAT JATI,BALE KAMBANG,29074,7395,21679,16834,38513,2021-11-06
3175031003,JAKARTA TIMUR,JATINEGARA,BALI MESTER,9752,2079,7673,6423,14096,2021-11-06
3175101006,JAKARTA TIMUR,CIPAYUNG,BAMBU APUS,26285,4912,21373,17641,39014,2021-11-06
3174031002,JAKARTA SELATAN,MAMPANG PRAPATAN,BANGKA,21566,4644,16922,13877,30799,2021-11-06
3175051002,JAKARTA TIMUR,PASAR REBO,BARU,23886,3998,19888,16943,36831,2021-11-06
3175041004,JAKARTA TIMUR,KRAMAT JATI,BATU AMPAR,47898,11844,36054,28647,64701,2021-11-06
3171071002,JAKARTA PUSAT,TANAH ABANG,BENDUNGAN HILIR,21494,4392,17102,14461,31563,2021-11-06
3175031002,JAKARTA TIMUR,JATINEGARA,BIDARA CINA,36689,8912,27777,21987,49764,2021-11-06
3174101002,JAKARTA SELATAN,PESANGGRAHAN,BINTARO,53098,10795,42303,36016,78319,2021-11-06
3174011005,JAKARTA SELATAN,TEBET,BUKIT DURI,34183,7038,27145,22412,49557,2021-11-06
3171041006,JAKARTA PUSAT,SENEN,BUNGUR,18144,3859,14285,11758,26043,2021-11-06
3175061007,JAKARTA TIMUR,CAKUNG,CAKUNG BARAT,57724,12001,45723,37398,83121,2021-11-06
3175061004,JAKARTA TIMUR,CAKUNG,CAKUNG TIMUR,58287,11670,46617,38353,84970,2021-11-06
3175041007,JAKARTA TIMUR,KRAMAT JATI,CAWANG,32762,7209,25553,20247,45800,2021-11-06
3175101008,JAKARTA TIMUR,CIPAYUNG,CEGER,18932,3777,15155,12561,27716,2021-11-06
3171031006,JAKARTA PUSAT,KEMAYORAN,CEMPAKA BARU,32581,6317,26264,20377,46641,2021-11-06
3171051002,JAKARTA PUSAT,CEMPAKA PUTIH,CEMPAKA PUTIH BARAT,35885,7753,28132,23771,51903,2021-11-06
3171051001,JAKARTA PUSAT,CEMPAKA PUTIH,CEMPAKA PUTIH TIMUR,24292,5067,19225,16607,35832,2021-11-06
3173011001,JAKARTA BARAT,CENGKARENG,CENGKARENG BARAT,66284,13465,52819,44298,97117,2021-11-06
3173011006,JAKARTA BARAT,CENGKARENG,CENGKARENG TIMUR,81027,16235,64792,53083,117875,2021-11-06
3175091002,JAKARTA TIMUR,CIRACAS,CIBUBUR,66364,11567,54797,45461,100258,2021-11-06
3171011002,JAKARTA PUSAT,GAMBIR,CIDENG,15390,3045,12345,10678,23023,2021-11-06
3174091003,JAKARTA SELATAN,JAGAKARSA,CIGANJUR,38497,6707,31790,25865,57655,2021-11-06
3175051003,JAKARTA TIMUR,PASAR REBO,CIJANTUNG,41419,7812,33607,27730,61337,2021-11-06
3171061003,JAKARTA PUSAT,MENTENG,CIKINI,8274,1507,6767,5286,12053,2021-11-06
3174081006,JAKARTA SELATAN,PANCORAN,CIKOKO,10547,1861,8686,7479,16165,2021-11-06
3174061001,JAKARTA SELATAN,CILANDAK,CILANDAK BARAT,51752,9303,42449,36507,78956,2021-11-06
3174041003,JAKARTA SELATAN,PASAR MINGGU,CILANDAK TIMUR,25145,4682,20463,17253,37716,2021-11-06
3175101002,JAKARTA TIMUR,CIPAYUNG,CILANGKAP,27635,4965,22670,19021,41691,2021-11-06
3175041006,JAKARTA TIMUR,KRAMAT JATI,CILILITAN,40181,8976,31205,25171,56376,2021-11-06
3172041001,JAKARTA UTARA,CILINCING,CILINCING,43609,10597,33012,25349,58361,2021-11-06
3175101001,JAKARTA TIMUR,CIPAYUNG,CIPAYUNG,26104,4616,21488,18278,39766,2021-11-06
3174091006,JAKARTA SELATAN,JAGAKARSA,CIPEDAK,38303,6433,31870,26535,58405,2021-11-06
3174061005,JAKARTA SELATAN,CILANDAK,CIPETE SELATAN,26704,5213,21491,18666,40157,2021-11-06
3174071010,JAKARTA SELATAN,KEBAYORAN BARU,CIPETE UTARA,34102,6611,27491,22504,49995,2021-11-06
3175021003,JAKARTA TIMUR,PULO GADUNG,CIPINANG,39306,7412,31894,26288,58182,2021-11-06
3175031007,JAKARTA TIMUR,JATINEGARA,CIPINANG BESAR SELATAN,35212,8455,26757,20704,47461,2021-11-06
3175031008,JAKARTA TIMUR,JATINEGARA,CIPINANG BESAR UTARA,45319,10846,34473,26555,61028,2021-11-06
3175031005,JAKARTA TIMUR,JATINEGARA,CIPINANG CEMPEDAK,32824,7225,25599,21360,46959,2021-11-06
3175081005,JAKARTA TIMUR,MAKASAR,CIPINANG MELAYU,42308,8284,34024,28562,62586,2021-11-06
3175031006,JAKARTA TIMUR,JATINEGARA,CIPINANG MUARA,55243,11998,43245,34803,78048,2021-11-06
3174051003,JAKARTA SELATAN,KEBAYORAN LAMA,CIPULIR,39937,8553,31384,25158,56542,2021-11-06
3175091001,JAKARTA TIMUR,CIRACAS,CIRACAS,64594,12024,52570,42976,95546,2021-11-06
3175041003,JAKARTA TIMUR,KRAMAT JATI,DUKUH,24609,4726,19883,16281,36164,2021-11-06
3175071001,JAKARTA TIMUR,DUREN SAWIT,DUREN SAWIT,61160,13062,48098,39068,87166,2021-11-06
3174081004,JAKARTA SELATAN,PANCORAN,DUREN TIGA,28319,5744,22575,18754,41329,2021-11-06
3173051005,JAKARTA BARAT,KEBON JERUK,DURI KEPA,60138,11917,48221,41294,89515,2021-11-06
3173011002,JAKARTA BARAT,CENGKARENG,DURI KOSAMBI,77923,16966,60957,48327,109284,2021-11-06
3171011006,JAKARTA PUSAT,GAMBIR,DURI PULO,19610,4211,15399,12293,27692,2021-11-06
3173041011,JAKARTA BARAT,TAMBORA,DURI SELATAN,14259,2581,11678,9783,21461,2021-11-06
3173041003,JAKARTA BARAT,TAMBORA,DURI UTARA,19844,3653,16191,13225,29416,2021-11-06
3171081003,JAKARTA PUSAT,JOHAR BARU,GALUR,18243,3629,14614,11696,26310,2021-11-06
3171011001,JAKARTA PUSAT,GAMBIR,GAMBIR,2191,459,1732,1493,3225,2021-11-06
3174061004,JAKARTA SELATAN,CILANDAK,GANDARIA SELATAN,22119,4308,17811,15007,32818,2021-11-06
3174071009,JAKARTA SELATAN,KEBAYORAN BARU,GANDARIA UTARA,39922,8075,31847,26469,58316,2021-11-06
3175051001,JAKARTA TIMUR,PASAR REBO,GEDONG,35755,7279,28476,23860,52336,2021-11-06
3171071001,JAKARTA PUSAT,TANAH ABANG,GELORA,3127,619,2508,2143,4651,2021-11-06
3173031007,JAKARTA BARAT,TAMAN SARI,GLODOK,7837,1214,6623,5878,12501,2021-11-06
3171061004,JAKARTA PUSAT,MENTENG,GONDANGDIA,4100,932,3168,2877,6045,2021-11-06
3173021001,JAKARTA BARAT,GROGOL PETAMBURAN,GROGOL,16876,3427,13449,11250,24699,2021-11-06
3174051005,JAKARTA SELATAN,KEBAYORAN LAMA,GROGOL SELATAN,44251,8937,35314,28712,64026,2021-11-06
3174051004,JAKARTA SELATAN,KEBAYORAN LAMA,GROGOL UTARA,42494,8779,33715,27662,61377,2021-11-06
3174021007,JAKARTA SELATAN,SETIA BUDI,GUNTUR,3985,755,3230,2823,6053,2021-11-06
3174071002,JAKARTA SELATAN,KEBAYORAN BARU,GUNUNG,9436,1763,7673,6756,14429,2021-11-06
3171031005,JAKARTA PUSAT,KEMAYORAN,GUNUNG SAHARI SELATAN,19199,3943,15256,12741,27997,2021-11-06
3171021004,JAKARTA PUSAT,SAWAH BESAR,GUNUNG SAHARI UTARA,16650,2981,13669,12104,25773,2021-11-06
3175081004,JAKARTA TIMUR,MAKASAR,HALIM PERDANA KUSUMAH,28363,3742,24621,22354,46975,2021-11-06
3171031003,JAKARTA PUSAT,KEMAYORAN,HARAPAN MULIA,22557,4632,17925,14440,32365,2021-11-06
3174091001,JAKARTA SELATAN,JAGAKARSA,JAGAKARSA,62389,10469,51920,42539,94459,2021-11-06
3175021007,JAKARTA TIMUR,PULO GADUNG,JATI,32757,6198,26559,22736,49295,2021-11-06
3174041002,JAKARTA SELATAN,PASAR MINGGU,JATI PADANG,37502,7580,29922,24949,54871,2021-11-06
3173071004,JAKARTA BARAT,PALMERAH,JATI PULO,28738,5809,22929,18160,41089,2021-11-06
3175061001,JAKARTA TIMUR,CAKUNG,JATINEGARA,84160,18215,65945,53670,119615,2021-11-06
3175021004,JAKARTA TIMUR,PULO GADUNG,JATINEGARA KAUM,24632,4462,20170,16258,36428,2021-11-06
3173021004,JAKARTA BARAT,GROGOL PETAMBURAN,JELAMBAR,30266,5594,24672,21259,45931,2021-11-06
3173021006,JAKARTA BARAT,GROGOL PETAMBURAN,JELAMBAR BARU,38246,7205,31041,26704,57745,2021-11-06
3173041006,JAKARTA BARAT,TAMBORA,JEMBATAN BESI,29314,7207,22107,17056,39163,2021-11-06
3173041008,JAKARTA BARAT,TAMBORA,JEMBATAN LIMA,21021,4953,16068,12576,28644,2021-11-06
3173081005,JAKARTA BARAT,KEMBANGAN,JOGLO,40839,8453,32386,27289,59675,2021-11-06
3171081001,JAKARTA PUSAT,JOHAR BARU,JOHAR BARU,37488,7020,30468,25526,55994,2021-11-06
3173041002,JAKARTA BARAT,TAMBORA,KALI ANYAR,23856,4797,19059,15058,34117,2021-11-06
3172041004,JAKARTA UTARA,CILINCING,KALIBARU,67684,18879,48805,34434,83239,2021-11-06
3174081002,JAKARTA SELATAN,PANCORAN,KALIBATA,41994,9713,32281,25945,58226,2021-11-06
3173061001,JAKARTA BARAT,KALI DERES,KALIDERES,72447,14955,57492,48168,105660,2021-11-06
3175051004,JAKARTA TIMUR,PASAR REBO,KALISARI,43212,7847,35365,29437,64802,2021-11-06
3173061004,JAKARTA BARAT,KALI DERES,KAMAL,53783,12726,41057,32254,73311,2021-11-06
3172011002,JAKARTA UTARA,PENJARINGAN,KAMAL MUARA,12930,2309,10621,9012,19633,2021-11-06
3171071007,JAKARTA PUSAT,TANAH ABANG,KAMPUNG BALI,11358,2489,8869,6743,15612,2021-11-06
3175031001,JAKARTA TIMUR,JATINEGARA,KAMPUNG MELAYU,25717,5935,19782,15306,35088,2021-11-06
3171081002,JAKARTA PUSAT,JOHAR BARU,KAMPUNG RAWA,21237,3561,17676,14042,31718,2021-11-06
3175041002,JAKARTA TIMUR,KRAMAT JATI,KAMPUNG TENGAH,43993,11205,32788,25917,58705,2021-11-06
3173011005,JAKARTA BARAT,CENGKARENG,KAPUK,134466,32932,101534,81198,182732,2021-11-06
3172011003,JAKARTA UTARA,PENJARINGAN,KAPUK MUARA,35781,6945,28836,25081,53917,2021-11-06
3171021002,JAKARTA PUSAT,SAWAH BESAR,KARANG ANYAR,25761,5043,20718,17336,38054,2021-11-06
3174021004,JAKARTA SELATAN,SETIA BUDI,KARET,9623,1870,7753,6400,14153,2021-11-06
3174021003,JAKARTA SELATAN,SETIA BUDI,KARET KUNINGAN,16055,3173,12882,10804,23686,2021-11-06
3174021002,JAKARTA SELATAN,SETIA BUDI,KARET SEMANGGI,2770,556,2214,1955,4169,2021-11-06
3171071003,JAKARTA PUSAT,TANAH ABANG,KARET TENGSIN,19271,3763,15508,12525,28033,2021-11-06
3171021003,JAKARTA PUSAT,SAWAH BESAR,KARTINI,22292,4284,18008,15344,33352,2021-11-06
3175011003,JAKARTA TIMUR,MATRAMAN,KAYU MANIS,25284,5419,19865,15660,35525,2021-11-06
3175021006,JAKARTA TIMUR,PULO GADUNG,KAYU PUTIH,40696,7787,32909,28538,61447,2021-11-06
3173031006,JAKARTA BARAT,TAMAN SARI,KEAGUNGAN,17387,3278,14109,11426,25535,2021-11-06
3174041007,JAKARTA SELATAN,PASAR MINGGU,KEBAGUSAN,44552,8982,35570,29080,64650,2021-11-06
3174051006,JAKARTA SELATAN,KEBAYORAN LAMA,KEBAYORAN LAMA SELATAN,41212,7794,33418,27866,61284,2021-11-06
3174051001,JAKARTA SELATAN,KEBAYORAN LAMA,KEBAYORAN LAMA UTARA,42422,8997,33425,27141,60566,2021-11-06
3174011004,JAKARTA SELATAN,TEBET,KEBON BARU,35165,6728,28437,23669,52106,2021-11-06
3172021005,JAKARTA UTARA,TANJUNG PRIOK,KEBON BAWANG,50952,10462,40490,33344,73834,2021-11-06
3173051001,JAKARTA BARAT,KEBON JERUK,KEBON JERUK,53887,11734,42153,34221,76374,2021-11-06
3171071006,JAKARTA PUSAT,TANAH ABANG,KEBON KACANG,21531,5199,16332,12792,29124,2021-11-06
3171011005,JAKARTA PUSAT,GAMBIR,KEBON KELAPA,10163,2067,8096,6755,14851,2021-11-06
3171031002,JAKARTA PUSAT,KEMAYORAN,KEBON KOSONG,30019,6065,23954,19369,43323,2021-11-06
3175011005,JAKARTA TIMUR,MATRAMAN,KEBON MANGGIS,16490,3274,13216,10882,24098,2021-11-06
3171071005,JAKARTA PUSAT,TANAH ABANG,KEBON MELATI,32206,8697,23509,17253,40762,2021-11-06
3175081003,JAKARTA TIMUR,MAKASAR,KEBON PALA,46614,9305,37309,30793,68102,2021-11-06
3171061005,JAKARTA PUSAT,MENTENG,KEBON SIRIH,12299,2688,9611,7663,17274,2021-11-06
3173011004,JAKARTA BARAT,CENGKARENG,KEDAUNG KALI ANGKE,32612,6404,26208,21825,48033,2021-11-06
3173051007,JAKARTA BARAT,KEBON JERUK,KEDOYA SELATAN,32165,5943,26222,21523,47745,2021-11-06
3173051006,JAKARTA BARAT,KEBON JERUK,KEDOYA UTARA,45740,8795,36945,31036,67981,2021-11-06
3173051004,JAKARTA BARAT,KEBON JERUK,KELAPA DUA,23565,4801,18764,15579,34343,2021-11-06
3175091003,JAKARTA TIMUR,CIRACAS,KELAPA DUA WETAN,46875,8099,38776,32310,71086,2021-11-06
3172061003,JAKARTA UTARA,KELAPA GADING,KELAPA GADING BARAT,35717,6299,29418,26352,55770,2021-11-06
3172061001,JAKARTA UTARA,KELAPA GADING,KELAPA GADING TIMUR,33592,5193,28399,26084,54483,2021-11-06
3173071005,JAKARTA BARAT,PALMERAH,KEMANGGISAN,32139,6161,25978,21573,47551,2021-11-06
3171031001,JAKARTA PUSAT,KEMAYORAN,KEMAYORAN,20708,4261,16447,13420,29867,2021-11-06
3173081006,JAKARTA BARAT,KEMBANGAN,KEMBANGAN SELATAN,27130,5753,21377,18315,39692,2021-11-06
3173081001,JAKARTA BARAT,KEMBANGAN,KEMBANGAN UTARA,54451,12113,42338,34991,77329,2021-11-06
3171041002,JAKARTA PUSAT,SENEN,KENARI,9579,1883,7696,6512,14208,2021-11-06
3173041005,JAKARTA BARAT,TAMBORA,KERENDANG,19973,4144,15829,12748,28577,2021-11-06
3175071003,JAKARTA TIMUR,DUREN SAWIT,KLENDER,69978,16644,53334,41958,95292,2021-11-06
3172031001,JAKARTA UTARA,KOJA,KOJA,28175,6499,21676,17351,39027,2021-11-06
3173071006,JAKARTA BARAT,PALMERAH,KOTA BAMBU SELATAN,21158,4231,16927,13075,30002,2021-11-06
3173071003,JAKARTA BARAT,PALMERAH,KOTA BAMBU UTARA,24995,5250,19745,15209,34954,2021-11-06
3171041004,JAKARTA PUSAT,SENEN,KRAMAT,28835,7008,21827,16463,38290,2021-11-06
3175041001,JAKARTA TIMUR,KRAMAT JATI,KRAMAT JATI,34144,7615,26529,21419,47948,2021-11-06
3174071003,JAKARTA SELATAN,KEBAYORAN BARU,KRAMAT PELA,14413,2832,11581,9802,21383,2021-11-06
3173031002,JAKARTA BARAT,TAMAN SARI,KRUKUT,19244,3671,15573,12499,28072,2021-11-06
3174031005,JAKARTA SELATAN,MAMPANG PRAPATAN,KUNINGAN BARAT,12785,2385,10400,8598,18998,2021-11-06
3174021008,JAKARTA SELATAN,SETIA BUDI,KUNINGAN TIMUR,6008,1207,4801,4022,8823,2021-11-06
3171041005,JAKARTA PUSAT,SENEN,KWITANG,15486,3528,11958,9587,21545,2021-11-06
3172031003,JAKARTA UTARA,KOJA,LAGOA,59065,14184,44881,35137,80018,2021-11-06
3174061002,JAKARTA SELATAN,CILANDAK,LEBAK BULUS,37626,7183,30443,26267,56710,2021-11-06
3174091004,JAKARTA SELATAN,JAGAKARSA,LENTENG AGUNG,53946,9880,44066,35421,79487,2021-11-06
3175101007,JAKARTA TIMUR,CIPAYUNG,LUBANG BUAYA,63547,12104,51443,42251,93694,2021-11-06
3175081001,JAKARTA TIMUR,MAKASAR,MAKASAR,34390,6415,27975,23362,51337,2021-11-06
3175071006,JAKARTA TIMUR,DUREN SAWIT,MALAKA JAYA,30927,5402,25525,21671,47196,2021-11-06
3175071005,JAKARTA TIMUR,DUREN SAWIT,MALAKA SARI,27530,4651,22879,19520,42399,2021-11-06
3174031001,JAKARTA SELATAN,MAMPANG PRAPATAN,MAMPANG PRAPATAN,18159,3773,14386,11756,26142,2021-11-06
3173031005,JAKARTA BARAT,TAMAN SARI,MANGGA BESAR,7707,1314,6393,5546,11939,2021-11-06
3171021005,JAKARTA PUSAT,SAWAH BESAR,MANGGA DUA SELATAN,27442,5789,21653,18193,39846,2021-11-06
3174011007,JAKARTA SELATAN,TEBET,MANGGARAI,28373,5129,23244,18710,41954,2021-11-06
3174011006,JAKARTA SELATAN,TEBET,MANGGARAI SELATAN,23075,4086,18989,15873,34862,2021-11-06
3173031003,JAKARTA BARAT,TAMAN SARI,MAPHAR,16461,3107,13354,11051,24405,2021-11-06
3172041003,JAKARTA UTARA,CILINCING,MARUNDA,28943,6660,22283,16551,38834,2021-11-06
3174071001,JAKARTA SELATAN,KEBAYORAN BARU,MELAWAI,2627,514,2113,1938,4051,2021-11-06
3171061001,JAKARTA PUSAT,MENTENG,MENTENG,25624,5731,19893,15572,35465,2021-11-06
3174021005,JAKARTA SELATAN,SETIA BUDI,MENTENG ATAS,27816,5088,22728,18724,41452,2021-11-06
3174011003,JAKARTA SELATAN,TEBET,MENTENG DALAM,36028,7089,28939,24202,53141,2021-11-06
3173081003,JAKARTA BARAT,KEMBANGAN,MERUYA SELATAN,32130,6694,25436,21241,46677,2021-11-06
3173081002,JAKARTA BARAT,KEMBANGAN,MERUYA UTARA,43752,9103,34649,29887,64536,2021-11-06
3175101004,JAKARTA TIMUR,CIPAYUNG,MUNJUL,23871,4402,19469,16343,35812,2021-11-06
3172051002,JAKARTA UTARA,PADEMANGAN,PADEMANGAN BARAT,74240,17872,56368,45074,101442,2021-11-06
3172051001,JAKARTA UTARA,PADEMANGAN,PADEMANGAN TIMUR,37736,6773,30963,26879,57842,2021-11-06
3175011004,JAKARTA TIMUR,MATRAMAN,PAL MERIAM,19769,4154,15615,12444,28059,2021-11-06
3173071001,JAKARTA BARAT,PALMERAH,PALMERAH,63011,13534,49477,39940,89417,2021-11-06
3174081001,JAKARTA SELATAN,PANCORAN,PANCORAN,19421,4032,15389,12629,28018,2021-11-06
3172021003,JAKARTA UTARA,TANJUNG PRIOK,PAPANGGO,39097,7770,31327,25457,56784,2021-11-06
3171021001,JAKARTA PUSAT,SAWAH BESAR,PASAR BARU,12035,2326,9709,8613,18322,2021-11-06
3174021006,JAKARTA SELATAN,SETIA BUDI,PASAR MANGGIS,26752,5382,21370,17490,38860,2021-11-06
3174041001,JAKARTA SELATAN,PASAR MINGGU,PASAR MINGGU,24821,4730,20091,17008,37099,2021-11-06
3171041003,JAKARTA PUSAT,SENEN,PASEBAN,23533,4958,18575,15151,33726,2021-11-06
3173061005,JAKARTA BARAT,KALI DERES,PEGADUNGAN,75587,15273,60314,51499,111813,2021-11-06
3171061002,JAKARTA PUSAT,MENTENG,PEGANGSAAN,23455,5103,18352,13968,32320,2021-11-06
3172061002,JAKARTA UTARA,KELAPA GADING,PEGANGSAAN DUA,49976,8337,41639,37445,79084,2021-11-06
3172011004,JAKARTA UTARA,PENJARINGAN,PEJAGALAN,74578,15692,58886,50311,109197,2021-11-06
3174041006,JAKARTA SELATAN,PASAR MINGGU,PEJATEN BARAT,37346,7434,29912,24831,54743,2021-11-06
3174041005,JAKARTA SELATAN,PASAR MINGGU,PEJATEN TIMUR,57656,13193,44463,36352,80815,2021-11-06
3175051005,JAKARTA TIMUR,PASAR REBO,PEKAYON,43250,7954,35296,29098,64394,2021-11-06
3173041009,JAKARTA BARAT,TAMBORA,PEKOJAN,23587,4556,19031,15777,34808,2021-11-06
3174031003,JAKARTA SELATAN,MAMPANG PRAPATAN,PELA MAMPANG,43522,8717,34805,28868,63673,2021-11-06
3174081005,JAKARTA SELATAN,PANCORAN,PENGADEGAN,21478,3995,17483,14771,32254,2021-11-06
3175061003,JAKARTA TIMUR,CAKUNG,PENGGILINGAN,99255,23383,75872,60222,136094,2021-11-06
3172011001,JAKARTA UTARA,PENJARINGAN,PENJARINGAN,88308,22912,65396,49958,115354,2021-11-06
3174101001,JAKARTA SELATAN,PESANGGRAHAN,PESANGGRAHAN,27545,4803,22742,19338,42080,2021-11-06
3171071004,JAKARTA PUSAT,TANAH ABANG,PETAMBURAN,33271,8882,24389,18346,42735,2021-11-06
3174071008,JAKARTA SELATAN,KEBAYORAN BARU,PETOGOGAN,11499,2262,9237,7817,17054,2021-11-06
3171011004,JAKARTA PUSAT,GAMBIR,PETOJO SELATAN,14692,3349,11343,9570,20913,2021-11-06
3171011003,JAKARTA PUSAT,GAMBIR,PETOJO UTARA,17458,3808,13650,11164,24814,2021-11-06
3174101004,JAKARTA SELATAN,PESANGGRAHAN,PETUKANGAN SELATAN,37187,7768,29419,24582,54001,2021-11-06
3174101003,JAKARTA SELATAN,PESANGGRAHAN,PETUKANGAN UTARA,53716,11713,42003,34601,76604,2021-11-06
3175081002,JAKARTA TIMUR,MAKASAR,PINANG RANTI,27198,5986,21212,17377,38589,2021-11-06
3173031008,JAKARTA BARAT,TAMAN SARI,PINANGSIA,10729,1898,8831,7277,16108,2021-11-06
3175011001,JAKARTA TIMUR,MATRAMAN,PISANGAN BARU,31776,6609,25167,19841,45008,2021-11-06
3175021002,JAKARTA TIMUR,PULO GADUNG,PISANGAN TIMUR,41011,7680,33331,27998,61329,2021-11-06
3172011005,JAKARTA UTARA,PENJARINGAN,PLUIT,47783,9257,38526,33561,72087,2021-11-06
3175071002,JAKARTA TIMUR,DUREN SAWIT,PONDOK BAMBU,61550,13186,48364,39383,87747,2021-11-06
3175071004,JAKARTA TIMUR,DUREN SAWIT,PONDOK KELAPA,72015,14433,57582,48982,106564,2021-11-06
3175071007,JAKARTA TIMUR,DUREN SAWIT,PONDOK KOPI,35367,6687,28680,22470,51150,2021-11-06
3174061003,JAKARTA SELATAN,CILANDAK,PONDOK LABU,46464,7983,38481,33190,71671,2021-11-06
3174051002,JAKARTA SELATAN,KEBAYORAN LAMA,PONDOK PINANG,56169,10941,45228,38313,83541,2021-11-06
3175101003,JAKARTA TIMUR,CIPAYUNG,PONDOK RANGGON,25574,4849,20725,17198,37923,2021-11-06
3101011003,KAB.ADM.KEP.SERIBU,KEP. SERIBU UTARA,PULAU HARAPAN,2060,223,1837,1600,3437,2021-11-06
3101011002,KAB.ADM.KEP.SERIBU,KEP. SERIBU UTARA,PULAU KELAPA,5528,607,4921,4053,8974,2021-11-06
3101011001,KAB.ADM.KEP.SERIBU,KEP. SERIBU UTARA,PULAU PANGGANG,5450,443,5007,4462,9469,2021-11-06
3101021003,KAB.ADM.KEP.SERIBU,KEP. SERIBU SELATAN,PULAU PARI,2765,195,2570,2411,4981,2021-11-06
3101021002,KAB.ADM.KEP.SERIBU,KEP. SERIBU SELATAN,PULAU TIDUNG,4553,369,4184,3815,7999,2021-11-06
3101021001,KAB.ADM.KEP.SERIBU,KEP. SERIBU SELATAN,PULAU UNTUNG JAWA,1941,163,1778,1639,3417,2021-11-06
3174071007,JAKARTA SELATAN,KEBAYORAN BARU,PULO,5835,1019,4816,4376,9192,2021-11-06
3175021001,JAKARTA TIMUR,PULO GADUNG,PULO GADUNG,34422,7621,26801,22217,49018,2021-11-06
3175061005,JAKARTA TIMUR,CAKUNG,PULO GEBANG,97301,18992,78309,63144,141453,2021-11-06
3174041004,JAKARTA SELATAN,PASAR MINGGU,RAGUNAN,39616,7444,32172,27177,59349,2021-11-06
3175091005,JAKARTA TIMUR,CIRACAS,RAMBUTAN,36771,8729,28042,22302,50344,2021-11-06
3172031006,JAKARTA UTARA,KOJA,RAWA BADAK SELATAN,42179,10147,32032,25110,57142,2021-11-06
3172031004,JAKARTA UTARA,KOJA,RAWA BADAK UTARA,34408,7794,26614,21144,47758,2021-11-06
3174071005,JAKARTA SELATAN,KEBAYORAN BARU,RAWA BARAT,5625,1011,4614,4064,8678,2021-11-06
3173011003,JAKARTA BARAT,CENGKARENG,RAWA BUAYA,63799,12911,50888,40839,91727,2021-11-06
3175031004,JAKARTA TIMUR,JATINEGARA,RAWA BUNGA,21434,5244,16190,13024,29214,2021-11-06
3174081003,JAKARTA SELATAN,PANCORAN,RAWA JATI,20509,3947,16562,14051,30613,2021-11-06
3175061002,JAKARTA TIMUR,CAKUNG,RAWA TERATE,24637,4521,20116,16286,36402,2021-11-06
3175021005,JAKARTA TIMUR,PULO GADUNG,RAWAMANGUN,37612,7521,30091,25268,55359,2021-11-06
3171051003,JAKARTA PUSAT,CEMPAKA PUTIH,RAWASARI,21967,4525,17442,14740,32182,2021-11-06
3173041010,JAKARTA BARAT,TAMBORA,ROA MALAKA,3484,621,2863,2516,5379,2021-11-06
3172041006,JAKARTA UTARA,CILINCING,ROROTAN,41668,8468,33200,26342,59542,2021-11-06
3174071004,JAKARTA SELATAN,KEBAYORAN BARU,SELONG,2842,551,2291,2106,4397,2021-11-06
3173061002,JAKARTA BARAT,KALI DERES,SEMANAN,71354,15565,55789,44738,100527,2021-11-06
3172041007,JAKARTA UTARA,CILINCING,SEMPER BARAT,68587,13554,55033,45258,100291,2021-11-06
3172041005,JAKARTA UTARA,CILINCING,SEMPER TIMUR,36267,7893,28374,22816,51190,2021-11-06
3174071006,JAKARTA SELATAN,KEBAYORAN BARU,SENAYAN,2771,661,2110,1816,3926,2021-11-06
3171041001,JAKARTA PUSAT,SENEN,SENEN,6804,1474,5330,4404,9734,2021-11-06
3171031004,JAKARTA PUSAT,KEMAYORAN,SERDANG,29668,5965,23703,19581,43284,2021-11-06
3174021001,JAKARTA SELATAN,SETIA BUDI,SETIA BUDI,3023,624,2399,2019,4418,2021-11-06
3175101005,JAKARTA TIMUR,CIPAYUNG,SETU,20572,4126,16446,13186,29632,2021-11-06
3173071002,JAKARTA BARAT,PALMERAH,SLIPI,16591,3031,13560,11303,24863,2021-11-06
3173081004,JAKARTA BARAT,KEMBANGAN,SRENGSENG,45523,10350,35173,29606,64779,2021-11-06
3174091002,JAKARTA SELATAN,JAGAKARSA,SRENGSENG SAWAH,58196,9170,49026,41246,90272,2021-11-06
3173051003,JAKARTA BARAT,KEBON JERUK,SUKABUMI SELATAN,37033,8402,28631,22099,50730,2021-11-06
3173051002,JAKARTA BARAT,KEBON JERUK,SUKABUMI UTARA,38290,9060,29230,22737,51967,2021-11-06
3172041002,JAKARTA UTARA,CILINCING,SUKAPURA,53949,12321,41628,33908,75536,2021-11-06
3171031007,JAKARTA PUSAT,KEMAYORAN,SUMUR BATU,22717,4586,18131,15304,33435,2021-11-06
3172021004,JAKARTA UTARA,TANJUNG PRIOK,SUNGAI BAMBU,29876,6101,23775,19492,43267,2021-11-06
3172021006,JAKARTA UTARA,TANJUNG PRIOK,SUNTER AGUNG,71805,12648,59157,51243,110400,2021-11-06
3172021002,JAKARTA UTARA,TANJUNG PRIOK,SUNTER JAYA,63031,11314,51717,44457,96174,2021-11-06
3175091004,JAKARTA TIMUR,CIRACAS,SUSUKAN,38257,7315,30942,25604,56546,2021-11-06
3173031001,JAKARTA BARAT,TAMAN SARI,TAMAN SARI,14348,2658,11690,9963,21653,2021-11-06
3173041001,JAKARTA BARAT,TAMBORA,TAMBORA,10204,2292,7912,6325,14237,2021-11-06
3173041004,JAKARTA BARAT,TAMBORA,TANAH SEREAL,26387,4551,21836,18253,40089,2021-11-06
3171081004,JAKARTA PUSAT,JOHAR BARU,TANAH TINGGI,37693,7262,30431,24530,54961,2021-11-06
3173031004,JAKARTA BARAT,TAMAN SARI,TANGKI,13324,2222,11102,9298,20400,2021-11-06
3174091005,JAKARTA SELATAN,JAGAKARSA,TANJUNG BARAT,39770,6855,32915,27059,59974,2021-11-06
3173021005,JAKARTA BARAT,GROGOL PETAMBURAN,TANJUNG DUREN SELATAN,25337,4887,20450,17910,38360,2021-11-06
3173021002,JAKARTA BARAT,GROGOL PETAMBURAN,TANJUNG DUREN UTARA,17010,2917,14093,12553,26646,2021-11-06
3172021001,JAKARTA UTARA,TANJUNG PRIOK,TANJUNG PRIOK,34588,7221,27367,22153,49520,2021-11-06
3174011002,JAKARTA SELATAN,TEBET,TEBET BARAT,21194,3505,17689,15464,33153,2021-11-06
3174011001,JAKARTA SELATAN,TEBET,TEBET TIMUR,18199,2958,15241,13643,28884,2021-11-06
3173061003,JAKARTA BARAT,KALI DERES,TEGAL ALUR,83647,17560,66087,54172,120259,2021-11-06
3174031004,JAKARTA SELATAN,MAMPANG PRAPATAN,TEGAL PARANG,32401,7220,25181,19500,44681,2021-11-06
3173021003,JAKARTA BARAT,GROGOL PETAMBURAN,TOMANG,29605,5531,24074,20456,44530,2021-11-06
3172031005,JAKARTA UTARA,KOJA,TUGU SELATAN,39122,8852,30270,24232,54502,2021-11-06
3172031002,JAKARTA UTARA,KOJA,TUGU UTARA,67670,16202,51468,40328,91796,2021-11-06
3175061006,JAKARTA TIMUR,CAKUNG,UJUNG MENTENG,29934,5270,24664,20765,45429,2021-11-06
3174101005,JAKARTA SELATAN,PESANGGRAHAN,ULUJAMI,40544,9262,31282,25549,56831,2021-11-06
3175011006,JAKARTA TIMUR,MATRAMAN,UTAN KAYU SELATAN,33511,6134,27377,22436,49813,2021-11-06
3175011002,JAKARTA TIMUR,MATRAMAN,UTAN KAYU UTARA,28169,5944,22225,18039,40264,2021-11-06
3171031008,JAKARTA PUSAT,KEMAYORAN,UTAN PANJANG,29208,6025,23183,18620,41803,2021-11-06
3172021007,JAKARTA UTARA,TANJUNG PRIOK,WARAKAS,44401,8256,36145,28858,65003,2021-11-06
3173021007,JAKARTA BARAT,GROGOL PETAMBURAN,WIJAYA KUSUMA,38934,8249,30685,25620,56305,2021-11-06
3172051003,JAKARTA UTARA,PADEMANGAN,ANCOL,23947,5862,18085,14760,32845,2021-11-07
3173041007,JAKARTA BARAT,TAMBORA,ANGKE,29381,6333,23048,18537,41585,2021-11-07
3175041005,JAKARTA TIMUR,KRAMAT JATI,BALE KAMBANG,29074,7376,21698,16893,38591,2021-11-07
3175031003,JAKARTA TIMUR,JATINEGARA,BALI MESTER,9752,2078,7674,6433,14107,2021-11-07
3175101006,JAKARTA TIMUR,CIPAYUNG,BAMBU APUS,26285,4901,21384,17668,39052,2021-11-07
3174031002,JAKARTA SELATAN,MAMPANG PRAPATAN,BANGKA,21566,4635,16931,13887,30818,2021-11-07
3175051002,JAKARTA TIMUR,PASAR REBO,BARU,23886,3989,19897,16961,36858,2021-11-07
3175041004,JAKARTA TIMUR,KRAMAT JATI,BATU AMPAR,47898,11802,36096,28714,64810,2021-11-07
3171071002,JAKARTA PUSAT,TANAH ABANG,BENDUNGAN HILIR,21494,4387,17107,14476,31583,2021-11-07
3175031002,JAKARTA TIMUR,JATINEGARA,BIDARA CINA,36689,8896,27793,22031,49824,2021-11-07
3174101002,JAKARTA SELATAN,PESANGGRAHAN,BINTARO,53098,10770,42328,36088,78416,2021-11-07
3174011005,JAKARTA SELATAN,TEBET,BUKIT DURI,34183,7024,27159,22438,49597,2021-11-07
3171041006,JAKARTA PUSAT,SENEN,BUNGUR,18144,3855,14289,11778,26067,2021-11-07
3175061007,JAKARTA TIMUR,CAKUNG,CAKUNG BARAT,57724,11984,45740,37447,83187,2021-11-07
3175061004,JAKARTA TIMUR,CAKUNG,CAKUNG TIMUR,58287,11644,46643,38394,85037,2021-11-07
3175041007,JAKARTA TIMUR,KRAMAT JATI,CAWANG,32762,7195,25567,20281,45848,2021-11-07
3175101008,JAKARTA TIMUR,CIPAYUNG,CEGER,18932,3768,15164,12577,27741,2021-11-07
3171031006,JAKARTA PUSAT,KEMAYORAN,CEMPAKA BARU,32581,6301,26280,20406,46686,2021-11-07
3171051002,JAKARTA PUSAT,CEMPAKA PUTIH,CEMPAKA PUTIH BARAT,35885,7739,28146,23804,51950,2021-11-07
3171051001,JAKARTA PUSAT,CEMPAKA PUTIH,CEMPAKA PUTIH TIMUR,24292,5056,19236,16629,35865,2021-11-07
3173011001,JAKARTA BARAT,CENGKARENG,CENGKARENG BARAT,66284,13442,52842,44360,97202,2021-11-07
3173011006,JAKARTA BARAT,CENGKARENG,CENGKARENG TIMUR,81027,16191,64836,53222,118058,2021-11-07
3175091002,JAKARTA TIMUR,CIRACAS,CIBUBUR,66364,11537,54827,45645,100472,2021-11-07
3171011002,JAKARTA PUSAT,GAMBIR,CIDENG,15390,3037,12353,10694,23047,2021-11-07
3174091003,JAKARTA SELATAN,JAGAKARSA,CIGANJUR,38497,6697,31800,25910,57710,2021-11-07
3175051003,JAKARTA TIMUR,PASAR REBO,CIJANTUNG,41419,7797,33622,27759,61381,2021-11-07
3171061003,JAKARTA PUSAT,MENTENG,CIKINI,8274,1505,6769,5287,12056,2021-11-07
3174081006,JAKARTA SELATAN,PANCORAN,CIKOKO,10547,1856,8691,7487,16178,2021-11-07
3174061001,JAKARTA SELATAN,CILANDAK,CILANDAK BARAT,51752,9278,42474,36594,79068,2021-11-07
3174041003,JAKARTA SELATAN,PASAR MINGGU,CILANDAK TIMUR,25145,4675,20470,17280,37750,2021-11-07
3175101002,JAKARTA TIMUR,CIPAYUNG,CILANGKAP,27635,4961,22674,19039,41713,2021-11-07
3175041006,JAKARTA TIMUR,KRAMAT JATI,CILILITAN,40181,8960,31221,25229,56450,2021-11-07
3172041001,JAKARTA UTARA,CILINCING,CILINCING,43609,10578,33031,25384,58415,2021-11-07
3175101001,JAKARTA TIMUR,CIPAYUNG,CIPAYUNG,26104,4613,21491,18304,39795,2021-11-07
3174091006,JAKARTA SELATAN,JAGAKARSA,CIPEDAK,38303,6419,31884,26563,58447,2021-11-07
3174061005,JAKARTA SELATAN,CILANDAK,CIPETE SELATAN,26704,5203,21501,18697,40198,2021-11-07
3174071010,JAKARTA SELATAN,KEBAYORAN BARU,CIPETE UTARA,34102,6595,27507,22551,50058,2021-11-07
3175021003,JAKARTA TIMUR,PULO GADUNG,CIPINANG,39306,7399,31907,26342,58249,2021-11-07
3175031007,JAKARTA TIMUR,JATINEGARA,CIPINANG BESAR SELATAN,35212,8447,26765,20729,47494,2021-11-07
3175031008,JAKARTA TIMUR,JATINEGARA,CIPINANG BESAR UTARA,45319,10834,34485,26579,61064,2021-11-07
3175031005,JAKARTA TIMUR,JATINEGARA,CIPINANG CEMPEDAK,32824,7205,25619,21454,47073,2021-11-07
3175081005,JAKARTA TIMUR,MAKASAR,CIPINANG MELAYU,42308,8266,34042,28593,62635,2021-11-07
3175031006,JAKARTA TIMUR,JATINEGARA,CIPINANG MUARA,55243,11976,43267,34858,78125,2021-11-07
3174051003,JAKARTA SELATAN,KEBAYORAN LAMA,CIPULIR,39937,8536,31401,25186,56587,2021-11-07
3175091001,JAKARTA TIMUR,CIRACAS,CIRACAS,64594,11990,52604,43071,95675,2021-11-07
3175041003,JAKARTA TIMUR,KRAMAT JATI,DUKUH,24609,4719,19890,16305,36195,2021-11-07
3175071001,JAKARTA TIMUR,DUREN SAWIT,DUREN SAWIT,61160,13038,48122,39117,87239,2021-11-07
3174081004,JAKARTA SELATAN,PANCORAN,DUREN TIGA,28319,5736,22583,18775,41358,2021-11-07
3173051005,JAKARTA BARAT,KEBON JERUK,DURI KEPA,60138,11898,48240,41337,89577,2021-11-07
3173011002,JAKARTA BARAT,CENGKARENG,DURI KOSAMBI,77923,16930,60993,48403,109396,2021-11-07
3171011006,JAKARTA PUSAT,GAMBIR,DURI PULO,19610,4203,15407,12316,27723,2021-11-07
3173041011,JAKARTA BARAT,TAMBORA,DURI SELATAN,14259,2578,11681,9797,21478,2021-11-07
3173041003,JAKARTA BARAT,TAMBORA,DURI UTARA,19844,3645,16199,13242,29441,2021-11-07
3171081003,JAKARTA PUSAT,JOHAR BARU,GALUR,18243,3623,14620,11711,26331,2021-11-07
3171011001,JAKARTA PUSAT,GAMBIR,GAMBIR,2191,458,1733,1495,3228,2021-11-07
3174061004,JAKARTA SELATAN,CILANDAK,GANDARIA SELATAN,22119,4299,17820,15030,32850,2021-11-07
3174071009,JAKARTA SELATAN,KEBAYORAN BARU,GANDARIA UTARA,39922,8059,31863,26514,58377,2021-11-07
3175051001,JAKARTA TIMUR,PASAR REBO,GEDONG,35755,7270,28485,23887,52372,2021-11-07
3171071001,JAKARTA PUSAT,TANAH ABANG,GELORA,3127,618,2509,2144,4653,2021-11-07
3173031007,JAKARTA BARAT,TAMAN SARI,GLODOK,7837,1209,6628,5886,12514,2021-11-07
3171061004,JAKARTA PUSAT,MENTENG,GONDANGDIA,4100,929,3171,2881,6052,2021-11-07
3173021001,JAKARTA BARAT,GROGOL PETAMBURAN,GROGOL,16876,3420,13456,11265,24721,2021-11-07
3174051005,JAKARTA SELATAN,KEBAYORAN LAMA,GROGOL SELATAN,44251,8916,35335,28744,64079,2021-11-07
3174051004,JAKARTA SELATAN,KEBAYORAN LAMA,GROGOL UTARA,42494,8764,33730,27689,61419,2021-11-07
3174021007,JAKARTA SELATAN,SETIA BUDI,GUNTUR,3985,752,3233,2828,6061,2021-11-07
3174071002,JAKARTA SELATAN,KEBAYORAN BARU,GUNUNG,9436,1761,7675,6761,14436,2021-11-07
3171031005,JAKARTA PUSAT,KEMAYORAN,GUNUNG SAHARI SELATAN,19199,3941,15258,12751,28009,2021-11-07
3171021004,JAKARTA PUSAT,SAWAH BESAR,GUNUNG SAHARI UTARA,16650,2976,13674,12119,25793,2021-11-07
3175081004,JAKARTA TIMUR,MAKASAR,HALIM PERDANA KUSUMAH,28363,3737,24626,22370,46996,2021-11-07
3171031003,JAKARTA PUSAT,KEMAYORAN,HARAPAN MULIA,22557,4616,17941,14460,32401,2021-11-07
3174091001,JAKARTA SELATAN,JAGAKARSA,JAGAKARSA,62389,10446,51943,42595,94538,2021-11-07
3175021007,JAKARTA TIMUR,PULO GADUNG,JATI,32757,6183,26574,22773,49347,2021-11-07
3174041002,JAKARTA SELATAN,PASAR MINGGU,JATI PADANG,37502,7563,29939,24999,54938,2021-11-07
3173071004,JAKARTA BARAT,PALMERAH,JATI PULO,28738,5802,22936,18190,41126,2021-11-07
3175061001,JAKARTA TIMUR,CAKUNG,JATINEGARA,84160,18152,66008,53787,119795,2021-11-07
3175021004,JAKARTA TIMUR,PULO GADUNG,JATINEGARA KAUM,24632,4449,20183,16275,36458,2021-11-07
3173021004,JAKARTA BARAT,GROGOL PETAMBURAN,JELAMBAR,30266,5587,24679,21309,45988,2021-11-07
3173021006,JAKARTA BARAT,GROGOL PETAMBURAN,JELAMBAR BARU,38246,7198,31048,26732,57780,2021-11-07
3173041006,JAKARTA BARAT,TAMBORA,JEMBATAN BESI,29314,7195,22119,17081,39200,2021-11-07
3173041008,JAKARTA BARAT,TAMBORA,JEMBATAN LIMA,21021,4925,16096,12597,28693,2021-11-07
3173081005,JAKARTA BARAT,KEMBANGAN,JOGLO,40839,8436,32403,27314,59717,2021-11-07
3171081001,JAKARTA PUSAT,JOHAR BARU,JOHAR BARU,37488,7013,30475,25548,56023,2021-11-07
3173041002,JAKARTA BARAT,TAMBORA,KALI ANYAR,23856,4781,19075,15081,34156,2021-11-07
3172041004,JAKARTA UTARA,CILINCING,KALIBARU,67684,18832,48852,34509,83361,2021-11-07
3174081002,JAKARTA SELATAN,PANCORAN,KALIBATA,41994,9693,32301,25974,58275,2021-11-07
3173061001,JAKARTA BARAT,KALI DERES,KALIDERES,72447,14911,57536,48299,105835,2021-11-07
3175051004,JAKARTA TIMUR,PASAR REBO,KALISARI,43212,7839,35373,29467,64840,2021-11-07
3173061004,JAKARTA BARAT,KALI DERES,KAMAL,53783,12703,41080,32295,73375,2021-11-07
3172011002,JAKARTA UTARA,PENJARINGAN,KAMAL MUARA,12930,2305,10625,9017,19642,2021-11-07
3171071007,JAKARTA PUSAT,TANAH ABANG,KAMPUNG BALI,11358,2487,8871,6749,15620,2021-11-07
3175031001,JAKARTA TIMUR,JATINEGARA,KAMPUNG MELAYU,25717,5934,19783,15325,35108,2021-11-07
3171081002,JAKARTA PUSAT,JOHAR BARU,KAMPUNG RAWA,21237,3552,17685,14059,31744,2021-11-07
3175041002,JAKARTA TIMUR,KRAMAT JATI,KAMPUNG TENGAH,43993,11189,32804,25945,58749,2021-11-07
3173011005,JAKARTA BARAT,CENGKARENG,KAPUK,134466,32873,101593,81347,182940,2021-11-07
3172011003,JAKARTA UTARA,PENJARINGAN,KAPUK MUARA,35781,6932,28849,25110,53959,2021-11-07
3171021002,JAKARTA PUSAT,SAWAH BESAR,KARANG ANYAR,25761,5027,20734,17350,38084,2021-11-07
3174021004,JAKARTA SELATAN,SETIA BUDI,KARET,9623,1865,7758,6412,14170,2021-11-07
3174021003,JAKARTA SELATAN,SETIA BUDI,KARET KUNINGAN,16055,3169,12886,10836,23722,2021-11-07
3174021002,JAKARTA SELATAN,SETIA BUDI,KARET SEMANGGI,2770,556,2214,1955,4169,2021-11-07
3171071003,JAKARTA PUSAT,TANAH ABANG,KARET TENGSIN,19271,3760,15511,12531,28042,2021-11-07
3171021003,JAKARTA PUSAT,SAWAH BESAR,KARTINI,22292,4280,18012,15355,33367,2021-11-07
3175011003,JAKARTA TIMUR,MATRAMAN,KAYU MANIS,25284,5403,19881,15681,35562,2021-11-07
3175021006,JAKARTA TIMUR,PULO GADUNG,KAYU PUTIH,40696,7771,32925,28590,61515,2021-11-07
3173031006,JAKARTA BARAT,TAMAN SARI,KEAGUNGAN,17387,3273,14114,11443,25557,2021-11-07
3174041007,JAKARTA SELATAN,PASAR MINGGU,KEBAGUSAN,44552,8957,35595,29125,64720,2021-11-07
3174051006,JAKARTA SELATAN,KEBAYORAN LAMA,KEBAYORAN LAMA SELATAN,41212,7780,33432,27943,61375,2021-11-07
3174051001,JAKARTA SELATAN,KEBAYORAN LAMA,KEBAYORAN LAMA UTARA,42422,8980,33442,27188,60630,2021-11-07
3174011004,JAKARTA SELATAN,TEBET,KEBON BARU,35165,6717,28448,23697,52145,2021-11-07
3172021005,JAKARTA UTARA,TANJUNG PRIOK,KEBON BAWANG,50952,10437,40515,33437,73952,2021-11-07
3173051001,JAKARTA BARAT,KEBON JERUK,KEBON JERUK,53887,11712,42175,34269,76444,2021-11-07
3171071006,JAKARTA PUSAT,TANAH ABANG,KEBON KACANG,21531,5186,16345,12805,29150,2021-11-07
3171011005,JAKARTA PUSAT,GAMBIR,KEBON KELAPA,10163,2063,8100,6768,14868,2021-11-07
3171031002,JAKARTA PUSAT,KEMAYORAN,KEBON KOSONG,30019,6056,23963,19388,43351,2021-11-07
3175011005,JAKARTA TIMUR,MATRAMAN,KEBON MANGGIS,16490,3263,13227,10896,24123,2021-11-07
3171071005,JAKARTA PUSAT,TANAH ABANG,KEBON MELATI,32206,8676,23530,17283,40813,2021-11-07
3175081003,JAKARTA TIMUR,MAKASAR,KEBON PALA,46614,9289,37325,30840,68165,2021-11-07
3171061005,JAKARTA PUSAT,MENTENG,KEBON SIRIH,12299,2685,9614,7674,17288,2021-11-07
3173011004,JAKARTA BARAT,CENGKARENG,KEDAUNG KALI ANGKE,32612,6397,26215,21855,48070,2021-11-07
3173051007,JAKARTA BARAT,KEBON JERUK,KEDOYA SELATAN,32165,5934,26231,21554,47785,2021-11-07
3173051006,JAKARTA BARAT,KEBON JERUK,KEDOYA UTARA,45740,8776,36964,31084,68048,2021-11-07
3173051004,JAKARTA BARAT,KEBON JERUK,KELAPA DUA,23565,4789,18776,15597,34373,2021-11-07
3175091003,JAKARTA TIMUR,CIRACAS,KELAPA DUA WETAN,46875,8091,38784,32361,71145,2021-11-07
3172061003,JAKARTA UTARA,KELAPA GADING,KELAPA GADING BARAT,35717,6283,29434,26371,55805,2021-11-07
3172061001,JAKARTA UTARA,KELAPA GADING,KELAPA GADING TIMUR,33592,5184,28408,26110,54518,2021-11-07
3173071005,JAKARTA BARAT,PALMERAH,KEMANGGISAN,32139,6141,25998,21592,47590,2021-11-07
3171031001,JAKARTA PUSAT,KEMAYORAN,KEMAYORAN,20708,4253,16455,13440,29895,2021-11-07
3173081006,JAKARTA BARAT,KEMBANGAN,KEMBANGAN SELATAN,27130,5748,21382,18325,39707,2021-11-07
3173081001,JAKARTA BARAT,KEMBANGAN,KEMBANGAN UTARA,54451,12085,42366,35031,77397,2021-11-07
3171041002,JAKARTA PUSAT,SENEN,KENARI,9579,1879,7700,6515,14215,2021-11-07
3173041005,JAKARTA BARAT,TAMBORA,KERENDANG,19973,4138,15835,12768,28603,2021-11-07
3175071003,JAKARTA TIMUR,DUREN SAWIT,KLENDER,69978,16587,53391,42060,95451,2021-11-07
3172031001,JAKARTA UTARA,KOJA,KOJA,28175,6485,21690,17377,39067,2021-11-07
3173071006,JAKARTA BARAT,PALMERAH,KOTA BAMBU SELATAN,21158,4218,16940,13090,30030,2021-11-07
3173071003,JAKARTA BARAT,PALMERAH,KOTA BAMBU UTARA,24995,5240,19755,15227,34982,2021-11-07
3171041004,JAKARTA PUSAT,SENEN,KRAMAT,28835,6989,21846,16486,38332,2021-11-07
3175041001,JAKARTA TIMUR,KRAMAT JATI,KRAMAT JATI,34144,7603,26541,21450,47991,2021-11-07
3174071003,JAKARTA SELATAN,KEBAYORAN BARU,KRAMAT PELA,14413,2828,11585,9824,21409,2021-11-07
3173031002,JAKARTA BARAT,TAMAN SARI,KRUKUT,19244,3669,15575,12514,28089,2021-11-07
3174031005,JAKARTA SELATAN,MAMPANG PRAPATAN,KUNINGAN BARAT,12785,2379,10406,8610,19016,2021-11-07
3174021008,JAKARTA SELATAN,SETIA BUDI,KUNINGAN TIMUR,6008,1204,4804,4028,8832,2021-11-07
3171041005,JAKARTA PUSAT,SENEN,KWITANG,15486,3525,11961,9599,21560,2021-11-07
3172031003,JAKARTA UTARA,KOJA,LAGOA,59065,14154,44911,35195,80106,2021-11-07
3174061002,JAKARTA SELATAN,CILANDAK,LEBAK BULUS,37626,7171,30455,26306,56761,2021-11-07
3174091004,JAKARTA SELATAN,JAGAKARSA,LENTENG AGUNG,53946,9823,44123,35556,79679,2021-11-07
3175101007,JAKARTA TIMUR,CIPAYUNG,LUBANG BUAYA,63547,12079,51468,42322,93790,2021-11-07
3175081001,JAKARTA TIMUR,MAKASAR,MAKASAR,34390,6404,27986,23386,51372,2021-11-07
3175071006,JAKARTA TIMUR,DUREN SAWIT,MALAKA JAYA,30927,5387,25540,21697,47237,2021-11-07
3175071005,JAKARTA TIMUR,DUREN SAWIT,MALAKA SARI,27530,4643,22887,19540,42427,2021-11-07
3174031001,JAKARTA SELATAN,MAMPANG PRAPATAN,MAMPANG PRAPATAN,18159,3763,14396,11779,26175,2021-11-07
3173031005,JAKARTA BARAT,TAMAN SARI,MANGGA BESAR,7707,1313,6394,5555,11949,2021-11-07
3171021005,JAKARTA PUSAT,SAWAH BESAR,MANGGA DUA SELATAN,27442,5771,21671,18226,39897,2021-11-07
3174011007,JAKARTA SELATAN,TEBET,MANGGARAI,28373,5113,23260,18742,42002,2021-11-07
3174011006,JAKARTA SELATAN,TEBET,MANGGARAI SELATAN,23075,4076,18999,15893,34892,2021-11-07
3173031003,JAKARTA BARAT,TAMAN SARI,MAPHAR,16461,3100,13361,11077,24438,2021-11-07
3172041003,JAKARTA UTARA,CILINCING,MARUNDA,28943,6643,22300,16570,38870,2021-11-07
3174071001,JAKARTA SELATAN,KEBAYORAN BARU,MELAWAI,2627,513,2114,1941,4055,2021-11-07
3171061001,JAKARTA PUSAT,MENTENG,MENTENG,25624,5723,19901,15591,35492,2021-11-07
3174021005,JAKARTA SELATAN,SETIA BUDI,MENTENG ATAS,27816,5074,22742,18746,41488,2021-11-07
3174011003,JAKARTA SELATAN,TEBET,MENTENG DALAM,36028,7081,28947,24238,53185,2021-11-07
3173081003,JAKARTA BARAT,KEMBANGAN,MERUYA SELATAN,32130,6687,25443,21254,46697,2021-11-07
3173081002,JAKARTA BARAT,KEMBANGAN,MERUYA UTARA,43752,9086,34666,29910,64576,2021-11-07
3175101004,JAKARTA TIMUR,CIPAYUNG,MUNJUL,23871,4396,19475,16363,35838,2021-11-07
3172051002,JAKARTA UTARA,PADEMANGAN,PADEMANGAN BARAT,74240,17829,56411,45165,101576,2021-11-07
3172051001,JAKARTA UTARA,PADEMANGAN,PADEMANGAN TIMUR,37736,6762,30974,26934,57908,2021-11-07
3175011004,JAKARTA TIMUR,MATRAMAN,PAL MERIAM,19769,4142,15627,12470,28097,2021-11-07
3173071001,JAKARTA BARAT,PALMERAH,PALMERAH,63011,13394,49617,40054,89671,2021-11-07
3174081001,JAKARTA SELATAN,PANCORAN,PANCORAN,19421,4026,15395,12644,28039,2021-11-07
3172021003,JAKARTA UTARA,TANJUNG PRIOK,PAPANGGO,39097,7763,31334,25484,56818,2021-11-07
3171021001,JAKARTA PUSAT,SAWAH BESAR,PASAR BARU,12035,2319,9716,8628,18344,2021-11-07
3174021006,JAKARTA SELATAN,SETIA BUDI,PASAR MANGGIS,26752,5369,21383,17508,38891,2021-11-07
3174041001,JAKARTA SELATAN,PASAR MINGGU,PASAR MINGGU,24821,4725,20096,17040,37136,2021-11-07
3171041003,JAKARTA PUSAT,SENEN,PASEBAN,23533,4947,18586,15176,33762,2021-11-07
3173061005,JAKARTA BARAT,KALI DERES,PEGADUNGAN,75587,15252,60335,51580,111915,2021-11-07
3171061002,JAKARTA PUSAT,MENTENG,PEGANGSAAN,23455,5096,18359,13988,32347,2021-11-07
3172061002,JAKARTA UTARA,KELAPA GADING,PEGANGSAAN DUA,49976,8318,41658,37480,79138,2021-11-07
3172011004,JAKARTA UTARA,PENJARINGAN,PEJAGALAN,74578,15659,58919,50372,109291,2021-11-07
3174041006,JAKARTA SELATAN,PASAR MINGGU,PEJATEN BARAT,37346,7420,29926,24850,54776,2021-11-07
3174041005,JAKARTA SELATAN,PASAR MINGGU,PEJATEN TIMUR,57656,13170,44486,36411,80897,2021-11-07
3175051005,JAKARTA TIMUR,PASAR REBO,PEKAYON,43250,7940,35310,29136,64446,2021-11-07
3173041009,JAKARTA BARAT,TAMBORA,PEKOJAN,23587,4541,19046,15811,34857,2021-11-07
3174031003,JAKARTA SELATAN,MAMPANG PRAPATAN,PELA MAMPANG,43522,8693,34829,28916,63745,2021-11-07
3174081005,JAKARTA SELATAN,PANCORAN,PENGADEGAN,21478,3985,17493,14782,32275,2021-11-07
3175061003,JAKARTA TIMUR,CAKUNG,PENGGILINGAN,99255,23320,75935,60324,136259,2021-11-07
3172011001,JAKARTA UTARA,PENJARINGAN,PENJARINGAN,88308,22866,65442,50066,115508,2021-11-07
3174101001,JAKARTA SELATAN,PESANGGRAHAN,PESANGGRAHAN,27545,4788,22757,19362,42119,2021-11-07
3171071004,JAKARTA PUSAT,TANAH ABANG,PETAMBURAN,33271,8847,24424,18375,42799,2021-11-07
3174071008,JAKARTA SELATAN,KEBAYORAN BARU,PETOGOGAN,11499,2253,9246,7834,17080,2021-11-07
3171011004,JAKARTA PUSAT,GAMBIR,PETOJO SELATAN,14692,3339,11353,9577,20930,2021-11-07
3171011003,JAKARTA PUSAT,GAMBIR,PETOJO UTARA,17458,3801,13657,11182,24839,2021-11-07
3174101004,JAKARTA SELATAN,PESANGGRAHAN,PETUKANGAN SELATAN,37187,7741,29446,24604,54050,2021-11-07
3174101003,JAKARTA SELATAN,PESANGGRAHAN,PETUKANGAN UTARA,53716,11677,42039,34659,76698,2021-11-07
3175081002,JAKARTA TIMUR,MAKASAR,PINANG RANTI,27198,5978,21220,17396,38616,2021-11-07
3173031008,JAKARTA BARAT,TAMAN SARI,PINANGSIA,10729,1896,8833,7288,16121,2021-11-07
3175011001,JAKARTA TIMUR,MATRAMAN,PISANGAN BARU,31776,6592,25184,19869,45053,2021-11-07
3175021002,JAKARTA TIMUR,PULO GADUNG,PISANGAN TIMUR,41011,7669,33342,28029,61371,2021-11-07
3172011005,JAKARTA UTARA,PENJARINGAN,PLUIT,47783,9245,38538,33598,72136,2021-11-07
3175071002,JAKARTA TIMUR,DUREN SAWIT,PONDOK BAMBU,61550,13167,48383,39432,87815,2021-11-07
3175071004,JAKARTA TIMUR,DUREN SAWIT,PONDOK KELAPA,72015,14397,57618,49057,106675,2021-11-07
3175071007,JAKARTA TIMUR,DUREN SAWIT,PONDOK KOPI,35367,6679,28688,22495,51183,2021-11-07
3174061003,JAKARTA SELATAN,CILANDAK,PONDOK LABU,46464,7965,38499,33237,71736,2021-11-07
3174051002,JAKARTA SELATAN,KEBAYORAN LAMA,PONDOK PINANG,56169,10920,45249,38359,83608,2021-11-07
3175101003,JAKARTA TIMUR,CIPAYUNG,PONDOK RANGGON,25574,4840,20734,17222,37956,2021-11-07
3101011003,KAB.ADM.KEP.SERIBU,KEP. SERIBU UTARA,PULAU HARAPAN,2060,222,1838,1601,3439,2021-11-07
3101011002,KAB.ADM.KEP.SERIBU,KEP. SERIBU UTARA,PULAU KELAPA,5528,607,4921,4054,8975,2021-11-07
3101011001,KAB.ADM.KEP.SERIBU,KEP. SERIBU UTARA,PULAU PANGGANG,5450,443,5007,4463,9470,2021-11-07
3101021003,KAB.ADM.KEP.SERIBU,KEP. SERIBU SELATAN,PULAU PARI,2765,194,2571,2411,4982,2021-11-07
3101021002,KAB.ADM.KEP.SERIBU,KEP. SERIBU SELATAN,PULAU TIDUNG,4553,369,4184,3817,8001,2021-11-07
3101021001,KAB.ADM.KEP.SERIBU,KEP. SERIBU SELATAN,PULAU UNTUNG JAWA,1941,163,1778,1639,3417,2021-11-07
3174071007,JAKARTA SELATAN,KEBAYORAN BARU,PULO,5835,1016,4819,4383,9202,2021-11-07
3175021001,JAKARTA TIMUR,PULO GADUNG,PULO GADUNG,34422,7599,26823,22255,49078,2021-11-07
3175061005,JAKARTA TIMUR,CAKUNG,PULO GEBANG,97301,18958,78343,63242,141585,2021-11-07
3174041004,JAKARTA SELATAN,PASAR MINGGU,RAGUNAN,39616,7426,32190,27214,59404,2021-11-07
3175091005,JAKARTA TIMUR,CIRACAS,RAMBUTAN,36771,8713,28058,22340,50398,2021-11-07
3172031006,JAKARTA UTARA,KOJA,RAWA BADAK SELATAN,42179,10127,32052,25141,57193,2021-11-07
3172031004,JAKARTA UTARA,KOJA,RAWA BADAK UTARA,34408,7786,26622,21178,47800,2021-11-07
3174071005,JAKARTA SELATAN,KEBAYORAN BARU,RAWA BARAT,5625,1007,4618,4072,8690,2021-11-07
3173011003,JAKARTA BARAT,CENGKARENG,RAWA BUAYA,63799,12881,50918,40891,91809,2021-11-07
3175031004,JAKARTA TIMUR,JATINEGARA,RAWA BUNGA,21434,5236,16198,13042,29240,2021-11-07
3174081003,JAKARTA SELATAN,PANCORAN,RAWA JATI,20509,3939,16570,14071,30641,2021-11-07
3175061002,JAKARTA TIMUR,CAKUNG,RAWA TERATE,24637,4516,20121,16307,36428,2021-11-07
3175021005,JAKARTA TIMUR,PULO GADUNG,RAWAMANGUN,37612,7494,30118,25347,55465,2021-11-07
3171051003,JAKARTA PUSAT,CEMPAKA PUTIH,RAWASARI,21967,4514,17453,14762,32215,2021-11-07
3173041010,JAKARTA BARAT,TAMBORA,ROA MALAKA,3484,620,2864,2519,5383,2021-11-07
3172041006,JAKARTA UTARA,CILINCING,ROROTAN,41668,8452,33216,26398,59614,2021-11-07
3174071004,JAKARTA SELATAN,KEBAYORAN BARU,SELONG,2842,549,2293,2106,4399,2021-11-07
3173061002,JAKARTA BARAT,KALI DERES,SEMANAN,71354,15530,55824,44799,100623,2021-11-07
3172041007,JAKARTA UTARA,CILINCING,SEMPER BARAT,68587,13524,55063,45316,100379,2021-11-07
3172041005,JAKARTA UTARA,CILINCING,SEMPER TIMUR,36267,7887,28380,22852,51232,2021-11-07
3174071006,JAKARTA SELATAN,KEBAYORAN BARU,SENAYAN,2771,658,2113,1817,3930,2021-11-07
3171041001,JAKARTA PUSAT,SENEN,SENEN,6804,1472,5332,4417,9749,2021-11-07
3171031004,JAKARTA PUSAT,KEMAYORAN,SERDANG,29668,5950,23718,19609,43327,2021-11-07
3174021001,JAKARTA SELATAN,SETIA BUDI,SETIA BUDI,3023,620,2403,2024,4427,2021-11-07
3175101005,JAKARTA TIMUR,CIPAYUNG,SETU,20572,4120,16452,13203,29655,2021-11-07
3173071002,JAKARTA BARAT,PALMERAH,SLIPI,16591,3023,13568,11313,24881,2021-11-07
3173081004,JAKARTA BARAT,KEMBANGAN,SRENGSENG,45523,10331,35192,29634,64826,2021-11-07
3174091002,JAKARTA SELATAN,JAGAKARSA,SRENGSENG SAWAH,58196,9158,49038,41302,90340,2021-11-07
3173051003,JAKARTA BARAT,KEBON JERUK,SUKABUMI SELATAN,37033,8374,28659,22141,50800,2021-11-07
3173051002,JAKARTA BARAT,KEBON JERUK,SUKABUMI UTARA,38290,9046,29244,22772,52016,2021-11-07
3172041002,JAKARTA UTARA,CILINCING,SUKAPURA,53949,12289,41660,33976,75636,2021-11-07
3171031007,JAKARTA PUSAT,KEMAYORAN,SUMUR BATU,22717,4574,18143,15315,33458,2021-11-07
3172021004,JAKARTA UTARA,TANJUNG PRIOK,SUNGAI BAMBU,29876,6085,23791,19576,43367,2021-11-07
3172021006,JAKARTA UTARA,TANJUNG PRIOK,SUNTER AGUNG,71805,12624,59181,51323,110504,2021-11-07
3172021002,JAKARTA UTARA,TANJUNG PRIOK,SUNTER JAYA,63031,11249,51782,44502,96284,2021-11-07
3175091004,JAKARTA TIMUR,CIRACAS,SUSUKAN,38257,7289,30968,25660,56628,2021-11-07
3173031001,JAKARTA BARAT,TAMAN SARI,TAMAN SARI,14348,2653,11695,9981,21676,2021-11-07
3173041001,JAKARTA BARAT,TAMBORA,TAMBORA,10204,2290,7914,6336,14250,2021-11-07
3173041004,JAKARTA BARAT,TAMBORA,TANAH SEREAL,26387,4543,21844,18279,40123,2021-11-07
3171081004,JAKARTA PUSAT,JOHAR BARU,TANAH TINGGI,37693,7251,30442,24567,55009,2021-11-07
3173031004,JAKARTA BARAT,TAMAN SARI,TANGKI,13324,2220,11104,9316,20420,2021-11-07
3174091005,JAKARTA SELATAN,JAGAKARSA,TANJUNG BARAT,39770,6846,32924,27093,60017,2021-11-07
3173021005,JAKARTA BARAT,GROGOL PETAMBURAN,TANJUNG DUREN SELATAN,25337,4876,20461,17943,38404,2021-11-07
3173021002,JAKARTA BARAT,GROGOL PETAMBURAN,TANJUNG DUREN UTARA,17010,2908,14102,12573,26675,2021-11-07
3172021001,JAKARTA UTARA,TANJUNG PRIOK,TANJUNG PRIOK,34588,7205,27383,22192,49575,2021-11-07
3174011002,JAKARTA SELATAN,TEBET,TEBET BARAT,21194,3488,17706,15493,33199,2021-11-07
3174011001,JAKARTA SELATAN,TEBET,TEBET TIMUR,18199,2955,15244,13652,28896,2021-11-07
3173061003,JAKARTA BARAT,KALI DERES,TEGAL ALUR,83647,17528,66119,54269,120388,2021-11-07
3174031004,JAKARTA SELATAN,MAMPANG PRAPATAN,TEGAL PARANG,32401,7204,25197,19534,44731,2021-11-07
3173021003,JAKARTA BARAT,GROGOL PETAMBURAN,TOMANG,29605,5522,24083,20488,44571,2021-11-07
3172031005,JAKARTA UTARA,KOJA,TUGU SELATAN,39122,8831,30291,24268,54559,2021-11-07
3172031002,JAKARTA UTARA,KOJA,TUGU UTARA,67670,16179,51491,40378,91869,2021-11-07
3175061006,JAKARTA TIMUR,CAKUNG,UJUNG MENTENG,29934,5241,24693,20815,45508,2021-11-07
3174101005,JAKARTA SELATAN,PESANGGRAHAN,ULUJAMI,40544,9239,31305,25610,56915,2021-11-07
3175011006,JAKARTA TIMUR,MATRAMAN,UTAN KAYU SELATAN,33511,6110,27401,22465,49866,2021-11-07
3175011002,JAKARTA TIMUR,MATRAMAN,UTAN KAYU UTARA,28169,5931,22238,18087,40325,2021-11-07
3171031008,JAKARTA PUSAT,KEMAYORAN,UTAN PANJANG,29208,5998,23210,18651,41861,2021-11-07
3172021007,JAKARTA UTARA,TANJUNG PRIOK,WARAKAS,44401,8238,36163,28914,65077,2021-11-07
3173021007,JAKARTA BARAT,GROGOL PETAMBURAN,WIJAYA KUSUMA,38934,8231,30703,25670,56373,2021-11-07
3172051003,JAKARTA UTARA,PADEMANGAN,ANCOL,23947,5859,18088,14774,32862,2021-11-08
3173041007,JAKARTA BARAT,TAMBORA,ANGKE,29381,6309,23072,18564,41636,2021-11-08
3175041005,JAKARTA TIMUR,KRAMAT JATI,BALE KAMBANG,29074,7374,21700,16903,38603,2021-11-08
3175031003,JAKARTA TIMUR,JATINEGARA,BALI MESTER,9752,2077,7675,6437,14112,2021-11-08
3175101006,JAKARTA TIMUR,CIPAYUNG,BAMBU APUS,26285,4901,21384,17671,39055,2021-11-08
3174031002,JAKARTA SELATAN,MAMPANG PRAPATAN,BANGKA,21566,4633,16933,13895,30828,2021-11-08
3175051002,JAKARTA TIMUR,PASAR REBO,BARU,23886,3987,19899,16965,36864,2021-11-08
3175041004,JAKARTA TIMUR,KRAMAT JATI,BATU AMPAR,47898,11798,36100,28721,64821,2021-11-08
3171071002,JAKARTA PUSAT,TANAH ABANG,BENDUNGAN HILIR,21494,4379,17115,14487,31602,2021-11-08
3175031002,JAKARTA TIMUR,JATINEGARA,BIDARA CINA,36689,8892,27797,22048,49845,2021-11-08
3174101002,JAKARTA SELATAN,PESANGGRAHAN,BINTARO,53098,10764,42334,36100,78434,2021-11-08
3174011005,JAKARTA SELATAN,TEBET,BUKIT DURI,34183,7019,27164,22453,49617,2021-11-08
3171041006,JAKARTA PUSAT,SENEN,BUNGUR,18144,3850,14294,11784,26078,2021-11-08
3175061007,JAKARTA TIMUR,CAKUNG,CAKUNG BARAT,57724,11972,45752,37467,83219,2021-11-08
3175061004,JAKARTA TIMUR,CAKUNG,CAKUNG TIMUR,58287,11629,46658,38482,85140,2021-11-08
3175041007,JAKARTA TIMUR,KRAMAT JATI,CAWANG,32762,7188,25574,20289,45863,2021-11-08
3175101008,JAKARTA TIMUR,CIPAYUNG,CEGER,18932,3760,15172,12579,27751,2021-11-08
3171031006,JAKARTA PUSAT,KEMAYORAN,CEMPAKA BARU,32581,6291,26290,20425,46715,2021-11-08
3171051002,JAKARTA PUSAT,CEMPAKA PUTIH,CEMPAKA PUTIH BARAT,35885,7737,28148,23815,51963,2021-11-08
3171051001,JAKARTA PUSAT,CEMPAKA PUTIH,CEMPAKA PUTIH TIMUR,24292,5051,19241,16639,35880,2021-11-08
3173011001,JAKARTA BARAT,CENGKARENG,CENGKARENG BARAT,66284,13431,52853,44396,97249,2021-11-08
3173011006,JAKARTA BARAT,CENGKARENG,CENGKARENG TIMUR,81027,16182,64845,53266,118111,2021-11-08
3175091002,JAKARTA TIMUR,CIRACAS,CIBUBUR,66364,11534,54830,45669,100499,2021-11-08
3171011002,JAKARTA PUSAT,GAMBIR,CIDENG,15390,3034,12356,10698,23054,2021-11-08
3174091003,JAKARTA SELATAN,JAGAKARSA,CIGANJUR,38497,6691,31806,25919,57725,2021-11-08
3175051003,JAKARTA TIMUR,PASAR REBO,CIJANTUNG,41419,7790,33629,27769,61398,2021-11-08
3171061003,JAKARTA PUSAT,MENTENG,CIKINI,8274,1503,6771,5292,12063,2021-11-08
3174081006,JAKARTA SELATAN,PANCORAN,CIKOKO,10547,1854,8693,7489,16182,2021-11-08
3174061001,JAKARTA SELATAN,CILANDAK,CILANDAK BARAT,51752,9272,42480,36637,79117,2021-11-08
3174041003,JAKARTA SELATAN,PASAR MINGGU,CILANDAK TIMUR,25145,4675,20470,17284,37754,2021-11-08
3175101002,JAKARTA TIMUR,CIPAYUNG,CILANGKAP,27635,4957,22678,19047,41725,2021-11-08
3175041006,JAKARTA TIMUR,KRAMAT JATI,CILILITAN,40181,8951,31230,25239,56469,2021-11-08
3172041001,JAKARTA UTARA,CILINCING,CILINCING,43609,10573,33036,25394,58430,2021-11-08
3175101001,JAKARTA TIMUR,CIPAYUNG,CIPAYUNG,26104,4611,21493,18309,39802,2021-11-08
3174091006,JAKARTA SELATAN,JAGAKARSA,CIPEDAK,38303,6419,31884,26569,58453,2021-11-08
3174061005,JAKARTA SELATAN,CILANDAK,CIPETE SELATAN,26704,5202,21502,18708,40210,2021-11-08
3174071010,JAKARTA SELATAN,KEBAYORAN BARU,CIPETE UTARA,34102,6586,27516,22569,50085,2021-11-08
3175021003,JAKARTA TIMUR,PULO GADUNG,CIPINANG,39306,7397,31909,26347,58256,2021-11-08
3175031007,JAKARTA TIMUR,JATINEGARA,CIPINANG BESAR SELATAN,35212,8439,26773,20738,47511,2021-11-08
3175031008,JAKARTA TIMUR,JATINEGARA,CIPINANG BESAR UTARA,45319,10827,34492,26587,61079,2021-11-08
3175031005,JAKARTA TIMUR,JATINEGARA,CIPINANG CEMPEDAK,32824,7183,25641,21518,47159,2021-11-08
3175081005,JAKARTA TIMUR,MAKASAR,CIPINANG MELAYU,42308,8262,34046,28602,62648,2021-11-08
3175031006,JAKARTA TIMUR,JATINEGARA,CIPINANG MUARA,55243,11969,43274,34871,78145,2021-11-08
3174051003,JAKARTA SELATAN,KEBAYORAN LAMA,CIPULIR,39937,8529,31408,25206,56614,2021-11-08
3175091001,JAKARTA TIMUR,CIRACAS,CIRACAS,64594,11985,52609,43088,95697,2021-11-08
3175041003,JAKARTA TIMUR,KRAMAT JATI,DUKUH,24609,4712,19897,16315,36212,2021-11-08
3175071001,JAKARTA TIMUR,DUREN SAWIT,DUREN SAWIT,61160,13036,48124,39133,87257,2021-11-08
3174081004,JAKARTA SELATAN,PANCORAN,DUREN TIGA,28319,5730,22589,18793,41382,2021-11-08
3173051005,JAKARTA BARAT,KEBON JERUK,DURI KEPA,60138,11884,48254,41365,89619,2021-11-08
3173011002,JAKARTA BARAT,CENGKARENG,DURI KOSAMBI,77923,16923,61000,48430,109430,2021-11-08
3171011006,JAKARTA PUSAT,GAMBIR,DURI PULO,19610,4195,15415,12319,27734,2021-11-08
3173041011,JAKARTA BARAT,TAMBORA,DURI SELATAN,14259,2575,11684,9805,21489,2021-11-08
3173041003,JAKARTA BARAT,TAMBORA,DURI UTARA,19844,3637,16207,13254,29461,2021-11-08
3171081003,JAKARTA PUSAT,JOHAR BARU,GALUR,18243,3618,14625,11712,26337,2021-11-08
3171011001,JAKARTA PUSAT,GAMBIR,GAMBIR,2191,458,1733,1495,3228,2021-11-08
3174061004,JAKARTA SELATAN,CILANDAK,GANDARIA SELATAN,22119,4298,17821,15043,32864,2021-11-08
3174071009,JAKARTA SELATAN,KEBAYORAN BARU,GANDARIA UTARA,39922,8056,31866,26530,58396,2021-11-08
3175051001,JAKARTA TIMUR,PASAR REBO,GEDONG,35755,7264,28491,23894,52385,2021-11-08
3171071001,JAKARTA PUSAT,TANAH ABANG,GELORA,3127,618,2509,2144,4653,2021-11-08
3173031007,JAKARTA BARAT,TAMAN SARI,GLODOK,7837,1208,6629,5887,12516,2021-11-08
3171061004,JAKARTA PUSAT,MENTENG,GONDANGDIA,4100,928,3172,2883,6055,2021-11-08
3173021001,JAKARTA BARAT,GROGOL PETAMBURAN,GROGOL,16876,3419,13457,11270,24727,2021-11-08
3174051005,JAKARTA SELATAN,KEBAYORAN LAMA,GROGOL SELATAN,44251,8909,35342,28760,64102,2021-11-08
3174051004,JAKARTA SELATAN,KEBAYORAN LAMA,GROGOL UTARA,42494,8757,33737,27704,61441,2021-11-08
3174021007,JAKARTA SELATAN,SETIA BUDI,GUNTUR,3985,750,3235,2828,6063,2021-11-08
3174071002,JAKARTA SELATAN,KEBAYORAN BARU,GUNUNG,9436,1760,7676,6767,14443,2021-11-08
3171031005,JAKARTA PUSAT,KEMAYORAN,GUNUNG SAHARI SELATAN,19199,3934,15265,12766,28031,2021-11-08
3171021004,JAKARTA PUSAT,SAWAH BESAR,GUNUNG SAHARI UTARA,16650,2973,13677,12124,25801,2021-11-08
3175081004,JAKARTA TIMUR,MAKASAR,HALIM PERDANA KUSUMAH,28363,3733,24630,22378,47008,2021-11-08
3171031003,JAKARTA PUSAT,KEMAYORAN,HARAPAN MULIA,22557,4611,17946,14469,32415,2021-11-08
3174091001,JAKARTA SELATAN,JAGAKARSA,JAGAKARSA,62389,10443,51946,42615,94561,2021-11-08
3175021007,JAKARTA TIMUR,PULO GADUNG,JATI,32757,6179,26578,22778,49356,2021-11-08
3174041002,JAKARTA SELATAN,PASAR MINGGU,JATI PADANG,37502,7555,29947,25013,54960,2021-11-08
3173071004,JAKARTA BARAT,PALMERAH,JATI PULO,28738,5797,22941,18195,41136,2021-11-08
3175061001,JAKARTA TIMUR,CAKUNG,JATINEGARA,84160,18146,66014,53805,119819,2021-11-08
3175021004,JAKARTA TIMUR,PULO GADUNG,JATINEGARA KAUM,24632,4445,20187,16284,36471,2021-11-08
3173021004,JAKARTA BARAT,GROGOL PETAMBURAN,JELAMBAR,30266,5584,24682,21320,46002,2021-11-08
3173021006,JAKARTA BARAT,GROGOL PETAMBURAN,JELAMBAR BARU,38246,7192,31054,26751,57805,2021-11-08
3173041006,JAKARTA BARAT,TAMBORA,JEMBATAN BESI,29314,7188,22126,17100,39226,2021-11-08
3173041008,JAKARTA BARAT,TAMBORA,JEMBATAN LIMA,21021,4916,16105,12608,28713,2021-11-08
3173081005,JAKARTA BARAT,KEMBANGAN,JOGLO,40839,8431,32408,27322,59730,2021-11-08
3171081001,JAKARTA PUSAT,JOHAR BARU,JOHAR BARU,37488,7010,30478,25559,56037,2021-11-08
3173041002,JAKARTA BARAT,TAMBORA,KALI ANYAR,23856,4778,19078,15088,34166,2021-11-08
3172041004,JAKARTA UTARA,CILINCING,KALIBARU,67684,18797,48887,34567,83454,2021-11-08
3174081002,JAKARTA SELATAN,PANCORAN,KALIBATA,41994,9689,32305,25993,58298,2021-11-08
3173061001,JAKARTA BARAT,KALI DERES,KALIDERES,72447,14875,57572,48387,105959,2021-11-08
3175051004,JAKARTA TIMUR,PASAR REBO,KALISARI,43212,7835,35377,29476,64853,2021-11-08
3173061004,JAKARTA BARAT,KALI DERES,KAMAL,53783,12692,41091,32324,73415,2021-11-08
3172011002,JAKARTA UTARA,PENJARINGAN,KAMAL MUARA,12930,2304,10626,9018,19644,2021-11-08
3171071007,JAKARTA PUSAT,TANAH ABANG,KAMPUNG BALI,11358,2485,8873,6754,15627,2021-11-08
3175031001,JAKARTA TIMUR,JATINEGARA,KAMPUNG MELAYU,25717,5933,19784,15333,35117,2021-11-08
3171081002,JAKARTA PUSAT,JOHAR BARU,KAMPUNG RAWA,21237,3550,17687,14062,31749,2021-11-08
3175041002,JAKARTA TIMUR,KRAMAT JATI,KAMPUNG TENGAH,43993,11181,32812,25962,58774,2021-11-08
3173011005,JAKARTA BARAT,CENGKARENG,KAPUK,134466,32855,101611,81415,183026,2021-11-08
3172011003,JAKARTA UTARA,PENJARINGAN,KAPUK MUARA,35781,6928,28853,25120,53973,2021-11-08
3171021002,JAKARTA PUSAT,SAWAH BESAR,KARANG ANYAR,25761,5018,20743,17358,38101,2021-11-08
3174021004,JAKARTA SELATAN,SETIA BUDI,KARET,9623,1864,7759,6415,14174,2021-11-08
3174021003,JAKARTA SELATAN,SETIA BUDI,KARET KUNINGAN,16055,3166,12889,10842,23731,2021-11-08
3174021002,JAKARTA SELATAN,SETIA BUDI,KARET SEMANGGI,2770,556,2214,1955,4169,2021-11-08
3171071003,JAKARTA PUSAT,TANAH ABANG,KARET TENGSIN,19271,3753,15518,12532,28050,2021-11-08
3171021003,JAKARTA PUSAT,SAWAH BESAR,KARTINI,22292,4274,18018,15361,33379,2021-11-08
3175011003,JAKARTA TIMUR,MATRAMAN,KAYU MANIS,25284,5399,19885,15703,35588,2021-11-08
3175021006,JAKARTA TIMUR,PULO GADUNG,KAYU PUTIH,40696,7761,32935,28602,61537,2021-11-08
3173031006,JAKARTA BARAT,TAMAN SARI,KEAGUNGAN,17387,3272,14115,11446,25561,2021-11-08
3174041007,JAKARTA SELATAN,PASAR MINGGU,KEBAGUSAN,44552,8952,35600,29139,64739,2021-11-08
3174051006,JAKARTA SELATAN,KEBAYORAN LAMA,KEBAYORAN LAMA SELATAN,41212,7776,33436,27963,61399,2021-11-08
3174051001,JAKARTA SELATAN,KEBAYORAN LAMA,KEBAYORAN LAMA UTARA,42422,8944,33478,27222,60700,2021-11-08
3174011004,JAKARTA SELATAN,TEBET,KEBON BARU,35165,6710,28455,23702,52157,2021-11-08
3172021005,JAKARTA UTARA,TANJUNG PRIOK,KEBON BAWANG,50952,10427,40525,33449,73974,2021-11-08
3173051001,JAKARTA BARAT,KEBON JERUK,KEBON JERUK,53887,11701,42186,34294,76480,2021-11-08
3171071006,JAKARTA PUSAT,TANAH ABANG,KEBON KACANG,21531,5185,16346,12813,29159,2021-11-08
3171011005,JAKARTA PUSAT,GAMBIR,KEBON KELAPA,10163,2056,8107,6776,14883,2021-11-08
3171031002,JAKARTA PUSAT,KEMAYORAN,KEBON KOSONG,30019,6053,23966,19402,43368,2021-11-08
3175011005,JAKARTA TIMUR,MATRAMAN,KEBON MANGGIS,16490,3262,13228,10901,24129,2021-11-08
3171071005,JAKARTA PUSAT,TANAH ABANG,KEBON MELATI,32206,8673,23533,17295,40828,2021-11-08
3175081003,JAKARTA TIMUR,MAKASAR,KEBON PALA,46614,9286,37328,30853,68181,2021-11-08
3171061005,JAKARTA PUSAT,MENTENG,KEBON SIRIH,12299,2682,9617,7677,17294,2021-11-08
3173011004,JAKARTA BARAT,CENGKARENG,KEDAUNG KALI ANGKE,32612,6391,26221,21865,48086,2021-11-08
3173051007,JAKARTA BARAT,KEBON JERUK,KEDOYA SELATAN,32165,5931,26234,21568,47802,2021-11-08
3173051006,JAKARTA BARAT,KEBON JERUK,KEDOYA UTARA,45740,8770,36970,31101,68071,2021-11-08
3173051004,JAKARTA BARAT,KEBON JERUK,KELAPA DUA,23565,4780,18785,15610,34395,2021-11-08
3175091003,JAKARTA TIMUR,CIRACAS,KELAPA DUA WETAN,46875,8088,38787,32373,71160,2021-11-08
3172061003,JAKARTA UTARA,KELAPA GADING,KELAPA GADING BARAT,35717,6277,29440,26375,55815,2021-11-08
3172061001,JAKARTA UTARA,KELAPA GADING,KELAPA GADING TIMUR,33592,5181,28411,26115,54526,2021-11-08
3173071005,JAKARTA BARAT,PALMERAH,KEMANGGISAN,32139,6136,26003,21609,47612,2021-11-08
3171031001,JAKARTA PUSAT,KEMAYORAN,KEMAYORAN,20708,4248,16460,13452,29912,2021-11-08
3173081006,JAKARTA BARAT,KEMBANGAN,KEMBANGAN SELATAN,27130,5746,21384,18366,39750,2021-11-08
3173081001,JAKARTA BARAT,KEMBANGAN,KEMBANGAN UTARA,54451,12076,42375,35060,77435,2021-11-08
3171041002,JAKARTA PUSAT,SENEN,KENARI,9579,1879,7700,6519,14219,2021-11-08
3173041005,JAKARTA BARAT,TAMBORA,KERENDANG,19973,4133,15840,12773,28613,2021-11-08
3175071003,JAKARTA TIMUR,DUREN SAWIT,KLENDER,69978,16582,53396,42081,95477,2021-11-08
3172031001,JAKARTA UTARA,KOJA,KOJA,28175,6483,21692,17387,39079,2021-11-08
3173071006,JAKARTA BARAT,PALMERAH,KOTA BAMBU SELATAN,21158,4214,16944,13099,30043,2021-11-08
3173071003,JAKARTA BARAT,PALMERAH,KOTA BAMBU UTARA,24995,5235,19760,15237,34997,2021-11-08
3171041004,JAKARTA PUSAT,SENEN,KRAMAT,28835,6985,21850,16489,38339,2021-11-08
3175041001,JAKARTA TIMUR,KRAMAT JATI,KRAMAT JATI,34144,7595,26549,21455,48004,2021-11-08
3174071003,JAKARTA SELATAN,KEBAYORAN BARU,KRAMAT PELA,14413,2827,11586,9830,21416,2021-11-08
3173031002,JAKARTA BARAT,TAMAN SARI,KRUKUT,19244,3666,15578,12521,28099,2021-11-08
3174031005,JAKARTA SELATAN,MAMPANG PRAPATAN,KUNINGAN BARAT,12785,2376,10409,8613,19022,2021-11-08
3174021008,JAKARTA SELATAN,SETIA BUDI,KUNINGAN TIMUR,6008,1204,4804,4032,8836,2021-11-08
3171041005,JAKARTA PUSAT,SENEN,KWITANG,15486,3523,11963,9601,21564,2021-11-08
3172031003,JAKARTA UTARA,KOJA,LAGOA,59065,14139,44926,35202,80128,2021-11-08
3174061002,JAKARTA SELATAN,CILANDAK,LEBAK BULUS,37626,7166,30460,26331,56791,2021-11-08
3174091004,JAKARTA SELATAN,JAGAKARSA,LENTENG AGUNG,53946,9818,44128,35572,79700,2021-11-08
3175101007,JAKARTA TIMUR,CIPAYUNG,LUBANG BUAYA,63547,12072,51475,42331,93806,2021-11-08
3175081001,JAKARTA TIMUR,MAKASAR,MAKASAR,34390,6398,27992,23397,51389,2021-11-08
3175071006,JAKARTA TIMUR,DUREN SAWIT,MALAKA JAYA,30927,5377,25550,21740,47290,2021-11-08
3175071005,JAKARTA TIMUR,DUREN SAWIT,MALAKA SARI,27530,4641,22889,19559,42448,2021-11-08
3174031001,JAKARTA SELATAN,MAMPANG PRAPATAN,MAMPANG PRAPATAN,18159,3762,14397,11786,26183,2021-11-08
3173031005,JAKARTA BARAT,TAMAN SARI,MANGGA BESAR,7707,1308,6399,5562,11961,2021-11-08
3171021005,JAKARTA PUSAT,SAWAH BESAR,MANGGA DUA SELATAN,27442,5765,21677,18235,39912,2021-11-08
3174011007,JAKARTA SELATAN,TEBET,MANGGARAI,28373,5113,23260,18748,42008,2021-11-08
3174011006,JAKARTA SELATAN,TEBET,MANGGARAI SELATAN,23075,4071,19004,15899,34903,2021-11-08
3173031003,JAKARTA BARAT,TAMAN SARI,MAPHAR,16461,3098,13363,11086,24449,2021-11-08
3172041003,JAKARTA UTARA,CILINCING,MARUNDA,28943,6639,22304,16572,38876,2021-11-08
3174071001,JAKARTA SELATAN,KEBAYORAN BARU,MELAWAI,2627,512,2115,1942,4057,2021-11-08
3171061001,JAKARTA PUSAT,MENTENG,MENTENG,25624,5721,19903,15592,35495,2021-11-08
3174021005,JAKARTA SELATAN,SETIA BUDI,MENTENG ATAS,27816,5073,22743,18758,41501,2021-11-08
3174011003,JAKARTA SELATAN,TEBET,MENTENG DALAM,36028,7079,28949,24246,53195,2021-11-08
3173081003,JAKARTA BARAT,KEMBANGAN,MERUYA SELATAN,32130,6682,25448,21264,46712,2021-11-08
3173081002,JAKARTA BARAT,KEMBANGAN,MERUYA UTARA,43752,9074,34678,29925,64603,2021-11-08
3175101004,JAKARTA TIMUR,CIPAYUNG,MUNJUL,23871,4394,19477,16368,35845,2021-11-08
3172051002,JAKARTA UTARA,PADEMANGAN,PADEMANGAN BARAT,74240,17807,56433,45190,101623,2021-11-08
3172051001,JAKARTA UTARA,PADEMANGAN,PADEMANGAN TIMUR,37736,6756,30980,26957,57937,2021-11-08
3175011004,JAKARTA TIMUR,MATRAMAN,PAL MERIAM,19769,4132,15637,12490,28127,2021-11-08
3173071001,JAKARTA BARAT,PALMERAH,PALMERAH,63011,13381,49630,40071,89701,2021-11-08
3174081001,JAKARTA SELATAN,PANCORAN,PANCORAN,19421,4020,15401,12651,28052,2021-11-08
3172021003,JAKARTA UTARA,TANJUNG PRIOK,PAPANGGO,39097,7759,31338,25496,56834,2021-11-08
3171021001,JAKARTA PUSAT,SAWAH BESAR,PASAR BARU,12035,2317,9718,8634,18352,2021-11-08
3174021006,JAKARTA SELATAN,SETIA BUDI,PASAR MANGGIS,26752,5364,21388,17511,38899,2021-11-08
3174041001,JAKARTA SELATAN,PASAR MINGGU,PASAR MINGGU,24821,4723,20098,17051,37149,2021-11-08
3171041003,JAKARTA PUSAT,SENEN,PASEBAN,23533,4943,18590,15182,33772,2021-11-08
3173061005,JAKARTA BARAT,KALI DERES,PEGADUNGAN,75587,15225,60362,51631,111993,2021-11-08
3171061002,JAKARTA PUSAT,MENTENG,PEGANGSAAN,23455,5092,18363,13991,32354,2021-11-08
3172061002,JAKARTA UTARA,KELAPA GADING,PEGANGSAAN DUA,49976,8311,41665,37498,79163,2021-11-08
3172011004,JAKARTA UTARA,PENJARINGAN,PEJAGALAN,74578,15648,58930,50409,109339,2021-11-08
3174041006,JAKARTA SELATAN,PASAR MINGGU,PEJATEN BARAT,37346,7416,29930,24860,54790,2021-11-08
3174041005,JAKARTA SELATAN,PASAR MINGGU,PEJATEN TIMUR,57656,13159,44497,36469,80966,2021-11-08
3175051005,JAKARTA TIMUR,PASAR REBO,PEKAYON,43250,7935,35315,29150,64465,2021-11-08
3173041009,JAKARTA BARAT,TAMBORA,PEKOJAN,23587,4538,19049,15818,34867,2021-11-08
3174031003,JAKARTA SELATAN,MAMPANG PRAPATAN,PELA MAMPANG,43522,8683,34839,28939,63778,2021-11-08
3174081005,JAKARTA SELATAN,PANCORAN,PENGADEGAN,21478,3984,17494,14787,32281,2021-11-08
3175061003,JAKARTA TIMUR,CAKUNG,PENGGILINGAN,99255,23312,75943,60350,136293,2021-11-08
3172011001,JAKARTA UTARA,PENJARINGAN,PENJARINGAN,88308,22829,65479,50109,115588,2021-11-08
3174101001,JAKARTA SELATAN,PESANGGRAHAN,PESANGGRAHAN,27545,4788,22757,19366,42123,2021-11-08
3171071004,JAKARTA PUSAT,TANAH ABANG,PETAMBURAN,33271,8842,24429,18384,42813,2021-11-08
3174071008,JAKARTA SELATAN,KEBAYORAN BARU,PETOGOGAN,11499,2250,9249,7840,17089,2021-11-08
3171011004,JAKARTA PUSAT,GAMBIR,PETOJO SELATAN,14692,3339,11353,9583,20936,2021-11-08
3171011003,JAKARTA PUSAT,GAMBIR,PETOJO UTARA,17458,3796,13662,11196,24858,2021-11-08
3174101004,JAKARTA SELATAN,PESANGGRAHAN,PETUKANGAN SELATAN,37187,7733,29454,24616,54070,2021-11-08
3174101003,JAKARTA SELATAN,PESANGGRAHAN,PETUKANGAN UTARA,53716,11667,42049,34672,76721,2021-11-08
3175081002,JAKARTA TIMUR,MAKASAR,PINANG RANTI,27198,5976,21222,17402,38624,2021-11-08
3173031008,JAKARTA BARAT,TAMAN SARI,PINANGSIA,10729,1896,8833,7291,16124,2021-11-08
3175011001,JAKARTA TIMUR,MATRAMAN,PISANGAN BARU,31776,6582,25194,19883,45077,2021-11-08
3175021002,JAKARTA TIMUR,PULO GADUNG,PISANGAN TIMUR,41011,7664,33347,28042,61389,2021-11-08
3172011005,JAKARTA UTARA,PENJARINGAN,PLUIT,47783,9237,38546,33610,72156,2021-11-08
3175071002,JAKARTA TIMUR,DUREN SAWIT,PONDOK BAMBU,61550,13153,48397,39451,87848,2021-11-08
3175071004,JAKARTA TIMUR,DUREN SAWIT,PONDOK KELAPA,72015,14387,57628,49088,106716,2021-11-08
3175071007,JAKARTA TIMUR,DUREN SAWIT,PONDOK KOPI,35367,6675,28692,22525,51217,2021-11-08
3174061003,JAKARTA SELATAN,CILANDAK,PONDOK LABU,46464,7956,38508,33258,71766,2021-11-08
3174051002,JAKARTA SELATAN,KEBAYORAN LAMA,PONDOK PINANG,56169,10908,45261,38381,83642,2021-11-08
3175101003,JAKARTA TIMUR,CIPAYUNG,PONDOK RANGGON,25574,4836,20738,17223,37961,2021-11-08
3101011003,KAB.ADM.KEP.SERIBU,KEP. SERIBU UTARA,PULAU HARAPAN,2060,222,1838,1601,3439,2021-11-08
3101011002,KAB.ADM.KEP.SERIBU,KEP. SERIBU UTARA,PULAU KELAPA,5528,607,4921,4055,8976,2021-11-08
3101011001,KAB.ADM.KEP.SERIBU,KEP. SERIBU UTARA,PULAU PANGGANG,5450,443,5007,4463,9470,2021-11-08
3101021003,KAB.ADM.KEP.SERIBU,KEP. SERIBU SELATAN,PULAU PARI,2765,193,2572,2416,4988,2021-11-08
3101021002,KAB.ADM.KEP.SERIBU,KEP. SERIBU SELATAN,PULAU TIDUNG,4553,369,4184,3817,8001,2021-11-08
3101021001,KAB.ADM.KEP.SERIBU,KEP. SERIBU SELATAN,PULAU UNTUNG JAWA,1941,163,1778,1639,3417,2021-11-08
3174071007,JAKARTA SELATAN,KEBAYORAN BARU,PULO,5835,1015,4820,4390,9210,2021-11-08
3175021001,JAKARTA TIMUR,PULO GADUNG,PULO GADUNG,34422,7597,26825,22263,49088,2021-11-08
3175061005,JAKARTA TIMUR,CAKUNG,PULO GEBANG,97301,18949,78352,63267,141619,2021-11-08
3174041004,JAKARTA SELATAN,PASAR MINGGU,RAGUNAN,39616,7417,32199,27232,59431,2021-11-08
3175091005,JAKARTA TIMUR,CIRACAS,RAMBUTAN,36771,8705,28066,22354,50420,2021-11-08
3172031006,JAKARTA UTARA,KOJA,RAWA BADAK SELATAN,42179,10121,32058,25148,57206,2021-11-08
3172031004,JAKARTA UTARA,KOJA,RAWA BADAK UTARA,34408,7784,26624,21181,47805,2021-11-08
3174071005,JAKARTA SELATAN,KEBAYORAN BARU,RAWA BARAT,5625,1006,4619,4075,8694,2021-11-08
3173011003,JAKARTA BARAT,CENGKARENG,RAWA BUAYA,63799,12869,50930,40917,91847,2021-11-08
3175031004,JAKARTA TIMUR,JATINEGARA,RAWA BUNGA,21434,5236,16198,13053,29251,2021-11-08
3174081003,JAKARTA SELATAN,PANCORAN,RAWA JATI,20509,3937,16572,14078,30650,2021-11-08
3175061002,JAKARTA TIMUR,CAKUNG,RAWA TERATE,24637,4514,20123,16320,36443,2021-11-08
3175021005,JAKARTA TIMUR,PULO GADUNG,RAWAMANGUN,37612,7488,30124,25355,55479,2021-11-08
3171051003,JAKARTA PUSAT,CEMPAKA PUTIH,RAWASARI,21967,4514,17453,14768,32221,2021-11-08
3173041010,JAKARTA BARAT,TAMBORA,ROA MALAKA,3484,620,2864,2519,5383,2021-11-08
3172041006,JAKARTA UTARA,CILINCING,ROROTAN,41668,8449,33219,26402,59621,2021-11-08
3174071004,JAKARTA SELATAN,KEBAYORAN BARU,SELONG,2842,548,2294,2107,4401,2021-11-08
3173061002,JAKARTA BARAT,KALI DERES,SEMANAN,71354,15526,55828,44823,100651,2021-11-08
3172041007,JAKARTA UTARA,CILINCING,SEMPER BARAT,68587,13521,55066,45332,100398,2021-11-08
3172041005,JAKARTA UTARA,CILINCING,SEMPER TIMUR,36267,7884,28383,22857,51240,2021-11-08
3174071006,JAKARTA SELATAN,KEBAYORAN BARU,SENAYAN,2771,657,2114,1817,3931,2021-11-08
3171041001,JAKARTA PUSAT,SENEN,SENEN,6804,1469,5335,4421,9756,2021-11-08
3171031004,JAKARTA PUSAT,KEMAYORAN,SERDANG,29668,5944,23724,19625,43349,2021-11-08
3174021001,JAKARTA SELATAN,SETIA BUDI,SETIA BUDI,3023,620,2403,2027,4430,2021-11-08
3175101005,JAKARTA TIMUR,CIPAYUNG,SETU,20572,4117,16455,13210,29665,2021-11-08
3173071002,JAKARTA BARAT,PALMERAH,SLIPI,16591,3018,13573,11314,24887,2021-11-08
3173081004,JAKARTA BARAT,KEMBANGAN,SRENGSENG,45523,10323,35200,29647,64847,2021-11-08
3174091002,JAKARTA SELATAN,JAGAKARSA,SRENGSENG SAWAH,58196,9155,49041,41314,90355,2021-11-08
3173051003,JAKARTA BARAT,KEBON JERUK,SUKABUMI SELATAN,37033,8368,28665,22169,50834,2021-11-08
3173051002,JAKARTA BARAT,KEBON JERUK,SUKABUMI UTARA,38290,9038,29252,22806,52058,2021-11-08
3172041002,JAKARTA UTARA,CILINCING,SUKAPURA,53949,12273,41676,33986,75662,2021-11-08
3171031007,JAKARTA PUSAT,KEMAYORAN,SUMUR BATU,22717,4571,18146,15327,33473,2021-11-08
3172021004,JAKARTA UTARA,TANJUNG PRIOK,SUNGAI BAMBU,29876,6081,23795,19584,43379,2021-11-08
3172021006,JAKARTA UTARA,TANJUNG PRIOK,SUNTER AGUNG,71805,12616,59189,51351,110540,2021-11-08
3172021002,JAKARTA UTARA,TANJUNG PRIOK,SUNTER JAYA,63031,11244,51787,44524,96311,2021-11-08
3175091004,JAKARTA TIMUR,CIRACAS,SUSUKAN,38257,7283,30974,25678,56652,2021-11-08
3173031001,JAKARTA BARAT,TAMAN SARI,TAMAN SARI,14348,2651,11697,9986,21683,2021-11-08
3173041001,JAKARTA BARAT,TAMBORA,TAMBORA,10204,2288,7916,6345,14261,2021-11-08
3173041004,JAKARTA BARAT,TAMBORA,TANAH SEREAL,26387,4538,21849,18284,40133,2021-11-08
3171081004,JAKARTA PUSAT,JOHAR BARU,TANAH TINGGI,37693,7244,30449,24576,55025,2021-11-08
3173031004,JAKARTA BARAT,TAMAN SARI,TANGKI,13324,2218,11106,9320,20426,2021-11-08
3174091005,JAKARTA SELATAN,JAGAKARSA,TANJUNG BARAT,39770,6841,32929,27108,60037,2021-11-08
3173021005,JAKARTA BARAT,GROGOL PETAMBURAN,TANJUNG DUREN SELATAN,25337,4870,20467,17954,38421,2021-11-08
3173021002,JAKARTA BARAT,GROGOL PETAMBURAN,TANJUNG DUREN UTARA,17010,2907,14103,12575,26678,2021-11-08
3172021001,JAKARTA UTARA,TANJUNG PRIOK,TANJUNG PRIOK,34588,7200,27388,22213,49601,2021-11-08
3174011002,JAKARTA SELATAN,TEBET,TEBET BARAT,21194,3482,17712,15503,33215,2021-11-08
3174011001,JAKARTA SELATAN,TEBET,TEBET TIMUR,18199,2953,15246,13657,28903,2021-11-08
3173061003,JAKARTA BARAT,KALI DERES,TEGAL ALUR,83647,17518,66129,54315,120444,2021-11-08
3174031004,JAKARTA SELATAN,MAMPANG PRAPATAN,TEGAL PARANG,32401,7195,25206,19570,44776,2021-11-08
3173021003,JAKARTA BARAT,GROGOL PETAMBURAN,TOMANG,29605,5519,24086,20499,44585,2021-11-08
3172031005,JAKARTA UTARA,KOJA,TUGU SELATAN,39122,8826,30296,24276,54572,2021-11-08
3172031002,JAKARTA UTARA,KOJA,TUGU UTARA,67670,16141,51529,40402,91931,2021-11-08
3175061006,JAKARTA TIMUR,CAKUNG,UJUNG MENTENG,29934,5237,24697,20828,45525,2021-11-08
3174101005,JAKARTA SELATAN,PESANGGRAHAN,ULUJAMI,40544,9234,31310,25626,56936,2021-11-08
3175011006,JAKARTA TIMUR,MATRAMAN,UTAN KAYU SELATAN,33511,6105,27406,22482,49888,2021-11-08
3175011002,JAKARTA TIMUR,MATRAMAN,UTAN KAYU UTARA,28169,5912,22257,18113,40370,2021-11-08
3171031008,JAKARTA PUSAT,KEMAYORAN,UTAN PANJANG,29208,5994,23214,18668,41882,2021-11-08
3172021007,JAKARTA UTARA,TANJUNG PRIOK,WARAKAS,44401,8234,36167,28923,65090,2021-11-08
3173021007,JAKARTA BARAT,GROGOL PETAMBURAN,WIJAYA KUSUMA,38934,8226,30708,25682,56390,2021-11-08
3172051003,JAKARTA UTARA,PADEMANGAN,ANCOL,23947,5838,18109,14818,32927,2021-11-09
3173041007,JAKARTA BARAT,TAMBORA,ANGKE,29381,6288,23093,18613,41706,2021-11-09
3175041005,JAKARTA TIMUR,KRAMAT JATI,BALE KAMBANG,29074,7338,21736,16999,38735,2021-11-09
3175031003,JAKARTA TIMUR,JATINEGARA,BALI MESTER,9752,2064,7688,6446,14134,2021-11-09
3175101006,JAKARTA TIMUR,CIPAYUNG,BAMBU APUS,26285,4878,21407,17759,39166,2021-11-09
3174031002,JAKARTA SELATAN,MAMPANG PRAPATAN,BANGKA,21566,4605,16961,13944,30905,2021-11-09
3175051002,JAKARTA TIMUR,PASAR REBO,BARU,23886,3968,19918,17013,36931,2021-11-09
3175041004,JAKARTA TIMUR,KRAMAT JATI,BATU AMPAR,47898,11748,36150,28848,64998,2021-11-09
3171071002,JAKARTA PUSAT,TANAH ABANG,BENDUNGAN HILIR,21494,4367,17127,14534,31661,2021-11-09
3175031002,JAKARTA TIMUR,JATINEGARA,BIDARA CINA,36689,8861,27828,22106,49934,2021-11-09
3174101002,JAKARTA SELATAN,PESANGGRAHAN,BINTARO,53098,10724,42374,36226,78600,2021-11-09
3174011005,JAKARTA SELATAN,TEBET,BUKIT DURI,34183,6959,27224,22518,49742,2021-11-09
3171041006,JAKARTA PUSAT,SENEN,BUNGUR,18144,3811,14333,11806,26139,2021-11-09
3175061007,JAKARTA TIMUR,CAKUNG,CAKUNG BARAT,57724,11932,45792,37545,83337,2021-11-09
3175061004,JAKARTA TIMUR,CAKUNG,CAKUNG TIMUR,58287,11579,46708,38596,85304,2021-11-09
3175041007,JAKARTA TIMUR,KRAMAT JATI,CAWANG,32762,7149,25613,20382,45995,2021-11-09
3175101008,JAKARTA TIMUR,CIPAYUNG,CEGER,18932,3702,15230,12624,27854,2021-11-09
3171031006,JAKARTA PUSAT,KEMAYORAN,CEMPAKA BARU,32581,6249,26332,20512,46844,2021-11-09
3171051002,JAKARTA PUSAT,CEMPAKA PUTIH,CEMPAKA PUTIH BARAT,35885,7702,28183,23903,52086,2021-11-09
3171051001,JAKARTA PUSAT,CEMPAKA PUTIH,CEMPAKA PUTIH TIMUR,24292,5030,19262,16705,35967,2021-11-09
3173011001,JAKARTA BARAT,CENGKARENG,CENGKARENG BARAT,66284,13366,52918,44626,97544,2021-11-09
3173011006,JAKARTA BARAT,CENGKARENG,CENGKARENG TIMUR,81027,16105,64922,53512,118434,2021-11-09
3175091002,JAKARTA TIMUR,CIRACAS,CIBUBUR,66364,11480,54884,45899,100783,2021-11-09
3171011002,JAKARTA PUSAT,GAMBIR,CIDENG,15390,3031,12359,10712,23071,2021-11-09
3174091003,JAKARTA SELATAN,JAGAKARSA,CIGANJUR,38497,6655,31842,26033,57875,2021-11-09
3175051003,JAKARTA TIMUR,PASAR REBO,CIJANTUNG,41419,7755,33664,27851,61515,2021-11-09
3171061003,JAKARTA PUSAT,MENTENG,CIKINI,8274,1497,6777,5308,12085,2021-11-09
3174081006,JAKARTA SELATAN,PANCORAN,CIKOKO,10547,1844,8703,7502,16205,2021-11-09
3174061001,JAKARTA SELATAN,CILANDAK,CILANDAK BARAT,51752,9243,42509,36737,79246,2021-11-09
3174041003,JAKARTA SELATAN,PASAR MINGGU,CILANDAK TIMUR,25145,4655,20490,17328,37818,2021-11-09
3175101002,JAKARTA TIMUR,CIPAYUNG,CILANGKAP,27635,4933,22702,19134,41836,2021-11-09
3175041006,JAKARTA TIMUR,KRAMAT JATI,CILILITAN,40181,8876,31305,25345,56650,2021-11-09
3172041001,JAKARTA UTARA,CILINCING,CILINCING,43609,10521,33088,25486,58574,2021-11-09
3175101001,JAKARTA TIMUR,CIPAYUNG,CIPAYUNG,26104,4597,21507,18347,39854,2021-11-09
3174091006,JAKARTA SELATAN,JAGAKARSA,CIPEDAK,38303,6382,31921,26640,58561,2021-11-09
3174061005,JAKARTA SELATAN,CILANDAK,CIPETE SELATAN,26704,5183,21521,18784,40305,2021-11-09
3174071010,JAKARTA SELATAN,KEBAYORAN BARU,CIPETE UTARA,34102,6541,27561,22729,50290,2021-11-09
3175021003,JAKARTA TIMUR,PULO GADUNG,CIPINANG,39306,7338,31968,26434,58402,2021-11-09
3175031007,JAKARTA TIMUR,JATINEGARA,CIPINANG BESAR SELATAN,35212,8394,26818,20798,47616,2021-11-09
3175031008,JAKARTA TIMUR,JATINEGARA,CIPINANG BESAR UTARA,45319,10726,34593,26735,61328,2021-11-09
3175031005,JAKARTA TIMUR,JATINEGARA,CIPINANG CEMPEDAK,32824,7158,25666,21569,47235,2021-11-09
3175081005,JAKARTA TIMUR,MAKASAR,CIPINANG MELAYU,42308,8235,34073,28686,62759,2021-11-09
3175031006,JAKARTA TIMUR,JATINEGARA,CIPINANG MUARA,55243,11902,43341,35015,78356,2021-11-09
3174051003,JAKARTA SELATAN,KEBAYORAN LAMA,CIPULIR,39937,8507,31430,25316,56746,2021-11-09
3175091001,JAKARTA TIMUR,CIRACAS,CIRACAS,64594,11931,52663,43261,95924,2021-11-09
3175041003,JAKARTA TIMUR,KRAMAT JATI,DUKUH,24609,4668,19941,16406,36347,2021-11-09
3175071001,JAKARTA TIMUR,DUREN SAWIT,DUREN SAWIT,61160,12973,48187,39398,87585,2021-11-09
3174081004,JAKARTA SELATAN,PANCORAN,DUREN TIGA,28319,5712,22607,18839,41446,2021-11-09
3173051005,JAKARTA BARAT,KEBON JERUK,DURI KEPA,60138,11835,48303,41433,89736,2021-11-09
3173011002,JAKARTA BARAT,CENGKARENG,DURI KOSAMBI,77923,16834,61089,48564,109653,2021-11-09
3171011006,JAKARTA PUSAT,GAMBIR,DURI PULO,19610,4171,15439,12356,27795,2021-11-09
3173041011,JAKARTA BARAT,TAMBORA,DURI SELATAN,14259,2562,11697,9844,21541,2021-11-09
3173041003,JAKARTA BARAT,TAMBORA,DURI UTARA,19844,3630,16214,13278,29492,2021-11-09
3171081003,JAKARTA PUSAT,JOHAR BARU,GALUR,18243,3605,14638,11736,26374,2021-11-09
3171011001,JAKARTA PUSAT,GAMBIR,GAMBIR,2191,458,1733,1497,3230,2021-11-09
3174061004,JAKARTA SELATAN,CILANDAK,GANDARIA SELATAN,22119,4284,17835,15089,32924,2021-11-09
3174071009,JAKARTA SELATAN,KEBAYORAN BARU,GANDARIA UTARA,39922,8014,31908,26695,58603,2021-11-09
3175051001,JAKARTA TIMUR,PASAR REBO,GEDONG,35755,7229,28526,23965,52491,2021-11-09
3171071001,JAKARTA PUSAT,TANAH ABANG,GELORA,3127,615,2512,2150,4662,2021-11-09
3173031007,JAKARTA BARAT,TAMAN SARI,GLODOK,7837,1205,6632,5900,12532,2021-11-09
3171061004,JAKARTA PUSAT,MENTENG,GONDANGDIA,4100,926,3174,2889,6063,2021-11-09
3173021001,JAKARTA BARAT,GROGOL PETAMBURAN,GROGOL,16876,3398,13478,11314,24792,2021-11-09
3174051005,JAKARTA SELATAN,KEBAYORAN LAMA,GROGOL SELATAN,44251,8866,35385,28856,64241,2021-11-09
3174051004,JAKARTA SELATAN,KEBAYORAN LAMA,GROGOL UTARA,42494,8725,33769,27785,61554,2021-11-09
3174021007,JAKARTA SELATAN,SETIA BUDI,GUNTUR,3985,749,3236,2833,6069,2021-11-09
3174071002,JAKARTA SELATAN,KEBAYORAN BARU,GUNUNG,9436,1755,7681,6785,14466,2021-11-09
3171031005,JAKARTA PUSAT,KEMAYORAN,GUNUNG SAHARI SELATAN,19199,3920,15279,12798,28077,2021-11-09
3171021004,JAKARTA PUSAT,SAWAH BESAR,GUNUNG SAHARI UTARA,16650,2965,13685,12153,25838,2021-11-09
3175081004,JAKARTA TIMUR,MAKASAR,HALIM PERDANA KUSUMAH,28363,3711,24652,22410,47062,2021-11-09
3171031003,JAKARTA PUSAT,KEMAYORAN,HARAPAN MULIA,22557,4592,17965,14532,32497,2021-11-09
3174091001,JAKARTA SELATAN,JAGAKARSA,JAGAKARSA,62389,10388,52001,42932,94933,2021-11-09
3175021007,JAKARTA TIMUR,PULO GADUNG,JATI,32757,6152,26605,22862,49467,2021-11-09
3174041002,JAKARTA SELATAN,PASAR MINGGU,JATI PADANG,37502,7503,29999,25058,55057,2021-11-09
3173071004,JAKARTA BARAT,PALMERAH,JATI PULO,28738,5762,22976,18265,41241,2021-11-09
3175061001,JAKARTA TIMUR,CAKUNG,JATINEGARA,84160,18065,66095,53996,120091,2021-11-09
3175021004,JAKARTA TIMUR,PULO GADUNG,JATINEGARA KAUM,24632,4431,20201,16353,36554,2021-11-09
3173021004,JAKARTA BARAT,GROGOL PETAMBURAN,JELAMBAR,30266,5566,24700,21393,46093,2021-11-09
3173021006,JAKARTA BARAT,GROGOL PETAMBURAN,JELAMBAR BARU,38246,7143,31103,26827,57930,2021-11-09
3173041006,JAKARTA BARAT,TAMBORA,JEMBATAN BESI,29314,7154,22160,17169,39329,2021-11-09
3173041008,JAKARTA BARAT,TAMBORA,JEMBATAN LIMA,21021,4900,16121,12659,28780,2021-11-09
3173081005,JAKARTA BARAT,KEMBANGAN,JOGLO,40839,8325,32514,27374,59888,2021-11-09
3171081001,JAKARTA PUSAT,JOHAR BARU,JOHAR BARU,37488,6988,30500,25626,56126,2021-11-09
3173041002,JAKARTA BARAT,TAMBORA,KALI ANYAR,23856,4754,19102,15129,34231,2021-11-09
3172041004,JAKARTA UTARA,CILINCING,KALIBARU,67684,18738,48946,34662,83608,2021-11-09
3174081002,JAKARTA SELATAN,PANCORAN,KALIBATA,41994,9640,32354,26078,58432,2021-11-09
3173061001,JAKARTA BARAT,KALI DERES,KALIDERES,72447,14770,57677,48549,106226,2021-11-09
3175051004,JAKARTA TIMUR,PASAR REBO,KALISARI,43212,7798,35414,29602,65016,2021-11-09
3173061004,JAKARTA BARAT,KALI DERES,KAMAL,53783,12636,41147,32454,73601,2021-11-09
3172011002,JAKARTA UTARA,PENJARINGAN,KAMAL MUARA,12930,2297,10633,9033,19666,2021-11-09
3171071007,JAKARTA PUSAT,TANAH ABANG,KAMPUNG BALI,11358,2470,8888,6777,15665,2021-11-09
3175031001,JAKARTA TIMUR,JATINEGARA,KAMPUNG MELAYU,25717,5913,19804,15357,35161,2021-11-09
3171081002,JAKARTA PUSAT,JOHAR BARU,KAMPUNG RAWA,21237,3545,17692,14088,31780,2021-11-09
3175041002,JAKARTA TIMUR,KRAMAT JATI,KAMPUNG TENGAH,43993,11131,32862,26098,58960,2021-11-09
3173011005,JAKARTA BARAT,CENGKARENG,KAPUK,134466,32715,101751,81715,183466,2021-11-09
3172011003,JAKARTA UTARA,PENJARINGAN,KAPUK MUARA,35781,6906,28875,25161,54036,2021-11-09
3171021002,JAKARTA PUSAT,SAWAH BESAR,KARANG ANYAR,25761,4981,20780,17405,38185,2021-11-09
3174021004,JAKARTA SELATAN,SETIA BUDI,KARET,9623,1859,7764,6426,14190,2021-11-09
3174021003,JAKARTA SELATAN,SETIA BUDI,KARET KUNINGAN,16055,3146,12909,10861,23770,2021-11-09
3174021002,JAKARTA SELATAN,SETIA BUDI,KARET SEMANGGI,2770,554,2216,1957,4173,2021-11-09
3171071003,JAKARTA PUSAT,TANAH ABANG,KARET TENGSIN,19271,3739,15532,12586,28118,2021-11-09
3171021003,JAKARTA PUSAT,SAWAH BESAR,KARTINI,22292,4251,18041,15416,33457,2021-11-09
3175011003,JAKARTA TIMUR,MATRAMAN,KAYU MANIS,25284,5379,19905,15755,35660,2021-11-09
3175021006,JAKARTA TIMUR,PULO GADUNG,KAYU PUTIH,40696,7724,32972,28680,61652,2021-11-09
3173031006,JAKARTA BARAT,TAMAN SARI,KEAGUNGAN,17387,3254,14133,11473,25606,2021-11-09
3174041007,JAKARTA SELATAN,PASAR MINGGU,KEBAGUSAN,44552,8903,35649,29219,64868,2021-11-09
3174051006,JAKARTA SELATAN,KEBAYORAN LAMA,KEBAYORAN LAMA SELATAN,41212,7714,33498,28179,61677,2021-11-09
3174051001,JAKARTA SELATAN,KEBAYORAN LAMA,KEBAYORAN LAMA UTARA,42422,8894,33528,27330,60858,2021-11-09
3174011004,JAKARTA SELATAN,TEBET,KEBON BARU,35165,6677,28488,23805,52293,2021-11-09
3172021005,JAKARTA UTARA,TANJUNG PRIOK,KEBON BAWANG,50952,10375,40577,33585,74162,2021-11-09
3173051001,JAKARTA BARAT,KEBON JERUK,KEBON JERUK,53887,11641,42246,34412,76658,2021-11-09
3171071006,JAKARTA PUSAT,TANAH ABANG,KEBON KACANG,21531,5170,16361,12847,29208,2021-11-09
3171011005,JAKARTA PUSAT,GAMBIR,KEBON KELAPA,10163,2052,8111,6793,14904,2021-11-09
3171031002,JAKARTA PUSAT,KEMAYORAN,KEBON KOSONG,30019,6039,23980,19457,43437,2021-11-09
3175011005,JAKARTA TIMUR,MATRAMAN,KEBON MANGGIS,16490,3241,13249,10926,24175,2021-11-09
3171071005,JAKARTA PUSAT,TANAH ABANG,KEBON MELATI,32206,8654,23552,17372,40924,2021-11-09
3175081003,JAKARTA TIMUR,MAKASAR,KEBON PALA,46614,9253,37361,30924,68285,2021-11-09
3171061005,JAKARTA PUSAT,MENTENG,KEBON SIRIH,12299,2674,9625,7698,17323,2021-11-09
3173011004,JAKARTA BARAT,CENGKARENG,KEDAUNG KALI ANGKE,32612,6370,26242,21907,48149,2021-11-09
3173051007,JAKARTA BARAT,KEBON JERUK,KEDOYA SELATAN,32165,5918,26247,21617,47864,2021-11-09
3173051006,JAKARTA BARAT,KEBON JERUK,KEDOYA UTARA,45740,8747,36993,31169,68162,2021-11-09
3173051004,JAKARTA BARAT,KEBON JERUK,KELAPA DUA,23565,4620,18945,15650,34595,2021-11-09
3175091003,JAKARTA TIMUR,CIRACAS,KELAPA DUA WETAN,46875,8056,38819,32486,71305,2021-11-09
3172061003,JAKARTA UTARA,KELAPA GADING,KELAPA GADING BARAT,35717,6248,29469,26439,55908,2021-11-09
3172061001,JAKARTA UTARA,KELAPA GADING,KELAPA GADING TIMUR,33592,5165,28427,26173,54600,2021-11-09
3173071005,JAKARTA BARAT,PALMERAH,KEMANGGISAN,32139,6119,26020,21719,47739,2021-11-09
3171031001,JAKARTA PUSAT,KEMAYORAN,KEMAYORAN,20708,4235,16473,13484,29957,2021-11-09
3173081006,JAKARTA BARAT,KEMBANGAN,KEMBANGAN SELATAN,27130,5717,21413,18420,39833,2021-11-09
3173081001,JAKARTA BARAT,KEMBANGAN,KEMBANGAN UTARA,54451,12028,42423,35153,77576,2021-11-09
3171041002,JAKARTA PUSAT,SENEN,KENARI,9579,1875,7704,6532,14236,2021-11-09
3173041005,JAKARTA BARAT,TAMBORA,KERENDANG,19973,4105,15868,12813,28681,2021-11-09
3175071003,JAKARTA TIMUR,DUREN SAWIT,KLENDER,69978,16522,53456,42274,95730,2021-11-09
3172031001,JAKARTA UTARA,KOJA,KOJA,28175,6454,21721,17448,39169,2021-11-09
3173071006,JAKARTA BARAT,PALMERAH,KOTA BAMBU SELATAN,21158,4195,16963,13197,30160,2021-11-09
3173071003,JAKARTA BARAT,PALMERAH,KOTA BAMBU UTARA,24995,5203,19792,15278,35070,2021-11-09
3171041004,JAKARTA PUSAT,SENEN,KRAMAT,28835,6966,21869,16558,38427,2021-11-09
3175041001,JAKARTA TIMUR,KRAMAT JATI,KRAMAT JATI,34144,7562,26582,21562,48144,2021-11-09
3174071003,JAKARTA SELATAN,KEBAYORAN BARU,KRAMAT PELA,14413,2817,11596,9873,21469,2021-11-09
3173031002,JAKARTA BARAT,TAMAN SARI,KRUKUT,19244,3652,15592,12586,28178,2021-11-09
3174031005,JAKARTA SELATAN,MAMPANG PRAPATAN,KUNINGAN BARAT,12785,2359,10426,8633,19059,2021-11-09
3174021008,JAKARTA SELATAN,SETIA BUDI,KUNINGAN TIMUR,6008,1195,4813,4054,8867,2021-11-09
3171041005,JAKARTA PUSAT,SENEN,KWITANG,15486,3476,12010,9623,21633,2021-11-09
3172031003,JAKARTA UTARA,KOJA,LAGOA,59065,14082,44983,35333,80316,2021-11-09
3174061002,JAKARTA SELATAN,CILANDAK,LEBAK BULUS,37626,7141,30485,26457,56942,2021-11-09
3174091004,JAKARTA SELATAN,JAGAKARSA,LENTENG AGUNG,53946,9768,44178,35730,79908,2021-11-09
3175101007,JAKARTA TIMUR,CIPAYUNG,LUBANG BUAYA,63547,12031,51516,42420,93936,2021-11-09
3175081001,JAKARTA TIMUR,MAKASAR,MAKASAR,34390,6365,28025,23439,51464,2021-11-09
3175071006,JAKARTA TIMUR,DUREN SAWIT,MALAKA JAYA,30927,5339,25588,21818,47406,2021-11-09
3175071005,JAKARTA TIMUR,DUREN SAWIT,MALAKA SARI,27530,4610,22920,19611,42531,2021-11-09
3174031001,JAKARTA SELATAN,MAMPANG PRAPATAN,MAMPANG PRAPATAN,18159,3751,14408,11830,26238,2021-11-09
3173031005,JAKARTA BARAT,TAMAN SARI,MANGGA BESAR,7707,1299,6408,5611,12019,2021-11-09
3171021005,JAKARTA PUSAT,SAWAH BESAR,MANGGA DUA SELATAN,27442,5742,21700,18312,40012,2021-11-09
3174011007,JAKARTA SELATAN,TEBET,MANGGARAI,28373,5069,23304,18805,42109,2021-11-09
3174011006,JAKARTA SELATAN,TEBET,MANGGARAI SELATAN,23075,4052,19023,15947,34970,2021-11-09
3173031003,JAKARTA BARAT,TAMAN SARI,MAPHAR,16461,3086,13375,11128,24503,2021-11-09
3172041003,JAKARTA UTARA,CILINCING,MARUNDA,28943,6604,22339,16624,38963,2021-11-09
3174071001,JAKARTA SELATAN,KEBAYORAN BARU,MELAWAI,2627,511,2116,1943,4059,2021-11-09
3171061001,JAKARTA PUSAT,MENTENG,MENTENG,25624,5705,19919,15640,35559,2021-11-09
3174021005,JAKARTA SELATAN,SETIA BUDI,MENTENG ATAS,27816,5042,22774,18828,41602,2021-11-09
3174011003,JAKARTA SELATAN,TEBET,MENTENG DALAM,36028,7055,28973,24345,53318,2021-11-09
3173081003,JAKARTA BARAT,KEMBANGAN,MERUYA SELATAN,32130,6654,25476,21312,46788,2021-11-09
3173081002,JAKARTA BARAT,KEMBANGAN,MERUYA UTARA,43752,9052,34700,29988,64688,2021-11-09
3175101004,JAKARTA TIMUR,CIPAYUNG,MUNJUL,23871,4377,19494,16435,35929,2021-11-09
3172051002,JAKARTA UTARA,PADEMANGAN,PADEMANGAN BARAT,74240,17720,56520,45363,101883,2021-11-09
3172051001,JAKARTA UTARA,PADEMANGAN,PADEMANGAN TIMUR,37736,6734,31002,27048,58050,2021-11-09
3175011004,JAKARTA TIMUR,MATRAMAN,PAL MERIAM,19769,4116,15653,12526,28179,2021-11-09
3173071001,JAKARTA BARAT,PALMERAH,PALMERAH,63011,13330,49681,40247,89928,2021-11-09
3174081001,JAKARTA SELATAN,PANCORAN,PANCORAN,19421,4007,15414,12686,28100,2021-11-09
3172021003,JAKARTA UTARA,TANJUNG PRIOK,PAPANGGO,39097,7718,31379,25586,56965,2021-11-09
3171021001,JAKARTA PUSAT,SAWAH BESAR,PASAR BARU,12035,2308,9727,8664,18391,2021-11-09
3174021006,JAKARTA SELATAN,SETIA BUDI,PASAR MANGGIS,26752,5325,21427,17581,39008,2021-11-09
3174041001,JAKARTA SELATAN,PASAR MINGGU,PASAR MINGGU,24821,4694,20127,17112,37239,2021-11-09
3171041003,JAKARTA PUSAT,SENEN,PASEBAN,23533,4921,18612,15217,33829,2021-11-09
3173061005,JAKARTA BARAT,KALI DERES,PEGADUNGAN,75587,15076,60511,51788,112299,2021-11-09
3171061002,JAKARTA PUSAT,MENTENG,PEGANGSAAN,23455,5076,18379,14060,32439,2021-11-09
3172061002,JAKARTA UTARA,KELAPA GADING,PEGANGSAAN DUA,49976,8291,41685,37572,79257,2021-11-09
3172011004,JAKARTA UTARA,PENJARINGAN,PEJAGALAN,74578,15577,59001,50594,109595,2021-11-09
3174041006,JAKARTA SELATAN,PASAR MINGGU,PEJATEN BARAT,37346,7358,29988,24940,54928,2021-11-09
3174041005,JAKARTA SELATAN,PASAR MINGGU,PEJATEN TIMUR,57656,13037,44619,36632,81251,2021-11-09
3175051005,JAKARTA TIMUR,PASAR REBO,PEKAYON,43250,7891,35359,29244,64603,2021-11-09
3173041009,JAKARTA BARAT,TAMBORA,PEKOJAN,23587,4512,19075,15883,34958,2021-11-09
3174031003,JAKARTA SELATAN,MAMPANG PRAPATAN,PELA MAMPANG,43522,8613,34909,29019,63928,2021-11-09
3174081005,JAKARTA SELATAN,PANCORAN,PENGADEGAN,21478,3963,17515,14823,32338,2021-11-09
3175061003,JAKARTA TIMUR,CAKUNG,PENGGILINGAN,99255,23203,76052,60575,136627,2021-11-09
3172011001,JAKARTA UTARA,PENJARINGAN,PENJARINGAN,88308,22724,65584,50333,115917,2021-11-09
3174101001,JAKARTA SELATAN,PESANGGRAHAN,PESANGGRAHAN,27545,4762,22783,19429,42212,2021-11-09
3171071004,JAKARTA PUSAT,TANAH ABANG,PETAMBURAN,33271,8802,24469,18448,42917,2021-11-09
3174071008,JAKARTA SELATAN,KEBAYORAN BARU,PETOGOGAN,11499,2243,9256,7865,17121,2021-11-09
3171011004,JAKARTA PUSAT,GAMBIR,PETOJO SELATAN,14692,3327,11365,9612,20977,2021-11-09
3171011003,JAKARTA PUSAT,GAMBIR,PETOJO UTARA,17458,3782,13676,11249,24925,2021-11-09
3174101004,JAKARTA SELATAN,PESANGGRAHAN,PETUKANGAN SELATAN,37187,7709,29478,24680,54158,2021-11-09
3174101003,JAKARTA SELATAN,PESANGGRAHAN,PETUKANGAN UTARA,53716,11630,42086,34757,76843,2021-11-09
3175081002,JAKARTA TIMUR,MAKASAR,PINANG RANTI,27198,5950,21248,17428,38676,2021-11-09
3173031008,JAKARTA BARAT,TAMAN SARI,PINANGSIA,10729,1891,8838,7310,16148,2021-11-09
3175011001,JAKARTA TIMUR,MATRAMAN,PISANGAN BARU,31776,6557,25219,19964,45183,2021-11-09
3175021002,JAKARTA TIMUR,PULO GADUNG,PISANGAN TIMUR,41011,7637,33374,28129,61503,2021-11-09
3172011005,JAKARTA UTARA,PENJARINGAN,PLUIT,47783,9208,38575,33708,72283,2021-11-09
3175071002,JAKARTA TIMUR,DUREN SAWIT,PONDOK BAMBU,61550,13081,48469,39674,88143,2021-11-09
3175071004,JAKARTA TIMUR,DUREN SAWIT,PONDOK KELAPA,72015,14342,57673,49181,106854,2021-11-09
3175071007,JAKARTA TIMUR,DUREN SAWIT,PONDOK KOPI,35367,6655,28712,22580,51292,2021-11-09
3174061003,JAKARTA SELATAN,CILANDAK,PONDOK LABU,46464,7911,38553,33330,71883,2021-11-09
3174051002,JAKARTA SELATAN,KEBAYORAN LAMA,PONDOK PINANG,56169,10834,45335,38501,83836,2021-11-09
3175101003,JAKARTA TIMUR,CIPAYUNG,PONDOK RANGGON,25574,4811,20763,17395,38158,2021-11-09
3101011003,KAB.ADM.KEP.SERIBU,KEP. SERIBU UTARA,PULAU HARAPAN,2060,222,1838,1602,3440,2021-11-09
3101011002,KAB.ADM.KEP.SERIBU,KEP. SERIBU UTARA,PULAU KELAPA,5528,601,4927,4061,8988,2021-11-09
3101011001,KAB.ADM.KEP.SERIBU,KEP. SERIBU UTARA,PULAU PANGGANG,5450,443,5007,4472,9479,2021-11-09
3101021003,KAB.ADM.KEP.SERIBU,KEP. SERIBU SELATAN,PULAU PARI,2765,193,2572,2416,4988,2021-11-09
3101021002,KAB.ADM.KEP.SERIBU,KEP. SERIBU SELATAN,PULAU TIDUNG,4553,369,4184,3819,8003,2021-11-09
3101021001,KAB.ADM.KEP.SERIBU,KEP. SERIBU SELATAN,PULAU UNTUNG JAWA,1941,162,1779,1639,3418,2021-11-09
3174071007,JAKARTA SELATAN,KEBAYORAN BARU,PULO,5835,1014,4821,4395,9216,2021-11-09
3175021001,JAKARTA TIMUR,PULO GADUNG,PULO GADUNG,34422,7573,26849,22334,49183,2021-11-09
3175061005,JAKARTA TIMUR,CAKUNG,PULO GEBANG,97301,18865,78436,63444,141880,2021-11-09
3174041004,JAKARTA SELATAN,PASAR MINGGU,RAGUNAN,39616,7366,32250,27334,59584,2021-11-09
3175091005,JAKARTA TIMUR,CIRACAS,RAMBUTAN,36771,8666,28105,22493,50598,2021-11-09
3172031006,JAKARTA UTARA,KOJA,RAWA BADAK SELATAN,42179,10065,32114,25241,57355,2021-11-09
3172031004,JAKARTA UTARA,KOJA,RAWA BADAK UTARA,34408,7755,26653,21290,47943,2021-11-09
3174071005,JAKARTA SELATAN,KEBAYORAN BARU,RAWA BARAT,5625,1003,4622,4084,8706,2021-11-09
3173011003,JAKARTA BARAT,CENGKARENG,RAWA BUAYA,63799,12805,50994,41140,92134,2021-11-09
3175031004,JAKARTA TIMUR,JATINEGARA,RAWA BUNGA,21434,5216,16218,13095,29313,2021-11-09
3174081003,JAKARTA SELATAN,PANCORAN,RAWA JATI,20509,3923,16586,14111,30697,2021-11-09
3175061002,JAKARTA TIMUR,CAKUNG,RAWA TERATE,24637,4502,20135,16373,36508,2021-11-09
3175021005,JAKARTA TIMUR,PULO GADUNG,RAWAMANGUN,37612,7452,30160,25443,55603,2021-11-09
3171051003,JAKARTA PUSAT,CEMPAKA PUTIH,RAWASARI,21967,4492,17475,14852,32327,2021-11-09
3173041010,JAKARTA BARAT,TAMBORA,ROA MALAKA,3484,619,2865,2525,5390,2021-11-09
3172041006,JAKARTA UTARA,CILINCING,ROROTAN,41668,8405,33263,26498,59761,2021-11-09
3174071004,JAKARTA SELATAN,KEBAYORAN BARU,SELONG,2842,548,2294,2111,4405,2021-11-09
3173061002,JAKARTA BARAT,KALI DERES,SEMANAN,71354,15426,55928,45010,100938,2021-11-09
3172041007,JAKARTA UTARA,CILINCING,SEMPER BARAT,68587,13452,55135,45526,100661,2021-11-09
3172041005,JAKARTA UTARA,CILINCING,SEMPER TIMUR,36267,7861,28406,22955,51361,2021-11-09
3174071006,JAKARTA SELATAN,KEBAYORAN BARU,SENAYAN,2771,653,2118,1821,3939,2021-11-09
3171041001,JAKARTA PUSAT,SENEN,SENEN,6804,1460,5344,4437,9781,2021-11-09
3171031004,JAKARTA PUSAT,KEMAYORAN,SERDANG,29668,5900,23768,19678,43446,2021-11-09
3174021001,JAKARTA SELATAN,SETIA BUDI,SETIA BUDI,3023,614,2409,2036,4445,2021-11-09
3175101005,JAKARTA TIMUR,CIPAYUNG,SETU,20572,4108,16464,13314,29778,2021-11-09
3173071002,JAKARTA BARAT,PALMERAH,SLIPI,16591,2996,13595,11380,24975,2021-11-09
3173081004,JAKARTA BARAT,KEMBANGAN,SRENGSENG,45523,10292,35231,29745,64976,2021-11-09
3174091002,JAKARTA SELATAN,JAGAKARSA,SRENGSENG SAWAH,58196,9092,49104,41509,90613,2021-11-09
3173051003,JAKARTA BARAT,KEBON JERUK,SUKABUMI SELATAN,37033,8310,28723,22231,50954,2021-11-09
3173051002,JAKARTA BARAT,KEBON JERUK,SUKABUMI UTARA,38290,8999,29291,22883,52174,2021-11-09
3172041002,JAKARTA UTARA,CILINCING,SUKAPURA,53949,12234,41715,34142,75857,2021-11-09
3171031007,JAKARTA PUSAT,KEMAYORAN,SUMUR BATU,22717,4480,18237,15385,33622,2021-11-09
3172021004,JAKARTA UTARA,TANJUNG PRIOK,SUNGAI BAMBU,29876,6052,23824,19684,43508,2021-11-09
3172021006,JAKARTA UTARA,TANJUNG PRIOK,SUNTER AGUNG,71805,12556,59249,51554,110803,2021-11-09
3172021002,JAKARTA UTARA,TANJUNG PRIOK,SUNTER JAYA,63031,11172,51859,44633,96492,2021-11-09
3175091004,JAKARTA TIMUR,CIRACAS,SUSUKAN,38257,7247,31010,25761,56771,2021-11-09
3173031001,JAKARTA BARAT,TAMAN SARI,TAMAN SARI,14348,2643,11705,10010,21715,2021-11-09
3173041001,JAKARTA BARAT,TAMBORA,TAMBORA,10204,2265,7939,6368,14307,2021-11-09
3173041004,JAKARTA BARAT,TAMBORA,TANAH SEREAL,26387,4514,21873,18320,40193,2021-11-09
3171081004,JAKARTA PUSAT,JOHAR BARU,TANAH TINGGI,37693,7222,30471,24616,55087,2021-11-09
3173031004,JAKARTA BARAT,TAMAN SARI,TANGKI,13324,2214,11110,9341,20451,2021-11-09
3174091005,JAKARTA SELATAN,JAGAKARSA,TANJUNG BARAT,39770,6802,32968,27201,60169,2021-11-09
3173021005,JAKARTA BARAT,GROGOL PETAMBURAN,TANJUNG DUREN SELATAN,25337,4847,20490,18000,38490,2021-11-09
3173021002,JAKARTA BARAT,GROGOL PETAMBURAN,TANJUNG DUREN UTARA,17010,2897,14113,12621,26734,2021-11-09
3172021001,JAKARTA UTARA,TANJUNG PRIOK,TANJUNG PRIOK,34588,7172,27416,22298,49714,2021-11-09
3174011002,JAKARTA SELATAN,TEBET,TEBET BARAT,21194,3465,17729,15544,33273,2021-11-09
3174011001,JAKARTA SELATAN,TEBET,TEBET TIMUR,18199,2940,15259,13697,28956,2021-11-09
3173061003,JAKARTA BARAT,KALI DERES,TEGAL ALUR,83647,17436,66211,54512,120723,2021-11-09
3174031004,JAKARTA SELATAN,MAMPANG PRAPATAN,TEGAL PARANG,32401,7173,25228,19616,44844,2021-11-09
3173021003,JAKARTA BARAT,GROGOL PETAMBURAN,TOMANG,29605,5489,24116,20545,44661,2021-11-09
3172031005,JAKARTA UTARA,KOJA,TUGU SELATAN,39122,8771,30351,24354,54705,2021-11-09
3172031002,JAKARTA UTARA,KOJA,TUGU UTARA,67670,16081,51589,40566,92155,2021-11-09
3175061006,JAKARTA TIMUR,CAKUNG,UJUNG MENTENG,29934,5218,24716,20869,45585,2021-11-09
3174101005,JAKARTA SELATAN,PESANGGRAHAN,ULUJAMI,40544,9191,31353,25721,57074,2021-11-09
3175011006,JAKARTA TIMUR,MATRAMAN,UTAN KAYU SELATAN,33511,6076,27435,22560,49995,2021-11-09
3175011002,JAKARTA TIMUR,MATRAMAN,UTAN KAYU UTARA,28169,5892,22277,18172,40449,2021-11-09
3171031008,JAKARTA PUSAT,KEMAYORAN,UTAN PANJANG,29208,5967,23241,18717,41958,2021-11-09
3172021007,JAKARTA UTARA,TANJUNG PRIOK,WARAKAS,44401,8200,36201,29105,65306,2021-11-09
3173021007,JAKARTA BARAT,GROGOL PETAMBURAN,WIJAYA KUSUMA,38934,8179,30755,25774,56529,2021-11-09
3172051003,JAKARTA UTARA,PADEMANGAN,ANCOL,23947,5826,18121,14847,32968,2021-11-10
3173041007,JAKARTA BARAT,TAMBORA,ANGKE,29381,6269,23112,18654,41766,2021-11-10
3175041005,JAKARTA TIMUR,KRAMAT JATI,BALE KAMBANG,29074,7312,21762,17065,38827,2021-11-10
3175031003,JAKARTA TIMUR,JATINEGARA,BALI MESTER,9752,2054,7698,6455,14153,2021-11-10
3175101006,JAKARTA TIMUR,CIPAYUNG,BAMBU APUS,26285,4861,21424,17838,39262,2021-11-10
3174031002,JAKARTA SELATAN,MAMPANG PRAPATAN,BANGKA,21566,4593,16973,13983,30956,2021-11-10
3175051002,JAKARTA TIMUR,PASAR REBO,BARU,23886,3957,19929,17043,36972,2021-11-10
3175041004,JAKARTA TIMUR,KRAMAT JATI,BATU AMPAR,47898,11699,36199,28974,65173,2021-11-10
3171071002,JAKARTA PUSAT,TANAH ABANG,BENDUNGAN HILIR,21494,4360,17134,14574,31708,2021-11-10
3175031002,JAKARTA TIMUR,JATINEGARA,BIDARA CINA,36689,8828,27861,22201,50062,2021-11-10
3174101002,JAKARTA SELATAN,PESANGGRAHAN,BINTARO,53098,10684,42414,36377,78791,2021-11-10
3174011005,JAKARTA SELATAN,TEBET,BUKIT DURI,34183,6934,27249,22565,49814,2021-11-10
3171041006,JAKARTA PUSAT,SENEN,BUNGUR,18144,3796,14348,11833,26181,2021-11-10
3175061007,JAKARTA TIMUR,CAKUNG,CAKUNG BARAT,57724,11868,45856,37663,83519,2021-11-10
3175061004,JAKARTA TIMUR,CAKUNG,CAKUNG TIMUR,58287,11537,46750,38688,85438,2021-11-10
3175041007,JAKARTA TIMUR,KRAMAT JATI,CAWANG,32762,7130,25632,20445,46077,2021-11-10
3175101008,JAKARTA TIMUR,CIPAYUNG,CEGER,18932,3690,15242,12654,27896,2021-11-10
3171031006,JAKARTA PUSAT,KEMAYORAN,CEMPAKA BARU,32581,6228,26353,20580,46933,2021-11-10
3171051002,JAKARTA PUSAT,CEMPAKA PUTIH,CEMPAKA PUTIH BARAT,35885,7684,28201,23963,52164,2021-11-10
3171051001,JAKARTA PUSAT,CEMPAKA PUTIH,CEMPAKA PUTIH TIMUR,24292,5008,19284,16748,36032,2021-11-10
3173011001,JAKARTA BARAT,CENGKARENG,CENGKARENG BARAT,66284,13303,52981,44764,97745,2021-11-10
3173011006,JAKARTA BARAT,CENGKARENG,CENGKARENG TIMUR,81027,16058,64969,53664,118633,2021-11-10
3175091002,JAKARTA TIMUR,CIRACAS,CIBUBUR,66364,11455,54909,45992,100901,2021-11-10
3171011002,JAKARTA PUSAT,GAMBIR,CIDENG,15390,3026,12364,10747,23111,2021-11-10
3174091003,JAKARTA SELATAN,JAGAKARSA,CIGANJUR,38497,6496,32001,26135,58136,2021-11-10
3175051003,JAKARTA TIMUR,PASAR REBO,CIJANTUNG,41419,7722,33697,27917,61614,2021-11-10
3171061003,JAKARTA PUSAT,MENTENG,CIKINI,8274,1493,6781,5331,12112,2021-11-10
3174081006,JAKARTA SELATAN,PANCORAN,CIKOKO,10547,1837,8710,7523,16233,2021-11-10
3174061001,JAKARTA SELATAN,CILANDAK,CILANDAK BARAT,51752,9180,42572,36930,79502,2021-11-10
3174041003,JAKARTA SELATAN,PASAR MINGGU,CILANDAK TIMUR,25145,4638,20507,17386,37893,2021-11-10
3175101002,JAKARTA TIMUR,CIPAYUNG,CILANGKAP,27635,4922,22713,19202,41915,2021-11-10
3175041006,JAKARTA TIMUR,KRAMAT JATI,CILILITAN,40181,8815,31366,25433,56799,2021-11-10
3172041001,JAKARTA UTARA,CILINCING,CILINCING,43609,10498,33111,25549,58660,2021-11-10
3175101001,JAKARTA TIMUR,CIPAYUNG,CIPAYUNG,26104,4576,21528,18390,39918,2021-11-10
3174091006,JAKARTA SELATAN,JAGAKARSA,CIPEDAK,38303,6355,31948,26710,58658,2021-11-10
3174061005,JAKARTA SELATAN,CILANDAK,CIPETE SELATAN,26704,5162,21542,18824,40366,2021-11-10
3174071010,JAKARTA SELATAN,KEBAYORAN BARU,CIPETE UTARA,34102,6521,27581,22820,50401,2021-11-10
3175021003,JAKARTA TIMUR,PULO GADUNG,CIPINANG,39306,7314,31992,26497,58489,2021-11-10
3175031007,JAKARTA TIMUR,JATINEGARA,CIPINANG BESAR SELATAN,35212,8359,26853,20859,47712,2021-11-10
3175031008,JAKARTA TIMUR,JATINEGARA,CIPINANG BESAR UTARA,45319,10698,34621,26814,61435,2021-11-10
3175031005,JAKARTA TIMUR,JATINEGARA,CIPINANG CEMPEDAK,32824,7152,25672,21680,47352,2021-11-10
3175081005,JAKARTA TIMUR,MAKASAR,CIPINANG MELAYU,42308,8217,34091,28742,62833,2021-11-10
3175031006,JAKARTA TIMUR,JATINEGARA,CIPINANG MUARA,55243,11851,43392,35120,78512,2021-11-10
3174051003,JAKARTA SELATAN,KEBAYORAN LAMA,CIPULIR,39937,8494,31443,25381,56824,2021-11-10
3175091001,JAKARTA TIMUR,CIRACAS,CIRACAS,64594,11894,52700,43407,96107,2021-11-10
3175041003,JAKARTA TIMUR,KRAMAT JATI,DUKUH,24609,4659,19950,16427,36377,2021-11-10
3175071001,JAKARTA TIMUR,DUREN SAWIT,DUREN SAWIT,61160,12946,48214,39570,87784,2021-11-10
3174081004,JAKARTA SELATAN,PANCORAN,DUREN TIGA,28319,5701,22618,18877,41495,2021-11-10
3173051005,JAKARTA BARAT,KEBON JERUK,DURI KEPA,60138,11814,48324,41512,89836,2021-11-10
3173011002,JAKARTA BARAT,CENGKARENG,DURI KOSAMBI,77923,16770,61153,48733,109886,2021-11-10
3171011006,JAKARTA PUSAT,GAMBIR,DURI PULO,19610,4155,15455,12401,27856,2021-11-10
3173041011,JAKARTA BARAT,TAMBORA,DURI SELATAN,14259,2557,11702,9863,21565,2021-11-10
3173041003,JAKARTA BARAT,TAMBORA,DURI UTARA,19844,3620,16224,13303,29527,2021-11-10
3171081003,JAKARTA PUSAT,JOHAR BARU,GALUR,18243,3599,14644,11761,26405,2021-11-10
3171011001,JAKARTA PUSAT,GAMBIR,GAMBIR,2191,458,1733,1499,3232,2021-11-10
3174061004,JAKARTA SELATAN,CILANDAK,GANDARIA SELATAN,22119,4273,17846,15117,32963,2021-11-10
3174071009,JAKARTA SELATAN,KEBAYORAN BARU,GANDARIA UTARA,39922,7998,31924,26835,58759,2021-11-10
3175051001,JAKARTA TIMUR,PASAR REBO,GEDONG,35755,7204,28551,24023,52574,2021-11-10
3171071001,JAKARTA PUSAT,TANAH ABANG,GELORA,3127,613,2514,2153,4667,2021-11-10
3173031007,JAKARTA BARAT,TAMAN SARI,GLODOK,7837,1203,6634,5902,12536,2021-11-10
3171061004,JAKARTA PUSAT,MENTENG,GONDANGDIA,4100,922,3178,2896,6074,2021-11-10
3173021001,JAKARTA BARAT,GROGOL PETAMBURAN,GROGOL,16876,3382,13494,11352,24846,2021-11-10
3174051005,JAKARTA SELATAN,KEBAYORAN LAMA,GROGOL SELATAN,44251,8837,35414,28930,64344,2021-11-10
3174051004,JAKARTA SELATAN,KEBAYORAN LAMA,GROGOL UTARA,42494,8695,33799,27847,61646,2021-11-10
3174021007,JAKARTA SELATAN,SETIA BUDI,GUNTUR,3985,746,3239,2836,6075,2021-11-10
3174071002,JAKARTA SELATAN,KEBAYORAN BARU,GUNUNG,9436,1752,7684,6797,14481,2021-11-10
3171031005,JAKARTA PUSAT,KEMAYORAN,GUNUNG SAHARI SELATAN,19199,3905,15294,12824,28118,2021-11-10
3171021004,JAKARTA PUSAT,SAWAH BESAR,GUNUNG SAHARI UTARA,16650,2953,13697,12177,25874,2021-11-10
3175081004,JAKARTA TIMUR,MAKASAR,HALIM PERDANA KUSUMAH,28363,3699,24664,22441,47105,2021-11-10
3171031003,JAKARTA PUSAT,KEMAYORAN,HARAPAN MULIA,22557,4578,17979,14574,32553,2021-11-10
3174091001,JAKARTA SELATAN,JAGAKARSA,JAGAKARSA,62389,10340,52049,43060,95109,2021-11-10
3175021007,JAKARTA TIMUR,PULO GADUNG,JATI,32757,6138,26619,22913,49532,2021-11-10
3174041002,JAKARTA SELATAN,PASAR MINGGU,JATI PADANG,37502,7468,30034,25113,55147,2021-11-10
3173071004,JAKARTA BARAT,PALMERAH,JATI PULO,28738,5735,23003,18321,41324,2021-11-10
3175061001,JAKARTA TIMUR,CAKUNG,JATINEGARA,84160,17996,66164,54169,120333,2021-11-10
3175021004,JAKARTA TIMUR,PULO GADUNG,JATINEGARA KAUM,24632,4421,20211,16396,36607,2021-11-10
3173021004,JAKARTA BARAT,GROGOL PETAMBURAN,JELAMBAR,30266,5558,24708,21463,46171,2021-11-10
3173021006,JAKARTA BARAT,GROGOL PETAMBURAN,JELAMBAR BARU,38246,7108,31138,26897,58035,2021-11-10
3173041006,JAKARTA BARAT,TAMBORA,JEMBATAN BESI,29314,7131,22183,17218,39401,2021-11-10
3173041008,JAKARTA BARAT,TAMBORA,JEMBATAN LIMA,21021,4875,16146,12685,28831,2021-11-10
3173081005,JAKARTA BARAT,KEMBANGAN,JOGLO,40839,8268,32571,27475,60046,2021-11-10
3171081001,JAKARTA PUSAT,JOHAR BARU,JOHAR BARU,37488,6976,30512,25670,56182,2021-11-10
3173041002,JAKARTA BARAT,TAMBORA,KALI ANYAR,23856,4740,19116,15165,34281,2021-11-10
3172041004,JAKARTA UTARA,CILINCING,KALIBARU,67684,18693,48991,34729,83720,2021-11-10
3174081002,JAKARTA SELATAN,PANCORAN,KALIBATA,41994,9557,32437,26219,58656,2021-11-10
3173061001,JAKARTA BARAT,KALI DERES,KALIDERES,72447,14708,57739,48730,106469,2021-11-10
3175051004,JAKARTA TIMUR,PASAR REBO,KALISARI,43212,7770,35442,29688,65130,2021-11-10
3173061004,JAKARTA BARAT,KALI DERES,KAMAL,53783,12617,41166,32531,73697,2021-11-10
3172011002,JAKARTA UTARA,PENJARINGAN,KAMAL MUARA,12930,2294,10636,9043,19679,2021-11-10
3171071007,JAKARTA PUSAT,TANAH ABANG,KAMPUNG BALI,11358,2462,8896,6801,15697,2021-11-10
3175031001,JAKARTA TIMUR,JATINEGARA,KAMPUNG MELAYU,25717,5907,19810,15379,35189,2021-11-10
3171081002,JAKARTA PUSAT,JOHAR BARU,KAMPUNG RAWA,21237,3541,17696,14112,31808,2021-11-10
3175041002,JAKARTA TIMUR,KRAMAT JATI,KAMPUNG TENGAH,43993,11086,32907,26213,59120,2021-11-10
3173011005,JAKARTA BARAT,CENGKARENG,KAPUK,134466,32595,101871,82016,183887,2021-11-10
3172011003,JAKARTA UTARA,PENJARINGAN,KAPUK MUARA,35781,6892,28889,25243,54132,2021-11-10
3171021002,JAKARTA PUSAT,SAWAH BESAR,KARANG ANYAR,25761,4968,20793,17449,38242,2021-11-10
3174021004,JAKARTA SELATAN,SETIA BUDI,KARET,9623,1853,7770,6440,14210,2021-11-10
3174021003,JAKARTA SELATAN,SETIA BUDI,KARET KUNINGAN,16055,3137,12918,10908,23826,2021-11-10
3174021002,JAKARTA SELATAN,SETIA BUDI,KARET SEMANGGI,2770,553,2217,1959,4176,2021-11-10
3171071003,JAKARTA PUSAT,TANAH ABANG,KARET TENGSIN,19271,3733,15538,12644,28182,2021-11-10
3171021003,JAKARTA PUSAT,SAWAH BESAR,KARTINI,22292,4232,18060,15457,33517,2021-11-10
3175011003,JAKARTA TIMUR,MATRAMAN,KAYU MANIS,25284,5360,19924,15804,35728,2021-11-10
3175021006,JAKARTA TIMUR,PULO GADUNG,KAYU PUTIH,40696,7705,32991,28732,61723,2021-11-10
3173031006,JAKARTA BARAT,TAMAN SARI,KEAGUNGAN,17387,3245,14142,11487,25629,2021-11-10
3174041007,JAKARTA SELATAN,PASAR MINGGU,KEBAGUSAN,44552,8865,35687,29285,64972,2021-11-10
3174051006,JAKARTA SELATAN,KEBAYORAN LAMA,KEBAYORAN LAMA SELATAN,41212,7691,33521,28308,61829,2021-11-10
3174051001,JAKARTA SELATAN,KEBAYORAN LAMA,KEBAYORAN LAMA UTARA,42422,8851,33571,27586,61157,2021-11-10
3174011004,JAKARTA SELATAN,TEBET,KEBON BARU,35165,6665,28500,23833,52333,2021-11-10
3172021005,JAKARTA UTARA,TANJUNG PRIOK,KEBON BAWANG,50952,10343,40609,33667,74276,2021-11-10
3173051001,JAKARTA BARAT,KEBON JERUK,KEBON JERUK,53887,11527,42360,34510,76870,2021-11-10
3171071006,JAKARTA PUSAT,TANAH ABANG,KEBON KACANG,21531,5162,16369,12877,29246,2021-11-10
3171011005,JAKARTA PUSAT,GAMBIR,KEBON KELAPA,10163,2043,8120,6810,14930,2021-11-10
3171031002,JAKARTA PUSAT,KEMAYORAN,KEBON KOSONG,30019,6023,23996,19503,43499,2021-11-10
3175011005,JAKARTA TIMUR,MATRAMAN,KEBON MANGGIS,16490,3228,13262,10947,24209,2021-11-10
3171071005,JAKARTA PUSAT,TANAH ABANG,KEBON MELATI,32206,8640,23566,17423,40989,2021-11-10
3175081003,JAKARTA TIMUR,MAKASAR,KEBON PALA,46614,9232,37382,30980,68362,2021-11-10
3171061005,JAKARTA PUSAT,MENTENG,KEBON SIRIH,12299,2666,9633,7709,17342,2021-11-10
3173011004,JAKARTA BARAT,CENGKARENG,KEDAUNG KALI ANGKE,32612,6364,26248,21934,48182,2021-11-10
3173051007,JAKARTA BARAT,KEBON JERUK,KEDOYA SELATAN,32165,5901,26264,21649,47913,2021-11-10
3173051006,JAKARTA BARAT,KEBON JERUK,KEDOYA UTARA,45740,8730,37010,31218,68228,2021-11-10
3173051004,JAKARTA BARAT,KEBON JERUK,KELAPA DUA,23565,4608,18957,15676,34633,2021-11-10
3175091003,JAKARTA TIMUR,CIRACAS,KELAPA DUA WETAN,46875,8027,38848,32639,71487,2021-11-10
3172061003,JAKARTA UTARA,KELAPA GADING,KELAPA GADING BARAT,35717,6242,29475,26486,55961,2021-11-10
3172061001,JAKARTA UTARA,KELAPA GADING,KELAPA GADING TIMUR,33592,5152,28440,26222,54662,2021-11-10
3173071005,JAKARTA BARAT,PALMERAH,KEMANGGISAN,32139,6105,26034,21782,47816,2021-11-10
3171031001,JAKARTA PUSAT,KEMAYORAN,KEMAYORAN,20708,4218,16490,13509,29999,2021-11-10
3173081006,JAKARTA BARAT,KEMBANGAN,KEMBANGAN SELATAN,27130,5706,21424,18455,39879,2021-11-10
3173081001,JAKARTA BARAT,KEMBANGAN,KEMBANGAN UTARA,54451,11983,42468,35239,77707,2021-11-10
3171041002,JAKARTA PUSAT,SENEN,KENARI,9579,1870,7709,6549,14258,2021-11-10
3173041005,JAKARTA BARAT,TAMBORA,KERENDANG,19973,4093,15880,12849,28729,2021-11-10
3175071003,JAKARTA TIMUR,DUREN SAWIT,KLENDER,69978,16484,53494,42413,95907,2021-11-10
3172031001,JAKARTA UTARA,KOJA,KOJA,28175,6442,21733,17481,39214,2021-11-10
3173071006,JAKARTA BARAT,PALMERAH,KOTA BAMBU SELATAN,21158,4181,16977,13243,30220,2021-11-10
3173071003,JAKARTA BARAT,PALMERAH,KOTA BAMBU UTARA,24995,5182,19813,15302,35115,2021-11-10
3171041004,JAKARTA PUSAT,SENEN,KRAMAT,28835,6952,21883,16598,38481,2021-11-10
3175041001,JAKARTA TIMUR,KRAMAT JATI,KRAMAT JATI,34144,7533,26611,21616,48227,2021-11-10
3174071003,JAKARTA SELATAN,KEBAYORAN BARU,KRAMAT PELA,14413,2808,11605,9895,21500,2021-11-10
3173031002,JAKARTA BARAT,TAMAN SARI,KRUKUT,19244,3643,15601,12618,28219,2021-11-10
3174031005,JAKARTA SELATAN,MAMPANG PRAPATAN,KUNINGAN BARAT,12785,2342,10443,8656,19099,2021-11-10
3174021008,JAKARTA SELATAN,SETIA BUDI,KUNINGAN TIMUR,6008,1193,4815,4058,8873,2021-11-10
3171041005,JAKARTA PUSAT,SENEN,KWITANG,15486,3464,12022,9641,21663,2021-11-10
3172031003,JAKARTA UTARA,KOJA,LAGOA,59065,14056,45009,35393,80402,2021-11-10
3174061002,JAKARTA SELATAN,CILANDAK,LEBAK BULUS,37626,7128,30498,26561,57059,2021-11-10
3174091004,JAKARTA SELATAN,JAGAKARSA,LENTENG AGUNG,53946,9719,44227,35925,80152,2021-11-10
3175101007,JAKARTA TIMUR,CIPAYUNG,LUBANG BUAYA,63547,11994,51553,42550,94103,2021-11-10
3175081001,JAKARTA TIMUR,MAKASAR,MAKASAR,34390,6350,28040,23495,51535,2021-11-10
3175071006,JAKARTA TIMUR,DUREN SAWIT,MALAKA JAYA,30927,5309,25618,21886,47504,2021-11-10
3175071005,JAKARTA TIMUR,DUREN SAWIT,MALAKA SARI,27530,4586,22944,19667,42611,2021-11-10
3174031001,JAKARTA SELATAN,MAMPANG PRAPATAN,MAMPANG PRAPATAN,18159,3743,14416,11852,26268,2021-11-10
3173031005,JAKARTA BARAT,TAMAN SARI,MANGGA BESAR,7707,1293,6414,5620,12034,2021-11-10
3171021005,JAKARTA PUSAT,SAWAH BESAR,MANGGA DUA SELATAN,27442,5733,21709,18366,40075,2021-11-10
3174011007,JAKARTA SELATAN,TEBET,MANGGARAI,28373,5026,23347,18884,42231,2021-11-10
3174011006,JAKARTA SELATAN,TEBET,MANGGARAI SELATAN,23075,4033,19042,15983,35025,2021-11-10
3173031003,JAKARTA BARAT,TAMAN SARI,MAPHAR,16461,3081,13380,11153,24533,2021-11-10
3172041003,JAKARTA UTARA,CILINCING,MARUNDA,28943,6579,22364,16697,39061,2021-11-10
3174071001,JAKARTA SELATAN,KEBAYORAN BARU,MELAWAI,2627,511,2116,1943,4059,2021-11-10
3171061001,JAKARTA PUSAT,MENTENG,MENTENG,25624,5672,19952,15694,35646,2021-11-10
3174021005,JAKARTA SELATAN,SETIA BUDI,MENTENG ATAS,27816,5024,22792,18874,41666,2021-11-10
3174011003,JAKARTA SELATAN,TEBET,MENTENG DALAM,36028,7044,28984,24381,53365,2021-11-10
3173081003,JAKARTA BARAT,KEMBANGAN,MERUYA SELATAN,32130,6631,25499,21382,46881,2021-11-10
3173081002,JAKARTA BARAT,KEMBANGAN,MERUYA UTARA,43752,9025,34727,30093,64820,2021-11-10
3175101004,JAKARTA TIMUR,CIPAYUNG,MUNJUL,23871,4361,19510,16467,35977,2021-11-10
3172051002,JAKARTA UTARA,PADEMANGAN,PADEMANGAN BARAT,74240,17614,56626,45579,102205,2021-11-10
3172051001,JAKARTA UTARA,PADEMANGAN,PADEMANGAN TIMUR,37736,6716,31020,27114,58134,2021-11-10
3175011004,JAKARTA TIMUR,MATRAMAN,PAL MERIAM,19769,4100,15669,12560,28229,2021-11-10
3173071001,JAKARTA BARAT,PALMERAH,PALMERAH,63011,13286,49725,40409,90134,2021-11-10
3174081001,JAKARTA SELATAN,PANCORAN,PANCORAN,19421,3997,15424,12716,28140,2021-11-10
3172021003,JAKARTA UTARA,TANJUNG PRIOK,PAPANGGO,39097,7699,31398,25673,57071,2021-11-10
3171021001,JAKARTA PUSAT,SAWAH BESAR,PASAR BARU,12035,2303,9732,8680,18412,2021-11-10
3174021006,JAKARTA SELATAN,SETIA BUDI,PASAR MANGGIS,26752,5287,21465,17640,39105,2021-11-10
3174041001,JAKARTA SELATAN,PASAR MINGGU,PASAR MINGGU,24821,4684,20137,17151,37288,2021-11-10
3171041003,JAKARTA PUSAT,SENEN,PASEBAN,23533,4898,18635,15242,33877,2021-11-10
3173061005,JAKARTA BARAT,KALI DERES,PEGADUNGAN,75587,14978,60609,51926,112535,2021-11-10
3171061002,JAKARTA PUSAT,MENTENG,PEGANGSAAN,23455,5062,18393,14093,32486,2021-11-10
3172061002,JAKARTA UTARA,KELAPA GADING,PEGANGSAAN DUA,49976,8279,41697,37636,79333,2021-11-10
3172011004,JAKARTA UTARA,PENJARINGAN,PEJAGALAN,74578,15514,59064,50763,109827,2021-11-10
3174041006,JAKARTA SELATAN,PASAR MINGGU,PEJATEN BARAT,37346,7309,30037,25046,55083,2021-11-10
3174041005,JAKARTA SELATAN,PASAR MINGGU,PEJATEN TIMUR,57656,12958,44698,36706,81404,2021-11-10
3175051005,JAKARTA TIMUR,PASAR REBO,PEKAYON,43250,7868,35382,29323,64705,2021-11-10
3173041009,JAKARTA BARAT,TAMBORA,PEKOJAN,23587,4498,19089,15905,34994,2021-11-10
3174031003,JAKARTA SELATAN,MAMPANG PRAPATAN,PELA MAMPANG,43522,8569,34953,29088,64041,2021-11-10
3174081005,JAKARTA SELATAN,PANCORAN,PENGADEGAN,21478,3953,17525,14863,32388,2021-11-10
3175061003,JAKARTA TIMUR,CAKUNG,PENGGILINGAN,99255,23094,76161,60734,136895,2021-11-10
3172011001,JAKARTA UTARA,PENJARINGAN,PENJARINGAN,88308,22672,65636,50480,116116,2021-11-10
3174101001,JAKARTA SELATAN,PESANGGRAHAN,PESANGGRAHAN,27545,4751,22794,19462,42256,2021-11-10
3171071004,JAKARTA PUSAT,TANAH ABANG,PETAMBURAN,33271,8783,24488,18512,43000,2021-11-10
3174071008,JAKARTA SELATAN,KEBAYORAN BARU,PETOGOGAN,11499,2240,9259,7882,17141,2021-11-10
3171011004,JAKARTA PUSAT,GAMBIR,PETOJO SELATAN,14692,3318,11374,9645,21019,2021-11-10
3171011003,JAKARTA PUSAT,GAMBIR,PETOJO UTARA,17458,3780,13678,11267,24945,2021-11-10
3174101004,JAKARTA SELATAN,PESANGGRAHAN,PETUKANGAN SELATAN,37187,7693,29494,24728,54222,2021-11-10
3174101003,JAKARTA SELATAN,PESANGGRAHAN,PETUKANGAN UTARA,53716,11553,42163,34881,77044,2021-11-10
3175081002,JAKARTA TIMUR,MAKASAR,PINANG RANTI,27198,5926,21272,17492,38764,2021-11-10
3173031008,JAKARTA BARAT,TAMAN SARI,PINANGSIA,10729,1886,8843,7322,16165,2021-11-10
3175011001,JAKARTA TIMUR,MATRAMAN,PISANGAN BARU,31776,6544,25232,20031,45263,2021-11-10
3175021002,JAKARTA TIMUR,PULO GADUNG,PISANGAN TIMUR,41011,7623,33388,28192,61580,2021-11-10
3172011005,JAKARTA UTARA,PENJARINGAN,PLUIT,47783,9200,38583,33798,72381,2021-11-10
3175071002,JAKARTA TIMUR,DUREN SAWIT,PONDOK BAMBU,61550,13043,48507,39832,88339,2021-11-10
3175071004,JAKARTA TIMUR,DUREN SAWIT,PONDOK KELAPA,72015,14273,57742,49361,107103,2021-11-10
3175071007,JAKARTA TIMUR,DUREN SAWIT,PONDOK KOPI,35367,6635,28732,22738,51470,2021-11-10
3174061003,JAKARTA SELATAN,CILANDAK,PONDOK LABU,46464,7867,38597,33400,71997,2021-11-10
3174051002,JAKARTA SELATAN,KEBAYORAN LAMA,PONDOK PINANG,56169,10790,45379,38721,84100,2021-11-10
3175101003,JAKARTA TIMUR,CIPAYUNG,PONDOK RANGGON,25574,4803,20771,17417,38188,2021-11-10
3101011003,KAB.ADM.KEP.SERIBU,KEP. SERIBU UTARA,PULAU HARAPAN,2060,221,1839,1606,3445,2021-11-10
3101011002,KAB.ADM.KEP.SERIBU,KEP. SERIBU UTARA,PULAU KELAPA,5528,597,4931,4070,9001,2021-11-10
3101011001,KAB.ADM.KEP.SERIBU,KEP. SERIBU UTARA,PULAU PANGGANG,5450,441,5009,4478,9487,2021-11-10
3101021003,KAB.ADM.KEP.SERIBU,KEP. SERIBU SELATAN,PULAU PARI,2765,193,2572,2417,4989,2021-11-10
3101021002,KAB.ADM.KEP.SERIBU,KEP. SERIBU SELATAN,PULAU TIDUNG,4553,368,4185,3827,8012,2021-11-10
3101021001,KAB.ADM.KEP.SERIBU,KEP. SERIBU SELATAN,PULAU UNTUNG JAWA,1941,162,1779,1641,3420,2021-11-10
3174071007,JAKARTA SELATAN,KEBAYORAN BARU,PULO,5835,1013,4822,4403,9225,2021-11-10
3175021001,JAKARTA TIMUR,PULO GADUNG,PULO GADUNG,34422,7550,26872,22404,49276,2021-11-10
3175061005,JAKARTA TIMUR,CAKUNG,PULO GEBANG,97301,18809,78492,63559,142051,2021-11-10
3174041004,JAKARTA SELATAN,PASAR MINGGU,RAGUNAN,39616,7333,32283,27406,59689,2021-11-10
3175091005,JAKARTA TIMUR,CIRACAS,RAMBUTAN,36771,8631,28140,22610,50750,2021-11-10
3172031006,JAKARTA UTARA,KOJA,RAWA BADAK SELATAN,42179,10042,32137,25281,57418,2021-11-10
3172031004,JAKARTA UTARA,KOJA,RAWA BADAK UTARA,34408,7731,26677,21346,48023,2021-11-10
3174071005,JAKARTA SELATAN,KEBAYORAN BARU,RAWA BARAT,5625,1002,4623,4092,8715,2021-11-10
3173011003,JAKARTA BARAT,CENGKARENG,RAWA BUAYA,63799,12755,51044,41333,92377,2021-11-10
3175031004,JAKARTA TIMUR,JATINEGARA,RAWA BUNGA,21434,5196,16238,13121,29359,2021-11-10
3174081003,JAKARTA SELATAN,PANCORAN,RAWA JATI,20509,3915,16594,14139,30733,2021-11-10
3175061002,JAKARTA TIMUR,CAKUNG,RAWA TERATE,24637,4496,20141,16400,36541,2021-11-10
3175021005,JAKARTA TIMUR,PULO GADUNG,RAWAMANGUN,37612,7431,30181,25492,55673,2021-11-10
3171051003,JAKARTA PUSAT,CEMPAKA PUTIH,RAWASARI,21967,4485,17482,14897,32379,2021-11-10
3173041010,JAKARTA BARAT,TAMBORA,ROA MALAKA,3484,619,2865,2526,5391,2021-11-10
3172041006,JAKARTA UTARA,CILINCING,ROROTAN,41668,8372,33296,26579,59875,2021-11-10
3174071004,JAKARTA SELATAN,KEBAYORAN BARU,SELONG,2842,548,2294,2122,4416,2021-11-10
3173061002,JAKARTA BARAT,KALI DERES,SEMANAN,71354,15363,55991,45182,101173,2021-11-10
3172041007,JAKARTA UTARA,CILINCING,SEMPER BARAT,68587,13407,55180,45650,100830,2021-11-10
3172041005,JAKARTA UTARA,CILINCING,SEMPER TIMUR,36267,7832,28435,23005,51440,2021-11-10
3174071006,JAKARTA SELATAN,KEBAYORAN BARU,SENAYAN,2771,653,2118,1823,3941,2021-11-10
3171041001,JAKARTA PUSAT,SENEN,SENEN,6804,1458,5346,4444,9790,2021-11-10
3171031004,JAKARTA PUSAT,KEMAYORAN,SERDANG,29668,5831,23837,19738,43575,2021-11-10
3174021001,JAKARTA SELATAN,SETIA BUDI,SETIA BUDI,3023,612,2411,2043,4454,2021-11-10
3175101005,JAKARTA TIMUR,CIPAYUNG,SETU,20572,4103,16469,13358,29827,2021-11-10
3173071002,JAKARTA BARAT,PALMERAH,SLIPI,16591,2986,13605,11410,25015,2021-11-10
3173081004,JAKARTA BARAT,KEMBANGAN,SRENGSENG,45523,10261,35262,29801,65063,2021-11-10
3174091002,JAKARTA SELATAN,JAGAKARSA,SRENGSENG SAWAH,58196,9044,49152,41701,90853,2021-11-10
3173051003,JAKARTA BARAT,KEBON JERUK,SUKABUMI SELATAN,37033,8297,28736,22275,51011,2021-11-10
3173051002,JAKARTA BARAT,KEBON JERUK,SUKABUMI UTARA,38290,8983,29307,22928,52235,2021-11-10
3172041002,JAKARTA UTARA,CILINCING,SUKAPURA,53949,12206,41743,34223,75966,2021-11-10
3171031007,JAKARTA PUSAT,KEMAYORAN,SUMUR BATU,22717,4434,18283,15428,33711,2021-11-10
3172021004,JAKARTA UTARA,TANJUNG PRIOK,SUNGAI BAMBU,29876,6039,23837,19745,43582,2021-11-10
3172021006,JAKARTA UTARA,TANJUNG PRIOK,SUNTER AGUNG,71805,12486,59319,51685,111004,2021-11-10
3172021002,JAKARTA UTARA,TANJUNG PRIOK,SUNTER JAYA,63031,11140,51891,44756,96647,2021-11-10
3175091004,JAKARTA TIMUR,CIRACAS,SUSUKAN,38257,7229,31028,25823,56851,2021-11-10
3173031001,JAKARTA BARAT,TAMAN SARI,TAMAN SARI,14348,2632,11716,10025,21741,2021-11-10
3173041001,JAKARTA BARAT,TAMBORA,TAMBORA,10204,2248,7956,6395,14351,2021-11-10
3173041004,JAKARTA BARAT,TAMBORA,TANAH SEREAL,26387,4503,21884,18350,40234,2021-11-10
3171081004,JAKARTA PUSAT,JOHAR BARU,TANAH TINGGI,37693,7207,30486,24647,55133,2021-11-10
3173031004,JAKARTA BARAT,TAMAN SARI,TANGKI,13324,2208,11116,9360,20476,2021-11-10
3174091005,JAKARTA SELATAN,JAGAKARSA,TANJUNG BARAT,39770,6784,32986,27329,60315,2021-11-10
3173021005,JAKARTA BARAT,GROGOL PETAMBURAN,TANJUNG DUREN SELATAN,25337,4833,20504,18029,38533,2021-11-10
3173021002,JAKARTA BARAT,GROGOL PETAMBURAN,TANJUNG DUREN UTARA,17010,2888,14122,12637,26759,2021-11-10
3172021001,JAKARTA UTARA,TANJUNG PRIOK,TANJUNG PRIOK,34588,7153,27435,22343,49778,2021-11-10
3174011002,JAKARTA SELATAN,TEBET,TEBET BARAT,21194,3442,17752,15588,33340,2021-11-10
3174011001,JAKARTA SELATAN,TEBET,TEBET TIMUR,18199,2932,15267,13721,28988,2021-11-10
3173061003,JAKARTA BARAT,KALI DERES,TEGAL ALUR,83647,17339,66308,54643,120951,2021-11-10
3174031004,JAKARTA SELATAN,MAMPANG PRAPATAN,TEGAL PARANG,32401,7161,25240,19667,44907,2021-11-10
3173021003,JAKARTA BARAT,GROGOL PETAMBURAN,TOMANG,29605,5479,24126,20571,44697,2021-11-10
3172031005,JAKARTA UTARA,KOJA,TUGU SELATAN,39122,8754,30368,24406,54774,2021-11-10
3172031002,JAKARTA UTARA,KOJA,TUGU UTARA,67670,16029,51641,40711,92352,2021-11-10
3175061006,JAKARTA TIMUR,CAKUNG,UJUNG MENTENG,29934,5191,24743,20912,45655,2021-11-10
3174101005,JAKARTA SELATAN,PESANGGRAHAN,ULUJAMI,40544,9176,31368,25799,57167,2021-11-10
3175011006,JAKARTA TIMUR,MATRAMAN,UTAN KAYU SELATAN,33511,6060,27451,22608,50059,2021-11-10
3175011002,JAKARTA TIMUR,MATRAMAN,UTAN KAYU UTARA,28169,5877,22292,18205,40497,2021-11-10
3171031008,JAKARTA PUSAT,KEMAYORAN,UTAN PANJANG,29208,5951,23257,18769,42026,2021-11-10
3172021007,JAKARTA UTARA,TANJUNG PRIOK,WARAKAS,44401,8182,36219,29179,65398,2021-11-10
3173021007,JAKARTA BARAT,GROGOL PETAMBURAN,WIJAYA KUSUMA,38934,8154,30780,25831,56611,2021-11-10
3172051003,JAKARTA UTARA,PADEMANGAN,ANCOL,23947,5811,18136,14851,32987,2021-11-11
3173041007,JAKARTA BARAT,TAMBORA,ANGKE,29381,6261,23120,18660,41780,2021-11-11
3175041005,JAKARTA TIMUR,KRAMAT JATI,BALE KAMBANG,29074,7308,21766,17065,38831,2021-11-11
3175031003,JAKARTA TIMUR,JATINEGARA,BALI MESTER,9752,2054,7698,6456,14154,2021-11-11
3175101006,JAKARTA TIMUR,CIPAYUNG,BAMBU APUS,26285,4854,21431,17844,39275,2021-11-11
3174031002,JAKARTA SELATAN,MAMPANG PRAPATAN,BANGKA,21566,4590,16976,13984,30960,2021-11-11
3175051002,JAKARTA TIMUR,PASAR REBO,BARU,23886,3956,19930,17046,36976,2021-11-11
3175041004,JAKARTA TIMUR,KRAMAT JATI,BATU AMPAR,47898,11689,36209,28979,65188,2021-11-11
3171071002,JAKARTA PUSAT,TANAH ABANG,BENDUNGAN HILIR,21494,4353,17141,14581,31722,2021-11-11
3175031002,JAKARTA TIMUR,JATINEGARA,BIDARA CINA,36689,8824,27865,22205,50070,2021-11-11
3174101002,JAKARTA SELATAN,PESANGGRAHAN,BINTARO,53098,10678,42420,36383,78803,2021-11-11
3174011005,JAKARTA SELATAN,TEBET,BUKIT DURI,34183,6932,27251,22567,49818,2021-11-11
3171041006,JAKARTA PUSAT,SENEN,BUNGUR,18144,3796,14348,11836,26184,2021-11-11
3175061007,JAKARTA TIMUR,CAKUNG,CAKUNG BARAT,57724,11858,45866,37673,83539,2021-11-11
3175061004,JAKARTA TIMUR,CAKUNG,CAKUNG TIMUR,58287,11527,46760,38699,85459,2021-11-11
3175041007,JAKARTA TIMUR,KRAMAT JATI,CAWANG,32762,7127,25635,20451,46086,2021-11-11
3175101008,JAKARTA TIMUR,CIPAYUNG,CEGER,18932,3689,15243,12655,27898,2021-11-11
3171031006,JAKARTA PUSAT,KEMAYORAN,CEMPAKA BARU,32581,6224,26357,20585,46942,2021-11-11
3171051002,JAKARTA PUSAT,CEMPAKA PUTIH,CEMPAKA PUTIH BARAT,35885,7679,28206,23965,52171,2021-11-11
3171051001,JAKARTA PUSAT,CEMPAKA PUTIH,CEMPAKA PUTIH TIMUR,24292,5005,19287,16750,36037,2021-11-11
3173011001,JAKARTA BARAT,CENGKARENG,CENGKARENG BARAT,66284,13297,52987,44770,97757,2021-11-11
3173011006,JAKARTA BARAT,CENGKARENG,CENGKARENG TIMUR,81027,16031,64996,53672,118668,2021-11-11
3175091002,JAKARTA TIMUR,CIRACAS,CIBUBUR,66364,11450,54914,46001,100915,2021-11-11
3171011002,JAKARTA PUSAT,GAMBIR,CIDENG,15390,3025,12365,10749,23114,2021-11-11
3174091003,JAKARTA SELATAN,JAGAKARSA,CIGANJUR,38497,6495,32002,26146,58148,2021-11-11
3175051003,JAKARTA TIMUR,PASAR REBO,CIJANTUNG,41419,7717,33702,27922,61624,2021-11-11
3171061003,JAKARTA PUSAT,MENTENG,CIKINI,8274,1493,6781,5334,12115,2021-11-11
3174081006,JAKARTA SELATAN,PANCORAN,CIKOKO,10547,1835,8712,7523,16235,2021-11-11
3174061001,JAKARTA SELATAN,CILANDAK,CILANDAK BARAT,51752,9177,42575,36939,79514,2021-11-11
3174041003,JAKARTA SELATAN,PASAR MINGGU,CILANDAK TIMUR,25145,4638,20507,17388,37895,2021-11-11
3175101002,JAKARTA TIMUR,CIPAYUNG,CILANGKAP,27635,4918,22717,19206,41923,2021-11-11
3175041006,JAKARTA TIMUR,KRAMAT JATI,CILILITAN,40181,8812,31369,25442,56811,2021-11-11
3172041001,JAKARTA UTARA,CILINCING,CILINCING,43609,10485,33124,25553,58677,2021-11-11
3175101001,JAKARTA TIMUR,CIPAYUNG,CIPAYUNG,26104,4572,21532,18394,39926,2021-11-11
3174091006,JAKARTA SELATAN,JAGAKARSA,CIPEDAK,38303,6351,31952,26714,58666,2021-11-11
3174061005,JAKARTA SELATAN,CILANDAK,CIPETE SELATAN,26704,5160,21544,18829,40373,2021-11-11
3174071010,JAKARTA SELATAN,KEBAYORAN BARU,CIPETE UTARA,34102,6517,27585,22822,50407,2021-11-11
3175021003,JAKARTA TIMUR,PULO GADUNG,CIPINANG,39306,7306,32000,26502,58502,2021-11-11
3175031007,JAKARTA TIMUR,JATINEGARA,CIPINANG BESAR SELATAN,35212,8357,26855,20863,47718,2021-11-11
3175031008,JAKARTA TIMUR,JATINEGARA,CIPINANG BESAR UTARA,45319,10693,34626,26823,61449,2021-11-11
3175031005,JAKARTA TIMUR,JATINEGARA,CIPINANG CEMPEDAK,32824,7145,25679,21685,47364,2021-11-11
3175081005,JAKARTA TIMUR,MAKASAR,CIPINANG MELAYU,42308,8214,34094,28748,62842,2021-11-11
3175031006,JAKARTA TIMUR,JATINEGARA,CIPINANG MUARA,55243,11843,43400,35126,78526,2021-11-11
3174051003,JAKARTA SELATAN,KEBAYORAN LAMA,CIPULIR,39937,8489,31448,25385,56833,2021-11-11
3175091001,JAKARTA TIMUR,CIRACAS,CIRACAS,64594,11882,52712,43413,96125,2021-11-11
3175041003,JAKARTA TIMUR,KRAMAT JATI,DUKUH,24609,4656,19953,16430,36383,2021-11-11
3175071001,JAKARTA TIMUR,DUREN SAWIT,DUREN SAWIT,61160,12939,48221,39578,87799,2021-11-11
3174081004,JAKARTA SELATAN,PANCORAN,DUREN TIGA,28319,5699,22620,18877,41497,2021-11-11
3173051005,JAKARTA BARAT,KEBON JERUK,DURI KEPA,60138,11808,48330,41518,89848,2021-11-11
3173011002,JAKARTA BARAT,CENGKARENG,DURI KOSAMBI,77923,16763,61160,48741,109901,2021-11-11
3171011006,JAKARTA PUSAT,GAMBIR,DURI PULO,19610,4150,15460,12401,27861,2021-11-11
3173041011,JAKARTA BARAT,TAMBORA,DURI SELATAN,14259,2557,11702,9863,21565,2021-11-11
3173041003,JAKARTA BARAT,TAMBORA,DURI UTARA,19844,3617,16227,13306,29533,2021-11-11
3171081003,JAKARTA PUSAT,JOHAR BARU,GALUR,18243,3597,14646,11764,26410,2021-11-11
3171011001,JAKARTA PUSAT,GAMBIR,GAMBIR,2191,458,1733,1499,3232,2021-11-11
3174061004,JAKARTA SELATAN,CILANDAK,GANDARIA SELATAN,22119,4270,17849,15118,32967,2021-11-11
3174071009,JAKARTA SELATAN,KEBAYORAN BARU,GANDARIA UTARA,39922,7992,31930,26838,58768,2021-11-11
3175051001,JAKARTA TIMUR,PASAR REBO,GEDONG,35755,7198,28557,24029,52586,2021-11-11
3171071001,JAKARTA PUSAT,TANAH ABANG,GELORA,3127,613,2514,2154,4668,2021-11-11
3173031007,JAKARTA BARAT,TAMAN SARI,GLODOK,7837,1202,6635,5905,12540,2021-11-11
3171061004,JAKARTA PUSAT,MENTENG,GONDANGDIA,4100,921,3179,2896,6075,2021-11-11
3173021001,JAKARTA BARAT,GROGOL PETAMBURAN,GROGOL,16876,3380,13496,11354,24850,2021-11-11
3174051005,JAKARTA SELATAN,KEBAYORAN LAMA,GROGOL SELATAN,44251,8830,35421,28933,64354,2021-11-11
3174051004,JAKARTA SELATAN,KEBAYORAN LAMA,GROGOL UTARA,42494,8687,33807,27853,61660,2021-11-11
3174021007,JAKARTA SELATAN,SETIA BUDI,GUNTUR,3985,746,3239,2837,6076,2021-11-11
3174071002,JAKARTA SELATAN,KEBAYORAN BARU,GUNUNG,9436,1752,7684,6799,14483,2021-11-11
3171031005,JAKARTA PUSAT,KEMAYORAN,GUNUNG SAHARI SELATAN,19199,3903,15296,12826,28122,2021-11-11
3171021004,JAKARTA PUSAT,SAWAH BESAR,GUNUNG SAHARI UTARA,16650,2952,13698,12178,25876,2021-11-11
3175081004,JAKARTA TIMUR,MAKASAR,HALIM PERDANA KUSUMAH,28363,3699,24664,22445,47109,2021-11-11
3171031003,JAKARTA PUSAT,KEMAYORAN,HARAPAN MULIA,22557,4578,17979,14576,32555,2021-11-11
3174091001,JAKARTA SELATAN,JAGAKARSA,JAGAKARSA,62389,10329,52060,43063,95123,2021-11-11
3175021007,JAKARTA TIMUR,PULO GADUNG,JATI,32757,6133,26624,22917,49541,2021-11-11
3174041002,JAKARTA SELATAN,PASAR MINGGU,JATI PADANG,37502,7467,30035,25120,55155,2021-11-11
3173071004,JAKARTA BARAT,PALMERAH,JATI PULO,28738,5731,23007,18324,41331,2021-11-11
3175061001,JAKARTA TIMUR,CAKUNG,JATINEGARA,84160,17986,66174,54181,120355,2021-11-11
3175021004,JAKARTA TIMUR,PULO GADUNG,JATINEGARA KAUM,24632,4419,20213,16397,36610,2021-11-11
3173021004,JAKARTA BARAT,GROGOL PETAMBURAN,JELAMBAR,30266,5555,24711,21470,46181,2021-11-11
3173021006,JAKARTA BARAT,GROGOL PETAMBURAN,JELAMBAR BARU,38246,7104,31142,26903,58045,2021-11-11
3173041006,JAKARTA BARAT,TAMBORA,JEMBATAN BESI,29314,7121,22193,17226,39419,2021-11-11
3173041008,JAKARTA BARAT,TAMBORA,JEMBATAN LIMA,21021,4870,16151,12690,28841,2021-11-11
3173081005,JAKARTA BARAT,KEMBANGAN,JOGLO,40839,8264,32575,27477,60052,2021-11-11
3171081001,JAKARTA PUSAT,JOHAR BARU,JOHAR BARU,37488,6974,30514,25672,56186,2021-11-11
3173041002,JAKARTA BARAT,TAMBORA,KALI ANYAR,23856,4736,19120,15166,34286,2021-11-11
3172041004,JAKARTA UTARA,CILINCING,KALIBARU,67684,18683,49001,34746,83747,2021-11-11
3174081002,JAKARTA SELATAN,PANCORAN,KALIBATA,41994,9547,32447,26222,58669,2021-11-11
3173061001,JAKARTA BARAT,KALI DERES,KALIDERES,72447,14700,57747,48735,106482,2021-11-11
3175051004,JAKARTA TIMUR,PASAR REBO,KALISARI,43212,7761,35451,29698,65149,2021-11-11
3173061004,JAKARTA BARAT,KALI DERES,KAMAL,53783,12613,41170,32539,73709,2021-11-11
3172011002,JAKARTA UTARA,PENJARINGAN,KAMAL MUARA,12930,2294,10636,9043,19679,2021-11-11
3171071007,JAKARTA PUSAT,TANAH ABANG,KAMPUNG BALI,11358,2460,8898,6803,15701,2021-11-11
3175031001,JAKARTA TIMUR,JATINEGARA,KAMPUNG MELAYU,25717,5903,19814,15386,35200,2021-11-11
3171081002,JAKARTA PUSAT,JOHAR BARU,KAMPUNG RAWA,21237,3539,17698,14115,31813,2021-11-11
3175041002,JAKARTA TIMUR,KRAMAT JATI,KAMPUNG TENGAH,43993,11080,32913,26219,59132,2021-11-11
3173011005,JAKARTA BARAT,CENGKARENG,KAPUK,134466,32570,101896,82040,183936,2021-11-11
3172011003,JAKARTA UTARA,PENJARINGAN,KAPUK MUARA,35781,6890,28891,25247,54138,2021-11-11
3171021002,JAKARTA PUSAT,SAWAH BESAR,KARANG ANYAR,25761,4964,20797,17453,38250,2021-11-11
3174021004,JAKARTA SELATAN,SETIA BUDI,KARET,9623,1853,7770,6441,14211,2021-11-11
3174021003,JAKARTA SELATAN,SETIA BUDI,KARET KUNINGAN,16055,3134,12921,10910,23831,2021-11-11
3174021002,JAKARTA SELATAN,SETIA BUDI,KARET SEMANGGI,2770,553,2217,1959,4176,2021-11-11
3171071003,JAKARTA PUSAT,TANAH ABANG,KARET TENGSIN,19271,3731,15540,12644,28184,2021-11-11
3171021003,JAKARTA PUSAT,SAWAH BESAR,KARTINI,22292,4232,18060,15460,33520,2021-11-11
3175011003,JAKARTA TIMUR,MATRAMAN,KAYU MANIS,25284,5358,19926,15806,35732,2021-11-11
3175021006,JAKARTA TIMUR,PULO GADUNG,KAYU PUTIH,40696,7700,32996,28735,61731,2021-11-11
3173031006,JAKARTA BARAT,TAMAN SARI,KEAGUNGAN,17387,3241,14146,11490,25636,2021-11-11
3174041007,JAKARTA SELATAN,PASAR MINGGU,KEBAGUSAN,44552,8865,35687,29289,64976,2021-11-11
3174051006,JAKARTA SELATAN,KEBAYORAN LAMA,KEBAYORAN LAMA SELATAN,41212,7689,33523,28317,61840,2021-11-11
3174051001,JAKARTA SELATAN,KEBAYORAN LAMA,KEBAYORAN LAMA UTARA,42422,8850,33572,27591,61163,2021-11-11
3174011004,JAKARTA SELATAN,TEBET,KEBON BARU,35165,6664,28501,23834,52335,2021-11-11
3172021005,JAKARTA UTARA,TANJUNG PRIOK,KEBON BAWANG,50952,10334,40618,33682,74300,2021-11-11
3173051001,JAKARTA BARAT,KEBON JERUK,KEBON JERUK,53887,11517,42370,34517,76887,2021-11-11
3171071006,JAKARTA PUSAT,TANAH ABANG,KEBON KACANG,21531,5160,16371,12878,29249,2021-11-11
3171011005,JAKARTA PUSAT,GAMBIR,KEBON KELAPA,10163,2042,8121,6812,14933,2021-11-11
3171031002,JAKARTA PUSAT,KEMAYORAN,KEBON KOSONG,30019,6020,23999,19510,43509,2021-11-11
3175011005,JAKARTA TIMUR,MATRAMAN,KEBON MANGGIS,16490,3227,13263,10948,24211,2021-11-11
3171071005,JAKARTA PUSAT,TANAH ABANG,KEBON MELATI,32206,8637,23569,17431,41000,2021-11-11
3175081003,JAKARTA TIMUR,MAKASAR,KEBON PALA,46614,9229,37385,30987,68372,2021-11-11
3171061005,JAKARTA PUSAT,MENTENG,KEBON SIRIH,12299,2666,9633,7711,17344,2021-11-11
3173011004,JAKARTA BARAT,CENGKARENG,KEDAUNG KALI ANGKE,32612,6358,26254,21941,48195,2021-11-11
3173051007,JAKARTA BARAT,KEBON JERUK,KEDOYA SELATAN,32165,5897,26268,21650,47918,2021-11-11
3173051006,JAKARTA BARAT,KEBON JERUK,KEDOYA UTARA,45740,8723,37017,31224,68241,2021-11-11
3173051004,JAKARTA BARAT,KEBON JERUK,KELAPA DUA,23565,4607,18958,15677,34635,2021-11-11
3175091003,JAKARTA TIMUR,CIRACAS,KELAPA DUA WETAN,46875,8024,38851,32644,71495,2021-11-11
3172061003,JAKARTA UTARA,KELAPA GADING,KELAPA GADING BARAT,35717,6239,29478,26494,55972,2021-11-11
3172061001,JAKARTA UTARA,KELAPA GADING,KELAPA GADING TIMUR,33592,5151,28441,26223,54664,2021-11-11
3173071005,JAKARTA BARAT,PALMERAH,KEMANGGISAN,32139,6105,26034,21786,47820,2021-11-11
3171031001,JAKARTA PUSAT,KEMAYORAN,KEMAYORAN,20708,4214,16494,13511,30005,2021-11-11
3173081006,JAKARTA BARAT,KEMBANGAN,KEMBANGAN SELATAN,27130,5706,21424,18459,39883,2021-11-11
3173081001,JAKARTA BARAT,KEMBANGAN,KEMBANGAN UTARA,54451,11975,42476,35247,77723,2021-11-11
3171041002,JAKARTA PUSAT,SENEN,KENARI,9579,1869,7710,6550,14260,2021-11-11
3173041005,JAKARTA BARAT,TAMBORA,KERENDANG,19973,4087,15886,12852,28738,2021-11-11
3175071003,JAKARTA TIMUR,DUREN SAWIT,KLENDER,69978,16473,53505,42422,95927,2021-11-11
3172031001,JAKARTA UTARA,KOJA,KOJA,28175,6439,21736,17485,39221,2021-11-11
3173071006,JAKARTA BARAT,PALMERAH,KOTA BAMBU SELATAN,21158,4179,16979,13245,30224,2021-11-11
3173071003,JAKARTA BARAT,PALMERAH,KOTA BAMBU UTARA,24995,5182,19813,15306,35119,2021-11-11
3171041004,JAKARTA PUSAT,SENEN,KRAMAT,28835,6947,21888,16605,38493,2021-11-11
3175041001,JAKARTA TIMUR,KRAMAT JATI,KRAMAT JATI,34144,7531,26613,21621,48234,2021-11-11
3174071003,JAKARTA SELATAN,KEBAYORAN BARU,KRAMAT PELA,14413,2805,11608,9895,21503,2021-11-11
3173031002,JAKARTA BARAT,TAMAN SARI,KRUKUT,19244,3640,15604,12623,28227,2021-11-11
3174031005,JAKARTA SELATAN,MAMPANG PRAPATAN,KUNINGAN BARAT,12785,2341,10444,8659,19103,2021-11-11
3174021008,JAKARTA SELATAN,SETIA BUDI,KUNINGAN TIMUR,6008,1193,4815,4058,8873,2021-11-11
3171041005,JAKARTA PUSAT,SENEN,KWITANG,15486,3461,12025,9643,21668,2021-11-11
3172031003,JAKARTA UTARA,KOJA,LAGOA,59065,14047,45018,35408,80426,2021-11-11
3174061002,JAKARTA SELATAN,CILANDAK,LEBAK BULUS,37626,7127,30499,26565,57064,2021-11-11
3174091004,JAKARTA SELATAN,JAGAKARSA,LENTENG AGUNG,53946,9712,44234,35934,80168,2021-11-11
3175101007,JAKARTA TIMUR,CIPAYUNG,LUBANG BUAYA,63547,11991,51556,42557,94113,2021-11-11
3175081001,JAKARTA TIMUR,MAKASAR,MAKASAR,34390,6346,28044,23496,51540,2021-11-11
3175071006,JAKARTA TIMUR,DUREN SAWIT,MALAKA JAYA,30927,5307,25620,21890,47510,2021-11-11
3175071005,JAKARTA TIMUR,DUREN SAWIT,MALAKA SARI,27530,4581,22949,19675,42624,2021-11-11
3174031001,JAKARTA SELATAN,MAMPANG PRAPATAN,MAMPANG PRAPATAN,18159,3742,14417,11852,26269,2021-11-11
3173031005,JAKARTA BARAT,TAMAN SARI,MANGGA BESAR,7707,1293,6414,5621,12035,2021-11-11
3171021005,JAKARTA PUSAT,SAWAH BESAR,MANGGA DUA SELATAN,27442,5730,21712,18373,40085,2021-11-11
3174011007,JAKARTA SELATAN,TEBET,MANGGARAI,28373,5025,23348,18892,42240,2021-11-11
3174011006,JAKARTA SELATAN,TEBET,MANGGARAI SELATAN,23075,4032,19043,15984,35027,2021-11-11
3173031003,JAKARTA BARAT,TAMAN SARI,MAPHAR,16461,3075,13386,11154,24540,2021-11-11
3172041003,JAKARTA UTARA,CILINCING,MARUNDA,28943,6578,22365,16700,39065,2021-11-11
3174071001,JAKARTA SELATAN,KEBAYORAN BARU,MELAWAI,2627,511,2116,1943,4059,2021-11-11
3171061001,JAKARTA PUSAT,MENTENG,MENTENG,25624,5670,19954,15695,35649,2021-11-11
3174021005,JAKARTA SELATAN,SETIA BUDI,MENTENG ATAS,27816,5023,22793,18878,41671,2021-11-11
3174011003,JAKARTA SELATAN,TEBET,MENTENG DALAM,36028,7042,28986,24384,53370,2021-11-11
3173081003,JAKARTA BARAT,KEMBANGAN,MERUYA SELATAN,32130,6629,25501,21383,46884,2021-11-11
3173081002,JAKARTA BARAT,KEMBANGAN,MERUYA UTARA,43752,9025,34727,30096,64823,2021-11-11
3175101004,JAKARTA TIMUR,CIPAYUNG,MUNJUL,23871,4360,19511,16468,35979,2021-11-11
3172051002,JAKARTA UTARA,PADEMANGAN,PADEMANGAN BARAT,74240,17584,56656,45589,102245,2021-11-11
3172051001,JAKARTA UTARA,PADEMANGAN,PADEMANGAN TIMUR,37736,6710,31026,27118,58144,2021-11-11
3175011004,JAKARTA TIMUR,MATRAMAN,PAL MERIAM,19769,4097,15672,12563,28235,2021-11-11
3173071001,JAKARTA BARAT,PALMERAH,PALMERAH,63011,13282,49729,40416,90145,2021-11-11
3174081001,JAKARTA SELATAN,PANCORAN,PANCORAN,19421,3995,15426,12716,28142,2021-11-11
3172021003,JAKARTA UTARA,TANJUNG PRIOK,PAPANGGO,39097,7688,31409,25682,57091,2021-11-11
3171021001,JAKARTA PUSAT,SAWAH BESAR,PASAR BARU,12035,2303,9732,8680,18412,2021-11-11
3174021006,JAKARTA SELATAN,SETIA BUDI,PASAR MANGGIS,26752,5279,21473,17642,39115,2021-11-11
3174041001,JAKARTA SELATAN,PASAR MINGGU,PASAR MINGGU,24821,4680,20141,17154,37295,2021-11-11
3171041003,JAKARTA PUSAT,SENEN,PASEBAN,23533,4895,18638,15246,33884,2021-11-11
3173061005,JAKARTA BARAT,KALI DERES,PEGADUNGAN,75587,14969,60618,51935,112553,2021-11-11
3171061002,JAKARTA PUSAT,MENTENG,PEGANGSAAN,23455,5059,18396,14096,32492,2021-11-11
3172061002,JAKARTA UTARA,KELAPA GADING,PEGANGSAAN DUA,49976,8279,41697,37641,79338,2021-11-11
3172011004,JAKARTA UTARA,PENJARINGAN,PEJAGALAN,74578,15508,59070,50775,109845,2021-11-11
3174041006,JAKARTA SELATAN,PASAR MINGGU,PEJATEN BARAT,37346,7308,30038,25051,55089,2021-11-11
3174041005,JAKARTA SELATAN,PASAR MINGGU,PEJATEN TIMUR,57656,12948,44708,36714,81422,2021-11-11
3175051005,JAKARTA TIMUR,PASAR REBO,PEKAYON,43250,7865,35385,29327,64712,2021-11-11
3173041009,JAKARTA BARAT,TAMBORA,PEKOJAN,23587,4496,19091,15910,35001,2021-11-11
3174031003,JAKARTA SELATAN,MAMPANG PRAPATAN,PELA MAMPANG,43522,8568,34954,29094,64048,2021-11-11
3174081005,JAKARTA SELATAN,PANCORAN,PENGADEGAN,21478,3950,17528,14864,32392,2021-11-11
3175061003,JAKARTA TIMUR,CAKUNG,PENGGILINGAN,99255,23078,76177,60752,136929,2021-11-11
3172011001,JAKARTA UTARA,PENJARINGAN,PENJARINGAN,88308,22657,65651,50491,116142,2021-11-11
3174101001,JAKARTA SELATAN,PESANGGRAHAN,PESANGGRAHAN,27545,4747,22798,19465,42263,2021-11-11
3171071004,JAKARTA PUSAT,TANAH ABANG,PETAMBURAN,33271,8780,24491,18516,43007,2021-11-11
3174071008,JAKARTA SELATAN,KEBAYORAN BARU,PETOGOGAN,11499,2237,9262,7882,17144,2021-11-11
3171011004,JAKARTA PUSAT,GAMBIR,PETOJO SELATAN,14692,3317,11375,9645,21020,2021-11-11
3171011003,JAKARTA PUSAT,GAMBIR,PETOJO UTARA,17458,3773,13685,11272,24957,2021-11-11
3174101004,JAKARTA SELATAN,PESANGGRAHAN,PETUKANGAN SELATAN,37187,7692,29495,24731,54226,2021-11-11
3174101003,JAKARTA SELATAN,PESANGGRAHAN,PETUKANGAN UTARA,53716,11550,42166,34889,77055,2021-11-11
3175081002,JAKARTA TIMUR,MAKASAR,PINANG RANTI,27198,5922,21276,17493,38769,2021-11-11
3173031008,JAKARTA BARAT,TAMAN SARI,PINANGSIA,10729,1882,8847,7324,16171,2021-11-11
3175011001,JAKARTA TIMUR,MATRAMAN,PISANGAN BARU,31776,6540,25236,20036,45272,2021-11-11
3175021002,JAKARTA TIMUR,PULO GADUNG,PISANGAN TIMUR,41011,7621,33390,28198,61588,2021-11-11
3172011005,JAKARTA UTARA,PENJARINGAN,PLUIT,47783,9197,38586,33806,72392,2021-11-11
3175071002,JAKARTA TIMUR,DUREN SAWIT,PONDOK BAMBU,61550,13030,48520,39839,88359,2021-11-11
3175071004,JAKARTA TIMUR,DUREN SAWIT,PONDOK KELAPA,72015,14269,57746,49371,107117,2021-11-11
3175071007,JAKARTA TIMUR,DUREN SAWIT,PONDOK KOPI,35367,6633,28734,22742,51476,2021-11-11
3174061003,JAKARTA SELATAN,CILANDAK,PONDOK LABU,46464,7864,38600,33404,72004,2021-11-11
3174051002,JAKARTA SELATAN,KEBAYORAN LAMA,PONDOK PINANG,56169,10789,45380,38730,84110,2021-11-11
3175101003,JAKARTA TIMUR,CIPAYUNG,PONDOK RANGGON,25574,4802,20772,17418,38190,2021-11-11
3101011003,KAB.ADM.KEP.SERIBU,KEP. SERIBU UTARA,PULAU HARAPAN,2060,221,1839,1607,3446,2021-11-11
3101011002,KAB.ADM.KEP.SERIBU,KEP. SERIBU UTARA,PULAU KELAPA,5528,596,4932,4071,9003,2021-11-11
3101011001,KAB.ADM.KEP.SERIBU,KEP. SERIBU UTARA,PULAU PANGGANG,5450,440,5010,4478,9488,2021-11-11
3101021003,KAB.ADM.KEP.SERIBU,KEP. SERIBU SELATAN,PULAU PARI,2765,193,2572,2417,4989,2021-11-11
3101021002,KAB.ADM.KEP.SERIBU,KEP. SERIBU SELATAN,PULAU TIDUNG,4553,367,4186,3828,8014,2021-11-11
3101021001,KAB.ADM.KEP.SERIBU,KEP. SERIBU SELATAN,PULAU UNTUNG JAWA,1941,162,1779,1641,3420,2021-11-11
3174071007,JAKARTA SELATAN,KEBAYORAN BARU,PULO,5835,1013,4822,4403,9225,2021-11-11
3175021001,JAKARTA TIMUR,PULO GADUNG,PULO GADUNG,34422,7547,26875,22409,49284,2021-11-11
3175061005,JAKARTA TIMUR,CAKUNG,PULO GEBANG,97301,18800,78501,63572,142073,2021-11-11
3174041004,JAKARTA SELATAN,PASAR MINGGU,RAGUNAN,39616,7330,32286,27410,59696,2021-11-11
3175091005,JAKARTA TIMUR,CIRACAS,RAMBUTAN,36771,8627,28144,22614,50758,2021-11-11
3172031006,JAKARTA UTARA,KOJA,RAWA BADAK SELATAN,42179,10039,32140,25286,57426,2021-11-11
3172031004,JAKARTA UTARA,KOJA,RAWA BADAK UTARA,34408,7725,26683,21355,48038,2021-11-11
3174071005,JAKARTA SELATAN,KEBAYORAN BARU,RAWA BARAT,5625,1002,4623,4092,8715,2021-11-11
3173011003,JAKARTA BARAT,CENGKARENG,RAWA BUAYA,63799,12751,51048,41339,92387,2021-11-11
3175031004,JAKARTA TIMUR,JATINEGARA,RAWA BUNGA,21434,5192,16242,13123,29365,2021-11-11
3174081003,JAKARTA SELATAN,PANCORAN,RAWA JATI,20509,3911,16598,14144,30742,2021-11-11
3175061002,JAKARTA TIMUR,CAKUNG,RAWA TERATE,24637,4495,20142,16403,36545,2021-11-11
3175021005,JAKARTA TIMUR,PULO GADUNG,RAWAMANGUN,37612,7427,30185,25498,55683,2021-11-11
3171051003,JAKARTA PUSAT,CEMPAKA PUTIH,RAWASARI,21967,4482,17485,14898,32383,2021-11-11
3173041010,JAKARTA BARAT,TAMBORA,ROA MALAKA,3484,619,2865,2526,5391,2021-11-11
3172041006,JAKARTA UTARA,CILINCING,ROROTAN,41668,8369,33299,26590,59889,2021-11-11
3174071004,JAKARTA SELATAN,KEBAYORAN BARU,SELONG,2842,548,2294,2122,4416,2021-11-11
3173061002,JAKARTA BARAT,KALI DERES,SEMANAN,71354,15358,55996,45186,101182,2021-11-11
3172041007,JAKARTA UTARA,CILINCING,SEMPER BARAT,68587,13396,55191,45673,100864,2021-11-11
3172041005,JAKARTA UTARA,CILINCING,SEMPER TIMUR,36267,7820,28447,23010,51457,2021-11-11
3174071006,JAKARTA SELATAN,KEBAYORAN BARU,SENAYAN,2771,653,2118,1823,3941,2021-11-11
3171041001,JAKARTA PUSAT,SENEN,SENEN,6804,1457,5347,4444,9791,2021-11-11
3171031004,JAKARTA PUSAT,KEMAYORAN,SERDANG,29668,5831,23837,19743,43580,2021-11-11
3174021001,JAKARTA SELATAN,SETIA BUDI,SETIA BUDI,3023,612,2411,2043,4454,2021-11-11
3175101005,JAKARTA TIMUR,CIPAYUNG,SETU,20572,4099,16473,13359,29832,2021-11-11
3173071002,JAKARTA BARAT,PALMERAH,SLIPI,16591,2985,13606,11414,25020,2021-11-11
3173081004,JAKARTA BARAT,KEMBANGAN,SRENGSENG,45523,10259,35264,29804,65068,2021-11-11
3174091002,JAKARTA SELATAN,JAGAKARSA,SRENGSENG SAWAH,58196,9041,49155,41703,90858,2021-11-11
3173051003,JAKARTA BARAT,KEBON JERUK,SUKABUMI SELATAN,37033,8295,28738,22278,51016,2021-11-11
3173051002,JAKARTA BARAT,KEBON JERUK,SUKABUMI UTARA,38290,8978,29312,22932,52244,2021-11-11
3172041002,JAKARTA UTARA,CILINCING,SUKAPURA,53949,12192,41757,34244,76001,2021-11-11
3171031007,JAKARTA PUSAT,KEMAYORAN,SUMUR BATU,22717,4429,18288,15431,33719,2021-11-11
3172021004,JAKARTA UTARA,TANJUNG PRIOK,SUNGAI BAMBU,29876,6034,23842,19749,43591,2021-11-11
3172021006,JAKARTA UTARA,TANJUNG PRIOK,SUNTER AGUNG,71805,12475,59330,51690,111020,2021-11-11
3172021002,JAKARTA UTARA,TANJUNG PRIOK,SUNTER JAYA,63031,11136,51895,44765,96660,2021-11-11
3175091004,JAKARTA TIMUR,CIRACAS,SUSUKAN,38257,7226,31031,25825,56856,2021-11-11
3173031001,JAKARTA BARAT,TAMAN SARI,TAMAN SARI,14348,2630,11718,10032,21750,2021-11-11
3173041001,JAKARTA BARAT,TAMBORA,TAMBORA,10204,2245,7959,6395,14354,2021-11-11
3173041004,JAKARTA BARAT,TAMBORA,TANAH SEREAL,26387,4498,21889,18354,40243,2021-11-11
3171081004,JAKARTA PUSAT,JOHAR BARU,TANAH TINGGI,37693,7203,30490,24659,55149,2021-11-11
3173031004,JAKARTA BARAT,TAMAN SARI,TANGKI,13324,2208,11116,9363,20479,2021-11-11
3174091005,JAKARTA SELATAN,JAGAKARSA,TANJUNG BARAT,39770,6780,32990,27333,60323,2021-11-11
3173021005,JAKARTA BARAT,GROGOL PETAMBURAN,TANJUNG DUREN SELATAN,25337,4832,20505,18029,38534,2021-11-11
3173021002,JAKARTA BARAT,GROGOL PETAMBURAN,TANJUNG DUREN UTARA,17010,2887,14123,12639,26762,2021-11-11
3172021001,JAKARTA UTARA,TANJUNG PRIOK,TANJUNG PRIOK,34588,7149,27439,22354,49793,2021-11-11
3174011002,JAKARTA SELATAN,TEBET,TEBET BARAT,21194,3442,17752,15591,33343,2021-11-11
3174011001,JAKARTA SELATAN,TEBET,TEBET TIMUR,18199,2931,15268,13722,28990,2021-11-11
3173061003,JAKARTA BARAT,KALI DERES,TEGAL ALUR,83647,17333,66314,54662,120976,2021-11-11
3174031004,JAKARTA SELATAN,MAMPANG PRAPATAN,TEGAL PARANG,32401,7156,25245,19670,44915,2021-11-11
3173021003,JAKARTA BARAT,GROGOL PETAMBURAN,TOMANG,29605,5474,24131,20575,44706,2021-11-11
3172031005,JAKARTA UTARA,KOJA,TUGU SELATAN,39122,8746,30376,24416,54792,2021-11-11
3172031002,JAKARTA UTARA,KOJA,TUGU UTARA,67670,16014,51656,40721,92377,2021-11-11
3175061006,JAKARTA TIMUR,CAKUNG,UJUNG MENTENG,29934,5188,24746,20919,45665,2021-11-11
3174101005,JAKARTA SELATAN,PESANGGRAHAN,ULUJAMI,40544,9173,31371,25803,57174,2021-11-11
3175011006,JAKARTA TIMUR,MATRAMAN,UTAN KAYU SELATAN,33511,6055,27456,22619,50075,2021-11-11
3175011002,JAKARTA TIMUR,MATRAMAN,UTAN KAYU UTARA,28169,5874,22295,18209,40504,2021-11-11
3171031008,JAKARTA PUSAT,KEMAYORAN,UTAN PANJANG,29208,5947,23261,18770,42031,2021-11-11
3172021007,JAKARTA UTARA,TANJUNG PRIOK,WARAKAS,44401,8171,36230,29188,65418,2021-11-11
3173021007,JAKARTA BARAT,GROGOL PETAMBURAN,WIJAYA KUSUMA,38934,8144,30790,25839,56629,2021-11-11
3172051003,JAKARTA UTARA,PADEMANGAN,ANCOL,23947,5798,18149,14869,33018,2021-11-12
3173041007,JAKARTA BARAT,TAMBORA,ANGKE,29381,6249,23132,18693,41825,2021-11-12
3175041005,JAKARTA TIMUR,KRAMAT JATI,BALE KAMBANG,29074,7296,21778,17088,38866,2021-11-12
3175031003,JAKARTA TIMUR,JATINEGARA,BALI MESTER,9752,2053,7699,6464,14163,2021-11-12
3175101006,JAKARTA TIMUR,CIPAYUNG,BAMBU APUS,26285,4838,21447,17881,39328,2021-11-12
3174031002,JAKARTA SELATAN,MAMPANG PRAPATAN,BANGKA,21566,4572,16994,14006,31000,2021-11-12
3175051002,JAKARTA TIMUR,PASAR REBO,BARU,23886,3953,19933,17061,36994,2021-11-12
3175041004,JAKARTA TIMUR,KRAMAT JATI,BATU AMPAR,47898,11641,36257,29103,65360,2021-11-12
3171071002,JAKARTA PUSAT,TANAH ABANG,BENDUNGAN HILIR,21494,4349,17145,14599,31744,2021-11-12
3175031002,JAKARTA TIMUR,JATINEGARA,BIDARA CINA,36689,8818,27871,22226,50097,2021-11-12
3174101002,JAKARTA SELATAN,PESANGGRAHAN,BINTARO,53098,10654,42444,36565,79009,2021-11-12
3174011005,JAKARTA SELATAN,TEBET,BUKIT DURI,34183,6928,27255,22594,49849,2021-11-12
3171041006,JAKARTA PUSAT,SENEN,BUNGUR,18144,3776,14368,11860,26228,2021-11-12
3175061007,JAKARTA TIMUR,CAKUNG,CAKUNG BARAT,57724,11841,45883,37717,83600,2021-11-12
3175061004,JAKARTA TIMUR,CAKUNG,CAKUNG TIMUR,58287,11490,46797,38764,85561,2021-11-12
3175041007,JAKARTA TIMUR,KRAMAT JATI,CAWANG,32762,7080,25682,20486,46168,2021-11-12
3175101008,JAKARTA TIMUR,CIPAYUNG,CEGER,18932,3675,15257,12713,27970,2021-11-12
3171031006,JAKARTA PUSAT,KEMAYORAN,CEMPAKA BARU,32581,6217,26364,20604,46968,2021-11-12
3171051002,JAKARTA PUSAT,CEMPAKA PUTIH,CEMPAKA PUTIH BARAT,35885,7670,28215,23987,52202,2021-11-12
3171051001,JAKARTA PUSAT,CEMPAKA PUTIH,CEMPAKA PUTIH TIMUR,24292,4997,19295,16767,36062,2021-11-12
3173011001,JAKARTA BARAT,CENGKARENG,CENGKARENG BARAT,66284,13266,53018,44913,97931,2021-11-12
3173011006,JAKARTA BARAT,CENGKARENG,CENGKARENG TIMUR,81027,16010,65017,53728,118745,2021-11-12
3175091002,JAKARTA TIMUR,CIRACAS,CIBUBUR,66364,11430,54934,46068,101002,2021-11-12
3171011002,JAKARTA PUSAT,GAMBIR,CIDENG,15390,3023,12367,10753,23120,2021-11-12
3174091003,JAKARTA SELATAN,JAGAKARSA,CIGANJUR,38497,6485,32012,26204,58216,2021-11-12
3175051003,JAKARTA TIMUR,PASAR REBO,CIJANTUNG,41419,7708,33711,27949,61660,2021-11-12
3171061003,JAKARTA PUSAT,MENTENG,CIKINI,8274,1491,6783,5336,12119,2021-11-12
3174081006,JAKARTA SELATAN,PANCORAN,CIKOKO,10547,1834,8713,7538,16251,2021-11-12
3174061001,JAKARTA SELATAN,CILANDAK,CILANDAK BARAT,51752,9164,42588,36981,79569,2021-11-12
3174041003,JAKARTA SELATAN,PASAR MINGGU,CILANDAK TIMUR,25145,4630,20515,17407,37922,2021-11-12
3175101002,JAKARTA TIMUR,CIPAYUNG,CILANGKAP,27635,4909,22726,19240,41966,2021-11-12
3175041006,JAKARTA TIMUR,KRAMAT JATI,CILILITAN,40181,8797,31384,25472,56856,2021-11-12
3172041001,JAKARTA UTARA,CILINCING,CILINCING,43609,10478,33131,25573,58704,2021-11-12
3175101001,JAKARTA TIMUR,CIPAYUNG,CIPAYUNG,26104,4564,21540,18418,39958,2021-11-12
3174091006,JAKARTA SELATAN,JAGAKARSA,CIPEDAK,38303,6339,31964,26742,58706,2021-11-12
3174061005,JAKARTA SELATAN,CILANDAK,CIPETE SELATAN,26704,5151,21553,18850,40403,2021-11-12
3174071010,JAKARTA SELATAN,KEBAYORAN BARU,CIPETE UTARA,34102,6508,27594,22869,50463,2021-11-12
3175021003,JAKARTA TIMUR,PULO GADUNG,CIPINANG,39306,7296,32010,26531,58541,2021-11-12
3175031007,JAKARTA TIMUR,JATINEGARA,CIPINANG BESAR SELATAN,35212,8353,26859,20888,47747,2021-11-12
3175031008,JAKARTA TIMUR,JATINEGARA,CIPINANG BESAR UTARA,45319,10690,34629,26850,61479,2021-11-12
3175031005,JAKARTA TIMUR,JATINEGARA,CIPINANG CEMPEDAK,32824,7139,25685,21705,47390,2021-11-12
3175081005,JAKARTA TIMUR,MAKASAR,CIPINANG MELAYU,42308,8209,34099,28776,62875,2021-11-12
3175031006,JAKARTA TIMUR,JATINEGARA,CIPINANG MUARA,55243,11830,43413,35172,78585,2021-11-12
3174051003,JAKARTA SELATAN,KEBAYORAN LAMA,CIPULIR,39937,8480,31457,25407,56864,2021-11-12
3175091001,JAKARTA TIMUR,CIRACAS,CIRACAS,64594,11866,52728,43457,96185,2021-11-12
3175041003,JAKARTA TIMUR,KRAMAT JATI,DUKUH,24609,4642,19967,16449,36416,2021-11-12
3175071001,JAKARTA TIMUR,DUREN SAWIT,DUREN SAWIT,61160,12930,48230,39624,87854,2021-11-12
3174081004,JAKARTA SELATAN,PANCORAN,DUREN TIGA,28319,5692,22627,18909,41536,2021-11-12
3173051005,JAKARTA BARAT,KEBON JERUK,DURI KEPA,60138,11788,48350,41551,89901,2021-11-12
3173011002,JAKARTA BARAT,CENGKARENG,DURI KOSAMBI,77923,16725,61198,48875,110073,2021-11-12
3171011006,JAKARTA PUSAT,GAMBIR,DURI PULO,19610,4146,15464,12410,27874,2021-11-12
3173041011,JAKARTA BARAT,TAMBORA,DURI SELATAN,14259,2552,11707,9878,21585,2021-11-12
3173041003,JAKARTA BARAT,TAMBORA,DURI UTARA,19844,3611,16233,13314,29547,2021-11-12
3171081003,JAKARTA PUSAT,JOHAR BARU,GALUR,18243,3591,14652,11775,26427,2021-11-12
3171011001,JAKARTA PUSAT,GAMBIR,GAMBIR,2191,457,1734,1502,3236,2021-11-12
3174061004,JAKARTA SELATAN,CILANDAK,GANDARIA SELATAN,22119,4264,17855,15129,32984,2021-11-12
3174071009,JAKARTA SELATAN,KEBAYORAN BARU,GANDARIA UTARA,39922,7978,31944,26889,58833,2021-11-12
3175051001,JAKARTA TIMUR,PASAR REBO,GEDONG,35755,7186,28569,24059,52628,2021-11-12
3171071001,JAKARTA PUSAT,TANAH ABANG,GELORA,3127,612,2515,2156,4671,2021-11-12
3173031007,JAKARTA BARAT,TAMAN SARI,GLODOK,7837,1201,6636,5912,12548,2021-11-12
3171061004,JAKARTA PUSAT,MENTENG,GONDANGDIA,4100,919,3181,2898,6079,2021-11-12
3173021001,JAKARTA BARAT,GROGOL PETAMBURAN,GROGOL,16876,3379,13497,11364,24861,2021-11-12
3174051005,JAKARTA SELATAN,KEBAYORAN LAMA,GROGOL SELATAN,44251,8820,35431,28964,64395,2021-11-12
3174051004,JAKARTA SELATAN,KEBAYORAN LAMA,GROGOL UTARA,42494,8678,33816,27876,61692,2021-11-12
3174021007,JAKARTA SELATAN,SETIA BUDI,GUNTUR,3985,744,3241,2839,6080,2021-11-12
3174071002,JAKARTA SELATAN,KEBAYORAN BARU,GUNUNG,9436,1751,7685,6810,14495,2021-11-12
3171031005,JAKARTA PUSAT,KEMAYORAN,GUNUNG SAHARI SELATAN,19199,3898,15301,12843,28144,2021-11-12
3171021004,JAKARTA PUSAT,SAWAH BESAR,GUNUNG SAHARI UTARA,16650,2946,13704,12189,25893,2021-11-12
3175081004,JAKARTA TIMUR,MAKASAR,HALIM PERDANA KUSUMAH,28363,3689,24674,22472,47146,2021-11-12
3171031003,JAKARTA PUSAT,KEMAYORAN,HARAPAN MULIA,22557,4569,17988,14588,32576,2021-11-12
3174091001,JAKARTA SELATAN,JAGAKARSA,JAGAKARSA,62389,10300,52089,43190,95279,2021-11-12
3175021007,JAKARTA TIMUR,PULO GADUNG,JATI,32757,6127,26630,22943,49573,2021-11-12
3174041002,JAKARTA SELATAN,PASAR MINGGU,JATI PADANG,37502,7402,30100,25243,55343,2021-11-12
3173071004,JAKARTA BARAT,PALMERAH,JATI PULO,28738,5724,23014,18341,41355,2021-11-12
3175061001,JAKARTA TIMUR,CAKUNG,JATINEGARA,84160,17962,66198,54256,120454,2021-11-12
3175021004,JAKARTA TIMUR,PULO GADUNG,JATINEGARA KAUM,24632,4411,20221,16417,36638,2021-11-12
3173021004,JAKARTA BARAT,GROGOL PETAMBURAN,JELAMBAR,30266,5536,24730,21553,46283,2021-11-12
3173021006,JAKARTA BARAT,GROGOL PETAMBURAN,JELAMBAR BARU,38246,7096,31150,26951,58101,2021-11-12
3173041006,JAKARTA BARAT,TAMBORA,JEMBATAN BESI,29314,7113,22201,17245,39446,2021-11-12
3173041008,JAKARTA BARAT,TAMBORA,JEMBATAN LIMA,21021,4853,16168,12707,28875,2021-11-12
3173081005,JAKARTA BARAT,KEMBANGAN,JOGLO,40839,8255,32584,27508,60092,2021-11-12
3171081001,JAKARTA PUSAT,JOHAR BARU,JOHAR BARU,37488,6960,30528,25711,56239,2021-11-12
3173041002,JAKARTA BARAT,TAMBORA,KALI ANYAR,23856,4733,19123,15176,34299,2021-11-12
3172041004,JAKARTA UTARA,CILINCING,KALIBARU,67684,18651,49033,34796,83829,2021-11-12
3174081002,JAKARTA SELATAN,PANCORAN,KALIBATA,41994,9536,32458,26262,58720,2021-11-12
3173061001,JAKARTA BARAT,KALI DERES,KALIDERES,72447,14657,57790,48875,106665,2021-11-12
3175051004,JAKARTA TIMUR,PASAR REBO,KALISARI,43212,7746,35466,29727,65193,2021-11-12
3173061004,JAKARTA BARAT,KALI DERES,KAMAL,53783,12482,41301,33078,74379,2021-11-12
3172011002,JAKARTA UTARA,PENJARINGAN,KAMAL MUARA,12930,2293,10637,9049,19686,2021-11-12
3171071007,JAKARTA PUSAT,TANAH ABANG,KAMPUNG BALI,11358,2457,8901,6834,15735,2021-11-12
3175031001,JAKARTA TIMUR,JATINEGARA,KAMPUNG MELAYU,25717,5902,19815,15392,35207,2021-11-12
3171081002,JAKARTA PUSAT,JOHAR BARU,KAMPUNG RAWA,21237,3531,17706,14131,31837,2021-11-12
3175041002,JAKARTA TIMUR,KRAMAT JATI,KAMPUNG TENGAH,43993,11051,32942,26282,59224,2021-11-12
3173011005,JAKARTA BARAT,CENGKARENG,KAPUK,134466,32526,101940,82142,184082,2021-11-12
3172011003,JAKARTA UTARA,PENJARINGAN,KAPUK MUARA,35781,6884,28897,25260,54157,2021-11-12
3171021002,JAKARTA PUSAT,SAWAH BESAR,KARANG ANYAR,25761,4957,20804,17482,38286,2021-11-12
3174021004,JAKARTA SELATAN,SETIA BUDI,KARET,9623,1852,7771,6447,14218,2021-11-12
3174021003,JAKARTA SELATAN,SETIA BUDI,KARET KUNINGAN,16055,3127,12928,10923,23851,2021-11-12
3174021002,JAKARTA SELATAN,SETIA BUDI,KARET SEMANGGI,2770,553,2217,1960,4177,2021-11-12
3171071003,JAKARTA PUSAT,TANAH ABANG,KARET TENGSIN,19271,3723,15548,12656,28204,2021-11-12
3171021003,JAKARTA PUSAT,SAWAH BESAR,KARTINI,22292,4207,18085,15502,33587,2021-11-12
3175011003,JAKARTA TIMUR,MATRAMAN,KAYU MANIS,25284,5349,19935,15844,35779,2021-11-12
3175021006,JAKARTA TIMUR,PULO GADUNG,KAYU PUTIH,40696,7673,33023,28780,61803,2021-11-12
3173031006,JAKARTA BARAT,TAMAN SARI,KEAGUNGAN,17387,3233,14154,11510,25664,2021-11-12
3174041007,JAKARTA SELATAN,PASAR MINGGU,KEBAGUSAN,44552,8857,35695,29317,65012,2021-11-12
3174051006,JAKARTA SELATAN,KEBAYORAN LAMA,KEBAYORAN LAMA SELATAN,41212,7677,33535,28416,61951,2021-11-12
3174051001,JAKARTA SELATAN,KEBAYORAN LAMA,KEBAYORAN LAMA UTARA,42422,8835,33587,27637,61224,2021-11-12
3174011004,JAKARTA SELATAN,TEBET,KEBON BARU,35165,6658,28507,23866,52373,2021-11-12
3172021005,JAKARTA UTARA,TANJUNG PRIOK,KEBON BAWANG,50952,10317,40635,33743,74378,2021-11-12
3173051001,JAKARTA BARAT,KEBON JERUK,KEBON JERUK,53887,11508,42379,34539,76918,2021-11-12
3171071006,JAKARTA PUSAT,TANAH ABANG,KEBON KACANG,21531,5155,16376,12887,29263,2021-11-12
3171011005,JAKARTA PUSAT,GAMBIR,KEBON KELAPA,10163,2040,8123,6820,14943,2021-11-12
3171031002,JAKARTA PUSAT,KEMAYORAN,KEBON KOSONG,30019,6013,24006,19524,43530,2021-11-12
3175011005,JAKARTA TIMUR,MATRAMAN,KEBON MANGGIS,16490,3214,13276,10977,24253,2021-11-12
3171071005,JAKARTA PUSAT,TANAH ABANG,KEBON MELATI,32206,8630,23576,17447,41023,2021-11-12
3175081003,JAKARTA TIMUR,MAKASAR,KEBON PALA,46614,9212,37402,31018,68420,2021-11-12
3171061005,JAKARTA PUSAT,MENTENG,KEBON SIRIH,12299,2664,9635,7717,17352,2021-11-12
3173011004,JAKARTA BARAT,CENGKARENG,KEDAUNG KALI ANGKE,32612,6348,26264,21962,48226,2021-11-12
3173051007,JAKARTA BARAT,KEBON JERUK,KEDOYA SELATAN,32165,5888,26277,21668,47945,2021-11-12
3173051006,JAKARTA BARAT,KEBON JERUK,KEDOYA UTARA,45740,8709,37031,31246,68277,2021-11-12
3173051004,JAKARTA BARAT,KEBON JERUK,KELAPA DUA,23565,4604,18961,15691,34652,2021-11-12
3175091003,JAKARTA TIMUR,CIRACAS,KELAPA DUA WETAN,46875,8004,38871,32726,71597,2021-11-12
3172061003,JAKARTA UTARA,KELAPA GADING,KELAPA GADING BARAT,35717,6220,29497,26548,56045,2021-11-12
3172061001,JAKARTA UTARA,KELAPA GADING,KELAPA GADING TIMUR,33592,5145,28447,26249,54696,2021-11-12
3173071005,JAKARTA BARAT,PALMERAH,KEMANGGISAN,32139,6094,26045,21805,47850,2021-11-12
3171031001,JAKARTA PUSAT,KEMAYORAN,KEMAYORAN,20708,4210,16498,13523,30021,2021-11-12
3173081006,JAKARTA BARAT,KEMBANGAN,KEMBANGAN SELATAN,27130,5704,21426,18469,39895,2021-11-12
3173081001,JAKARTA BARAT,KEMBANGAN,KEMBANGAN UTARA,54451,11961,42490,35282,77772,2021-11-12
3171041002,JAKARTA PUSAT,SENEN,KENARI,9579,1867,7712,6554,14266,2021-11-12
3173041005,JAKARTA BARAT,TAMBORA,KERENDANG,19973,4082,15891,12863,28754,2021-11-12
3175071003,JAKARTA TIMUR,DUREN SAWIT,KLENDER,69978,16458,53520,42486,96006,2021-11-12
3172031001,JAKARTA UTARA,KOJA,KOJA,28175,6433,21742,17504,39246,2021-11-12
3173071006,JAKARTA BARAT,PALMERAH,KOTA BAMBU SELATAN,21158,4174,16984,13252,30236,2021-11-12
3173071003,JAKARTA BARAT,PALMERAH,KOTA BAMBU UTARA,24995,5177,19818,15317,35135,2021-11-12
3171041004,JAKARTA PUSAT,SENEN,KRAMAT,28835,6936,21899,16624,38523,2021-11-12
3175041001,JAKARTA TIMUR,KRAMAT JATI,KRAMAT JATI,34144,7429,26715,21712,48427,2021-11-12
3174071003,JAKARTA SELATAN,KEBAYORAN BARU,KRAMAT PELA,14413,2798,11615,9910,21525,2021-11-12
3173031002,JAKARTA BARAT,TAMAN SARI,KRUKUT,19244,3631,15613,12658,28271,2021-11-12
3174031005,JAKARTA SELATAN,MAMPANG PRAPATAN,KUNINGAN BARAT,12785,2340,10445,8674,19119,2021-11-12
3174021008,JAKARTA SELATAN,SETIA BUDI,KUNINGAN TIMUR,6008,1189,4819,4081,8900,2021-11-12
3171041005,JAKARTA PUSAT,SENEN,KWITANG,15486,3443,12043,9653,21696,2021-11-12
3172031003,JAKARTA UTARA,KOJA,LAGOA,59065,14023,45042,35462,80504,2021-11-12
3174061002,JAKARTA SELATAN,CILANDAK,LEBAK BULUS,37626,7122,30504,26583,57087,2021-11-12
3174091004,JAKARTA SELATAN,JAGAKARSA,LENTENG AGUNG,53946,9696,44250,35997,80247,2021-11-12
3175101007,JAKARTA TIMUR,CIPAYUNG,LUBANG BUAYA,63547,11961,51586,42624,94210,2021-11-12
3175081001,JAKARTA TIMUR,MAKASAR,MAKASAR,34390,6335,28055,23542,51597,2021-11-12
3175071006,JAKARTA TIMUR,DUREN SAWIT,MALAKA JAYA,30927,5301,25626,21921,47547,2021-11-12
3175071005,JAKARTA TIMUR,DUREN SAWIT,MALAKA SARI,27530,4577,22953,19691,42644,2021-11-12
3174031001,JAKARTA SELATAN,MAMPANG PRAPATAN,MAMPANG PRAPATAN,18159,3738,14421,11881,26302,2021-11-12
3173031005,JAKARTA BARAT,TAMAN SARI,MANGGA BESAR,7707,1293,6414,5626,12040,2021-11-12
3171021005,JAKARTA PUSAT,SAWAH BESAR,MANGGA DUA SELATAN,27442,5717,21725,18391,40116,2021-11-12
3174011007,JAKARTA SELATAN,TEBET,MANGGARAI,28373,5016,23357,18920,42277,2021-11-12
3174011006,JAKARTA SELATAN,TEBET,MANGGARAI SELATAN,23075,4025,19050,16021,35071,2021-11-12
3173031003,JAKARTA BARAT,TAMAN SARI,MAPHAR,16461,3071,13390,11164,24554,2021-11-12
3172041003,JAKARTA UTARA,CILINCING,MARUNDA,28943,6572,22371,16717,39088,2021-11-12
3174071001,JAKARTA SELATAN,KEBAYORAN BARU,MELAWAI,2627,511,2116,1946,4062,2021-11-12
3171061001,JAKARTA PUSAT,MENTENG,MENTENG,25624,5660,19964,15708,35672,2021-11-12
3174021005,JAKARTA SELATAN,SETIA BUDI,MENTENG ATAS,27816,5022,22794,18899,41693,2021-11-12
3174011003,JAKARTA SELATAN,TEBET,MENTENG DALAM,36028,7035,28993,24417,53410,2021-11-12
3173081003,JAKARTA BARAT,KEMBANGAN,MERUYA SELATAN,32130,6620,25510,21403,46913,2021-11-12
3173081002,JAKARTA BARAT,KEMBANGAN,MERUYA UTARA,43752,9012,34740,30127,64867,2021-11-12
3175101004,JAKARTA TIMUR,CIPAYUNG,MUNJUL,23871,4349,19522,16487,36009,2021-11-12
3172051002,JAKARTA UTARA,PADEMANGAN,PADEMANGAN BARAT,74240,17505,56735,45702,102437,2021-11-12
3172051001,JAKARTA UTARA,PADEMANGAN,PADEMANGAN TIMUR,37736,6696,31040,27140,58180,2021-11-12
3175011004,JAKARTA TIMUR,MATRAMAN,PAL MERIAM,19769,4094,15675,12607,28282,2021-11-12
3173071001,JAKARTA BARAT,PALMERAH,PALMERAH,63011,13265,49746,40458,90204,2021-11-12
3174081001,JAKARTA SELATAN,PANCORAN,PANCORAN,19421,3930,15491,12787,28278,2021-11-12
3172021003,JAKARTA UTARA,TANJUNG PRIOK,PAPANGGO,39097,7681,31416,25709,57125,2021-11-12
3171021001,JAKARTA PUSAT,SAWAH BESAR,PASAR BARU,12035,2301,9734,8688,18422,2021-11-12
3174021006,JAKARTA SELATAN,SETIA BUDI,PASAR MANGGIS,26752,5273,21479,17666,39145,2021-11-12
3174041001,JAKARTA SELATAN,PASAR MINGGU,PASAR MINGGU,24821,4678,20143,17175,37318,2021-11-12
3171041003,JAKARTA PUSAT,SENEN,PASEBAN,23533,4881,18652,15292,33944,2021-11-12
3173061005,JAKARTA BARAT,KALI DERES,PEGADUNGAN,75587,14835,60752,52163,112915,2021-11-12
3171061002,JAKARTA PUSAT,MENTENG,PEGANGSAAN,23455,5054,18401,14128,32529,2021-11-12
3172061002,JAKARTA UTARA,KELAPA GADING,PEGANGSAAN DUA,49976,8267,41709,37674,79383,2021-11-12
3172011004,JAKARTA UTARA,PENJARINGAN,PEJAGALAN,74578,15487,59091,50807,109898,2021-11-12
3174041006,JAKARTA SELATAN,PASAR MINGGU,PEJATEN BARAT,37346,7295,30051,25081,55132,2021-11-12
3174041005,JAKARTA SELATAN,PASAR MINGGU,PEJATEN TIMUR,57656,12927,44729,36796,81525,2021-11-12
3175051005,JAKARTA TIMUR,PASAR REBO,PEKAYON,43250,7852,35398,29365,64763,2021-11-12
3173041009,JAKARTA BARAT,TAMBORA,PEKOJAN,23587,4491,19096,15922,35018,2021-11-12
3174031003,JAKARTA SELATAN,MAMPANG PRAPATAN,PELA MAMPANG,43522,8561,34961,29124,64085,2021-11-12
3174081005,JAKARTA SELATAN,PANCORAN,PENGADEGAN,21478,3946,17532,14881,32413,2021-11-12
3175061003,JAKARTA TIMUR,CAKUNG,PENGGILINGAN,99255,23051,76204,60813,137017,2021-11-12
3172011001,JAKARTA UTARA,PENJARINGAN,PENJARINGAN,88308,22625,65683,50551,116234,2021-11-12
3174101001,JAKARTA SELATAN,PESANGGRAHAN,PESANGGRAHAN,27545,4736,22809,19530,42339,2021-11-12
3171071004,JAKARTA PUSAT,TANAH ABANG,PETAMBURAN,33271,8771,24500,18531,43031,2021-11-12
3174071008,JAKARTA SELATAN,KEBAYORAN BARU,PETOGOGAN,11499,2236,9263,7897,17160,2021-11-12
3171011004,JAKARTA PUSAT,GAMBIR,PETOJO SELATAN,14692,3313,11379,9653,21032,2021-11-12
3171011003,JAKARTA PUSAT,GAMBIR,PETOJO UTARA,17458,3769,13689,11280,24969,2021-11-12
3174101004,JAKARTA SELATAN,PESANGGRAHAN,PETUKANGAN SELATAN,37187,7682,29505,24776,54281,2021-11-12
3174101003,JAKARTA SELATAN,PESANGGRAHAN,PETUKANGAN UTARA,53716,11536,42180,34922,77102,2021-11-12
3175081002,JAKARTA TIMUR,MAKASAR,PINANG RANTI,27198,5908,21290,17526,38816,2021-11-12
3173031008,JAKARTA BARAT,TAMAN SARI,PINANGSIA,10729,1878,8851,7335,16186,2021-11-12
3175011001,JAKARTA TIMUR,MATRAMAN,PISANGAN BARU,31776,6531,25245,20095,45340,2021-11-12
3175021002,JAKARTA TIMUR,PULO GADUNG,PISANGAN TIMUR,41011,7601,33410,28228,61638,2021-11-12
3172011005,JAKARTA UTARA,PENJARINGAN,PLUIT,47783,9193,38590,33817,72407,2021-11-12
3175071002,JAKARTA TIMUR,DUREN SAWIT,PONDOK BAMBU,61550,13015,48535,39881,88416,2021-11-12
3175071004,JAKARTA TIMUR,DUREN SAWIT,PONDOK KELAPA,72015,14256,57759,49406,107165,2021-11-12
3175071007,JAKARTA TIMUR,DUREN SAWIT,PONDOK KOPI,35367,6624,28743,22763,51506,2021-11-12
3174061003,JAKARTA SELATAN,CILANDAK,PONDOK LABU,46464,7851,38613,33440,72053,2021-11-12
3174051002,JAKARTA SELATAN,KEBAYORAN LAMA,PONDOK PINANG,56169,10744,45425,38927,84352,2021-11-12
3175101003,JAKARTA TIMUR,CIPAYUNG,PONDOK RANGGON,25574,4768,20806,17472,38278,2021-11-12
3101011003,KAB.ADM.KEP.SERIBU,KEP. SERIBU UTARA,PULAU HARAPAN,2060,221,1839,1607,3446,2021-11-12
3101011002,KAB.ADM.KEP.SERIBU,KEP. SERIBU UTARA,PULAU KELAPA,5528,596,4932,4071,9003,2021-11-12
3101011001,KAB.ADM.KEP.SERIBU,KEP. SERIBU UTARA,PULAU PANGGANG,5450,440,5010,4480,9490,2021-11-12
3101021003,KAB.ADM.KEP.SERIBU,KEP. SERIBU SELATAN,PULAU PARI,2765,193,2572,2417,4989,2021-11-12
3101021002,KAB.ADM.KEP.SERIBU,KEP. SERIBU SELATAN,PULAU TIDUNG,4553,367,4186,3828,8014,2021-11-12
3101021001,KAB.ADM.KEP.SERIBU,KEP. SERIBU SELATAN,PULAU UNTUNG JAWA,1941,162,1779,1641,3420,2021-11-12
3174071007,JAKARTA SELATAN,KEBAYORAN BARU,PULO,5835,1013,4822,4408,9230,2021-11-12
3175021001,JAKARTA TIMUR,PULO GADUNG,PULO GADUNG,34422,7543,26879,22431,49310,2021-11-12
3175061005,JAKARTA TIMUR,CAKUNG,PULO GEBANG,97301,18755,78546,63679,142225,2021-11-12
3174041004,JAKARTA SELATAN,PASAR MINGGU,RAGUNAN,39616,7326,32290,27455,59745,2021-11-12
3175091005,JAKARTA TIMUR,CIRACAS,RAMBUTAN,36771,8616,28155,22642,50797,2021-11-12
3172031006,JAKARTA UTARA,KOJA,RAWA BADAK SELATAN,42179,9989,32190,25320,57510,2021-11-12
3172031004,JAKARTA UTARA,KOJA,RAWA BADAK UTARA,34408,7708,26700,21376,48076,2021-11-12
3174071005,JAKARTA SELATAN,KEBAYORAN BARU,RAWA BARAT,5625,1002,4623,4097,8720,2021-11-12
3173011003,JAKARTA BARAT,CENGKARENG,RAWA BUAYA,63799,12738,51061,41394,92455,2021-11-12
3175031004,JAKARTA TIMUR,JATINEGARA,RAWA BUNGA,21434,5186,16248,13142,29390,2021-11-12
3174081003,JAKARTA SELATAN,PANCORAN,RAWA JATI,20509,3905,16604,14163,30767,2021-11-12
3175061002,JAKARTA TIMUR,CAKUNG,RAWA TERATE,24637,4483,20154,16424,36578,2021-11-12
3175021005,JAKARTA TIMUR,PULO GADUNG,RAWAMANGUN,37612,7419,30193,25534,55727,2021-11-12
3171051003,JAKARTA PUSAT,CEMPAKA PUTIH,RAWASARI,21967,4475,17492,14910,32402,2021-11-12
3173041010,JAKARTA BARAT,TAMBORA,ROA MALAKA,3484,618,2866,2528,5394,2021-11-12
3172041006,JAKARTA UTARA,CILINCING,ROROTAN,41668,8361,33307,26614,59921,2021-11-12
3174071004,JAKARTA SELATAN,KEBAYORAN BARU,SELONG,2842,548,2294,2124,4418,2021-11-12
3173061002,JAKARTA BARAT,KALI DERES,SEMANAN,71354,15187,56167,45433,101600,2021-11-12
3172041007,JAKARTA UTARA,CILINCING,SEMPER BARAT,68587,13383,55204,45713,100917,2021-11-12
3172041005,JAKARTA UTARA,CILINCING,SEMPER TIMUR,36267,7812,28455,23032,51487,2021-11-12
3174071006,JAKARTA SELATAN,KEBAYORAN BARU,SENAYAN,2771,652,2119,1824,3943,2021-11-12
3171041001,JAKARTA PUSAT,SENEN,SENEN,6804,1455,5349,4448,9797,2021-11-12
3171031004,JAKARTA PUSAT,KEMAYORAN,SERDANG,29668,5821,23847,19762,43609,2021-11-12
3174021001,JAKARTA SELATAN,SETIA BUDI,SETIA BUDI,3023,612,2411,2048,4459,2021-11-12
3175101005,JAKARTA TIMUR,CIPAYUNG,SETU,20572,4094,16478,13392,29870,2021-11-12
3173071002,JAKARTA BARAT,PALMERAH,SLIPI,16591,2977,13614,11424,25038,2021-11-12
3173081004,JAKARTA BARAT,KEMBANGAN,SRENGSENG,45523,10251,35272,29828,65100,2021-11-12
3174091002,JAKARTA SELATAN,JAGAKARSA,SRENGSENG SAWAH,58196,9003,49193,41787,90980,2021-11-12
3173051003,JAKARTA BARAT,KEBON JERUK,SUKABUMI SELATAN,37033,8283,28750,22298,51048,2021-11-12
3173051002,JAKARTA BARAT,KEBON JERUK,SUKABUMI UTARA,38290,8969,29321,22960,52281,2021-11-12
3172041002,JAKARTA UTARA,CILINCING,SUKAPURA,53949,12172,41777,34283,76060,2021-11-12
3171031007,JAKARTA PUSAT,KEMAYORAN,SUMUR BATU,22717,4425,18292,15458,33750,2021-11-12
3172021004,JAKARTA UTARA,TANJUNG PRIOK,SUNGAI BAMBU,29876,6022,23854,19780,43634,2021-11-12
3172021006,JAKARTA UTARA,TANJUNG PRIOK,SUNTER AGUNG,71805,12457,59348,51731,111079,2021-11-12
3172021002,JAKARTA UTARA,TANJUNG PRIOK,SUNTER JAYA,63031,11117,51914,44843,96757,2021-11-12
3175091004,JAKARTA TIMUR,CIRACAS,SUSUKAN,38257,7219,31038,25851,56889,2021-11-12
3173031001,JAKARTA BARAT,TAMAN SARI,TAMAN SARI,14348,2629,11719,10036,21755,2021-11-12
3173041001,JAKARTA BARAT,TAMBORA,TAMBORA,10204,2243,7961,6399,14360,2021-11-12
3173041004,JAKARTA BARAT,TAMBORA,TANAH SEREAL,26387,4495,21892,18369,40261,2021-11-12
3171081004,JAKARTA PUSAT,JOHAR BARU,TANAH TINGGI,37693,7196,30497,24681,55178,2021-11-12
3173031004,JAKARTA BARAT,TAMAN SARI,TANGKI,13324,2205,11119,9367,20486,2021-11-12
3174091005,JAKARTA SELATAN,JAGAKARSA,TANJUNG BARAT,39770,6770,33000,27362,60362,2021-11-12
3173021005,JAKARTA BARAT,GROGOL PETAMBURAN,TANJUNG DUREN SELATAN,25337,4831,20506,18044,38550,2021-11-12
3173021002,JAKARTA BARAT,GROGOL PETAMBURAN,TANJUNG DUREN UTARA,17010,2884,14126,12651,26777,2021-11-12
3172021001,JAKARTA UTARA,TANJUNG PRIOK,TANJUNG PRIOK,34588,7138,27450,22386,49836,2021-11-12
3174011002,JAKARTA SELATAN,TEBET,TEBET BARAT,21194,3435,17759,15620,33379,2021-11-12
3174011001,JAKARTA SELATAN,TEBET,TEBET TIMUR,18199,2927,15272,13742,29014,2021-11-12
3173061003,JAKARTA BARAT,KALI DERES,TEGAL ALUR,83647,17278,66369,54866,121235,2021-11-12
3174031004,JAKARTA SELATAN,MAMPANG PRAPATAN,TEGAL PARANG,32401,7144,25257,19708,44965,2021-11-12
3173021003,JAKARTA BARAT,GROGOL PETAMBURAN,TOMANG,29605,5468,24137,20584,44721,2021-11-12
3172031005,JAKARTA UTARA,KOJA,TUGU SELATAN,39122,8731,30391,24452,54843,2021-11-12
3172031002,JAKARTA UTARA,KOJA,TUGU UTARA,67670,15935,51735,40893,92628,2021-11-12
3175061006,JAKARTA TIMUR,CAKUNG,UJUNG MENTENG,29934,5155,24779,20958,45737,2021-11-12
3174101005,JAKARTA SELATAN,PESANGGRAHAN,ULUJAMI,40544,9165,31379,25831,57210,2021-11-12
3175011006,JAKARTA TIMUR,MATRAMAN,UTAN KAYU SELATAN,33511,6045,27466,22664,50130,2021-11-12
3175011002,JAKARTA TIMUR,MATRAMAN,UTAN KAYU UTARA,28169,5866,22303,18244,40547,2021-11-12
3171031008,JAKARTA PUSAT,KEMAYORAN,UTAN PANJANG,29208,5939,23269,18782,42051,2021-11-12
3172021007,JAKARTA UTARA,TANJUNG PRIOK,WARAKAS,44401,8159,36242,29233,65475,2021-11-12
3173021007,JAKARTA BARAT,GROGOL PETAMBURAN,WIJAYA KUSUMA,38934,8134,30800,25905,56705,2021-11-12
3172051003,JAKARTA UTARA,PADEMANGAN,ANCOL,23947,5765,18182,14952,33134,2021-11-13
3173041007,JAKARTA BARAT,TAMBORA,ANGKE,29381,6205,23176,18833,42009,2021-11-13
3175041005,JAKARTA TIMUR,KRAMAT JATI,BALE KAMBANG,29074,7220,21854,17263,39117,2021-11-13
3175031003,JAKARTA TIMUR,JATINEGARA,BALI MESTER,9752,2032,7720,6529,14249,2021-11-13
3175101006,JAKARTA TIMUR,CIPAYUNG,BAMBU APUS,26285,4818,21467,17992,39459,2021-11-13
3174031002,JAKARTA SELATAN,MAMPANG PRAPATAN,BANGKA,21566,4548,17018,14105,31123,2021-11-13
3175051002,JAKARTA TIMUR,PASAR REBO,BARU,23886,3929,19957,17190,37147,2021-11-13
3175041004,JAKARTA TIMUR,KRAMAT JATI,BATU AMPAR,47898,11541,36357,29341,65698,2021-11-13
3171071002,JAKARTA PUSAT,TANAH ABANG,BENDUNGAN HILIR,21494,4322,17172,14710,31882,2021-11-13
3175031002,JAKARTA TIMUR,JATINEGARA,BIDARA CINA,36689,8751,27938,22486,50424,2021-11-13
3174101002,JAKARTA SELATAN,PESANGGRAHAN,BINTARO,53098,10594,42504,36760,79264,2021-11-13
3174011005,JAKARTA SELATAN,TEBET,BUKIT DURI,34183,6837,27346,22809,50155,2021-11-13
3171041006,JAKARTA PUSAT,SENEN,BUNGUR,18144,3756,14388,11927,26315,2021-11-13
3175061007,JAKARTA TIMUR,CAKUNG,CAKUNG BARAT,57724,11772,45952,37934,83886,2021-11-13
3175061004,JAKARTA TIMUR,CAKUNG,CAKUNG TIMUR,58287,11350,46937,39014,85951,2021-11-13
3175041007,JAKARTA TIMUR,KRAMAT JATI,CAWANG,32762,6988,25774,20712,46486,2021-11-13
3175101008,JAKARTA TIMUR,CIPAYUNG,CEGER,18932,3655,15277,12771,28048,2021-11-13
3171031006,JAKARTA PUSAT,KEMAYORAN,CEMPAKA BARU,32581,6154,26427,20863,47290,2021-11-13
3171051002,JAKARTA PUSAT,CEMPAKA PUTIH,CEMPAKA PUTIH BARAT,35885,7614,28271,24192,52463,2021-11-13
3171051001,JAKARTA PUSAT,CEMPAKA PUTIH,CEMPAKA PUTIH TIMUR,24292,4967,19325,16905,36230,2021-11-13
3173011001,JAKARTA BARAT,CENGKARENG,CENGKARENG BARAT,66284,13136,53148,45379,98527,2021-11-13
3173011006,JAKARTA BARAT,CENGKARENG,CENGKARENG TIMUR,81027,15882,65145,54247,119392,2021-11-13
3175091002,JAKARTA TIMUR,CIRACAS,CIBUBUR,66364,11359,55005,46553,101558,2021-11-13
3171011002,JAKARTA PUSAT,GAMBIR,CIDENG,15390,3001,12389,10827,23216,2021-11-13
3174091003,JAKARTA SELATAN,JAGAKARSA,CIGANJUR,38497,6410,32087,26522,58609,2021-11-13
3175051003,JAKARTA TIMUR,PASAR REBO,CIJANTUNG,41419,7633,33786,28193,61979,2021-11-13
3171061003,JAKARTA PUSAT,MENTENG,CIKINI,8274,1480,6794,5406,12200,2021-11-13
3174081006,JAKARTA SELATAN,PANCORAN,CIKOKO,10547,1814,8733,7575,16308,2021-11-13
3174061001,JAKARTA SELATAN,CILANDAK,CILANDAK BARAT,51752,9078,42674,37294,79968,2021-11-13
3174041003,JAKARTA SELATAN,PASAR MINGGU,CILANDAK TIMUR,25145,4588,20557,17553,38110,2021-11-13
3175101002,JAKARTA TIMUR,CIPAYUNG,CILANGKAP,27635,4866,22769,19403,42172,2021-11-13
3175041006,JAKARTA TIMUR,KRAMAT JATI,CILILITAN,40181,8655,31526,25769,57295,2021-11-13
3172041001,JAKARTA UTARA,CILINCING,CILINCING,43609,10405,33204,25818,59022,2021-11-13
3175101001,JAKARTA TIMUR,CIPAYUNG,CIPAYUNG,26104,4534,21570,18533,40103,2021-11-13
3174091006,JAKARTA SELATAN,JAGAKARSA,CIPEDAK,38303,6297,32006,27022,59028,2021-11-13
3174061005,JAKARTA SELATAN,CILANDAK,CIPETE SELATAN,26704,5102,21602,19012,40614,2021-11-13
3174071010,JAKARTA SELATAN,KEBAYORAN BARU,CIPETE UTARA,34102,6456,27646,23171,50817,2021-11-13
3175021003,JAKARTA TIMUR,PULO GADUNG,CIPINANG,39306,7207,32099,26781,58880,2021-11-13
3175031007,JAKARTA TIMUR,JATINEGARA,CIPINANG BESAR SELATAN,35212,8295,26917,21166,48083,2021-11-13
3175031008,JAKARTA TIMUR,JATINEGARA,CIPINANG BESAR UTARA,45319,10580,34739,27154,61893,2021-11-13
3175031005,JAKARTA TIMUR,JATINEGARA,CIPINANG CEMPEDAK,32824,7109,25715,21879,47594,2021-11-13
3175081005,JAKARTA TIMUR,MAKASAR,CIPINANG MELAYU,42308,8128,34180,29030,63210,2021-11-13
3175031006,JAKARTA TIMUR,JATINEGARA,CIPINANG MUARA,55243,11715,43528,35549,79077,2021-11-13
3174051003,JAKARTA SELATAN,KEBAYORAN LAMA,CIPULIR,39937,8410,31527,25645,57172,2021-11-13
3175091001,JAKARTA TIMUR,CIRACAS,CIRACAS,64594,11766,52828,43856,96684,2021-11-13
3175041003,JAKARTA TIMUR,KRAMAT JATI,DUKUH,24609,4571,20038,16630,36668,2021-11-13
3175071001,JAKARTA TIMUR,DUREN SAWIT,DUREN SAWIT,61160,12835,48325,40145,88470,2021-11-13
3174081004,JAKARTA SELATAN,PANCORAN,DUREN TIGA,28319,5614,22705,19062,41767,2021-11-13
3173051005,JAKARTA BARAT,KEBON JERUK,DURI KEPA,60138,11726,48412,41803,90215,2021-11-13
3173011002,JAKARTA BARAT,CENGKARENG,DURI KOSAMBI,77923,16596,61327,49302,110629,2021-11-13
3171011006,JAKARTA PUSAT,GAMBIR,DURI PULO,19610,4117,15493,12487,27980,2021-11-13
3173041011,JAKARTA BARAT,TAMBORA,DURI SELATAN,14259,2528,11731,9986,21717,2021-11-13
3173041003,JAKARTA BARAT,TAMBORA,DURI UTARA,19844,3579,16265,13423,29688,2021-11-13
3171081003,JAKARTA PUSAT,JOHAR BARU,GALUR,18243,3556,14687,11922,26609,2021-11-13
3171011001,JAKARTA PUSAT,GAMBIR,GAMBIR,2191,456,1735,1509,3244,2021-11-13
3174061004,JAKARTA SELATAN,CILANDAK,GANDARIA SELATAN,22119,4219,17900,15302,33202,2021-11-13
3174071009,JAKARTA SELATAN,KEBAYORAN BARU,GANDARIA UTARA,39922,7903,32019,27159,59178,2021-11-13
3175051001,JAKARTA TIMUR,PASAR REBO,GEDONG,35755,7137,28618,24252,52870,2021-11-13
3171071001,JAKARTA PUSAT,TANAH ABANG,GELORA,3127,609,2518,2175,4693,2021-11-13
3173031007,JAKARTA BARAT,TAMAN SARI,GLODOK,7837,1179,6658,5979,12637,2021-11-13
3171061004,JAKARTA PUSAT,MENTENG,GONDANGDIA,4100,912,3188,2909,6097,2021-11-13
3173021001,JAKARTA BARAT,GROGOL PETAMBURAN,GROGOL,16876,3345,13531,11480,25011,2021-11-13
3174051005,JAKARTA SELATAN,KEBAYORAN LAMA,GROGOL SELATAN,44251,8762,35489,29242,64731,2021-11-13
3174051004,JAKARTA SELATAN,KEBAYORAN LAMA,GROGOL UTARA,42494,8615,33879,28068,61947,2021-11-13
3174021007,JAKARTA SELATAN,SETIA BUDI,GUNTUR,3985,743,3242,2853,6095,2021-11-13
3174071002,JAKARTA SELATAN,KEBAYORAN BARU,GUNUNG,9436,1741,7695,6856,14551,2021-11-13
3171031005,JAKARTA PUSAT,KEMAYORAN,GUNUNG SAHARI SELATAN,19199,3867,15332,12942,28274,2021-11-13
3171021004,JAKARTA PUSAT,SAWAH BESAR,GUNUNG SAHARI UTARA,16650,2924,13726,12265,25991,2021-11-13
3175081004,JAKARTA TIMUR,MAKASAR,HALIM PERDANA KUSUMAH,28363,3648,24715,22565,47280,2021-11-13
3171031003,JAKARTA PUSAT,KEMAYORAN,HARAPAN MULIA,22557,4534,18023,14719,32742,2021-11-13
3174091001,JAKARTA SELATAN,JAGAKARSA,JAGAKARSA,62389,10192,52197,43761,95958,2021-11-13
3175021007,JAKARTA TIMUR,PULO GADUNG,JATI,32757,6094,26663,23117,49780,2021-11-13
3174041002,JAKARTA SELATAN,PASAR MINGGU,JATI PADANG,37502,7314,30188,25411,55599,2021-11-13
3173071004,JAKARTA BARAT,PALMERAH,JATI PULO,28738,5687,23051,18472,41523,2021-11-13
3175061001,JAKARTA TIMUR,CAKUNG,JATINEGARA,84160,17800,66360,54737,121097,2021-11-13
3175021004,JAKARTA TIMUR,PULO GADUNG,JATINEGARA KAUM,24632,4373,20259,16532,36791,2021-11-13
3173021004,JAKARTA BARAT,GROGOL PETAMBURAN,JELAMBAR,30266,5501,24765,21707,46472,2021-11-13
3173021006,JAKARTA BARAT,GROGOL PETAMBURAN,JELAMBAR BARU,38246,7021,31225,27147,58372,2021-11-13
3173041006,JAKARTA BARAT,TAMBORA,JEMBATAN BESI,29314,7064,22250,17391,39641,2021-11-13
3173041008,JAKARTA BARAT,TAMBORA,JEMBATAN LIMA,21021,4825,16196,12861,29057,2021-11-13
3173081005,JAKARTA BARAT,KEMBANGAN,JOGLO,40839,8121,32718,27772,60490,2021-11-13
3171081001,JAKARTA PUSAT,JOHAR BARU,JOHAR BARU,37488,6915,30573,25878,56451,2021-11-13
3173041002,JAKARTA BARAT,TAMBORA,KALI ANYAR,23856,4694,19162,15314,34476,2021-11-13
3172041004,JAKARTA UTARA,CILINCING,KALIBARU,67684,18582,49102,35067,84169,2021-11-13
3174081002,JAKARTA SELATAN,PANCORAN,KALIBATA,41994,9479,32515,26530,59045,2021-11-13
3173061001,JAKARTA BARAT,KALI DERES,KALIDERES,72447,14481,57966,49146,107112,2021-11-13
3175051004,JAKARTA TIMUR,PASAR REBO,KALISARI,43212,7682,35530,30033,65563,2021-11-13
3173061004,JAKARTA BARAT,KALI DERES,KAMAL,53783,12430,41353,33244,74597,2021-11-13
3172011002,JAKARTA UTARA,PENJARINGAN,KAMAL MUARA,12930,2289,10641,9086,19727,2021-11-13
3171071007,JAKARTA PUSAT,TANAH ABANG,KAMPUNG BALI,11358,2444,8914,6899,15813,2021-11-13
3175031001,JAKARTA TIMUR,JATINEGARA,KAMPUNG MELAYU,25717,5866,19851,15564,35415,2021-11-13
3171081002,JAKARTA PUSAT,JOHAR BARU,KAMPUNG RAWA,21237,3500,17737,14232,31969,2021-11-13
3175041002,JAKARTA TIMUR,KRAMAT JATI,KAMPUNG TENGAH,43993,10963,33030,26564,59594,2021-11-13
3173011005,JAKARTA BARAT,CENGKARENG,KAPUK,134466,32242,102224,82980,185204,2021-11-13
3172011003,JAKARTA UTARA,PENJARINGAN,KAPUK MUARA,35781,6819,28962,25429,54391,2021-11-13
3171021002,JAKARTA PUSAT,SAWAH BESAR,KARANG ANYAR,25761,4917,20844,17598,38442,2021-11-13
3174021004,JAKARTA SELATAN,SETIA BUDI,KARET,9623,1844,7779,6490,14269,2021-11-13
3174021003,JAKARTA SELATAN,SETIA BUDI,KARET KUNINGAN,16055,3107,12948,11012,23960,2021-11-13
3174021002,JAKARTA SELATAN,SETIA BUDI,KARET SEMANGGI,2770,552,2218,1965,4183,2021-11-13
3171071003,JAKARTA PUSAT,TANAH ABANG,KARET TENGSIN,19271,3692,15579,12771,28350,2021-11-13
3171021003,JAKARTA PUSAT,SAWAH BESAR,KARTINI,22292,4180,18112,15585,33697,2021-11-13
3175011003,JAKARTA TIMUR,MATRAMAN,KAYU MANIS,25284,5305,19979,15950,35929,2021-11-13
3175021006,JAKARTA TIMUR,PULO GADUNG,KAYU PUTIH,40696,7635,33061,28953,62014,2021-11-13
3173031006,JAKARTA BARAT,TAMAN SARI,KEAGUNGAN,17387,3222,14165,11576,25741,2021-11-13
3174041007,JAKARTA SELATAN,PASAR MINGGU,KEBAGUSAN,44552,8781,35771,29563,65334,2021-11-13
3174051006,JAKARTA SELATAN,KEBAYORAN LAMA,KEBAYORAN LAMA SELATAN,41212,7623,33589,28645,62234,2021-11-13
3174051001,JAKARTA SELATAN,KEBAYORAN LAMA,KEBAYORAN LAMA UTARA,42422,8753,33669,27843,61512,2021-11-13
3174011004,JAKARTA SELATAN,TEBET,KEBON BARU,35165,6572,28593,24111,52704,2021-11-13
3172021005,JAKARTA UTARA,TANJUNG PRIOK,KEBON BAWANG,50952,10254,40698,33964,74662,2021-11-13
3173051001,JAKARTA BARAT,KEBON JERUK,KEBON JERUK,53887,11174,42713,34865,77578,2021-11-13
3171071006,JAKARTA PUSAT,TANAH ABANG,KEBON KACANG,21531,5114,16417,12992,29409,2021-11-13
3171011005,JAKARTA PUSAT,GAMBIR,KEBON KELAPA,10163,2031,8132,6863,14995,2021-11-13
3171031002,JAKARTA PUSAT,KEMAYORAN,KEBON KOSONG,30019,5992,24027,19680,43707,2021-11-13
3175011005,JAKARTA TIMUR,MATRAMAN,KEBON MANGGIS,16490,3191,13299,11042,24341,2021-11-13
3171071005,JAKARTA PUSAT,TANAH ABANG,KEBON MELATI,32206,8589,23617,17628,41245,2021-11-13
3175081003,JAKARTA TIMUR,MAKASAR,KEBON PALA,46614,9132,37482,31277,68759,2021-11-13
3171061005,JAKARTA PUSAT,MENTENG,KEBON SIRIH,12299,2628,9671,7790,17461,2021-11-13
3173011004,JAKARTA BARAT,CENGKARENG,KEDAUNG KALI ANGKE,32612,6292,26320,22182,48502,2021-11-13
3173051007,JAKARTA BARAT,KEBON JERUK,KEDOYA SELATAN,32165,5866,26299,21804,48103,2021-11-13
3173051006,JAKARTA BARAT,KEBON JERUK,KEDOYA UTARA,45740,8673,37067,31395,68462,2021-11-13
3173051004,JAKARTA BARAT,KEBON JERUK,KELAPA DUA,23565,4580,18985,15820,34805,2021-11-13
3175091003,JAKARTA TIMUR,CIRACAS,KELAPA DUA WETAN,46875,7930,38945,33008,71953,2021-11-13
3172061003,JAKARTA UTARA,KELAPA GADING,KELAPA GADING BARAT,35717,6197,29520,26648,56168,2021-11-13
3172061001,JAKARTA UTARA,KELAPA GADING,KELAPA GADING TIMUR,33592,5109,28483,26378,54861,2021-11-13
3173071005,JAKARTA BARAT,PALMERAH,KEMANGGISAN,32139,6045,26094,22065,48159,2021-11-13
3171031001,JAKARTA PUSAT,KEMAYORAN,KEMAYORAN,20708,4129,16579,13652,30231,2021-11-13
3173081006,JAKARTA BARAT,KEMBANGAN,KEMBANGAN SELATAN,27130,5667,21463,18577,40040,2021-11-13
3173081001,JAKARTA BARAT,KEMBANGAN,KEMBANGAN UTARA,54451,11879,42572,35542,78114,2021-11-13
3171041002,JAKARTA PUSAT,SENEN,KENARI,9579,1861,7718,6598,14316,2021-11-13
3173041005,JAKARTA BARAT,TAMBORA,KERENDANG,19973,4043,15930,12948,28878,2021-11-13
3175071003,JAKARTA TIMUR,DUREN SAWIT,KLENDER,69978,16350,53628,42849,96477,2021-11-13
3172031001,JAKARTA UTARA,KOJA,KOJA,28175,6394,21781,17662,39443,2021-11-13
3173071006,JAKARTA BARAT,PALMERAH,KOTA BAMBU SELATAN,21158,4142,17016,13375,30391,2021-11-13
3173071003,JAKARTA BARAT,PALMERAH,KOTA BAMBU UTARA,24995,5143,19852,15481,35333,2021-11-13
3171041004,JAKARTA PUSAT,SENEN,KRAMAT,28835,6897,21938,16769,38707,2021-11-13
3175041001,JAKARTA TIMUR,KRAMAT JATI,KRAMAT JATI,34144,7191,26953,21946,48899,2021-11-13
3174071003,JAKARTA SELATAN,KEBAYORAN BARU,KRAMAT PELA,14413,2780,11633,10005,21638,2021-11-13
3173031002,JAKARTA BARAT,TAMAN SARI,KRUKUT,19244,3611,15633,12717,28350,2021-11-13
3174031005,JAKARTA SELATAN,MAMPANG PRAPATAN,KUNINGAN BARAT,12785,2322,10463,8700,19163,2021-11-13
3174021008,JAKARTA SELATAN,SETIA BUDI,KUNINGAN TIMUR,6008,1183,4825,4126,8951,2021-11-13
3171041005,JAKARTA PUSAT,SENEN,KWITANG,15486,3433,12053,9723,21776,2021-11-13
3172031003,JAKARTA UTARA,KOJA,LAGOA,59065,13911,45154,35780,80934,2021-11-13
3174061002,JAKARTA SELATAN,CILANDAK,LEBAK BULUS,37626,7055,30571,26880,57451,2021-11-13
3174091004,JAKARTA SELATAN,JAGAKARSA,LENTENG AGUNG,53946,9629,44317,36355,80672,2021-11-13
3175101007,JAKARTA TIMUR,CIPAYUNG,LUBANG BUAYA,63547,11911,51636,42977,94613,2021-11-13
3175081001,JAKARTA TIMUR,MAKASAR,MAKASAR,34390,6253,28137,24124,52261,2021-11-13
3175071006,JAKARTA TIMUR,DUREN SAWIT,MALAKA JAYA,30927,5255,25672,22114,47786,2021-11-13
3175071005,JAKARTA TIMUR,DUREN SAWIT,MALAKA SARI,27530,4535,22995,19873,42868,2021-11-13
3174031001,JAKARTA SELATAN,MAMPANG PRAPATAN,MAMPANG PRAPATAN,18159,3699,14460,11970,26430,2021-11-13
3173031005,JAKARTA BARAT,TAMAN SARI,MANGGA BESAR,7707,1287,6420,5671,12091,2021-11-13
3171021005,JAKARTA PUSAT,SAWAH BESAR,MANGGA DUA SELATAN,27442,5668,21774,18534,40308,2021-11-13
3174011007,JAKARTA SELATAN,TEBET,MANGGARAI,28373,4970,23403,19115,42518,2021-11-13
3174011006,JAKARTA SELATAN,TEBET,MANGGARAI SELATAN,23075,3922,19153,16176,35329,2021-11-13
3173031003,JAKARTA BARAT,TAMAN SARI,MAPHAR,16461,3047,13414,11238,24652,2021-11-13
3172041003,JAKARTA UTARA,CILINCING,MARUNDA,28943,6520,22423,16867,39290,2021-11-13
3174071001,JAKARTA SELATAN,KEBAYORAN BARU,MELAWAI,2627,508,2119,1949,4068,2021-11-13
3171061001,JAKARTA PUSAT,MENTENG,MENTENG,25624,5614,20010,15902,35912,2021-11-13
3174021005,JAKARTA SELATAN,SETIA BUDI,MENTENG ATAS,27816,4970,22846,19125,41971,2021-11-13
3174011003,JAKARTA SELATAN,TEBET,MENTENG DALAM,36028,6967,29061,24652,53713,2021-11-13
3173081003,JAKARTA BARAT,KEMBANGAN,MERUYA SELATAN,32130,6551,25579,21624,47203,2021-11-13
3173081002,JAKARTA BARAT,KEMBANGAN,MERUYA UTARA,43752,8958,34794,30330,65124,2021-11-13
3175101004,JAKARTA TIMUR,CIPAYUNG,MUNJUL,23871,4323,19548,16609,36157,2021-11-13
3172051002,JAKARTA UTARA,PADEMANGAN,PADEMANGAN BARAT,74240,17344,56896,46091,102987,2021-11-13
3172051001,JAKARTA UTARA,PADEMANGAN,PADEMANGAN TIMUR,37736,6647,31089,27377,58466,2021-11-13
3175011004,JAKARTA TIMUR,MATRAMAN,PAL MERIAM,19769,4048,15721,12709,28430,2021-11-13
3173071001,JAKARTA BARAT,PALMERAH,PALMERAH,63011,13188,49823,40807,90630,2021-11-13
3174081001,JAKARTA SELATAN,PANCORAN,PANCORAN,19421,3915,15506,12864,28370,2021-11-13
3172021003,JAKARTA UTARA,TANJUNG PRIOK,PAPANGGO,39097,7640,31457,25928,57385,2021-11-13
3171021001,JAKARTA PUSAT,SAWAH BESAR,PASAR BARU,12035,2294,9741,8732,18473,2021-11-13
3174021006,JAKARTA SELATAN,SETIA BUDI,PASAR MANGGIS,26752,5211,21541,17876,39417,2021-11-13
3174041001,JAKARTA SELATAN,PASAR MINGGU,PASAR MINGGU,24821,4654,20167,17312,37479,2021-11-13
3171041003,JAKARTA PUSAT,SENEN,PASEBAN,23533,4862,18671,15377,34048,2021-11-13
3173061005,JAKARTA BARAT,KALI DERES,PEGADUNGAN,75587,14717,60870,52389,113259,2021-11-13
3171061002,JAKARTA PUSAT,MENTENG,PEGANGSAAN,23455,5018,18437,14283,32720,2021-11-13
3172061002,JAKARTA UTARA,KELAPA GADING,PEGANGSAAN DUA,49976,8224,41752,37832,79584,2021-11-13
3172011004,JAKARTA UTARA,PENJARINGAN,PEJAGALAN,74578,15363,59215,51222,110437,2021-11-13
3174041006,JAKARTA SELATAN,PASAR MINGGU,PEJATEN BARAT,37346,7218,30128,25363,55491,2021-11-13
3174041005,JAKARTA SELATAN,PASAR MINGGU,PEJATEN TIMUR,57656,12788,44868,36980,81848,2021-11-13
3175051005,JAKARTA TIMUR,PASAR REBO,PEKAYON,43250,7793,35457,29604,65061,2021-11-13
3173041009,JAKARTA BARAT,TAMBORA,PEKOJAN,23587,4458,19129,16142,35271,2021-11-13
3174031003,JAKARTA SELATAN,MAMPANG PRAPATAN,PELA MAMPANG,43522,8482,35040,29419,64459,2021-11-13
3174081005,JAKARTA SELATAN,PANCORAN,PENGADEGAN,21478,3925,17553,14985,32538,2021-11-13
3175061003,JAKARTA TIMUR,CAKUNG,PENGGILINGAN,99255,22698,76557,61334,137891,2021-11-13
3172011001,JAKARTA UTARA,PENJARINGAN,PENJARINGAN,88308,22526,65782,50974,116756,2021-11-13
3174101001,JAKARTA SELATAN,PESANGGRAHAN,PESANGGRAHAN,27545,4704,22841,19641,42482,2021-11-13
3171071004,JAKARTA PUSAT,TANAH ABANG,PETAMBURAN,33271,8711,24560,18715,43275,2021-11-13
3174071008,JAKARTA SELATAN,KEBAYORAN BARU,PETOGOGAN,11499,2217,9282,7973,17255,2021-11-13
3171011004,JAKARTA PUSAT,GAMBIR,PETOJO SELATAN,14692,3295,11397,9703,21100,2021-11-13
3171011003,JAKARTA PUSAT,GAMBIR,PETOJO UTARA,17458,3741,13717,11374,25091,2021-11-13
3174101004,JAKARTA SELATAN,PESANGGRAHAN,PETUKANGAN SELATAN,37187,7621,29566,25008,54574,2021-11-13
3174101003,JAKARTA SELATAN,PESANGGRAHAN,PETUKANGAN UTARA,53716,11480,42236,35184,77420,2021-11-13
3175081002,JAKARTA TIMUR,MAKASAR,PINANG RANTI,27198,5858,21340,17674,39014,2021-11-13
3173031008,JAKARTA BARAT,TAMAN SARI,PINANGSIA,10729,1864,8865,7398,16263,2021-11-13
3175011001,JAKARTA TIMUR,MATRAMAN,PISANGAN BARU,31776,6490,25286,20238,45524,2021-11-13
3175021002,JAKARTA TIMUR,PULO GADUNG,PISANGAN TIMUR,41011,7523,33488,28434,61922,2021-11-13
3172011005,JAKARTA UTARA,PENJARINGAN,PLUIT,47783,9144,38639,34048,72687,2021-11-13
3175071002,JAKARTA TIMUR,DUREN SAWIT,PONDOK BAMBU,61550,12900,48650,40403,89053,2021-11-13
3175071004,JAKARTA TIMUR,DUREN SAWIT,PONDOK KELAPA,72015,14192,57823,49671,107494,2021-11-13
3175071007,JAKARTA TIMUR,DUREN SAWIT,PONDOK KOPI,35367,6589,28778,22990,51768,2021-11-13
3174061003,JAKARTA SELATAN,CILANDAK,PONDOK LABU,46464,7736,38728,33656,72384,2021-11-13
3174051002,JAKARTA SELATAN,KEBAYORAN LAMA,PONDOK PINANG,56169,10683,45486,39170,84656,2021-11-13
3175101003,JAKARTA TIMUR,CIPAYUNG,PONDOK RANGGON,25574,4749,20825,17515,38340,2021-11-13
3101011003,KAB.ADM.KEP.SERIBU,KEP. SERIBU UTARA,PULAU HARAPAN,2060,220,1840,1609,3449,2021-11-13
3101011002,KAB.ADM.KEP.SERIBU,KEP. SERIBU UTARA,PULAU KELAPA,5528,595,4933,4075,9008,2021-11-13
3101011001,KAB.ADM.KEP.SERIBU,KEP. SERIBU UTARA,PULAU PANGGANG,5450,436,5014,4496,9510,2021-11-13
3101021003,KAB.ADM.KEP.SERIBU,KEP. SERIBU SELATAN,PULAU PARI,2765,193,2572,2432,5004,2021-11-13
3101021002,KAB.ADM.KEP.SERIBU,KEP. SERIBU SELATAN,PULAU TIDUNG,4553,366,4187,3834,8021,2021-11-13
3101021001,KAB.ADM.KEP.SERIBU,KEP. SERIBU SELATAN,PULAU UNTUNG JAWA,1941,161,1780,1653,3433,2021-11-13
3174071007,JAKARTA SELATAN,KEBAYORAN BARU,PULO,5835,1009,4826,4431,9257,2021-11-13
3175021001,JAKARTA TIMUR,PULO GADUNG,PULO GADUNG,34422,7497,26925,22571,49496,2021-11-13
3175061005,JAKARTA TIMUR,CAKUNG,PULO GEBANG,97301,18619,78682,64214,142896,2021-11-13
3174041004,JAKARTA SELATAN,PASAR MINGGU,RAGUNAN,39616,7245,32371,27697,60068,2021-11-13
3175091005,JAKARTA TIMUR,CIRACAS,RAMBUTAN,36771,8543,28228,22960,51188,2021-11-13
3172031006,JAKARTA UTARA,KOJA,RAWA BADAK SELATAN,42179,9931,32248,25521,57769,2021-11-13
3172031004,JAKARTA UTARA,KOJA,RAWA BADAK UTARA,34408,7656,26752,21574,48326,2021-11-13
3174071005,JAKARTA SELATAN,KEBAYORAN BARU,RAWA BARAT,5625,1001,4624,4112,8736,2021-11-13
3173011003,JAKARTA BARAT,CENGKARENG,RAWA BUAYA,63799,12572,51227,41894,93121,2021-11-13
3175031004,JAKARTA TIMUR,JATINEGARA,RAWA BUNGA,21434,5144,16290,13298,29588,2021-11-13
3174081003,JAKARTA SELATAN,PANCORAN,RAWA JATI,20509,3883,16626,14277,30903,2021-11-13
3175061002,JAKARTA TIMUR,CAKUNG,RAWA TERATE,24637,4450,20187,16519,36706,2021-11-13
3175021005,JAKARTA TIMUR,PULO GADUNG,RAWAMANGUN,37612,7367,30245,25746,55991,2021-11-13
3171051003,JAKARTA PUSAT,CEMPAKA PUTIH,RAWASARI,21967,4434,17533,15037,32570,2021-11-13
3173041010,JAKARTA BARAT,TAMBORA,ROA MALAKA,3484,614,2870,2550,5420,2021-11-13
3172041006,JAKARTA UTARA,CILINCING,ROROTAN,41668,8294,33374,26872,60246,2021-11-13
3174071004,JAKARTA SELATAN,KEBAYORAN BARU,SELONG,2842,545,2297,2130,4427,2021-11-13
3173061002,JAKARTA BARAT,KALI DERES,SEMANAN,71354,15111,56243,45640,101883,2021-11-13
3172041007,JAKARTA UTARA,CILINCING,SEMPER BARAT,68587,13231,55356,46162,101518,2021-11-13
3172041005,JAKARTA UTARA,CILINCING,SEMPER TIMUR,36267,7726,28541,23285,51826,2021-11-13
3174071006,JAKARTA SELATAN,KEBAYORAN BARU,SENAYAN,2771,649,2122,1839,3961,2021-11-13
3171041001,JAKARTA PUSAT,SENEN,SENEN,6804,1441,5363,4480,9843,2021-11-13
3171031004,JAKARTA PUSAT,KEMAYORAN,SERDANG,29668,5781,23887,19952,43839,2021-11-13
3174021001,JAKARTA SELATAN,SETIA BUDI,SETIA BUDI,3023,610,2413,2077,4490,2021-11-13
3175101005,JAKARTA TIMUR,CIPAYUNG,SETU,20572,4060,16512,13496,30008,2021-11-13
3173071002,JAKARTA BARAT,PALMERAH,SLIPI,16591,2956,13635,11537,25172,2021-11-13
3173081004,JAKARTA BARAT,KEMBANGAN,SRENGSENG,45523,10162,35361,30064,65425,2021-11-13
3174091002,JAKARTA SELATAN,JAGAKARSA,SRENGSENG SAWAH,58196,8949,49247,42093,91340,2021-11-13
3173051003,JAKARTA BARAT,KEBON JERUK,SUKABUMI SELATAN,37033,8243,28790,22501,51291,2021-11-13
3173051002,JAKARTA BARAT,KEBON JERUK,SUKABUMI UTARA,38290,8922,29368,23199,52567,2021-11-13
3172041002,JAKARTA UTARA,CILINCING,SUKAPURA,53949,12105,41844,34573,76417,2021-11-13
3171031007,JAKARTA PUSAT,KEMAYORAN,SUMUR BATU,22717,4332,18385,15640,34025,2021-11-13
3172021004,JAKARTA UTARA,TANJUNG PRIOK,SUNGAI BAMBU,29876,5967,23909,19916,43825,2021-11-13
3172021006,JAKARTA UTARA,TANJUNG PRIOK,SUNTER AGUNG,71805,12340,59465,52159,111624,2021-11-13
3172021002,JAKARTA UTARA,TANJUNG PRIOK,SUNTER JAYA,63031,11029,52002,45272,97274,2021-11-13
3175091004,JAKARTA TIMUR,CIRACAS,SUSUKAN,38257,7162,31095,26046,57141,2021-11-13
3173031001,JAKARTA BARAT,TAMAN SARI,TAMAN SARI,14348,2608,11740,10086,21826,2021-11-13
3173041001,JAKARTA BARAT,TAMBORA,TAMBORA,10204,2198,8006,6453,14459,2021-11-13
3173041004,JAKARTA BARAT,TAMBORA,TANAH SEREAL,26387,4457,21930,18460,40390,2021-11-13
3171081004,JAKARTA PUSAT,JOHAR BARU,TANAH TINGGI,37693,7148,30545,24871,55416,2021-11-13
3173031004,JAKARTA BARAT,TAMAN SARI,TANGKI,13324,2199,11125,9427,20552,2021-11-13
3174091005,JAKARTA SELATAN,JAGAKARSA,TANJUNG BARAT,39770,6718,33052,27589,60641,2021-11-13
3173021005,JAKARTA BARAT,GROGOL PETAMBURAN,TANJUNG DUREN SELATAN,25337,4803,20534,18213,38747,2021-11-13
3173021002,JAKARTA BARAT,GROGOL PETAMBURAN,TANJUNG DUREN UTARA,17010,2855,14155,12741,26896,2021-11-13
3172021001,JAKARTA UTARA,TANJUNG PRIOK,TANJUNG PRIOK,34588,7104,27484,22511,49995,2021-11-13
3174011002,JAKARTA SELATAN,TEBET,TEBET BARAT,21194,3409,17785,15716,33501,2021-11-13
3174011001,JAKARTA SELATAN,TEBET,TEBET TIMUR,18199,2913,15286,13832,29118,2021-11-13
3173061003,JAKARTA BARAT,KALI DERES,TEGAL ALUR,83647,17199,66448,55116,121564,2021-11-13
3174031004,JAKARTA SELATAN,MAMPANG PRAPATAN,TEGAL PARANG,32401,7109,25292,19848,45140,2021-11-13
3173021003,JAKARTA BARAT,GROGOL PETAMBURAN,TOMANG,29605,5423,24182,20785,44967,2021-11-13
3172031005,JAKARTA UTARA,KOJA,TUGU SELATAN,39122,8679,30443,24669,55112,2021-11-13
3172031002,JAKARTA UTARA,KOJA,TUGU UTARA,67670,15865,51805,41176,92981,2021-11-13
3175061006,JAKARTA TIMUR,CAKUNG,UJUNG MENTENG,29934,5119,24815,21091,45906,2021-11-13
3174101005,JAKARTA SELATAN,PESANGGRAHAN,ULUJAMI,40544,9054,31490,25983,57473,2021-11-13
3175011006,JAKARTA TIMUR,MATRAMAN,UTAN KAYU SELATAN,33511,5995,27516,22823,50339,2021-11-13
3175011002,JAKARTA TIMUR,MATRAMAN,UTAN KAYU UTARA,28169,5818,22351,18374,40725,2021-11-13
3171031008,JAKARTA PUSAT,KEMAYORAN,UTAN PANJANG,29208,5869,23339,18988,42327,2021-11-13
3172021007,JAKARTA UTARA,TANJUNG PRIOK,WARAKAS,44401,8107,36294,29444,65738,2021-11-13
3173021007,JAKARTA BARAT,GROGOL PETAMBURAN,WIJAYA KUSUMA,38934,8075,30859,26032,56891,2021-11-13
3172051003,JAKARTA UTARA,PADEMANGAN,ANCOL,23947,5754,18193,14974,33167,2021-11-14
3173041007,JAKARTA BARAT,TAMBORA,ANGKE,29381,6191,23190,18858,42048,2021-11-14
3175041005,JAKARTA TIMUR,KRAMAT JATI,BALE KAMBANG,29074,7201,21873,17309,39182,2021-11-14
3175031003,JAKARTA TIMUR,JATINEGARA,BALI MESTER,9752,2028,7724,6545,14269,2021-11-14
3175101006,JAKARTA TIMUR,CIPAYUNG,BAMBU APUS,26285,4811,21474,18008,39482,2021-11-14
3174031002,JAKARTA SELATAN,MAMPANG PRAPATAN,BANGKA,21566,4544,17022,14134,31156,2021-11-14
3175051002,JAKARTA TIMUR,PASAR REBO,BARU,23886,3927,19959,17214,37173,2021-11-14
3175041004,JAKARTA TIMUR,KRAMAT JATI,BATU AMPAR,47898,11517,36381,29397,65778,2021-11-14
3171071002,JAKARTA PUSAT,TANAH ABANG,BENDUNGAN HILIR,21494,4309,17185,14722,31907,2021-11-14
3175031002,JAKARTA TIMUR,JATINEGARA,BIDARA CINA,36689,8742,27947,22508,50455,2021-11-14
3174101002,JAKARTA SELATAN,PESANGGRAHAN,BINTARO,53098,10581,42517,36810,79327,2021-11-14
3174011005,JAKARTA SELATAN,TEBET,BUKIT DURI,34183,6829,27354,22827,50181,2021-11-14
3171041006,JAKARTA PUSAT,SENEN,BUNGUR,18144,3750,14394,11940,26334,2021-11-14
3175061007,JAKARTA TIMUR,CAKUNG,CAKUNG BARAT,57724,11760,45964,37986,83950,2021-11-14
3175061004,JAKARTA TIMUR,CAKUNG,CAKUNG TIMUR,58287,11338,46949,39043,85992,2021-11-14
3175041007,JAKARTA TIMUR,KRAMAT JATI,CAWANG,32762,6972,25790,20728,46518,2021-11-14
3175101008,JAKARTA TIMUR,CIPAYUNG,CEGER,18932,3650,15282,12780,28062,2021-11-14
3171031006,JAKARTA PUSAT,KEMAYORAN,CEMPAKA BARU,32581,6138,26443,20894,47337,2021-11-14
3171051002,JAKARTA PUSAT,CEMPAKA PUTIH,CEMPAKA PUTIH BARAT,35885,7597,28288,24224,52512,2021-11-14
3171051001,JAKARTA PUSAT,CEMPAKA PUTIH,CEMPAKA PUTIH TIMUR,24292,4960,19332,16923,36255,2021-11-14
3173011001,JAKARTA BARAT,CENGKARENG,CENGKARENG BARAT,66284,13126,53158,45417,98575,2021-11-14
3173011006,JAKARTA BARAT,CENGKARENG,CENGKARENG TIMUR,81027,15865,65162,54289,119451,2021-11-14
3175091002,JAKARTA TIMUR,CIRACAS,CIBUBUR,66364,11331,55033,46703,101736,2021-11-14
3171011002,JAKARTA PUSAT,GAMBIR,CIDENG,15390,2994,12396,10843,23239,2021-11-14
3174091003,JAKARTA SELATAN,JAGAKARSA,CIGANJUR,38497,6408,32089,26545,58634,2021-11-14
3175051003,JAKARTA TIMUR,PASAR REBO,CIJANTUNG,41419,7627,33792,28230,62022,2021-11-14
3171061003,JAKARTA PUSAT,MENTENG,CIKINI,8274,1480,6794,5413,12207,2021-11-14
3174081006,JAKARTA SELATAN,PANCORAN,CIKOKO,10547,1807,8740,7585,16325,2021-11-14
3174061001,JAKARTA SELATAN,CILANDAK,CILANDAK BARAT,51752,9065,42687,37354,80041,2021-11-14
3174041003,JAKARTA SELATAN,PASAR MINGGU,CILANDAK TIMUR,25145,4582,20563,17575,38138,2021-11-14
3175101002,JAKARTA TIMUR,CIPAYUNG,CILANGKAP,27635,4860,22775,19419,42194,2021-11-14
3175041006,JAKARTA TIMUR,KRAMAT JATI,CILILITAN,40181,8627,31554,25830,57384,2021-11-14
3172041001,JAKARTA UTARA,CILINCING,CILINCING,43609,10393,33216,25857,59073,2021-11-14
3175101001,JAKARTA TIMUR,CIPAYUNG,CIPAYUNG,26104,4526,21578,18548,40126,2021-11-14
3174091006,JAKARTA SELATAN,JAGAKARSA,CIPEDAK,38303,6285,32018,27033,59051,2021-11-14
3174061005,JAKARTA SELATAN,CILANDAK,CIPETE SELATAN,26704,5088,21616,19031,40647,2021-11-14
3174071010,JAKARTA SELATAN,KEBAYORAN BARU,CIPETE UTARA,34102,6450,27652,23199,50851,2021-11-14
3175021003,JAKARTA TIMUR,PULO GADUNG,CIPINANG,39306,7193,32113,26804,58917,2021-11-14
3175031007,JAKARTA TIMUR,JATINEGARA,CIPINANG BESAR SELATAN,35212,8286,26926,21203,48129,2021-11-14
3175031008,JAKARTA TIMUR,JATINEGARA,CIPINANG BESAR UTARA,45319,10568,34751,27198,61949,2021-11-14
3175031005,JAKARTA TIMUR,JATINEGARA,CIPINANG CEMPEDAK,32824,7099,25725,21908,47633,2021-11-14
3175081005,JAKARTA TIMUR,MAKASAR,CIPINANG MELAYU,42308,8120,34188,29058,63246,2021-11-14
3175031006,JAKARTA TIMUR,JATINEGARA,CIPINANG MUARA,55243,11697,43546,35582,79128,2021-11-14
3174051003,JAKARTA SELATAN,KEBAYORAN LAMA,CIPULIR,39937,8400,31537,25674,57211,2021-11-14
3175091001,JAKARTA TIMUR,CIRACAS,CIRACAS,64594,11741,52853,43939,96792,2021-11-14
3175041003,JAKARTA TIMUR,KRAMAT JATI,DUKUH,24609,4568,20041,16650,36691,2021-11-14
3175071001,JAKARTA TIMUR,DUREN SAWIT,DUREN SAWIT,61160,12814,48346,40223,88569,2021-11-14
3174081004,JAKARTA SELATAN,PANCORAN,DUREN TIGA,28319,5606,22713,19082,41795,2021-11-14
3173051005,JAKARTA BARAT,KEBON JERUK,DURI KEPA,60138,11714,48424,41841,90265,2021-11-14
3173011002,JAKARTA BARAT,CENGKARENG,DURI KOSAMBI,77923,16543,61380,49384,110764,2021-11-14
3171011006,JAKARTA PUSAT,GAMBIR,DURI PULO,19610,4107,15503,12502,28005,2021-11-14
3173041011,JAKARTA BARAT,TAMBORA,DURI SELATAN,14259,2518,11741,9998,21739,2021-11-14
3173041003,JAKARTA BARAT,TAMBORA,DURI UTARA,19844,3573,16271,13444,29715,2021-11-14
3171081003,JAKARTA PUSAT,JOHAR BARU,GALUR,18243,3551,14692,11932,26624,2021-11-14
3171011001,JAKARTA PUSAT,GAMBIR,GAMBIR,2191,456,1735,1510,3245,2021-11-14
3174061004,JAKARTA SELATAN,CILANDAK,GANDARIA SELATAN,22119,4210,17909,15314,33223,2021-11-14
3174071009,JAKARTA SELATAN,KEBAYORAN BARU,GANDARIA UTARA,39922,7895,32027,27188,59215,2021-11-14
3175051001,JAKARTA TIMUR,PASAR REBO,GEDONG,35755,7128,28627,24286,52913,2021-11-14
3171071001,JAKARTA PUSAT,TANAH ABANG,GELORA,3127,608,2519,2181,4700,2021-11-14
3173031007,JAKARTA BARAT,TAMAN SARI,GLODOK,7837,1176,6661,5986,12647,2021-11-14
3171061004,JAKARTA PUSAT,MENTENG,GONDANGDIA,4100,912,3188,2911,6099,2021-11-14
3173021001,JAKARTA BARAT,GROGOL PETAMBURAN,GROGOL,16876,3338,13538,11493,25031,2021-11-14
3174051005,JAKARTA SELATAN,KEBAYORAN LAMA,GROGOL SELATAN,44251,8751,35500,29274,64774,2021-11-14
3174051004,JAKARTA SELATAN,KEBAYORAN LAMA,GROGOL UTARA,42494,8603,33891,28097,61988,2021-11-14
3174021007,JAKARTA SELATAN,SETIA BUDI,GUNTUR,3985,742,3243,2854,6097,2021-11-14
3174071002,JAKARTA SELATAN,KEBAYORAN BARU,GUNUNG,9436,1739,7697,6867,14564,2021-11-14
3171031005,JAKARTA PUSAT,KEMAYORAN,GUNUNG SAHARI SELATAN,19199,3862,15337,12955,28292,2021-11-14
3171021004,JAKARTA PUSAT,SAWAH BESAR,GUNUNG SAHARI UTARA,16650,2922,13728,12277,26005,2021-11-14
3175081004,JAKARTA TIMUR,MAKASAR,HALIM PERDANA KUSUMAH,28363,3645,24718,22578,47296,2021-11-14
3171031003,JAKARTA PUSAT,KEMAYORAN,HARAPAN MULIA,22557,4530,18027,14740,32767,2021-11-14
3174091001,JAKARTA SELATAN,JAGAKARSA,JAGAKARSA,62389,10176,52213,43805,96018,2021-11-14
3175021007,JAKARTA TIMUR,PULO GADUNG,JATI,32757,6078,26679,23164,49843,2021-11-14
3174041002,JAKARTA SELATAN,PASAR MINGGU,JATI PADANG,37502,7302,30200,25513,55713,2021-11-14
3173071004,JAKARTA BARAT,PALMERAH,JATI PULO,28738,5677,23061,18490,41551,2021-11-14
3175061001,JAKARTA TIMUR,CAKUNG,JATINEGARA,84160,17773,66387,54863,121250,2021-11-14
3175021004,JAKARTA TIMUR,PULO GADUNG,JATINEGARA KAUM,24632,4367,20265,16551,36816,2021-11-14
3173021004,JAKARTA BARAT,GROGOL PETAMBURAN,JELAMBAR,30266,5491,24775,21719,46494,2021-11-14
3173021006,JAKARTA BARAT,GROGOL PETAMBURAN,JELAMBAR BARU,38246,7012,31234,27191,58425,2021-11-14
3173041006,JAKARTA BARAT,TAMBORA,JEMBATAN BESI,29314,7058,22256,17423,39679,2021-11-14
3173041008,JAKARTA BARAT,TAMBORA,JEMBATAN LIMA,21021,4813,16208,12876,29084,2021-11-14
3173081005,JAKARTA BARAT,KEMBANGAN,JOGLO,40839,8111,32728,27806,60534,2021-11-14
3171081001,JAKARTA PUSAT,JOHAR BARU,JOHAR BARU,37488,6909,30579,25905,56484,2021-11-14
3173041002,JAKARTA BARAT,TAMBORA,KALI ANYAR,23856,4686,19170,15336,34506,2021-11-14
3172041004,JAKARTA UTARA,CILINCING,KALIBARU,67684,18558,49126,35129,84255,2021-11-14
3174081002,JAKARTA SELATAN,PANCORAN,KALIBATA,41994,9467,32527,26561,59088,2021-11-14
3173061001,JAKARTA BARAT,KALI DERES,KALIDERES,72447,14452,57995,49213,107208,2021-11-14
3175051004,JAKARTA TIMUR,PASAR REBO,KALISARI,43212,7675,35537,30059,65596,2021-11-14
3173061004,JAKARTA BARAT,KALI DERES,KAMAL,53783,12420,41363,33265,74628,2021-11-14
3172011002,JAKARTA UTARA,PENJARINGAN,KAMAL MUARA,12930,2288,10642,9089,19731,2021-11-14
3171071007,JAKARTA PUSAT,TANAH ABANG,KAMPUNG BALI,11358,2442,8916,6909,15825,2021-11-14
3175031001,JAKARTA TIMUR,JATINEGARA,KAMPUNG MELAYU,25717,5862,19855,15572,35427,2021-11-14
3171081002,JAKARTA PUSAT,JOHAR BARU,KAMPUNG RAWA,21237,3494,17743,14248,31991,2021-11-14
3175041002,JAKARTA TIMUR,KRAMAT JATI,KAMPUNG TENGAH,43993,10946,33047,26586,59633,2021-11-14
3173011005,JAKARTA BARAT,CENGKARENG,KAPUK,134466,32186,102280,83082,185362,2021-11-14
3172011003,JAKARTA UTARA,PENJARINGAN,KAPUK MUARA,35781,6813,28968,25453,54421,2021-11-14
3171021002,JAKARTA PUSAT,SAWAH BESAR,KARANG ANYAR,25761,4907,20854,17621,38475,2021-11-14
3174021004,JAKARTA SELATAN,SETIA BUDI,KARET,9623,1843,7780,6493,14273,2021-11-14
3174021003,JAKARTA SELATAN,SETIA BUDI,KARET KUNINGAN,16055,3102,12953,11026,23979,2021-11-14
3174021002,JAKARTA SELATAN,SETIA BUDI,KARET SEMANGGI,2770,552,2218,1966,4184,2021-11-14
3171071003,JAKARTA PUSAT,TANAH ABANG,KARET TENGSIN,19271,3687,15584,12783,28367,2021-11-14
3171021003,JAKARTA PUSAT,SAWAH BESAR,KARTINI,22292,4172,18120,15594,33714,2021-11-14
3175011003,JAKARTA TIMUR,MATRAMAN,KAYU MANIS,25284,5297,19987,15977,35964,2021-11-14
3175021006,JAKARTA TIMUR,PULO GADUNG,KAYU PUTIH,40696,7624,33072,28986,62058,2021-11-14
3173031006,JAKARTA BARAT,TAMAN SARI,KEAGUNGAN,17387,3214,14173,11585,25758,2021-11-14
3174041007,JAKARTA SELATAN,PASAR MINGGU,KEBAGUSAN,44552,8776,35776,29600,65376,2021-11-14
3174051006,JAKARTA SELATAN,KEBAYORAN LAMA,KEBAYORAN LAMA SELATAN,41212,7608,33604,28693,62297,2021-11-14
3174051001,JAKARTA SELATAN,KEBAYORAN LAMA,KEBAYORAN LAMA UTARA,42422,8741,33681,27880,61561,2021-11-14
3174011004,JAKARTA SELATAN,TEBET,KEBON BARU,35165,6565,28600,24132,52732,2021-11-14
3172021005,JAKARTA UTARA,TANJUNG PRIOK,KEBON BAWANG,50952,10233,40719,34008,74727,2021-11-14
3173051001,JAKARTA BARAT,KEBON JERUK,KEBON JERUK,53887,11164,42723,34909,77632,2021-11-14
3171071006,JAKARTA PUSAT,TANAH ABANG,KEBON KACANG,21531,5097,16434,13018,29452,2021-11-14
3171011005,JAKARTA PUSAT,GAMBIR,KEBON KELAPA,10163,2028,8135,6871,15006,2021-11-14
3171031002,JAKARTA PUSAT,KEMAYORAN,KEBON KOSONG,30019,5988,24031,19697,43728,2021-11-14
3175011005,JAKARTA TIMUR,MATRAMAN,KEBON MANGGIS,16490,3190,13300,11052,24352,2021-11-14
3171071005,JAKARTA PUSAT,TANAH ABANG,KEBON MELATI,32206,8576,23630,17655,41285,2021-11-14
3175081003,JAKARTA TIMUR,MAKASAR,KEBON PALA,46614,9084,37530,31339,68869,2021-11-14
3171061005,JAKARTA PUSAT,MENTENG,KEBON SIRIH,12299,2626,9673,7798,17471,2021-11-14
3173011004,JAKARTA BARAT,CENGKARENG,KEDAUNG KALI ANGKE,32612,6284,26328,22204,48532,2021-11-14
3173051007,JAKARTA BARAT,KEBON JERUK,KEDOYA SELATAN,32165,5848,26317,21824,48141,2021-11-14
3173051006,JAKARTA BARAT,KEBON JERUK,KEDOYA UTARA,45740,8666,37074,31422,68496,2021-11-14
3173051004,JAKARTA BARAT,KEBON JERUK,KELAPA DUA,23565,4573,18992,15838,34830,2021-11-14
3175091003,JAKARTA TIMUR,CIRACAS,KELAPA DUA WETAN,46875,7919,38956,33048,72004,2021-11-14
3172061003,JAKARTA UTARA,KELAPA GADING,KELAPA GADING BARAT,35717,6188,29529,26674,56203,2021-11-14
3172061001,JAKARTA UTARA,KELAPA GADING,KELAPA GADING TIMUR,33592,5099,28493,26406,54899,2021-11-14
3173071005,JAKARTA BARAT,PALMERAH,KEMANGGISAN,32139,6039,26100,22088,48188,2021-11-14
3171031001,JAKARTA PUSAT,KEMAYORAN,KEMAYORAN,20708,4123,16585,13670,30255,2021-11-14
3173081006,JAKARTA BARAT,KEMBANGAN,KEMBANGAN SELATAN,27130,5667,21463,18597,40060,2021-11-14
3173081001,JAKARTA BARAT,KEMBANGAN,KEMBANGAN UTARA,54451,11865,42586,35571,78157,2021-11-14
3171041002,JAKARTA PUSAT,SENEN,KENARI,9579,1856,7723,6607,14330,2021-11-14
3173041005,JAKARTA BARAT,TAMBORA,KERENDANG,19973,4038,15935,12977,28912,2021-11-14
3175071003,JAKARTA TIMUR,DUREN SAWIT,KLENDER,69978,16324,53654,42918,96572,2021-11-14
3172031001,JAKARTA UTARA,KOJA,KOJA,28175,6383,21792,17684,39476,2021-11-14
3173071006,JAKARTA BARAT,PALMERAH,KOTA BAMBU SELATAN,21158,4138,17020,13392,30412,2021-11-14
3173071003,JAKARTA BARAT,PALMERAH,KOTA BAMBU UTARA,24995,5135,19860,15495,35355,2021-11-14
3171041004,JAKARTA PUSAT,SENEN,KRAMAT,28835,6886,21949,16783,38732,2021-11-14
3175041001,JAKARTA TIMUR,KRAMAT JATI,KRAMAT JATI,34144,7182,26962,21986,48948,2021-11-14
3174071003,JAKARTA SELATAN,KEBAYORAN BARU,KRAMAT PELA,14413,2776,11637,10027,21664,2021-11-14
3173031002,JAKARTA BARAT,TAMAN SARI,KRUKUT,19244,3605,15639,12731,28370,2021-11-14
3174031005,JAKARTA SELATAN,MAMPANG PRAPATAN,KUNINGAN BARAT,12785,2320,10465,8719,19184,2021-11-14
3174021008,JAKARTA SELATAN,SETIA BUDI,KUNINGAN TIMUR,6008,1182,4826,4129,8955,2021-11-14
3171041005,JAKARTA PUSAT,SENEN,KWITANG,15486,3426,12060,9745,21805,2021-11-14
3172031003,JAKARTA UTARA,KOJA,LAGOA,59065,13886,45179,35822,81001,2021-11-14
3174061002,JAKARTA SELATAN,CILANDAK,LEBAK BULUS,37626,7047,30579,26907,57486,2021-11-14
3174091004,JAKARTA SELATAN,JAGAKARSA,LENTENG AGUNG,53946,9593,44353,36407,80760,2021-11-14
3175101007,JAKARTA TIMUR,CIPAYUNG,LUBANG BUAYA,63547,11893,51654,43050,94704,2021-11-14
3175081001,JAKARTA TIMUR,MAKASAR,MAKASAR,34390,6242,28148,24157,52305,2021-11-14
3175071006,JAKARTA TIMUR,DUREN SAWIT,MALAKA JAYA,30927,5246,25681,22167,47848,2021-11-14
3175071005,JAKARTA TIMUR,DUREN SAWIT,MALAKA SARI,27530,4522,23008,19934,42942,2021-11-14
3174031001,JAKARTA SELATAN,MAMPANG PRAPATAN,MAMPANG PRAPATAN,18159,3696,14463,12008,26471,2021-11-14
3173031005,JAKARTA BARAT,TAMAN SARI,MANGGA BESAR,7707,1285,6422,5677,12099,2021-11-14
3171021005,JAKARTA PUSAT,SAWAH BESAR,MANGGA DUA SELATAN,27442,5663,21779,18561,40340,2021-11-14
3174011007,JAKARTA SELATAN,TEBET,MANGGARAI,28373,4960,23413,19132,42545,2021-11-14
3174011006,JAKARTA SELATAN,TEBET,MANGGARAI SELATAN,23075,3917,19158,16192,35350,2021-11-14
3173031003,JAKARTA BARAT,TAMAN SARI,MAPHAR,16461,3043,13418,11261,24679,2021-11-14
3172041003,JAKARTA UTARA,CILINCING,MARUNDA,28943,6507,22436,16896,39332,2021-11-14
3174071001,JAKARTA SELATAN,KEBAYORAN BARU,MELAWAI,2627,507,2120,1949,4069,2021-11-14
3171061001,JAKARTA PUSAT,MENTENG,MENTENG,25624,5609,20015,15908,35923,2021-11-14
3174021005,JAKARTA SELATAN,SETIA BUDI,MENTENG ATAS,27816,4960,22856,19148,42004,2021-11-14
3174011003,JAKARTA SELATAN,TEBET,MENTENG DALAM,36028,6964,29064,24674,53738,2021-11-14
3173081003,JAKARTA BARAT,KEMBANGAN,MERUYA SELATAN,32130,6545,25585,21641,47226,2021-11-14
3173081002,JAKARTA BARAT,KEMBANGAN,MERUYA UTARA,43752,8946,34806,30355,65161,2021-11-14
3175101004,JAKARTA TIMUR,CIPAYUNG,MUNJUL,23871,4321,19550,16618,36168,2021-11-14
3172051002,JAKARTA UTARA,PADEMANGAN,PADEMANGAN BARAT,74240,17318,56922,46171,103093,2021-11-14
3172051001,JAKARTA UTARA,PADEMANGAN,PADEMANGAN TIMUR,37736,6639,31097,27446,58543,2021-11-14
3175011004,JAKARTA TIMUR,MATRAMAN,PAL MERIAM,19769,4038,15731,12726,28457,2021-11-14
3173071001,JAKARTA BARAT,PALMERAH,PALMERAH,63011,13174,49837,40851,90688,2021-11-14
3174081001,JAKARTA SELATAN,PANCORAN,PANCORAN,19421,3910,15511,12876,28387,2021-11-14
3172021003,JAKARTA UTARA,TANJUNG PRIOK,PAPANGGO,39097,7630,31467,25954,57421,2021-11-14
3171021001,JAKARTA PUSAT,SAWAH BESAR,PASAR BARU,12035,2292,9743,8743,18486,2021-11-14
3174021006,JAKARTA SELATAN,SETIA BUDI,PASAR MANGGIS,26752,5205,21547,17896,39443,2021-11-14
3174041001,JAKARTA SELATAN,PASAR MINGGU,PASAR MINGGU,24821,4652,20169,17337,37506,2021-11-14
3171041003,JAKARTA PUSAT,SENEN,PASEBAN,23533,4851,18682,15400,34082,2021-11-14
3173061005,JAKARTA BARAT,KALI DERES,PEGADUNGAN,75587,14697,60890,52429,113319,2021-11-14
3171061002,JAKARTA PUSAT,MENTENG,PEGANGSAAN,23455,5007,18448,14294,32742,2021-11-14
3172061002,JAKARTA UTARA,KELAPA GADING,PEGANGSAAN DUA,49976,8210,41766,37872,79638,2021-11-14
3172011004,JAKARTA UTARA,PENJARINGAN,PEJAGALAN,74578,15340,59238,51275,110513,2021-11-14
3174041006,JAKARTA SELATAN,PASAR MINGGU,PEJATEN BARAT,37346,7206,30140,25385,55525,2021-11-14
3174041005,JAKARTA SELATAN,PASAR MINGGU,PEJATEN TIMUR,57656,12771,44885,37020,81905,2021-11-14
3175051005,JAKARTA TIMUR,PASAR REBO,PEKAYON,43250,7787,35463,29639,65102,2021-11-14
3173041009,JAKARTA BARAT,TAMBORA,PEKOJAN,23587,4452,19135,16181,35316,2021-11-14
3174031003,JAKARTA SELATAN,MAMPANG PRAPATAN,PELA MAMPANG,43522,8461,35061,29461,64522,2021-11-14
3174081005,JAKARTA SELATAN,PANCORAN,PENGADEGAN,21478,3920,17558,15004,32562,2021-11-14
3175061003,JAKARTA TIMUR,CAKUNG,PENGGILINGAN,99255,22673,76582,61431,138013,2021-11-14
3172011001,JAKARTA UTARA,PENJARINGAN,PENJARINGAN,88308,22489,65819,51042,116861,2021-11-14
3174101001,JAKARTA SELATAN,PESANGGRAHAN,PESANGGRAHAN,27545,4695,22850,19671,42521,2021-11-14
3171071004,JAKARTA PUSAT,TANAH ABANG,PETAMBURAN,33271,8699,24572,18740,43312,2021-11-14
3174071008,JAKARTA SELATAN,KEBAYORAN BARU,PETOGOGAN,11499,2214,9285,7986,17271,2021-11-14
3171011004,JAKARTA PUSAT,GAMBIR,PETOJO SELATAN,14692,3275,11417,9711,21128,2021-11-14
3171011003,JAKARTA PUSAT,GAMBIR,PETOJO UTARA,17458,3738,13720,11378,25098,2021-11-14
3174101004,JAKARTA SELATAN,PESANGGRAHAN,PETUKANGAN SELATAN,37187,7609,29578,25049,54627,2021-11-14
3174101003,JAKARTA SELATAN,PESANGGRAHAN,PETUKANGAN UTARA,53716,11453,42263,35237,77500,2021-11-14
3175081002,JAKARTA TIMUR,MAKASAR,PINANG RANTI,27198,5847,21351,17692,39043,2021-11-14
3173031008,JAKARTA BARAT,TAMAN SARI,PINANGSIA,10729,1862,8867,7402,16269,2021-11-14
3175011001,JAKARTA TIMUR,MATRAMAN,PISANGAN BARU,31776,6487,25289,20260,45549,2021-11-14
3175021002,JAKARTA TIMUR,PULO GADUNG,PISANGAN TIMUR,41011,7509,33502,28476,61978,2021-11-14
3172011005,JAKARTA UTARA,PENJARINGAN,PLUIT,47783,9137,38646,34083,72729,2021-11-14
3175071002,JAKARTA TIMUR,DUREN SAWIT,PONDOK BAMBU,61550,12882,48668,40475,89143,2021-11-14
3175071004,JAKARTA TIMUR,DUREN SAWIT,PONDOK KELAPA,72015,14161,57854,49742,107596,2021-11-14
3175071007,JAKARTA TIMUR,DUREN SAWIT,PONDOK KOPI,35367,6579,28788,23021,51809,2021-11-14
3174061003,JAKARTA SELATAN,CILANDAK,PONDOK LABU,46464,7729,38735,33690,72425,2021-11-14
3174051002,JAKARTA SELATAN,KEBAYORAN LAMA,PONDOK PINANG,56169,10667,45502,39208,84710,2021-11-14
3175101003,JAKARTA TIMUR,CIPAYUNG,PONDOK RANGGON,25574,4744,20830,17532,38362,2021-11-14
3101011003,KAB.ADM.KEP.SERIBU,KEP. SERIBU UTARA,PULAU HARAPAN,2060,220,1840,1609,3449,2021-11-14
3101011002,KAB.ADM.KEP.SERIBU,KEP. SERIBU UTARA,PULAU KELAPA,5528,595,4933,4076,9009,2021-11-14
3101011001,KAB.ADM.KEP.SERIBU,KEP. SERIBU UTARA,PULAU PANGGANG,5450,436,5014,4497,9511,2021-11-14
3101021003,KAB.ADM.KEP.SERIBU,KEP. SERIBU SELATAN,PULAU PARI,2765,192,2573,2432,5005,2021-11-14
3101021002,KAB.ADM.KEP.SERIBU,KEP. SERIBU SELATAN,PULAU TIDUNG,4553,365,4188,3834,8022,2021-11-14
3101021001,KAB.ADM.KEP.SERIBU,KEP. SERIBU SELATAN,PULAU UNTUNG JAWA,1941,161,1780,1654,3434,2021-11-14
3174071007,JAKARTA SELATAN,KEBAYORAN BARU,PULO,5835,1006,4829,4440,9269,2021-11-14
3175021001,JAKARTA TIMUR,PULO GADUNG,PULO GADUNG,34422,7492,26930,22593,49523,2021-11-14
3175061005,JAKARTA TIMUR,CAKUNG,PULO GEBANG,97301,18588,78713,64273,142986,2021-11-14
3174041004,JAKARTA SELATAN,PASAR MINGGU,RAGUNAN,39616,7230,32386,27725,60111,2021-11-14
3175091005,JAKARTA TIMUR,CIRACAS,RAMBUTAN,36771,8519,28252,22992,51244,2021-11-14
3172031006,JAKARTA UTARA,KOJA,RAWA BADAK SELATAN,42179,9919,32260,25554,57814,2021-11-14
3172031004,JAKARTA UTARA,KOJA,RAWA BADAK UTARA,34408,7647,26761,21598,48359,2021-11-14
3174071005,JAKARTA SELATAN,KEBAYORAN BARU,RAWA BARAT,5625,1000,4625,4115,8740,2021-11-14
3173011003,JAKARTA BARAT,CENGKARENG,RAWA BUAYA,63799,12553,51246,41927,93173,2021-11-14
3175031004,JAKARTA TIMUR,JATINEGARA,RAWA BUNGA,21434,5142,16292,13309,29601,2021-11-14
3174081003,JAKARTA SELATAN,PANCORAN,RAWA JATI,20509,3878,16631,14302,30933,2021-11-14
3175061002,JAKARTA TIMUR,CAKUNG,RAWA TERATE,24637,4441,20196,16535,36731,2021-11-14
3175021005,JAKARTA TIMUR,PULO GADUNG,RAWAMANGUN,37612,7351,30261,25782,56043,2021-11-14
3171051003,JAKARTA PUSAT,CEMPAKA PUTIH,RAWASARI,21967,4428,17539,15045,32584,2021-11-14
3173041010,JAKARTA BARAT,TAMBORA,ROA MALAKA,3484,613,2871,2556,5427,2021-11-14
3172041006,JAKARTA UTARA,CILINCING,ROROTAN,41668,8280,33388,26918,60306,2021-11-14
3174071004,JAKARTA SELATAN,KEBAYORAN BARU,SELONG,2842,544,2298,2132,4430,2021-11-14
3173061002,JAKARTA BARAT,KALI DERES,SEMANAN,71354,15095,56259,45679,101938,2021-11-14
3172041007,JAKARTA UTARA,CILINCING,SEMPER BARAT,68587,13221,55366,46215,101581,2021-11-14
3172041005,JAKARTA UTARA,CILINCING,SEMPER TIMUR,36267,7716,28551,23311,51862,2021-11-14
3174071006,JAKARTA SELATAN,KEBAYORAN BARU,SENAYAN,2771,647,2124,1842,3966,2021-11-14
3171041001,JAKARTA PUSAT,SENEN,SENEN,6804,1438,5366,4484,9850,2021-11-14
3171031004,JAKARTA PUSAT,KEMAYORAN,SERDANG,29668,5772,23896,19987,43883,2021-11-14
3174021001,JAKARTA SELATAN,SETIA BUDI,SETIA BUDI,3023,609,2414,2078,4492,2021-11-14
3175101005,JAKARTA TIMUR,CIPAYUNG,SETU,20572,4051,16521,13517,30038,2021-11-14
3173071002,JAKARTA BARAT,PALMERAH,SLIPI,16591,2950,13641,11551,25192,2021-11-14
3173081004,JAKARTA BARAT,KEMBANGAN,SRENGSENG,45523,10147,35376,30085,65461,2021-11-14
3174091002,JAKARTA SELATAN,JAGAKARSA,SRENGSENG SAWAH,58196,8939,49257,42124,91381,2021-11-14
3173051003,JAKARTA BARAT,KEBON JERUK,SUKABUMI SELATAN,37033,8229,28804,22536,51340,2021-11-14
3173051002,JAKARTA BARAT,KEBON JERUK,SUKABUMI UTARA,38290,8885,29405,23236,52641,2021-11-14
3172041002,JAKARTA UTARA,CILINCING,SUKAPURA,53949,12085,41864,34626,76490,2021-11-14
3171031007,JAKARTA PUSAT,KEMAYORAN,SUMUR BATU,22717,4327,18390,15661,34051,2021-11-14
3172021004,JAKARTA UTARA,TANJUNG PRIOK,SUNGAI BAMBU,29876,5955,23921,19935,43856,2021-11-14
3172021006,JAKARTA UTARA,TANJUNG PRIOK,SUNTER AGUNG,71805,12314,59491,52216,111707,2021-11-14
3172021002,JAKARTA UTARA,TANJUNG PRIOK,SUNTER JAYA,63031,11006,52025,45330,97355,2021-11-14
3175091004,JAKARTA TIMUR,CIRACAS,SUSUKAN,38257,7156,31101,26107,57208,2021-11-14
3173031001,JAKARTA BARAT,TAMAN SARI,TAMAN SARI,14348,2604,11744,10118,21862,2021-11-14
3173041001,JAKARTA BARAT,TAMBORA,TAMBORA,10204,2195,8009,6461,14470,2021-11-14
3173041004,JAKARTA BARAT,TAMBORA,TANAH SEREAL,26387,4448,21939,18486,40425,2021-11-14
3171081004,JAKARTA PUSAT,JOHAR BARU,TANAH TINGGI,37693,7140,30553,24892,55445,2021-11-14
3173031004,JAKARTA BARAT,TAMAN SARI,TANGKI,13324,2194,11130,9442,20572,2021-11-14
3174091005,JAKARTA SELATAN,JAGAKARSA,TANJUNG BARAT,39770,6712,33058,27613,60671,2021-11-14
3173021005,JAKARTA BARAT,GROGOL PETAMBURAN,TANJUNG DUREN SELATAN,25337,4799,20538,18240,38778,2021-11-14
3173021002,JAKARTA BARAT,GROGOL PETAMBURAN,TANJUNG DUREN UTARA,17010,2851,14159,12751,26910,2021-11-14
3172021001,JAKARTA UTARA,TANJUNG PRIOK,TANJUNG PRIOK,34588,7096,27492,22541,50033,2021-11-14
3174011002,JAKARTA SELATAN,TEBET,TEBET BARAT,21194,3406,17788,15736,33524,2021-11-14
3174011001,JAKARTA SELATAN,TEBET,TEBET TIMUR,18199,2909,15290,13850,29140,2021-11-14
3173061003,JAKARTA BARAT,KALI DERES,TEGAL ALUR,83647,17183,66464,55169,121633,2021-11-14
3174031004,JAKARTA SELATAN,MAMPANG PRAPATAN,TEGAL PARANG,32401,7098,25303,19896,45199,2021-11-14
3173021003,JAKARTA BARAT,GROGOL PETAMBURAN,TOMANG,29605,5417,24188,20811,44999,2021-11-14
3172031005,JAKARTA UTARA,KOJA,TUGU SELATAN,39122,8667,30455,24688,55143,2021-11-14
3172031002,JAKARTA UTARA,KOJA,TUGU UTARA,67670,15844,51826,41267,93093,2021-11-14
3175061006,JAKARTA TIMUR,CAKUNG,UJUNG MENTENG,29934,5115,24819,21123,45942,2021-11-14
3174101005,JAKARTA SELATAN,PESANGGRAHAN,ULUJAMI,40544,9033,31511,26036,57547,2021-11-14
3175011006,JAKARTA TIMUR,MATRAMAN,UTAN KAYU SELATAN,33511,5983,27528,22854,50382,2021-11-14
3175011002,JAKARTA TIMUR,MATRAMAN,UTAN KAYU UTARA,28169,5815,22354,18400,40754,2021-11-14
3171031008,JAKARTA PUSAT,KEMAYORAN,UTAN PANJANG,29208,5829,23379,19015,42394,2021-11-14
3172021007,JAKARTA UTARA,TANJUNG PRIOK,WARAKAS,44401,8102,36299,29479,65778,2021-11-14
3173021007,JAKARTA BARAT,GROGOL PETAMBURAN,WIJAYA KUSUMA,38934,8065,30869,26056,56925,2021-11-14
3172051003,JAKARTA UTARA,PADEMANGAN,ANCOL,23947,5752,18195,14980,33175,2021-11-15
3173041007,JAKARTA BARAT,TAMBORA,ANGKE,29381,6186,23195,18862,42057,2021-11-15
3175041005,JAKARTA TIMUR,KRAMAT JATI,BALE KAMBANG,29074,7195,21879,17323,39202,2021-11-15
3175031003,JAKARTA TIMUR,JATINEGARA,BALI MESTER,9752,2028,7724,6548,14272,2021-11-15
3175101006,JAKARTA TIMUR,CIPAYUNG,BAMBU APUS,26285,4811,21474,18016,39490,2021-11-15
3174031002,JAKARTA SELATAN,MAMPANG PRAPATAN,BANGKA,21566,4538,17028,14143,31171,2021-11-15
3175051002,JAKARTA TIMUR,PASAR REBO,BARU,23886,3925,19961,17219,37180,2021-11-15
3175041004,JAKARTA TIMUR,KRAMAT JATI,BATU AMPAR,47898,11512,36386,29411,65797,2021-11-15
3171071002,JAKARTA PUSAT,TANAH ABANG,BENDUNGAN HILIR,21494,4309,17185,14729,31914,2021-11-15
3175031002,JAKARTA TIMUR,JATINEGARA,BIDARA CINA,36689,8736,27953,22519,50472,2021-11-15
3174101002,JAKARTA SELATAN,PESANGGRAHAN,BINTARO,53098,10574,42524,36818,79342,2021-11-15
3174011005,JAKARTA SELATAN,TEBET,BUKIT DURI,34183,6824,27359,22835,50194,2021-11-15
3171041006,JAKARTA PUSAT,SENEN,BUNGUR,18144,3750,14394,11944,26338,2021-11-15
3175061007,JAKARTA TIMUR,CAKUNG,CAKUNG BARAT,57724,11740,45984,38004,83988,2021-11-15
3175061004,JAKARTA TIMUR,CAKUNG,CAKUNG TIMUR,58287,11325,46962,39085,86047,2021-11-15
3175041007,JAKARTA TIMUR,KRAMAT JATI,CAWANG,32762,6971,25791,20734,46525,2021-11-15
3175101008,JAKARTA TIMUR,CIPAYUNG,CEGER,18932,3647,15285,12784,28069,2021-11-15
3171031006,JAKARTA PUSAT,KEMAYORAN,CEMPAKA BARU,32581,6133,26448,20899,47347,2021-11-15
3171051002,JAKARTA PUSAT,CEMPAKA PUTIH,CEMPAKA PUTIH BARAT,35885,7591,28294,24228,52522,2021-11-15
3171051001,JAKARTA PUSAT,CEMPAKA PUTIH,CEMPAKA PUTIH TIMUR,24292,4954,19338,16932,36270,2021-11-15
3173011001,JAKARTA BARAT,CENGKARENG,CENGKARENG BARAT,66284,13120,53164,45430,98594,2021-11-15
3173011006,JAKARTA BARAT,CENGKARENG,CENGKARENG TIMUR,81027,15849,65178,54301,119479,2021-11-15
3175091002,JAKARTA TIMUR,CIRACAS,CIBUBUR,66364,11321,55043,46717,101760,2021-11-15
3171011002,JAKARTA PUSAT,GAMBIR,CIDENG,15390,2992,12398,10847,23245,2021-11-15
3174091003,JAKARTA SELATAN,JAGAKARSA,CIGANJUR,38497,6401,32096,26552,58648,2021-11-15
3175051003,JAKARTA TIMUR,PASAR REBO,CIJANTUNG,41419,7623,33796,28232,62028,2021-11-15
3171061003,JAKARTA PUSAT,MENTENG,CIKINI,8274,1480,6794,5420,12214,2021-11-15
3174081006,JAKARTA SELATAN,PANCORAN,CIKOKO,10547,1806,8741,7587,16328,2021-11-15
3174061001,JAKARTA SELATAN,CILANDAK,CILANDAK BARAT,51752,9061,42691,37371,80062,2021-11-15
3174041003,JAKARTA SELATAN,PASAR MINGGU,CILANDAK TIMUR,25145,4578,20567,17581,38148,2021-11-15
3175101002,JAKARTA TIMUR,CIPAYUNG,CILANGKAP,27635,4857,22778,19422,42200,2021-11-15
3175041006,JAKARTA TIMUR,KRAMAT JATI,CILILITAN,40181,8624,31557,25838,57395,2021-11-15
3172041001,JAKARTA UTARA,CILINCING,CILINCING,43609,10374,33235,25866,59101,2021-11-15
3175101001,JAKARTA TIMUR,CIPAYUNG,CIPAYUNG,26104,4521,21583,18552,40135,2021-11-15
3174091006,JAKARTA SELATAN,JAGAKARSA,CIPEDAK,38303,6281,32022,27038,59060,2021-11-15
3174061005,JAKARTA SELATAN,CILANDAK,CIPETE SELATAN,26704,5085,21619,19044,40663,2021-11-15
3174071010,JAKARTA SELATAN,KEBAYORAN BARU,CIPETE UTARA,34102,6437,27665,23213,50878,2021-11-15
3175021003,JAKARTA TIMUR,PULO GADUNG,CIPINANG,39306,7189,32117,26812,58929,2021-11-15
3175031007,JAKARTA TIMUR,JATINEGARA,CIPINANG BESAR SELATAN,35212,8281,26931,21213,48144,2021-11-15
3175031008,JAKARTA TIMUR,JATINEGARA,CIPINANG BESAR UTARA,45319,10566,34753,27204,61957,2021-11-15
3175031005,JAKARTA TIMUR,JATINEGARA,CIPINANG CEMPEDAK,32824,7095,25729,21913,47642,2021-11-15
3175081005,JAKARTA TIMUR,MAKASAR,CIPINANG MELAYU,42308,8116,34192,29071,63263,2021-11-15
3175031006,JAKARTA TIMUR,JATINEGARA,CIPINANG MUARA,55243,11686,43557,35591,79148,2021-11-15
3174051003,JAKARTA SELATAN,KEBAYORAN LAMA,CIPULIR,39937,8394,31543,25679,57222,2021-11-15
3175091001,JAKARTA TIMUR,CIRACAS,CIRACAS,64594,11731,52863,43953,96816,2021-11-15
3175041003,JAKARTA TIMUR,KRAMAT JATI,DUKUH,24609,4563,20046,16651,36697,2021-11-15
3175071001,JAKARTA TIMUR,DUREN SAWIT,DUREN SAWIT,61160,12809,48351,40237,88588,2021-11-15
3174081004,JAKARTA SELATAN,PANCORAN,DUREN TIGA,28319,5599,22720,19087,41807,2021-11-15
3173051005,JAKARTA BARAT,KEBON JERUK,DURI KEPA,60138,11708,48430,41874,90304,2021-11-15
3173011002,JAKARTA BARAT,CENGKARENG,DURI KOSAMBI,77923,16497,61426,49426,110852,2021-11-15
3171011006,JAKARTA PUSAT,GAMBIR,DURI PULO,19610,4105,15505,12503,28008,2021-11-15
3173041011,JAKARTA BARAT,TAMBORA,DURI SELATAN,14259,2516,11743,9999,21742,2021-11-15
3173041003,JAKARTA BARAT,TAMBORA,DURI UTARA,19844,3571,16273,13449,29722,2021-11-15
3171081003,JAKARTA PUSAT,JOHAR BARU,GALUR,18243,3548,14695,11934,26629,2021-11-15
3171011001,JAKARTA PUSAT,GAMBIR,GAMBIR,2191,456,1735,1511,3246,2021-11-15
3174061004,JAKARTA SELATAN,CILANDAK,GANDARIA SELATAN,22119,4207,17912,15317,33229,2021-11-15
3174071009,JAKARTA SELATAN,KEBAYORAN BARU,GANDARIA UTARA,39922,7884,32038,27198,59236,2021-11-15
3175051001,JAKARTA TIMUR,PASAR REBO,GEDONG,35755,7123,28632,24288,52920,2021-11-15
3171071001,JAKARTA PUSAT,TANAH ABANG,GELORA,3127,607,2520,2182,4702,2021-11-15
3173031007,JAKARTA BARAT,TAMAN SARI,GLODOK,7837,1174,6663,5985,12648,2021-11-15
3171061004,JAKARTA PUSAT,MENTENG,GONDANGDIA,4100,911,3189,2911,6100,2021-11-15
3173021001,JAKARTA BARAT,GROGOL PETAMBURAN,GROGOL,16876,3335,13541,11497,25038,2021-11-15
3174051005,JAKARTA SELATAN,KEBAYORAN LAMA,GROGOL SELATAN,44251,8744,35507,29277,64784,2021-11-15
3174051004,JAKARTA SELATAN,KEBAYORAN LAMA,GROGOL UTARA,42494,8599,33895,28106,62001,2021-11-15
3174021007,JAKARTA SELATAN,SETIA BUDI,GUNTUR,3985,742,3243,2855,6098,2021-11-15
3174071002,JAKARTA SELATAN,KEBAYORAN BARU,GUNUNG,9436,1738,7698,6869,14567,2021-11-15
3171031005,JAKARTA PUSAT,KEMAYORAN,GUNUNG SAHARI SELATAN,19199,3861,15338,12962,28300,2021-11-15
3171021004,JAKARTA PUSAT,SAWAH BESAR,GUNUNG SAHARI UTARA,16650,2921,13729,12279,26008,2021-11-15
3175081004,JAKARTA TIMUR,MAKASAR,HALIM PERDANA KUSUMAH,28363,3643,24720,22580,47300,2021-11-15
3171031003,JAKARTA PUSAT,KEMAYORAN,HARAPAN MULIA,22557,4529,18028,14744,32772,2021-11-15
3174091001,JAKARTA SELATAN,JAGAKARSA,JAGAKARSA,62389,10169,52220,43820,96040,2021-11-15
3175021007,JAKARTA TIMUR,PULO GADUNG,JATI,32757,6078,26679,23174,49853,2021-11-15
3174041002,JAKARTA SELATAN,PASAR MINGGU,JATI PADANG,37502,7294,30208,25528,55736,2021-11-15
3173071004,JAKARTA BARAT,PALMERAH,JATI PULO,28738,5670,23068,18493,41561,2021-11-15
3175061001,JAKARTA TIMUR,CAKUNG,JATINEGARA,84160,17761,66399,54884,121283,2021-11-15
3175021004,JAKARTA TIMUR,PULO GADUNG,JATINEGARA KAUM,24632,4363,20269,16558,36827,2021-11-15
3173021004,JAKARTA BARAT,GROGOL PETAMBURAN,JELAMBAR,30266,5489,24777,21724,46501,2021-11-15
3173021006,JAKARTA BARAT,GROGOL PETAMBURAN,JELAMBAR BARU,38246,7005,31241,27200,58441,2021-11-15
3173041006,JAKARTA BARAT,TAMBORA,JEMBATAN BESI,29314,7055,22259,17426,39685,2021-11-15
3173041008,JAKARTA BARAT,TAMBORA,JEMBATAN LIMA,21021,4810,16211,12880,29091,2021-11-15
3173081005,JAKARTA BARAT,KEMBANGAN,JOGLO,40839,8106,32733,27817,60550,2021-11-15
3171081001,JAKARTA PUSAT,JOHAR BARU,JOHAR BARU,37488,6906,30582,25912,56494,2021-11-15
3173041002,JAKARTA BARAT,TAMBORA,KALI ANYAR,23856,4681,19175,15343,34518,2021-11-15
3172041004,JAKARTA UTARA,CILINCING,KALIBARU,67684,18386,49298,35152,84450,2021-11-15
3174081002,JAKARTA SELATAN,PANCORAN,KALIBATA,41994,9460,32534,26571,59105,2021-11-15
3173061001,JAKARTA BARAT,KALI DERES,KALIDERES,72447,14441,58006,49233,107239,2021-11-15
3175051004,JAKARTA TIMUR,PASAR REBO,KALISARI,43212,7669,35543,30074,65617,2021-11-15
3173061004,JAKARTA BARAT,KALI DERES,KAMAL,53783,12417,41366,33274,74640,2021-11-15
3172011002,JAKARTA UTARA,PENJARINGAN,KAMAL MUARA,12930,2286,10644,9090,19734,2021-11-15
3171071007,JAKARTA PUSAT,TANAH ABANG,KAMPUNG BALI,11358,2441,8917,6914,15831,2021-11-15
3175031001,JAKARTA TIMUR,JATINEGARA,KAMPUNG MELAYU,25717,5857,19860,15577,35437,2021-11-15
3171081002,JAKARTA PUSAT,JOHAR BARU,KAMPUNG RAWA,21237,3492,17745,14253,31998,2021-11-15
3175041002,JAKARTA TIMUR,KRAMAT JATI,KAMPUNG TENGAH,43993,10940,33053,26593,59646,2021-11-15
3173011005,JAKARTA BARAT,CENGKARENG,KAPUK,134466,32088,102378,83185,185563,2021-11-15
3172011003,JAKARTA UTARA,PENJARINGAN,KAPUK MUARA,35781,6813,28968,25454,54422,2021-11-15
3171021002,JAKARTA PUSAT,SAWAH BESAR,KARANG ANYAR,25761,4903,20858,17625,38483,2021-11-15
3174021004,JAKARTA SELATAN,SETIA BUDI,KARET,9623,1843,7780,6497,14277,2021-11-15
3174021003,JAKARTA SELATAN,SETIA BUDI,KARET KUNINGAN,16055,3095,12960,11028,23988,2021-11-15
3174021002,JAKARTA SELATAN,SETIA BUDI,KARET SEMANGGI,2770,552,2218,1966,4184,2021-11-15
3171071003,JAKARTA PUSAT,TANAH ABANG,KARET TENGSIN,19271,3685,15586,12786,28372,2021-11-15
3171021003,JAKARTA PUSAT,SAWAH BESAR,KARTINI,22292,4172,18120,15601,33721,2021-11-15
3175011003,JAKARTA TIMUR,MATRAMAN,KAYU MANIS,25284,5293,19991,15982,35973,2021-11-15
3175021006,JAKARTA TIMUR,PULO GADUNG,KAYU PUTIH,40696,7616,33080,28995,62075,2021-11-15
3173031006,JAKARTA BARAT,TAMAN SARI,KEAGUNGAN,17387,3212,14175,11591,25766,2021-11-15
3174041007,JAKARTA SELATAN,PASAR MINGGU,KEBAGUSAN,44552,8763,35789,29611,65400,2021-11-15
3174051006,JAKARTA SELATAN,KEBAYORAN LAMA,KEBAYORAN LAMA SELATAN,41212,7601,33611,28702,62313,2021-11-15
3174051001,JAKARTA SELATAN,KEBAYORAN LAMA,KEBAYORAN LAMA UTARA,42422,8729,33693,27895,61588,2021-11-15
3174011004,JAKARTA SELATAN,TEBET,KEBON BARU,35165,6558,28607,24138,52745,2021-11-15
3172021005,JAKARTA UTARA,TANJUNG PRIOK,KEBON BAWANG,50952,10225,40727,34015,74742,2021-11-15
3173051001,JAKARTA BARAT,KEBON JERUK,KEBON JERUK,53887,11151,42736,34943,77679,2021-11-15
3171071006,JAKARTA PUSAT,TANAH ABANG,KEBON KACANG,21531,5095,16436,13023,29459,2021-11-15
3171011005,JAKARTA PUSAT,GAMBIR,KEBON KELAPA,10163,2028,8135,6876,15011,2021-11-15
3171031002,JAKARTA PUSAT,KEMAYORAN,KEBON KOSONG,30019,5986,24033,19706,43739,2021-11-15
3175011005,JAKARTA TIMUR,MATRAMAN,KEBON MANGGIS,16490,3189,13301,11052,24353,2021-11-15
3171071005,JAKARTA PUSAT,TANAH ABANG,KEBON MELATI,32206,8573,23633,17665,41298,2021-11-15
3175081003,JAKARTA TIMUR,MAKASAR,KEBON PALA,46614,9076,37538,31350,68888,2021-11-15
3171061005,JAKARTA PUSAT,MENTENG,KEBON SIRIH,12299,2624,9675,7799,17474,2021-11-15
3173011004,JAKARTA BARAT,CENGKARENG,KEDAUNG KALI ANGKE,32612,6274,26338,22216,48554,2021-11-15
3173051007,JAKARTA BARAT,KEBON JERUK,KEDOYA SELATAN,32165,5845,26320,21831,48151,2021-11-15
3173051006,JAKARTA BARAT,KEBON JERUK,KEDOYA UTARA,45740,8657,37083,31434,68517,2021-11-15
3173051004,JAKARTA BARAT,KEBON JERUK,KELAPA DUA,23565,4569,18996,15845,34841,2021-11-15
3175091003,JAKARTA TIMUR,CIRACAS,KELAPA DUA WETAN,46875,7917,38958,33060,72018,2021-11-15
3172061003,JAKARTA UTARA,KELAPA GADING,KELAPA GADING BARAT,35717,6187,29530,26695,56225,2021-11-15
3172061001,JAKARTA UTARA,KELAPA GADING,KELAPA GADING TIMUR,33592,5098,28494,26413,54907,2021-11-15
3173071005,JAKARTA BARAT,PALMERAH,KEMANGGISAN,32139,6032,26107,22095,48202,2021-11-15
3171031001,JAKARTA PUSAT,KEMAYORAN,KEMAYORAN,20708,4121,16587,13683,30270,2021-11-15
3173081006,JAKARTA BARAT,KEMBANGAN,KEMBANGAN SELATAN,27130,5664,21466,18602,40068,2021-11-15
3173081001,JAKARTA BARAT,KEMBANGAN,KEMBANGAN UTARA,54451,11856,42595,35574,78169,2021-11-15
3171041002,JAKARTA PUSAT,SENEN,KENARI,9579,1855,7724,6607,14331,2021-11-15
3173041005,JAKARTA BARAT,TAMBORA,KERENDANG,19973,4034,15939,12979,28918,2021-11-15
3175071003,JAKARTA TIMUR,DUREN SAWIT,KLENDER,69978,16307,53671,42939,96610,2021-11-15
3172031001,JAKARTA UTARA,KOJA,KOJA,28175,6377,21798,17696,39494,2021-11-15
3173071006,JAKARTA BARAT,PALMERAH,KOTA BAMBU SELATAN,21158,4133,17025,13404,30429,2021-11-15
3173071003,JAKARTA BARAT,PALMERAH,KOTA BAMBU UTARA,24995,5135,19860,15500,35360,2021-11-15
3171041004,JAKARTA PUSAT,SENEN,KRAMAT,28835,6882,21953,16790,38743,2021-11-15
3175041001,JAKARTA TIMUR,KRAMAT JATI,KRAMAT JATI,34144,7177,26967,21997,48964,2021-11-15
3174071003,JAKARTA SELATAN,KEBAYORAN BARU,KRAMAT PELA,14413,2775,11638,10031,21669,2021-11-15
3173031002,JAKARTA BARAT,TAMAN SARI,KRUKUT,19244,3605,15639,12735,28374,2021-11-15
3174031005,JAKARTA SELATAN,MAMPANG PRAPATAN,KUNINGAN BARAT,12785,2319,10466,8718,19184,2021-11-15
3174021008,JAKARTA SELATAN,SETIA BUDI,KUNINGAN TIMUR,6008,1181,4827,4131,8958,2021-11-15
3171041005,JAKARTA PUSAT,SENEN,KWITANG,15486,3426,12060,9748,21808,2021-11-15
3172031003,JAKARTA UTARA,KOJA,LAGOA,59065,13879,45186,35835,81021,2021-11-15
3174061002,JAKARTA SELATAN,CILANDAK,LEBAK BULUS,37626,7042,30584,26916,57500,2021-11-15
3174091004,JAKARTA SELATAN,JAGAKARSA,LENTENG AGUNG,53946,9589,44357,36415,80772,2021-11-15
3175101007,JAKARTA TIMUR,CIPAYUNG,LUBANG BUAYA,63547,11884,51663,43062,94725,2021-11-15
3175081001,JAKARTA TIMUR,MAKASAR,MAKASAR,34390,6240,28150,24161,52311,2021-11-15
3175071006,JAKARTA TIMUR,DUREN SAWIT,MALAKA JAYA,30927,5241,25686,22171,47857,2021-11-15
3175071005,JAKARTA TIMUR,DUREN SAWIT,MALAKA SARI,27530,4521,23009,19944,42953,2021-11-15
3174031001,JAKARTA SELATAN,MAMPANG PRAPATAN,MAMPANG PRAPATAN,18159,3695,14464,12012,26476,2021-11-15
3173031005,JAKARTA BARAT,TAMAN SARI,MANGGA BESAR,7707,1283,6424,5679,12103,2021-11-15
3171021005,JAKARTA PUSAT,SAWAH BESAR,MANGGA DUA SELATAN,27442,5660,21782,18572,40354,2021-11-15
3174011007,JAKARTA SELATAN,TEBET,MANGGARAI,28373,4957,23416,19140,42556,2021-11-15
3174011006,JAKARTA SELATAN,TEBET,MANGGARAI SELATAN,23075,3913,19162,16203,35365,2021-11-15
3173031003,JAKARTA BARAT,TAMAN SARI,MAPHAR,16461,3039,13422,11267,24689,2021-11-15
3172041003,JAKARTA UTARA,CILINCING,MARUNDA,28943,6500,22443,16899,39342,2021-11-15
3174071001,JAKARTA SELATAN,KEBAYORAN BARU,MELAWAI,2627,506,2121,1952,4073,2021-11-15
3171061001,JAKARTA PUSAT,MENTENG,MENTENG,25624,5605,20019,15913,35932,2021-11-15
3174021005,JAKARTA SELATAN,SETIA BUDI,MENTENG ATAS,27816,4957,22859,19150,42009,2021-11-15
3174011003,JAKARTA SELATAN,TEBET,MENTENG DALAM,36028,6962,29066,24677,53743,2021-11-15
3173081003,JAKARTA BARAT,KEMBANGAN,MERUYA SELATAN,32130,6544,25586,21644,47230,2021-11-15
3173081002,JAKARTA BARAT,KEMBANGAN,MERUYA UTARA,43752,8942,34810,30373,65183,2021-11-15
3175101004,JAKARTA TIMUR,CIPAYUNG,MUNJUL,23871,4320,19551,16624,36175,2021-11-15
3172051002,JAKARTA UTARA,PADEMANGAN,PADEMANGAN BARAT,74240,17308,56932,46186,103118,2021-11-15
3172051001,JAKARTA UTARA,PADEMANGAN,PADEMANGAN TIMUR,37736,6637,31099,27449,58548,2021-11-15
3175011004,JAKARTA TIMUR,MATRAMAN,PAL MERIAM,19769,4034,15735,12734,28469,2021-11-15
3173071001,JAKARTA BARAT,PALMERAH,PALMERAH,63011,13165,49846,40868,90714,2021-11-15
3174081001,JAKARTA SELATAN,PANCORAN,PANCORAN,19421,3908,15513,12886,28399,2021-11-15
3172021003,JAKARTA UTARA,TANJUNG PRIOK,PAPANGGO,39097,7622,31475,25960,57435,2021-11-15
3171021001,JAKARTA PUSAT,SAWAH BESAR,PASAR BARU,12035,2292,9743,8747,18490,2021-11-15
3174021006,JAKARTA SELATAN,SETIA BUDI,PASAR MANGGIS,26752,5197,21555,17908,39463,2021-11-15
3174041001,JAKARTA SELATAN,PASAR MINGGU,PASAR MINGGU,24821,4651,20170,17347,37517,2021-11-15
3171041003,JAKARTA PUSAT,SENEN,PASEBAN,23533,4850,18683,15404,34087,2021-11-15
3173061005,JAKARTA BARAT,KALI DERES,PEGADUNGAN,75587,14685,60902,52462,113364,2021-11-15
3171061002,JAKARTA PUSAT,MENTENG,PEGANGSAAN,23455,5005,18450,14296,32746,2021-11-15
3172061002,JAKARTA UTARA,KELAPA GADING,PEGANGSAAN DUA,49976,8199,41777,37879,79656,2021-11-15
3172011004,JAKARTA UTARA,PENJARINGAN,PEJAGALAN,74578,15330,59248,51296,110544,2021-11-15
3174041006,JAKARTA SELATAN,PASAR MINGGU,PEJATEN BARAT,37346,7201,30145,25394,55539,2021-11-15
3174041005,JAKARTA SELATAN,PASAR MINGGU,PEJATEN TIMUR,57656,12631,45025,37045,82070,2021-11-15
3175051005,JAKARTA TIMUR,PASAR REBO,PEKAYON,43250,7781,35469,29650,65119,2021-11-15
3173041009,JAKARTA BARAT,TAMBORA,PEKOJAN,23587,4451,19136,16182,35318,2021-11-15
3174031003,JAKARTA SELATAN,MAMPANG PRAPATAN,PELA MAMPANG,43522,8456,35066,29474,64540,2021-11-15
3174081005,JAKARTA SELATAN,PANCORAN,PENGADEGAN,21478,3918,17560,15007,32567,2021-11-15
3175061003,JAKARTA TIMUR,CAKUNG,PENGGILINGAN,99255,22657,76598,61453,138051,2021-11-15
3172011001,JAKARTA UTARA,PENJARINGAN,PENJARINGAN,88308,22458,65850,51071,116921,2021-11-15
3174101001,JAKARTA SELATAN,PESANGGRAHAN,PESANGGRAHAN,27545,4693,22852,19674,42526,2021-11-15
3171071004,JAKARTA PUSAT,TANAH ABANG,PETAMBURAN,33271,8698,24573,18748,43321,2021-11-15
3174071008,JAKARTA SELATAN,KEBAYORAN BARU,PETOGOGAN,11499,2209,9290,7988,17278,2021-11-15
3171011004,JAKARTA PUSAT,GAMBIR,PETOJO SELATAN,14692,3271,11421,9718,21139,2021-11-15
3171011003,JAKARTA PUSAT,GAMBIR,PETOJO UTARA,17458,3736,13722,11382,25104,2021-11-15
3174101004,JAKARTA SELATAN,PESANGGRAHAN,PETUKANGAN SELATAN,37187,7607,29580,25053,54633,2021-11-15
3174101003,JAKARTA SELATAN,PESANGGRAHAN,PETUKANGAN UTARA,53716,11443,42273,35251,77524,2021-11-15
3175081002,JAKARTA TIMUR,MAKASAR,PINANG RANTI,27198,5843,21355,17695,39050,2021-11-15
3173031008,JAKARTA BARAT,TAMAN SARI,PINANGSIA,10729,1862,8867,7401,16268,2021-11-15
3175011001,JAKARTA TIMUR,MATRAMAN,PISANGAN BARU,31776,6484,25292,20263,45555,2021-11-15
3175021002,JAKARTA TIMUR,PULO GADUNG,PISANGAN TIMUR,41011,7506,33505,28484,61989,2021-11-15
3172011005,JAKARTA UTARA,PENJARINGAN,PLUIT,47783,9135,38648,34085,72733,2021-11-15
3175071002,JAKARTA TIMUR,DUREN SAWIT,PONDOK BAMBU,61550,12870,48680,40491,89171,2021-11-15
3175071004,JAKARTA TIMUR,DUREN SAWIT,PONDOK KELAPA,72015,14157,57858,49755,107613,2021-11-15
3175071007,JAKARTA TIMUR,DUREN SAWIT,PONDOK KOPI,35367,6577,28790,23027,51817,2021-11-15
3174061003,JAKARTA SELATAN,CILANDAK,PONDOK LABU,46464,7725,38739,33782,72521,2021-11-15
3174051002,JAKARTA SELATAN,KEBAYORAN LAMA,PONDOK PINANG,56169,10660,45509,39225,84734,2021-11-15
3175101003,JAKARTA TIMUR,CIPAYUNG,PONDOK RANGGON,25574,4742,20832,17537,38369,2021-11-15
3101011003,KAB.ADM.KEP.SERIBU,KEP. SERIBU UTARA,PULAU HARAPAN,2060,220,1840,1609,3449,2021-11-15
3101011002,KAB.ADM.KEP.SERIBU,KEP. SERIBU UTARA,PULAU KELAPA,5528,595,4933,4077,9010,2021-11-15
3101011001,KAB.ADM.KEP.SERIBU,KEP. SERIBU UTARA,PULAU PANGGANG,5450,436,5014,4497,9511,2021-11-15
3101021003,KAB.ADM.KEP.SERIBU,KEP. SERIBU SELATAN,PULAU PARI,2765,192,2573,2432,5005,2021-11-15
3101021002,KAB.ADM.KEP.SERIBU,KEP. SERIBU SELATAN,PULAU TIDUNG,4553,365,4188,3834,8022,2021-11-15
3101021001,KAB.ADM.KEP.SERIBU,KEP. SERIBU SELATAN,PULAU UNTUNG JAWA,1941,161,1780,1654,3434,2021-11-15
3174071007,JAKARTA SELATAN,KEBAYORAN BARU,PULO,5835,1005,4830,4441,9271,2021-11-15
3175021001,JAKARTA TIMUR,PULO GADUNG,PULO GADUNG,34422,7488,26934,22598,49532,2021-11-15
3175061005,JAKARTA TIMUR,CAKUNG,PULO GEBANG,97301,18572,78729,64304,143033,2021-11-15
3174041004,JAKARTA SELATAN,PASAR MINGGU,RAGUNAN,39616,7221,32395,27735,60130,2021-11-15
3175091005,JAKARTA TIMUR,CIRACAS,RAMBUTAN,36771,8516,28255,23004,51259,2021-11-15
3172031006,JAKARTA UTARA,KOJA,RAWA BADAK SELATAN,42179,9914,32265,25563,57828,2021-11-15
3172031004,JAKARTA UTARA,KOJA,RAWA BADAK UTARA,34408,7642,26766,21613,48379,2021-11-15
3174071005,JAKARTA SELATAN,KEBAYORAN BARU,RAWA BARAT,5625,999,4626,4115,8741,2021-11-15
3173011003,JAKARTA BARAT,CENGKARENG,RAWA BUAYA,63799,12534,51265,41945,93210,2021-11-15
3175031004,JAKARTA TIMUR,JATINEGARA,RAWA BUNGA,21434,5141,16293,13309,29602,2021-11-15
3174081003,JAKARTA SELATAN,PANCORAN,RAWA JATI,20509,3878,16631,14306,30937,2021-11-15
3175061002,JAKARTA TIMUR,CAKUNG,RAWA TERATE,24637,4437,20200,16536,36736,2021-11-15
3175021005,JAKARTA TIMUR,PULO GADUNG,RAWAMANGUN,37612,7343,30269,25787,56056,2021-11-15
3171051003,JAKARTA PUSAT,CEMPAKA PUTIH,RAWASARI,21967,4426,17541,15053,32594,2021-11-15
3173041010,JAKARTA BARAT,TAMBORA,ROA MALAKA,3484,613,2871,2557,5428,2021-11-15
3172041006,JAKARTA UTARA,CILINCING,ROROTAN,41668,8277,33391,26922,60313,2021-11-15
3174071004,JAKARTA SELATAN,KEBAYORAN BARU,SELONG,2842,544,2298,2134,4432,2021-11-15
3173061002,JAKARTA BARAT,KALI DERES,SEMANAN,71354,14937,56417,45776,102193,2021-11-15
3172041007,JAKARTA UTARA,CILINCING,SEMPER BARAT,68587,13209,55378,46230,101608,2021-11-15
3172041005,JAKARTA UTARA,CILINCING,SEMPER TIMUR,36267,7706,28561,23320,51881,2021-11-15
3174071006,JAKARTA SELATAN,KEBAYORAN BARU,SENAYAN,2771,647,2124,1842,3966,2021-11-15
3171041001,JAKARTA PUSAT,SENEN,SENEN,6804,1438,5366,4484,9850,2021-11-15
3171031004,JAKARTA PUSAT,KEMAYORAN,SERDANG,29668,5767,23901,19989,43890,2021-11-15
3174021001,JAKARTA SELATAN,SETIA BUDI,SETIA BUDI,3023,608,2415,2075,4490,2021-11-15
3175101005,JAKARTA TIMUR,CIPAYUNG,SETU,20572,4047,16525,13523,30048,2021-11-15
3173071002,JAKARTA BARAT,PALMERAH,SLIPI,16591,2949,13642,11556,25198,2021-11-15
3173081004,JAKARTA BARAT,KEMBANGAN,SRENGSENG,45523,10144,35379,30090,65469,2021-11-15
3174091002,JAKARTA SELATAN,JAGAKARSA,SRENGSENG SAWAH,58196,8936,49260,42131,91391,2021-11-15
3173051003,JAKARTA BARAT,KEBON JERUK,SUKABUMI SELATAN,37033,8224,28809,22542,51351,2021-11-15
3173051002,JAKARTA BARAT,KEBON JERUK,SUKABUMI UTARA,38290,8879,29411,23241,52652,2021-11-15
3172041002,JAKARTA UTARA,CILINCING,SUKAPURA,53949,12072,41877,34640,76517,2021-11-15
3171031007,JAKARTA PUSAT,KEMAYORAN,SUMUR BATU,22717,4324,18393,15665,34058,2021-11-15
3172021004,JAKARTA UTARA,TANJUNG PRIOK,SUNGAI BAMBU,29876,5952,23924,19943,43867,2021-11-15
3172021006,JAKARTA UTARA,TANJUNG PRIOK,SUNTER AGUNG,71805,12310,59495,52236,111731,2021-11-15
3172021002,JAKARTA UTARA,TANJUNG PRIOK,SUNTER JAYA,63031,10989,52042,45366,97408,2021-11-15
3175091004,JAKARTA TIMUR,CIRACAS,SUSUKAN,38257,7151,31106,26133,57239,2021-11-15
3173031001,JAKARTA BARAT,TAMAN SARI,TAMAN SARI,14348,2602,11746,10120,21866,2021-11-15
3173041001,JAKARTA BARAT,TAMBORA,TAMBORA,10204,2195,8009,6463,14472,2021-11-15
3173041004,JAKARTA BARAT,TAMBORA,TANAH SEREAL,26387,4442,21945,18493,40438,2021-11-15
3171081004,JAKARTA PUSAT,JOHAR BARU,TANAH TINGGI,37693,7136,30557,24898,55455,2021-11-15
3173031004,JAKARTA BARAT,TAMAN SARI,TANGKI,13324,2189,11135,9448,20583,2021-11-15
3174091005,JAKARTA SELATAN,JAGAKARSA,TANJUNG BARAT,39770,6707,33063,27618,60681,2021-11-15
3173021005,JAKARTA BARAT,GROGOL PETAMBURAN,TANJUNG DUREN SELATAN,25337,4798,20539,18244,38783,2021-11-15
3173021002,JAKARTA BARAT,GROGOL PETAMBURAN,TANJUNG DUREN UTARA,17010,2850,14160,12754,26914,2021-11-15
3172021001,JAKARTA UTARA,TANJUNG PRIOK,TANJUNG PRIOK,34588,7090,27498,22545,50043,2021-11-15
3174011002,JAKARTA SELATAN,TEBET,TEBET BARAT,21194,3405,17789,15742,33531,2021-11-15
3174011001,JAKARTA SELATAN,TEBET,TEBET TIMUR,18199,2908,15291,13857,29148,2021-11-15
3173061003,JAKARTA BARAT,KALI DERES,TEGAL ALUR,83647,17174,66473,55183,121656,2021-11-15
3174031004,JAKARTA SELATAN,MAMPANG PRAPATAN,TEGAL PARANG,32401,7090,25311,19906,45217,2021-11-15
3173021003,JAKARTA BARAT,GROGOL PETAMBURAN,TOMANG,29605,5415,24190,20821,45011,2021-11-15
3172031005,JAKARTA UTARA,KOJA,TUGU SELATAN,39122,8659,30463,24692,55155,2021-11-15
3172031002,JAKARTA UTARA,KOJA,TUGU UTARA,67670,15833,51837,41280,93117,2021-11-15
3175061006,JAKARTA TIMUR,CAKUNG,UJUNG MENTENG,29934,5112,24822,21130,45952,2021-11-15
3174101005,JAKARTA SELATAN,PESANGGRAHAN,ULUJAMI,40544,9029,31515,26037,57552,2021-11-15
3175011006,JAKARTA TIMUR,MATRAMAN,UTAN KAYU SELATAN,33511,5981,27530,22860,50390,2021-11-15
3175011002,JAKARTA TIMUR,MATRAMAN,UTAN KAYU UTARA,28169,5815,22354,18413,40767,2021-11-15
3171031008,JAKARTA PUSAT,KEMAYORAN,UTAN PANJANG,29208,5825,23383,19018,42401,2021-11-15
3172021007,JAKARTA UTARA,TANJUNG PRIOK,WARAKAS,44401,8100,36301,29482,65783,2021-11-15
3173021007,JAKARTA BARAT,GROGOL PETAMBURAN,WIJAYA KUSUMA,38934,8056,30878,26062,56940,2021-11-15
3172051003,JAKARTA UTARA,PADEMANGAN,ANCOL,23947,5733,18214,15028,33242,2021-11-16
3173041007,JAKARTA BARAT,TAMBORA,ANGKE,29381,6159,23222,18915,42137,2021-11-16
3175041005,JAKARTA TIMUR,KRAMAT JATI,BALE KAMBANG,29074,7153,21921,17401,39322,2021-11-16
3175031003,JAKARTA TIMUR,JATINEGARA,BALI MESTER,9752,2019,7733,6558,14291,2021-11-16
3175101006,JAKARTA TIMUR,CIPAYUNG,BAMBU APUS,26285,4797,21488,18076,39564,2021-11-16
3174031002,JAKARTA SELATAN,MAMPANG PRAPATAN,BANGKA,21566,4521,17045,14227,31272,2021-11-16
3175051002,JAKARTA TIMUR,PASAR REBO,BARU,23886,3913,19973,17289,37262,2021-11-16
3175041004,JAKARTA TIMUR,KRAMAT JATI,BATU AMPAR,47898,11491,36407,29527,65934,2021-11-16
3171071002,JAKARTA PUSAT,TANAH ABANG,BENDUNGAN HILIR,21494,4300,17194,14765,31959,2021-11-16
3175031002,JAKARTA TIMUR,JATINEGARA,BIDARA CINA,36689,8716,27973,22590,50563,2021-11-16
3174101002,JAKARTA SELATAN,PESANGGRAHAN,BINTARO,53098,10554,42544,36909,79453,2021-11-16
3174011005,JAKARTA SELATAN,TEBET,BUKIT DURI,34183,6785,27398,22936,50334,2021-11-16
3171041006,JAKARTA PUSAT,SENEN,BUNGUR,18144,3733,14411,11970,26381,2021-11-16
3175061007,JAKARTA TIMUR,CAKUNG,CAKUNG BARAT,57724,11714,46010,38114,84124,2021-11-16
3175061004,JAKARTA TIMUR,CAKUNG,CAKUNG TIMUR,58287,11295,46992,39243,86235,2021-11-16
3175041007,JAKARTA TIMUR,KRAMAT JATI,CAWANG,32762,6952,25810,20833,46643,2021-11-16
3175101008,JAKARTA TIMUR,CIPAYUNG,CEGER,18932,3640,15292,12844,28136,2021-11-16
3171031006,JAKARTA PUSAT,KEMAYORAN,CEMPAKA BARU,32581,6116,26465,21037,47502,2021-11-16
3171051002,JAKARTA PUSAT,CEMPAKA PUTIH,CEMPAKA PUTIH BARAT,35885,7569,28316,24328,52644,2021-11-16
3171051001,JAKARTA PUSAT,CEMPAKA PUTIH,CEMPAKA PUTIH TIMUR,24292,4943,19349,17010,36359,2021-11-16
3173011001,JAKARTA BARAT,CENGKARENG,CENGKARENG BARAT,66284,13062,53222,45663,98885,2021-11-16
3173011006,JAKARTA BARAT,CENGKARENG,CENGKARENG TIMUR,81027,15797,65230,54462,119692,2021-11-16
3175091002,JAKARTA TIMUR,CIRACAS,CIBUBUR,66364,11298,55066,46798,101864,2021-11-16
3171011002,JAKARTA PUSAT,GAMBIR,CIDENG,15390,2987,12403,10872,23275,2021-11-16
3174091003,JAKARTA SELATAN,JAGAKARSA,CIGANJUR,38497,6374,32123,26735,58858,2021-11-16
3175051003,JAKARTA TIMUR,PASAR REBO,CIJANTUNG,41419,7590,33829,28377,62206,2021-11-16
3171061003,JAKARTA PUSAT,MENTENG,CIKINI,8274,1476,6798,5430,12228,2021-11-16
3174081006,JAKARTA SELATAN,PANCORAN,CIKOKO,10547,1804,8743,7615,16358,2021-11-16
3174061001,JAKARTA SELATAN,CILANDAK,CILANDAK BARAT,51752,9025,42727,37495,80222,2021-11-16
3174041003,JAKARTA SELATAN,PASAR MINGGU,CILANDAK TIMUR,25145,4567,20578,17646,38224,2021-11-16
3175101002,JAKARTA TIMUR,CIPAYUNG,CILANGKAP,27635,4845,22790,19499,42289,2021-11-16
3175041006,JAKARTA TIMUR,KRAMAT JATI,CILILITAN,40181,8549,31632,25967,57599,2021-11-16
3172041001,JAKARTA UTARA,CILINCING,CILINCING,43609,10343,33266,25984,59250,2021-11-16
3175101001,JAKARTA TIMUR,CIPAYUNG,CIPAYUNG,26104,4509,21595,18587,40182,2021-11-16
3174091006,JAKARTA SELATAN,JAGAKARSA,CIPEDAK,38303,6259,32044,27144,59188,2021-11-16
3174061005,JAKARTA SELATAN,CILANDAK,CIPETE SELATAN,26704,5063,21641,19114,40755,2021-11-16
3174071010,JAKARTA SELATAN,KEBAYORAN BARU,CIPETE UTARA,34102,6420,27682,23282,50964,2021-11-16
3175021003,JAKARTA TIMUR,PULO GADUNG,CIPINANG,39306,7158,32148,26897,59045,2021-11-16
3175031007,JAKARTA TIMUR,JATINEGARA,CIPINANG BESAR SELATAN,35212,8243,26969,21286,48255,2021-11-16
3175031008,JAKARTA TIMUR,JATINEGARA,CIPINANG BESAR UTARA,45319,10534,34785,27331,62116,2021-11-16
3175031005,JAKARTA TIMUR,JATINEGARA,CIPINANG CEMPEDAK,32824,7072,25752,21969,47721,2021-11-16
3175081005,JAKARTA TIMUR,MAKASAR,CIPINANG MELAYU,42308,8093,34215,29188,63403,2021-11-16
3175031006,JAKARTA TIMUR,JATINEGARA,CIPINANG MUARA,55243,11643,43600,35692,79292,2021-11-16
3174051003,JAKARTA SELATAN,KEBAYORAN LAMA,CIPULIR,39937,8363,31574,25764,57338,2021-11-16
3175091001,JAKARTA TIMUR,CIRACAS,CIRACAS,64594,11700,52894,44120,97014,2021-11-16
3175041003,JAKARTA TIMUR,KRAMAT JATI,DUKUH,24609,4537,20072,16716,36788,2021-11-16
3175071001,JAKARTA TIMUR,DUREN SAWIT,DUREN SAWIT,61160,12770,48390,40430,88820,2021-11-16
3174081004,JAKARTA SELATAN,PANCORAN,DUREN TIGA,28319,5588,22731,19145,41876,2021-11-16
3173051005,JAKARTA BARAT,KEBON JERUK,DURI KEPA,60138,11683,48455,41976,90431,2021-11-16
3173011002,JAKARTA BARAT,CENGKARENG,DURI KOSAMBI,77923,16455,61468,49577,111045,2021-11-16
3171011006,JAKARTA PUSAT,GAMBIR,DURI PULO,19610,4096,15514,12534,28048,2021-11-16
3173041011,JAKARTA BARAT,TAMBORA,DURI SELATAN,14259,2508,11751,10009,21760,2021-11-16
3173041003,JAKARTA BARAT,TAMBORA,DURI UTARA,19844,3550,16294,13496,29790,2021-11-16
3171081003,JAKARTA PUSAT,JOHAR BARU,GALUR,18243,3545,14698,11963,26661,2021-11-16
3171011001,JAKARTA PUSAT,GAMBIR,GAMBIR,2191,456,1735,1513,3248,2021-11-16
3174061004,JAKARTA SELATAN,CILANDAK,GANDARIA SELATAN,22119,4199,17920,15375,33295,2021-11-16
3174071009,JAKARTA SELATAN,KEBAYORAN BARU,GANDARIA UTARA,39922,7854,32068,27327,59395,2021-11-16
3175051001,JAKARTA TIMUR,PASAR REBO,GEDONG,35755,7092,28663,24364,53027,2021-11-16
3171071001,JAKARTA PUSAT,TANAH ABANG,GELORA,3127,605,2522,2188,4710,2021-11-16
3173031007,JAKARTA BARAT,TAMAN SARI,GLODOK,7837,1169,6668,6002,12670,2021-11-16
3171061004,JAKARTA PUSAT,MENTENG,GONDANGDIA,4100,911,3189,2914,6103,2021-11-16
3173021001,JAKARTA BARAT,GROGOL PETAMBURAN,GROGOL,16876,3317,13559,11541,25100,2021-11-16
3174051005,JAKARTA SELATAN,KEBAYORAN LAMA,GROGOL SELATAN,44251,8723,35528,29435,64963,2021-11-16
3174051004,JAKARTA SELATAN,KEBAYORAN LAMA,GROGOL UTARA,42494,8585,33909,28224,62133,2021-11-16
3174021007,JAKARTA SELATAN,SETIA BUDI,GUNTUR,3985,740,3245,2868,6113,2021-11-16
3174071002,JAKARTA SELATAN,KEBAYORAN BARU,GUNUNG,9436,1734,7702,6876,14578,2021-11-16
3171031005,JAKARTA PUSAT,KEMAYORAN,GUNUNG SAHARI SELATAN,19199,3803,15396,13028,28424,2021-11-16
3171021004,JAKARTA PUSAT,SAWAH BESAR,GUNUNG SAHARI UTARA,16650,2911,13739,12306,26045,2021-11-16
3175081004,JAKARTA TIMUR,MAKASAR,HALIM PERDANA KUSUMAH,28363,3638,24725,22626,47351,2021-11-16
3171031003,JAKARTA PUSAT,KEMAYORAN,HARAPAN MULIA,22557,4511,18046,14813,32859,2021-11-16
3174091001,JAKARTA SELATAN,JAGAKARSA,JAGAKARSA,62389,10129,52260,44000,96260,2021-11-16
3175021007,JAKARTA TIMUR,PULO GADUNG,JATI,32757,6058,26699,23273,49972,2021-11-16
3174041002,JAKARTA SELATAN,PASAR MINGGU,JATI PADANG,37502,7274,30228,25630,55858,2021-11-16
3173071004,JAKARTA BARAT,PALMERAH,JATI PULO,28738,5659,23079,18556,41635,2021-11-16
3175061001,JAKARTA TIMUR,CAKUNG,JATINEGARA,84160,17721,66439,55112,121551,2021-11-16
3175021004,JAKARTA TIMUR,PULO GADUNG,JATINEGARA KAUM,24632,4350,20282,16626,36908,2021-11-16
3173021004,JAKARTA BARAT,GROGOL PETAMBURAN,JELAMBAR,30266,5465,24801,21812,46613,2021-11-16
3173021006,JAKARTA BARAT,GROGOL PETAMBURAN,JELAMBAR BARU,38246,6971,31275,27336,58611,2021-11-16
3173041006,JAKARTA BARAT,TAMBORA,JEMBATAN BESI,29314,7031,22283,17494,39777,2021-11-16
3173041008,JAKARTA BARAT,TAMBORA,JEMBATAN LIMA,21021,4800,16221,12933,29154,2021-11-16
3173081005,JAKARTA BARAT,KEMBANGAN,JOGLO,40839,8093,32746,27859,60605,2021-11-16
3171081001,JAKARTA PUSAT,JOHAR BARU,JOHAR BARU,37488,6886,30602,25972,56574,2021-11-16
3173041002,JAKARTA BARAT,TAMBORA,KALI ANYAR,23856,4662,19194,15430,34624,2021-11-16
3172041004,JAKARTA UTARA,CILINCING,KALIBARU,67684,18348,49336,35251,84587,2021-11-16
3174081002,JAKARTA SELATAN,PANCORAN,KALIBATA,41994,9434,32560,26684,59244,2021-11-16
3173061001,JAKARTA BARAT,KALI DERES,KALIDERES,72447,14376,58071,49396,107467,2021-11-16
3175051004,JAKARTA TIMUR,PASAR REBO,KALISARI,43212,7637,35575,30185,65760,2021-11-16
3173061004,JAKARTA BARAT,KALI DERES,KAMAL,53783,12386,41397,33387,74784,2021-11-16
3172011002,JAKARTA UTARA,PENJARINGAN,KAMAL MUARA,12930,2281,10649,9101,19750,2021-11-16
3171071007,JAKARTA PUSAT,TANAH ABANG,KAMPUNG BALI,11358,2434,8924,6934,15858,2021-11-16
3175031001,JAKARTA TIMUR,JATINEGARA,KAMPUNG MELAYU,25717,5825,19892,15613,35505,2021-11-16
3171081002,JAKARTA PUSAT,JOHAR BARU,KAMPUNG RAWA,21237,3487,17750,14299,32049,2021-11-16
3175041002,JAKARTA TIMUR,KRAMAT JATI,KAMPUNG TENGAH,43993,10913,33080,26681,59761,2021-11-16
3173011005,JAKARTA BARAT,CENGKARENG,KAPUK,134466,31987,102479,83398,185877,2021-11-16
3172011003,JAKARTA UTARA,PENJARINGAN,KAPUK MUARA,35781,6784,28997,25505,54502,2021-11-16
3171021002,JAKARTA PUSAT,SAWAH BESAR,KARANG ANYAR,25761,4864,20897,17695,38592,2021-11-16
3174021004,JAKARTA SELATAN,SETIA BUDI,KARET,9623,1838,7785,6534,14319,2021-11-16
3174021003,JAKARTA SELATAN,SETIA BUDI,KARET KUNINGAN,16055,3093,12962,11054,24016,2021-11-16
3174021002,JAKARTA SELATAN,SETIA BUDI,KARET SEMANGGI,2770,552,2218,1969,4187,2021-11-16
3171071003,JAKARTA PUSAT,TANAH ABANG,KARET TENGSIN,19271,3679,15592,12806,28398,2021-11-16
3171021003,JAKARTA PUSAT,SAWAH BESAR,KARTINI,22292,4147,18145,15659,33804,2021-11-16
3175011003,JAKARTA TIMUR,MATRAMAN,KAYU MANIS,25284,5277,20007,16050,36057,2021-11-16
3175021006,JAKARTA TIMUR,PULO GADUNG,KAYU PUTIH,40696,7596,33100,29081,62181,2021-11-16
3173031006,JAKARTA BARAT,TAMAN SARI,KEAGUNGAN,17387,3206,14181,11664,25845,2021-11-16
3174041007,JAKARTA SELATAN,PASAR MINGGU,KEBAGUSAN,44552,8739,35813,29760,65573,2021-11-16
3174051006,JAKARTA SELATAN,KEBAYORAN LAMA,KEBAYORAN LAMA SELATAN,41212,7590,33622,28807,62429,2021-11-16
3174051001,JAKARTA SELATAN,KEBAYORAN LAMA,KEBAYORAN LAMA UTARA,42422,8711,33711,27992,61703,2021-11-16
3174011004,JAKARTA SELATAN,TEBET,KEBON BARU,35165,6533,28632,24274,52906,2021-11-16
3172021005,JAKARTA UTARA,TANJUNG PRIOK,KEBON BAWANG,50952,10185,40767,34157,74924,2021-11-16
3173051001,JAKARTA BARAT,KEBON JERUK,KEBON JERUK,53887,11014,42873,35088,77961,2021-11-16
3171071006,JAKARTA PUSAT,TANAH ABANG,KEBON KACANG,21531,5075,16456,13080,29536,2021-11-16
3171011005,JAKARTA PUSAT,GAMBIR,KEBON KELAPA,10163,2025,8138,6892,15030,2021-11-16
3171031002,JAKARTA PUSAT,KEMAYORAN,KEBON KOSONG,30019,5963,24056,19805,43861,2021-11-16
3175011005,JAKARTA TIMUR,MATRAMAN,KEBON MANGGIS,16490,3182,13308,11085,24393,2021-11-16
3171071005,JAKARTA PUSAT,TANAH ABANG,KEBON MELATI,32206,8553,23653,17748,41401,2021-11-16
3175081003,JAKARTA TIMUR,MAKASAR,KEBON PALA,46614,9063,37551,31436,68987,2021-11-16
3171061005,JAKARTA PUSAT,MENTENG,KEBON SIRIH,12299,2613,9686,7825,17511,2021-11-16
3173011004,JAKARTA BARAT,CENGKARENG,KEDAUNG KALI ANGKE,32612,6247,26365,22264,48629,2021-11-16
3173051007,JAKARTA BARAT,KEBON JERUK,KEDOYA SELATAN,32165,5830,26335,21884,48219,2021-11-16
3173051006,JAKARTA BARAT,KEBON JERUK,KEDOYA UTARA,45740,8645,37095,31492,68587,2021-11-16
3173051004,JAKARTA BARAT,KEBON JERUK,KELAPA DUA,23565,4552,19013,15906,34919,2021-11-16
3175091003,JAKARTA TIMUR,CIRACAS,KELAPA DUA WETAN,46875,7904,38971,33157,72128,2021-11-16
3172061003,JAKARTA UTARA,KELAPA GADING,KELAPA GADING BARAT,35717,6168,29549,26764,56313,2021-11-16
3172061001,JAKARTA UTARA,KELAPA GADING,KELAPA GADING TIMUR,33592,5090,28502,26483,54985,2021-11-16
3173071005,JAKARTA BARAT,PALMERAH,KEMANGGISAN,32139,6014,26125,22191,48316,2021-11-16
3171031001,JAKARTA PUSAT,KEMAYORAN,KEMAYORAN,20708,4106,16602,13742,30344,2021-11-16
3173081006,JAKARTA BARAT,KEMBANGAN,KEMBANGAN SELATAN,27130,5633,21497,18645,40142,2021-11-16
3173081001,JAKARTA BARAT,KEMBANGAN,KEMBANGAN UTARA,54451,11803,42648,35667,78315,2021-11-16
3171041002,JAKARTA PUSAT,SENEN,KENARI,9579,1850,7729,6614,14343,2021-11-16
3173041005,JAKARTA BARAT,TAMBORA,KERENDANG,19973,4017,15956,13018,28974,2021-11-16
3175071003,JAKARTA TIMUR,DUREN SAWIT,KLENDER,69978,16263,53715,43113,96828,2021-11-16
3172031001,JAKARTA UTARA,KOJA,KOJA,28175,6362,21813,17782,39595,2021-11-16
3173071006,JAKARTA BARAT,PALMERAH,KOTA BAMBU SELATAN,21158,4125,17033,13456,30489,2021-11-16
3173071003,JAKARTA BARAT,PALMERAH,KOTA BAMBU UTARA,24995,5119,19876,15535,35411,2021-11-16
3171041004,JAKARTA PUSAT,SENEN,KRAMAT,28835,6864,21971,16843,38814,2021-11-16
3175041001,JAKARTA TIMUR,KRAMAT JATI,KRAMAT JATI,34144,7161,26983,22094,49077,2021-11-16
3174071003,JAKARTA SELATAN,KEBAYORAN BARU,KRAMAT PELA,14413,2757,11656,10096,21752,2021-11-16
3173031002,JAKARTA BARAT,TAMAN SARI,KRUKUT,19244,3598,15646,12781,28427,2021-11-16
3174031005,JAKARTA SELATAN,MAMPANG PRAPATAN,KUNINGAN BARAT,12785,2307,10478,8749,19227,2021-11-16
3174021008,JAKARTA SELATAN,SETIA BUDI,KUNINGAN TIMUR,6008,1179,4829,4141,8970,2021-11-16
3171041005,JAKARTA PUSAT,SENEN,KWITANG,15486,3414,12072,9769,21841,2021-11-16
3172031003,JAKARTA UTARA,KOJA,LAGOA,59065,13834,45231,36000,81231,2021-11-16
3174061002,JAKARTA SELATAN,CILANDAK,LEBAK BULUS,37626,7015,30611,27042,57653,2021-11-16
3174091004,JAKARTA SELATAN,JAGAKARSA,LENTENG AGUNG,53946,9549,44397,36573,80970,2021-11-16
3175101007,JAKARTA TIMUR,CIPAYUNG,LUBANG BUAYA,63547,11855,51692,43145,94837,2021-11-16
3175081001,JAKARTA TIMUR,MAKASAR,MAKASAR,34390,6215,28175,24218,52393,2021-11-16
3175071006,JAKARTA TIMUR,DUREN SAWIT,MALAKA JAYA,30927,5225,25702,22233,47935,2021-11-16
3175071005,JAKARTA TIMUR,DUREN SAWIT,MALAKA SARI,27530,4507,23023,19991,43014,2021-11-16
3174031001,JAKARTA SELATAN,MAMPANG PRAPATAN,MAMPANG PRAPATAN,18159,3684,14475,12053,26528,2021-11-16
3173031005,JAKARTA BARAT,TAMAN SARI,MANGGA BESAR,7707,1281,6426,5694,12120,2021-11-16
3171021005,JAKARTA PUSAT,SAWAH BESAR,MANGGA DUA SELATAN,27442,5630,21812,18639,40451,2021-11-16
3174011007,JAKARTA SELATAN,TEBET,MANGGARAI,28373,4944,23429,19180,42609,2021-11-16
3174011006,JAKARTA SELATAN,TEBET,MANGGARAI SELATAN,23075,3903,19172,16233,35405,2021-11-16
3173031003,JAKARTA BARAT,TAMAN SARI,MAPHAR,16461,3029,13432,11293,24725,2021-11-16
3172041003,JAKARTA UTARA,CILINCING,MARUNDA,28943,6472,22471,16971,39442,2021-11-16
3174071001,JAKARTA SELATAN,KEBAYORAN BARU,MELAWAI,2627,505,2122,1955,4077,2021-11-16
3171061001,JAKARTA PUSAT,MENTENG,MENTENG,25624,5566,20058,16024,36082,2021-11-16
3174021005,JAKARTA SELATAN,SETIA BUDI,MENTENG ATAS,27816,4933,22883,19273,42156,2021-11-16
3174011003,JAKARTA SELATAN,TEBET,MENTENG DALAM,36028,6920,29108,24793,53901,2021-11-16
3173081003,JAKARTA BARAT,KEMBANGAN,MERUYA SELATAN,32130,6519,25611,21749,47360,2021-11-16
3173081002,JAKARTA BARAT,KEMBANGAN,MERUYA UTARA,43752,8918,34834,30432,65266,2021-11-16
3175101004,JAKARTA TIMUR,CIPAYUNG,MUNJUL,23871,4307,19564,16678,36242,2021-11-16
3172051002,JAKARTA UTARA,PADEMANGAN,PADEMANGAN BARAT,74240,17258,56982,46345,103327,2021-11-16
3172051001,JAKARTA UTARA,PADEMANGAN,PADEMANGAN TIMUR,37736,6617,31119,27532,58651,2021-11-16
3175011004,JAKARTA TIMUR,MATRAMAN,PAL MERIAM,19769,4024,15745,12781,28526,2021-11-16
3173071001,JAKARTA BARAT,PALMERAH,PALMERAH,63011,13122,49889,41006,90895,2021-11-16
3174081001,JAKARTA SELATAN,PANCORAN,PANCORAN,19421,3901,15520,12931,28451,2021-11-16
3172021003,JAKARTA UTARA,TANJUNG PRIOK,PAPANGGO,39097,7594,31503,26046,57549,2021-11-16
3171021001,JAKARTA PUSAT,SAWAH BESAR,PASAR BARU,12035,2287,9748,8772,18520,2021-11-16
3174021006,JAKARTA SELATAN,SETIA BUDI,PASAR MANGGIS,26752,5173,21579,17976,39555,2021-11-16
3174041001,JAKARTA SELATAN,PASAR MINGGU,PASAR MINGGU,24821,4628,20193,17417,37610,2021-11-16
3171041003,JAKARTA PUSAT,SENEN,PASEBAN,23533,4827,18706,15441,34147,2021-11-16
3173061005,JAKARTA BARAT,KALI DERES,PEGADUNGAN,75587,14629,60958,52582,113540,2021-11-16
3171061002,JAKARTA PUSAT,MENTENG,PEGANGSAAN,23455,4990,18465,14348,32813,2021-11-16
3172061002,JAKARTA UTARA,KELAPA GADING,PEGANGSAAN DUA,49976,8184,41792,37973,79765,2021-11-16
3172011004,JAKARTA UTARA,PENJARINGAN,PEJAGALAN,74578,15279,59299,51437,110736,2021-11-16
3174041006,JAKARTA SELATAN,PASAR MINGGU,PEJATEN BARAT,37346,7166,30180,25510,55690,2021-11-16
3174041005,JAKARTA SELATAN,PASAR MINGGU,PEJATEN TIMUR,57656,12589,45067,37269,82336,2021-11-16
3175051005,JAKARTA TIMUR,PASAR REBO,PEKAYON,43250,7758,35492,29774,65266,2021-11-16
3173041009,JAKARTA BARAT,TAMBORA,PEKOJAN,23587,4438,19149,16238,35387,2021-11-16
3174031003,JAKARTA SELATAN,MAMPANG PRAPATAN,PELA MAMPANG,43522,8426,35096,29611,64707,2021-11-16
3174081005,JAKARTA SELATAN,PANCORAN,PENGADEGAN,21478,3910,17568,15112,32680,2021-11-16
3175061003,JAKARTA TIMUR,CAKUNG,PENGGILINGAN,99255,22588,76667,61695,138362,2021-11-16
3172011001,JAKARTA UTARA,PENJARINGAN,PENJARINGAN,88308,22398,65910,51259,117169,2021-11-16
3174101001,JAKARTA SELATAN,PESANGGRAHAN,PESANGGRAHAN,27545,4674,22871,19769,42640,2021-11-16
3171071004,JAKARTA PUSAT,TANAH ABANG,PETAMBURAN,33271,8675,24596,18818,43414,2021-11-16
3174071008,JAKARTA SELATAN,KEBAYORAN BARU,PETOGOGAN,11499,2202,9297,8007,17304,2021-11-16
3171011004,JAKARTA PUSAT,GAMBIR,PETOJO SELATAN,14692,3266,11426,9743,21169,2021-11-16
3171011003,JAKARTA PUSAT,GAMBIR,PETOJO UTARA,17458,3731,13727,11404,25131,2021-11-16
3174101004,JAKARTA SELATAN,PESANGGRAHAN,PETUKANGAN SELATAN,37187,7579,29608,25145,54753,2021-11-16
3174101003,JAKARTA SELATAN,PESANGGRAHAN,PETUKANGAN UTARA,53716,11403,42313,35424,77737,2021-11-16
3175081002,JAKARTA TIMUR,MAKASAR,PINANG RANTI,27198,5831,21367,17726,39093,2021-11-16
3173031008,JAKARTA BARAT,TAMAN SARI,PINANGSIA,10729,1860,8869,7410,16279,2021-11-16
3175011001,JAKARTA TIMUR,MATRAMAN,PISANGAN BARU,31776,6464,25312,20330,45642,2021-11-16
3175021002,JAKARTA TIMUR,PULO GADUNG,PISANGAN TIMUR,41011,7477,33534,28565,62099,2021-11-16
3172011005,JAKARTA UTARA,PENJARINGAN,PLUIT,47783,9123,38660,34146,72806,2021-11-16
3175071002,JAKARTA TIMUR,DUREN SAWIT,PONDOK BAMBU,61550,12836,48714,40745,89459,2021-11-16
3175071004,JAKARTA TIMUR,DUREN SAWIT,PONDOK KELAPA,72015,14108,57907,50002,107909,2021-11-16
3175071007,JAKARTA TIMUR,DUREN SAWIT,PONDOK KOPI,35367,6565,28802,23092,51894,2021-11-16
3174061003,JAKARTA SELATAN,CILANDAK,PONDOK LABU,46464,7697,38767,33992,72759,2021-11-16
3174051002,JAKARTA SELATAN,KEBAYORAN LAMA,PONDOK PINANG,56169,10638,45531,39309,84840,2021-11-16
3175101003,JAKARTA TIMUR,CIPAYUNG,PONDOK RANGGON,25574,4733,20841,17683,38524,2021-11-16
3101011003,KAB.ADM.KEP.SERIBU,KEP. SERIBU UTARA,PULAU HARAPAN,2060,220,1840,1609,3449,2021-11-16
3101011002,KAB.ADM.KEP.SERIBU,KEP. SERIBU UTARA,PULAU KELAPA,5528,595,4933,4077,9010,2021-11-16
3101011001,KAB.ADM.KEP.SERIBU,KEP. SERIBU UTARA,PULAU PANGGANG,5450,436,5014,4500,9514,2021-11-16
3101021003,KAB.ADM.KEP.SERIBU,KEP. SERIBU SELATAN,PULAU PARI,2765,192,2573,2432,5005,2021-11-16
3101021002,KAB.ADM.KEP.SERIBU,KEP. SERIBU SELATAN,PULAU TIDUNG,4553,365,4188,3845,8033,2021-11-16
3101021001,KAB.ADM.KEP.SERIBU,KEP. SERIBU SELATAN,PULAU UNTUNG JAWA,1941,159,1782,1662,3444,2021-11-16
3174071007,JAKARTA SELATAN,KEBAYORAN BARU,PULO,5835,1004,4831,4450,9281,2021-11-16
3175021001,JAKARTA TIMUR,PULO GADUNG,PULO GADUNG,34422,7463,26959,22689,49648,2021-11-16
3175061005,JAKARTA TIMUR,CAKUNG,PULO GEBANG,97301,18520,78781,64491,143272,2021-11-16
3174041004,JAKARTA SELATAN,PASAR MINGGU,RAGUNAN,39616,7182,32434,27873,60307,2021-11-16
3175091005,JAKARTA TIMUR,CIRACAS,RAMBUTAN,36771,8503,28268,23087,51355,2021-11-16
3172031006,JAKARTA UTARA,KOJA,RAWA BADAK SELATAN,42179,9879,32300,25665,57965,2021-11-16
3172031004,JAKARTA UTARA,KOJA,RAWA BADAK UTARA,34408,7612,26796,21758,48554,2021-11-16
3174071005,JAKARTA SELATAN,KEBAYORAN BARU,RAWA BARAT,5625,994,4631,4122,8753,2021-11-16
3173011003,JAKARTA BARAT,CENGKARENG,RAWA BUAYA,63799,12486,51313,42200,93513,2021-11-16
3175031004,JAKARTA TIMUR,JATINEGARA,RAWA BUNGA,21434,5113,16321,13357,29678,2021-11-16
3174081003,JAKARTA SELATAN,PANCORAN,RAWA JATI,20509,3870,16639,14364,31003,2021-11-16
3175061002,JAKARTA TIMUR,CAKUNG,RAWA TERATE,24637,4416,20221,16614,36835,2021-11-16
3175021005,JAKARTA TIMUR,PULO GADUNG,RAWAMANGUN,37612,7333,30279,25871,56150,2021-11-16
3171051003,JAKARTA PUSAT,CEMPAKA PUTIH,RAWASARI,21967,4412,17555,15122,32677,2021-11-16
3173041010,JAKARTA BARAT,TAMBORA,ROA MALAKA,3484,611,2873,2582,5455,2021-11-16
3172041006,JAKARTA UTARA,CILINCING,ROROTAN,41668,8250,33418,27012,60430,2021-11-16
3174071004,JAKARTA SELATAN,KEBAYORAN BARU,SELONG,2842,543,2299,2135,4434,2021-11-16
3173061002,JAKARTA BARAT,KALI DERES,SEMANAN,71354,14871,56483,45893,102376,2021-11-16
3172041007,JAKARTA UTARA,CILINCING,SEMPER BARAT,68587,13178,55409,46376,101785,2021-11-16
3172041005,JAKARTA UTARA,CILINCING,SEMPER TIMUR,36267,7671,28596,23425,52021,2021-11-16
3174071006,JAKARTA SELATAN,KEBAYORAN BARU,SENAYAN,2771,647,2124,1845,3969,2021-11-16
3171041001,JAKARTA PUSAT,SENEN,SENEN,6804,1436,5368,4493,9861,2021-11-16
3171031004,JAKARTA PUSAT,KEMAYORAN,SERDANG,29668,5743,23925,20058,43983,2021-11-16
3174021001,JAKARTA SELATAN,SETIA BUDI,SETIA BUDI,3023,600,2423,2083,4506,2021-11-16
3175101005,JAKARTA TIMUR,CIPAYUNG,SETU,20572,4043,16529,13596,30125,2021-11-16
3173071002,JAKARTA BARAT,PALMERAH,SLIPI,16591,2935,13656,11610,25266,2021-11-16
3173081004,JAKARTA BARAT,KEMBANGAN,SRENGSENG,45523,10113,35410,30189,65599,2021-11-16
3174091002,JAKARTA SELATAN,JAGAKARSA,SRENGSENG SAWAH,58196,8899,49297,42245,91542,2021-11-16
3173051003,JAKARTA BARAT,KEBON JERUK,SUKABUMI SELATAN,37033,8211,28822,22619,51441,2021-11-16
3173051002,JAKARTA BARAT,KEBON JERUK,SUKABUMI UTARA,38290,8861,29429,23326,52755,2021-11-16
3172041002,JAKARTA UTARA,CILINCING,SUKAPURA,53949,12027,41922,34763,76685,2021-11-16
3171031007,JAKARTA PUSAT,KEMAYORAN,SUMUR BATU,22717,4304,18413,15715,34128,2021-11-16
3172021004,JAKARTA UTARA,TANJUNG PRIOK,SUNGAI BAMBU,29876,5931,23945,20001,43946,2021-11-16
3172021006,JAKARTA UTARA,TANJUNG PRIOK,SUNTER AGUNG,71805,12286,59519,52387,111906,2021-11-16
3172021002,JAKARTA UTARA,TANJUNG PRIOK,SUNTER JAYA,63031,10962,52069,45531,97600,2021-11-16
3175091004,JAKARTA TIMUR,CIRACAS,SUSUKAN,38257,7133,31124,26217,57341,2021-11-16
3173031001,JAKARTA BARAT,TAMAN SARI,TAMAN SARI,14348,2591,11757,10149,21906,2021-11-16
3173041001,JAKARTA BARAT,TAMBORA,TAMBORA,10204,2187,8017,6487,14504,2021-11-16
3173041004,JAKARTA BARAT,TAMBORA,TANAH SEREAL,26387,4429,21958,18546,40504,2021-11-16
3171081004,JAKARTA PUSAT,JOHAR BARU,TANAH TINGGI,37693,7117,30576,24965,55541,2021-11-16
3173031004,JAKARTA BARAT,TAMAN SARI,TANGKI,13324,2182,11142,9480,20622,2021-11-16
3174091005,JAKARTA SELATAN,JAGAKARSA,TANJUNG BARAT,39770,6686,33084,27675,60759,2021-11-16
3173021005,JAKARTA BARAT,GROGOL PETAMBURAN,TANJUNG DUREN SELATAN,25337,4781,20556,18300,38856,2021-11-16
3173021002,JAKARTA BARAT,GROGOL PETAMBURAN,TANJUNG DUREN UTARA,17010,2843,14167,12797,26964,2021-11-16
3172021001,JAKARTA UTARA,TANJUNG PRIOK,TANJUNG PRIOK,34588,7077,27511,22619,50130,2021-11-16
3174011002,JAKARTA SELATAN,TEBET,TEBET BARAT,21194,3392,17802,15771,33573,2021-11-16
3174011001,JAKARTA SELATAN,TEBET,TEBET TIMUR,18199,2898,15301,13891,29192,2021-11-16
3173061003,JAKARTA BARAT,KALI DERES,TEGAL ALUR,83647,17132,66515,55339,121854,2021-11-16
3174031004,JAKARTA SELATAN,MAMPANG PRAPATAN,TEGAL PARANG,32401,7064,25337,19984,45321,2021-11-16
3173021003,JAKARTA BARAT,GROGOL PETAMBURAN,TOMANG,29605,5399,24206,20919,45125,2021-11-16
3172031005,JAKARTA UTARA,KOJA,TUGU SELATAN,39122,8635,30487,24814,55301,2021-11-16
3172031002,JAKARTA UTARA,KOJA,TUGU UTARA,67670,15801,51869,41389,93258,2021-11-16
3175061006,JAKARTA TIMUR,CAKUNG,UJUNG MENTENG,29934,5093,24841,21199,46040,2021-11-16
3174101005,JAKARTA SELATAN,PESANGGRAHAN,ULUJAMI,40544,9007,31537,26149,57686,2021-11-16
3175011006,JAKARTA TIMUR,MATRAMAN,UTAN KAYU SELATAN,33511,5959,27552,22964,50516,2021-11-16
3175011002,JAKARTA TIMUR,MATRAMAN,UTAN KAYU UTARA,28169,5792,22377,18469,40846,2021-11-16
3171031008,JAKARTA PUSAT,KEMAYORAN,UTAN PANJANG,29208,5769,23439,19110,42549,2021-11-16
3172021007,JAKARTA UTARA,TANJUNG PRIOK,WARAKAS,44401,8076,36325,29551,65876,2021-11-16
3173021007,JAKARTA BARAT,GROGOL PETAMBURAN,WIJAYA KUSUMA,38934,8024,30910,26215,57125,2021-11-16
3172051003,JAKARTA UTARA,PADEMANGAN,ANCOL,23947,5718,18229,15086,33315,2021-11-17
3173041007,JAKARTA BARAT,TAMBORA,ANGKE,29381,6141,23240,18966,42206,2021-11-17
3175041005,JAKARTA TIMUR,KRAMAT JATI,BALE KAMBANG,29074,7122,21952,17476,39428,2021-11-17
3175031003,JAKARTA TIMUR,JATINEGARA,BALI MESTER,9752,2012,7740,6573,14313,2021-11-17
3175101006,JAKARTA TIMUR,CIPAYUNG,BAMBU APUS,26285,4779,21506,18150,39656,2021-11-17
3174031002,JAKARTA SELATAN,MAMPANG PRAPATAN,BANGKA,21566,4499,17067,14282,31349,2021-11-17
3175051002,JAKARTA TIMUR,PASAR REBO,BARU,23886,3899,19987,17341,37328,2021-11-17
3175041004,JAKARTA TIMUR,KRAMAT JATI,BATU AMPAR,47898,11425,36473,29674,66147,2021-11-17
3171071002,JAKARTA PUSAT,TANAH ABANG,BENDUNGAN HILIR,21494,4290,17204,14801,32005,2021-11-17
3175031002,JAKARTA TIMUR,JATINEGARA,BIDARA CINA,36689,8680,28009,22710,50719,2021-11-17
3174101002,JAKARTA SELATAN,PESANGGRAHAN,BINTARO,53098,10528,42570,37009,79579,2021-11-17
3174011005,JAKARTA SELATAN,TEBET,BUKIT DURI,34183,6761,27422,23019,50441,2021-11-17
3171041006,JAKARTA PUSAT,SENEN,BUNGUR,18144,3716,14428,12006,26434,2021-11-17
3175061007,JAKARTA TIMUR,CAKUNG,CAKUNG BARAT,57724,11668,46056,38218,84274,2021-11-17
3175061004,JAKARTA TIMUR,CAKUNG,CAKUNG TIMUR,58287,11265,47022,39378,86400,2021-11-17
3175041007,JAKARTA TIMUR,KRAMAT JATI,CAWANG,32762,6926,25836,20918,46754,2021-11-17
3175101008,JAKARTA TIMUR,CIPAYUNG,CEGER,18932,3628,15304,12879,28183,2021-11-17
3171031006,JAKARTA PUSAT,KEMAYORAN,CEMPAKA BARU,32581,6092,26489,21154,47643,2021-11-17
3171051002,JAKARTA PUSAT,CEMPAKA PUTIH,CEMPAKA PUTIH BARAT,35885,7546,28339,24386,52725,2021-11-17
3171051001,JAKARTA PUSAT,CEMPAKA PUTIH,CEMPAKA PUTIH TIMUR,24292,4933,19359,17060,36419,2021-11-17
3173011001,JAKARTA BARAT,CENGKARENG,CENGKARENG BARAT,66284,13007,53277,45898,99175,2021-11-17
3173011006,JAKARTA BARAT,CENGKARENG,CENGKARENG TIMUR,81027,15749,65278,54629,119907,2021-11-17
3175091002,JAKARTA TIMUR,CIRACAS,CIBUBUR,66364,11252,55112,47018,102130,2021-11-17
3171011002,JAKARTA PUSAT,GAMBIR,CIDENG,15390,2979,12411,10905,23316,2021-11-17
3174091003,JAKARTA SELATAN,JAGAKARSA,CIGANJUR,38497,6358,32139,26857,58996,2021-11-17
3175051003,JAKARTA TIMUR,PASAR REBO,CIJANTUNG,41419,7569,33850,28500,62350,2021-11-17
3171061003,JAKARTA PUSAT,MENTENG,CIKINI,8274,1473,6801,5445,12246,2021-11-17
3174081006,JAKARTA SELATAN,PANCORAN,CIKOKO,10547,1797,8750,7629,16379,2021-11-17
3174061001,JAKARTA SELATAN,CILANDAK,CILANDAK BARAT,51752,8983,42769,37635,80404,2021-11-17
3174041003,JAKARTA SELATAN,PASAR MINGGU,CILANDAK TIMUR,25145,4538,20607,17699,38306,2021-11-17
3175101002,JAKARTA TIMUR,CIPAYUNG,CILANGKAP,27635,4834,22801,19555,42356,2021-11-17
3175041006,JAKARTA TIMUR,KRAMAT JATI,CILILITAN,40181,8458,31723,26068,57791,2021-11-17
3172041001,JAKARTA UTARA,CILINCING,CILINCING,43609,10306,33303,26095,59398,2021-11-17
3175101001,JAKARTA TIMUR,CIPAYUNG,CIPAYUNG,26104,4487,21617,18642,40259,2021-11-17
3174091006,JAKARTA SELATAN,JAGAKARSA,CIPEDAK,38303,6236,32067,27225,59292,2021-11-17
3174061005,JAKARTA SELATAN,CILANDAK,CIPETE SELATAN,26704,5044,21660,19172,40832,2021-11-17
3174071010,JAKARTA SELATAN,KEBAYORAN BARU,CIPETE UTARA,34102,6401,27701,23382,51083,2021-11-17
3175021003,JAKARTA TIMUR,PULO GADUNG,CIPINANG,39306,7120,32186,26995,59181,2021-11-17
3175031007,JAKARTA TIMUR,JATINEGARA,CIPINANG BESAR SELATAN,35212,8224,26988,21386,48374,2021-11-17
3175031008,JAKARTA TIMUR,JATINEGARA,CIPINANG BESAR UTARA,45319,10511,34808,27415,62223,2021-11-17
3175031005,JAKARTA TIMUR,JATINEGARA,CIPINANG CEMPEDAK,32824,7047,25777,22086,47863,2021-11-17
3175081005,JAKARTA TIMUR,MAKASAR,CIPINANG MELAYU,42308,8074,34234,29266,63500,2021-11-17
3175031006,JAKARTA TIMUR,JATINEGARA,CIPINANG MUARA,55243,11564,43679,35815,79494,2021-11-17
3174051003,JAKARTA SELATAN,KEBAYORAN LAMA,CIPULIR,39937,8334,31603,25845,57448,2021-11-17
3175091001,JAKARTA TIMUR,CIRACAS,CIRACAS,64594,11662,52932,44285,97217,2021-11-17
3175041003,JAKARTA TIMUR,KRAMAT JATI,DUKUH,24609,4526,20083,16749,36832,2021-11-17
3175071001,JAKARTA TIMUR,DUREN SAWIT,DUREN SAWIT,61160,12733,48427,40609,89036,2021-11-17
3174081004,JAKARTA SELATAN,PANCORAN,DUREN TIGA,28319,5571,22748,19191,41939,2021-11-17
3173051005,JAKARTA BARAT,KEBON JERUK,DURI KEPA,60138,11657,48481,42049,90530,2021-11-17
3173011002,JAKARTA BARAT,CENGKARENG,DURI KOSAMBI,77923,16389,61534,49812,111346,2021-11-17
3171011006,JAKARTA PUSAT,GAMBIR,DURI PULO,19610,4091,15519,12570,28089,2021-11-17
3173041011,JAKARTA BARAT,TAMBORA,DURI SELATAN,14259,2504,11755,10033,21788,2021-11-17
3173041003,JAKARTA BARAT,TAMBORA,DURI UTARA,19844,3533,16311,13520,29831,2021-11-17
3171081003,JAKARTA PUSAT,JOHAR BARU,GALUR,18243,3543,14700,11977,26677,2021-11-17
3171011001,JAKARTA PUSAT,GAMBIR,GAMBIR,2191,454,1737,1515,3252,2021-11-17
3174061004,JAKARTA SELATAN,CILANDAK,GANDARIA SELATAN,22119,4179,17940,15409,33349,2021-11-17
3174071009,JAKARTA SELATAN,KEBAYORAN BARU,GANDARIA UTARA,39922,7812,32110,27441,59551,2021-11-17
3175051001,JAKARTA TIMUR,PASAR REBO,GEDONG,35755,7069,28686,24416,53102,2021-11-17
3171071001,JAKARTA PUSAT,TANAH ABANG,GELORA,3127,604,2523,2194,4717,2021-11-17
3173031007,JAKARTA BARAT,TAMAN SARI,GLODOK,7837,1167,6670,6009,12679,2021-11-17
3171061004,JAKARTA PUSAT,MENTENG,GONDANGDIA,4100,908,3192,2918,6110,2021-11-17
3173021001,JAKARTA BARAT,GROGOL PETAMBURAN,GROGOL,16876,3309,13567,11569,25136,2021-11-17
3174051005,JAKARTA SELATAN,KEBAYORAN LAMA,GROGOL SELATAN,44251,8711,35540,29601,65141,2021-11-17
3174051004,JAKARTA SELATAN,KEBAYORAN LAMA,GROGOL UTARA,42494,8562,33932,28332,62264,2021-11-17
3174021007,JAKARTA SELATAN,SETIA BUDI,GUNTUR,3985,736,3249,2880,6129,2021-11-17
3174071002,JAKARTA SELATAN,KEBAYORAN BARU,GUNUNG,9436,1732,7704,6886,14590,2021-11-17
3171031005,JAKARTA PUSAT,KEMAYORAN,GUNUNG SAHARI SELATAN,19199,3777,15422,13072,28494,2021-11-17
3171021004,JAKARTA PUSAT,SAWAH BESAR,GUNUNG SAHARI UTARA,16650,2901,13749,12326,26075,2021-11-17
3175081004,JAKARTA TIMUR,MAKASAR,HALIM PERDANA KUSUMAH,28363,3622,24741,22667,47408,2021-11-17
3171031003,JAKARTA PUSAT,KEMAYORAN,HARAPAN MULIA,22557,4474,18083,14904,32987,2021-11-17
3174091001,JAKARTA SELATAN,JAGAKARSA,JAGAKARSA,62389,10097,52292,44220,96512,2021-11-17
3175021007,JAKARTA TIMUR,PULO GADUNG,JATI,32757,6048,26709,23343,50052,2021-11-17
3174041002,JAKARTA SELATAN,PASAR MINGGU,JATI PADANG,37502,7244,30258,25726,55984,2021-11-17
3173071004,JAKARTA BARAT,PALMERAH,JATI PULO,28738,5638,23100,18630,41730,2021-11-17
3175061001,JAKARTA TIMUR,CAKUNG,JATINEGARA,84160,17613,66547,55332,121879,2021-11-17
3175021004,JAKARTA TIMUR,PULO GADUNG,JATINEGARA KAUM,24632,4328,20304,16689,36993,2021-11-17
3173021004,JAKARTA BARAT,GROGOL PETAMBURAN,JELAMBAR,30266,5451,24815,21890,46705,2021-11-17
3173021006,JAKARTA BARAT,GROGOL PETAMBURAN,JELAMBAR BARU,38246,6919,31327,27435,58762,2021-11-17
3173041006,JAKARTA BARAT,TAMBORA,JEMBATAN BESI,29314,7018,22296,17588,39884,2021-11-17
3173041008,JAKARTA BARAT,TAMBORA,JEMBATAN LIMA,21021,4786,16235,12977,29212,2021-11-17
3173081005,JAKARTA BARAT,KEMBANGAN,JOGLO,40839,8066,32773,27941,60714,2021-11-17
3171081001,JAKARTA PUSAT,JOHAR BARU,JOHAR BARU,37488,6872,30616,26045,56661,2021-11-17
3173041002,JAKARTA BARAT,TAMBORA,KALI ANYAR,23856,4650,19206,15470,34676,2021-11-17
3172041004,JAKARTA UTARA,CILINCING,KALIBARU,67684,18300,49384,35336,84720,2021-11-17
3174081002,JAKARTA SELATAN,PANCORAN,KALIBATA,41994,9414,32580,26763,59343,2021-11-17
3173061001,JAKARTA BARAT,KALI DERES,KALIDERES,72447,14328,58119,49512,107631,2021-11-17
3175051004,JAKARTA TIMUR,PASAR REBO,KALISARI,43212,7605,35607,30305,65912,2021-11-17
3173061004,JAKARTA BARAT,KALI DERES,KAMAL,53783,12369,41414,33473,74887,2021-11-17
3172011002,JAKARTA UTARA,PENJARINGAN,KAMAL MUARA,12930,2277,10653,9112,19765,2021-11-17
3171071007,JAKARTA PUSAT,TANAH ABANG,KAMPUNG BALI,11358,2431,8927,6955,15882,2021-11-17
3175031001,JAKARTA TIMUR,JATINEGARA,KAMPUNG MELAYU,25717,5790,19927,15671,35598,2021-11-17
3171081002,JAKARTA PUSAT,JOHAR BARU,KAMPUNG RAWA,21237,3477,17760,14338,32098,2021-11-17
3175041002,JAKARTA TIMUR,KRAMAT JATI,KAMPUNG TENGAH,43993,10859,33134,26767,59901,2021-11-17
3173011005,JAKARTA BARAT,CENGKARENG,KAPUK,134466,31903,102563,83689,186252,2021-11-17
3172011003,JAKARTA UTARA,PENJARINGAN,KAPUK MUARA,35781,6771,29010,25595,54605,2021-11-17
3171021002,JAKARTA PUSAT,SAWAH BESAR,KARANG ANYAR,25761,4846,20915,17733,38648,2021-11-17
3174021004,JAKARTA SELATAN,SETIA BUDI,KARET,9623,1834,7789,6546,14335,2021-11-17
3174021003,JAKARTA SELATAN,SETIA BUDI,KARET KUNINGAN,16055,3079,12976,11101,24077,2021-11-17
3174021002,JAKARTA SELATAN,SETIA BUDI,KARET SEMANGGI,2770,550,2220,1972,4192,2021-11-17
3171071003,JAKARTA PUSAT,TANAH ABANG,KARET TENGSIN,19271,3673,15598,12847,28445,2021-11-17
3171021003,JAKARTA PUSAT,SAWAH BESAR,KARTINI,22292,4135,18157,15697,33854,2021-11-17
3175011003,JAKARTA TIMUR,MATRAMAN,KAYU MANIS,25284,5249,20035,16130,36165,2021-11-17
3175021006,JAKARTA TIMUR,PULO GADUNG,KAYU PUTIH,40696,7586,33110,29158,62268,2021-11-17
3173031006,JAKARTA BARAT,TAMAN SARI,KEAGUNGAN,17387,3196,14191,11744,25935,2021-11-17
3174041007,JAKARTA SELATAN,PASAR MINGGU,KEBAGUSAN,44552,8705,35847,29929,65776,2021-11-17
3174051006,JAKARTA SELATAN,KEBAYORAN LAMA,KEBAYORAN LAMA SELATAN,41212,7561,33651,28889,62540,2021-11-17
3174051001,JAKARTA SELATAN,KEBAYORAN LAMA,KEBAYORAN LAMA UTARA,42422,8683,33739,28081,61820,2021-11-17
3174011004,JAKARTA SELATAN,TEBET,KEBON BARU,35165,6524,28641,24319,52960,2021-11-17
3172021005,JAKARTA UTARA,TANJUNG PRIOK,KEBON BAWANG,50952,10158,40794,34275,75069,2021-11-17
3173051001,JAKARTA BARAT,KEBON JERUK,KEBON JERUK,53887,10874,43013,35232,78245,2021-11-17
3171071006,JAKARTA PUSAT,TANAH ABANG,KEBON KACANG,21531,5070,16461,13134,29595,2021-11-17
3171011005,JAKARTA PUSAT,GAMBIR,KEBON KELAPA,10163,2024,8139,6908,15047,2021-11-17
3171031002,JAKARTA PUSAT,KEMAYORAN,KEBON KOSONG,30019,5941,24078,19866,43944,2021-11-17
3175011005,JAKARTA TIMUR,MATRAMAN,KEBON MANGGIS,16490,3173,13317,11116,24433,2021-11-17
3171071005,JAKARTA PUSAT,TANAH ABANG,KEBON MELATI,32206,8536,23670,17803,41473,2021-11-17
3175081003,JAKARTA TIMUR,MAKASAR,KEBON PALA,46614,9023,37591,31580,69171,2021-11-17
3171061005,JAKARTA PUSAT,MENTENG,KEBON SIRIH,12299,2608,9691,7858,17549,2021-11-17
3173011004,JAKARTA BARAT,CENGKARENG,KEDAUNG KALI ANGKE,32612,6224,26388,22369,48757,2021-11-17
3173051007,JAKARTA BARAT,KEBON JERUK,KEDOYA SELATAN,32165,5811,26354,21947,48301,2021-11-17
3173051006,JAKARTA BARAT,KEBON JERUK,KEDOYA UTARA,45740,8628,37112,31557,68669,2021-11-17
3173051004,JAKARTA BARAT,KEBON JERUK,KELAPA DUA,23565,4545,19020,15975,34995,2021-11-17
3175091003,JAKARTA TIMUR,CIRACAS,KELAPA DUA WETAN,46875,7869,39006,33300,72306,2021-11-17
3172061003,JAKARTA UTARA,KELAPA GADING,KELAPA GADING BARAT,35717,6155,29562,26821,56383,2021-11-17
3172061001,JAKARTA UTARA,KELAPA GADING,KELAPA GADING TIMUR,33592,5083,28509,26534,55043,2021-11-17
3173071005,JAKARTA BARAT,PALMERAH,KEMANGGISAN,32139,5998,26141,22254,48395,2021-11-17
3171031001,JAKARTA PUSAT,KEMAYORAN,KEMAYORAN,20708,4095,16613,13772,30385,2021-11-17
3173081006,JAKARTA BARAT,KEMBANGAN,KEMBANGAN SELATAN,27130,5622,21508,18714,40222,2021-11-17
3173081001,JAKARTA BARAT,KEMBANGAN,KEMBANGAN UTARA,54451,11763,42688,35753,78441,2021-11-17
3171041002,JAKARTA PUSAT,SENEN,KENARI,9579,1843,7736,6633,14369,2021-11-17
3173041005,JAKARTA BARAT,TAMBORA,KERENDANG,19973,3998,15975,13078,29053,2021-11-17
3175071003,JAKARTA TIMUR,DUREN SAWIT,KLENDER,69978,16221,53757,43286,97043,2021-11-17
3172031001,JAKARTA UTARA,KOJA,KOJA,28175,6278,21897,17869,39766,2021-11-17
3173071006,JAKARTA BARAT,PALMERAH,KOTA BAMBU SELATAN,21158,4113,17045,13493,30538,2021-11-17
3173071003,JAKARTA BARAT,PALMERAH,KOTA BAMBU UTARA,24995,5106,19889,15567,35456,2021-11-17
3171041004,JAKARTA PUSAT,SENEN,KRAMAT,28835,6855,21980,16889,38869,2021-11-17
3175041001,JAKARTA TIMUR,KRAMAT JATI,KRAMAT JATI,34144,7132,27012,22146,49158,2021-11-17
3174071003,JAKARTA SELATAN,KEBAYORAN BARU,KRAMAT PELA,14413,2751,11662,10126,21788,2021-11-17
3173031002,JAKARTA BARAT,TAMAN SARI,KRUKUT,19244,3585,15659,12838,28497,2021-11-17
3174031005,JAKARTA SELATAN,MAMPANG PRAPATAN,KUNINGAN BARAT,12785,2301,10484,8771,19255,2021-11-17
3174021008,JAKARTA SELATAN,SETIA BUDI,KUNINGAN TIMUR,6008,1177,4831,4153,8984,2021-11-17
3171041005,JAKARTA PUSAT,SENEN,KWITANG,15486,3400,12086,9789,21875,2021-11-17
3172031003,JAKARTA UTARA,KOJA,LAGOA,59065,13801,45264,36134,81398,2021-11-17
3174061002,JAKARTA SELATAN,CILANDAK,LEBAK BULUS,37626,6997,30629,27132,57761,2021-11-17
3174091004,JAKARTA SELATAN,JAGAKARSA,LENTENG AGUNG,53946,9514,44432,36762,81194,2021-11-17
3175101007,JAKARTA TIMUR,CIPAYUNG,LUBANG BUAYA,63547,11809,51738,43335,95073,2021-11-17
3175081001,JAKARTA TIMUR,MAKASAR,MAKASAR,34390,6198,28192,24288,52480,2021-11-17
3175071006,JAKARTA TIMUR,DUREN SAWIT,MALAKA JAYA,30927,5205,25722,22310,48032,2021-11-17
3175071005,JAKARTA TIMUR,DUREN SAWIT,MALAKA SARI,27530,4492,23038,20070,43108,2021-11-17
3174031001,JAKARTA SELATAN,MAMPANG PRAPATAN,MAMPANG PRAPATAN,18159,3667,14492,12106,26598,2021-11-17
3173031005,JAKARTA BARAT,TAMAN SARI,MANGGA BESAR,7707,1281,6426,5703,12129,2021-11-17
3171021005,JAKARTA PUSAT,SAWAH BESAR,MANGGA DUA SELATAN,27442,5607,21835,18697,40532,2021-11-17
3174011007,JAKARTA SELATAN,TEBET,MANGGARAI,28373,4915,23458,19297,42755,2021-11-17
3174011006,JAKARTA SELATAN,TEBET,MANGGARAI SELATAN,23075,3892,19183,16278,35461,2021-11-17
3173031003,JAKARTA BARAT,TAMAN SARI,MAPHAR,16461,3018,13443,11320,24763,2021-11-17
3172041003,JAKARTA UTARA,CILINCING,MARUNDA,28943,6460,22483,17046,39529,2021-11-17
3174071001,JAKARTA SELATAN,KEBAYORAN BARU,MELAWAI,2627,502,2125,1958,4083,2021-11-17
3171061001,JAKARTA PUSAT,MENTENG,MENTENG,25624,5517,20107,16115,36222,2021-11-17
3174021005,JAKARTA SELATAN,SETIA BUDI,MENTENG ATAS,27816,4922,22894,19334,42228,2021-11-17
3174011003,JAKARTA SELATAN,TEBET,MENTENG DALAM,36028,6914,29114,24851,53965,2021-11-17
3173081003,JAKARTA BARAT,KEMBANGAN,MERUYA SELATAN,32130,6497,25633,21842,47475,2021-11-17
3173081002,JAKARTA BARAT,KEMBANGAN,MERUYA UTARA,43752,8881,34871,30564,65435,2021-11-17
3175101004,JAKARTA TIMUR,CIPAYUNG,MUNJUL,23871,4297,19574,16711,36285,2021-11-17
3172051002,JAKARTA UTARA,PADEMANGAN,PADEMANGAN BARAT,74240,17146,57094,46615,103709,2021-11-17
3172051001,JAKARTA UTARA,PADEMANGAN,PADEMANGAN TIMUR,37736,6592,31144,27647,58791,2021-11-17
3175011004,JAKARTA TIMUR,MATRAMAN,PAL MERIAM,19769,4011,15758,12827,28585,2021-11-17
3173071001,JAKARTA BARAT,PALMERAH,PALMERAH,63011,13073,49938,41133,91071,2021-11-17
3174081001,JAKARTA SELATAN,PANCORAN,PANCORAN,19421,3841,15580,13038,28618,2021-11-17
3172021003,JAKARTA UTARA,TANJUNG PRIOK,PAPANGGO,39097,7561,31536,26136,57672,2021-11-17
3171021001,JAKARTA PUSAT,SAWAH BESAR,PASAR BARU,12035,2275,9760,8790,18550,2021-11-17
3174021006,JAKARTA SELATAN,SETIA BUDI,PASAR MANGGIS,26752,5158,21594,18040,39634,2021-11-17
3174041001,JAKARTA SELATAN,PASAR MINGGU,PASAR MINGGU,24821,4615,20206,17491,37697,2021-11-17
3171041003,JAKARTA PUSAT,SENEN,PASEBAN,23533,4818,18715,15484,34199,2021-11-17
3173061005,JAKARTA BARAT,KALI DERES,PEGADUNGAN,75587,14573,61014,52698,113712,2021-11-17
3171061002,JAKARTA PUSAT,MENTENG,PEGANGSAAN,23455,4975,18480,14394,32874,2021-11-17
3172061002,JAKARTA UTARA,KELAPA GADING,PEGANGSAAN DUA,49976,8167,41809,38053,79862,2021-11-17
3172011004,JAKARTA UTARA,PENJARINGAN,PEJAGALAN,74578,15226,59352,51582,110934,2021-11-17
3174041006,JAKARTA SELATAN,PASAR MINGGU,PEJATEN BARAT,37346,7139,30207,25608,55815,2021-11-17
3174041005,JAKARTA SELATAN,PASAR MINGGU,PEJATEN TIMUR,57656,12548,45108,37363,82471,2021-11-17
3175051005,JAKARTA TIMUR,PASAR REBO,PEKAYON,43250,7730,35520,29893,65413,2021-11-17
3173041009,JAKARTA BARAT,TAMBORA,PEKOJAN,23587,4422,19165,16292,35457,2021-11-17
3174031003,JAKARTA SELATAN,MAMPANG PRAPATAN,PELA MAMPANG,43522,8397,35125,29752,64877,2021-11-17
3174081005,JAKARTA SELATAN,PANCORAN,PENGADEGAN,21478,3902,17576,15142,32718,2021-11-17
3175061003,JAKARTA TIMUR,CAKUNG,PENGGILINGAN,99255,22506,76749,61921,138670,2021-11-17
3172011001,JAKARTA UTARA,PENJARINGAN,PENJARINGAN,88308,22351,65957,51489,117446,2021-11-17
3174101001,JAKARTA SELATAN,PESANGGRAHAN,PESANGGRAHAN,27545,4662,22883,19845,42728,2021-11-17
3171071004,JAKARTA PUSAT,TANAH ABANG,PETAMBURAN,33271,8655,24616,18873,43489,2021-11-17
3174071008,JAKARTA SELATAN,KEBAYORAN BARU,PETOGOGAN,11499,2195,9304,8028,17332,2021-11-17
3171011004,JAKARTA PUSAT,GAMBIR,PETOJO SELATAN,14692,3262,11430,9772,21202,2021-11-17
3171011003,JAKARTA PUSAT,GAMBIR,PETOJO UTARA,17458,3718,13740,11439,25179,2021-11-17
3174101004,JAKARTA SELATAN,PESANGGRAHAN,PETUKANGAN SELATAN,37187,7550,29637,25241,54878,2021-11-17
3174101003,JAKARTA SELATAN,PESANGGRAHAN,PETUKANGAN UTARA,53716,11361,42355,35556,77911,2021-11-17
3175081002,JAKARTA TIMUR,MAKASAR,PINANG RANTI,27198,5809,21389,17795,39184,2021-11-17
3173031008,JAKARTA BARAT,TAMAN SARI,PINANGSIA,10729,1855,8874,7433,16307,2021-11-17
3175011001,JAKARTA TIMUR,MATRAMAN,PISANGAN BARU,31776,6438,25338,20409,45747,2021-11-17
3175021002,JAKARTA TIMUR,PULO GADUNG,PISANGAN TIMUR,41011,7456,33555,28634,62189,2021-11-17
3172011005,JAKARTA UTARA,PENJARINGAN,PLUIT,47783,9113,38670,34191,72861,2021-11-17
3175071002,JAKARTA TIMUR,DUREN SAWIT,PONDOK BAMBU,61550,12767,48783,41006,89789,2021-11-17
3175071004,JAKARTA TIMUR,DUREN SAWIT,PONDOK KELAPA,72015,14076,57939,50122,108061,2021-11-17
3175071007,JAKARTA TIMUR,DUREN SAWIT,PONDOK KOPI,35367,6533,28834,23268,52102,2021-11-17
3174061003,JAKARTA SELATAN,CILANDAK,PONDOK LABU,46464,7663,38801,34125,72926,2021-11-17
3174051002,JAKARTA SELATAN,KEBAYORAN LAMA,PONDOK PINANG,56169,10617,45552,39372,84924,2021-11-17
3175101003,JAKARTA TIMUR,CIPAYUNG,PONDOK RANGGON,25574,4726,20848,17712,38560,2021-11-17
3101011003,KAB.ADM.KEP.SERIBU,KEP. SERIBU UTARA,PULAU HARAPAN,2060,219,1841,1615,3456,2021-11-17
3101011002,KAB.ADM.KEP.SERIBU,KEP. SERIBU UTARA,PULAU KELAPA,5528,594,4934,4084,9018,2021-11-17
3101011001,KAB.ADM.KEP.SERIBU,KEP. SERIBU UTARA,PULAU PANGGANG,5450,433,5017,4500,9517,2021-11-17
3101021003,KAB.ADM.KEP.SERIBU,KEP. SERIBU SELATAN,PULAU PARI,2765,192,2573,2432,5005,2021-11-17
3101021002,KAB.ADM.KEP.SERIBU,KEP. SERIBU SELATAN,PULAU TIDUNG,4553,365,4188,3847,8035,2021-11-17
3101021001,KAB.ADM.KEP.SERIBU,KEP. SERIBU SELATAN,PULAU UNTUNG JAWA,1941,159,1782,1662,3444,2021-11-17
3174071007,JAKARTA SELATAN,KEBAYORAN BARU,PULO,5835,1001,4834,4461,9295,2021-11-17
3175021001,JAKARTA TIMUR,PULO GADUNG,PULO GADUNG,34422,7439,26983,22753,49736,2021-11-17
3175061005,JAKARTA TIMUR,CAKUNG,PULO GEBANG,97301,18469,78832,64686,143518,2021-11-17
3174041004,JAKARTA SELATAN,PASAR MINGGU,RAGUNAN,39616,7148,32468,27977,60445,2021-11-17
3175091005,JAKARTA TIMUR,CIRACAS,RAMBUTAN,36771,8474,28297,23230,51527,2021-11-17
3172031006,JAKARTA UTARA,KOJA,RAWA BADAK SELATAN,42179,9854,32325,25769,58094,2021-11-17
3172031004,JAKARTA UTARA,KOJA,RAWA BADAK UTARA,34408,7586,26822,21884,48706,2021-11-17
3174071005,JAKARTA SELATAN,KEBAYORAN BARU,RAWA BARAT,5625,991,4634,4131,8765,2021-11-17
3173011003,JAKARTA BARAT,CENGKARENG,RAWA BUAYA,63799,12421,51378,42395,93773,2021-11-17
3175031004,JAKARTA TIMUR,JATINEGARA,RAWA BUNGA,21434,5093,16341,13402,29743,2021-11-17
3174081003,JAKARTA SELATAN,PANCORAN,RAWA JATI,20509,3862,16647,14394,31041,2021-11-17
3175061002,JAKARTA TIMUR,CAKUNG,RAWA TERATE,24637,4407,20230,16661,36891,2021-11-17
3175021005,JAKARTA TIMUR,PULO GADUNG,RAWAMANGUN,37612,7300,30312,25966,56278,2021-11-17
3171051003,JAKARTA PUSAT,CEMPAKA PUTIH,RAWASARI,21967,4399,17568,15181,32749,2021-11-17
3173041010,JAKARTA BARAT,TAMBORA,ROA MALAKA,3484,608,2876,2591,5467,2021-11-17
3172041006,JAKARTA UTARA,CILINCING,ROROTAN,41668,8223,33445,27079,60524,2021-11-17
3174071004,JAKARTA SELATAN,KEBAYORAN BARU,SELONG,2842,542,2300,2139,4439,2021-11-17
3173061002,JAKARTA BARAT,KALI DERES,SEMANAN,71354,14811,56543,46031,102574,2021-11-17
3172041007,JAKARTA UTARA,CILINCING,SEMPER BARAT,68587,13133,55454,46535,101989,2021-11-17
3172041005,JAKARTA UTARA,CILINCING,SEMPER TIMUR,36267,7649,28618,23502,52120,2021-11-17
3174071006,JAKARTA SELATAN,KEBAYORAN BARU,SENAYAN,2771,643,2128,1856,3984,2021-11-17
3171041001,JAKARTA PUSAT,SENEN,SENEN,6804,1427,5377,4502,9879,2021-11-17
3171031004,JAKARTA PUSAT,KEMAYORAN,SERDANG,29668,5718,23950,20135,44085,2021-11-17
3174021001,JAKARTA SELATAN,SETIA BUDI,SETIA BUDI,3023,600,2423,2092,4515,2021-11-17
3175101005,JAKARTA TIMUR,CIPAYUNG,SETU,20572,4031,16541,13644,30185,2021-11-17
3173071002,JAKARTA BARAT,PALMERAH,SLIPI,16591,2931,13660,11652,25312,2021-11-17
3173081004,JAKARTA BARAT,KEMBANGAN,SRENGSENG,45523,10075,35448,30256,65704,2021-11-17
3174091002,JAKARTA SELATAN,JAGAKARSA,SRENGSENG SAWAH,58196,8876,49320,42419,91739,2021-11-17
3173051003,JAKARTA BARAT,KEBON JERUK,SUKABUMI SELATAN,37033,8194,28839,22700,51539,2021-11-17
3173051002,JAKARTA BARAT,KEBON JERUK,SUKABUMI UTARA,38290,8840,29450,23424,52874,2021-11-17
3172041002,JAKARTA UTARA,CILINCING,SUKAPURA,53949,11975,41974,34872,76846,2021-11-17
3171031007,JAKARTA PUSAT,KEMAYORAN,SUMUR BATU,22717,4294,18423,15789,34212,2021-11-17
3172021004,JAKARTA UTARA,TANJUNG PRIOK,SUNGAI BAMBU,29876,5907,23969,20051,44020,2021-11-17
3172021006,JAKARTA UTARA,TANJUNG PRIOK,SUNTER AGUNG,71805,12254,59551,52561,112112,2021-11-17
3172021002,JAKARTA UTARA,TANJUNG PRIOK,SUNTER JAYA,63031,10934,52097,45637,97734,2021-11-17
3175091004,JAKARTA TIMUR,CIRACAS,SUSUKAN,38257,7118,31139,26301,57440,2021-11-17
3173031001,JAKARTA BARAT,TAMAN SARI,TAMAN SARI,14348,2588,11760,10181,21941,2021-11-17
3173041001,JAKARTA BARAT,TAMBORA,TAMBORA,10204,2176,8028,6511,14539,2021-11-17
3173041004,JAKARTA BARAT,TAMBORA,TANAH SEREAL,26387,4420,21967,18602,40569,2021-11-17
3171081004,JAKARTA PUSAT,JOHAR BARU,TANAH TINGGI,37693,7097,30596,25025,55621,2021-11-17
3173031004,JAKARTA BARAT,TAMAN SARI,TANGKI,13324,2179,11145,9507,20652,2021-11-17
3174091005,JAKARTA SELATAN,JAGAKARSA,TANJUNG BARAT,39770,6658,33112,27822,60934,2021-11-17
3173021005,JAKARTA BARAT,GROGOL PETAMBURAN,TANJUNG DUREN SELATAN,25337,4764,20573,18356,38929,2021-11-17
3173021002,JAKARTA BARAT,GROGOL PETAMBURAN,TANJUNG DUREN UTARA,17010,2836,14174,12841,27015,2021-11-17
3172021001,JAKARTA UTARA,TANJUNG PRIOK,TANJUNG PRIOK,34588,7060,27528,22670,50198,2021-11-17
3174011002,JAKARTA SELATAN,TEBET,TEBET BARAT,21194,3376,17818,15829,33647,2021-11-17
3174011001,JAKARTA SELATAN,TEBET,TEBET TIMUR,18199,2891,15308,13923,29231,2021-11-17
3173061003,JAKARTA BARAT,KALI DERES,TEGAL ALUR,83647,17100,66547,55511,122058,2021-11-17
3174031004,JAKARTA SELATAN,MAMPANG PRAPATAN,TEGAL PARANG,32401,7039,25362,20079,45441,2021-11-17
3173021003,JAKARTA BARAT,GROGOL PETAMBURAN,TOMANG,29605,5381,24224,20980,45204,2021-11-17
3172031005,JAKARTA UTARA,KOJA,TUGU SELATAN,39122,8609,30513,24918,55431,2021-11-17
3172031002,JAKARTA UTARA,KOJA,TUGU UTARA,67670,15759,51911,41560,93471,2021-11-17
3175061006,JAKARTA TIMUR,CAKUNG,UJUNG MENTENG,29934,5088,24846,21262,46108,2021-11-17
3174101005,JAKARTA SELATAN,PESANGGRAHAN,ULUJAMI,40544,8987,31557,26244,57801,2021-11-17
3175011006,JAKARTA TIMUR,MATRAMAN,UTAN KAYU SELATAN,33511,5930,27581,23078,50659,2021-11-17
3175011002,JAKARTA TIMUR,MATRAMAN,UTAN KAYU UTARA,28169,5765,22404,18536,40940,2021-11-17
3171031008,JAKARTA PUSAT,KEMAYORAN,UTAN PANJANG,29208,5738,23470,19169,42639,2021-11-17
3172021007,JAKARTA UTARA,TANJUNG PRIOK,WARAKAS,44401,8044,36357,29663,66020,2021-11-17
3173021007,JAKARTA BARAT,GROGOL PETAMBURAN,WIJAYA KUSUMA,38934,7999,30935,26297,57232,2021-11-17
3172051003,JAKARTA UTARA,PADEMANGAN,ANCOL,23947,5712,18235,15091,33326,2021-11-18
3173041007,JAKARTA BARAT,TAMBORA,ANGKE,29381,6132,23249,18974,42223,2021-11-18
3175041005,JAKARTA TIMUR,KRAMAT JATI,BALE KAMBANG,29074,7109,21965,17490,39455,2021-11-18
3175031003,JAKARTA TIMUR,JATINEGARA,BALI MESTER,9752,2008,7744,6576,14320,2021-11-18
3175101006,JAKARTA TIMUR,CIPAYUNG,BAMBU APUS,26285,4771,21514,18165,39679,2021-11-18
3174031002,JAKARTA SELATAN,MAMPANG PRAPATAN,BANGKA,21566,4488,17078,14289,31367,2021-11-18
3175051002,JAKARTA TIMUR,PASAR REBO,BARU,23886,3895,19991,17352,37343,2021-11-18
3175041004,JAKARTA TIMUR,KRAMAT JATI,BATU AMPAR,47898,11411,36487,29707,66194,2021-11-18
3171071002,JAKARTA PUSAT,TANAH ABANG,BENDUNGAN HILIR,21494,4286,17208,14807,32015,2021-11-18
3175031002,JAKARTA TIMUR,JATINEGARA,BIDARA CINA,36689,8676,28013,22723,50736,2021-11-18
3174101002,JAKARTA SELATAN,PESANGGRAHAN,BINTARO,53098,10521,42577,37049,79626,2021-11-18
3174011005,JAKARTA SELATAN,TEBET,BUKIT DURI,34183,6752,27431,23035,50466,2021-11-18
3171041006,JAKARTA PUSAT,SENEN,BUNGUR,18144,3716,14428,12012,26440,2021-11-18
3175061007,JAKARTA TIMUR,CAKUNG,CAKUNG BARAT,57724,11654,46070,38239,84309,2021-11-18
3175061004,JAKARTA TIMUR,CAKUNG,CAKUNG TIMUR,58287,11256,47031,39400,86431,2021-11-18
3175041007,JAKARTA TIMUR,KRAMAT JATI,CAWANG,32762,6919,25843,20927,46770,2021-11-18
3175101008,JAKARTA TIMUR,CIPAYUNG,CEGER,18932,3623,15309,12891,28200,2021-11-18
3171031006,JAKARTA PUSAT,KEMAYORAN,CEMPAKA BARU,32581,6081,26500,21175,47675,2021-11-18
3171051002,JAKARTA PUSAT,CEMPAKA PUTIH,CEMPAKA PUTIH BARAT,35885,7531,28354,24394,52748,2021-11-18
3171051001,JAKARTA PUSAT,CEMPAKA PUTIH,CEMPAKA PUTIH TIMUR,24292,4928,19364,17067,36431,2021-11-18
3173011001,JAKARTA BARAT,CENGKARENG,CENGKARENG BARAT,66284,12997,53287,45915,99202,2021-11-18
3173011006,JAKARTA BARAT,CENGKARENG,CENGKARENG TIMUR,81027,15741,65286,54663,119949,2021-11-18
3175091002,JAKARTA TIMUR,CIRACAS,CIBUBUR,66364,11246,55118,47039,102157,2021-11-18
3171011002,JAKARTA PUSAT,GAMBIR,CIDENG,15390,2976,12414,10906,23320,2021-11-18
3174091003,JAKARTA SELATAN,JAGAKARSA,CIGANJUR,38497,6349,32148,26875,59023,2021-11-18
3175051003,JAKARTA TIMUR,PASAR REBO,CIJANTUNG,41419,7558,33861,28519,62380,2021-11-18
3171061003,JAKARTA PUSAT,MENTENG,CIKINI,8274,1472,6802,5448,12250,2021-11-18
3174081006,JAKARTA SELATAN,PANCORAN,CIKOKO,10547,1797,8750,7633,16383,2021-11-18
3174061001,JAKARTA SELATAN,CILANDAK,CILANDAK BARAT,51752,8975,42777,37650,80427,2021-11-18
3174041003,JAKARTA SELATAN,PASAR MINGGU,CILANDAK TIMUR,25145,4533,20612,17711,38323,2021-11-18
3175101002,JAKARTA TIMUR,CIPAYUNG,CILANGKAP,27635,4827,22808,19568,42376,2021-11-18
3175041006,JAKARTA TIMUR,KRAMAT JATI,CILILITAN,40181,8443,31738,26083,57821,2021-11-18
3172041001,JAKARTA UTARA,CILINCING,CILINCING,43609,10294,33315,26117,59432,2021-11-18
3175101001,JAKARTA TIMUR,CIPAYUNG,CIPAYUNG,26104,4486,21618,18652,40270,2021-11-18
3174091006,JAKARTA SELATAN,JAGAKARSA,CIPEDAK,38303,6233,32070,27241,59311,2021-11-18
3174061005,JAKARTA SELATAN,CILANDAK,CIPETE SELATAN,26704,5038,21666,19182,40848,2021-11-18
3174071010,JAKARTA SELATAN,KEBAYORAN BARU,CIPETE UTARA,34102,6393,27709,23398,51107,2021-11-18
3175021003,JAKARTA TIMUR,PULO GADUNG,CIPINANG,39306,7105,32201,27013,59214,2021-11-18
3175031007,JAKARTA TIMUR,JATINEGARA,CIPINANG BESAR SELATAN,35212,8216,26996,21402,48398,2021-11-18
3175031008,JAKARTA TIMUR,JATINEGARA,CIPINANG BESAR UTARA,45319,10503,34816,27436,62252,2021-11-18
3175031005,JAKARTA TIMUR,JATINEGARA,CIPINANG CEMPEDAK,32824,7046,25778,22094,47872,2021-11-18
3175081005,JAKARTA TIMUR,MAKASAR,CIPINANG MELAYU,42308,8068,34240,29288,63528,2021-11-18
3175031006,JAKARTA TIMUR,JATINEGARA,CIPINANG MUARA,55243,11556,43687,35843,79530,2021-11-18
3174051003,JAKARTA SELATAN,KEBAYORAN LAMA,CIPULIR,39937,8329,31608,25860,57468,2021-11-18
3175091001,JAKARTA TIMUR,CIRACAS,CIRACAS,64594,11651,52943,44306,97249,2021-11-18
3175041003,JAKARTA TIMUR,KRAMAT JATI,DUKUH,24609,4507,20102,16757,36859,2021-11-18
3175071001,JAKARTA TIMUR,DUREN SAWIT,DUREN SAWIT,61160,12722,48438,40631,89069,2021-11-18
3174081004,JAKARTA SELATAN,PANCORAN,DUREN TIGA,28319,5553,22766,19210,41976,2021-11-18
3173051005,JAKARTA BARAT,KEBON JERUK,DURI KEPA,60138,11651,48487,42062,90549,2021-11-18
3173011002,JAKARTA BARAT,CENGKARENG,DURI KOSAMBI,77923,16369,61554,49848,111402,2021-11-18
3171011006,JAKARTA PUSAT,GAMBIR,DURI PULO,19610,4088,15522,12579,28101,2021-11-18
3173041011,JAKARTA BARAT,TAMBORA,DURI SELATAN,14259,2503,11756,10033,21789,2021-11-18
3173041003,JAKARTA BARAT,TAMBORA,DURI UTARA,19844,3530,16314,13522,29836,2021-11-18
3171081003,JAKARTA PUSAT,JOHAR BARU,GALUR,18243,3539,14704,11984,26688,2021-11-18
3171011001,JAKARTA PUSAT,GAMBIR,GAMBIR,2191,454,1737,1516,3253,2021-11-18
3174061004,JAKARTA SELATAN,CILANDAK,GANDARIA SELATAN,22119,4175,17944,15423,33367,2021-11-18
3174071009,JAKARTA SELATAN,KEBAYORAN BARU,GANDARIA UTARA,39922,7804,32118,27452,59570,2021-11-18
3175051001,JAKARTA TIMUR,PASAR REBO,GEDONG,35755,7063,28692,24432,53124,2021-11-18
3171071001,JAKARTA PUSAT,TANAH ABANG,GELORA,3127,603,2524,2195,4719,2021-11-18
3173031007,JAKARTA BARAT,TAMAN SARI,GLODOK,7837,1166,6671,6010,12681,2021-11-18
3171061004,JAKARTA PUSAT,MENTENG,GONDANGDIA,4100,907,3193,2918,6111,2021-11-18
3173021001,JAKARTA BARAT,GROGOL PETAMBURAN,GROGOL,16876,3307,13569,11569,25138,2021-11-18
3174051005,JAKARTA SELATAN,KEBAYORAN LAMA,GROGOL SELATAN,44251,8707,35544,29622,65166,2021-11-18
3174051004,JAKARTA SELATAN,KEBAYORAN LAMA,GROGOL UTARA,42494,8556,33938,28346,62284,2021-11-18
3174021007,JAKARTA SELATAN,SETIA BUDI,GUNTUR,3985,735,3250,2881,6131,2021-11-18
3174071002,JAKARTA SELATAN,KEBAYORAN BARU,GUNUNG,9436,1728,7708,6890,14598,2021-11-18
3171031005,JAKARTA PUSAT,KEMAYORAN,GUNUNG SAHARI SELATAN,19199,3768,15431,13083,28514,2021-11-18
3171021004,JAKARTA PUSAT,SAWAH BESAR,GUNUNG SAHARI UTARA,16650,2900,13750,12332,26082,2021-11-18
3175081004,JAKARTA TIMUR,MAKASAR,HALIM PERDANA KUSUMAH,28363,3618,24745,22678,47423,2021-11-18
3171031003,JAKARTA PUSAT,KEMAYORAN,HARAPAN MULIA,22557,4462,18095,14913,33008,2021-11-18
3174091001,JAKARTA SELATAN,JAGAKARSA,JAGAKARSA,62389,10083,52306,44252,96558,2021-11-18
3175021007,JAKARTA TIMUR,PULO GADUNG,JATI,32757,6043,26714,23354,50068,2021-11-18
3174041002,JAKARTA SELATAN,PASAR MINGGU,JATI PADANG,37502,7214,30288,25747,56035,2021-11-18
3173071004,JAKARTA BARAT,PALMERAH,JATI PULO,28738,5635,23103,18638,41741,2021-11-18
3175061001,JAKARTA TIMUR,CAKUNG,JATINEGARA,84160,17595,66565,55364,121929,2021-11-18
3175021004,JAKARTA TIMUR,PULO GADUNG,JATINEGARA KAUM,24632,4317,20315,16718,37033,2021-11-18
3173021004,JAKARTA BARAT,GROGOL PETAMBURAN,JELAMBAR,30266,5438,24828,21902,46730,2021-11-18
3173021006,JAKARTA BARAT,GROGOL PETAMBURAN,JELAMBAR BARU,38246,6899,31347,27452,58799,2021-11-18
3173041006,JAKARTA BARAT,TAMBORA,JEMBATAN BESI,29314,7015,22299,17596,39895,2021-11-18
3173041008,JAKARTA BARAT,TAMBORA,JEMBATAN LIMA,21021,4778,16243,12982,29225,2021-11-18
3173081005,JAKARTA BARAT,KEMBANGAN,JOGLO,40839,8057,32782,27954,60736,2021-11-18
3171081001,JAKARTA PUSAT,JOHAR BARU,JOHAR BARU,37488,6865,30623,26060,56683,2021-11-18
3173041002,JAKARTA BARAT,TAMBORA,KALI ANYAR,23856,4647,19209,15471,34680,2021-11-18
3172041004,JAKARTA UTARA,CILINCING,KALIBARU,67684,18285,49399,35358,84757,2021-11-18
3174081002,JAKARTA SELATAN,PANCORAN,KALIBATA,41994,9409,32585,26788,59373,2021-11-18
3173061001,JAKARTA BARAT,KALI DERES,KALIDERES,72447,14315,58132,49542,107674,2021-11-18
3175051004,JAKARTA TIMUR,PASAR REBO,KALISARI,43212,7595,35617,30323,65940,2021-11-18
3173061004,JAKARTA BARAT,KALI DERES,KAMAL,53783,12358,41425,33506,74931,2021-11-18
3172011002,JAKARTA UTARA,PENJARINGAN,KAMAL MUARA,12930,2277,10653,9115,19768,2021-11-18
3171071007,JAKARTA PUSAT,TANAH ABANG,KAMPUNG BALI,11358,2428,8930,6957,15887,2021-11-18
3175031001,JAKARTA TIMUR,JATINEGARA,KAMPUNG MELAYU,25717,5783,19934,15685,35619,2021-11-18
3171081002,JAKARTA PUSAT,JOHAR BARU,KAMPUNG RAWA,21237,3475,17762,14343,32105,2021-11-18
3175041002,JAKARTA TIMUR,KRAMAT JATI,KAMPUNG TENGAH,43993,10852,33141,26781,59922,2021-11-18
3173011005,JAKARTA BARAT,CENGKARENG,KAPUK,134466,31884,102582,83725,186307,2021-11-18
3172011003,JAKARTA UTARA,PENJARINGAN,KAPUK MUARA,35781,6768,29013,25603,54616,2021-11-18
3171021002,JAKARTA PUSAT,SAWAH BESAR,KARANG ANYAR,25761,4841,20920,17734,38654,2021-11-18
3174021004,JAKARTA SELATAN,SETIA BUDI,KARET,9623,1834,7789,6553,14342,2021-11-18
3174021003,JAKARTA SELATAN,SETIA BUDI,KARET KUNINGAN,16055,3077,12978,11104,24082,2021-11-18
3174021002,JAKARTA SELATAN,SETIA BUDI,KARET SEMANGGI,2770,550,2220,1972,4192,2021-11-18
3171071003,JAKARTA PUSAT,TANAH ABANG,KARET TENGSIN,19271,3670,15601,12857,28458,2021-11-18
3171021003,JAKARTA PUSAT,SAWAH BESAR,KARTINI,22292,4133,18159,15703,33862,2021-11-18
3175011003,JAKARTA TIMUR,MATRAMAN,KAYU MANIS,25284,5243,20041,16154,36195,2021-11-18
3175021006,JAKARTA TIMUR,PULO GADUNG,KAYU PUTIH,40696,7580,33116,29169,62285,2021-11-18
3173031006,JAKARTA BARAT,TAMAN SARI,KEAGUNGAN,17387,3194,14193,11752,25945,2021-11-18
3174041007,JAKARTA SELATAN,PASAR MINGGU,KEBAGUSAN,44552,8696,35856,29950,65806,2021-11-18
3174051006,JAKARTA SELATAN,KEBAYORAN LAMA,KEBAYORAN LAMA SELATAN,41212,7546,33666,28917,62583,2021-11-18
3174051001,JAKARTA SELATAN,KEBAYORAN LAMA,KEBAYORAN LAMA UTARA,42422,8679,33743,28091,61834,2021-11-18
3174011004,JAKARTA SELATAN,TEBET,KEBON BARU,35165,6513,28652,24339,52991,2021-11-18
3172021005,JAKARTA UTARA,TANJUNG PRIOK,KEBON BAWANG,50952,10141,40811,34302,75113,2021-11-18
3173051001,JAKARTA BARAT,KEBON JERUK,KEBON JERUK,53887,10842,43045,35243,78288,2021-11-18
3171071006,JAKARTA PUSAT,TANAH ABANG,KEBON KACANG,21531,5068,16463,13136,29599,2021-11-18
3171011005,JAKARTA PUSAT,GAMBIR,KEBON KELAPA,10163,2024,8139,6912,15051,2021-11-18
3171031002,JAKARTA PUSAT,KEMAYORAN,KEBON KOSONG,30019,5935,24084,19876,43960,2021-11-18
3175011005,JAKARTA TIMUR,MATRAMAN,KEBON MANGGIS,16490,3169,13321,11122,24443,2021-11-18
3171071005,JAKARTA PUSAT,TANAH ABANG,KEBON MELATI,32206,8533,23673,17810,41483,2021-11-18
3175081003,JAKARTA TIMUR,MAKASAR,KEBON PALA,46614,9007,37607,31607,69214,2021-11-18
3171061005,JAKARTA PUSAT,MENTENG,KEBON SIRIH,12299,2607,9692,7863,17555,2021-11-18
3173011004,JAKARTA BARAT,CENGKARENG,KEDAUNG KALI ANGKE,32612,6208,26404,22387,48791,2021-11-18
3173051007,JAKARTA BARAT,KEBON JERUK,KEDOYA SELATAN,32165,5808,26357,21958,48315,2021-11-18
3173051006,JAKARTA BARAT,KEBON JERUK,KEDOYA UTARA,45740,8623,37117,31560,68677,2021-11-18
3173051004,JAKARTA BARAT,KEBON JERUK,KELAPA DUA,23565,4545,19020,15982,35002,2021-11-18
3175091003,JAKARTA TIMUR,CIRACAS,KELAPA DUA WETAN,46875,7860,39015,33310,72325,2021-11-18
3172061003,JAKARTA UTARA,KELAPA GADING,KELAPA GADING BARAT,35717,6153,29564,26834,56398,2021-11-18
3172061001,JAKARTA UTARA,KELAPA GADING,KELAPA GADING TIMUR,33592,5081,28511,26544,55055,2021-11-18
3173071005,JAKARTA BARAT,PALMERAH,KEMANGGISAN,32139,5995,26144,22261,48405,2021-11-18
3171031001,JAKARTA PUSAT,KEMAYORAN,KEMAYORAN,20708,4088,16620,13784,30404,2021-11-18
3173081006,JAKARTA BARAT,KEMBANGAN,KEMBANGAN SELATAN,27130,5621,21509,18718,40227,2021-11-18
3173081001,JAKARTA BARAT,KEMBANGAN,KEMBANGAN UTARA,54451,11748,42703,35770,78473,2021-11-18
3171041002,JAKARTA PUSAT,SENEN,KENARI,9579,1843,7736,6635,14371,2021-11-18
3173041005,JAKARTA BARAT,TAMBORA,KERENDANG,19973,3994,15979,13085,29064,2021-11-18
3175071003,JAKARTA TIMUR,DUREN SAWIT,KLENDER,69978,16215,53763,43314,97077,2021-11-18
3172031001,JAKARTA UTARA,KOJA,KOJA,28175,6275,21900,17881,39781,2021-11-18
3173071006,JAKARTA BARAT,PALMERAH,KOTA BAMBU SELATAN,21158,4108,17050,13500,30550,2021-11-18
3173071003,JAKARTA BARAT,PALMERAH,KOTA BAMBU UTARA,24995,5099,19896,15585,35481,2021-11-18
3171041004,JAKARTA PUSAT,SENEN,KRAMAT,28835,6851,21984,16897,38881,2021-11-18
3175041001,JAKARTA TIMUR,KRAMAT JATI,KRAMAT JATI,34144,7126,27018,22163,49181,2021-11-18
3174071003,JAKARTA SELATAN,KEBAYORAN BARU,KRAMAT PELA,14413,2750,11663,10129,21792,2021-11-18
3173031002,JAKARTA BARAT,TAMAN SARI,KRUKUT,19244,3582,15662,12852,28514,2021-11-18
3174031005,JAKARTA SELATAN,MAMPANG PRAPATAN,KUNINGAN BARAT,12785,2299,10486,8826,19312,2021-11-18
3174021008,JAKARTA SELATAN,SETIA BUDI,KUNINGAN TIMUR,6008,1175,4833,4157,8990,2021-11-18
3171041005,JAKARTA PUSAT,SENEN,KWITANG,15486,3395,12091,9801,21892,2021-11-18
3172031003,JAKARTA UTARA,KOJA,LAGOA,59065,13780,45285,36149,81434,2021-11-18
3174061002,JAKARTA SELATAN,CILANDAK,LEBAK BULUS,37626,6989,30637,27140,57777,2021-11-18
3174091004,JAKARTA SELATAN,JAGAKARSA,LENTENG AGUNG,53946,9503,44443,36775,81218,2021-11-18
3175101007,JAKARTA TIMUR,CIPAYUNG,LUBANG BUAYA,63547,11788,51759,43374,95133,2021-11-18
3175081001,JAKARTA TIMUR,MAKASAR,MAKASAR,34390,6190,28200,24310,52510,2021-11-18
3175071006,JAKARTA TIMUR,DUREN SAWIT,MALAKA JAYA,30927,5197,25730,22318,48048,2021-11-18
3175071005,JAKARTA TIMUR,DUREN SAWIT,MALAKA SARI,27530,4487,23043,20078,43121,2021-11-18
3174031001,JAKARTA SELATAN,MAMPANG PRAPATAN,MAMPANG PRAPATAN,18159,3663,14496,12118,26614,2021-11-18
3173031005,JAKARTA BARAT,TAMAN SARI,MANGGA BESAR,7707,1280,6427,5705,12132,2021-11-18
3171021005,JAKARTA PUSAT,SAWAH BESAR,MANGGA DUA SELATAN,27442,5599,21843,18702,40545,2021-11-18
3174011007,JAKARTA SELATAN,TEBET,MANGGARAI,28373,4906,23467,19318,42785,2021-11-18
3174011006,JAKARTA SELATAN,TEBET,MANGGARAI SELATAN,23075,3879,19196,16299,35495,2021-11-18
3173031003,JAKARTA BARAT,TAMAN SARI,MAPHAR,16461,3016,13445,11323,24768,2021-11-18
3172041003,JAKARTA UTARA,CILINCING,MARUNDA,28943,6455,22488,17054,39542,2021-11-18
3174071001,JAKARTA SELATAN,KEBAYORAN BARU,MELAWAI,2627,502,2125,1958,4083,2021-11-18
3171061001,JAKARTA PUSAT,MENTENG,MENTENG,25624,5512,20112,16125,36237,2021-11-18
3174021005,JAKARTA SELATAN,SETIA BUDI,MENTENG ATAS,27816,4920,22896,19341,42237,2021-11-18
3174011003,JAKARTA SELATAN,TEBET,MENTENG DALAM,36028,6901,29127,24886,54013,2021-11-18
3173081003,JAKARTA BARAT,KEMBANGAN,MERUYA SELATAN,32130,6489,25641,21852,47493,2021-11-18
3173081002,JAKARTA BARAT,KEMBANGAN,MERUYA UTARA,43752,8875,34877,30568,65445,2021-11-18
3175101004,JAKARTA TIMUR,CIPAYUNG,MUNJUL,23871,4291,19580,16715,36295,2021-11-18
3172051002,JAKARTA UTARA,PADEMANGAN,PADEMANGAN BARAT,74240,17128,57112,46628,103740,2021-11-18
3172051001,JAKARTA UTARA,PADEMANGAN,PADEMANGAN TIMUR,37736,6591,31145,27654,58799,2021-11-18
3175011004,JAKARTA TIMUR,MATRAMAN,PAL MERIAM,19769,4006,15763,12833,28596,2021-11-18
3173071001,JAKARTA BARAT,PALMERAH,PALMERAH,63011,13052,49959,41150,91109,2021-11-18
3174081001,JAKARTA SELATAN,PANCORAN,PANCORAN,19421,3824,15597,13068,28665,2021-11-18
3172021003,JAKARTA UTARA,TANJUNG PRIOK,PAPANGGO,39097,7554,31543,26148,57691,2021-11-18
3171021001,JAKARTA PUSAT,SAWAH BESAR,PASAR BARU,12035,2272,9763,8791,18554,2021-11-18
3174021006,JAKARTA SELATAN,SETIA BUDI,PASAR MANGGIS,26752,5152,21600,18049,39649,2021-11-18
3174041001,JAKARTA SELATAN,PASAR MINGGU,PASAR MINGGU,24821,4612,20209,17499,37708,2021-11-18
3171041003,JAKARTA PUSAT,SENEN,PASEBAN,23533,4806,18727,15492,34219,2021-11-18
3173061005,JAKARTA BARAT,KALI DERES,PEGADUNGAN,75587,14549,61038,52727,113765,2021-11-18
3171061002,JAKARTA PUSAT,MENTENG,PEGANGSAAN,23455,4968,18487,14400,32887,2021-11-18
3172061002,JAKARTA UTARA,KELAPA GADING,PEGANGSAAN DUA,49976,8162,41814,38060,79874,2021-11-18
3172011004,JAKARTA UTARA,PENJARINGAN,PEJAGALAN,74578,15211,59367,51600,110967,2021-11-18
3174041006,JAKARTA SELATAN,PASAR MINGGU,PEJATEN BARAT,37346,7125,30221,25618,55839,2021-11-18
3174041005,JAKARTA SELATAN,PASAR MINGGU,PEJATEN TIMUR,57656,12457,45199,37388,82587,2021-11-18
3175051005,JAKARTA TIMUR,PASAR REBO,PEKAYON,43250,7720,35530,29910,65440,2021-11-18
3173041009,JAKARTA BARAT,TAMBORA,PEKOJAN,23587,4418,19169,16298,35467,2021-11-18
3174031003,JAKARTA SELATAN,MAMPANG PRAPATAN,PELA MAMPANG,43522,8387,35135,29774,64909,2021-11-18
3174081005,JAKARTA SELATAN,PANCORAN,PENGADEGAN,21478,3898,17580,15154,32734,2021-11-18
3175061003,JAKARTA TIMUR,CAKUNG,PENGGILINGAN,99255,22484,76771,61956,138727,2021-11-18
3172011001,JAKARTA UTARA,PENJARINGAN,PENJARINGAN,88308,22336,65972,51512,117484,2021-11-18
3174101001,JAKARTA SELATAN,PESANGGRAHAN,PESANGGRAHAN,27545,4657,22888,19852,42740,2021-11-18
3171071004,JAKARTA PUSAT,TANAH ABANG,PETAMBURAN,33271,8650,24621,18879,43500,2021-11-18
3174071008,JAKARTA SELATAN,KEBAYORAN BARU,PETOGOGAN,11499,2195,9304,8033,17337,2021-11-18
3171011004,JAKARTA PUSAT,GAMBIR,PETOJO SELATAN,14692,3260,11432,9774,21206,2021-11-18
3171011003,JAKARTA PUSAT,GAMBIR,PETOJO UTARA,17458,3717,13741,11445,25186,2021-11-18
3174101004,JAKARTA SELATAN,PESANGGRAHAN,PETUKANGAN SELATAN,37187,7542,29645,25254,54899,2021-11-18
3174101003,JAKARTA SELATAN,PESANGGRAHAN,PETUKANGAN UTARA,53716,11347,42369,35577,77946,2021-11-18
3175081002,JAKARTA TIMUR,MAKASAR,PINANG RANTI,27198,5804,21394,17804,39198,2021-11-18
3173031008,JAKARTA BARAT,TAMAN SARI,PINANGSIA,10729,1853,8876,7437,16313,2021-11-18
3175011001,JAKARTA TIMUR,MATRAMAN,PISANGAN BARU,31776,6432,25344,20431,45775,2021-11-18
3175021002,JAKARTA TIMUR,PULO GADUNG,PISANGAN TIMUR,41011,7452,33559,28642,62201,2021-11-18
3172011005,JAKARTA UTARA,PENJARINGAN,PLUIT,47783,9108,38675,34197,72872,2021-11-18
3175071002,JAKARTA TIMUR,DUREN SAWIT,PONDOK BAMBU,61550,12752,48798,41042,89840,2021-11-18
3175071004,JAKARTA TIMUR,DUREN SAWIT,PONDOK KELAPA,72015,14070,57945,50135,108080,2021-11-18
3175071007,JAKARTA TIMUR,DUREN SAWIT,PONDOK KOPI,35367,6528,28839,23275,52114,2021-11-18
3174061003,JAKARTA SELATAN,CILANDAK,PONDOK LABU,46464,7655,38809,34147,72956,2021-11-18
3174051002,JAKARTA SELATAN,KEBAYORAN LAMA,PONDOK PINANG,56169,10611,45558,39377,84935,2021-11-18
3175101003,JAKARTA TIMUR,CIPAYUNG,PONDOK RANGGON,25574,4713,20861,17730,38591,2021-11-18
3101011003,KAB.ADM.KEP.SERIBU,KEP. SERIBU UTARA,PULAU HARAPAN,2060,219,1841,1615,3456,2021-11-18
3101011002,KAB.ADM.KEP.SERIBU,KEP. SERIBU UTARA,PULAU KELAPA,5528,593,4935,4085,9020,2021-11-18
3101011001,KAB.ADM.KEP.SERIBU,KEP. SERIBU UTARA,PULAU PANGGANG,5450,433,5017,4500,9517,2021-11-18
3101021003,KAB.ADM.KEP.SERIBU,KEP. SERIBU SELATAN,PULAU PARI,2765,192,2573,2433,5006,2021-11-18
3101021002,KAB.ADM.KEP.SERIBU,KEP. SERIBU SELATAN,PULAU TIDUNG,4553,365,4188,3848,8036,2021-11-18
3101021001,KAB.ADM.KEP.SERIBU,KEP. SERIBU SELATAN,PULAU UNTUNG JAWA,1941,158,1783,1662,3445,2021-11-18
3174071007,JAKARTA SELATAN,KEBAYORAN BARU,PULO,5835,999,4836,4461,9297,2021-11-18
3175021001,JAKARTA TIMUR,PULO GADUNG,PULO GADUNG,34422,7429,26993,22760,49753,2021-11-18
3175061005,JAKARTA TIMUR,CAKUNG,PULO GEBANG,97301,18453,78848,64722,143570,2021-11-18
3174041004,JAKARTA SELATAN,PASAR MINGGU,RAGUNAN,39616,7142,32474,28000,60474,2021-11-18
3175091005,JAKARTA TIMUR,CIRACAS,RAMBUTAN,36771,8463,28308,23240,51548,2021-11-18
3172031006,JAKARTA UTARA,KOJA,RAWA BADAK SELATAN,42179,9839,32340,25799,58139,2021-11-18
3172031004,JAKARTA UTARA,KOJA,RAWA BADAK UTARA,34408,7577,26831,21901,48732,2021-11-18
3174071005,JAKARTA SELATAN,KEBAYORAN BARU,RAWA BARAT,5625,991,4634,4134,8768,2021-11-18
3173011003,JAKARTA BARAT,CENGKARENG,RAWA BUAYA,63799,12400,51399,42466,93865,2021-11-18
3175031004,JAKARTA TIMUR,JATINEGARA,RAWA BUNGA,21434,5084,16350,13402,29752,2021-11-18
3174081003,JAKARTA SELATAN,PANCORAN,RAWA JATI,20509,3861,16648,14399,31047,2021-11-18
3175061002,JAKARTA TIMUR,CAKUNG,RAWA TERATE,24637,4401,20236,16668,36904,2021-11-18
3175021005,JAKARTA TIMUR,PULO GADUNG,RAWAMANGUN,37612,7294,30318,25978,56296,2021-11-18
3171051003,JAKARTA PUSAT,CEMPAKA PUTIH,RAWASARI,21967,4396,17571,15187,32758,2021-11-18
3173041010,JAKARTA BARAT,TAMBORA,ROA MALAKA,3484,608,2876,2592,5468,2021-11-18
3172041006,JAKARTA UTARA,CILINCING,ROROTAN,41668,8212,33456,27098,60554,2021-11-18
3174071004,JAKARTA SELATAN,KEBAYORAN BARU,SELONG,2842,542,2300,2139,4439,2021-11-18
3173061002,JAKARTA BARAT,KALI DERES,SEMANAN,71354,14773,56581,46088,102669,2021-11-18
3172041007,JAKARTA UTARA,CILINCING,SEMPER BARAT,68587,13118,55469,46561,102030,2021-11-18
3172041005,JAKARTA UTARA,CILINCING,SEMPER TIMUR,36267,7639,28628,23513,52141,2021-11-18
3174071006,JAKARTA SELATAN,KEBAYORAN BARU,SENAYAN,2771,643,2128,1858,3986,2021-11-18
3171041001,JAKARTA PUSAT,SENEN,SENEN,6804,1424,5380,4504,9884,2021-11-18
3171031004,JAKARTA PUSAT,KEMAYORAN,SERDANG,29668,5707,23961,20149,44110,2021-11-18
3174021001,JAKARTA SELATAN,SETIA BUDI,SETIA BUDI,3023,600,2423,2093,4516,2021-11-18
3175101005,JAKARTA TIMUR,CIPAYUNG,SETU,20572,4027,16545,13653,30198,2021-11-18
3173071002,JAKARTA BARAT,PALMERAH,SLIPI,16591,2928,13663,11658,25321,2021-11-18
3173081004,JAKARTA BARAT,KEMBANGAN,SRENGSENG,45523,10069,35454,30270,65724,2021-11-18
3174091002,JAKARTA SELATAN,JAGAKARSA,SRENGSENG SAWAH,58196,8863,49333,42453,91786,2021-11-18
3173051003,JAKARTA BARAT,KEBON JERUK,SUKABUMI SELATAN,37033,8187,28846,22717,51563,2021-11-18
3173051002,JAKARTA BARAT,KEBON JERUK,SUKABUMI UTARA,38290,8833,29457,23439,52896,2021-11-18
3172041002,JAKARTA UTARA,CILINCING,SUKAPURA,53949,11962,41987,34896,76883,2021-11-18
3171031007,JAKARTA PUSAT,KEMAYORAN,SUMUR BATU,22717,4285,18432,15799,34231,2021-11-18
3172021004,JAKARTA UTARA,TANJUNG PRIOK,SUNGAI BAMBU,29876,5900,23976,20066,44042,2021-11-18
3172021006,JAKARTA UTARA,TANJUNG PRIOK,SUNTER AGUNG,71805,12246,59559,52579,112138,2021-11-18
3172021002,JAKARTA UTARA,TANJUNG PRIOK,SUNTER JAYA,63031,10918,52113,45658,97771,2021-11-18
3175091004,JAKARTA TIMUR,CIRACAS,SUSUKAN,38257,7107,31150,26311,57461,2021-11-18
3173031001,JAKARTA BARAT,TAMAN SARI,TAMAN SARI,14348,2587,11761,10187,21948,2021-11-18
3173041001,JAKARTA BARAT,TAMBORA,TAMBORA,10204,2175,8029,6516,14545,2021-11-18
3173041004,JAKARTA BARAT,TAMBORA,TANAH SEREAL,26387,4417,21970,18607,40577,2021-11-18
3171081004,JAKARTA PUSAT,JOHAR BARU,TANAH TINGGI,37693,7090,30603,25039,55642,2021-11-18
3173031004,JAKARTA BARAT,TAMAN SARI,TANGKI,13324,2179,11145,9515,20660,2021-11-18
3174091005,JAKARTA SELATAN,JAGAKARSA,TANJUNG BARAT,39770,6651,33119,27838,60957,2021-11-18
3173021005,JAKARTA BARAT,GROGOL PETAMBURAN,TANJUNG DUREN SELATAN,25337,4757,20580,18364,38944,2021-11-18
3173021002,JAKARTA BARAT,GROGOL PETAMBURAN,TANJUNG DUREN UTARA,17010,2833,14177,12844,27021,2021-11-18
3172021001,JAKARTA UTARA,TANJUNG PRIOK,TANJUNG PRIOK,34588,7048,27540,22681,50221,2021-11-18
3174011002,JAKARTA SELATAN,TEBET,TEBET BARAT,21194,3370,17824,15844,33668,2021-11-18
3174011001,JAKARTA SELATAN,TEBET,TEBET TIMUR,18199,2882,15317,13928,29245,2021-11-18
3173061003,JAKARTA BARAT,KALI DERES,TEGAL ALUR,83647,17081,66566,55555,122121,2021-11-18
3174031004,JAKARTA SELATAN,MAMPANG PRAPATAN,TEGAL PARANG,32401,7033,25368,20102,45470,2021-11-18
3173021003,JAKARTA BARAT,GROGOL PETAMBURAN,TOMANG,29605,5377,24228,20988,45216,2021-11-18
3172031005,JAKARTA UTARA,KOJA,TUGU SELATAN,39122,8601,30521,24927,55448,2021-11-18
3172031002,JAKARTA UTARA,KOJA,TUGU UTARA,67670,15746,51924,41597,93521,2021-11-18
3175061006,JAKARTA TIMUR,CAKUNG,UJUNG MENTENG,29934,5074,24860,21295,46155,2021-11-18
3174101005,JAKARTA SELATAN,PESANGGRAHAN,ULUJAMI,40544,8981,31563,26254,57817,2021-11-18
3175011006,JAKARTA TIMUR,MATRAMAN,UTAN KAYU SELATAN,33511,5922,27589,23093,50682,2021-11-18
3175011002,JAKARTA TIMUR,MATRAMAN,UTAN KAYU UTARA,28169,5753,22416,18557,40973,2021-11-18
3171031008,JAKARTA PUSAT,KEMAYORAN,UTAN PANJANG,29208,5731,23477,19180,42657,2021-11-18
3172021007,JAKARTA UTARA,TANJUNG PRIOK,WARAKAS,44401,8040,36361,29675,66036,2021-11-18
3173021007,JAKARTA BARAT,GROGOL PETAMBURAN,WIJAYA KUSUMA,38934,7992,30942,26326,57268,2021-11-18
3172051003,JAKARTA UTARA,PADEMANGAN,ANCOL,23947,5687,18260,15145,33405,2021-11-19
3173041007,JAKARTA BARAT,TAMBORA,ANGKE,29381,6106,23275,19039,42314,2021-11-19
3175041005,JAKARTA TIMUR,KRAMAT JATI,BALE KAMBANG,29074,7012,22062,17599,39661,2021-11-19
3175031003,JAKARTA TIMUR,JATINEGARA,BALI MESTER,9752,1994,7758,6596,14354,2021-11-19
3175101006,JAKARTA TIMUR,CIPAYUNG,BAMBU APUS,26285,4754,21531,18254,39785,2021-11-19
3174031002,JAKARTA SELATAN,MAMPANG PRAPATAN,BANGKA,21566,4462,17104,14361,31465,2021-11-19
3175051002,JAKARTA TIMUR,PASAR REBO,BARU,23886,3877,20009,17417,37426,2021-11-19
3175041004,JAKARTA TIMUR,KRAMAT JATI,BATU AMPAR,47898,11315,36583,29896,66479,2021-11-19
3171071002,JAKARTA PUSAT,TANAH ABANG,BENDUNGAN HILIR,21494,4270,17224,14851,32075,2021-11-19
3175031002,JAKARTA TIMUR,JATINEGARA,BIDARA CINA,36689,8612,28077,22863,50940,2021-11-19
3174101002,JAKARTA SELATAN,PESANGGRAHAN,BINTARO,53098,10469,42629,37234,79863,2021-11-19
3174011005,JAKARTA SELATAN,TEBET,BUKIT DURI,34183,6726,27457,23106,50563,2021-11-19
3171041006,JAKARTA PUSAT,SENEN,BUNGUR,18144,3698,14446,12059,26505,2021-11-19
3175061007,JAKARTA TIMUR,CAKUNG,CAKUNG BARAT,57724,11591,46133,38366,84499,2021-11-19
3175061004,JAKARTA TIMUR,CAKUNG,CAKUNG TIMUR,58287,11222,47065,39571,86636,2021-11-19
3175041007,JAKARTA TIMUR,KRAMAT JATI,CAWANG,32762,6852,25910,21069,46979,2021-11-19
3175101008,JAKARTA TIMUR,CIPAYUNG,CEGER,18932,3611,15321,12924,28245,2021-11-19
3171031006,JAKARTA PUSAT,KEMAYORAN,CEMPAKA BARU,32581,6031,26550,21392,47942,2021-11-19
3171051002,JAKARTA PUSAT,CEMPAKA PUTIH,CEMPAKA PUTIH BARAT,35885,7490,28395,24519,52914,2021-11-19
3171051001,JAKARTA PUSAT,CEMPAKA PUTIH,CEMPAKA PUTIH TIMUR,24292,4905,19387,17158,36545,2021-11-19
3173011001,JAKARTA BARAT,CENGKARENG,CENGKARENG BARAT,66284,12912,53372,46162,99534,2021-11-19
3173011006,JAKARTA BARAT,CENGKARENG,CENGKARENG TIMUR,81027,15669,65358,54952,120310,2021-11-19
3175091002,JAKARTA TIMUR,CIRACAS,CIBUBUR,66364,11190,55174,47277,102451,2021-11-19
3171011002,JAKARTA PUSAT,GAMBIR,CIDENG,15390,2969,12421,10936,23357,2021-11-19
3174091003,JAKARTA SELATAN,JAGAKARSA,CIGANJUR,38497,6327,32170,27105,59275,2021-11-19
3175051003,JAKARTA TIMUR,PASAR REBO,CIJANTUNG,41419,7516,33903,28675,62578,2021-11-19
3171061003,JAKARTA PUSAT,MENTENG,CIKINI,8274,1469,6805,5478,12283,2021-11-19
3174081006,JAKARTA SELATAN,PANCORAN,CIKOKO,10547,1784,8763,7661,16424,2021-11-19
3174061001,JAKARTA SELATAN,CILANDAK,CILANDAK BARAT,51752,8938,42814,37838,80652,2021-11-19
3174041003,JAKARTA SELATAN,PASAR MINGGU,CILANDAK TIMUR,25145,4514,20631,17784,38415,2021-11-19
3175101002,JAKARTA TIMUR,CIPAYUNG,CILANGKAP,27635,4803,22832,19659,42491,2021-11-19
3175041006,JAKARTA TIMUR,KRAMAT JATI,CILILITAN,40181,8354,31827,26237,58064,2021-11-19
3172041001,JAKARTA UTARA,CILINCING,CILINCING,43609,10245,33364,26296,59660,2021-11-19
3175101001,JAKARTA TIMUR,CIPAYUNG,CIPAYUNG,26104,4475,21629,18771,40400,2021-11-19
3174091006,JAKARTA SELATAN,JAGAKARSA,CIPEDAK,38303,6203,32100,27434,59534,2021-11-19
3174061005,JAKARTA SELATAN,CILANDAK,CIPETE SELATAN,26704,5000,21704,19250,40954,2021-11-19
3174071010,JAKARTA SELATAN,KEBAYORAN BARU,CIPETE UTARA,34102,6336,27766,23503,51269,2021-11-19
3175021003,JAKARTA TIMUR,PULO GADUNG,CIPINANG,39306,7033,32273,27147,59420,2021-11-19
3175031007,JAKARTA TIMUR,JATINEGARA,CIPINANG BESAR SELATAN,35212,8190,27022,21539,48561,2021-11-19
3175031008,JAKARTA TIMUR,JATINEGARA,CIPINANG BESAR UTARA,45319,10454,34865,27582,62447,2021-11-19
3175031005,JAKARTA TIMUR,JATINEGARA,CIPINANG CEMPEDAK,32824,7019,25805,22213,48018,2021-11-19
3175081005,JAKARTA TIMUR,MAKASAR,CIPINANG MELAYU,42308,8014,34294,29515,63809,2021-11-19
3175031006,JAKARTA TIMUR,JATINEGARA,CIPINANG MUARA,55243,11493,43750,36100,79850,2021-11-19
3174051003,JAKARTA SELATAN,KEBAYORAN LAMA,CIPULIR,39937,8284,31653,26010,57663,2021-11-19
3175091001,JAKARTA TIMUR,CIRACAS,CIRACAS,64594,11606,52988,44519,97507,2021-11-19
3175041003,JAKARTA TIMUR,KRAMAT JATI,DUKUH,24609,4458,20151,16805,36956,2021-11-19
3175071001,JAKARTA TIMUR,DUREN SAWIT,DUREN SAWIT,61160,12676,48484,40826,89310,2021-11-19
3174081004,JAKARTA SELATAN,PANCORAN,DUREN TIGA,28319,5500,22819,19318,42137,2021-11-19
3173051005,JAKARTA BARAT,KEBON JERUK,DURI KEPA,60138,11620,48518,42201,90719,2021-11-19
3173011002,JAKARTA BARAT,CENGKARENG,DURI KOSAMBI,77923,16292,61631,50125,111756,2021-11-19
3171011006,JAKARTA PUSAT,GAMBIR,DURI PULO,19610,4069,15541,12621,28162,2021-11-19
3173041011,JAKARTA BARAT,TAMBORA,DURI SELATAN,14259,2496,11763,10065,21828,2021-11-19
3173041003,JAKARTA BARAT,TAMBORA,DURI UTARA,19844,3514,16330,13564,29894,2021-11-19
3171081003,JAKARTA PUSAT,JOHAR BARU,GALUR,18243,3516,14727,12026,26753,2021-11-19
3171011001,JAKARTA PUSAT,GAMBIR,GAMBIR,2191,452,1739,1519,3258,2021-11-19
3174061004,JAKARTA SELATAN,CILANDAK,GANDARIA SELATAN,22119,4151,17968,15506,33474,2021-11-19
3174071009,JAKARTA SELATAN,KEBAYORAN BARU,GANDARIA UTARA,39922,7764,32158,27579,59737,2021-11-19
3175051001,JAKARTA TIMUR,PASAR REBO,GEDONG,35755,7032,28723,24540,53263,2021-11-19
3171071001,JAKARTA PUSAT,TANAH ABANG,GELORA,3127,598,2529,2207,4736,2021-11-19
3173031007,JAKARTA BARAT,TAMAN SARI,GLODOK,7837,1157,6680,6060,12740,2021-11-19
3171061004,JAKARTA PUSAT,MENTENG,GONDANGDIA,4100,904,3196,2929,6125,2021-11-19
3173021001,JAKARTA BARAT,GROGOL PETAMBURAN,GROGOL,16876,3298,13578,11610,25188,2021-11-19
3174051005,JAKARTA SELATAN,KEBAYORAN LAMA,GROGOL SELATAN,44251,8665,35586,29817,65403,2021-11-19
3174051004,JAKARTA SELATAN,KEBAYORAN LAMA,GROGOL UTARA,42494,8519,33975,28566,62541,2021-11-19
3174021007,JAKARTA SELATAN,SETIA BUDI,GUNTUR,3985,734,3251,2894,6145,2021-11-19
3174071002,JAKARTA SELATAN,KEBAYORAN BARU,GUNUNG,9436,1721,7715,6928,14643,2021-11-19
3171031005,JAKARTA PUSAT,KEMAYORAN,GUNUNG SAHARI SELATAN,19199,3742,15457,13137,28594,2021-11-19
3171021004,JAKARTA PUSAT,SAWAH BESAR,GUNUNG SAHARI UTARA,16650,2888,13762,12368,26130,2021-11-19
3175081004,JAKARTA TIMUR,MAKASAR,HALIM PERDANA KUSUMAH,28363,3597,24766,22747,47513,2021-11-19
3171031003,JAKARTA PUSAT,KEMAYORAN,HARAPAN MULIA,22557,4381,18176,15010,33186,2021-11-19
3174091001,JAKARTA SELATAN,JAGAKARSA,JAGAKARSA,62389,10029,52360,44722,97082,2021-11-19
3175021007,JAKARTA TIMUR,PULO GADUNG,JATI,32757,6015,26742,23455,50197,2021-11-19
3174041002,JAKARTA SELATAN,PASAR MINGGU,JATI PADANG,37502,7137,30365,25940,56305,2021-11-19
3173071004,JAKARTA BARAT,PALMERAH,JATI PULO,28738,5607,23131,18712,41843,2021-11-19
3175061001,JAKARTA TIMUR,CAKUNG,JATINEGARA,84160,17515,66645,55586,122231,2021-11-19
3175021004,JAKARTA TIMUR,PULO GADUNG,JATINEGARA KAUM,24632,4294,20338,16813,37151,2021-11-19
3173021004,JAKARTA BARAT,GROGOL PETAMBURAN,JELAMBAR,30266,5417,24849,21996,46845,2021-11-19
3173021006,JAKARTA BARAT,GROGOL PETAMBURAN,JELAMBAR BARU,38246,6855,31391,27587,58978,2021-11-19
3173041006,JAKARTA BARAT,TAMBORA,JEMBATAN BESI,29314,6986,22328,17698,40026,2021-11-19
3173041008,JAKARTA BARAT,TAMBORA,JEMBATAN LIMA,21021,4752,16269,13069,29338,2021-11-19
3173081005,JAKARTA BARAT,KEMBANGAN,JOGLO,40839,8020,32819,28052,60871,2021-11-19
3171081001,JAKARTA PUSAT,JOHAR BARU,JOHAR BARU,37488,6842,30646,26146,56792,2021-11-19
3173041002,JAKARTA BARAT,TAMBORA,KALI ANYAR,23856,4617,19239,15523,34762,2021-11-19
3172041004,JAKARTA UTARA,CILINCING,KALIBARU,67684,18199,49485,35501,84986,2021-11-19
3174081002,JAKARTA SELATAN,PANCORAN,KALIBATA,41994,9322,32672,27006,59678,2021-11-19
3173061001,JAKARTA BARAT,KALI DERES,KALIDERES,72447,14257,58190,49743,107933,2021-11-19
3175051004,JAKARTA TIMUR,PASAR REBO,KALISARI,43212,7533,35679,30499,66178,2021-11-19
3173061004,JAKARTA BARAT,KALI DERES,KAMAL,53783,12321,41462,33618,75080,2021-11-19
3172011002,JAKARTA UTARA,PENJARINGAN,KAMAL MUARA,12930,2267,10663,9139,19802,2021-11-19
3171071007,JAKARTA PUSAT,TANAH ABANG,KAMPUNG BALI,11358,2423,8935,6994,15929,2021-11-19
3175031001,JAKARTA TIMUR,JATINEGARA,KAMPUNG MELAYU,25717,5772,19945,15758,35703,2021-11-19
3171081002,JAKARTA PUSAT,JOHAR BARU,KAMPUNG RAWA,21237,3459,17778,14402,32180,2021-11-19
3175041002,JAKARTA TIMUR,KRAMAT JATI,KAMPUNG TENGAH,43993,10810,33183,26951,60134,2021-11-19
3173011005,JAKARTA BARAT,CENGKARENG,KAPUK,134466,31734,102732,84157,186889,2021-11-19
3172011003,JAKARTA UTARA,PENJARINGAN,KAPUK MUARA,35781,6743,29038,25686,54724,2021-11-19
3171021002,JAKARTA PUSAT,SAWAH BESAR,KARANG ANYAR,25761,4803,20958,17788,38746,2021-11-19
3174021004,JAKARTA SELATAN,SETIA BUDI,KARET,9623,1829,7794,6575,14369,2021-11-19
3174021003,JAKARTA SELATAN,SETIA BUDI,KARET KUNINGAN,16055,3062,12993,11141,24134,2021-11-19
3174021002,JAKARTA SELATAN,SETIA BUDI,KARET SEMANGGI,2770,550,2220,1978,4198,2021-11-19
3171071003,JAKARTA PUSAT,TANAH ABANG,KARET TENGSIN,19271,3656,15615,12925,28540,2021-11-19
3171021003,JAKARTA PUSAT,SAWAH BESAR,KARTINI,22292,4112,18180,15777,33957,2021-11-19
3175011003,JAKARTA TIMUR,MATRAMAN,KAYU MANIS,25284,5204,20080,16298,36378,2021-11-19
3175021006,JAKARTA TIMUR,PULO GADUNG,KAYU PUTIH,40696,7547,33149,29276,62425,2021-11-19
3173031006,JAKARTA BARAT,TAMAN SARI,KEAGUNGAN,17387,3173,14214,11800,26014,2021-11-19
3174041007,JAKARTA SELATAN,PASAR MINGGU,KEBAGUSAN,44552,8651,35901,30149,66050,2021-11-19
3174051006,JAKARTA SELATAN,KEBAYORAN LAMA,KEBAYORAN LAMA SELATAN,41212,7494,33718,29105,62823,2021-11-19
3174051001,JAKARTA SELATAN,KEBAYORAN LAMA,KEBAYORAN LAMA UTARA,42422,8622,33800,28394,62194,2021-11-19
3174011004,JAKARTA SELATAN,TEBET,KEBON BARU,35165,6480,28685,24449,53134,2021-11-19
3172021005,JAKARTA UTARA,TANJUNG PRIOK,KEBON BAWANG,50952,10062,40890,34475,75365,2021-11-19
3173051001,JAKARTA BARAT,KEBON JERUK,KEBON JERUK,53887,10726,43161,35440,78601,2021-11-19
3171071006,JAKARTA PUSAT,TANAH ABANG,KEBON KACANG,21531,5048,16483,13212,29695,2021-11-19
3171011005,JAKARTA PUSAT,GAMBIR,KEBON KELAPA,10163,2004,8159,6994,15153,2021-11-19
3171031002,JAKARTA PUSAT,KEMAYORAN,KEBON KOSONG,30019,5902,24117,19986,44103,2021-11-19
3175011005,JAKARTA TIMUR,MATRAMAN,KEBON MANGGIS,16490,3155,13335,11173,24508,2021-11-19
3171071005,JAKARTA PUSAT,TANAH ABANG,KEBON MELATI,32206,8473,23733,17928,41661,2021-11-19
3175081003,JAKARTA TIMUR,MAKASAR,KEBON PALA,46614,8957,37657,31790,69447,2021-11-19
3171061005,JAKARTA PUSAT,MENTENG,KEBON SIRIH,12299,2585,9714,7902,17616,2021-11-19
3173011004,JAKARTA BARAT,CENGKARENG,KEDAUNG KALI ANGKE,32612,6180,26432,22491,48923,2021-11-19
3173051007,JAKARTA BARAT,KEBON JERUK,KEDOYA SELATAN,32165,5779,26386,22033,48419,2021-11-19
3173051006,JAKARTA BARAT,KEBON JERUK,KEDOYA UTARA,45740,8585,37155,31669,68824,2021-11-19
3173051004,JAKARTA BARAT,KEBON JERUK,KELAPA DUA,23565,4527,19038,16055,35093,2021-11-19
3175091003,JAKARTA TIMUR,CIRACAS,KELAPA DUA WETAN,46875,7824,39051,33490,72541,2021-11-19
3172061003,JAKARTA UTARA,KELAPA GADING,KELAPA GADING BARAT,35717,6135,29582,26915,56497,2021-11-19
3172061001,JAKARTA UTARA,KELAPA GADING,KELAPA GADING TIMUR,33592,5062,28530,26618,55148,2021-11-19
3173071005,JAKARTA BARAT,PALMERAH,KEMANGGISAN,32139,5963,26176,22389,48565,2021-11-19
3171031001,JAKARTA PUSAT,KEMAYORAN,KEMAYORAN,20708,4059,16649,13858,30507,2021-11-19
3173081006,JAKARTA BARAT,KEMBANGAN,KEMBANGAN SELATAN,27130,5577,21553,18778,40331,2021-11-19
3173081001,JAKARTA BARAT,KEMBANGAN,KEMBANGAN UTARA,54451,11703,42748,35899,78647,2021-11-19
3171041002,JAKARTA PUSAT,SENEN,KENARI,9579,1837,7742,6654,14396,2021-11-19
3173041005,JAKARTA BARAT,TAMBORA,KERENDANG,19973,3966,16007,13159,29166,2021-11-19
3175071003,JAKARTA TIMUR,DUREN SAWIT,KLENDER,69978,16141,53837,43554,97391,2021-11-19
3172031001,JAKARTA UTARA,KOJA,KOJA,28175,6253,21922,17970,39892,2021-11-19
3173071006,JAKARTA BARAT,PALMERAH,KOTA BAMBU SELATAN,21158,4083,17075,13577,30652,2021-11-19
3173071003,JAKARTA BARAT,PALMERAH,KOTA BAMBU UTARA,24995,5048,19947,15690,35637,2021-11-19
3171041004,JAKARTA PUSAT,SENEN,KRAMAT,28835,6826,22009,16980,38989,2021-11-19
3175041001,JAKARTA TIMUR,KRAMAT JATI,KRAMAT JATI,34144,7094,27050,22265,49315,2021-11-19
3174071003,JAKARTA SELATAN,KEBAYORAN BARU,KRAMAT PELA,14413,2734,11679,10177,21856,2021-11-19
3173031002,JAKARTA BARAT,TAMAN SARI,KRUKUT,19244,3570,15674,12902,28576,2021-11-19
3174031005,JAKARTA SELATAN,MAMPANG PRAPATAN,KUNINGAN BARAT,12785,2289,10496,8929,19425,2021-11-19
3174021008,JAKARTA SELATAN,SETIA BUDI,KUNINGAN TIMUR,6008,1166,4842,4185,9027,2021-11-19
3171041005,JAKARTA PUSAT,SENEN,KWITANG,15486,3368,12118,9857,21975,2021-11-19
3172031003,JAKARTA UTARA,KOJA,LAGOA,59065,13713,45352,36359,81711,2021-11-19
3174061002,JAKARTA SELATAN,CILANDAK,LEBAK BULUS,37626,6952,30674,27264,57938,2021-11-19
3174091004,JAKARTA SELATAN,JAGAKARSA,LENTENG AGUNG,53946,9452,44494,36962,81456,2021-11-19
3175101007,JAKARTA TIMUR,CIPAYUNG,LUBANG BUAYA,63547,11733,51814,43614,95428,2021-11-19
3175081001,JAKARTA TIMUR,MAKASAR,MAKASAR,34390,6167,28223,24448,52671,2021-11-19
3175071006,JAKARTA TIMUR,DUREN SAWIT,MALAKA JAYA,30927,5180,25747,22423,48170,2021-11-19
3175071005,JAKARTA TIMUR,DUREN SAWIT,MALAKA SARI,27530,4457,23073,20211,43284,2021-11-19
3174031001,JAKARTA SELATAN,MAMPANG PRAPATAN,MAMPANG PRAPATAN,18159,3641,14518,12177,26695,2021-11-19
3173031005,JAKARTA BARAT,TAMAN SARI,MANGGA BESAR,7707,1277,6430,5721,12151,2021-11-19
3171021005,JAKARTA PUSAT,SAWAH BESAR,MANGGA DUA SELATAN,27442,5564,21878,18751,40629,2021-11-19
3174011007,JAKARTA SELATAN,TEBET,MANGGARAI,28373,4871,23502,19449,42951,2021-11-19
3174011006,JAKARTA SELATAN,TEBET,MANGGARAI SELATAN,23075,3778,19297,16427,35724,2021-11-19
3173031003,JAKARTA BARAT,TAMAN SARI,MAPHAR,16461,3003,13458,11363,24821,2021-11-19
3172041003,JAKARTA UTARA,CILINCING,MARUNDA,28943,6420,22523,17173,39696,2021-11-19
3174071001,JAKARTA SELATAN,KEBAYORAN BARU,MELAWAI,2627,502,2125,1966,4091,2021-11-19
3171061001,JAKARTA PUSAT,MENTENG,MENTENG,25624,5485,20139,16223,36362,2021-11-19
3174021005,JAKARTA SELATAN,SETIA BUDI,MENTENG ATAS,27816,4893,22923,19443,42366,2021-11-19
3174011003,JAKARTA SELATAN,TEBET,MENTENG DALAM,36028,6861,29167,25029,54196,2021-11-19
3173081003,JAKARTA BARAT,KEMBANGAN,MERUYA SELATAN,32130,6457,25673,21954,47627,2021-11-19
3173081002,JAKARTA BARAT,KEMBANGAN,MERUYA UTARA,43752,8826,34926,30722,65648,2021-11-19
3175101004,JAKARTA TIMUR,CIPAYUNG,MUNJUL,23871,4277,19594,16765,36359,2021-11-19
3172051002,JAKARTA UTARA,PADEMANGAN,PADEMANGAN BARAT,74240,17060,57180,46812,103992,2021-11-19
3172051001,JAKARTA UTARA,PADEMANGAN,PADEMANGAN TIMUR,37736,6557,31179,27756,58935,2021-11-19
3175011004,JAKARTA TIMUR,MATRAMAN,PAL MERIAM,19769,3962,15807,12910,28717,2021-11-19
3173071001,JAKARTA BARAT,PALMERAH,PALMERAH,63011,12932,50079,41365,91444,2021-11-19
3174081001,JAKARTA SELATAN,PANCORAN,PANCORAN,19421,3805,15616,13155,28771,2021-11-19
3172021003,JAKARTA UTARA,TANJUNG PRIOK,PAPANGGO,39097,7524,31573,26260,57833,2021-11-19
3171021001,JAKARTA PUSAT,SAWAH BESAR,PASAR BARU,12035,2259,9776,8828,18604,2021-11-19
3174021006,JAKARTA SELATAN,SETIA BUDI,PASAR MANGGIS,26752,5127,21625,18147,39772,2021-11-19
3174041001,JAKARTA SELATAN,PASAR MINGGU,PASAR MINGGU,24821,4589,20232,17559,37791,2021-11-19
3171041003,JAKARTA PUSAT,SENEN,PASEBAN,23533,4784,18749,15544,34293,2021-11-19
3173061005,JAKARTA BARAT,KALI DERES,PEGADUNGAN,75587,14448,61139,52938,114077,2021-11-19
3171061002,JAKARTA PUSAT,MENTENG,PEGANGSAAN,23455,4942,18513,14455,32968,2021-11-19
3172061002,JAKARTA UTARA,KELAPA GADING,PEGANGSAAN DUA,49976,8143,41833,38183,80016,2021-11-19
3172011004,JAKARTA UTARA,PENJARINGAN,PEJAGALAN,74578,15148,59430,51852,111282,2021-11-19
3174041006,JAKARTA SELATAN,PASAR MINGGU,PEJATEN BARAT,37346,7080,30266,25742,56008,2021-11-19
3174041005,JAKARTA SELATAN,PASAR MINGGU,PEJATEN TIMUR,57656,12343,45313,37505,82818,2021-11-19
3175051005,JAKARTA TIMUR,PASAR REBO,PEKAYON,43250,7686,35564,30072,65636,2021-11-19
3173041009,JAKARTA BARAT,TAMBORA,PEKOJAN,23587,4397,19190,16365,35555,2021-11-19
3174031003,JAKARTA SELATAN,MAMPANG PRAPATAN,PELA MAMPANG,43522,8351,35171,29950,65121,2021-11-19
3174081005,JAKARTA SELATAN,PANCORAN,PENGADEGAN,21478,3875,17603,15222,32825,2021-11-19
3175061003,JAKARTA TIMUR,CAKUNG,PENGGILINGAN,99255,22403,76852,62305,139157,2021-11-19
3172011001,JAKARTA UTARA,PENJARINGAN,PENJARINGAN,88308,22243,66065,51778,117843,2021-11-19
3174101001,JAKARTA SELATAN,PESANGGRAHAN,PESANGGRAHAN,27545,4643,22902,19927,42829,2021-11-19
3171071004,JAKARTA PUSAT,TANAH ABANG,PETAMBURAN,33271,8613,24658,18990,43648,2021-11-19
3174071008,JAKARTA SELATAN,KEBAYORAN BARU,PETOGOGAN,11499,2182,9317,8066,17383,2021-11-19
3171011004,JAKARTA PUSAT,GAMBIR,PETOJO SELATAN,14692,3240,11452,9804,21256,2021-11-19
3171011003,JAKARTA PUSAT,GAMBIR,PETOJO UTARA,17458,3702,13756,11491,25247,2021-11-19
3174101004,JAKARTA SELATAN,PESANGGRAHAN,PETUKANGAN SELATAN,37187,7515,29672,25356,55028,2021-11-19
3174101003,JAKARTA SELATAN,PESANGGRAHAN,PETUKANGAN UTARA,53716,11273,42443,35775,78218,2021-11-19
3175081002,JAKARTA TIMUR,MAKASAR,PINANG RANTI,27198,5784,21414,17895,39309,2021-11-19
3173031008,JAKARTA BARAT,TAMAN SARI,PINANGSIA,10729,1843,8886,7466,16352,2021-11-19
3175011001,JAKARTA TIMUR,MATRAMAN,PISANGAN BARU,31776,6393,25383,20572,45955,2021-11-19
3175021002,JAKARTA TIMUR,PULO GADUNG,PISANGAN TIMUR,41011,7414,33597,28760,62357,2021-11-19
3172011005,JAKARTA UTARA,PENJARINGAN,PLUIT,47783,9089,38694,34282,72976,2021-11-19
3175071002,JAKARTA TIMUR,DUREN SAWIT,PONDOK BAMBU,61550,12681,48869,41328,90197,2021-11-19
3175071004,JAKARTA TIMUR,DUREN SAWIT,PONDOK KELAPA,72015,13975,58040,50418,108458,2021-11-19
3175071007,JAKARTA TIMUR,DUREN SAWIT,PONDOK KOPI,35367,6496,28871,23491,52362,2021-11-19
3174061003,JAKARTA SELATAN,CILANDAK,PONDOK LABU,46464,7609,38855,34334,73189,2021-11-19
3174051002,JAKARTA SELATAN,KEBAYORAN LAMA,PONDOK PINANG,56169,10578,45591,39506,85097,2021-11-19
3175101003,JAKARTA TIMUR,CIPAYUNG,PONDOK RANGGON,25574,4697,20877,17777,38654,2021-11-19
3101011003,KAB.ADM.KEP.SERIBU,KEP. SERIBU UTARA,PULAU HARAPAN,2060,218,1842,1620,3462,2021-11-19
3101011002,KAB.ADM.KEP.SERIBU,KEP. SERIBU UTARA,PULAU KELAPA,5528,587,4941,4093,9034,2021-11-19
3101011001,KAB.ADM.KEP.SERIBU,KEP. SERIBU UTARA,PULAU PANGGANG,5450,431,5019,4502,9521,2021-11-19
3101021003,KAB.ADM.KEP.SERIBU,KEP. SERIBU SELATAN,PULAU PARI,2765,192,2573,2439,5012,2021-11-19
3101021002,KAB.ADM.KEP.SERIBU,KEP. SERIBU SELATAN,PULAU TIDUNG,4553,365,4188,3853,8041,2021-11-19
3101021001,KAB.ADM.KEP.SERIBU,KEP. SERIBU SELATAN,PULAU UNTUNG JAWA,1941,157,1784,1662,3446,2021-11-19
3174071007,JAKARTA SELATAN,KEBAYORAN BARU,PULO,5835,996,4839,4473,9312,2021-11-19
3175021001,JAKARTA TIMUR,PULO GADUNG,PULO GADUNG,34422,7393,27029,22859,49888,2021-11-19
3175061005,JAKARTA TIMUR,CAKUNG,PULO GEBANG,97301,18351,78950,65000,143950,2021-11-19
3174041004,JAKARTA SELATAN,PASAR MINGGU,RAGUNAN,39616,7093,32523,28127,60650,2021-11-19
3175091005,JAKARTA TIMUR,CIRACAS,RAMBUTAN,36771,8416,28355,23430,51785,2021-11-19
3172031006,JAKARTA UTARA,KOJA,RAWA BADAK SELATAN,42179,9797,32382,26001,58383,2021-11-19
3172031004,JAKARTA UTARA,KOJA,RAWA BADAK UTARA,34408,7540,26868,22027,48895,2021-11-19
3174071005,JAKARTA SELATAN,KEBAYORAN BARU,RAWA BARAT,5625,989,4636,4153,8789,2021-11-19
3173011003,JAKARTA BARAT,CENGKARENG,RAWA BUAYA,63799,12317,51482,42795,94277,2021-11-19
3175031004,JAKARTA TIMUR,JATINEGARA,RAWA BUNGA,21434,5061,16373,13470,29843,2021-11-19
3174081003,JAKARTA SELATAN,PANCORAN,RAWA JATI,20509,3849,16660,14466,31126,2021-11-19
3175061002,JAKARTA TIMUR,CAKUNG,RAWA TERATE,24637,4377,20260,16734,36994,2021-11-19
3175021005,JAKARTA TIMUR,PULO GADUNG,RAWAMANGUN,37612,7267,30345,26068,56413,2021-11-19
3171051003,JAKARTA PUSAT,CEMPAKA PUTIH,RAWASARI,21967,4378,17589,15254,32843,2021-11-19
3173041010,JAKARTA BARAT,TAMBORA,ROA MALAKA,3484,605,2879,2598,5477,2021-11-19
3172041006,JAKARTA UTARA,CILINCING,ROROTAN,41668,8182,33486,27283,60769,2021-11-19
3174071004,JAKARTA SELATAN,KEBAYORAN BARU,SELONG,2842,542,2300,2143,4443,2021-11-19
3173061002,JAKARTA BARAT,KALI DERES,SEMANAN,71354,14674,56680,46310,102990,2021-11-19
3172041007,JAKARTA UTARA,CILINCING,SEMPER BARAT,68587,13064,55523,46776,102299,2021-11-19
3172041005,JAKARTA UTARA,CILINCING,SEMPER TIMUR,36267,7608,28659,23628,52287,2021-11-19
3174071006,JAKARTA SELATAN,KEBAYORAN BARU,SENAYAN,2771,642,2129,1865,3994,2021-11-19
3171041001,JAKARTA PUSAT,SENEN,SENEN,6804,1419,5385,4523,9908,2021-11-19
3171031004,JAKARTA PUSAT,KEMAYORAN,SERDANG,29668,5660,24008,20244,44252,2021-11-19
3174021001,JAKARTA SELATAN,SETIA BUDI,SETIA BUDI,3023,595,2428,2106,4534,2021-11-19
3175101005,JAKARTA TIMUR,CIPAYUNG,SETU,20572,4009,16563,13732,30295,2021-11-19
3173071002,JAKARTA BARAT,PALMERAH,SLIPI,16591,2917,13674,11697,25371,2021-11-19
3173081004,JAKARTA BARAT,KEMBANGAN,SRENGSENG,45523,10004,35519,30386,65905,2021-11-19
3174091002,JAKARTA SELATAN,JAGAKARSA,SRENGSENG SAWAH,58196,8830,49366,42783,92149,2021-11-19
3173051003,JAKARTA BARAT,KEBON JERUK,SUKABUMI SELATAN,37033,8075,28958,22841,51799,2021-11-19
3173051002,JAKARTA BARAT,KEBON JERUK,SUKABUMI UTARA,38290,8796,29494,23582,53076,2021-11-19
3172041002,JAKARTA UTARA,CILINCING,SUKAPURA,53949,11919,42030,35060,77090,2021-11-19
3171031007,JAKARTA PUSAT,KEMAYORAN,SUMUR BATU,22717,4241,18476,15904,34380,2021-11-19
3172021004,JAKARTA UTARA,TANJUNG PRIOK,SUNGAI BAMBU,29876,5870,24006,20145,44151,2021-11-19
3172021006,JAKARTA UTARA,TANJUNG PRIOK,SUNTER AGUNG,71805,12176,59629,52784,112413,2021-11-19
3172021002,JAKARTA UTARA,TANJUNG PRIOK,SUNTER JAYA,63031,10865,52166,45825,97991,2021-11-19
3175091004,JAKARTA TIMUR,CIRACAS,SUSUKAN,38257,7074,31183,26412,57595,2021-11-19
3173031001,JAKARTA BARAT,TAMAN SARI,TAMAN SARI,14348,2574,11774,10218,21992,2021-11-19
3173041001,JAKARTA BARAT,TAMBORA,TAMBORA,10204,2161,8043,6549,14592,2021-11-19
3173041004,JAKARTA BARAT,TAMBORA,TANAH SEREAL,26387,4396,21991,18649,40640,2021-11-19
3171081004,JAKARTA PUSAT,JOHAR BARU,TANAH TINGGI,37693,7062,30631,25115,55746,2021-11-19
3173031004,JAKARTA BARAT,TAMAN SARI,TANGKI,13324,2172,11152,9561,20713,2021-11-19
3174091005,JAKARTA SELATAN,JAGAKARSA,TANJUNG BARAT,39770,6615,33155,27943,61098,2021-11-19
3173021005,JAKARTA BARAT,GROGOL PETAMBURAN,TANJUNG DUREN SELATAN,25337,4744,20593,18429,39022,2021-11-19
3173021002,JAKARTA BARAT,GROGOL PETAMBURAN,TANJUNG DUREN UTARA,17010,2814,14196,12874,27070,2021-11-19
3172021001,JAKARTA UTARA,TANJUNG PRIOK,TANJUNG PRIOK,34588,7025,27563,22757,50320,2021-11-19
3174011002,JAKARTA SELATAN,TEBET,TEBET BARAT,21194,3344,17850,15912,33762,2021-11-19
3174011001,JAKARTA SELATAN,TEBET,TEBET TIMUR,18199,2862,15337,13982,29319,2021-11-19
3173061003,JAKARTA BARAT,KALI DERES,TEGAL ALUR,83647,16989,66658,55755,122413,2021-11-19
3174031004,JAKARTA SELATAN,MAMPANG PRAPATAN,TEGAL PARANG,32401,6983,25418,20237,45655,2021-11-19
3173021003,JAKARTA BARAT,GROGOL PETAMBURAN,TOMANG,29605,5353,24252,21106,45358,2021-11-19
3172031005,JAKARTA UTARA,KOJA,TUGU SELATAN,39122,8569,30553,25119,55672,2021-11-19
3172031002,JAKARTA UTARA,KOJA,TUGU UTARA,67670,15682,51988,41834,93822,2021-11-19
3175061006,JAKARTA TIMUR,CAKUNG,UJUNG MENTENG,29934,5043,24891,21417,46308,2021-11-19
3174101005,JAKARTA SELATAN,PESANGGRAHAN,ULUJAMI,40544,8878,31666,26434,58100,2021-11-19
3175011006,JAKARTA TIMUR,MATRAMAN,UTAN KAYU SELATAN,33511,5893,27618,23202,50820,2021-11-19
3175011002,JAKARTA TIMUR,MATRAMAN,UTAN KAYU UTARA,28169,5718,22451,18655,41106,2021-11-19
3171031008,JAKARTA PUSAT,KEMAYORAN,UTAN PANJANG,29208,5667,23541,19305,42846,2021-11-19
3172021007,JAKARTA UTARA,TANJUNG PRIOK,WARAKAS,44401,7997,36404,29796,66200,2021-11-19
3173021007,JAKARTA BARAT,GROGOL PETAMBURAN,WIJAYA KUSUMA,38934,7947,30987,26449,57436,2021-11-19
3172051003,JAKARTA UTARA,PADEMANGAN,ANCOL,23947,5673,18274,15186,33460,2021-11-20
3173041007,JAKARTA BARAT,TAMBORA,ANGKE,29381,6092,23289,19102,42391,2021-11-20
3175041005,JAKARTA TIMUR,KRAMAT JATI,BALE KAMBANG,29074,6953,22121,17673,39794,2021-11-20
3175031003,JAKARTA TIMUR,JATINEGARA,BALI MESTER,9752,1980,7772,6612,14384,2021-11-20
3175101006,JAKARTA TIMUR,CIPAYUNG,BAMBU APUS,26285,4738,21547,18301,39848,2021-11-20
3174031002,JAKARTA SELATAN,MAMPANG PRAPATAN,BANGKA,21566,4441,17125,14410,31535,2021-11-20
3175051002,JAKARTA TIMUR,PASAR REBO,BARU,23886,3870,20016,17464,37480,2021-11-20
3175041004,JAKARTA TIMUR,KRAMAT JATI,BATU AMPAR,47898,11268,36630,30052,66682,2021-11-20
3171071002,JAKARTA PUSAT,TANAH ABANG,BENDUNGAN HILIR,21494,4262,17232,14900,32132,2021-11-20
3175031002,JAKARTA TIMUR,JATINEGARA,BIDARA CINA,36689,8585,28104,22942,51046,2021-11-20
3174101002,JAKARTA SELATAN,PESANGGRAHAN,BINTARO,53098,10434,42664,37385,80049,2021-11-20
3174011005,JAKARTA SELATAN,TEBET,BUKIT DURI,34183,6711,27472,23187,50659,2021-11-20
3171041006,JAKARTA PUSAT,SENEN,BUNGUR,18144,3697,14447,12093,26540,2021-11-20
3175061007,JAKARTA TIMUR,CAKUNG,CAKUNG BARAT,57724,11557,46167,38458,84625,2021-11-20
3175061004,JAKARTA TIMUR,CAKUNG,CAKUNG TIMUR,58287,11201,47086,39646,86732,2021-11-20
3175041007,JAKARTA TIMUR,KRAMAT JATI,CAWANG,32762,6830,25932,21153,47085,2021-11-20
3175101008,JAKARTA TIMUR,CIPAYUNG,CEGER,18932,3597,15335,12951,28286,2021-11-20
3171031006,JAKARTA PUSAT,KEMAYORAN,CEMPAKA BARU,32581,6010,26571,21563,48134,2021-11-20
3171051002,JAKARTA PUSAT,CEMPAKA PUTIH,CEMPAKA PUTIH BARAT,35885,7464,28421,24613,53034,2021-11-20
3171051001,JAKARTA PUSAT,CEMPAKA PUTIH,CEMPAKA PUTIH TIMUR,24292,4900,19392,17195,36587,2021-11-20
3173011001,JAKARTA BARAT,CENGKARENG,CENGKARENG BARAT,66284,12869,53415,46358,99773,2021-11-20
3173011006,JAKARTA BARAT,CENGKARENG,CENGKARENG TIMUR,81027,15640,65387,55125,120512,2021-11-20
3175091002,JAKARTA TIMUR,CIRACAS,CIBUBUR,66364,11170,55194,47407,102601,2021-11-20
3171011002,JAKARTA PUSAT,GAMBIR,CIDENG,15390,2967,12423,10972,23395,2021-11-20
3174091003,JAKARTA SELATAN,JAGAKARSA,CIGANJUR,38497,6313,32184,27207,59391,2021-11-20
3175051003,JAKARTA TIMUR,PASAR REBO,CIJANTUNG,41419,7487,33932,28782,62714,2021-11-20
3171061003,JAKARTA PUSAT,MENTENG,CIKINI,8274,1467,6807,5499,12306,2021-11-20
3174081006,JAKARTA SELATAN,PANCORAN,CIKOKO,10547,1781,8766,7682,16448,2021-11-20
3174061001,JAKARTA SELATAN,CILANDAK,CILANDAK BARAT,51752,8892,42860,37929,80789,2021-11-20
3174041003,JAKARTA SELATAN,PASAR MINGGU,CILANDAK TIMUR,25145,4499,20646,17843,38489,2021-11-20
3175101002,JAKARTA TIMUR,CIPAYUNG,CILANGKAP,27635,4793,22842,19680,42522,2021-11-20
3175041006,JAKARTA TIMUR,KRAMAT JATI,CILILITAN,40181,8334,31847,26300,58147,2021-11-20
3172041001,JAKARTA UTARA,CILINCING,CILINCING,43609,10217,33392,26373,59765,2021-11-20
3175101001,JAKARTA TIMUR,CIPAYUNG,CIPAYUNG,26104,4461,21643,18806,40449,2021-11-20
3174091006,JAKARTA SELATAN,JAGAKARSA,CIPEDAK,38303,6187,32116,27562,59678,2021-11-20
3174061005,JAKARTA SELATAN,CILANDAK,CIPETE SELATAN,26704,4975,21729,19315,41044,2021-11-20
3174071010,JAKARTA SELATAN,KEBAYORAN BARU,CIPETE UTARA,34102,6317,27785,23604,51389,2021-11-20
3175021003,JAKARTA TIMUR,PULO GADUNG,CIPINANG,39306,6999,32307,27250,59557,2021-11-20
3175031007,JAKARTA TIMUR,JATINEGARA,CIPINANG BESAR SELATAN,35212,8146,27066,21639,48705,2021-11-20
3175031008,JAKARTA TIMUR,JATINEGARA,CIPINANG BESAR UTARA,45319,10421,34898,27703,62601,2021-11-20
3175031005,JAKARTA TIMUR,JATINEGARA,CIPINANG CEMPEDAK,32824,7000,25824,22277,48101,2021-11-20
3175081005,JAKARTA TIMUR,MAKASAR,CIPINANG MELAYU,42308,7994,34314,29574,63888,2021-11-20
3175031006,JAKARTA TIMUR,JATINEGARA,CIPINANG MUARA,55243,11463,43780,36291,80071,2021-11-20
3174051003,JAKARTA SELATAN,KEBAYORAN LAMA,CIPULIR,39937,8276,31661,26103,57764,2021-11-20
3175091001,JAKARTA TIMUR,CIRACAS,CIRACAS,64594,11576,53018,44647,97665,2021-11-20
3175041003,JAKARTA TIMUR,KRAMAT JATI,DUKUH,24609,4443,20166,16906,37072,2021-11-20
3175071001,JAKARTA TIMUR,DUREN SAWIT,DUREN SAWIT,61160,12643,48517,41025,89542,2021-11-20
3174081004,JAKARTA SELATAN,PANCORAN,DUREN TIGA,28319,5484,22835,19362,42197,2021-11-20
3173051005,JAKARTA BARAT,KEBON JERUK,DURI KEPA,60138,11596,48542,42312,90854,2021-11-20
3173011002,JAKARTA BARAT,CENGKARENG,DURI KOSAMBI,77923,16236,61687,50383,112070,2021-11-20
3171011006,JAKARTA PUSAT,GAMBIR,DURI PULO,19610,4062,15548,12653,28201,2021-11-20
3173041011,JAKARTA BARAT,TAMBORA,DURI SELATAN,14259,2491,11768,10085,21853,2021-11-20
3173041003,JAKARTA BARAT,TAMBORA,DURI UTARA,19844,3505,16339,13616,29955,2021-11-20
3171081003,JAKARTA PUSAT,JOHAR BARU,GALUR,18243,3495,14748,12076,26824,2021-11-20
3171011001,JAKARTA PUSAT,GAMBIR,GAMBIR,2191,451,1740,1525,3265,2021-11-20
3174061004,JAKARTA SELATAN,CILANDAK,GANDARIA SELATAN,22119,4129,17990,15601,33591,2021-11-20
3174071009,JAKARTA SELATAN,KEBAYORAN BARU,GANDARIA UTARA,39922,7736,32186,27678,59864,2021-11-20
3175051001,JAKARTA TIMUR,PASAR REBO,GEDONG,35755,7015,28740,24613,53353,2021-11-20
3171071001,JAKARTA PUSAT,TANAH ABANG,GELORA,3127,597,2530,2222,4752,2021-11-20
3173031007,JAKARTA BARAT,TAMAN SARI,GLODOK,7837,1154,6683,6079,12762,2021-11-20
3171061004,JAKARTA PUSAT,MENTENG,GONDANGDIA,4100,904,3196,2931,6127,2021-11-20
3173021001,JAKARTA BARAT,GROGOL PETAMBURAN,GROGOL,16876,3287,13589,11640,25229,2021-11-20
3174051005,JAKARTA SELATAN,KEBAYORAN LAMA,GROGOL SELATAN,44251,8641,35610,29893,65503,2021-11-20
3174051004,JAKARTA SELATAN,KEBAYORAN LAMA,GROGOL UTARA,42494,8472,34022,28691,62713,2021-11-20
3174021007,JAKARTA SELATAN,SETIA BUDI,GUNTUR,3985,730,3255,2924,6179,2021-11-20
3174071002,JAKARTA SELATAN,KEBAYORAN BARU,GUNUNG,9436,1718,7718,6945,14663,2021-11-20
3171031005,JAKARTA PUSAT,KEMAYORAN,GUNUNG SAHARI SELATAN,19199,3730,15469,13191,28660,2021-11-20
3171021004,JAKARTA PUSAT,SAWAH BESAR,GUNUNG SAHARI UTARA,16650,2879,13771,12399,26170,2021-11-20
3175081004,JAKARTA TIMUR,MAKASAR,HALIM PERDANA KUSUMAH,28363,3591,24772,22794,47566,2021-11-20
3171031003,JAKARTA PUSAT,KEMAYORAN,HARAPAN MULIA,22557,4341,18216,15086,33302,2021-11-20
3174091001,JAKARTA SELATAN,JAGAKARSA,JAGAKARSA,62389,9984,52405,45003,97408,2021-11-20
3175021007,JAKARTA TIMUR,PULO GADUNG,JATI,32757,5999,26758,23532,50290,2021-11-20
3174041002,JAKARTA SELATAN,PASAR MINGGU,JATI PADANG,37502,7081,30421,26043,56464,2021-11-20
3173071004,JAKARTA BARAT,PALMERAH,JATI PULO,28738,5583,23155,18798,41953,2021-11-20
3175061001,JAKARTA TIMUR,CAKUNG,JATINEGARA,84160,17356,66804,55871,122675,2021-11-20
3175021004,JAKARTA TIMUR,PULO GADUNG,JATINEGARA KAUM,24632,4281,20351,16868,37219,2021-11-20
3173021004,JAKARTA BARAT,GROGOL PETAMBURAN,JELAMBAR,30266,5404,24862,22098,46960,2021-11-20
3173021006,JAKARTA BARAT,GROGOL PETAMBURAN,JELAMBAR BARU,38246,6820,31426,27674,59100,2021-11-20
3173041006,JAKARTA BARAT,TAMBORA,JEMBATAN BESI,29314,6965,22349,17766,40115,2021-11-20
3173041008,JAKARTA BARAT,TAMBORA,JEMBATAN LIMA,21021,4735,16286,13129,29415,2021-11-20
3173081005,JAKARTA BARAT,KEMBANGAN,JOGLO,40839,7997,32842,28175,61017,2021-11-20
3171081001,JAKARTA PUSAT,JOHAR BARU,JOHAR BARU,37488,6820,30668,26202,56870,2021-11-20
3173041002,JAKARTA BARAT,TAMBORA,KALI ANYAR,23856,4599,19257,15576,34833,2021-11-20
3172041004,JAKARTA UTARA,CILINCING,KALIBARU,67684,18160,49524,35583,85107,2021-11-20
3174081002,JAKARTA SELATAN,PANCORAN,KALIBATA,41994,9294,32700,27096,59796,2021-11-20
3173061001,JAKARTA BARAT,KALI DERES,KALIDERES,72447,14187,58260,49917,108177,2021-11-20
3175051004,JAKARTA TIMUR,PASAR REBO,KALISARI,43212,7496,35716,30610,66326,2021-11-20
3173061004,JAKARTA BARAT,KALI DERES,KAMAL,53783,12288,41495,33743,75238,2021-11-20
3172011002,JAKARTA UTARA,PENJARINGAN,KAMAL MUARA,12930,2263,10667,9152,19819,2021-11-20
3171071007,JAKARTA PUSAT,TANAH ABANG,KAMPUNG BALI,11358,2414,8944,7041,15985,2021-11-20
3175031001,JAKARTA TIMUR,JATINEGARA,KAMPUNG MELAYU,25717,5758,19959,15807,35766,2021-11-20
3171081002,JAKARTA PUSAT,JOHAR BARU,KAMPUNG RAWA,21237,3452,17785,14432,32217,2021-11-20
3175041002,JAKARTA TIMUR,KRAMAT JATI,KAMPUNG TENGAH,43993,10781,33212,27027,60239,2021-11-20
3173011005,JAKARTA BARAT,CENGKARENG,KAPUK,134466,31627,102839,84624,187463,2021-11-20
3172011003,JAKARTA UTARA,PENJARINGAN,KAPUK MUARA,35781,6721,29060,25794,54854,2021-11-20
3171021002,JAKARTA PUSAT,SAWAH BESAR,KARANG ANYAR,25761,4792,20969,17833,38802,2021-11-20
3174021004,JAKARTA SELATAN,SETIA BUDI,KARET,9623,1819,7804,6616,14420,2021-11-20
3174021003,JAKARTA SELATAN,SETIA BUDI,KARET KUNINGAN,16055,3055,13000,11181,24181,2021-11-20
3174021002,JAKARTA SELATAN,SETIA BUDI,KARET SEMANGGI,2770,550,2220,1982,4202,2021-11-20
3171071003,JAKARTA PUSAT,TANAH ABANG,KARET TENGSIN,19271,3646,15625,12967,28592,2021-11-20
3171021003,JAKARTA PUSAT,SAWAH BESAR,KARTINI,22292,4105,18187,15804,33991,2021-11-20
3175011003,JAKARTA TIMUR,MATRAMAN,KAYU MANIS,25284,5177,20107,16379,36486,2021-11-20
3175021006,JAKARTA TIMUR,PULO GADUNG,KAYU PUTIH,40696,7522,33174,29341,62515,2021-11-20
3173031006,JAKARTA BARAT,TAMAN SARI,KEAGUNGAN,17387,3163,14224,11842,26066,2021-11-20
3174041007,JAKARTA SELATAN,PASAR MINGGU,KEBAGUSAN,44552,8618,35934,30255,66189,2021-11-20
3174051006,JAKARTA SELATAN,KEBAYORAN LAMA,KEBAYORAN LAMA SELATAN,41212,7474,33738,29174,62912,2021-11-20
3174051001,JAKARTA SELATAN,KEBAYORAN LAMA,KEBAYORAN LAMA UTARA,42422,8605,33817,28466,62283,2021-11-20
3174011004,JAKARTA SELATAN,TEBET,KEBON BARU,35165,6444,28721,24575,53296,2021-11-20
3172021005,JAKARTA UTARA,TANJUNG PRIOK,KEBON BAWANG,50952,10027,40925,34576,75501,2021-11-20
3173051001,JAKARTA BARAT,KEBON JERUK,KEBON JERUK,53887,10703,43184,35624,78808,2021-11-20
3171071006,JAKARTA PUSAT,TANAH ABANG,KEBON KACANG,21531,5029,16502,13262,29764,2021-11-20
3171011005,JAKARTA PUSAT,GAMBIR,KEBON KELAPA,10163,2001,8162,7006,15168,2021-11-20
3171031002,JAKARTA PUSAT,KEMAYORAN,KEBON KOSONG,30019,5879,24140,20069,44209,2021-11-20
3175011005,JAKARTA TIMUR,MATRAMAN,KEBON MANGGIS,16490,3135,13355,11203,24558,2021-11-20
3171071005,JAKARTA PUSAT,TANAH ABANG,KEBON MELATI,32206,8447,23759,17993,41752,2021-11-20
3175081003,JAKARTA TIMUR,MAKASAR,KEBON PALA,46614,8939,37675,31861,69536,2021-11-20
3171061005,JAKARTA PUSAT,MENTENG,KEBON SIRIH,12299,2578,9721,7925,17646,2021-11-20
3173011004,JAKARTA BARAT,CENGKARENG,KEDAUNG KALI ANGKE,32612,6159,26453,22579,49032,2021-11-20
3173051007,JAKARTA BARAT,KEBON JERUK,KEDOYA SELATAN,32165,5770,26395,22093,48488,2021-11-20
3173051006,JAKARTA BARAT,KEBON JERUK,KEDOYA UTARA,45740,8573,37167,31737,68904,2021-11-20
3173051004,JAKARTA BARAT,KEBON JERUK,KELAPA DUA,23565,4521,19044,16093,35137,2021-11-20
3175091003,JAKARTA TIMUR,CIRACAS,KELAPA DUA WETAN,46875,7810,39065,33564,72629,2021-11-20
3172061003,JAKARTA UTARA,KELAPA GADING,KELAPA GADING BARAT,35717,6121,29596,26971,56567,2021-11-20
3172061001,JAKARTA UTARA,KELAPA GADING,KELAPA GADING TIMUR,33592,5048,28544,26661,55205,2021-11-20
3173071005,JAKARTA BARAT,PALMERAH,KEMANGGISAN,32139,5944,26195,22466,48661,2021-11-20
3171031001,JAKARTA PUSAT,KEMAYORAN,KEMAYORAN,20708,4044,16664,13898,30562,2021-11-20
3173081006,JAKARTA BARAT,KEMBANGAN,KEMBANGAN SELATAN,27130,5567,21563,18828,40391,2021-11-20
3173081001,JAKARTA BARAT,KEMBANGAN,KEMBANGAN UTARA,54451,11672,42779,36014,78793,2021-11-20
3171041002,JAKARTA PUSAT,SENEN,KENARI,9579,1834,7745,6668,14413,2021-11-20
3173041005,JAKARTA BARAT,TAMBORA,KERENDANG,19973,3956,16017,13210,29227,2021-11-20
3175071003,JAKARTA TIMUR,DUREN SAWIT,KLENDER,69978,16087,53891,43709,97600,2021-11-20
3172031001,JAKARTA UTARA,KOJA,KOJA,28175,6243,21932,18020,39952,2021-11-20
3173071006,JAKARTA BARAT,PALMERAH,KOTA BAMBU SELATAN,21158,4071,17087,13634,30721,2021-11-20
3173071003,JAKARTA BARAT,PALMERAH,KOTA BAMBU UTARA,24995,5026,19969,15766,35735,2021-11-20
3171041004,JAKARTA PUSAT,SENEN,KRAMAT,28835,6811,22024,17037,39061,2021-11-20
3175041001,JAKARTA TIMUR,KRAMAT JATI,KRAMAT JATI,34144,7076,27068,22324,49392,2021-11-20
3174071003,JAKARTA SELATAN,KEBAYORAN BARU,KRAMAT PELA,14413,2729,11684,10207,21891,2021-11-20
3173031002,JAKARTA BARAT,TAMAN SARI,KRUKUT,19244,3559,15685,12937,28622,2021-11-20
3174031005,JAKARTA SELATAN,MAMPANG PRAPATAN,KUNINGAN BARAT,12785,2283,10502,8954,19456,2021-11-20
3174021008,JAKARTA SELATAN,SETIA BUDI,KUNINGAN TIMUR,6008,1163,4845,4206,9051,2021-11-20
3171041005,JAKARTA PUSAT,SENEN,KWITANG,15486,3362,12124,9880,22004,2021-11-20
3172031003,JAKARTA UTARA,KOJA,LAGOA,59065,13641,45424,36564,81988,2021-11-20
3174061002,JAKARTA SELATAN,CILANDAK,LEBAK BULUS,37626,6935,30691,27337,58028,2021-11-20
3174091004,JAKARTA SELATAN,JAGAKARSA,LENTENG AGUNG,53946,9423,44523,37070,81593,2021-11-20
3175101007,JAKARTA TIMUR,CIPAYUNG,LUBANG BUAYA,63547,11713,51834,43793,95627,2021-11-20
3175081001,JAKARTA TIMUR,MAKASAR,MAKASAR,34390,6157,28233,24502,52735,2021-11-20
3175071006,JAKARTA TIMUR,DUREN SAWIT,MALAKA JAYA,30927,5155,25772,22505,48277,2021-11-20
3175071005,JAKARTA TIMUR,DUREN SAWIT,MALAKA SARI,27530,4448,23082,20292,43374,2021-11-20
3174031001,JAKARTA SELATAN,MAMPANG PRAPATAN,MAMPANG PRAPATAN,18159,3639,14520,12204,26724,2021-11-20
3173031005,JAKARTA BARAT,TAMAN SARI,MANGGA BESAR,7707,1277,6430,5726,12156,2021-11-20
3171021005,JAKARTA PUSAT,SAWAH BESAR,MANGGA DUA SELATAN,27442,5544,21898,18794,40692,2021-11-20
3174011007,JAKARTA SELATAN,TEBET,MANGGARAI,28373,4859,23514,19500,43014,2021-11-20
3174011006,JAKARTA SELATAN,TEBET,MANGGARAI SELATAN,23075,3761,19314,16460,35774,2021-11-20
3173031003,JAKARTA BARAT,TAMAN SARI,MAPHAR,16461,2996,13465,11396,24861,2021-11-20
3172041003,JAKARTA UTARA,CILINCING,MARUNDA,28943,6408,22535,17232,39767,2021-11-20
3174071001,JAKARTA SELATAN,KEBAYORAN BARU,MELAWAI,2627,502,2125,1966,4091,2021-11-20
3171061001,JAKARTA PUSAT,MENTENG,MENTENG,25624,5471,20153,16273,36426,2021-11-20
3174021005,JAKARTA SELATAN,SETIA BUDI,MENTENG ATAS,27816,4871,22945,19501,42446,2021-11-20
3174011003,JAKARTA SELATAN,TEBET,MENTENG DALAM,36028,6838,29190,25132,54322,2021-11-20
3173081003,JAKARTA BARAT,KEMBANGAN,MERUYA SELATAN,32130,6427,25703,22062,47765,2021-11-20
3173081002,JAKARTA BARAT,KEMBANGAN,MERUYA UTARA,43752,8811,34941,30804,65745,2021-11-20
3175101004,JAKARTA TIMUR,CIPAYUNG,MUNJUL,23871,4268,19603,16817,36420,2021-11-20
3172051002,JAKARTA UTARA,PADEMANGAN,PADEMANGAN BARAT,74240,17008,57232,46962,104194,2021-11-20
3172051001,JAKARTA UTARA,PADEMANGAN,PADEMANGAN TIMUR,37736,6534,31202,27834,59036,2021-11-20
3175011004,JAKARTA TIMUR,MATRAMAN,PAL MERIAM,19769,3949,15820,12952,28772,2021-11-20
3173071001,JAKARTA BARAT,PALMERAH,PALMERAH,63011,12885,50126,41511,91637,2021-11-20
3174081001,JAKARTA SELATAN,PANCORAN,PANCORAN,19421,3799,15622,13207,28829,2021-11-20
3172021003,JAKARTA UTARA,TANJUNG PRIOK,PAPANGGO,39097,7503,31594,26335,57929,2021-11-20
3171021001,JAKARTA PUSAT,SAWAH BESAR,PASAR BARU,12035,2251,9784,8847,18631,2021-11-20
3174021006,JAKARTA SELATAN,SETIA BUDI,PASAR MANGGIS,26752,5110,21642,18210,39852,2021-11-20
3174041001,JAKARTA SELATAN,PASAR MINGGU,PASAR MINGGU,24821,4578,20243,17613,37856,2021-11-20
3171041003,JAKARTA PUSAT,SENEN,PASEBAN,23533,4769,18764,15584,34348,2021-11-20
3173061005,JAKARTA BARAT,KALI DERES,PEGADUNGAN,75587,14407,61180,53068,114248,2021-11-20
3171061002,JAKARTA PUSAT,MENTENG,PEGANGSAAN,23455,4925,18530,14507,33037,2021-11-20
3172061002,JAKARTA UTARA,KELAPA GADING,PEGANGSAAN DUA,49976,8127,41849,38270,80119,2021-11-20
3172011004,JAKARTA UTARA,PENJARINGAN,PEJAGALAN,74578,15095,59483,52019,111502,2021-11-20
3174041006,JAKARTA SELATAN,PASAR MINGGU,PEJATEN BARAT,37346,7048,30298,25832,56130,2021-11-20
3174041005,JAKARTA SELATAN,PASAR MINGGU,PEJATEN TIMUR,57656,12269,45387,37587,82974,2021-11-20
3175051005,JAKARTA TIMUR,PASAR REBO,PEKAYON,43250,7672,35578,30167,65745,2021-11-20
3173041009,JAKARTA BARAT,TAMBORA,PEKOJAN,23587,4379,19208,16415,35623,2021-11-20
3174031003,JAKARTA SELATAN,MAMPANG PRAPATAN,PELA MAMPANG,43522,8332,35190,30028,65218,2021-11-20
3174081005,JAKARTA SELATAN,PANCORAN,PENGADEGAN,21478,3865,17613,15298,32911,2021-11-20
3175061003,JAKARTA TIMUR,CAKUNG,PENGGILINGAN,99255,22286,76969,62530,139499,2021-11-20
3172011001,JAKARTA UTARA,PENJARINGAN,PENJARINGAN,88308,22198,66110,51935,118045,2021-11-20
3174101001,JAKARTA SELATAN,PESANGGRAHAN,PESANGGRAHAN,27545,4634,22911,19988,42899,2021-11-20
3171071004,JAKARTA PUSAT,TANAH ABANG,PETAMBURAN,33271,8601,24670,19075,43745,2021-11-20
3174071008,JAKARTA SELATAN,KEBAYORAN BARU,PETOGOGAN,11499,2179,9320,8081,17401,2021-11-20
3171011004,JAKARTA PUSAT,GAMBIR,PETOJO SELATAN,14692,3237,11455,9818,21273,2021-11-20
3171011003,JAKARTA PUSAT,GAMBIR,PETOJO UTARA,17458,3696,13762,11506,25268,2021-11-20
3174101004,JAKARTA SELATAN,PESANGGRAHAN,PETUKANGAN SELATAN,37187,7483,29704,25478,55182,2021-11-20
3174101003,JAKARTA SELATAN,PESANGGRAHAN,PETUKANGAN UTARA,53716,11247,42469,35876,78345,2021-11-20
3175081002,JAKARTA TIMUR,MAKASAR,PINANG RANTI,27198,5777,21421,17942,39363,2021-11-20
3173031008,JAKARTA BARAT,TAMAN SARI,PINANGSIA,10729,1839,8890,7480,16370,2021-11-20
3175011001,JAKARTA TIMUR,MATRAMAN,PISANGAN BARU,31776,6380,25396,20647,46043,2021-11-20
3175021002,JAKARTA TIMUR,PULO GADUNG,PISANGAN TIMUR,41011,7401,33610,28850,62460,2021-11-20
3172011005,JAKARTA UTARA,PENJARINGAN,PLUIT,47783,9074,38709,34357,73066,2021-11-20
3175071002,JAKARTA TIMUR,DUREN SAWIT,PONDOK BAMBU,61550,12646,48904,41453,90357,2021-11-20
3175071004,JAKARTA TIMUR,DUREN SAWIT,PONDOK KELAPA,72015,13936,58079,50550,108629,2021-11-20
3175071007,JAKARTA TIMUR,DUREN SAWIT,PONDOK KOPI,35367,6487,28880,23522,52402,2021-11-20
3174061003,JAKARTA SELATAN,CILANDAK,PONDOK LABU,46464,7520,38944,34448,73392,2021-11-20
3174051002,JAKARTA SELATAN,KEBAYORAN LAMA,PONDOK PINANG,56169,10554,45615,39599,85214,2021-11-20
3175101003,JAKARTA TIMUR,CIPAYUNG,PONDOK RANGGON,25574,4689,20885,17793,38678,2021-11-20
3101011003,KAB.ADM.KEP.SERIBU,KEP. SERIBU UTARA,PULAU HARAPAN,2060,218,1842,1620,3462,2021-11-20
3101011002,KAB.ADM.KEP.SERIBU,KEP. SERIBU UTARA,PULAU KELAPA,5528,587,4941,4096,9037,2021-11-20
3101011001,KAB.ADM.KEP.SERIBU,KEP. SERIBU UTARA,PULAU PANGGANG,5450,429,5021,4503,9524,2021-11-20
3101021003,KAB.ADM.KEP.SERIBU,KEP. SERIBU SELATAN,PULAU PARI,2765,192,2573,2439,5012,2021-11-20
3101021002,KAB.ADM.KEP.SERIBU,KEP. SERIBU SELATAN,PULAU TIDUNG,4553,365,4188,3861,8049,2021-11-20
3101021001,KAB.ADM.KEP.SERIBU,KEP. SERIBU SELATAN,PULAU UNTUNG JAWA,1941,157,1784,1662,3446,2021-11-20
3174071007,JAKARTA SELATAN,KEBAYORAN BARU,PULO,5835,990,4845,4483,9328,2021-11-20
3175021001,JAKARTA TIMUR,PULO GADUNG,PULO GADUNG,34422,7378,27044,22934,49978,2021-11-20
3175061005,JAKARTA TIMUR,CAKUNG,PULO GEBANG,97301,18276,79025,65267,144292,2021-11-20
3174041004,JAKARTA SELATAN,PASAR MINGGU,RAGUNAN,39616,7049,32567,28259,60826,2021-11-20
3175091005,JAKARTA TIMUR,CIRACAS,RAMBUTAN,36771,8385,28386,23546,51932,2021-11-20
3172031006,JAKARTA UTARA,KOJA,RAWA BADAK SELATAN,42179,9753,32426,26145,58571,2021-11-20
3172031004,JAKARTA UTARA,KOJA,RAWA BADAK UTARA,34408,7520,26888,22117,49005,2021-11-20
3174071005,JAKARTA SELATAN,KEBAYORAN BARU,RAWA BARAT,5625,987,4638,4165,8803,2021-11-20
3173011003,JAKARTA BARAT,CENGKARENG,RAWA BUAYA,63799,12282,51517,43099,94616,2021-11-20
3175031004,JAKARTA TIMUR,JATINEGARA,RAWA BUNGA,21434,5050,16384,13570,29954,2021-11-20
3174081003,JAKARTA SELATAN,PANCORAN,RAWA JATI,20509,3829,16680,14510,31190,2021-11-20
3175061002,JAKARTA TIMUR,CAKUNG,RAWA TERATE,24637,4352,20285,16786,37071,2021-11-20
3175021005,JAKARTA TIMUR,PULO GADUNG,RAWAMANGUN,37612,7249,30363,26168,56531,2021-11-20
3171051003,JAKARTA PUSAT,CEMPAKA PUTIH,RAWASARI,21967,4353,17614,15322,32936,2021-11-20
3173041010,JAKARTA BARAT,TAMBORA,ROA MALAKA,3484,605,2879,2601,5480,2021-11-20
3172041006,JAKARTA UTARA,CILINCING,ROROTAN,41668,8155,33513,27382,60895,2021-11-20
3174071004,JAKARTA SELATAN,KEBAYORAN BARU,SELONG,2842,542,2300,2147,4447,2021-11-20
3173061002,JAKARTA BARAT,KALI DERES,SEMANAN,71354,14603,56751,46441,103192,2021-11-20
3172041007,JAKARTA UTARA,CILINCING,SEMPER BARAT,68587,13027,55560,46919,102479,2021-11-20
3172041005,JAKARTA UTARA,CILINCING,SEMPER TIMUR,36267,7592,28675,23718,52393,2021-11-20
3174071006,JAKARTA SELATAN,KEBAYORAN BARU,SENAYAN,2771,640,2131,1872,4003,2021-11-20
3171041001,JAKARTA PUSAT,SENEN,SENEN,6804,1417,5387,4536,9923,2021-11-20
3171031004,JAKARTA PUSAT,KEMAYORAN,SERDANG,29668,5623,24045,20343,44388,2021-11-20
3174021001,JAKARTA SELATAN,SETIA BUDI,SETIA BUDI,3023,595,2428,2119,4547,2021-11-20
3175101005,JAKARTA TIMUR,CIPAYUNG,SETU,20572,3999,16573,13782,30355,2021-11-20
3173071002,JAKARTA BARAT,PALMERAH,SLIPI,16591,2907,13684,11738,25422,2021-11-20
3173081004,JAKARTA BARAT,KEMBANGAN,SRENGSENG,45523,9966,35557,30501,66058,2021-11-20
3174091002,JAKARTA SELATAN,JAGAKARSA,SRENGSENG SAWAH,58196,8796,49400,42948,92348,2021-11-20
3173051003,JAKARTA BARAT,KEBON JERUK,SUKABUMI SELATAN,37033,7921,29112,22913,52025,2021-11-20
3173051002,JAKARTA BARAT,KEBON JERUK,SUKABUMI UTARA,38290,8777,29513,23659,53172,2021-11-20
3172041002,JAKARTA UTARA,CILINCING,SUKAPURA,53949,11889,42060,35175,77235,2021-11-20
3171031007,JAKARTA PUSAT,KEMAYORAN,SUMUR BATU,22717,4218,18499,15989,34488,2021-11-20
3172021004,JAKARTA UTARA,TANJUNG PRIOK,SUNGAI BAMBU,29876,5847,24029,20238,44267,2021-11-20
3172021006,JAKARTA UTARA,TANJUNG PRIOK,SUNTER AGUNG,71805,12146,59659,52949,112608,2021-11-20
3172021002,JAKARTA UTARA,TANJUNG PRIOK,SUNTER JAYA,63031,10824,52207,45946,98153,2021-11-20
3175091004,JAKARTA TIMUR,CIRACAS,SUSUKAN,38257,7052,31205,26509,57714,2021-11-20
3173031001,JAKARTA BARAT,TAMAN SARI,TAMAN SARI,14348,2566,11782,10245,22027,2021-11-20
3173041001,JAKARTA BARAT,TAMBORA,TAMBORA,10204,2154,8050,6574,14624,2021-11-20
3173041004,JAKARTA BARAT,TAMBORA,TANAH SEREAL,26387,4379,22008,18706,40714,2021-11-20
3171081004,JAKARTA PUSAT,JOHAR BARU,TANAH TINGGI,37693,7049,30644,25163,55807,2021-11-20
3173031004,JAKARTA BARAT,TAMAN SARI,TANGKI,13324,2168,11156,9587,20743,2021-11-20
3174091005,JAKARTA SELATAN,JAGAKARSA,TANJUNG BARAT,39770,6589,33181,28025,61206,2021-11-20
3173021005,JAKARTA BARAT,GROGOL PETAMBURAN,TANJUNG DUREN SELATAN,25337,4720,20617,18508,39125,2021-11-20
3173021002,JAKARTA BARAT,GROGOL PETAMBURAN,TANJUNG DUREN UTARA,17010,2805,14205,12929,27134,2021-11-20
3172021001,JAKARTA UTARA,TANJUNG PRIOK,TANJUNG PRIOK,34588,7015,27573,22816,50389,2021-11-20
3174011002,JAKARTA SELATAN,TEBET,TEBET BARAT,21194,3338,17856,15951,33807,2021-11-20
3174011001,JAKARTA SELATAN,TEBET,TEBET TIMUR,18199,2851,15348,14030,29378,2021-11-20
3173061003,JAKARTA BARAT,KALI DERES,TEGAL ALUR,83647,16939,66708,55932,122640,2021-11-20
3174031004,JAKARTA SELATAN,MAMPANG PRAPATAN,TEGAL PARANG,32401,6966,25435,20309,45744,2021-11-20
3173021003,JAKARTA BARAT,GROGOL PETAMBURAN,TOMANG,29605,5334,24271,21176,45447,2021-11-20
3172031005,JAKARTA UTARA,KOJA,TUGU SELATAN,39122,8545,30577,25227,55804,2021-11-20
3172031002,JAKARTA UTARA,KOJA,TUGU UTARA,67670,15630,52040,41992,94032,2021-11-20
3175061006,JAKARTA TIMUR,CAKUNG,UJUNG MENTENG,29934,5019,24915,21478,46393,2021-11-20
3174101005,JAKARTA SELATAN,PESANGGRAHAN,ULUJAMI,40544,8837,31707,26539,58246,2021-11-20
3175011006,JAKARTA TIMUR,MATRAMAN,UTAN KAYU SELATAN,33511,5878,27633,23302,50935,2021-11-20
3175011002,JAKARTA TIMUR,MATRAMAN,UTAN KAYU UTARA,28169,5697,22472,18737,41209,2021-11-20
3171031008,JAKARTA PUSAT,KEMAYORAN,UTAN PANJANG,29208,5626,23582,19380,42962,2021-11-20
3172021007,JAKARTA UTARA,TANJUNG PRIOK,WARAKAS,44401,7982,36419,29904,66323,2021-11-20
3173021007,JAKARTA BARAT,GROGOL PETAMBURAN,WIJAYA KUSUMA,38934,7932,31002,26543,57545,2021-11-20
3172051003,JAKARTA UTARA,PADEMANGAN,ANCOL,23947,5665,18282,15202,33484,2021-11-21
3173041007,JAKARTA BARAT,TAMBORA,ANGKE,29381,6087,23294,19125,42419,2021-11-21
3175041005,JAKARTA TIMUR,KRAMAT JATI,BALE KAMBANG,29074,6931,22143,17733,39876,2021-11-21
3175031003,JAKARTA TIMUR,JATINEGARA,BALI MESTER,9752,1980,7772,6630,14402,2021-11-21
3175101006,JAKARTA TIMUR,CIPAYUNG,BAMBU APUS,26285,4733,21552,18315,39867,2021-11-21
3174031002,JAKARTA SELATAN,MAMPANG PRAPATAN,BANGKA,21566,4440,17126,14421,31547,2021-11-21
3175051002,JAKARTA TIMUR,PASAR REBO,BARU,23886,3867,20019,17471,37490,2021-11-21
3175041004,JAKARTA TIMUR,KRAMAT JATI,BATU AMPAR,47898,11234,36664,30116,66780,2021-11-21
3171071002,JAKARTA PUSAT,TANAH ABANG,BENDUNGAN HILIR,21494,4258,17236,14912,32148,2021-11-21
3175031002,JAKARTA TIMUR,JATINEGARA,BIDARA CINA,36689,8580,28109,22976,51085,2021-11-21
3174101002,JAKARTA SELATAN,PESANGGRAHAN,BINTARO,53098,10418,42680,37433,80113,2021-11-21
3174011005,JAKARTA SELATAN,TEBET,BUKIT DURI,34183,6701,27482,23225,50707,2021-11-21
3171041006,JAKARTA PUSAT,SENEN,BUNGUR,18144,3696,14448,12106,26554,2021-11-21
3175061007,JAKARTA TIMUR,CAKUNG,CAKUNG BARAT,57724,11549,46175,38499,84674,2021-11-21
3175061004,JAKARTA TIMUR,CAKUNG,CAKUNG TIMUR,58287,11192,47095,39665,86760,2021-11-21
3175041007,JAKARTA TIMUR,KRAMAT JATI,CAWANG,32762,6825,25937,21178,47115,2021-11-21
3175101008,JAKARTA TIMUR,CIPAYUNG,CEGER,18932,3578,15354,12983,28337,2021-11-21
3171031006,JAKARTA PUSAT,KEMAYORAN,CEMPAKA BARU,32581,6006,26575,21585,48160,2021-11-21
3171051002,JAKARTA PUSAT,CEMPAKA PUTIH,CEMPAKA PUTIH BARAT,35885,7459,28426,24625,53051,2021-11-21
3171051001,JAKARTA PUSAT,CEMPAKA PUTIH,CEMPAKA PUTIH TIMUR,24292,4900,19392,17206,36598,2021-11-21
3173011001,JAKARTA BARAT,CENGKARENG,CENGKARENG BARAT,66284,12865,53419,46384,99803,2021-11-21
3173011006,JAKARTA BARAT,CENGKARENG,CENGKARENG TIMUR,81027,15624,65403,55160,120563,2021-11-21
3175091002,JAKARTA TIMUR,CIRACAS,CIBUBUR,66364,11147,55217,47540,102757,2021-11-21
3171011002,JAKARTA PUSAT,GAMBIR,CIDENG,15390,2964,12426,10982,23408,2021-11-21
3174091003,JAKARTA SELATAN,JAGAKARSA,CIGANJUR,38497,6309,32188,27234,59422,2021-11-21
3175051003,JAKARTA TIMUR,PASAR REBO,CIJANTUNG,41419,7481,33938,28797,62735,2021-11-21
3171061003,JAKARTA PUSAT,MENTENG,CIKINI,8274,1466,6808,5504,12312,2021-11-21
3174081006,JAKARTA SELATAN,PANCORAN,CIKOKO,10547,1779,8768,7689,16457,2021-11-21
3174061001,JAKARTA SELATAN,CILANDAK,CILANDAK BARAT,51752,8881,42871,37991,80862,2021-11-21
3174041003,JAKARTA SELATAN,PASAR MINGGU,CILANDAK TIMUR,25145,4487,20658,17877,38535,2021-11-21
3175101002,JAKARTA TIMUR,CIPAYUNG,CILANGKAP,27635,4788,22847,19700,42547,2021-11-21
3175041006,JAKARTA TIMUR,KRAMAT JATI,CILILITAN,40181,8303,31878,26329,58207,2021-11-21
3172041001,JAKARTA UTARA,CILINCING,CILINCING,43609,10206,33403,26400,59803,2021-11-21
3175101001,JAKARTA TIMUR,CIPAYUNG,CIPAYUNG,26104,4458,21646,18814,40460,2021-11-21
3174091006,JAKARTA SELATAN,JAGAKARSA,CIPEDAK,38303,6181,32122,27584,59706,2021-11-21
3174061005,JAKARTA SELATAN,CILANDAK,CIPETE SELATAN,26704,4973,21731,19347,41078,2021-11-21
3174071010,JAKARTA SELATAN,KEBAYORAN BARU,CIPETE UTARA,34102,6307,27795,23629,51424,2021-11-21
3175021003,JAKARTA TIMUR,PULO GADUNG,CIPINANG,39306,6995,32311,27274,59585,2021-11-21
3175031007,JAKARTA TIMUR,JATINEGARA,CIPINANG BESAR SELATAN,35212,8136,27076,21671,48747,2021-11-21
3175031008,JAKARTA TIMUR,JATINEGARA,CIPINANG BESAR UTARA,45319,10414,34905,27726,62631,2021-11-21
3175031005,JAKARTA TIMUR,JATINEGARA,CIPINANG CEMPEDAK,32824,6992,25832,22300,48132,2021-11-21
3175081005,JAKARTA TIMUR,MAKASAR,CIPINANG MELAYU,42308,7986,34322,29599,63921,2021-11-21
3175031006,JAKARTA TIMUR,JATINEGARA,CIPINANG MUARA,55243,11454,43789,36335,80124,2021-11-21
3174051003,JAKARTA SELATAN,KEBAYORAN LAMA,CIPULIR,39937,8270,31667,26200,57867,2021-11-21
3175091001,JAKARTA TIMUR,CIRACAS,CIRACAS,64594,11571,53023,44678,97701,2021-11-21
3175041003,JAKARTA TIMUR,KRAMAT JATI,DUKUH,24609,4441,20168,16916,37084,2021-11-21
3175071001,JAKARTA TIMUR,DUREN SAWIT,DUREN SAWIT,61160,12627,48533,41090,89623,2021-11-21
3174081004,JAKARTA SELATAN,PANCORAN,DUREN TIGA,28319,5477,22842,19382,42224,2021-11-21
3173051005,JAKARTA BARAT,KEBON JERUK,DURI KEPA,60138,11581,48557,42369,90926,2021-11-21
3173011002,JAKARTA BARAT,CENGKARENG,DURI KOSAMBI,77923,16223,61700,50429,112129,2021-11-21
3171011006,JAKARTA PUSAT,GAMBIR,DURI PULO,19610,4061,15549,12667,28216,2021-11-21
3173041011,JAKARTA BARAT,TAMBORA,DURI SELATAN,14259,2483,11776,10108,21884,2021-11-21
3173041003,JAKARTA BARAT,TAMBORA,DURI UTARA,19844,3499,16345,13633,29978,2021-11-21
3171081003,JAKARTA PUSAT,JOHAR BARU,GALUR,18243,3491,14752,12090,26842,2021-11-21
3171011001,JAKARTA PUSAT,GAMBIR,GAMBIR,2191,451,1740,1525,3265,2021-11-21
3174061004,JAKARTA SELATAN,CILANDAK,GANDARIA SELATAN,22119,4124,17995,15621,33616,2021-11-21
3174071009,JAKARTA SELATAN,KEBAYORAN BARU,GANDARIA UTARA,39922,7726,32196,27700,59896,2021-11-21
3175051001,JAKARTA TIMUR,PASAR REBO,GEDONG,35755,7005,28750,24633,53383,2021-11-21
3171071001,JAKARTA PUSAT,TANAH ABANG,GELORA,3127,596,2531,2226,4757,2021-11-21
3173031007,JAKARTA BARAT,TAMAN SARI,GLODOK,7837,1153,6684,6084,12768,2021-11-21
3171061004,JAKARTA PUSAT,MENTENG,GONDANGDIA,4100,904,3196,2932,6128,2021-11-21
3173021001,JAKARTA BARAT,GROGOL PETAMBURAN,GROGOL,16876,3282,13594,11674,25268,2021-11-21
3174051005,JAKARTA SELATAN,KEBAYORAN LAMA,GROGOL SELATAN,44251,8637,35614,29914,65528,2021-11-21
3174051004,JAKARTA SELATAN,KEBAYORAN LAMA,GROGOL UTARA,42494,8465,34029,28710,62739,2021-11-21
3174021007,JAKARTA SELATAN,SETIA BUDI,GUNTUR,3985,730,3255,2925,6180,2021-11-21
3174071002,JAKARTA SELATAN,KEBAYORAN BARU,GUNUNG,9436,1717,7719,6951,14670,2021-11-21
3171031005,JAKARTA PUSAT,KEMAYORAN,GUNUNG SAHARI SELATAN,19199,3725,15474,13216,28690,2021-11-21
3171021004,JAKARTA PUSAT,SAWAH BESAR,GUNUNG SAHARI UTARA,16650,2876,13774,12408,26182,2021-11-21
3175081004,JAKARTA TIMUR,MAKASAR,HALIM PERDANA KUSUMAH,28363,3588,24775,22809,47584,2021-11-21
3171031003,JAKARTA PUSAT,KEMAYORAN,HARAPAN MULIA,22557,4337,18220,15097,33317,2021-11-21
3174091001,JAKARTA SELATAN,JAGAKARSA,JAGAKARSA,62389,9978,52411,45039,97450,2021-11-21
3175021007,JAKARTA TIMUR,PULO GADUNG,JATI,32757,5995,26762,23547,50309,2021-11-21
3174041002,JAKARTA SELATAN,PASAR MINGGU,JATI PADANG,37502,7074,30428,26062,56490,2021-11-21
3173071004,JAKARTA BARAT,PALMERAH,JATI PULO,28738,5574,23164,18822,41986,2021-11-21
3175061001,JAKARTA TIMUR,CAKUNG,JATINEGARA,84160,17335,66825,55944,122769,2021-11-21
3175021004,JAKARTA TIMUR,PULO GADUNG,JATINEGARA KAUM,24632,4279,20353,16878,37231,2021-11-21
3173021004,JAKARTA BARAT,GROGOL PETAMBURAN,JELAMBAR,30266,5401,24865,22147,47012,2021-11-21
3173021006,JAKARTA BARAT,GROGOL PETAMBURAN,JELAMBAR BARU,38246,6813,31433,27715,59148,2021-11-21
3173041006,JAKARTA BARAT,TAMBORA,JEMBATAN BESI,29314,6957,22357,17791,40148,2021-11-21
3173041008,JAKARTA BARAT,TAMBORA,JEMBATAN LIMA,21021,4721,16300,13151,29451,2021-11-21
3173081005,JAKARTA BARAT,KEMBANGAN,JOGLO,40839,7991,32848,28195,61043,2021-11-21
3171081001,JAKARTA PUSAT,JOHAR BARU,JOHAR BARU,37488,6814,30674,26217,56891,2021-11-21
3173041002,JAKARTA BARAT,TAMBORA,KALI ANYAR,23856,4590,19266,15586,34852,2021-11-21
3172041004,JAKARTA UTARA,CILINCING,KALIBARU,67684,18139,49545,35663,85208,2021-11-21
3174081002,JAKARTA SELATAN,PANCORAN,KALIBATA,41994,9281,32713,27127,59840,2021-11-21
3173061001,JAKARTA BARAT,KALI DERES,KALIDERES,72447,14176,58271,49964,108235,2021-11-21
3175051004,JAKARTA TIMUR,PASAR REBO,KALISARI,43212,7490,35722,30625,66347,2021-11-21
3173061004,JAKARTA BARAT,KALI DERES,KAMAL,53783,12269,41514,33788,75302,2021-11-21
3172011002,JAKARTA UTARA,PENJARINGAN,KAMAL MUARA,12930,2261,10669,9158,19827,2021-11-21
3171071007,JAKARTA PUSAT,TANAH ABANG,KAMPUNG BALI,11358,2408,8950,7053,16003,2021-11-21
3175031001,JAKARTA TIMUR,JATINEGARA,KAMPUNG MELAYU,25717,5757,19960,15813,35773,2021-11-21
3171081002,JAKARTA PUSAT,JOHAR BARU,KAMPUNG RAWA,21237,3450,17787,14439,32226,2021-11-21
3175041002,JAKARTA TIMUR,KRAMAT JATI,KAMPUNG TENGAH,43993,10768,33225,27057,60282,2021-11-21
3173011005,JAKARTA BARAT,CENGKARENG,KAPUK,134466,31598,102868,84753,187621,2021-11-21
3172011003,JAKARTA UTARA,PENJARINGAN,KAPUK MUARA,35781,6714,29067,25813,54880,2021-11-21
3171021002,JAKARTA PUSAT,SAWAH BESAR,KARANG ANYAR,25761,4788,20973,17848,38821,2021-11-21
3174021004,JAKARTA SELATAN,SETIA BUDI,KARET,9623,1819,7804,6619,14423,2021-11-21
3174021003,JAKARTA SELATAN,SETIA BUDI,KARET KUNINGAN,16055,3054,13001,11194,24195,2021-11-21
3174021002,JAKARTA SELATAN,SETIA BUDI,KARET SEMANGGI,2770,550,2220,1984,4204,2021-11-21
3171071003,JAKARTA PUSAT,TANAH ABANG,KARET TENGSIN,19271,3644,15627,12979,28606,2021-11-21
3171021003,JAKARTA PUSAT,SAWAH BESAR,KARTINI,22292,4101,18191,15822,34013,2021-11-21
3175011003,JAKARTA TIMUR,MATRAMAN,KAYU MANIS,25284,5174,20110,16398,36508,2021-11-21
3175021006,JAKARTA TIMUR,PULO GADUNG,KAYU PUTIH,40696,7514,33182,29361,62543,2021-11-21
3173031006,JAKARTA BARAT,TAMAN SARI,KEAGUNGAN,17387,3162,14225,11855,26080,2021-11-21
3174041007,JAKARTA SELATAN,PASAR MINGGU,KEBAGUSAN,44552,8610,35942,30279,66221,2021-11-21
3174051006,JAKARTA SELATAN,KEBAYORAN LAMA,KEBAYORAN LAMA SELATAN,41212,7461,33751,29202,62953,2021-11-21
3174051001,JAKARTA SELATAN,KEBAYORAN LAMA,KEBAYORAN LAMA UTARA,42422,8597,33825,28508,62333,2021-11-21
3174011004,JAKARTA SELATAN,TEBET,KEBON BARU,35165,6439,28726,24598,53324,2021-11-21
3172021005,JAKARTA UTARA,TANJUNG PRIOK,KEBON BAWANG,50952,10010,40942,34622,75564,2021-11-21
3173051001,JAKARTA BARAT,KEBON JERUK,KEBON JERUK,53887,10692,43195,35673,78868,2021-11-21
3171071006,JAKARTA PUSAT,TANAH ABANG,KEBON KACANG,21531,5024,16507,13273,29780,2021-11-21
3171011005,JAKARTA PUSAT,GAMBIR,KEBON KELAPA,10163,1996,8167,7017,15184,2021-11-21
3171031002,JAKARTA PUSAT,KEMAYORAN,KEBON KOSONG,30019,5871,24148,20097,44245,2021-11-21
3175011005,JAKARTA TIMUR,MATRAMAN,KEBON MANGGIS,16490,3131,13359,11213,24572,2021-11-21
3171071005,JAKARTA PUSAT,TANAH ABANG,KEBON MELATI,32206,8437,23769,18016,41785,2021-11-21
3175081003,JAKARTA TIMUR,MAKASAR,KEBON PALA,46614,8936,37678,31885,69563,2021-11-21
3171061005,JAKARTA PUSAT,MENTENG,KEBON SIRIH,12299,2575,9724,7930,17654,2021-11-21
3173011004,JAKARTA BARAT,CENGKARENG,KEDAUNG KALI ANGKE,32612,6152,26460,22594,49054,2021-11-21
3173051007,JAKARTA BARAT,KEBON JERUK,KEDOYA SELATAN,32165,5759,26406,22112,48518,2021-11-21
3173051006,JAKARTA BARAT,KEBON JERUK,KEDOYA UTARA,45740,8559,37181,31762,68943,2021-11-21
3173051004,JAKARTA BARAT,KEBON JERUK,KELAPA DUA,23565,4513,19052,16104,35156,2021-11-21
3175091003,JAKARTA TIMUR,CIRACAS,KELAPA DUA WETAN,46875,7800,39075,33590,72665,2021-11-21
3172061003,JAKARTA UTARA,KELAPA GADING,KELAPA GADING BARAT,35717,6116,29601,26983,56584,2021-11-21
3172061001,JAKARTA UTARA,KELAPA GADING,KELAPA GADING TIMUR,33592,5044,28548,26683,55231,2021-11-21
3173071005,JAKARTA BARAT,PALMERAH,KEMANGGISAN,32139,5943,26196,22483,48679,2021-11-21
3171031001,JAKARTA PUSAT,KEMAYORAN,KEMAYORAN,20708,4042,16666,13912,30578,2021-11-21
3173081006,JAKARTA BARAT,KEMBANGAN,KEMBANGAN SELATAN,27130,5565,21565,18836,40401,2021-11-21
3173081001,JAKARTA BARAT,KEMBANGAN,KEMBANGAN UTARA,54451,11661,42790,36038,78828,2021-11-21
3171041002,JAKARTA PUSAT,SENEN,KENARI,9579,1827,7752,6677,14429,2021-11-21
3173041005,JAKARTA BARAT,TAMBORA,KERENDANG,19973,3954,16019,13225,29244,2021-11-21
3175071003,JAKARTA TIMUR,DUREN SAWIT,KLENDER,69978,16073,53905,43776,97681,2021-11-21
3172031001,JAKARTA UTARA,KOJA,KOJA,28175,6239,21936,18037,39973,2021-11-21
3173071006,JAKARTA BARAT,PALMERAH,KOTA BAMBU SELATAN,21158,4063,17095,13646,30741,2021-11-21
3173071003,JAKARTA BARAT,PALMERAH,KOTA BAMBU UTARA,24995,4988,20007,15826,35833,2021-11-21
3171041004,JAKARTA PUSAT,SENEN,KRAMAT,28835,6807,22028,17053,39081,2021-11-21
3175041001,JAKARTA TIMUR,KRAMAT JATI,KRAMAT JATI,34144,7068,27076,22350,49426,2021-11-21
3174071003,JAKARTA SELATAN,KEBAYORAN BARU,KRAMAT PELA,14413,2729,11684,10213,21897,2021-11-21
3173031002,JAKARTA BARAT,TAMAN SARI,KRUKUT,19244,3558,15686,12951,28637,2021-11-21
3174031005,JAKARTA SELATAN,MAMPANG PRAPATAN,KUNINGAN BARAT,12785,2280,10505,8967,19472,2021-11-21
3174021008,JAKARTA SELATAN,SETIA BUDI,KUNINGAN TIMUR,6008,1161,4847,4211,9058,2021-11-21
3171041005,JAKARTA PUSAT,SENEN,KWITANG,15486,3359,12127,9890,22017,2021-11-21
3172031003,JAKARTA UTARA,KOJA,LAGOA,59065,13622,45443,36594,82037,2021-11-21
3174061002,JAKARTA SELATAN,CILANDAK,LEBAK BULUS,37626,6927,30699,27352,58051,2021-11-21
3174091004,JAKARTA SELATAN,JAGAKARSA,LENTENG AGUNG,53946,9420,44526,37105,81631,2021-11-21
3175101007,JAKARTA TIMUR,CIPAYUNG,LUBANG BUAYA,63547,11702,51845,43831,95676,2021-11-21
3175081001,JAKARTA TIMUR,MAKASAR,MAKASAR,34390,6150,28240,24521,52761,2021-11-21
3175071006,JAKARTA TIMUR,DUREN SAWIT,MALAKA JAYA,30927,5142,25785,22574,48359,2021-11-21
3175071005,JAKARTA TIMUR,DUREN SAWIT,MALAKA SARI,27530,4432,23098,20347,43445,2021-11-21
3174031001,JAKARTA SELATAN,MAMPANG PRAPATAN,MAMPANG PRAPATAN,18159,3635,14524,12230,26754,2021-11-21
3173031005,JAKARTA BARAT,TAMAN SARI,MANGGA BESAR,7707,1277,6430,5731,12161,2021-11-21
3171021005,JAKARTA PUSAT,SAWAH BESAR,MANGGA DUA SELATAN,27442,5542,21900,18814,40714,2021-11-21
3174011007,JAKARTA SELATAN,TEBET,MANGGARAI,28373,4850,23523,19539,43062,2021-11-21
3174011006,JAKARTA SELATAN,TEBET,MANGGARAI SELATAN,23075,3758,19317,16523,35840,2021-11-21
3173031003,JAKARTA BARAT,TAMAN SARI,MAPHAR,16461,2996,13465,11419,24884,2021-11-21
3172041003,JAKARTA UTARA,CILINCING,MARUNDA,28943,6404,22539,17254,39793,2021-11-21
3174071001,JAKARTA SELATAN,KEBAYORAN BARU,MELAWAI,2627,501,2126,1970,4096,2021-11-21
3171061001,JAKARTA PUSAT,MENTENG,MENTENG,25624,5467,20157,16286,36443,2021-11-21
3174021005,JAKARTA SELATAN,SETIA BUDI,MENTENG ATAS,27816,4867,22949,19525,42474,2021-11-21
3174011003,JAKARTA SELATAN,TEBET,MENTENG DALAM,36028,6832,29196,25170,54366,2021-11-21
3173081003,JAKARTA BARAT,KEMBANGAN,MERUYA SELATAN,32130,6426,25704,22077,47781,2021-11-21
3173081002,JAKARTA BARAT,KEMBANGAN,MERUYA UTARA,43752,8806,34946,30815,65761,2021-11-21
3175101004,JAKARTA TIMUR,CIPAYUNG,MUNJUL,23871,4265,19606,16842,36448,2021-11-21
3172051002,JAKARTA UTARA,PADEMANGAN,PADEMANGAN BARAT,74240,16994,57246,47012,104258,2021-11-21
3172051001,JAKARTA UTARA,PADEMANGAN,PADEMANGAN TIMUR,37736,6528,31208,27859,59067,2021-11-21
3175011004,JAKARTA TIMUR,MATRAMAN,PAL MERIAM,19769,3942,15827,12970,28797,2021-11-21
3173071001,JAKARTA BARAT,PALMERAH,PALMERAH,63011,12879,50132,41553,91685,2021-11-21
3174081001,JAKARTA SELATAN,PANCORAN,PANCORAN,19421,3795,15626,13216,28842,2021-11-21
3172021003,JAKARTA UTARA,TANJUNG PRIOK,PAPANGGO,39097,7483,31614,26363,57977,2021-11-21
3171021001,JAKARTA PUSAT,SAWAH BESAR,PASAR BARU,12035,2248,9787,8864,18651,2021-11-21
3174021006,JAKARTA SELATAN,SETIA BUDI,PASAR MANGGIS,26752,5106,21646,18237,39883,2021-11-21
3174041001,JAKARTA SELATAN,PASAR MINGGU,PASAR MINGGU,24821,4576,20245,17623,37868,2021-11-21
3171041003,JAKARTA PUSAT,SENEN,PASEBAN,23533,4764,18769,15597,34366,2021-11-21
3173061005,JAKARTA BARAT,KALI DERES,PEGADUNGAN,75587,14394,61193,53093,114286,2021-11-21
3171061002,JAKARTA PUSAT,MENTENG,PEGANGSAAN,23455,4921,18534,14526,33060,2021-11-21
3172061002,JAKARTA UTARA,KELAPA GADING,PEGANGSAAN DUA,49976,8118,41858,38306,80164,2021-11-21
3172011004,JAKARTA UTARA,PENJARINGAN,PEJAGALAN,74578,15074,59504,52074,111578,2021-11-21
3174041006,JAKARTA SELATAN,PASAR MINGGU,PEJATEN BARAT,37346,7043,30303,25850,56153,2021-11-21
3174041005,JAKARTA SELATAN,PASAR MINGGU,PEJATEN TIMUR,57656,12251,45405,37633,83038,2021-11-21
3175051005,JAKARTA TIMUR,PASAR REBO,PEKAYON,43250,7666,35584,30189,65773,2021-11-21
3173041009,JAKARTA BARAT,TAMBORA,PEKOJAN,23587,4377,19210,16432,35642,2021-11-21
3174031003,JAKARTA SELATAN,MAMPANG PRAPATAN,PELA MAMPANG,43522,8325,35197,30053,65250,2021-11-21
3174081005,JAKARTA SELATAN,PANCORAN,PENGADEGAN,21478,3860,17618,15310,32928,2021-11-21
3175061003,JAKARTA TIMUR,CAKUNG,PENGGILINGAN,99255,22232,77023,62703,139726,2021-11-21
3172011001,JAKARTA UTARA,PENJARINGAN,PENJARINGAN,88308,22191,66117,51983,118100,2021-11-21
3174101001,JAKARTA SELATAN,PESANGGRAHAN,PESANGGRAHAN,27545,4628,22917,20010,42927,2021-11-21
3171071004,JAKARTA PUSAT,TANAH ABANG,PETAMBURAN,33271,8594,24677,19106,43783,2021-11-21
3174071008,JAKARTA SELATAN,KEBAYORAN BARU,PETOGOGAN,11499,2177,9322,8089,17411,2021-11-21
3171011004,JAKARTA PUSAT,GAMBIR,PETOJO SELATAN,14692,3236,11456,9824,21280,2021-11-21
3171011003,JAKARTA PUSAT,GAMBIR,PETOJO UTARA,17458,3695,13763,11517,25280,2021-11-21
3174101004,JAKARTA SELATAN,PESANGGRAHAN,PETUKANGAN SELATAN,37187,7475,29712,25501,55213,2021-11-21
3174101003,JAKARTA SELATAN,PESANGGRAHAN,PETUKANGAN UTARA,53716,11237,42479,35921,78400,2021-11-21
3175081002,JAKARTA TIMUR,MAKASAR,PINANG RANTI,27198,5773,21425,17953,39378,2021-11-21
3173031008,JAKARTA BARAT,TAMAN SARI,PINANGSIA,10729,1839,8890,7488,16378,2021-11-21
3175011001,JAKARTA TIMUR,MATRAMAN,PISANGAN BARU,31776,6354,25422,20720,46142,2021-11-21
3175021002,JAKARTA TIMUR,PULO GADUNG,PISANGAN TIMUR,41011,7394,33617,28863,62480,2021-11-21
3172011005,JAKARTA UTARA,PENJARINGAN,PLUIT,47783,9067,38716,34370,73086,2021-11-21
3175071002,JAKARTA TIMUR,DUREN SAWIT,PONDOK BAMBU,61550,12626,48924,41496,90420,2021-11-21
3175071004,JAKARTA TIMUR,DUREN SAWIT,PONDOK KELAPA,72015,13915,58100,50619,108719,2021-11-21
3175071007,JAKARTA TIMUR,DUREN SAWIT,PONDOK KOPI,35367,6480,28887,23545,52432,2021-11-21
3174061003,JAKARTA SELATAN,CILANDAK,PONDOK LABU,46464,7509,38955,34492,73447,2021-11-21
3174051002,JAKARTA SELATAN,KEBAYORAN LAMA,PONDOK PINANG,56169,10538,45631,39625,85256,2021-11-21
3175101003,JAKARTA TIMUR,CIPAYUNG,PONDOK RANGGON,25574,4683,20891,17804,38695,2021-11-21
3101011003,KAB.ADM.KEP.SERIBU,KEP. SERIBU UTARA,PULAU HARAPAN,2060,218,1842,1620,3462,2021-11-21
3101011002,KAB.ADM.KEP.SERIBU,KEP. SERIBU UTARA,PULAU KELAPA,5528,587,4941,4096,9037,2021-11-21
3101011001,KAB.ADM.KEP.SERIBU,KEP. SERIBU UTARA,PULAU PANGGANG,5450,428,5022,4503,9525,2021-11-21
3101021003,KAB.ADM.KEP.SERIBU,KEP. SERIBU SELATAN,PULAU PARI,2765,192,2573,2439,5012,2021-11-21
3101021002,KAB.ADM.KEP.SERIBU,KEP. SERIBU SELATAN,PULAU TIDUNG,4553,365,4188,3861,8049,2021-11-21
3101021001,KAB.ADM.KEP.SERIBU,KEP. SERIBU SELATAN,PULAU UNTUNG JAWA,1941,157,1784,1662,3446,2021-11-21
3174071007,JAKARTA SELATAN,KEBAYORAN BARU,PULO,5835,988,4847,4491,9338,2021-11-21
3175021001,JAKARTA TIMUR,PULO GADUNG,PULO GADUNG,34422,7370,27052,22951,50003,2021-11-21
3175061005,JAKARTA TIMUR,CAKUNG,PULO GEBANG,97301,18261,79040,65345,144385,2021-11-21
3174041004,JAKARTA SELATAN,PASAR MINGGU,RAGUNAN,39616,7038,32578,28282,60860,2021-11-21
3175091005,JAKARTA TIMUR,CIRACAS,RAMBUTAN,36771,8379,28392,23556,51948,2021-11-21
3172031006,JAKARTA UTARA,KOJA,RAWA BADAK SELATAN,42179,9748,32431,26166,58597,2021-11-21
3172031004,JAKARTA UTARA,KOJA,RAWA BADAK UTARA,34408,7501,26907,22151,49058,2021-11-21
3174071005,JAKARTA SELATAN,KEBAYORAN BARU,RAWA BARAT,5625,984,4641,4170,8811,2021-11-21
3173011003,JAKARTA BARAT,CENGKARENG,RAWA BUAYA,63799,12276,51523,43122,94645,2021-11-21
3175031004,JAKARTA TIMUR,JATINEGARA,RAWA BUNGA,21434,5047,16387,13589,29976,2021-11-21
3174081003,JAKARTA SELATAN,PANCORAN,RAWA JATI,20509,3827,16682,14521,31203,2021-11-21
3175061002,JAKARTA TIMUR,CAKUNG,RAWA TERATE,24637,4346,20291,16806,37097,2021-11-21
3175021005,JAKARTA TIMUR,PULO GADUNG,RAWAMANGUN,37612,7238,30374,26183,56557,2021-11-21
3171051003,JAKARTA PUSAT,CEMPAKA PUTIH,RAWASARI,21967,4347,17620,15334,32954,2021-11-21
3173041010,JAKARTA BARAT,TAMBORA,ROA MALAKA,3484,605,2879,2601,5480,2021-11-21
3172041006,JAKARTA UTARA,CILINCING,ROROTAN,41668,8141,33527,27459,60986,2021-11-21
3174071004,JAKARTA SELATAN,KEBAYORAN BARU,SELONG,2842,542,2300,2150,4450,2021-11-21
3173061002,JAKARTA BARAT,KALI DERES,SEMANAN,71354,14581,56773,46499,103272,2021-11-21
3172041007,JAKARTA UTARA,CILINCING,SEMPER BARAT,68587,13017,55570,46961,102531,2021-11-21
3172041005,JAKARTA UTARA,CILINCING,SEMPER TIMUR,36267,7580,28687,23734,52421,2021-11-21
3174071006,JAKARTA SELATAN,KEBAYORAN BARU,SENAYAN,2771,640,2131,1872,4003,2021-11-21
3171041001,JAKARTA PUSAT,SENEN,SENEN,6804,1415,5389,4544,9933,2021-11-21
3171031004,JAKARTA PUSAT,KEMAYORAN,SERDANG,29668,5623,24045,20360,44405,2021-11-21
3174021001,JAKARTA SELATAN,SETIA BUDI,SETIA BUDI,3023,595,2428,2119,4547,2021-11-21
3175101005,JAKARTA TIMUR,CIPAYUNG,SETU,20572,3998,16574,13792,30366,2021-11-21
3173071002,JAKARTA BARAT,PALMERAH,SLIPI,16591,2904,13687,11756,25443,2021-11-21
3173081004,JAKARTA BARAT,KEMBANGAN,SRENGSENG,45523,9963,35560,30519,66079,2021-11-21
3174091002,JAKARTA SELATAN,JAGAKARSA,SRENGSENG SAWAH,58196,8788,49408,42973,92381,2021-11-21
3173051003,JAKARTA BARAT,KEBON JERUK,SUKABUMI SELATAN,37033,7914,29119,22936,52055,2021-11-21
3173051002,JAKARTA BARAT,KEBON JERUK,SUKABUMI UTARA,38290,8761,29529,23682,53211,2021-11-21
3172041002,JAKARTA UTARA,CILINCING,SUKAPURA,53949,11877,42072,35211,77283,2021-11-21
3171031007,JAKARTA PUSAT,KEMAYORAN,SUMUR BATU,22717,4214,18503,16005,34508,2021-11-21
3172021004,JAKARTA UTARA,TANJUNG PRIOK,SUNGAI BAMBU,29876,5840,24036,20257,44293,2021-11-21
3172021006,JAKARTA UTARA,TANJUNG PRIOK,SUNTER AGUNG,71805,12132,59673,53011,112684,2021-11-21
3172021002,JAKARTA UTARA,TANJUNG PRIOK,SUNTER JAYA,63031,10812,52219,45980,98199,2021-11-21
3175091004,JAKARTA TIMUR,CIRACAS,SUSUKAN,38257,7040,31217,26524,57741,2021-11-21
3173031001,JAKARTA BARAT,TAMAN SARI,TAMAN SARI,14348,2560,11788,10257,22045,2021-11-21
3173041001,JAKARTA BARAT,TAMBORA,TAMBORA,10204,2152,8052,6584,14636,2021-11-21
3173041004,JAKARTA BARAT,TAMBORA,TANAH SEREAL,26387,4374,22013,18721,40734,2021-11-21
3171081004,JAKARTA PUSAT,JOHAR BARU,TANAH TINGGI,37693,7045,30648,25178,55826,2021-11-21
3173031004,JAKARTA BARAT,TAMAN SARI,TANGKI,13324,2166,11158,9600,20758,2021-11-21
3174091005,JAKARTA SELATAN,JAGAKARSA,TANJUNG BARAT,39770,6585,33185,28056,61241,2021-11-21
3173021005,JAKARTA BARAT,GROGOL PETAMBURAN,TANJUNG DUREN SELATAN,25337,4718,20619,18525,39144,2021-11-21
3173021002,JAKARTA BARAT,GROGOL PETAMBURAN,TANJUNG DUREN UTARA,17010,2802,14208,12943,27151,2021-11-21
3172021001,JAKARTA UTARA,TANJUNG PRIOK,TANJUNG PRIOK,34588,6982,27606,22920,50526,2021-11-21
3174011002,JAKARTA SELATAN,TEBET,TEBET BARAT,21194,3330,17864,15972,33836,2021-11-21
3174011001,JAKARTA SELATAN,TEBET,TEBET TIMUR,18199,2849,15350,14053,29403,2021-11-21
3173061003,JAKARTA BARAT,KALI DERES,TEGAL ALUR,83647,16923,66724,55969,122693,2021-11-21
3174031004,JAKARTA SELATAN,MAMPANG PRAPATAN,TEGAL PARANG,32401,6960,25441,20340,45781,2021-11-21
3173021003,JAKARTA BARAT,GROGOL PETAMBURAN,TOMANG,29605,5327,24278,21234,45512,2021-11-21
3172031005,JAKARTA UTARA,KOJA,TUGU SELATAN,39122,8540,30582,25245,55827,2021-11-21
3172031002,JAKARTA UTARA,KOJA,TUGU UTARA,67670,15623,52047,42018,94065,2021-11-21
3175061006,JAKARTA TIMUR,CAKUNG,UJUNG MENTENG,29934,5017,24917,21493,46410,2021-11-21
3174101005,JAKARTA SELATAN,PESANGGRAHAN,ULUJAMI,40544,8828,31716,26590,58306,2021-11-21
3175011006,JAKARTA TIMUR,MATRAMAN,UTAN KAYU SELATAN,33511,5871,27640,23323,50963,2021-11-21
3175011002,JAKARTA TIMUR,MATRAMAN,UTAN KAYU UTARA,28169,5691,22478,18752,41230,2021-11-21
3171031008,JAKARTA PUSAT,KEMAYORAN,UTAN PANJANG,29208,5618,23590,19398,42988,2021-11-21
3172021007,JAKARTA UTARA,TANJUNG PRIOK,WARAKAS,44401,7977,36424,29936,66360,2021-11-21
3173021007,JAKARTA BARAT,GROGOL PETAMBURAN,WIJAYA KUSUMA,38934,7926,31008,26560,57568,2021-11-21
3172051003,JAKARTA UTARA,PADEMANGAN,ANCOL,23947,5665,18282,15209,33491,2021-11-22
3173041007,JAKARTA BARAT,TAMBORA,ANGKE,29381,6085,23296,19132,42428,2021-11-22
3175041005,JAKARTA TIMUR,KRAMAT JATI,BALE KAMBANG,29074,6929,22145,17742,39887,2021-11-22
3175031003,JAKARTA TIMUR,JATINEGARA,BALI MESTER,9752,1979,7773,6633,14406,2021-11-22
3175101006,JAKARTA TIMUR,CIPAYUNG,BAMBU APUS,26285,4732,21553,18318,39871,2021-11-22
3174031002,JAKARTA SELATAN,MAMPANG PRAPATAN,BANGKA,21566,4439,17127,14431,31558,2021-11-22
3175051002,JAKARTA TIMUR,PASAR REBO,BARU,23886,3867,20019,17475,37494,2021-11-22
3175041004,JAKARTA TIMUR,KRAMAT JATI,BATU AMPAR,47898,11232,36666,30129,66795,2021-11-22
3171071002,JAKARTA PUSAT,TANAH ABANG,BENDUNGAN HILIR,21494,4256,17238,14915,32153,2021-11-22
3175031002,JAKARTA TIMUR,JATINEGARA,BIDARA CINA,36689,8579,28110,22982,51092,2021-11-22
3174101002,JAKARTA SELATAN,PESANGGRAHAN,BINTARO,53098,10418,42680,37444,80124,2021-11-22
3174011005,JAKARTA SELATAN,TEBET,BUKIT DURI,34183,6698,27485,23232,50717,2021-11-22
3171041006,JAKARTA PUSAT,SENEN,BUNGUR,18144,3693,14451,12108,26559,2021-11-22
3175061007,JAKARTA TIMUR,CAKUNG,CAKUNG BARAT,57724,11537,46187,38528,84715,2021-11-22
3175061004,JAKARTA TIMUR,CAKUNG,CAKUNG TIMUR,58287,11159,47128,39721,86849,2021-11-22
3175041007,JAKARTA TIMUR,KRAMAT JATI,CAWANG,32762,6823,25939,21187,47126,2021-11-22
3175101008,JAKARTA TIMUR,CIPAYUNG,CEGER,18932,3577,15355,12988,28343,2021-11-22
3171031006,JAKARTA PUSAT,KEMAYORAN,CEMPAKA BARU,32581,6004,26577,21594,48171,2021-11-22
3171051002,JAKARTA PUSAT,CEMPAKA PUTIH,CEMPAKA PUTIH BARAT,35885,7458,28427,24641,53068,2021-11-22
3171051001,JAKARTA PUSAT,CEMPAKA PUTIH,CEMPAKA PUTIH TIMUR,24292,4900,19392,17207,36599,2021-11-22
3173011001,JAKARTA BARAT,CENGKARENG,CENGKARENG BARAT,66284,12852,53432,46396,99828,2021-11-22
3173011006,JAKARTA BARAT,CENGKARENG,CENGKARENG TIMUR,81027,15618,65409,55179,120588,2021-11-22
3175091002,JAKARTA TIMUR,CIRACAS,CIBUBUR,66364,11146,55218,47548,102766,2021-11-22
3171011002,JAKARTA PUSAT,GAMBIR,CIDENG,15390,2963,12427,10982,23409,2021-11-22
3174091003,JAKARTA SELATAN,JAGAKARSA,CIGANJUR,38497,6307,32190,27242,59432,2021-11-22
3175051003,JAKARTA TIMUR,PASAR REBO,CIJANTUNG,41419,7478,33941,28805,62746,2021-11-22
3171061003,JAKARTA PUSAT,MENTENG,CIKINI,8274,1466,6808,5506,12314,2021-11-22
3174081006,JAKARTA SELATAN,PANCORAN,CIKOKO,10547,1778,8769,7691,16460,2021-11-22
3174061001,JAKARTA SELATAN,CILANDAK,CILANDAK BARAT,51752,8878,42874,38031,80905,2021-11-22
3174041003,JAKARTA SELATAN,PASAR MINGGU,CILANDAK TIMUR,25145,4485,20660,17882,38542,2021-11-22
3175101002,JAKARTA TIMUR,CIPAYUNG,CILANGKAP,27635,4783,22852,19708,42560,2021-11-22
3175041006,JAKARTA TIMUR,KRAMAT JATI,CILILITAN,40181,8299,31882,26337,58219,2021-11-22
3172041001,JAKARTA UTARA,CILINCING,CILINCING,43609,10202,33407,26408,59815,2021-11-22
3175101001,JAKARTA TIMUR,CIPAYUNG,CIPAYUNG,26104,4453,21651,18818,40469,2021-11-22
3174091006,JAKARTA SELATAN,JAGAKARSA,CIPEDAK,38303,6181,32122,27593,59715,2021-11-22
3174061005,JAKARTA SELATAN,CILANDAK,CIPETE SELATAN,26704,4972,21732,19355,41087,2021-11-22
3174071010,JAKARTA SELATAN,KEBAYORAN BARU,CIPETE UTARA,34102,6305,27797,23641,51438,2021-11-22
3175021003,JAKARTA TIMUR,PULO GADUNG,CIPINANG,39306,6992,32314,27288,59602,2021-11-22
3175031007,JAKARTA TIMUR,JATINEGARA,CIPINANG BESAR SELATAN,35212,8091,27121,21728,48849,2021-11-22
3175031008,JAKARTA TIMUR,JATINEGARA,CIPINANG BESAR UTARA,45319,10412,34907,27742,62649,2021-11-22
3175031005,JAKARTA TIMUR,JATINEGARA,CIPINANG CEMPEDAK,32824,6990,25834,22313,48147,2021-11-22
3175081005,JAKARTA TIMUR,MAKASAR,CIPINANG MELAYU,42308,7982,34326,29607,63933,2021-11-22
3175031006,JAKARTA TIMUR,JATINEGARA,CIPINANG MUARA,55243,11451,43792,36354,80146,2021-11-22
3174051003,JAKARTA SELATAN,KEBAYORAN LAMA,CIPULIR,39937,8268,31669,26261,57930,2021-11-22
3175091001,JAKARTA TIMUR,CIRACAS,CIRACAS,64594,11569,53025,44687,97712,2021-11-22
3175041003,JAKARTA TIMUR,KRAMAT JATI,DUKUH,24609,4440,20169,16919,37088,2021-11-22
3175071001,JAKARTA TIMUR,DUREN SAWIT,DUREN SAWIT,61160,12626,48534,41102,89636,2021-11-22
3174081004,JAKARTA SELATAN,PANCORAN,DUREN TIGA,28319,5476,22843,19387,42230,2021-11-22
3173051005,JAKARTA BARAT,KEBON JERUK,DURI KEPA,60138,11576,48562,42396,90958,2021-11-22
3173011002,JAKARTA BARAT,CENGKARENG,DURI KOSAMBI,77923,16215,61708,50441,112149,2021-11-22
3171011006,JAKARTA PUSAT,GAMBIR,DURI PULO,19610,4058,15552,12672,28224,2021-11-22
3173041011,JAKARTA BARAT,TAMBORA,DURI SELATAN,14259,2481,11778,10108,21886,2021-11-22
3173041003,JAKARTA BARAT,TAMBORA,DURI UTARA,19844,3498,16346,13637,29983,2021-11-22
3171081003,JAKARTA PUSAT,JOHAR BARU,GALUR,18243,3490,14753,12090,26843,2021-11-22
3171011001,JAKARTA PUSAT,GAMBIR,GAMBIR,2191,451,1740,1526,3266,2021-11-22
3174061004,JAKARTA SELATAN,CILANDAK,GANDARIA SELATAN,22119,4123,17996,15634,33630,2021-11-22
3174071009,JAKARTA SELATAN,KEBAYORAN BARU,GANDARIA UTARA,39922,7724,32198,27708,59906,2021-11-22
3175051001,JAKARTA TIMUR,PASAR REBO,GEDONG,35755,7003,28752,24640,53392,2021-11-22
3171071001,JAKARTA PUSAT,TANAH ABANG,GELORA,3127,596,2531,2226,4757,2021-11-22
3173031007,JAKARTA BARAT,TAMAN SARI,GLODOK,7837,1153,6684,6085,12769,2021-11-22
3171061004,JAKARTA PUSAT,MENTENG,GONDANGDIA,4100,904,3196,2932,6128,2021-11-22
3173021001,JAKARTA BARAT,GROGOL PETAMBURAN,GROGOL,16876,3282,13594,11677,25271,2021-11-22
3174051005,JAKARTA SELATAN,KEBAYORAN LAMA,GROGOL SELATAN,44251,8636,35615,29930,65545,2021-11-22
3174051004,JAKARTA SELATAN,KEBAYORAN LAMA,GROGOL UTARA,42494,8461,34033,28715,62748,2021-11-22
3174021007,JAKARTA SELATAN,SETIA BUDI,GUNTUR,3985,729,3256,2926,6182,2021-11-22
3174071002,JAKARTA SELATAN,KEBAYORAN BARU,GUNUNG,9436,1716,7720,6953,14673,2021-11-22
3171031005,JAKARTA PUSAT,KEMAYORAN,GUNUNG SAHARI SELATAN,19199,3723,15476,13223,28699,2021-11-22
3171021004,JAKARTA PUSAT,SAWAH BESAR,GUNUNG SAHARI UTARA,16650,2875,13775,12409,26184,2021-11-22
3175081004,JAKARTA TIMUR,MAKASAR,HALIM PERDANA KUSUMAH,28363,3587,24776,22814,47590,2021-11-22
3171031003,JAKARTA PUSAT,KEMAYORAN,HARAPAN MULIA,22557,4333,18224,15107,33331,2021-11-22
3174091001,JAKARTA SELATAN,JAGAKARSA,JAGAKARSA,62389,9977,52412,45054,97466,2021-11-22
3175021007,JAKARTA TIMUR,PULO GADUNG,JATI,32757,5994,26763,23557,50320,2021-11-22
3174041002,JAKARTA SELATAN,PASAR MINGGU,JATI PADANG,37502,7071,30431,26067,56498,2021-11-22
3173071004,JAKARTA BARAT,PALMERAH,JATI PULO,28738,5573,23165,18826,41991,2021-11-22
3175061001,JAKARTA TIMUR,CAKUNG,JATINEGARA,84160,17318,66842,55980,122822,2021-11-22
3175021004,JAKARTA TIMUR,PULO GADUNG,JATINEGARA KAUM,24632,4276,20356,16884,37240,2021-11-22
3173021004,JAKARTA BARAT,GROGOL PETAMBURAN,JELAMBAR,30266,5399,24867,22153,47020,2021-11-22
3173021006,JAKARTA BARAT,GROGOL PETAMBURAN,JELAMBAR BARU,38246,6811,31435,27726,59161,2021-11-22
3173041006,JAKARTA BARAT,TAMBORA,JEMBATAN BESI,29314,6955,22359,17807,40166,2021-11-22
3173041008,JAKARTA BARAT,TAMBORA,JEMBATAN LIMA,21021,4719,16302,13161,29463,2021-11-22
3173081005,JAKARTA BARAT,KEMBANGAN,JOGLO,40839,7988,32851,28207,61058,2021-11-22
3171081001,JAKARTA PUSAT,JOHAR BARU,JOHAR BARU,37488,6811,30677,26226,56903,2021-11-22
3173041002,JAKARTA BARAT,TAMBORA,KALI ANYAR,23856,4590,19266,15592,34858,2021-11-22
3172041004,JAKARTA UTARA,CILINCING,KALIBARU,67684,18107,49577,35705,85282,2021-11-22
3174081002,JAKARTA SELATAN,PANCORAN,KALIBATA,41994,9279,32715,27140,59855,2021-11-22
3173061001,JAKARTA BARAT,KALI DERES,KALIDERES,72447,14167,58280,49986,108266,2021-11-22
3175051004,JAKARTA TIMUR,PASAR REBO,KALISARI,43212,7490,35722,30630,66352,2021-11-22
3173061004,JAKARTA BARAT,KALI DERES,KAMAL,53783,12253,41530,33836,75366,2021-11-22
3172011002,JAKARTA UTARA,PENJARINGAN,KAMAL MUARA,12930,2260,10670,9162,19832,2021-11-22
3171071007,JAKARTA PUSAT,TANAH ABANG,KAMPUNG BALI,11358,2408,8950,7054,16004,2021-11-22
3175031001,JAKARTA TIMUR,JATINEGARA,KAMPUNG MELAYU,25717,5741,19976,15936,35912,2021-11-22
3171081002,JAKARTA PUSAT,JOHAR BARU,KAMPUNG RAWA,21237,3447,17790,14447,32237,2021-11-22
3175041002,JAKARTA TIMUR,KRAMAT JATI,KAMPUNG TENGAH,43993,10764,33229,27065,60294,2021-11-22
3173011005,JAKARTA BARAT,CENGKARENG,KAPUK,134466,31476,102990,84926,187916,2021-11-22
3172011003,JAKARTA UTARA,PENJARINGAN,KAPUK MUARA,35781,6709,29072,25828,54900,2021-11-22
3171021002,JAKARTA PUSAT,SAWAH BESAR,KARANG ANYAR,25761,4784,20977,17852,38829,2021-11-22
3174021004,JAKARTA SELATAN,SETIA BUDI,KARET,9623,1819,7804,6619,14423,2021-11-22
3174021003,JAKARTA SELATAN,SETIA BUDI,KARET KUNINGAN,16055,3053,13002,11203,24205,2021-11-22
3174021002,JAKARTA SELATAN,SETIA BUDI,KARET SEMANGGI,2770,550,2220,1984,4204,2021-11-22
3171071003,JAKARTA PUSAT,TANAH ABANG,KARET TENGSIN,19271,3643,15628,12983,28611,2021-11-22
3171021003,JAKARTA PUSAT,SAWAH BESAR,KARTINI,22292,4101,18191,15826,34017,2021-11-22
3175011003,JAKARTA TIMUR,MATRAMAN,KAYU MANIS,25284,5169,20115,16409,36524,2021-11-22
3175021006,JAKARTA TIMUR,PULO GADUNG,KAYU PUTIH,40696,7513,33183,29368,62551,2021-11-22
3173031006,JAKARTA BARAT,TAMAN SARI,KEAGUNGAN,17387,3161,14226,11865,26091,2021-11-22
3174041007,JAKARTA SELATAN,PASAR MINGGU,KEBAGUSAN,44552,8605,35947,30293,66240,2021-11-22
3174051006,JAKARTA SELATAN,KEBAYORAN LAMA,KEBAYORAN LAMA SELATAN,41212,7460,33752,29210,62962,2021-11-22
3174051001,JAKARTA SELATAN,KEBAYORAN LAMA,KEBAYORAN LAMA UTARA,42422,8596,33826,28519,62345,2021-11-22
3174011004,JAKARTA SELATAN,TEBET,KEBON BARU,35165,6438,28727,24612,53339,2021-11-22
3172021005,JAKARTA UTARA,TANJUNG PRIOK,KEBON BAWANG,50952,10004,40948,34627,75575,2021-11-22
3173051001,JAKARTA BARAT,KEBON JERUK,KEBON JERUK,53887,10689,43198,35694,78892,2021-11-22
3171071006,JAKARTA PUSAT,TANAH ABANG,KEBON KACANG,21531,5021,16510,13277,29787,2021-11-22
3171011005,JAKARTA PUSAT,GAMBIR,KEBON KELAPA,10163,1994,8169,7019,15188,2021-11-22
3171031002,JAKARTA PUSAT,KEMAYORAN,KEBON KOSONG,30019,5869,24150,20102,44252,2021-11-22
3175011005,JAKARTA TIMUR,MATRAMAN,KEBON MANGGIS,16490,3130,13360,11218,24578,2021-11-22
3171071005,JAKARTA PUSAT,TANAH ABANG,KEBON MELATI,32206,8436,23770,18024,41794,2021-11-22
3175081003,JAKARTA TIMUR,MAKASAR,KEBON PALA,46614,8934,37680,31930,69610,2021-11-22
3171061005,JAKARTA PUSAT,MENTENG,KEBON SIRIH,12299,2570,9729,7934,17663,2021-11-22
3173011004,JAKARTA BARAT,CENGKARENG,KEDAUNG KALI ANGKE,32612,6148,26464,22603,49067,2021-11-22
3173051007,JAKARTA BARAT,KEBON JERUK,KEDOYA SELATAN,32165,5752,26413,22132,48545,2021-11-22
3173051006,JAKARTA BARAT,KEBON JERUK,KEDOYA UTARA,45740,8556,37184,31783,68967,2021-11-22
3173051004,JAKARTA BARAT,KEBON JERUK,KELAPA DUA,23565,4510,19055,16109,35164,2021-11-22
3175091003,JAKARTA TIMUR,CIRACAS,KELAPA DUA WETAN,46875,7799,39076,33597,72673,2021-11-22
3172061003,JAKARTA UTARA,KELAPA GADING,KELAPA GADING BARAT,35717,6114,29603,26993,56596,2021-11-22
3172061001,JAKARTA UTARA,KELAPA GADING,KELAPA GADING TIMUR,33592,5042,28550,26692,55242,2021-11-22
3173071005,JAKARTA BARAT,PALMERAH,KEMANGGISAN,32139,5943,26196,22489,48685,2021-11-22
3171031001,JAKARTA PUSAT,KEMAYORAN,KEMAYORAN,20708,4042,16666,13920,30586,2021-11-22
3173081006,JAKARTA BARAT,KEMBANGAN,KEMBANGAN SELATAN,27130,5564,21566,18839,40405,2021-11-22
3173081001,JAKARTA BARAT,KEMBANGAN,KEMBANGAN UTARA,54451,11659,42792,36047,78839,2021-11-22
3171041002,JAKARTA PUSAT,SENEN,KENARI,9579,1827,7752,6678,14430,2021-11-22
3173041005,JAKARTA BARAT,TAMBORA,KERENDANG,19973,3953,16020,13228,29248,2021-11-22
3175071003,JAKARTA TIMUR,DUREN SAWIT,KLENDER,69978,16071,53907,43793,97700,2021-11-22
3172031001,JAKARTA UTARA,KOJA,KOJA,28175,6238,21937,18045,39982,2021-11-22
3173071006,JAKARTA BARAT,PALMERAH,KOTA BAMBU SELATAN,21158,4062,17096,13648,30744,2021-11-22
3173071003,JAKARTA BARAT,PALMERAH,KOTA BAMBU UTARA,24995,4983,20012,15831,35843,2021-11-22
3171041004,JAKARTA PUSAT,SENEN,KRAMAT,28835,6802,22033,17063,39096,2021-11-22
3175041001,JAKARTA TIMUR,KRAMAT JATI,KRAMAT JATI,34144,7068,27076,22358,49434,2021-11-22
3174071003,JAKARTA SELATAN,KEBAYORAN BARU,KRAMAT PELA,14413,2727,11686,10217,21903,2021-11-22
3173031002,JAKARTA BARAT,TAMAN SARI,KRUKUT,19244,3557,15687,12954,28641,2021-11-22
3174031005,JAKARTA SELATAN,MAMPANG PRAPATAN,KUNINGAN BARAT,12785,2279,10506,8970,19476,2021-11-22
3174021008,JAKARTA SELATAN,SETIA BUDI,KUNINGAN TIMUR,6008,1161,4847,4211,9058,2021-11-22
3171041005,JAKARTA PUSAT,SENEN,KWITANG,15486,3358,12128,9890,22018,2021-11-22
3172031003,JAKARTA UTARA,KOJA,LAGOA,59065,13618,45447,36609,82056,2021-11-22
3174061002,JAKARTA SELATAN,CILANDAK,LEBAK BULUS,37626,6923,30703,27360,58063,2021-11-22
3174091004,JAKARTA SELATAN,JAGAKARSA,LENTENG AGUNG,53946,9401,44545,37166,81711,2021-11-22
3175101007,JAKARTA TIMUR,CIPAYUNG,LUBANG BUAYA,63547,11699,51848,43844,95692,2021-11-22
3175081001,JAKARTA TIMUR,MAKASAR,MAKASAR,34390,6150,28240,24529,52769,2021-11-22
3175071006,JAKARTA TIMUR,DUREN SAWIT,MALAKA JAYA,30927,5141,25786,22584,48370,2021-11-22
3175071005,JAKARTA TIMUR,DUREN SAWIT,MALAKA SARI,27530,4429,23101,20355,43456,2021-11-22
3174031001,JAKARTA SELATAN,MAMPANG PRAPATAN,MAMPANG PRAPATAN,18159,3635,14524,12236,26760,2021-11-22
3173031005,JAKARTA BARAT,TAMAN SARI,MANGGA BESAR,7707,1276,6431,5734,12165,2021-11-22
3171021005,JAKARTA PUSAT,SAWAH BESAR,MANGGA DUA SELATAN,27442,5539,21903,18817,40720,2021-11-22
3174011007,JAKARTA SELATAN,TEBET,MANGGARAI,28373,4847,23526,19548,43074,2021-11-22
3174011006,JAKARTA SELATAN,TEBET,MANGGARAI SELATAN,23075,3755,19320,16528,35848,2021-11-22
3173031003,JAKARTA BARAT,TAMAN SARI,MAPHAR,16461,2993,13468,11431,24899,2021-11-22
3172041003,JAKARTA UTARA,CILINCING,MARUNDA,28943,6402,22541,17256,39797,2021-11-22
3174071001,JAKARTA SELATAN,KEBAYORAN BARU,MELAWAI,2627,501,2126,1970,4096,2021-11-22
3171061001,JAKARTA PUSAT,MENTENG,MENTENG,25624,5465,20159,16288,36447,2021-11-22
3174021005,JAKARTA SELATAN,SETIA BUDI,MENTENG ATAS,27816,4865,22951,19532,42483,2021-11-22
3174011003,JAKARTA SELATAN,TEBET,MENTENG DALAM,36028,6831,29197,25175,54372,2021-11-22
3173081003,JAKARTA BARAT,KEMBANGAN,MERUYA SELATAN,32130,6422,25708,22082,47790,2021-11-22
3173081002,JAKARTA BARAT,KEMBANGAN,MERUYA UTARA,43752,8805,34947,30829,65776,2021-11-22
3175101004,JAKARTA TIMUR,CIPAYUNG,MUNJUL,23871,4262,19609,16844,36453,2021-11-22
3172051002,JAKARTA UTARA,PADEMANGAN,PADEMANGAN BARAT,74240,16986,57254,47023,104277,2021-11-22
3172051001,JAKARTA UTARA,PADEMANGAN,PADEMANGAN TIMUR,37736,6528,31208,27866,59074,2021-11-22
3175011004,JAKARTA TIMUR,MATRAMAN,PAL MERIAM,19769,3940,15829,12974,28803,2021-11-22
3173071001,JAKARTA BARAT,PALMERAH,PALMERAH,63011,12878,50133,41575,91708,2021-11-22
3174081001,JAKARTA SELATAN,PANCORAN,PANCORAN,19421,3795,15626,13221,28847,2021-11-22
3172021003,JAKARTA UTARA,TANJUNG PRIOK,PAPANGGO,39097,7482,31615,26369,57984,2021-11-22
3171021001,JAKARTA PUSAT,SAWAH BESAR,PASAR BARU,12035,2247,9788,8865,18653,2021-11-22
3174021006,JAKARTA SELATAN,SETIA BUDI,PASAR MANGGIS,26752,5103,21649,18242,39891,2021-11-22
3174041001,JAKARTA SELATAN,PASAR MINGGU,PASAR MINGGU,24821,4575,20246,17634,37880,2021-11-22
3171041003,JAKARTA PUSAT,SENEN,PASEBAN,23533,4761,18772,15604,34376,2021-11-22
3173061005,JAKARTA BARAT,KALI DERES,PEGADUNGAN,75587,14388,61199,53122,114321,2021-11-22
3171061002,JAKARTA PUSAT,MENTENG,PEGANGSAAN,23455,4917,18538,14529,33067,2021-11-22
3172061002,JAKARTA UTARA,KELAPA GADING,PEGANGSAAN DUA,49976,8117,41859,38320,80179,2021-11-22
3172011004,JAKARTA UTARA,PENJARINGAN,PEJAGALAN,74578,15065,59513,52093,111606,2021-11-22
3174041006,JAKARTA SELATAN,PASAR MINGGU,PEJATEN BARAT,37346,7041,30305,25860,56165,2021-11-22
3174041005,JAKARTA SELATAN,PASAR MINGGU,PEJATEN TIMUR,57656,12242,45414,37644,83058,2021-11-22
3175051005,JAKARTA TIMUR,PASAR REBO,PEKAYON,43250,7661,35589,30196,65785,2021-11-22
3173041009,JAKARTA BARAT,TAMBORA,PEKOJAN,23587,4376,19211,16435,35646,2021-11-22
3174031003,JAKARTA SELATAN,MAMPANG PRAPATAN,PELA MAMPANG,43522,8324,35198,30060,65258,2021-11-22
3174081005,JAKARTA SELATAN,PANCORAN,PENGADEGAN,21478,3858,17620,15314,32934,2021-11-22
3175061003,JAKARTA TIMUR,CAKUNG,PENGGILINGAN,99255,22199,77056,62776,139832,2021-11-22
3172011001,JAKARTA UTARA,PENJARINGAN,PENJARINGAN,88308,22163,66145,52035,118180,2021-11-22
3174101001,JAKARTA SELATAN,PESANGGRAHAN,PESANGGRAHAN,27545,4627,22918,20018,42936,2021-11-22
3171071004,JAKARTA PUSAT,TANAH ABANG,PETAMBURAN,33271,8589,24682,19120,43802,2021-11-22
3174071008,JAKARTA SELATAN,KEBAYORAN BARU,PETOGOGAN,11499,2177,9322,8096,17418,2021-11-22
3171011004,JAKARTA PUSAT,GAMBIR,PETOJO SELATAN,14692,3236,11456,9827,21283,2021-11-22
3171011003,JAKARTA PUSAT,GAMBIR,PETOJO UTARA,17458,3695,13763,11519,25282,2021-11-22
3174101004,JAKARTA SELATAN,PESANGGRAHAN,PETUKANGAN SELATAN,37187,7472,29715,25512,55227,2021-11-22
3174101003,JAKARTA SELATAN,PESANGGRAHAN,PETUKANGAN UTARA,53716,11233,42483,35925,78408,2021-11-22
3175081002,JAKARTA TIMUR,MAKASAR,PINANG RANTI,27198,5772,21426,17955,39381,2021-11-22
3173031008,JAKARTA BARAT,TAMAN SARI,PINANGSIA,10729,1839,8890,7494,16384,2021-11-22
3175011001,JAKARTA TIMUR,MATRAMAN,PISANGAN BARU,31776,6343,25433,20760,46193,2021-11-22
3175021002,JAKARTA TIMUR,PULO GADUNG,PISANGAN TIMUR,41011,7391,33620,28873,62493,2021-11-22
3172011005,JAKARTA UTARA,PENJARINGAN,PLUIT,47783,9067,38716,34374,73090,2021-11-22
3175071002,JAKARTA TIMUR,DUREN SAWIT,PONDOK BAMBU,61550,12619,48931,41508,90439,2021-11-22
3175071004,JAKARTA TIMUR,DUREN SAWIT,PONDOK KELAPA,72015,13913,58102,50625,108727,2021-11-22
3175071007,JAKARTA TIMUR,DUREN SAWIT,PONDOK KOPI,35367,6480,28887,23550,52437,2021-11-22
3174061003,JAKARTA SELATAN,CILANDAK,PONDOK LABU,46464,7506,38958,34513,73471,2021-11-22
3174051002,JAKARTA SELATAN,KEBAYORAN LAMA,PONDOK PINANG,56169,10533,45636,39641,85277,2021-11-22
3175101003,JAKARTA TIMUR,CIPAYUNG,PONDOK RANGGON,25574,4680,20894,17806,38700,2021-11-22
3101011003,KAB.ADM.KEP.SERIBU,KEP. SERIBU UTARA,PULAU HARAPAN,2060,218,1842,1620,3462,2021-11-22
3101011002,KAB.ADM.KEP.SERIBU,KEP. SERIBU UTARA,PULAU KELAPA,5528,587,4941,4098,9039,2021-11-22
3101011001,KAB.ADM.KEP.SERIBU,KEP. SERIBU UTARA,PULAU PANGGANG,5450,427,5023,4503,9526,2021-11-22
3101021003,KAB.ADM.KEP.SERIBU,KEP. SERIBU SELATAN,PULAU PARI,2765,192,2573,2439,5012,2021-11-22
3101021002,KAB.ADM.KEP.SERIBU,KEP. SERIBU SELATAN,PULAU TIDUNG,4553,365,4188,3861,8049,2021-11-22
3101021001,KAB.ADM.KEP.SERIBU,KEP. SERIBU SELATAN,PULAU UNTUNG JAWA,1941,156,1785,1662,3447,2021-11-22
3174071007,JAKARTA SELATAN,KEBAYORAN BARU,PULO,5835,988,4847,4493,9340,2021-11-22
3175021001,JAKARTA TIMUR,PULO GADUNG,PULO GADUNG,34422,7363,27059,22962,50021,2021-11-22
3175061005,JAKARTA TIMUR,CAKUNG,PULO GEBANG,97301,18253,79048,65399,144447,2021-11-22
3174041004,JAKARTA SELATAN,PASAR MINGGU,RAGUNAN,39616,7036,32580,28289,60869,2021-11-22
3175091005,JAKARTA TIMUR,CIRACAS,RAMBUTAN,36771,8374,28397,23562,51959,2021-11-22
3172031006,JAKARTA UTARA,KOJA,RAWA BADAK SELATAN,42179,9733,32446,26187,58633,2021-11-22
3172031004,JAKARTA UTARA,KOJA,RAWA BADAK UTARA,34408,7500,26908,22157,49065,2021-11-22
3174071005,JAKARTA SELATAN,KEBAYORAN BARU,RAWA BARAT,5625,984,4641,4171,8812,2021-11-22
3173011003,JAKARTA BARAT,CENGKARENG,RAWA BUAYA,63799,12271,51528,43144,94672,2021-11-22
3175031004,JAKARTA TIMUR,JATINEGARA,RAWA BUNGA,21434,5044,16390,13594,29984,2021-11-22
3174081003,JAKARTA SELATAN,PANCORAN,RAWA JATI,20509,3823,16686,14525,31211,2021-11-22
3175061002,JAKARTA TIMUR,CAKUNG,RAWA TERATE,24637,4339,20298,16817,37115,2021-11-22
3175021005,JAKARTA TIMUR,PULO GADUNG,RAWAMANGUN,37612,7234,30378,26194,56572,2021-11-22
3171051003,JAKARTA PUSAT,CEMPAKA PUTIH,RAWASARI,21967,4347,17620,15337,32957,2021-11-22
3173041010,JAKARTA BARAT,TAMBORA,ROA MALAKA,3484,605,2879,2601,5480,2021-11-22
3172041006,JAKARTA UTARA,CILINCING,ROROTAN,41668,8136,33532,27465,60997,2021-11-22
3174071004,JAKARTA SELATAN,KEBAYORAN BARU,SELONG,2842,542,2300,2151,4451,2021-11-22
3173061002,JAKARTA BARAT,KALI DERES,SEMANAN,71354,14542,56812,46550,103362,2021-11-22
3172041007,JAKARTA UTARA,CILINCING,SEMPER BARAT,68587,13012,55575,46974,102549,2021-11-22
3172041005,JAKARTA UTARA,CILINCING,SEMPER TIMUR,36267,7580,28687,23738,52425,2021-11-22
3174071006,JAKARTA SELATAN,KEBAYORAN BARU,SENAYAN,2771,640,2131,1877,4008,2021-11-22
3171041001,JAKARTA PUSAT,SENEN,SENEN,6804,1412,5392,4545,9937,2021-11-22
3171031004,JAKARTA PUSAT,KEMAYORAN,SERDANG,29668,5619,24049,20368,44417,2021-11-22
3174021001,JAKARTA SELATAN,SETIA BUDI,SETIA BUDI,3023,595,2428,2119,4547,2021-11-22
3175101005,JAKARTA TIMUR,CIPAYUNG,SETU,20572,3996,16576,13798,30374,2021-11-22
3173071002,JAKARTA BARAT,PALMERAH,SLIPI,16591,2903,13688,11758,25446,2021-11-22
3173081004,JAKARTA BARAT,KEMBANGAN,SRENGSENG,45523,9959,35564,30529,66093,2021-11-22
3174091002,JAKARTA SELATAN,JAGAKARSA,SRENGSENG SAWAH,58196,8662,49534,43324,92858,2021-11-22
3173051003,JAKARTA BARAT,KEBON JERUK,SUKABUMI SELATAN,37033,7908,29125,22945,52070,2021-11-22
3173051002,JAKARTA BARAT,KEBON JERUK,SUKABUMI UTARA,38290,8750,29540,23701,53241,2021-11-22
3172041002,JAKARTA UTARA,CILINCING,SUKAPURA,53949,11868,42081,35219,77300,2021-11-22
3171031007,JAKARTA PUSAT,KEMAYORAN,SUMUR BATU,22717,4212,18505,16010,34515,2021-11-22
3172021004,JAKARTA UTARA,TANJUNG PRIOK,SUNGAI BAMBU,29876,5837,24039,20265,44304,2021-11-22
3172021006,JAKARTA UTARA,TANJUNG PRIOK,SUNTER AGUNG,71805,12129,59676,53020,112696,2021-11-22
3172021002,JAKARTA UTARA,TANJUNG PRIOK,SUNTER JAYA,63031,10809,52222,45993,98215,2021-11-22
3175091004,JAKARTA TIMUR,CIRACAS,SUSUKAN,38257,7039,31218,26530,57748,2021-11-22
3173031001,JAKARTA BARAT,TAMAN SARI,TAMAN SARI,14348,2560,11788,10268,22056,2021-11-22
3173041001,JAKARTA BARAT,TAMBORA,TAMBORA,10204,2152,8052,6585,14637,2021-11-22
3173041004,JAKARTA BARAT,TAMBORA,TANAH SEREAL,26387,4372,22015,18726,40741,2021-11-22
3171081004,JAKARTA PUSAT,JOHAR BARU,TANAH TINGGI,37693,7044,30649,25183,55832,2021-11-22
3173031004,JAKARTA BARAT,TAMAN SARI,TANGKI,13324,2165,11159,9609,20768,2021-11-22
3174091005,JAKARTA SELATAN,JAGAKARSA,TANJUNG BARAT,39770,6584,33186,28068,61254,2021-11-22
3173021005,JAKARTA BARAT,GROGOL PETAMBURAN,TANJUNG DUREN SELATAN,25337,4718,20619,18528,39147,2021-11-22
3173021002,JAKARTA BARAT,GROGOL PETAMBURAN,TANJUNG DUREN UTARA,17010,2801,14209,12944,27153,2021-11-22
3172021001,JAKARTA UTARA,TANJUNG PRIOK,TANJUNG PRIOK,34588,6981,27607,22925,50532,2021-11-22
3174011002,JAKARTA SELATAN,TEBET,TEBET BARAT,21194,3328,17866,15977,33843,2021-11-22
3174011001,JAKARTA SELATAN,TEBET,TEBET TIMUR,18199,2847,15352,14056,29408,2021-11-22
3173061003,JAKARTA BARAT,KALI DERES,TEGAL ALUR,83647,16887,66760,56030,122790,2021-11-22
3174031004,JAKARTA SELATAN,MAMPANG PRAPATAN,TEGAL PARANG,32401,6950,25451,20350,45801,2021-11-22
3173021003,JAKARTA BARAT,GROGOL PETAMBURAN,TOMANG,29605,5325,24280,21241,45521,2021-11-22
3172031005,JAKARTA UTARA,KOJA,TUGU SELATAN,39122,8538,30584,25252,55836,2021-11-22
3172031002,JAKARTA UTARA,KOJA,TUGU UTARA,67670,15618,52052,42030,94082,2021-11-22
3175061006,JAKARTA TIMUR,CAKUNG,UJUNG MENTENG,29934,5013,24921,21501,46422,2021-11-22
3174101005,JAKARTA SELATAN,PESANGGRAHAN,ULUJAMI,40544,8825,31719,26605,58324,2021-11-22
3175011006,JAKARTA TIMUR,MATRAMAN,UTAN KAYU SELATAN,33511,5868,27643,23338,50981,2021-11-22
3175011002,JAKARTA TIMUR,MATRAMAN,UTAN KAYU UTARA,28169,5689,22480,18760,41240,2021-11-22
3171031008,JAKARTA PUSAT,KEMAYORAN,UTAN PANJANG,29208,5617,23591,19403,42994,2021-11-22
3172021007,JAKARTA UTARA,TANJUNG PRIOK,WARAKAS,44401,7975,36426,29940,66366,2021-11-22
3173021007,JAKARTA BARAT,GROGOL PETAMBURAN,WIJAYA KUSUMA,38934,7922,31012,26567,57579,2021-11-22
3172051003,JAKARTA UTARA,PADEMANGAN,ANCOL,23947,5604,18343,15270,33613,2021-11-23
3173041007,JAKARTA BARAT,TAMBORA,ANGKE,29381,6071,23310,19190,42500,2021-11-23
3175041005,JAKARTA TIMUR,KRAMAT JATI,BALE KAMBANG,29074,6921,22153,17794,39947,2021-11-23
3175031003,JAKARTA TIMUR,JATINEGARA,BALI MESTER,9752,1964,7788,6658,14446,2021-11-23
3175101006,JAKARTA TIMUR,CIPAYUNG,BAMBU APUS,26285,4724,21561,18386,39947,2021-11-23
3174031002,JAKARTA SELATAN,MAMPANG PRAPATAN,BANGKA,21566,4422,17144,14466,31610,2021-11-23
3175051002,JAKARTA TIMUR,PASAR REBO,BARU,23886,3857,20029,17524,37553,2021-11-23
3175041004,JAKARTA TIMUR,KRAMAT JATI,BATU AMPAR,47898,11202,36696,30244,66940,2021-11-23
3171071002,JAKARTA PUSAT,TANAH ABANG,BENDUNGAN HILIR,21494,4245,17249,14951,32200,2021-11-23
3175031002,JAKARTA TIMUR,JATINEGARA,BIDARA CINA,36689,8557,28132,23109,51241,2021-11-23
3174101002,JAKARTA SELATAN,PESANGGRAHAN,BINTARO,53098,10392,42706,37574,80280,2021-11-23
3174011005,JAKARTA SELATAN,TEBET,BUKIT DURI,34183,6663,27520,23339,50859,2021-11-23
3171041006,JAKARTA PUSAT,SENEN,BUNGUR,18144,3677,14467,12166,26633,2021-11-23
3175061007,JAKARTA TIMUR,CAKUNG,CAKUNG BARAT,57724,11507,46217,38611,84828,2021-11-23
3175061004,JAKARTA TIMUR,CAKUNG,CAKUNG TIMUR,58287,11128,47159,39833,86992,2021-11-23
3175041007,JAKARTA TIMUR,KRAMAT JATI,CAWANG,32762,6804,25958,21256,47214,2021-11-23
3175101008,JAKARTA TIMUR,CIPAYUNG,CEGER,18932,3568,15364,13032,28396,2021-11-23
3171031006,JAKARTA PUSAT,KEMAYORAN,CEMPAKA BARU,32581,5974,26607,21801,48408,2021-11-23
3171051002,JAKARTA PUSAT,CEMPAKA PUTIH,CEMPAKA PUTIH BARAT,35885,7377,28508,24768,53276,2021-11-23
3171051001,JAKARTA PUSAT,CEMPAKA PUTIH,CEMPAKA PUTIH TIMUR,24292,4879,19413,17292,36705,2021-11-23
3173011001,JAKARTA BARAT,CENGKARENG,CENGKARENG BARAT,66284,12792,53492,46649,100141,2021-11-23
3173011006,JAKARTA BARAT,CENGKARENG,CENGKARENG TIMUR,81027,15588,65439,55374,120813,2021-11-23
3175091002,JAKARTA TIMUR,CIRACAS,CIBUBUR,66364,11108,55256,47695,102951,2021-11-23
3171011002,JAKARTA PUSAT,GAMBIR,CIDENG,15390,2956,12434,11007,23441,2021-11-23
3174091003,JAKARTA SELATAN,JAGAKARSA,CIGANJUR,38497,6285,32212,27325,59537,2021-11-23
3175051003,JAKARTA TIMUR,PASAR REBO,CIJANTUNG,41419,7452,33967,28894,62861,2021-11-23
3171061003,JAKARTA PUSAT,MENTENG,CIKINI,8274,1462,6812,5533,12345,2021-11-23
3174081006,JAKARTA SELATAN,PANCORAN,CIKOKO,10547,1773,8774,7701,16475,2021-11-23
3174061001,JAKARTA SELATAN,CILANDAK,CILANDAK BARAT,51752,8850,42902,38152,81054,2021-11-23
3174041003,JAKARTA SELATAN,PASAR MINGGU,CILANDAK TIMUR,25145,4482,20663,17936,38599,2021-11-23
3175101002,JAKARTA TIMUR,CIPAYUNG,CILANGKAP,27635,4771,22864,19774,42638,2021-11-23
3175041006,JAKARTA TIMUR,KRAMAT JATI,CILILITAN,40181,8262,31919,26410,58329,2021-11-23
3172041001,JAKARTA UTARA,CILINCING,CILINCING,43609,10162,33447,26502,59949,2021-11-23
3175101001,JAKARTA TIMUR,CIPAYUNG,CIPAYUNG,26104,4445,21659,18842,40501,2021-11-23
3174091006,JAKARTA SELATAN,JAGAKARSA,CIPEDAK,38303,6165,32138,27708,59846,2021-11-23
3174061005,JAKARTA SELATAN,CILANDAK,CIPETE SELATAN,26704,4956,21748,19432,41180,2021-11-23
3174071010,JAKARTA SELATAN,KEBAYORAN BARU,CIPETE UTARA,34102,6292,27810,23744,51554,2021-11-23
3175021003,JAKARTA TIMUR,PULO GADUNG,CIPINANG,39306,6962,32344,27396,59740,2021-11-23
3175031007,JAKARTA TIMUR,JATINEGARA,CIPINANG BESAR SELATAN,35212,8052,27160,21796,48956,2021-11-23
3175031008,JAKARTA TIMUR,JATINEGARA,CIPINANG BESAR UTARA,45319,10372,34947,27886,62833,2021-11-23
3175031005,JAKARTA TIMUR,JATINEGARA,CIPINANG CEMPEDAK,32824,6976,25848,22361,48209,2021-11-23
3175081005,JAKARTA TIMUR,MAKASAR,CIPINANG MELAYU,42308,7968,34340,29653,63993,2021-11-23
3175031006,JAKARTA TIMUR,JATINEGARA,CIPINANG MUARA,55243,11401,43842,36451,80293,2021-11-23
3174051003,JAKARTA SELATAN,KEBAYORAN LAMA,CIPULIR,39937,8238,31699,26391,58090,2021-11-23
3175091001,JAKARTA TIMUR,CIRACAS,CIRACAS,64594,11551,53043,44768,97811,2021-11-23
3175041003,JAKARTA TIMUR,KRAMAT JATI,DUKUH,24609,4436,20173,16947,37120,2021-11-23
3175071001,JAKARTA TIMUR,DUREN SAWIT,DUREN SAWIT,61160,12577,48583,41265,89848,2021-11-23
3174081004,JAKARTA SELATAN,PANCORAN,DUREN TIGA,28319,5466,22853,19434,42287,2021-11-23
3173051005,JAKARTA BARAT,KEBON JERUK,DURI KEPA,60138,11556,48582,42504,91086,2021-11-23
3173011002,JAKARTA BARAT,CENGKARENG,DURI KOSAMBI,77923,16172,61751,50669,112420,2021-11-23
3171011006,JAKARTA PUSAT,GAMBIR,DURI PULO,19610,4048,15562,12694,28256,2021-11-23
3173041011,JAKARTA BARAT,TAMBORA,DURI SELATAN,14259,2469,11790,10134,21924,2021-11-23
3173041003,JAKARTA BARAT,TAMBORA,DURI UTARA,19844,3490,16354,13664,30018,2021-11-23
3171081003,JAKARTA PUSAT,JOHAR BARU,GALUR,18243,3484,14759,12106,26865,2021-11-23
3171011001,JAKARTA PUSAT,GAMBIR,GAMBIR,2191,451,1740,1526,3266,2021-11-23
3174061004,JAKARTA SELATAN,CILANDAK,GANDARIA SELATAN,22119,4113,18006,15685,33691,2021-11-23
3174071009,JAKARTA SELATAN,KEBAYORAN BARU,GANDARIA UTARA,39922,7695,32227,27811,60038,2021-11-23
3175051001,JAKARTA TIMUR,PASAR REBO,GEDONG,35755,6979,28776,24703,53479,2021-11-23
3171071001,JAKARTA PUSAT,TANAH ABANG,GELORA,3127,596,2531,2233,4764,2021-11-23
3173031007,JAKARTA BARAT,TAMAN SARI,GLODOK,7837,1152,6685,6099,12784,2021-11-23
3171061004,JAKARTA PUSAT,MENTENG,GONDANGDIA,4100,902,3198,2936,6134,2021-11-23
3173021001,JAKARTA BARAT,GROGOL PETAMBURAN,GROGOL,16876,3268,13608,11705,25313,2021-11-23
3174051005,JAKARTA SELATAN,KEBAYORAN LAMA,GROGOL SELATAN,44251,8618,35633,30020,65653,2021-11-23
3174051004,JAKARTA SELATAN,KEBAYORAN LAMA,GROGOL UTARA,42494,8444,34050,28809,62859,2021-11-23
3174021007,JAKARTA SELATAN,SETIA BUDI,GUNTUR,3985,729,3256,2928,6184,2021-11-23
3174071002,JAKARTA SELATAN,KEBAYORAN BARU,GUNUNG,9436,1713,7723,6960,14683,2021-11-23
3171031005,JAKARTA PUSAT,KEMAYORAN,GUNUNG SAHARI SELATAN,19199,3696,15503,13288,28791,2021-11-23
3171021004,JAKARTA PUSAT,SAWAH BESAR,GUNUNG SAHARI UTARA,16650,2867,13783,12443,26226,2021-11-23
3175081004,JAKARTA TIMUR,MAKASAR,HALIM PERDANA KUSUMAH,28363,3579,24784,22837,47621,2021-11-23
3171031003,JAKARTA PUSAT,KEMAYORAN,HARAPAN MULIA,22557,4303,18254,15176,33430,2021-11-23
3174091001,JAKARTA SELATAN,JAGAKARSA,JAGAKARSA,62389,9947,52442,45194,97636,2021-11-23
3175021007,JAKARTA TIMUR,PULO GADUNG,JATI,32757,5978,26779,23613,50392,2021-11-23
3174041002,JAKARTA SELATAN,PASAR MINGGU,JATI PADANG,37502,7049,30453,26145,56598,2021-11-23
3173071004,JAKARTA BARAT,PALMERAH,JATI PULO,28738,5554,23184,18906,42090,2021-11-23
3175061001,JAKARTA TIMUR,CAKUNG,JATINEGARA,84160,17271,66889,56129,123018,2021-11-23
3175021004,JAKARTA TIMUR,PULO GADUNG,JATINEGARA KAUM,24632,4265,20367,16930,37297,2021-11-23
3173021004,JAKARTA BARAT,GROGOL PETAMBURAN,JELAMBAR,30266,5384,24882,22226,47108,2021-11-23
3173021006,JAKARTA BARAT,GROGOL PETAMBURAN,JELAMBAR BARU,38246,6749,31497,27839,59336,2021-11-23
3173041006,JAKARTA BARAT,TAMBORA,JEMBATAN BESI,29314,6929,22385,17864,40249,2021-11-23
3173041008,JAKARTA BARAT,TAMBORA,JEMBATAN LIMA,21021,4667,16354,13217,29571,2021-11-23
3173081005,JAKARTA BARAT,KEMBANGAN,JOGLO,40839,7970,32869,28256,61125,2021-11-23
3171081001,JAKARTA PUSAT,JOHAR BARU,JOHAR BARU,37488,6796,30692,26295,56987,2021-11-23
3173041002,JAKARTA BARAT,TAMBORA,KALI ANYAR,23856,4574,19282,15654,34936,2021-11-23
3172041004,JAKARTA UTARA,CILINCING,KALIBARU,67684,18062,49622,35766,85388,2021-11-23
3174081002,JAKARTA SELATAN,PANCORAN,KALIBATA,41994,9262,32732,27213,59945,2021-11-23
3173061001,JAKARTA BARAT,KALI DERES,KALIDERES,72447,14119,58328,50132,108460,2021-11-23
3175051004,JAKARTA TIMUR,PASAR REBO,KALISARI,43212,7469,35743,30711,66454,2021-11-23
3173061004,JAKARTA BARAT,KALI DERES,KAMAL,53783,12233,41550,33908,75458,2021-11-23
3172011002,JAKARTA UTARA,PENJARINGAN,KAMAL MUARA,12930,2255,10675,9176,19851,2021-11-23
3171071007,JAKARTA PUSAT,TANAH ABANG,KAMPUNG BALI,11358,2398,8960,7088,16048,2021-11-23
3175031001,JAKARTA TIMUR,JATINEGARA,KAMPUNG MELAYU,25717,5725,19992,15978,35970,2021-11-23
3171081002,JAKARTA PUSAT,JOHAR BARU,KAMPUNG RAWA,21237,3437,17800,14469,32269,2021-11-23
3175041002,JAKARTA TIMUR,KRAMAT JATI,KAMPUNG TENGAH,43993,10704,33289,27170,60459,2021-11-23
3173011005,JAKARTA BARAT,CENGKARENG,KAPUK,134466,31359,103107,85224,188331,2021-11-23
3172011003,JAKARTA UTARA,PENJARINGAN,KAPUK MUARA,35781,6697,29084,25893,54977,2021-11-23
3171021002,JAKARTA PUSAT,SAWAH BESAR,KARANG ANYAR,25761,4772,20989,17901,38890,2021-11-23
3174021004,JAKARTA SELATAN,SETIA BUDI,KARET,9623,1815,7808,6641,14449,2021-11-23
3174021003,JAKARTA SELATAN,SETIA BUDI,KARET KUNINGAN,16055,3049,13006,11220,24226,2021-11-23
3174021002,JAKARTA SELATAN,SETIA BUDI,KARET SEMANGGI,2770,550,2220,1988,4208,2021-11-23
3171071003,JAKARTA PUSAT,TANAH ABANG,KARET TENGSIN,19271,3632,15639,13036,28675,2021-11-23
3171021003,JAKARTA PUSAT,SAWAH BESAR,KARTINI,22292,4089,18203,15863,34066,2021-11-23
3175011003,JAKARTA TIMUR,MATRAMAN,KAYU MANIS,25284,5141,20143,16444,36587,2021-11-23
3175021006,JAKARTA TIMUR,PULO GADUNG,KAYU PUTIH,40696,7499,33197,29448,62645,2021-11-23
3173031006,JAKARTA BARAT,TAMAN SARI,KEAGUNGAN,17387,3152,14235,11910,26145,2021-11-23
3174041007,JAKARTA SELATAN,PASAR MINGGU,KEBAGUSAN,44552,8574,35978,30412,66390,2021-11-23
3174051006,JAKARTA SELATAN,KEBAYORAN LAMA,KEBAYORAN LAMA SELATAN,41212,7439,33773,29281,63054,2021-11-23
3174051001,JAKARTA SELATAN,KEBAYORAN LAMA,KEBAYORAN LAMA UTARA,42422,8575,33847,28631,62478,2021-11-23
3174011004,JAKARTA SELATAN,TEBET,KEBON BARU,35165,6387,28778,24711,53489,2021-11-23
3172021005,JAKARTA UTARA,TANJUNG PRIOK,KEBON BAWANG,50952,9979,40973,34759,75732,2021-11-23
3173051001,JAKARTA BARAT,KEBON JERUK,KEBON JERUK,53887,10656,43231,35840,79071,2021-11-23
3171071006,JAKARTA PUSAT,TANAH ABANG,KEBON KACANG,21531,5011,16520,13336,29856,2021-11-23
3171011005,JAKARTA PUSAT,GAMBIR,KEBON KELAPA,10163,1991,8172,7037,15209,2021-11-23
3171031002,JAKARTA PUSAT,KEMAYORAN,KEBON KOSONG,30019,5853,24166,20215,44381,2021-11-23
3175011005,JAKARTA TIMUR,MATRAMAN,KEBON MANGGIS,16490,3113,13377,11260,24637,2021-11-23
3171071005,JAKARTA PUSAT,TANAH ABANG,KEBON MELATI,32206,8402,23804,18134,41938,2021-11-23
3175081003,JAKARTA TIMUR,MAKASAR,KEBON PALA,46614,8913,37701,31992,69693,2021-11-23
3171061005,JAKARTA PUSAT,MENTENG,KEBON SIRIH,12299,2567,9732,7956,17688,2021-11-23
3173011004,JAKARTA BARAT,CENGKARENG,KEDAUNG KALI ANGKE,32612,6127,26485,22708,49193,2021-11-23
3173051007,JAKARTA BARAT,KEBON JERUK,KEDOYA SELATAN,32165,5737,26428,22173,48601,2021-11-23
3173051006,JAKARTA BARAT,KEBON JERUK,KEDOYA UTARA,45740,8535,37205,31862,69067,2021-11-23
3173051004,JAKARTA BARAT,KEBON JERUK,KELAPA DUA,23565,4497,19068,16173,35241,2021-11-23
3175091003,JAKARTA TIMUR,CIRACAS,KELAPA DUA WETAN,46875,7783,39092,33670,72762,2021-11-23
3172061003,JAKARTA UTARA,KELAPA GADING,KELAPA GADING BARAT,35717,6098,29619,27043,56662,2021-11-23
3172061001,JAKARTA UTARA,KELAPA GADING,KELAPA GADING TIMUR,33592,5024,28568,26742,55310,2021-11-23
3173071005,JAKARTA BARAT,PALMERAH,KEMANGGISAN,32139,5921,26218,22610,48828,2021-11-23
3171031001,JAKARTA PUSAT,KEMAYORAN,KEMAYORAN,20708,4026,16682,13978,30660,2021-11-23
3173081006,JAKARTA BARAT,KEMBANGAN,KEMBANGAN SELATAN,27130,5558,21572,18869,40441,2021-11-23
3173081001,JAKARTA BARAT,KEMBANGAN,KEMBANGAN UTARA,54451,11623,42828,36167,78995,2021-11-23
3171041002,JAKARTA PUSAT,SENEN,KENARI,9579,1826,7753,6694,14447,2021-11-23
3173041005,JAKARTA BARAT,TAMBORA,KERENDANG,19973,3943,16030,13275,29305,2021-11-23
3175071003,JAKARTA TIMUR,DUREN SAWIT,KLENDER,69978,16017,53961,43949,97910,2021-11-23
3172031001,JAKARTA UTARA,KOJA,KOJA,28175,6222,21953,18113,40066,2021-11-23
3173071006,JAKARTA BARAT,PALMERAH,KOTA BAMBU SELATAN,21158,4051,17107,13713,30820,2021-11-23
3173071003,JAKARTA BARAT,PALMERAH,KOTA BAMBU UTARA,24995,4969,20026,15873,35899,2021-11-23
3171041004,JAKARTA PUSAT,SENEN,KRAMAT,28835,6727,22108,17139,39247,2021-11-23
3175041001,JAKARTA TIMUR,KRAMAT JATI,KRAMAT JATI,34144,7047,27097,22414,49511,2021-11-23
3174071003,JAKARTA SELATAN,KEBAYORAN BARU,KRAMAT PELA,14413,2721,11692,10241,21933,2021-11-23
3173031002,JAKARTA BARAT,TAMAN SARI,KRUKUT,19244,3547,15697,13026,28723,2021-11-23
3174031005,JAKARTA SELATAN,MAMPANG PRAPATAN,KUNINGAN BARAT,12785,2277,10508,8990,19498,2021-11-23
3174021008,JAKARTA SELATAN,SETIA BUDI,KUNINGAN TIMUR,6008,1160,4848,4222,9070,2021-11-23
3171041005,JAKARTA PUSAT,SENEN,KWITANG,15486,3344,12142,9918,22060,2021-11-23
3172031003,JAKARTA UTARA,KOJA,LAGOA,59065,13576,45489,36748,82237,2021-11-23
3174061002,JAKARTA SELATAN,CILANDAK,LEBAK BULUS,37626,6902,30724,27430,58154,2021-11-23
3174091004,JAKARTA SELATAN,JAGAKARSA,LENTENG AGUNG,53946,9375,44571,37299,81870,2021-11-23
3175101007,JAKARTA TIMUR,CIPAYUNG,LUBANG BUAYA,63547,11678,51869,43912,95781,2021-11-23
3175081001,JAKARTA TIMUR,MAKASAR,MAKASAR,34390,6096,28294,24592,52886,2021-11-23
3175071006,JAKARTA TIMUR,DUREN SAWIT,MALAKA JAYA,30927,5111,25816,22644,48460,2021-11-23
3175071005,JAKARTA TIMUR,DUREN SAWIT,MALAKA SARI,27530,4418,23112,20399,43511,2021-11-23
3174031001,JAKARTA SELATAN,MAMPANG PRAPATAN,MAMPANG PRAPATAN,18159,3628,14531,12267,26798,2021-11-23
3173031005,JAKARTA BARAT,TAMAN SARI,MANGGA BESAR,7707,1275,6432,5751,12183,2021-11-23
3171021005,JAKARTA PUSAT,SAWAH BESAR,MANGGA DUA SELATAN,27442,5507,21935,18871,40806,2021-11-23
3174011007,JAKARTA SELATAN,TEBET,MANGGARAI,28373,4838,23535,19589,43124,2021-11-23
3174011006,JAKARTA SELATAN,TEBET,MANGGARAI SELATAN,23075,3749,19326,16560,35886,2021-11-23
3173031003,JAKARTA BARAT,TAMAN SARI,MAPHAR,16461,2988,13473,11460,24933,2021-11-23
3172041003,JAKARTA UTARA,CILINCING,MARUNDA,28943,6378,22565,17322,39887,2021-11-23
3174071001,JAKARTA SELATAN,KEBAYORAN BARU,MELAWAI,2627,499,2128,1975,4103,2021-11-23
3171061001,JAKARTA PUSAT,MENTENG,MENTENG,25624,5454,20170,16333,36503,2021-11-23
3174021005,JAKARTA SELATAN,SETIA BUDI,MENTENG ATAS,27816,4847,22969,19606,42575,2021-11-23
3174011003,JAKARTA SELATAN,TEBET,MENTENG DALAM,36028,6812,29216,25208,54424,2021-11-23
3173081003,JAKARTA BARAT,KEMBANGAN,MERUYA SELATAN,32130,6398,25732,22164,47896,2021-11-23
3173081002,JAKARTA BARAT,KEMBANGAN,MERUYA UTARA,43752,8782,34970,30907,65877,2021-11-23
3175101004,JAKARTA TIMUR,CIPAYUNG,MUNJUL,23871,4248,19623,16892,36515,2021-11-23
3172051002,JAKARTA UTARA,PADEMANGAN,PADEMANGAN BARAT,74240,16935,57305,47158,104463,2021-11-23
3172051001,JAKARTA UTARA,PADEMANGAN,PADEMANGAN TIMUR,37736,6478,31258,27986,59244,2021-11-23
3175011004,JAKARTA TIMUR,MATRAMAN,PAL MERIAM,19769,3919,15850,13027,28877,2021-11-23
3173071001,JAKARTA BARAT,PALMERAH,PALMERAH,63011,12833,50178,41778,91956,2021-11-23
3174081001,JAKARTA SELATAN,PANCORAN,PANCORAN,19421,3785,15636,13233,28869,2021-11-23
3172021003,JAKARTA UTARA,TANJUNG PRIOK,PAPANGGO,39097,7462,31635,26457,58092,2021-11-23
3171021001,JAKARTA PUSAT,SAWAH BESAR,PASAR BARU,12035,2245,9790,8876,18666,2021-11-23
3174021006,JAKARTA SELATAN,SETIA BUDI,PASAR MANGGIS,26752,5074,21678,18296,39974,2021-11-23
3174041001,JAKARTA SELATAN,PASAR MINGGU,PASAR MINGGU,24821,4542,20279,17698,37977,2021-11-23
3171041003,JAKARTA PUSAT,SENEN,PASEBAN,23533,4749,18784,15646,34430,2021-11-23
3173061005,JAKARTA BARAT,KALI DERES,PEGADUNGAN,75587,14347,61240,53271,114511,2021-11-23
3171061002,JAKARTA PUSAT,MENTENG,PEGANGSAAN,23455,4905,18550,14623,33173,2021-11-23
3172061002,JAKARTA UTARA,KELAPA GADING,PEGANGSAAN DUA,49976,8101,41875,38376,80251,2021-11-23
3172011004,JAKARTA UTARA,PENJARINGAN,PEJAGALAN,74578,15021,59557,52211,111768,2021-11-23
3174041006,JAKARTA SELATAN,PASAR MINGGU,PEJATEN BARAT,37346,7024,30322,25994,56316,2021-11-23
3174041005,JAKARTA SELATAN,PASAR MINGGU,PEJATEN TIMUR,57656,12212,45444,37840,83284,2021-11-23
3175051005,JAKARTA TIMUR,PASAR REBO,PEKAYON,43250,7635,35615,30266,65881,2021-11-23
3173041009,JAKARTA BARAT,TAMBORA,PEKOJAN,23587,4363,19224,16482,35706,2021-11-23
3174031003,JAKARTA SELATAN,MAMPANG PRAPATAN,PELA MAMPANG,43522,8298,35224,30158,65382,2021-11-23
3174081005,JAKARTA SELATAN,PANCORAN,PENGADEGAN,21478,3842,17636,15350,32986,2021-11-23
3175061003,JAKARTA TIMUR,CAKUNG,PENGGILINGAN,99255,22153,77102,62910,140012,2021-11-23
3172011001,JAKARTA UTARA,PENJARINGAN,PENJARINGAN,88308,22099,66209,52276,118485,2021-11-23
3174101001,JAKARTA SELATAN,PESANGGRAHAN,PESANGGRAHAN,27545,4597,22948,20078,43026,2021-11-23
3171071004,JAKARTA PUSAT,TANAH ABANG,PETAMBURAN,33271,8565,24706,19194,43900,2021-11-23
3174071008,JAKARTA SELATAN,KEBAYORAN BARU,PETOGOGAN,11499,2168,9331,8115,17446,2021-11-23
3171011004,JAKARTA PUSAT,GAMBIR,PETOJO SELATAN,14692,3230,11462,9861,21323,2021-11-23
3171011003,JAKARTA PUSAT,GAMBIR,PETOJO UTARA,17458,3689,13769,11538,25307,2021-11-23
3174101004,JAKARTA SELATAN,PESANGGRAHAN,PETUKANGAN SELATAN,37187,7458,29729,25579,55308,2021-11-23
3174101003,JAKARTA SELATAN,PESANGGRAHAN,PETUKANGAN UTARA,53716,11202,42514,36034,78548,2021-11-23
3175081002,JAKARTA TIMUR,MAKASAR,PINANG RANTI,27198,5761,21437,17990,39427,2021-11-23
3173031008,JAKARTA BARAT,TAMAN SARI,PINANGSIA,10729,1836,8893,7513,16406,2021-11-23
3175011001,JAKARTA TIMUR,MATRAMAN,PISANGAN BARU,31776,6318,25458,20822,46280,2021-11-23
3175021002,JAKARTA TIMUR,PULO GADUNG,PISANGAN TIMUR,41011,7372,33639,28961,62600,2021-11-23
3172011005,JAKARTA UTARA,PENJARINGAN,PLUIT,47783,9050,38733,34439,73172,2021-11-23
3175071002,JAKARTA TIMUR,DUREN SAWIT,PONDOK BAMBU,61550,12581,48969,41723,90692,2021-11-23
3175071004,JAKARTA TIMUR,DUREN SAWIT,PONDOK KELAPA,72015,13892,58123,50707,108830,2021-11-23
3175071007,JAKARTA TIMUR,DUREN SAWIT,PONDOK KOPI,35367,6472,28895,23584,52479,2021-11-23
3174061003,JAKARTA SELATAN,CILANDAK,PONDOK LABU,46464,7470,38994,34582,73576,2021-11-23
3174051002,JAKARTA SELATAN,KEBAYORAN LAMA,PONDOK PINANG,56169,10504,45665,39781,85446,2021-11-23
3175101003,JAKARTA TIMUR,CIPAYUNG,PONDOK RANGGON,25574,4672,20902,17988,38890,2021-11-23
3101011003,KAB.ADM.KEP.SERIBU,KEP. SERIBU UTARA,PULAU HARAPAN,2060,218,1842,1621,3463,2021-11-23
3101011002,KAB.ADM.KEP.SERIBU,KEP. SERIBU UTARA,PULAU KELAPA,5528,587,4941,4098,9039,2021-11-23
3101011001,KAB.ADM.KEP.SERIBU,KEP. SERIBU UTARA,PULAU PANGGANG,5450,427,5023,4508,9531,2021-11-23
3101021003,KAB.ADM.KEP.SERIBU,KEP. SERIBU SELATAN,PULAU PARI,2765,191,2574,2440,5014,2021-11-23
3101021002,KAB.ADM.KEP.SERIBU,KEP. SERIBU SELATAN,PULAU TIDUNG,4553,365,4188,3863,8051,2021-11-23
3101021001,KAB.ADM.KEP.SERIBU,KEP. SERIBU SELATAN,PULAU UNTUNG JAWA,1941,156,1785,1662,3447,2021-11-23
3174071007,JAKARTA SELATAN,KEBAYORAN BARU,PULO,5835,986,4849,4500,9349,2021-11-23
3175021001,JAKARTA TIMUR,PULO GADUNG,PULO GADUNG,34422,7341,27081,23026,50107,2021-11-23
3175061005,JAKARTA TIMUR,CAKUNG,PULO GEBANG,97301,18210,79091,65592,144683,2021-11-23
3174041004,JAKARTA SELATAN,PASAR MINGGU,RAGUNAN,39616,7011,32605,28423,61028,2021-11-23
3175091005,JAKARTA TIMUR,CIRACAS,RAMBUTAN,36771,8364,28407,23609,52016,2021-11-23
3172031006,JAKARTA UTARA,KOJA,RAWA BADAK SELATAN,42179,9702,32477,26300,58777,2021-11-23
3172031004,JAKARTA UTARA,KOJA,RAWA BADAK UTARA,34408,7478,26930,22233,49163,2021-11-23
3174071005,JAKARTA SELATAN,KEBAYORAN BARU,RAWA BARAT,5625,983,4642,4175,8817,2021-11-23
3173011003,JAKARTA BARAT,CENGKARENG,RAWA BUAYA,63799,12221,51578,43403,94981,2021-11-23
3175031004,JAKARTA TIMUR,JATINEGARA,RAWA BUNGA,21434,5021,16413,13625,30038,2021-11-23
3174081003,JAKARTA SELATAN,PANCORAN,RAWA JATI,20509,3815,16694,14560,31254,2021-11-23
3175061002,JAKARTA TIMUR,CAKUNG,RAWA TERATE,24637,4328,20309,16898,37207,2021-11-23
3175021005,JAKARTA TIMUR,PULO GADUNG,RAWAMANGUN,37612,7216,30396,26289,56685,2021-11-23
3171051003,JAKARTA PUSAT,CEMPAKA PUTIH,RAWASARI,21967,4331,17636,15382,33018,2021-11-23
3173041010,JAKARTA BARAT,TAMBORA,ROA MALAKA,3484,605,2879,2609,5488,2021-11-23
3172041006,JAKARTA UTARA,CILINCING,ROROTAN,41668,8119,33549,27596,61145,2021-11-23
3174071004,JAKARTA SELATAN,KEBAYORAN BARU,SELONG,2842,541,2301,2154,4455,2021-11-23
3173061002,JAKARTA BARAT,KALI DERES,SEMANAN,71354,14495,56859,46669,103528,2021-11-23
3172041007,JAKARTA UTARA,CILINCING,SEMPER BARAT,68587,12974,55613,47102,102715,2021-11-23
3172041005,JAKARTA UTARA,CILINCING,SEMPER TIMUR,36267,7552,28715,23809,52524,2021-11-23
3174071006,JAKARTA SELATAN,KEBAYORAN BARU,SENAYAN,2771,640,2131,1881,4012,2021-11-23
3171041001,JAKARTA PUSAT,SENEN,SENEN,6804,1406,5398,4551,9949,2021-11-23
3171031004,JAKARTA PUSAT,KEMAYORAN,SERDANG,29668,5592,24076,20453,44529,2021-11-23
3174021001,JAKARTA SELATAN,SETIA BUDI,SETIA BUDI,3023,593,2430,2123,4553,2021-11-23
3175101005,JAKARTA TIMUR,CIPAYUNG,SETU,20572,3986,16586,13853,30439,2021-11-23
3173071002,JAKARTA BARAT,PALMERAH,SLIPI,16591,2898,13693,11812,25505,2021-11-23
3173081004,JAKARTA BARAT,KEMBANGAN,SRENGSENG,45523,9927,35596,30605,66201,2021-11-23
3174091002,JAKARTA SELATAN,JAGAKARSA,SRENGSENG SAWAH,58196,8632,49564,43443,93007,2021-11-23
3173051003,JAKARTA BARAT,KEBON JERUK,SUKABUMI SELATAN,37033,7808,29225,23132,52357,2021-11-23
3173051002,JAKARTA BARAT,KEBON JERUK,SUKABUMI UTARA,38290,8715,29575,23789,53364,2021-11-23
3172041002,JAKARTA UTARA,CILINCING,SUKAPURA,53949,11834,42115,35335,77450,2021-11-23
3171031007,JAKARTA PUSAT,KEMAYORAN,SUMUR BATU,22717,4198,18519,16065,34584,2021-11-23
3172021004,JAKARTA UTARA,TANJUNG PRIOK,SUNGAI BAMBU,29876,5823,24053,20343,44396,2021-11-23
3172021006,JAKARTA UTARA,TANJUNG PRIOK,SUNTER AGUNG,71805,12098,59707,53164,112871,2021-11-23
3172021002,JAKARTA UTARA,TANJUNG PRIOK,SUNTER JAYA,63031,10778,52253,46121,98374,2021-11-23
3175091004,JAKARTA TIMUR,CIRACAS,SUSUKAN,38257,7011,31246,26595,57841,2021-11-23
3173031001,JAKARTA BARAT,TAMAN SARI,TAMAN SARI,14348,2550,11798,10286,22084,2021-11-23
3173041001,JAKARTA BARAT,TAMBORA,TAMBORA,10204,2141,8063,6615,14678,2021-11-23
3173041004,JAKARTA BARAT,TAMBORA,TANAH SEREAL,26387,4354,22033,18777,40810,2021-11-23
3171081004,JAKARTA PUSAT,JOHAR BARU,TANAH TINGGI,37693,7019,30674,25247,55921,2021-11-23
3173031004,JAKARTA BARAT,TAMAN SARI,TANGKI,13324,2164,11160,9635,20795,2021-11-23
3174091005,JAKARTA SELATAN,JAGAKARSA,TANJUNG BARAT,39770,6567,33203,28123,61326,2021-11-23
3173021005,JAKARTA BARAT,GROGOL PETAMBURAN,TANJUNG DUREN SELATAN,25337,4701,20636,18576,39212,2021-11-23
3173021002,JAKARTA BARAT,GROGOL PETAMBURAN,TANJUNG DUREN UTARA,17010,2797,14213,12975,27188,2021-11-23
3172021001,JAKARTA UTARA,TANJUNG PRIOK,TANJUNG PRIOK,34588,6961,27627,22982,50609,2021-11-23
3174011002,JAKARTA SELATAN,TEBET,TEBET BARAT,21194,3318,17876,16008,33884,2021-11-23
3174011001,JAKARTA SELATAN,TEBET,TEBET TIMUR,18199,2836,15363,14098,29461,2021-11-23
3173061003,JAKARTA BARAT,KALI DERES,TEGAL ALUR,83647,16830,66817,56185,123002,2021-11-23
3174031004,JAKARTA SELATAN,MAMPANG PRAPATAN,TEGAL PARANG,32401,6927,25474,20433,45907,2021-11-23
3173021003,JAKARTA BARAT,GROGOL PETAMBURAN,TOMANG,29605,5315,24290,21320,45610,2021-11-23
3172031005,JAKARTA UTARA,KOJA,TUGU SELATAN,39122,8513,30609,25379,55988,2021-11-23
3172031002,JAKARTA UTARA,KOJA,TUGU UTARA,67670,15566,52104,42147,94251,2021-11-23
3175061006,JAKARTA TIMUR,CAKUNG,UJUNG MENTENG,29934,5002,24932,21564,46496,2021-11-23
3174101005,JAKARTA SELATAN,PESANGGRAHAN,ULUJAMI,40544,8793,31751,26698,58449,2021-11-23
3175011006,JAKARTA TIMUR,MATRAMAN,UTAN KAYU SELATAN,33511,5835,27676,23412,51088,2021-11-23
3175011002,JAKARTA TIMUR,MATRAMAN,UTAN KAYU UTARA,28169,5667,22502,18807,41309,2021-11-23
3171031008,JAKARTA PUSAT,KEMAYORAN,UTAN PANJANG,29208,5590,23618,19454,43072,2021-11-23
3172021007,JAKARTA UTARA,TANJUNG PRIOK,WARAKAS,44401,7947,36454,30021,66475,2021-11-23
3173021007,JAKARTA BARAT,GROGOL PETAMBURAN,WIJAYA KUSUMA,38934,7906,31028,26657,57685,2021-11-23
3172051003,JAKARTA UTARA,PADEMANGAN,ANCOL,23947,5592,18355,15301,33656,2021-11-24
3173041007,JAKARTA BARAT,TAMBORA,ANGKE,29381,6060,23321,19225,42546,2021-11-24
3175041005,JAKARTA TIMUR,KRAMAT JATI,BALE KAMBANG,29074,6895,22179,17852,40031,2021-11-24
3175031003,JAKARTA TIMUR,JATINEGARA,BALI MESTER,9752,1957,7795,6667,14462,2021-11-24
3175101006,JAKARTA TIMUR,CIPAYUNG,BAMBU APUS,26285,4721,21564,18414,39978,2021-11-24
3174031002,JAKARTA SELATAN,MAMPANG PRAPATAN,BANGKA,21566,4389,17177,14494,31671,2021-11-24
3175051002,JAKARTA TIMUR,PASAR REBO,BARU,23886,3813,20073,17594,37667,2021-11-24
3175041004,JAKARTA TIMUR,KRAMAT JATI,BATU AMPAR,47898,11162,36736,30303,67039,2021-11-24
3171071002,JAKARTA PUSAT,TANAH ABANG,BENDUNGAN HILIR,21494,4236,17258,14980,32238,2021-11-24
3175031002,JAKARTA TIMUR,JATINEGARA,BIDARA CINA,36689,8539,28150,23187,51337,2021-11-24
3174101002,JAKARTA SELATAN,PESANGGRAHAN,BINTARO,53098,10373,42725,37676,80401,2021-11-24
3174011005,JAKARTA SELATAN,TEBET,BUKIT DURI,34183,6631,27552,23404,50956,2021-11-24
3171041006,JAKARTA PUSAT,SENEN,BUNGUR,18144,3663,14481,12195,26676,2021-11-24
3175061007,JAKARTA TIMUR,CAKUNG,CAKUNG BARAT,57724,11471,46253,38686,84939,2021-11-24
3175061004,JAKARTA TIMUR,CAKUNG,CAKUNG TIMUR,58287,11106,47181,39893,87074,2021-11-24
3175041007,JAKARTA TIMUR,KRAMAT JATI,CAWANG,32762,6780,25982,21288,47270,2021-11-24
3175101008,JAKARTA TIMUR,CIPAYUNG,CEGER,18932,3563,15369,13073,28442,2021-11-24
3171031006,JAKARTA PUSAT,KEMAYORAN,CEMPAKA BARU,32581,5958,26623,21889,48512,2021-11-24
3171051002,JAKARTA PUSAT,CEMPAKA PUTIH,CEMPAKA PUTIH BARAT,35885,7348,28537,24826,53363,2021-11-24
3171051001,JAKARTA PUSAT,CEMPAKA PUTIH,CEMPAKA PUTIH TIMUR,24292,4869,19423,17334,36757,2021-11-24
3173011001,JAKARTA BARAT,CENGKARENG,CENGKARENG BARAT,66284,12754,53530,46752,100282,2021-11-24
3173011006,JAKARTA BARAT,CENGKARENG,CENGKARENG TIMUR,81027,15545,65482,55470,120952,2021-11-24
3175091002,JAKARTA TIMUR,CIRACAS,CIBUBUR,66364,11088,55276,47745,103021,2021-11-24
3171011002,JAKARTA PUSAT,GAMBIR,CIDENG,15390,2947,12443,11023,23466,2021-11-24
3174091003,JAKARTA SELATAN,JAGAKARSA,CIGANJUR,38497,6266,32231,27376,59607,2021-11-24
3175051003,JAKARTA TIMUR,PASAR REBO,CIJANTUNG,41419,7428,33991,28948,62939,2021-11-24
3171061003,JAKARTA PUSAT,MENTENG,CIKINI,8274,1457,6817,5538,12355,2021-11-24
3174081006,JAKARTA SELATAN,PANCORAN,CIKOKO,10547,1768,8779,7707,16486,2021-11-24
3174061001,JAKARTA SELATAN,CILANDAK,CILANDAK BARAT,51752,8833,42919,38214,81133,2021-11-24
3174041003,JAKARTA SELATAN,PASAR MINGGU,CILANDAK TIMUR,25145,4467,20678,17952,38630,2021-11-24
3175101002,JAKARTA TIMUR,CIPAYUNG,CILANGKAP,27635,4765,22870,19805,42675,2021-11-24
3175041006,JAKARTA TIMUR,KRAMAT JATI,CILILITAN,40181,8242,31939,26450,58389,2021-11-24
3172041001,JAKARTA UTARA,CILINCING,CILINCING,43609,10134,33475,26576,60051,2021-11-24
3175101001,JAKARTA TIMUR,CIPAYUNG,CIPAYUNG,26104,4427,21677,18877,40554,2021-11-24
3174091006,JAKARTA SELATAN,JAGAKARSA,CIPEDAK,38303,6146,32157,27765,59922,2021-11-24
3174061005,JAKARTA SELATAN,CILANDAK,CIPETE SELATAN,26704,4944,21760,19460,41220,2021-11-24
3174071010,JAKARTA SELATAN,KEBAYORAN BARU,CIPETE UTARA,34102,6285,27817,23802,51619,2021-11-24
3175021003,JAKARTA TIMUR,PULO GADUNG,CIPINANG,39306,6937,32369,27459,59828,2021-11-24
3175031007,JAKARTA TIMUR,JATINEGARA,CIPINANG BESAR SELATAN,35212,8029,27183,21844,49027,2021-11-24
3175031008,JAKARTA TIMUR,JATINEGARA,CIPINANG BESAR UTARA,45319,10342,34977,27925,62902,2021-11-24
3175031005,JAKARTA TIMUR,JATINEGARA,CIPINANG CEMPEDAK,32824,6966,25858,22428,48286,2021-11-24
3175081005,JAKARTA TIMUR,MAKASAR,CIPINANG MELAYU,42308,7953,34355,29694,64049,2021-11-24
3175031006,JAKARTA TIMUR,JATINEGARA,CIPINANG MUARA,55243,11370,43873,36521,80394,2021-11-24
3174051003,JAKARTA SELATAN,KEBAYORAN LAMA,CIPULIR,39937,8218,31719,26494,58213,2021-11-24
3175091001,JAKARTA TIMUR,CIRACAS,CIRACAS,64594,11529,53065,44892,97957,2021-11-24
3175041003,JAKARTA TIMUR,KRAMAT JATI,DUKUH,24609,4410,20199,17005,37204,2021-11-24
3175071001,JAKARTA TIMUR,DUREN SAWIT,DUREN SAWIT,61160,12549,48611,41353,89964,2021-11-24
3174081004,JAKARTA SELATAN,PANCORAN,DUREN TIGA,28319,5451,22868,19454,42322,2021-11-24
3173051005,JAKARTA BARAT,KEBON JERUK,DURI KEPA,60138,11531,48607,42551,91158,2021-11-24
3173011002,JAKARTA BARAT,CENGKARENG,DURI KOSAMBI,77923,16119,61804,50856,112660,2021-11-24
3171011006,JAKARTA PUSAT,GAMBIR,DURI PULO,19610,4044,15566,12712,28278,2021-11-24
3173041011,JAKARTA BARAT,TAMBORA,DURI SELATAN,14259,2465,11794,10143,21937,2021-11-24
3173041003,JAKARTA BARAT,TAMBORA,DURI UTARA,19844,3474,16370,13711,30081,2021-11-24
3171081003,JAKARTA PUSAT,JOHAR BARU,GALUR,18243,3474,14769,12126,26895,2021-11-24
3171011001,JAKARTA PUSAT,GAMBIR,GAMBIR,2191,451,1740,1530,3270,2021-11-24
3174061004,JAKARTA SELATAN,CILANDAK,GANDARIA SELATAN,22119,4106,18013,15712,33725,2021-11-24
3174071009,JAKARTA SELATAN,KEBAYORAN BARU,GANDARIA UTARA,39922,7677,32245,27852,60097,2021-11-24
3175051001,JAKARTA TIMUR,PASAR REBO,GEDONG,35755,6968,28787,24744,53531,2021-11-24
3171071001,JAKARTA PUSAT,TANAH ABANG,GELORA,3127,596,2531,2236,4767,2021-11-24
3173031007,JAKARTA BARAT,TAMAN SARI,GLODOK,7837,1149,6688,6106,12794,2021-11-24
3171061004,JAKARTA PUSAT,MENTENG,GONDANGDIA,4100,902,3198,2937,6135,2021-11-24
3173021001,JAKARTA BARAT,GROGOL PETAMBURAN,GROGOL,16876,3260,13616,11727,25343,2021-11-24
3174051005,JAKARTA SELATAN,KEBAYORAN LAMA,GROGOL SELATAN,44251,8602,35649,30092,65741,2021-11-24
3174051004,JAKARTA SELATAN,KEBAYORAN LAMA,GROGOL UTARA,42494,8429,34065,28867,62932,2021-11-24
3174021007,JAKARTA SELATAN,SETIA BUDI,GUNTUR,3985,725,3260,2931,6191,2021-11-24
3174071002,JAKARTA SELATAN,KEBAYORAN BARU,GUNUNG,9436,1708,7728,6971,14699,2021-11-24
3171031005,JAKARTA PUSAT,KEMAYORAN,GUNUNG SAHARI SELATAN,19199,3669,15530,13328,28858,2021-11-24
3171021004,JAKARTA PUSAT,SAWAH BESAR,GUNUNG SAHARI UTARA,16650,2862,13788,12452,26240,2021-11-24
3175081004,JAKARTA TIMUR,MAKASAR,HALIM PERDANA KUSUMAH,28363,3570,24793,22853,47646,2021-11-24
3171031003,JAKARTA PUSAT,KEMAYORAN,HARAPAN MULIA,22557,4280,18277,15226,33503,2021-11-24
3174091001,JAKARTA SELATAN,JAGAKARSA,JAGAKARSA,62389,9906,52483,45368,97851,2021-11-24
3175021007,JAKARTA TIMUR,PULO GADUNG,JATI,32757,5971,26786,23661,50447,2021-11-24
3174041002,JAKARTA SELATAN,PASAR MINGGU,JATI PADANG,37502,7014,30488,26193,56681,2021-11-24
3173071004,JAKARTA BARAT,PALMERAH,JATI PULO,28738,5539,23199,18956,42155,2021-11-24
3175061001,JAKARTA TIMUR,CAKUNG,JATINEGARA,84160,17219,66941,56236,123177,2021-11-24
3175021004,JAKARTA TIMUR,PULO GADUNG,JATINEGARA KAUM,24632,4250,20382,16968,37350,2021-11-24
3173021004,JAKARTA BARAT,GROGOL PETAMBURAN,JELAMBAR,30266,5370,24896,22260,47156,2021-11-24
3173021006,JAKARTA BARAT,GROGOL PETAMBURAN,JELAMBAR BARU,38246,6718,31528,27881,59409,2021-11-24
3173041006,JAKARTA BARAT,TAMBORA,JEMBATAN BESI,29314,6911,22403,17896,40299,2021-11-24
3173041008,JAKARTA BARAT,TAMBORA,JEMBATAN LIMA,21021,4648,16373,13242,29615,2021-11-24
3173081005,JAKARTA BARAT,KEMBANGAN,JOGLO,40839,7950,32889,28307,61196,2021-11-24
3171081001,JAKARTA PUSAT,JOHAR BARU,JOHAR BARU,37488,6780,30708,26342,57050,2021-11-24
3173041002,JAKARTA BARAT,TAMBORA,KALI ANYAR,23856,4561,19295,15685,34980,2021-11-24
3172041004,JAKARTA UTARA,CILINCING,KALIBARU,67684,17932,49752,36135,85887,2021-11-24
3174081002,JAKARTA SELATAN,PANCORAN,KALIBATA,41994,9230,32764,27279,60043,2021-11-24
3173061001,JAKARTA BARAT,KALI DERES,KALIDERES,72447,14067,58380,50242,108622,2021-11-24
3175051004,JAKARTA TIMUR,PASAR REBO,KALISARI,43212,7445,35767,30774,66541,2021-11-24
3173061004,JAKARTA BARAT,KALI DERES,KAMAL,53783,12195,41588,34002,75590,2021-11-24
3172011002,JAKARTA UTARA,PENJARINGAN,KAMAL MUARA,12930,2253,10677,9180,19857,2021-11-24
3171071007,JAKARTA PUSAT,TANAH ABANG,KAMPUNG BALI,11358,2392,8966,7106,16072,2021-11-24
3175031001,JAKARTA TIMUR,JATINEGARA,KAMPUNG MELAYU,25717,5709,20008,16000,36008,2021-11-24
3171081002,JAKARTA PUSAT,JOHAR BARU,KAMPUNG RAWA,21237,3427,17810,14490,32300,2021-11-24
3175041002,JAKARTA TIMUR,KRAMAT JATI,KAMPUNG TENGAH,43993,10662,33331,27274,60605,2021-11-24
3173011005,JAKARTA BARAT,CENGKARENG,KAPUK,134466,31295,103171,85373,188544,2021-11-24
3172011003,JAKARTA UTARA,PENJARINGAN,KAPUK MUARA,35781,6677,29104,25945,55049,2021-11-24
3171021002,JAKARTA PUSAT,SAWAH BESAR,KARANG ANYAR,25761,4760,21001,17931,38932,2021-11-24
3174021004,JAKARTA SELATAN,SETIA BUDI,KARET,9623,1810,7813,6651,14464,2021-11-24
3174021003,JAKARTA SELATAN,SETIA BUDI,KARET KUNINGAN,16055,3033,13022,11261,24283,2021-11-24
3174021002,JAKARTA SELATAN,SETIA BUDI,KARET SEMANGGI,2770,549,2221,1995,4216,2021-11-24
3171071003,JAKARTA PUSAT,TANAH ABANG,KARET TENGSIN,19271,3624,15647,13062,28709,2021-11-24
3171021003,JAKARTA PUSAT,SAWAH BESAR,KARTINI,22292,4083,18209,15897,34106,2021-11-24
3175011003,JAKARTA TIMUR,MATRAMAN,KAYU MANIS,25284,5132,20152,16484,36636,2021-11-24
3175021006,JAKARTA TIMUR,PULO GADUNG,KAYU PUTIH,40696,7483,33213,29509,62722,2021-11-24
3173031006,JAKARTA BARAT,TAMAN SARI,KEAGUNGAN,17387,3142,14245,11935,26180,2021-11-24
3174041007,JAKARTA SELATAN,PASAR MINGGU,KEBAGUSAN,44552,8545,36007,30479,66486,2021-11-24
3174051006,JAKARTA SELATAN,KEBAYORAN LAMA,KEBAYORAN LAMA SELATAN,41212,7427,33785,29339,63124,2021-11-24
3174051001,JAKARTA SELATAN,KEBAYORAN LAMA,KEBAYORAN LAMA UTARA,42422,8534,33888,28796,62684,2021-11-24
3174011004,JAKARTA SELATAN,TEBET,KEBON BARU,35165,6357,28808,24749,53557,2021-11-24
3172021005,JAKARTA UTARA,TANJUNG PRIOK,KEBON BAWANG,50952,9954,40998,34819,75817,2021-11-24
3173051001,JAKARTA BARAT,KEBON JERUK,KEBON JERUK,53887,10629,43258,35952,79210,2021-11-24
3171071006,JAKARTA PUSAT,TANAH ABANG,KEBON KACANG,21531,5002,16529,13373,29902,2021-11-24
3171011005,JAKARTA PUSAT,GAMBIR,KEBON KELAPA,10163,1984,8179,7044,15223,2021-11-24
3171031002,JAKARTA PUSAT,KEMAYORAN,KEBON KOSONG,30019,5836,24183,20286,44469,2021-11-24
3175011005,JAKARTA TIMUR,MATRAMAN,KEBON MANGGIS,16490,3110,13380,11279,24659,2021-11-24
3171071005,JAKARTA PUSAT,TANAH ABANG,KEBON MELATI,32206,8387,23819,18170,41989,2021-11-24
3175081003,JAKARTA TIMUR,MAKASAR,KEBON PALA,46614,8890,37724,32056,69780,2021-11-24
3171061005,JAKARTA PUSAT,MENTENG,KEBON SIRIH,12299,2562,9737,7969,17706,2021-11-24
3173011004,JAKARTA BARAT,CENGKARENG,KEDAUNG KALI ANGKE,32612,6119,26493,22749,49242,2021-11-24
3173051007,JAKARTA BARAT,KEBON JERUK,KEDOYA SELATAN,32165,5729,26436,22212,48648,2021-11-24
3173051006,JAKARTA BARAT,KEBON JERUK,KEDOYA UTARA,45740,8520,37220,31905,69125,2021-11-24
3173051004,JAKARTA BARAT,KEBON JERUK,KELAPA DUA,23565,4480,19085,16206,35291,2021-11-24
3175091003,JAKARTA TIMUR,CIRACAS,KELAPA DUA WETAN,46875,7762,39113,33734,72847,2021-11-24
3172061003,JAKARTA UTARA,KELAPA GADING,KELAPA GADING BARAT,35717,6087,29630,27065,56695,2021-11-24
3172061001,JAKARTA UTARA,KELAPA GADING,KELAPA GADING TIMUR,33592,5018,28574,26766,55340,2021-11-24
3173071005,JAKARTA BARAT,PALMERAH,KEMANGGISAN,32139,5906,26233,22674,48907,2021-11-24
3171031001,JAKARTA PUSAT,KEMAYORAN,KEMAYORAN,20708,3998,16710,14029,30739,2021-11-24
3173081006,JAKARTA BARAT,KEMBANGAN,KEMBANGAN SELATAN,27130,5532,21598,18910,40508,2021-11-24
3173081001,JAKARTA BARAT,KEMBANGAN,KEMBANGAN UTARA,54451,11595,42856,36231,79087,2021-11-24
3171041002,JAKARTA PUSAT,SENEN,KENARI,9579,1823,7756,6705,14461,2021-11-24
3173041005,JAKARTA BARAT,TAMBORA,KERENDANG,19973,3932,16041,13298,29339,2021-11-24
3175071003,JAKARTA TIMUR,DUREN SAWIT,KLENDER,69978,15951,54027,44087,98114,2021-11-24
3172031001,JAKARTA UTARA,KOJA,KOJA,28175,6211,21964,18158,40122,2021-11-24
3173071006,JAKARTA BARAT,PALMERAH,KOTA BAMBU SELATAN,21158,4042,17116,13758,30874,2021-11-24
3173071003,JAKARTA BARAT,PALMERAH,KOTA BAMBU UTARA,24995,4952,20043,15897,35940,2021-11-24
3171041004,JAKARTA PUSAT,SENEN,KRAMAT,28835,6640,22195,17195,39390,2021-11-24
3175041001,JAKARTA TIMUR,KRAMAT JATI,KRAMAT JATI,34144,7037,27107,22445,49552,2021-11-24
3174071003,JAKARTA SELATAN,KEBAYORAN BARU,KRAMAT PELA,14413,2719,11694,10252,21946,2021-11-24
3173031002,JAKARTA BARAT,TAMAN SARI,KRUKUT,19244,3536,15708,13046,28754,2021-11-24
3174031005,JAKARTA SELATAN,MAMPANG PRAPATAN,KUNINGAN BARAT,12785,2267,10518,9001,19519,2021-11-24
3174021008,JAKARTA SELATAN,SETIA BUDI,KUNINGAN TIMUR,6008,1160,4848,4227,9075,2021-11-24
3171041005,JAKARTA PUSAT,SENEN,KWITANG,15486,3333,12153,9946,22099,2021-11-24
3172031003,JAKARTA UTARA,KOJA,LAGOA,59065,13524,45541,36839,82380,2021-11-24
3174061002,JAKARTA SELATAN,CILANDAK,LEBAK BULUS,37626,6889,30737,27475,58212,2021-11-24
3174091004,JAKARTA SELATAN,JAGAKARSA,LENTENG AGUNG,53946,9359,44587,37372,81959,2021-11-24
3175101007,JAKARTA TIMUR,CIPAYUNG,LUBANG BUAYA,63547,11643,51904,44017,95921,2021-11-24
3175081001,JAKARTA TIMUR,MAKASAR,MAKASAR,34390,6057,28333,24645,52978,2021-11-24
3175071006,JAKARTA TIMUR,DUREN SAWIT,MALAKA JAYA,30927,5095,25832,22712,48544,2021-11-24
3175071005,JAKARTA TIMUR,DUREN SAWIT,MALAKA SARI,27530,4407,23123,20442,43565,2021-11-24
3174031001,JAKARTA SELATAN,MAMPANG PRAPATAN,MAMPANG PRAPATAN,18159,3603,14556,12291,26847,2021-11-24
3173031005,JAKARTA BARAT,TAMAN SARI,MANGGA BESAR,7707,1273,6434,5760,12194,2021-11-24
3171021005,JAKARTA PUSAT,SAWAH BESAR,MANGGA DUA SELATAN,27442,5482,21960,18902,40862,2021-11-24
3174011007,JAKARTA SELATAN,TEBET,MANGGARAI,28373,4814,23559,19678,43237,2021-11-24
3174011006,JAKARTA SELATAN,TEBET,MANGGARAI SELATAN,23075,3698,19377,16608,35985,2021-11-24
3173031003,JAKARTA BARAT,TAMAN SARI,MAPHAR,16461,2986,13475,11472,24947,2021-11-24
3172041003,JAKARTA UTARA,CILINCING,MARUNDA,28943,6354,22589,17358,39947,2021-11-24
3174071001,JAKARTA SELATAN,KEBAYORAN BARU,MELAWAI,2627,498,2129,1975,4104,2021-11-24
3171061001,JAKARTA PUSAT,MENTENG,MENTENG,25624,5426,20198,16396,36594,2021-11-24
3174021005,JAKARTA SELATAN,SETIA BUDI,MENTENG ATAS,27816,4834,22982,19632,42614,2021-11-24
3174011003,JAKARTA SELATAN,TEBET,MENTENG DALAM,36028,6776,29252,25263,54515,2021-11-24
3173081003,JAKARTA BARAT,KEMBANGAN,MERUYA SELATAN,32130,6379,25751,22194,47945,2021-11-24
3173081002,JAKARTA BARAT,KEMBANGAN,MERUYA UTARA,43752,8756,34996,30978,65974,2021-11-24
3175101004,JAKARTA TIMUR,CIPAYUNG,MUNJUL,23871,4242,19629,16917,36546,2021-11-24
3172051002,JAKARTA UTARA,PADEMANGAN,PADEMANGAN BARAT,74240,16890,57350,47260,104610,2021-11-24
3172051001,JAKARTA UTARA,PADEMANGAN,PADEMANGAN TIMUR,37736,6465,31271,28020,59291,2021-11-24
3175011004,JAKARTA TIMUR,MATRAMAN,PAL MERIAM,19769,3913,15856,13060,28916,2021-11-24
3173071001,JAKARTA BARAT,PALMERAH,PALMERAH,63011,12798,50213,41877,92090,2021-11-24
3174081001,JAKARTA SELATAN,PANCORAN,PANCORAN,19421,3774,15647,13252,28899,2021-11-24
3172021003,JAKARTA UTARA,TANJUNG PRIOK,PAPANGGO,39097,7446,31651,26509,58160,2021-11-24
3171021001,JAKARTA PUSAT,SAWAH BESAR,PASAR BARU,12035,2243,9792,8888,18680,2021-11-24
3174021006,JAKARTA SELATAN,SETIA BUDI,PASAR MANGGIS,26752,4995,21757,18443,40200,2021-11-24
3174041001,JAKARTA SELATAN,PASAR MINGGU,PASAR MINGGU,24821,4533,20288,17729,38017,2021-11-24
3171041003,JAKARTA PUSAT,SENEN,PASEBAN,23533,4741,18792,15675,34467,2021-11-24
3173061005,JAKARTA BARAT,KALI DERES,PEGADUNGAN,75587,14280,61307,53349,114656,2021-11-24
3171061002,JAKARTA PUSAT,MENTENG,PEGANGSAAN,23455,4878,18577,14681,33258,2021-11-24
3172061002,JAKARTA UTARA,KELAPA GADING,PEGANGSAAN DUA,49976,8085,41891,38400,80291,2021-11-24
3172011004,JAKARTA UTARA,PENJARINGAN,PEJAGALAN,74578,14995,59583,52292,111875,2021-11-24
3174041006,JAKARTA SELATAN,PASAR MINGGU,PEJATEN BARAT,37346,6999,30347,26037,56384,2021-11-24
3174041005,JAKARTA SELATAN,PASAR MINGGU,PEJATEN TIMUR,57656,12100,45556,37887,83443,2021-11-24
3175051005,JAKARTA TIMUR,PASAR REBO,PEKAYON,43250,7609,35641,30313,65954,2021-11-24
3173041009,JAKARTA BARAT,TAMBORA,PEKOJAN,23587,4354,19233,16508,35741,2021-11-24
3174031003,JAKARTA SELATAN,MAMPANG PRAPATAN,PELA MAMPANG,43522,8273,35249,30208,65457,2021-11-24
3174081005,JAKARTA SELATAN,PANCORAN,PENGADEGAN,21478,3831,17647,15378,33025,2021-11-24
3175061003,JAKARTA TIMUR,CAKUNG,PENGGILINGAN,99255,22089,77166,63052,140218,2021-11-24
3172011001,JAKARTA UTARA,PENJARINGAN,PENJARINGAN,88308,22052,66256,52392,118648,2021-11-24
3174101001,JAKARTA SELATAN,PESANGGRAHAN,PESANGGRAHAN,27545,4595,22950,20107,43057,2021-11-24
3171071004,JAKARTA PUSAT,TANAH ABANG,PETAMBURAN,33271,8543,24728,19267,43995,2021-11-24
3174071008,JAKARTA SELATAN,KEBAYORAN BARU,PETOGOGAN,11499,2161,9338,8127,17465,2021-11-24
3171011004,JAKARTA PUSAT,GAMBIR,PETOJO SELATAN,14692,3225,11467,9885,21352,2021-11-24
3171011003,JAKARTA PUSAT,GAMBIR,PETOJO UTARA,17458,3677,13781,11560,25341,2021-11-24
3174101004,JAKARTA SELATAN,PESANGGRAHAN,PETUKANGAN SELATAN,37187,7449,29738,25621,55359,2021-11-24
3174101003,JAKARTA SELATAN,PESANGGRAHAN,PETUKANGAN UTARA,53716,11164,42552,36107,78659,2021-11-24
3175081002,JAKARTA TIMUR,MAKASAR,PINANG RANTI,27198,5744,21454,18037,39491,2021-11-24
3173031008,JAKARTA BARAT,TAMAN SARI,PINANGSIA,10729,1834,8895,7524,16419,2021-11-24
3175011001,JAKARTA TIMUR,MATRAMAN,PISANGAN BARU,31776,6305,25471,20863,46334,2021-11-24
3175021002,JAKARTA TIMUR,PULO GADUNG,PISANGAN TIMUR,41011,7347,33664,29007,62671,2021-11-24
3172011005,JAKARTA UTARA,PENJARINGAN,PLUIT,47783,9035,38748,34487,73235,2021-11-24
3175071002,JAKARTA TIMUR,DUREN SAWIT,PONDOK BAMBU,61550,12550,49000,41821,90821,2021-11-24
3175071004,JAKARTA TIMUR,DUREN SAWIT,PONDOK KELAPA,72015,13875,58140,50771,108911,2021-11-24
3175071007,JAKARTA TIMUR,DUREN SAWIT,PONDOK KOPI,35367,6452,28915,23717,52632,2021-11-24
3174061003,JAKARTA SELATAN,CILANDAK,PONDOK LABU,46464,7451,39013,34649,73662,2021-11-24
3174051002,JAKARTA SELATAN,KEBAYORAN LAMA,PONDOK PINANG,56169,10479,45690,39833,85523,2021-11-24
3175101003,JAKARTA TIMUR,CIPAYUNG,PONDOK RANGGON,25574,4667,20907,18005,38912,2021-11-24
3101011003,KAB.ADM.KEP.SERIBU,KEP. SERIBU UTARA,PULAU HARAPAN,2060,218,1842,1624,3466,2021-11-24
3101011002,KAB.ADM.KEP.SERIBU,KEP. SERIBU UTARA,PULAU KELAPA,5528,586,4942,4101,9043,2021-11-24
3101011001,KAB.ADM.KEP.SERIBU,KEP. SERIBU UTARA,PULAU PANGGANG,5450,427,5023,4512,9535,2021-11-24
3101021003,KAB.ADM.KEP.SERIBU,KEP. SERIBU SELATAN,PULAU PARI,2765,191,2574,2440,5014,2021-11-24
3101021002,KAB.ADM.KEP.SERIBU,KEP. SERIBU SELATAN,PULAU TIDUNG,4553,363,4190,3879,8069,2021-11-24
3101021001,KAB.ADM.KEP.SERIBU,KEP. SERIBU SELATAN,PULAU UNTUNG JAWA,1941,156,1785,1663,3448,2021-11-24
3174071007,JAKARTA SELATAN,KEBAYORAN BARU,PULO,5835,984,4851,4504,9355,2021-11-24
3175021001,JAKARTA TIMUR,PULO GADUNG,PULO GADUNG,34422,7322,27100,23076,50176,2021-11-24
3175061005,JAKARTA TIMUR,CAKUNG,PULO GEBANG,97301,18139,79162,65747,144909,2021-11-24
3174041004,JAKARTA SELATAN,PASAR MINGGU,RAGUNAN,39616,6904,32712,28486,61198,2021-11-24
3175091005,JAKARTA TIMUR,CIRACAS,RAMBUTAN,36771,8342,28429,23669,52098,2021-11-24
3172031006,JAKARTA UTARA,KOJA,RAWA BADAK SELATAN,42179,9666,32513,26348,58861,2021-11-24
3172031004,JAKARTA UTARA,KOJA,RAWA BADAK UTARA,34408,7464,26944,22297,49241,2021-11-24
3174071005,JAKARTA SELATAN,KEBAYORAN BARU,RAWA BARAT,5625,981,4644,4181,8825,2021-11-24
3173011003,JAKARTA BARAT,CENGKARENG,RAWA BUAYA,63799,12182,51617,43530,95147,2021-11-24
3175031004,JAKARTA TIMUR,JATINEGARA,RAWA BUNGA,21434,5014,16420,13641,30061,2021-11-24
3174081003,JAKARTA SELATAN,PANCORAN,RAWA JATI,20509,3802,16707,14573,31280,2021-11-24
3175061002,JAKARTA TIMUR,CAKUNG,RAWA TERATE,24637,4322,20315,16925,37240,2021-11-24
3175021005,JAKARTA TIMUR,PULO GADUNG,RAWAMANGUN,37612,7199,30413,26342,56755,2021-11-24
3171051003,JAKARTA PUSAT,CEMPAKA PUTIH,RAWASARI,21967,4323,17644,15414,33058,2021-11-24
3173041010,JAKARTA BARAT,TAMBORA,ROA MALAKA,3484,605,2879,2613,5492,2021-11-24
3172041006,JAKARTA UTARA,CILINCING,ROROTAN,41668,8098,33570,27678,61248,2021-11-24
3174071004,JAKARTA SELATAN,KEBAYORAN BARU,SELONG,2842,538,2304,2155,4459,2021-11-24
3173061002,JAKARTA BARAT,KALI DERES,SEMANAN,71354,14455,56899,46807,103706,2021-11-24
3172041007,JAKARTA UTARA,CILINCING,SEMPER BARAT,68587,12938,55649,47193,102842,2021-11-24
3172041005,JAKARTA UTARA,CILINCING,SEMPER TIMUR,36267,7531,28736,23848,52584,2021-11-24
3174071006,JAKARTA SELATAN,KEBAYORAN BARU,SENAYAN,2771,639,2132,1883,4015,2021-11-24
3171041001,JAKARTA PUSAT,SENEN,SENEN,6804,1395,5409,4569,9978,2021-11-24
3171031004,JAKARTA PUSAT,KEMAYORAN,SERDANG,29668,5572,24096,20488,44584,2021-11-24
3174021001,JAKARTA SELATAN,SETIA BUDI,SETIA BUDI,3023,593,2430,2125,4555,2021-11-24
3175101005,JAKARTA TIMUR,CIPAYUNG,SETU,20572,3982,16590,13889,30479,2021-11-24
3173071002,JAKARTA BARAT,PALMERAH,SLIPI,16591,2892,13699,11836,25535,2021-11-24
3173081004,JAKARTA BARAT,KEMBANGAN,SRENGSENG,45523,9899,35624,30641,66265,2021-11-24
3174091002,JAKARTA SELATAN,JAGAKARSA,SRENGSENG SAWAH,58196,8602,49594,43533,93127,2021-11-24
3173051003,JAKARTA BARAT,KEBON JERUK,SUKABUMI SELATAN,37033,7711,29322,23335,52657,2021-11-24
3173051002,JAKARTA BARAT,KEBON JERUK,SUKABUMI UTARA,38290,8684,29606,23869,53475,2021-11-24
3172041002,JAKARTA UTARA,CILINCING,SUKAPURA,53949,11806,42143,35395,77538,2021-11-24
3171031007,JAKARTA PUSAT,KEMAYORAN,SUMUR BATU,22717,4188,18529,16081,34610,2021-11-24
3172021004,JAKARTA UTARA,TANJUNG PRIOK,SUNGAI BAMBU,29876,5805,24071,20392,44463,2021-11-24
3172021006,JAKARTA UTARA,TANJUNG PRIOK,SUNTER AGUNG,71805,12071,59734,53249,112983,2021-11-24
3172021002,JAKARTA UTARA,TANJUNG PRIOK,SUNTER JAYA,63031,10751,52280,46214,98494,2021-11-24
3175091004,JAKARTA TIMUR,CIRACAS,SUSUKAN,38257,6990,31267,26645,57912,2021-11-24
3173031001,JAKARTA BARAT,TAMAN SARI,TAMAN SARI,14348,2548,11800,10296,22096,2021-11-24
3173041001,JAKARTA BARAT,TAMBORA,TAMBORA,10204,2137,8067,6625,14692,2021-11-24
3173041004,JAKARTA BARAT,TAMBORA,TANAH SEREAL,26387,4343,22044,18801,40845,2021-11-24
3171081004,JAKARTA PUSAT,JOHAR BARU,TANAH TINGGI,37693,7011,30682,25280,55962,2021-11-24
3173031004,JAKARTA BARAT,TAMAN SARI,TANGKI,13324,2161,11163,9646,20809,2021-11-24
3174091005,JAKARTA SELATAN,JAGAKARSA,TANJUNG BARAT,39770,6553,33217,28222,61439,2021-11-24
3173021005,JAKARTA BARAT,GROGOL PETAMBURAN,TANJUNG DUREN SELATAN,25337,4688,20649,18592,39241,2021-11-24
3173021002,JAKARTA BARAT,GROGOL PETAMBURAN,TANJUNG DUREN UTARA,17010,2787,14223,12989,27212,2021-11-24
3172021001,JAKARTA UTARA,TANJUNG PRIOK,TANJUNG PRIOK,34588,6929,27659,23058,50717,2021-11-24
3174011002,JAKARTA SELATAN,TEBET,TEBET BARAT,21194,3300,17894,16035,33929,2021-11-24
3174011001,JAKARTA SELATAN,TEBET,TEBET TIMUR,18199,2829,15370,14115,29485,2021-11-24
3173061003,JAKARTA BARAT,KALI DERES,TEGAL ALUR,83647,16785,66862,56308,123170,2021-11-24
3174031004,JAKARTA SELATAN,MAMPANG PRAPATAN,TEGAL PARANG,32401,6907,25494,20474,45968,2021-11-24
3173021003,JAKARTA BARAT,GROGOL PETAMBURAN,TOMANG,29605,5302,24303,21359,45662,2021-11-24
3172031005,JAKARTA UTARA,KOJA,TUGU SELATAN,39122,8489,30633,25436,56069,2021-11-24
3172031002,JAKARTA UTARA,KOJA,TUGU UTARA,67670,15526,52144,42230,94374,2021-11-24
3175061006,JAKARTA TIMUR,CAKUNG,UJUNG MENTENG,29934,4981,24953,21606,46559,2021-11-24
3174101005,JAKARTA SELATAN,PESANGGRAHAN,ULUJAMI,40544,8769,31775,26758,58533,2021-11-24
3175011006,JAKARTA TIMUR,MATRAMAN,UTAN KAYU SELATAN,33511,5816,27695,23459,51154,2021-11-24
3175011002,JAKARTA TIMUR,MATRAMAN,UTAN KAYU UTARA,28169,5643,22526,18837,41363,2021-11-24
3171031008,JAKARTA PUSAT,KEMAYORAN,UTAN PANJANG,29208,5576,23632,19497,43129,2021-11-24
3172021007,JAKARTA UTARA,TANJUNG PRIOK,WARAKAS,44401,7923,36478,30099,66577,2021-11-24
3173021007,JAKARTA BARAT,GROGOL PETAMBURAN,WIJAYA KUSUMA,38934,7876,31058,26732,57790,2021-11-24
3172051003,JAKARTA UTARA,PADEMANGAN,ANCOL,23947,5561,18386,15374,33760,2021-11-25
3173041007,JAKARTA BARAT,TAMBORA,ANGKE,29381,6047,23334,19277,42611,2021-11-25
3175041005,JAKARTA TIMUR,KRAMAT JATI,BALE KAMBANG,29074,6870,22204,17922,40126,2021-11-25
3175031003,JAKARTA TIMUR,JATINEGARA,BALI MESTER,9752,1945,7807,6704,14511,2021-11-25
3175101006,JAKARTA TIMUR,CIPAYUNG,BAMBU APUS,26285,4649,21636,18545,40181,2021-11-25
3174031002,JAKARTA SELATAN,MAMPANG PRAPATAN,BANGKA,21566,4372,17194,14564,31758,2021-11-25
3175051002,JAKARTA TIMUR,PASAR REBO,BARU,23886,3802,20084,17662,37746,2021-11-25
3175041004,JAKARTA TIMUR,KRAMAT JATI,BATU AMPAR,47898,11115,36783,30413,67196,2021-11-25
3171071002,JAKARTA PUSAT,TANAH ABANG,BENDUNGAN HILIR,21494,4218,17276,15023,32299,2021-11-25
3175031002,JAKARTA TIMUR,JATINEGARA,BIDARA CINA,36689,8519,28170,23327,51497,2021-11-25
3174101002,JAKARTA SELATAN,PESANGGRAHAN,BINTARO,53098,10345,42753,37821,80574,2021-11-25
3174011005,JAKARTA SELATAN,TEBET,BUKIT DURI,34183,6615,27568,23489,51057,2021-11-25
3171041006,JAKARTA PUSAT,SENEN,BUNGUR,18144,3658,14486,12233,26719,2021-11-25
3175061007,JAKARTA TIMUR,CAKUNG,CAKUNG BARAT,57724,11428,46296,38810,85106,2021-11-25
3175061004,JAKARTA TIMUR,CAKUNG,CAKUNG TIMUR,58287,11078,47209,40023,87232,2021-11-25
3175041007,JAKARTA TIMUR,KRAMAT JATI,CAWANG,32762,6766,25996,21373,47369,2021-11-25
3175101008,JAKARTA TIMUR,CIPAYUNG,CEGER,18932,3549,15383,13119,28502,2021-11-25
3171031006,JAKARTA PUSAT,KEMAYORAN,CEMPAKA BARU,32581,5932,26649,22112,48761,2021-11-25
3171051002,JAKARTA PUSAT,CEMPAKA PUTIH,CEMPAKA PUTIH BARAT,35885,7303,28582,24925,53507,2021-11-25
3171051001,JAKARTA PUSAT,CEMPAKA PUTIH,CEMPAKA PUTIH TIMUR,24292,4859,19433,17386,36819,2021-11-25
3173011001,JAKARTA BARAT,CENGKARENG,CENGKARENG BARAT,66284,12725,53559,46999,100558,2021-11-25
3173011006,JAKARTA BARAT,CENGKARENG,CENGKARENG TIMUR,81027,15500,65527,55733,121260,2021-11-25
3175091002,JAKARTA TIMUR,CIRACAS,CIBUBUR,66364,11061,55303,47879,103182,2021-11-25
3171011002,JAKARTA PUSAT,GAMBIR,CIDENG,15390,2942,12448,11046,23494,2021-11-25
3174091003,JAKARTA SELATAN,JAGAKARSA,CIGANJUR,38497,6251,32246,27492,59738,2021-11-25
3175051003,JAKARTA TIMUR,PASAR REBO,CIJANTUNG,41419,7400,34019,29058,63077,2021-11-25
3171061003,JAKARTA PUSAT,MENTENG,CIKINI,8274,1456,6818,5559,12377,2021-11-25
3174081006,JAKARTA SELATAN,PANCORAN,CIKOKO,10547,1763,8784,7736,16520,2021-11-25
3174061001,JAKARTA SELATAN,CILANDAK,CILANDAK BARAT,51752,8813,42939,38319,81258,2021-11-25
3174041003,JAKARTA SELATAN,PASAR MINGGU,CILANDAK TIMUR,25145,4452,20693,18009,38702,2021-11-25
3175101002,JAKARTA TIMUR,CIPAYUNG,CILANGKAP,27635,4740,22895,19887,42782,2021-11-25
3175041006,JAKARTA TIMUR,KRAMAT JATI,CILILITAN,40181,8193,31988,26551,58539,2021-11-25
3172041001,JAKARTA UTARA,CILINCING,CILINCING,43609,10103,33506,26744,60250,2021-11-25
3175101001,JAKARTA TIMUR,CIPAYUNG,CIPAYUNG,26104,4400,21704,18943,40647,2021-11-25
3174091006,JAKARTA SELATAN,JAGAKARSA,CIPEDAK,38303,6126,32177,27883,60060,2021-11-25
3174061005,JAKARTA SELATAN,CILANDAK,CIPETE SELATAN,26704,4927,21777,19540,41317,2021-11-25
3174071010,JAKARTA SELATAN,KEBAYORAN BARU,CIPETE UTARA,34102,6267,27835,23914,51749,2021-11-25
3175021003,JAKARTA TIMUR,PULO GADUNG,CIPINANG,39306,6909,32397,27617,60014,2021-11-25
3175031007,JAKARTA TIMUR,JATINEGARA,CIPINANG BESAR SELATAN,35212,8012,27200,21975,49175,2021-11-25
3175031008,JAKARTA TIMUR,JATINEGARA,CIPINANG BESAR UTARA,45319,10311,35008,28086,63094,2021-11-25
3175031005,JAKARTA TIMUR,JATINEGARA,CIPINANG CEMPEDAK,32824,6942,25882,22499,48381,2021-11-25
3175081005,JAKARTA TIMUR,MAKASAR,CIPINANG MELAYU,42308,7938,34370,29787,64157,2021-11-25
3175031006,JAKARTA TIMUR,JATINEGARA,CIPINANG MUARA,55243,11341,43902,36728,80630,2021-11-25
3174051003,JAKARTA SELATAN,KEBAYORAN LAMA,CIPULIR,39937,8169,31768,26726,58494,2021-11-25
3175091001,JAKARTA TIMUR,CIRACAS,CIRACAS,64594,11506,53088,45040,98128,2021-11-25
3175041003,JAKARTA TIMUR,KRAMAT JATI,DUKUH,24609,4400,20209,17058,37267,2021-11-25
3175071001,JAKARTA TIMUR,DUREN SAWIT,DUREN SAWIT,61160,12515,48645,41516,90161,2021-11-25
3174081004,JAKARTA SELATAN,PANCORAN,DUREN TIGA,28319,5427,22892,19526,42418,2021-11-25
3173051005,JAKARTA BARAT,KEBON JERUK,DURI KEPA,60138,11507,48631,42693,91324,2021-11-25
3173011002,JAKARTA BARAT,CENGKARENG,DURI KOSAMBI,77923,16049,61874,51126,113000,2021-11-25
3171011006,JAKARTA PUSAT,GAMBIR,DURI PULO,19610,4037,15573,12751,28324,2021-11-25
3173041011,JAKARTA BARAT,TAMBORA,DURI SELATAN,14259,2454,11805,10164,21969,2021-11-25
3173041003,JAKARTA BARAT,TAMBORA,DURI UTARA,19844,3464,16380,13748,30128,2021-11-25
3171081003,JAKARTA PUSAT,JOHAR BARU,GALUR,18243,3464,14779,12157,26936,2021-11-25
3171011001,JAKARTA PUSAT,GAMBIR,GAMBIR,2191,449,1742,1534,3276,2021-11-25
3174061004,JAKARTA SELATAN,CILANDAK,GANDARIA SELATAN,22119,4094,18025,15768,33793,2021-11-25
3174071009,JAKARTA SELATAN,KEBAYORAN BARU,GANDARIA UTARA,39922,7647,32275,27984,60259,2021-11-25
3175051001,JAKARTA TIMUR,PASAR REBO,GEDONG,35755,6952,28803,24804,53607,2021-11-25
3171071001,JAKARTA PUSAT,TANAH ABANG,GELORA,3127,594,2533,2243,4776,2021-11-25
3173031007,JAKARTA BARAT,TAMAN SARI,GLODOK,7837,1146,6691,6110,12801,2021-11-25
3171061004,JAKARTA PUSAT,MENTENG,GONDANGDIA,4100,899,3201,2941,6142,2021-11-25
3173021001,JAKARTA BARAT,GROGOL PETAMBURAN,GROGOL,16876,3245,13631,11781,25412,2021-11-25
3174051005,JAKARTA SELATAN,KEBAYORAN LAMA,GROGOL SELATAN,44251,8575,35676,30229,65905,2021-11-25
3174051004,JAKARTA SELATAN,KEBAYORAN LAMA,GROGOL UTARA,42494,8409,34085,28963,63048,2021-11-25
3174021007,JAKARTA SELATAN,SETIA BUDI,GUNTUR,3985,722,3263,2934,6197,2021-11-25
3174071002,JAKARTA SELATAN,KEBAYORAN BARU,GUNUNG,9436,1707,7729,6986,14715,2021-11-25
3171031005,JAKARTA PUSAT,KEMAYORAN,GUNUNG SAHARI SELATAN,19199,3624,15575,13403,28978,2021-11-25
3171021004,JAKARTA PUSAT,SAWAH BESAR,GUNUNG SAHARI UTARA,16650,2857,13793,12480,26273,2021-11-25
3175081004,JAKARTA TIMUR,MAKASAR,HALIM PERDANA KUSUMAH,28363,3556,24807,22910,47717,2021-11-25
3171031003,JAKARTA PUSAT,KEMAYORAN,HARAPAN MULIA,22557,4259,18298,15298,33596,2021-11-25
3174091001,JAKARTA SELATAN,JAGAKARSA,JAGAKARSA,62389,9865,52524,45594,98118,2021-11-25
3175021007,JAKARTA TIMUR,PULO GADUNG,JATI,32757,5960,26797,23753,50550,2021-11-25
3174041002,JAKARTA SELATAN,PASAR MINGGU,JATI PADANG,37502,6967,30535,26267,56802,2021-11-25
3173071004,JAKARTA BARAT,PALMERAH,JATI PULO,28738,5522,23216,19025,42241,2021-11-25
3175061001,JAKARTA TIMUR,CAKUNG,JATINEGARA,84160,17166,66994,56458,123452,2021-11-25
3175021004,JAKARTA TIMUR,PULO GADUNG,JATINEGARA KAUM,24632,4238,20394,17018,37412,2021-11-25
3173021004,JAKARTA BARAT,GROGOL PETAMBURAN,JELAMBAR,30266,5358,24908,22329,47237,2021-11-25
3173021006,JAKARTA BARAT,GROGOL PETAMBURAN,JELAMBAR BARU,38246,6690,31556,28016,59572,2021-11-25
3173041006,JAKARTA BARAT,TAMBORA,JEMBATAN BESI,29314,6890,22424,17992,40416,2021-11-25
3173041008,JAKARTA BARAT,TAMBORA,JEMBATAN LIMA,21021,4615,16406,13285,29691,2021-11-25
3173081005,JAKARTA BARAT,KEMBANGAN,JOGLO,40839,7924,32915,28423,61338,2021-11-25
3171081001,JAKARTA PUSAT,JOHAR BARU,JOHAR BARU,37488,6750,30738,26433,57171,2021-11-25
3173041002,JAKARTA BARAT,TAMBORA,KALI ANYAR,23856,4552,19304,15738,35042,2021-11-25
3172041004,JAKARTA UTARA,CILINCING,KALIBARU,67684,17879,49805,36338,86143,2021-11-25
3174081002,JAKARTA SELATAN,PANCORAN,KALIBATA,41994,9209,32785,27394,60179,2021-11-25
3173061001,JAKARTA BARAT,KALI DERES,KALIDERES,72447,14027,58420,50400,108820,2021-11-25
3175051004,JAKARTA TIMUR,PASAR REBO,KALISARI,43212,7418,35794,30882,66676,2021-11-25
3173061004,JAKARTA BARAT,KALI DERES,KAMAL,53783,12137,41646,34146,75792,2021-11-25
3172011002,JAKARTA UTARA,PENJARINGAN,KAMAL MUARA,12930,2249,10681,9188,19869,2021-11-25
3171071007,JAKARTA PUSAT,TANAH ABANG,KAMPUNG BALI,11358,2380,8978,7140,16118,2021-11-25
3175031001,JAKARTA TIMUR,JATINEGARA,KAMPUNG MELAYU,25717,5694,20023,16051,36074,2021-11-25
3171081002,JAKARTA PUSAT,JOHAR BARU,KAMPUNG RAWA,21237,3417,17820,14528,32348,2021-11-25
3175041002,JAKARTA TIMUR,KRAMAT JATI,KAMPUNG TENGAH,43993,10521,33472,27464,60936,2021-11-25
3173011005,JAKARTA BARAT,CENGKARENG,KAPUK,134466,31214,103252,85708,188960,2021-11-25
3172011003,JAKARTA UTARA,PENJARINGAN,KAPUK MUARA,35781,6652,29129,26010,55139,2021-11-25
3171021002,JAKARTA PUSAT,SAWAH BESAR,KARANG ANYAR,25761,4742,21019,18001,39020,2021-11-25
3174021004,JAKARTA SELATAN,SETIA BUDI,KARET,9623,1805,7818,6673,14491,2021-11-25
3174021003,JAKARTA SELATAN,SETIA BUDI,KARET KUNINGAN,16055,3028,13027,11287,24314,2021-11-25
3174021002,JAKARTA SELATAN,SETIA BUDI,KARET SEMANGGI,2770,548,2222,2002,4224,2021-11-25
3171071003,JAKARTA PUSAT,TANAH ABANG,KARET TENGSIN,19271,3614,15657,13116,28773,2021-11-25
3171021003,JAKARTA PUSAT,SAWAH BESAR,KARTINI,22292,4070,18222,15941,34163,2021-11-25
3175011003,JAKARTA TIMUR,MATRAMAN,KAYU MANIS,25284,5114,20170,16559,36729,2021-11-25
3175021006,JAKARTA TIMUR,PULO GADUNG,KAYU PUTIH,40696,7470,33226,29577,62803,2021-11-25
3173031006,JAKARTA BARAT,TAMAN SARI,KEAGUNGAN,17387,3129,14258,11966,26224,2021-11-25
3174041007,JAKARTA SELATAN,PASAR MINGGU,KEBAGUSAN,44552,8518,36034,30584,66618,2021-11-25
3174051006,JAKARTA SELATAN,KEBAYORAN LAMA,KEBAYORAN LAMA SELATAN,41212,7372,33840,29507,63347,2021-11-25
3174051001,JAKARTA SELATAN,KEBAYORAN LAMA,KEBAYORAN LAMA UTARA,42422,8484,33938,28963,62901,2021-11-25
3174011004,JAKARTA SELATAN,TEBET,KEBON BARU,35165,6345,28820,24812,53632,2021-11-25
3172021005,JAKARTA UTARA,TANJUNG PRIOK,KEBON BAWANG,50952,9931,41021,34958,75979,2021-11-25
3173051001,JAKARTA BARAT,KEBON JERUK,KEBON JERUK,53887,10588,43299,36121,79420,2021-11-25
3171071006,JAKARTA PUSAT,TANAH ABANG,KEBON KACANG,21531,4990,16541,13455,29996,2021-11-25
3171011005,JAKARTA PUSAT,GAMBIR,KEBON KELAPA,10163,1980,8183,7065,15248,2021-11-25
3171031002,JAKARTA PUSAT,KEMAYORAN,KEBON KOSONG,30019,5821,24198,20383,44581,2021-11-25
3175011005,JAKARTA TIMUR,MATRAMAN,KEBON MANGGIS,16490,3097,13393,11317,24710,2021-11-25
3171071005,JAKARTA PUSAT,TANAH ABANG,KEBON MELATI,32206,8361,23845,18248,42093,2021-11-25
3175081003,JAKARTA TIMUR,MAKASAR,KEBON PALA,46614,8870,37744,32144,69888,2021-11-25
3171061005,JAKARTA PUSAT,MENTENG,KEBON SIRIH,12299,2560,9739,7998,17737,2021-11-25
3173011004,JAKARTA BARAT,CENGKARENG,KEDAUNG KALI ANGKE,32612,6098,26514,22810,49324,2021-11-25
3173051007,JAKARTA BARAT,KEBON JERUK,KEDOYA SELATAN,32165,5711,26454,22287,48741,2021-11-25
3173051006,JAKARTA BARAT,KEBON JERUK,KEDOYA UTARA,45740,8508,37232,31991,69223,2021-11-25
3173051004,JAKARTA BARAT,KEBON JERUK,KELAPA DUA,23565,4469,19096,16279,35375,2021-11-25
3175091003,JAKARTA TIMUR,CIRACAS,KELAPA DUA WETAN,46875,7742,39133,33841,72974,2021-11-25
3172061003,JAKARTA UTARA,KELAPA GADING,KELAPA GADING BARAT,35717,6075,29642,27112,56754,2021-11-25
3172061001,JAKARTA UTARA,KELAPA GADING,KELAPA GADING TIMUR,33592,5012,28580,26805,55385,2021-11-25
3173071005,JAKARTA BARAT,PALMERAH,KEMANGGISAN,32139,5884,26255,22756,49011,2021-11-25
3171031001,JAKARTA PUSAT,KEMAYORAN,KEMAYORAN,20708,3981,16727,14083,30810,2021-11-25
3173081006,JAKARTA BARAT,KEMBANGAN,KEMBANGAN SELATAN,27130,5520,21610,18953,40563,2021-11-25
3173081001,JAKARTA BARAT,KEMBANGAN,KEMBANGAN UTARA,54451,11563,42888,36362,79250,2021-11-25
3171041002,JAKARTA PUSAT,SENEN,KENARI,9579,1820,7759,6716,14475,2021-11-25
3173041005,JAKARTA BARAT,TAMBORA,KERENDANG,19973,3920,16053,13377,29430,2021-11-25
3175071003,JAKARTA TIMUR,DUREN SAWIT,KLENDER,69978,15915,54063,44255,98318,2021-11-25
3172031001,JAKARTA UTARA,KOJA,KOJA,28175,6197,21978,18205,40183,2021-11-25
3173071006,JAKARTA BARAT,PALMERAH,KOTA BAMBU SELATAN,21158,4030,17128,13838,30966,2021-11-25
3173071003,JAKARTA BARAT,PALMERAH,KOTA BAMBU UTARA,24995,4937,20058,16029,36087,2021-11-25
3171041004,JAKARTA PUSAT,SENEN,KRAMAT,28835,6573,22262,17283,39545,2021-11-25
3175041001,JAKARTA TIMUR,KRAMAT JATI,KRAMAT JATI,34144,7015,27129,22502,49631,2021-11-25
3174071003,JAKARTA SELATAN,KEBAYORAN BARU,KRAMAT PELA,14413,2714,11699,10281,21980,2021-11-25
3173031002,JAKARTA BARAT,TAMAN SARI,KRUKUT,19244,3515,15729,13086,28815,2021-11-25
3174031005,JAKARTA SELATAN,MAMPANG PRAPATAN,KUNINGAN BARAT,12785,2257,10528,9029,19557,2021-11-25
3174021008,JAKARTA SELATAN,SETIA BUDI,KUNINGAN TIMUR,6008,1156,4852,4249,9101,2021-11-25
3171041005,JAKARTA PUSAT,SENEN,KWITANG,15486,3325,12161,9973,22134,2021-11-25
3172031003,JAKARTA UTARA,KOJA,LAGOA,59065,13488,45577,36962,82539,2021-11-25
3174061002,JAKARTA SELATAN,CILANDAK,LEBAK BULUS,37626,6866,30760,27566,58326,2021-11-25
3174091004,JAKARTA SELATAN,JAGAKARSA,LENTENG AGUNG,53946,9328,44618,37472,82090,2021-11-25
3175101007,JAKARTA TIMUR,CIPAYUNG,LUBANG BUAYA,63547,11609,51938,44150,96088,2021-11-25
3175081001,JAKARTA TIMUR,MAKASAR,MAKASAR,34390,5996,28394,24732,53126,2021-11-25
3175071006,JAKARTA TIMUR,DUREN SAWIT,MALAKA JAYA,30927,5070,25857,22787,48644,2021-11-25
3175071005,JAKARTA TIMUR,DUREN SAWIT,MALAKA SARI,27530,4395,23135,20516,43651,2021-11-25
3174031001,JAKARTA SELATAN,MAMPANG PRAPATAN,MAMPANG PRAPATAN,18159,3594,14565,12345,26910,2021-11-25
3173031005,JAKARTA BARAT,TAMAN SARI,MANGGA BESAR,7707,1271,6436,5765,12201,2021-11-25
3171021005,JAKARTA PUSAT,SAWAH BESAR,MANGGA DUA SELATAN,27442,5463,21979,18974,40953,2021-11-25
3174011007,JAKARTA SELATAN,TEBET,MANGGARAI,28373,4806,23567,19724,43291,2021-11-25
3174011006,JAKARTA SELATAN,TEBET,MANGGARAI SELATAN,23075,3686,19389,16664,36053,2021-11-25
3173031003,JAKARTA BARAT,TAMAN SARI,MAPHAR,16461,2980,13481,11512,24993,2021-11-25
3172041003,JAKARTA UTARA,CILINCING,MARUNDA,28943,6319,22624,17455,40079,2021-11-25
3174071001,JAKARTA SELATAN,KEBAYORAN BARU,MELAWAI,2627,497,2130,1980,4110,2021-11-25
3171061001,JAKARTA PUSAT,MENTENG,MENTENG,25624,5407,20217,16491,36708,2021-11-25
3174021005,JAKARTA SELATAN,SETIA BUDI,MENTENG ATAS,27816,4820,22996,19732,42728,2021-11-25
3174011003,JAKARTA SELATAN,TEBET,MENTENG DALAM,36028,6754,29274,25323,54597,2021-11-25
3173081003,JAKARTA BARAT,KEMBANGAN,MERUYA SELATAN,32130,6374,25756,22282,48038,2021-11-25
3173081002,JAKARTA BARAT,KEMBANGAN,MERUYA UTARA,43752,8724,35028,31071,66099,2021-11-25
3175101004,JAKARTA TIMUR,CIPAYUNG,MUNJUL,23871,4228,19643,16989,36632,2021-11-25
3172051002,JAKARTA UTARA,PADEMANGAN,PADEMANGAN BARAT,74240,16842,57398,47403,104801,2021-11-25
3172051001,JAKARTA UTARA,PADEMANGAN,PADEMANGAN TIMUR,37736,6446,31290,28099,59389,2021-11-25
3175011004,JAKARTA TIMUR,MATRAMAN,PAL MERIAM,19769,3891,15878,13125,29003,2021-11-25
3173071001,JAKARTA BARAT,PALMERAH,PALMERAH,63011,12753,50258,42040,92298,2021-11-25
3174081001,JAKARTA SELATAN,PANCORAN,PANCORAN,19421,3731,15690,13380,29070,2021-11-25
3172021003,JAKARTA UTARA,TANJUNG PRIOK,PAPANGGO,39097,7426,31671,26585,58256,2021-11-25
3171021001,JAKARTA PUSAT,SAWAH BESAR,PASAR BARU,12035,2232,9803,8904,18707,2021-11-25
3174021006,JAKARTA SELATAN,SETIA BUDI,PASAR MANGGIS,26752,4960,21792,18534,40326,2021-11-25
3174041001,JAKARTA SELATAN,PASAR MINGGU,PASAR MINGGU,24821,4516,20305,17790,38095,2021-11-25
3171041003,JAKARTA PUSAT,SENEN,PASEBAN,23533,4726,18807,15728,34535,2021-11-25
3173061005,JAKARTA BARAT,KALI DERES,PEGADUNGAN,75587,14231,61356,53473,114829,2021-11-25
3171061002,JAKARTA PUSAT,MENTENG,PEGANGSAAN,23455,4860,18595,14785,33380,2021-11-25
3172061002,JAKARTA UTARA,KELAPA GADING,PEGANGSAAN DUA,49976,8068,41908,38472,80380,2021-11-25
3172011004,JAKARTA UTARA,PENJARINGAN,PEJAGALAN,74578,14951,59627,52469,112096,2021-11-25
3174041006,JAKARTA SELATAN,PASAR MINGGU,PEJATEN BARAT,37346,6982,30364,26163,56527,2021-11-25
3174041005,JAKARTA SELATAN,PASAR MINGGU,PEJATEN TIMUR,57656,12038,45618,37968,83586,2021-11-25
3175051005,JAKARTA TIMUR,PASAR REBO,PEKAYON,43250,7582,35668,30413,66081,2021-11-25
3173041009,JAKARTA BARAT,TAMBORA,PEKOJAN,23587,4340,19247,16548,35795,2021-11-25
3174031003,JAKARTA SELATAN,MAMPANG PRAPATAN,PELA MAMPANG,43522,8244,35278,30355,65633,2021-11-25
3174081005,JAKARTA SELATAN,PANCORAN,PENGADEGAN,21478,3820,17658,15432,33090,2021-11-25
3175061003,JAKARTA TIMUR,CAKUNG,PENGGILINGAN,99255,21978,77277,63376,140653,2021-11-25
3172011001,JAKARTA UTARA,PENJARINGAN,PENJARINGAN,88308,21999,66309,52609,118918,2021-11-25
3174101001,JAKARTA SELATAN,PESANGGRAHAN,PESANGGRAHAN,27545,4585,22960,20146,43106,2021-11-25
3171071004,JAKARTA PUSAT,TANAH ABANG,PETAMBURAN,33271,8524,24747,19333,44080,2021-11-25
3174071008,JAKARTA SELATAN,KEBAYORAN BARU,PETOGOGAN,11499,2153,9346,8160,17506,2021-11-25
3171011004,JAKARTA PUSAT,GAMBIR,PETOJO SELATAN,14692,3212,11480,9915,21395,2021-11-25
3171011003,JAKARTA PUSAT,GAMBIR,PETOJO UTARA,17458,3666,13792,11594,25386,2021-11-25
3174101004,JAKARTA SELATAN,PESANGGRAHAN,PETUKANGAN SELATAN,37187,7433,29754,25703,55457,2021-11-25
3174101003,JAKARTA SELATAN,PESANGGRAHAN,PETUKANGAN UTARA,53716,11100,42616,36309,78925,2021-11-25
3175081002,JAKARTA TIMUR,MAKASAR,PINANG RANTI,27198,5729,21469,18126,39595,2021-11-25
3173031008,JAKARTA BARAT,TAMAN SARI,PINANGSIA,10729,1825,8904,7555,16459,2021-11-25
3175011001,JAKARTA TIMUR,MATRAMAN,PISANGAN BARU,31776,6284,25492,20949,46441,2021-11-25
3175021002,JAKARTA TIMUR,PULO GADUNG,PISANGAN TIMUR,41011,7325,33686,29097,62783,2021-11-25
3172011005,JAKARTA UTARA,PENJARINGAN,PLUIT,47783,9020,38763,34556,73319,2021-11-25
3175071002,JAKARTA TIMUR,DUREN SAWIT,PONDOK BAMBU,61550,12520,49030,42023,91053,2021-11-25
3175071004,JAKARTA TIMUR,DUREN SAWIT,PONDOK KELAPA,72015,13851,58164,50915,109079,2021-11-25
3175071007,JAKARTA TIMUR,DUREN SAWIT,PONDOK KOPI,35367,6437,28930,23796,52726,2021-11-25
3174061003,JAKARTA SELATAN,CILANDAK,PONDOK LABU,46464,7433,39031,34769,73800,2021-11-25
3174051002,JAKARTA SELATAN,KEBAYORAN LAMA,PONDOK PINANG,56169,10454,45715,39992,85707,2021-11-25
3175101003,JAKARTA TIMUR,CIPAYUNG,PONDOK RANGGON,25574,4639,20935,18095,39030,2021-11-25
3101011003,KAB.ADM.KEP.SERIBU,KEP. SERIBU UTARA,PULAU HARAPAN,2060,218,1842,1640,3482,2021-11-25
3101011002,KAB.ADM.KEP.SERIBU,KEP. SERIBU UTARA,PULAU KELAPA,5528,586,4942,4104,9046,2021-11-25
3101011001,KAB.ADM.KEP.SERIBU,KEP. SERIBU UTARA,PULAU PANGGANG,5450,427,5023,4516,9539,2021-11-25
3101021003,KAB.ADM.KEP.SERIBU,KEP. SERIBU SELATAN,PULAU PARI,2765,191,2574,2440,5014,2021-11-25
3101021002,KAB.ADM.KEP.SERIBU,KEP. SERIBU SELATAN,PULAU TIDUNG,4553,362,4191,3884,8075,2021-11-25
3101021001,KAB.ADM.KEP.SERIBU,KEP. SERIBU SELATAN,PULAU UNTUNG JAWA,1941,156,1785,1663,3448,2021-11-25
3174071007,JAKARTA SELATAN,KEBAYORAN BARU,PULO,5835,983,4852,4511,9363,2021-11-25
3175021001,JAKARTA TIMUR,PULO GADUNG,PULO GADUNG,34422,7295,27127,23155,50282,2021-11-25
3175061005,JAKARTA TIMUR,CAKUNG,PULO GEBANG,97301,18093,79208,65973,145181,2021-11-25
3174041004,JAKARTA SELATAN,PASAR MINGGU,RAGUNAN,39616,6868,32748,28572,61320,2021-11-25
3175091005,JAKARTA TIMUR,CIRACAS,RAMBUTAN,36771,8313,28458,23753,52211,2021-11-25
3172031006,JAKARTA UTARA,KOJA,RAWA BADAK SELATAN,42179,9639,32540,26443,58983,2021-11-25
3172031004,JAKARTA UTARA,KOJA,RAWA BADAK UTARA,34408,7447,26961,22368,49329,2021-11-25
3174071005,JAKARTA SELATAN,KEBAYORAN BARU,RAWA BARAT,5625,981,4644,4189,8833,2021-11-25
3173011003,JAKARTA BARAT,CENGKARENG,RAWA BUAYA,63799,12140,51659,43758,95417,2021-11-25
3175031004,JAKARTA TIMUR,JATINEGARA,RAWA BUNGA,21434,4999,16435,13709,30144,2021-11-25
3174081003,JAKARTA SELATAN,PANCORAN,RAWA JATI,20509,3793,16716,14628,31344,2021-11-25
3175061002,JAKARTA TIMUR,CAKUNG,RAWA TERATE,24637,4309,20328,16967,37295,2021-11-25
3175021005,JAKARTA TIMUR,PULO GADUNG,RAWAMANGUN,37612,7181,30431,26457,56888,2021-11-25
3171051003,JAKARTA PUSAT,CEMPAKA PUTIH,RAWASARI,21967,4301,17666,15470,33136,2021-11-25
3173041010,JAKARTA BARAT,TAMBORA,ROA MALAKA,3484,604,2880,2621,5501,2021-11-25
3172041006,JAKARTA UTARA,CILINCING,ROROTAN,41668,8074,33594,27817,61411,2021-11-25
3174071004,JAKARTA SELATAN,KEBAYORAN BARU,SELONG,2842,537,2305,2157,4462,2021-11-25
3173061002,JAKARTA BARAT,KALI DERES,SEMANAN,71354,14383,56971,46965,103936,2021-11-25
3172041007,JAKARTA UTARA,CILINCING,SEMPER BARAT,68587,12907,55680,47369,103049,2021-11-25
3172041005,JAKARTA UTARA,CILINCING,SEMPER TIMUR,36267,7500,28767,23944,52711,2021-11-25
3174071006,JAKARTA SELATAN,KEBAYORAN BARU,SENAYAN,2771,638,2133,1885,4018,2021-11-25
3171041001,JAKARTA PUSAT,SENEN,SENEN,6804,1391,5413,4589,10002,2021-11-25
3171031004,JAKARTA PUSAT,KEMAYORAN,SERDANG,29668,5558,24110,20592,44702,2021-11-25
3174021001,JAKARTA SELATAN,SETIA BUDI,SETIA BUDI,3023,591,2432,2132,4564,2021-11-25
3175101005,JAKARTA TIMUR,CIPAYUNG,SETU,20572,3960,16612,13948,30560,2021-11-25
3173071002,JAKARTA BARAT,PALMERAH,SLIPI,16591,2877,13714,11881,25595,2021-11-25
3173081004,JAKARTA BARAT,KEMBANGAN,SRENGSENG,45523,9873,35650,30778,66428,2021-11-25
3174091002,JAKARTA SELATAN,JAGAKARSA,SRENGSENG SAWAH,58196,8577,49619,43671,93290,2021-11-25
3173051003,JAKARTA BARAT,KEBON JERUK,SUKABUMI SELATAN,37033,7602,29431,23436,52867,2021-11-25
3173051002,JAKARTA BARAT,KEBON JERUK,SUKABUMI UTARA,38290,8660,29630,23948,53578,2021-11-25
3172041002,JAKARTA UTARA,CILINCING,SUKAPURA,53949,11771,42178,35536,77714,2021-11-25
3171031007,JAKARTA PUSAT,KEMAYORAN,SUMUR BATU,22717,4169,18548,16138,34686,2021-11-25
3172021004,JAKARTA UTARA,TANJUNG PRIOK,SUNGAI BAMBU,29876,5777,24099,20468,44567,2021-11-25
3172021006,JAKARTA UTARA,TANJUNG PRIOK,SUNTER AGUNG,71805,12045,59760,53393,113153,2021-11-25
3172021002,JAKARTA UTARA,TANJUNG PRIOK,SUNTER JAYA,63031,10721,52310,46344,98654,2021-11-25
3175091004,JAKARTA TIMUR,CIRACAS,SUSUKAN,38257,6975,31282,26735,58017,2021-11-25
3173031001,JAKARTA BARAT,TAMAN SARI,TAMAN SARI,14348,2541,11807,10316,22123,2021-11-25
3173041001,JAKARTA BARAT,TAMBORA,TAMBORA,10204,2129,8075,6647,14722,2021-11-25
3173041004,JAKARTA BARAT,TAMBORA,TANAH SEREAL,26387,4332,22055,18852,40907,2021-11-25
3171081004,JAKARTA PUSAT,JOHAR BARU,TANAH TINGGI,37693,6996,30697,25349,56046,2021-11-25
3173031004,JAKARTA BARAT,TAMAN SARI,TANGKI,13324,2156,11168,9684,20852,2021-11-25
3174091005,JAKARTA SELATAN,JAGAKARSA,TANJUNG BARAT,39770,6529,33241,28357,61598,2021-11-25
3173021005,JAKARTA BARAT,GROGOL PETAMBURAN,TANJUNG DUREN SELATAN,25337,4678,20659,18639,39298,2021-11-25
3173021002,JAKARTA BARAT,GROGOL PETAMBURAN,TANJUNG DUREN UTARA,17010,2780,14230,13026,27256,2021-11-25
3172021001,JAKARTA UTARA,TANJUNG PRIOK,TANJUNG PRIOK,34588,6906,27682,23133,50815,2021-11-25
3174011002,JAKARTA SELATAN,TEBET,TEBET BARAT,21194,3289,17905,16067,33972,2021-11-25
3174011001,JAKARTA SELATAN,TEBET,TEBET TIMUR,18199,2826,15373,14152,29525,2021-11-25
3173061003,JAKARTA BARAT,KALI DERES,TEGAL ALUR,83647,16736,66911,56494,123405,2021-11-25
3174031004,JAKARTA SELATAN,MAMPANG PRAPATAN,TEGAL PARANG,32401,6892,25509,20554,46063,2021-11-25
3173021003,JAKARTA BARAT,GROGOL PETAMBURAN,TOMANG,29605,5287,24318,21431,45749,2021-11-25
3172031005,JAKARTA UTARA,KOJA,TUGU SELATAN,39122,8462,30660,25526,56186,2021-11-25
3172031002,JAKARTA UTARA,KOJA,TUGU UTARA,67670,15481,52189,42419,94608,2021-11-25
3175061006,JAKARTA TIMUR,CAKUNG,UJUNG MENTENG,29934,4971,24963,21685,46648,2021-11-25
3174101005,JAKARTA SELATAN,PESANGGRAHAN,ULUJAMI,40544,8742,31802,26860,58662,2021-11-25
3175011006,JAKARTA TIMUR,MATRAMAN,UTAN KAYU SELATAN,33511,5797,27714,23523,51237,2021-11-25
3175011002,JAKARTA TIMUR,MATRAMAN,UTAN KAYU UTARA,28169,5514,22655,18921,41576,2021-11-25
3171031008,JAKARTA PUSAT,KEMAYORAN,UTAN PANJANG,29208,5566,23642,19574,43216,2021-11-25
3172021007,JAKARTA UTARA,TANJUNG PRIOK,WARAKAS,44401,7896,36505,30193,66698,2021-11-25
3173021007,JAKARTA BARAT,GROGOL PETAMBURAN,WIJAYA KUSUMA,38934,7840,31094,26820,57914,2021-11-25
3172051003,JAKARTA UTARA,PADEMANGAN,ANCOL,23947,5556,18391,15388,33779,2021-11-26
3173041007,JAKARTA BARAT,TAMBORA,ANGKE,29381,6038,23343,19295,42638,2021-11-26
3175041005,JAKARTA TIMUR,KRAMAT JATI,BALE KAMBANG,29074,6858,22216,17960,40176,2021-11-26
3175031003,JAKARTA TIMUR,JATINEGARA,BALI MESTER,9752,1940,7812,6721,14533,2021-11-26
3175101006,JAKARTA TIMUR,CIPAYUNG,BAMBU APUS,26285,4641,21644,18595,40239,2021-11-26
3174031002,JAKARTA SELATAN,MAMPANG PRAPATAN,BANGKA,21566,4363,17203,14587,31790,2021-11-26
3175051002,JAKARTA TIMUR,PASAR REBO,BARU,23886,3799,20087,17680,37767,2021-11-26
3175041004,JAKARTA TIMUR,KRAMAT JATI,BATU AMPAR,47898,11093,36805,30456,67261,2021-11-26
3171071002,JAKARTA PUSAT,TANAH ABANG,BENDUNGAN HILIR,21494,4212,17282,15043,32325,2021-11-26
3175031002,JAKARTA TIMUR,JATINEGARA,BIDARA CINA,36689,8495,28194,23401,51595,2021-11-26
3174101002,JAKARTA SELATAN,PESANGGRAHAN,BINTARO,53098,10338,42760,37932,80692,2021-11-26
3174011005,JAKARTA SELATAN,TEBET,BUKIT DURI,34183,6604,27579,23521,51100,2021-11-26
3171041006,JAKARTA PUSAT,SENEN,BUNGUR,18144,3641,14503,12258,26761,2021-11-26
3175061007,JAKARTA TIMUR,CAKUNG,CAKUNG BARAT,57724,11419,46305,38852,85157,2021-11-26
3175061004,JAKARTA TIMUR,CAKUNG,CAKUNG TIMUR,58287,11056,47231,40081,87312,2021-11-26
3175041007,JAKARTA TIMUR,KRAMAT JATI,CAWANG,32762,6715,26047,21507,47554,2021-11-26
3175101008,JAKARTA TIMUR,CIPAYUNG,CEGER,18932,3538,15394,13152,28546,2021-11-26
3171031006,JAKARTA PUSAT,KEMAYORAN,CEMPAKA BARU,32581,5924,26657,22176,48833,2021-11-26
3171051002,JAKARTA PUSAT,CEMPAKA PUTIH,CEMPAKA PUTIH BARAT,35885,7289,28596,24953,53549,2021-11-26
3171051001,JAKARTA PUSAT,CEMPAKA PUTIH,CEMPAKA PUTIH TIMUR,24292,4852,19440,17403,36843,2021-11-26
3173011001,JAKARTA BARAT,CENGKARENG,CENGKARENG BARAT,66284,12717,53567,47068,100635,2021-11-26
3173011006,JAKARTA BARAT,CENGKARENG,CENGKARENG TIMUR,81027,15472,65555,55870,121425,2021-11-26
3175091002,JAKARTA TIMUR,CIRACAS,CIBUBUR,66364,11028,55336,48018,103354,2021-11-26
3171011002,JAKARTA PUSAT,GAMBIR,CIDENG,15390,2936,12454,11058,23512,2021-11-26
3174091003,JAKARTA SELATAN,JAGAKARSA,CIGANJUR,38497,6242,32255,27552,59807,2021-11-26
3175051003,JAKARTA TIMUR,PASAR REBO,CIJANTUNG,41419,7388,34031,29102,63133,2021-11-26
3171061003,JAKARTA PUSAT,MENTENG,CIKINI,8274,1454,6820,5570,12390,2021-11-26
3174081006,JAKARTA SELATAN,PANCORAN,CIKOKO,10547,1762,8785,7739,16524,2021-11-26
3174061001,JAKARTA SELATAN,CILANDAK,CILANDAK BARAT,51752,8807,42945,38351,81296,2021-11-26
3174041003,JAKARTA SELATAN,PASAR MINGGU,CILANDAK TIMUR,25145,4438,20707,18032,38739,2021-11-26
3175101002,JAKARTA TIMUR,CIPAYUNG,CILANGKAP,27635,4719,22916,19939,42855,2021-11-26
3175041006,JAKARTA TIMUR,KRAMAT JATI,CILILITAN,40181,8171,32010,26591,58601,2021-11-26
3172041001,JAKARTA UTARA,CILINCING,CILINCING,43609,10029,33580,26867,60447,2021-11-26
3175101001,JAKARTA TIMUR,CIPAYUNG,CIPAYUNG,26104,4389,21715,19013,40728,2021-11-26
3174091006,JAKARTA SELATAN,JAGAKARSA,CIPEDAK,38303,6114,32189,27921,60110,2021-11-26
3174061005,JAKARTA SELATAN,CILANDAK,CIPETE SELATAN,26704,4916,21788,19554,41342,2021-11-26
3174071010,JAKARTA SELATAN,KEBAYORAN BARU,CIPETE UTARA,34102,6260,27842,23940,51782,2021-11-26
3175021003,JAKARTA TIMUR,PULO GADUNG,CIPINANG,39306,6890,32416,27681,60097,2021-11-26
3175031007,JAKARTA TIMUR,JATINEGARA,CIPINANG BESAR SELATAN,35212,8008,27204,22061,49265,2021-11-26
3175031008,JAKARTA TIMUR,JATINEGARA,CIPINANG BESAR UTARA,45319,10285,35034,28120,63154,2021-11-26
3175031005,JAKARTA TIMUR,JATINEGARA,CIPINANG CEMPEDAK,32824,6926,25898,22556,48454,2021-11-26
3175081005,JAKARTA TIMUR,MAKASAR,CIPINANG MELAYU,42308,7931,34377,29828,64205,2021-11-26
3175031006,JAKARTA TIMUR,JATINEGARA,CIPINANG MUARA,55243,11322,43921,36804,80725,2021-11-26
3174051003,JAKARTA SELATAN,KEBAYORAN LAMA,CIPULIR,39937,8153,31784,26772,58556,2021-11-26
3175091001,JAKARTA TIMUR,CIRACAS,CIRACAS,64594,11479,53115,45124,98239,2021-11-26
3175041003,JAKARTA TIMUR,KRAMAT JATI,DUKUH,24609,4386,20223,17109,37332,2021-11-26
3175071001,JAKARTA TIMUR,DUREN SAWIT,DUREN SAWIT,61160,12492,48668,41582,90250,2021-11-26
3174081004,JAKARTA SELATAN,PANCORAN,DUREN TIGA,28319,5417,22902,19549,42451,2021-11-26
3173051005,JAKARTA BARAT,KEBON JERUK,DURI KEPA,60138,11492,48646,42747,91393,2021-11-26
3173011002,JAKARTA BARAT,CENGKARENG,DURI KOSAMBI,77923,16022,61901,51242,113143,2021-11-26
3171011006,JAKARTA PUSAT,GAMBIR,DURI PULO,19610,4031,15579,12771,28350,2021-11-26
3173041011,JAKARTA BARAT,TAMBORA,DURI SELATAN,14259,2454,11805,10174,21979,2021-11-26
3173041003,JAKARTA BARAT,TAMBORA,DURI UTARA,19844,3451,16393,13765,30158,2021-11-26
3171081003,JAKARTA PUSAT,JOHAR BARU,GALUR,18243,3460,14783,12166,26949,2021-11-26
3171011001,JAKARTA PUSAT,GAMBIR,GAMBIR,2191,449,1742,1534,3276,2021-11-26
3174061004,JAKARTA SELATAN,CILANDAK,GANDARIA SELATAN,22119,4088,18031,15786,33817,2021-11-26
3174071009,JAKARTA SELATAN,KEBAYORAN BARU,GANDARIA UTARA,39922,7632,32290,28016,60306,2021-11-26
3175051001,JAKARTA TIMUR,PASAR REBO,GEDONG,35755,6937,28818,24849,53667,2021-11-26
3171071001,JAKARTA PUSAT,TANAH ABANG,GELORA,3127,594,2533,2244,4777,2021-11-26
3173031007,JAKARTA BARAT,TAMAN SARI,GLODOK,7837,1145,6692,6134,12826,2021-11-26
3171061004,JAKARTA PUSAT,MENTENG,GONDANGDIA,4100,897,3203,2945,6148,2021-11-26
3173021001,JAKARTA BARAT,GROGOL PETAMBURAN,GROGOL,16876,3238,13638,11790,25428,2021-11-26
3174051005,JAKARTA SELATAN,KEBAYORAN LAMA,GROGOL SELATAN,44251,8558,35693,30281,65974,2021-11-26
3174051004,JAKARTA SELATAN,KEBAYORAN LAMA,GROGOL UTARA,42494,8390,34104,29012,63116,2021-11-26
3174021007,JAKARTA SELATAN,SETIA BUDI,GUNTUR,3985,722,3263,2936,6199,2021-11-26
3174071002,JAKARTA SELATAN,KEBAYORAN BARU,GUNUNG,9436,1705,7731,6989,14720,2021-11-26
3171031005,JAKARTA PUSAT,KEMAYORAN,GUNUNG SAHARI SELATAN,19199,3610,15589,13425,29014,2021-11-26
3171021004,JAKARTA PUSAT,SAWAH BESAR,GUNUNG SAHARI UTARA,16650,2851,13799,12497,26296,2021-11-26
3175081004,JAKARTA TIMUR,MAKASAR,HALIM PERDANA KUSUMAH,28363,3554,24809,22924,47733,2021-11-26
3171031003,JAKARTA PUSAT,KEMAYORAN,HARAPAN MULIA,22557,4247,18310,15334,33644,2021-11-26
3174091001,JAKARTA SELATAN,JAGAKARSA,JAGAKARSA,62389,9845,52544,45712,98256,2021-11-26
3175021007,JAKARTA TIMUR,PULO GADUNG,JATI,32757,5942,26815,23803,50618,2021-11-26
3174041002,JAKARTA SELATAN,PASAR MINGGU,JATI PADANG,37502,6949,30553,26377,56930,2021-11-26
3173071004,JAKARTA BARAT,PALMERAH,JATI PULO,28738,5513,23225,19065,42290,2021-11-26
3175061001,JAKARTA TIMUR,CAKUNG,JATINEGARA,84160,17153,67007,56557,123564,2021-11-26
3175021004,JAKARTA TIMUR,PULO GADUNG,JATINEGARA KAUM,24632,4229,20403,17046,37449,2021-11-26
3173021004,JAKARTA BARAT,GROGOL PETAMBURAN,JELAMBAR,30266,5352,24914,22371,47285,2021-11-26
3173021006,JAKARTA BARAT,GROGOL PETAMBURAN,JELAMBAR BARU,38246,6673,31573,28058,59631,2021-11-26
3173041006,JAKARTA BARAT,TAMBORA,JEMBATAN BESI,29314,6874,22440,18028,40468,2021-11-26
3173041008,JAKARTA BARAT,TAMBORA,JEMBATAN LIMA,21021,4604,16417,13317,29734,2021-11-26
3173081005,JAKARTA BARAT,KEMBANGAN,JOGLO,40839,7911,32928,28441,61369,2021-11-26
3171081001,JAKARTA PUSAT,JOHAR BARU,JOHAR BARU,37488,6741,30747,26458,57205,2021-11-26
3173041002,JAKARTA BARAT,TAMBORA,KALI ANYAR,23856,4547,19309,15755,35064,2021-11-26
3172041004,JAKARTA UTARA,CILINCING,KALIBARU,67684,17845,49839,36412,86251,2021-11-26
3174081002,JAKARTA SELATAN,PANCORAN,KALIBATA,41994,9193,32801,27437,60238,2021-11-26
3173061001,JAKARTA BARAT,KALI DERES,KALIDERES,72447,14001,58446,50467,108913,2021-11-26
3175051004,JAKARTA TIMUR,PASAR REBO,KALISARI,43212,7405,35807,30906,66713,2021-11-26
3173061004,JAKARTA BARAT,KALI DERES,KAMAL,53783,12072,41711,34239,75950,2021-11-26
3172011002,JAKARTA UTARA,PENJARINGAN,KAMAL MUARA,12930,2248,10682,9189,19871,2021-11-26
3171071007,JAKARTA PUSAT,TANAH ABANG,KAMPUNG BALI,11358,2374,8984,7154,16138,2021-11-26
3175031001,JAKARTA TIMUR,JATINEGARA,KAMPUNG MELAYU,25717,5673,20044,16105,36149,2021-11-26
3171081002,JAKARTA PUSAT,JOHAR BARU,KAMPUNG RAWA,21237,3412,17825,14545,32370,2021-11-26
3175041002,JAKARTA TIMUR,KRAMAT JATI,KAMPUNG TENGAH,43993,10506,33487,27509,60996,2021-11-26
3173011005,JAKARTA BARAT,CENGKARENG,KAPUK,134466,31162,103304,85868,189172,2021-11-26
3172011003,JAKARTA UTARA,PENJARINGAN,KAPUK MUARA,35781,6638,29143,26022,55165,2021-11-26
3171021002,JAKARTA PUSAT,SAWAH BESAR,KARANG ANYAR,25761,4730,21031,18024,39055,2021-11-26
3174021004,JAKARTA SELATAN,SETIA BUDI,KARET,9623,1804,7819,6682,14501,2021-11-26
3174021003,JAKARTA SELATAN,SETIA BUDI,KARET KUNINGAN,16055,3027,13028,11297,24325,2021-11-26
3174021002,JAKARTA SELATAN,SETIA BUDI,KARET SEMANGGI,2770,546,2224,2003,4227,2021-11-26
3171071003,JAKARTA PUSAT,TANAH ABANG,KARET TENGSIN,19271,3610,15661,13128,28789,2021-11-26
3171021003,JAKARTA PUSAT,SAWAH BESAR,KARTINI,22292,4065,18227,15954,34181,2021-11-26
3175011003,JAKARTA TIMUR,MATRAMAN,KAYU MANIS,25284,5096,20188,16591,36779,2021-11-26
3175021006,JAKARTA TIMUR,PULO GADUNG,KAYU PUTIH,40696,7454,33242,29600,62842,2021-11-26
3173031006,JAKARTA BARAT,TAMAN SARI,KEAGUNGAN,17387,3122,14265,11980,26245,2021-11-26
3174041007,JAKARTA SELATAN,PASAR MINGGU,KEBAGUSAN,44552,8498,36054,30648,66702,2021-11-26
3174051006,JAKARTA SELATAN,KEBAYORAN LAMA,KEBAYORAN LAMA SELATAN,41212,7351,33861,29543,63404,2021-11-26
3174051001,JAKARTA SELATAN,KEBAYORAN LAMA,KEBAYORAN LAMA UTARA,42422,8466,33956,29032,62988,2021-11-26
3174011004,JAKARTA SELATAN,TEBET,KEBON BARU,35165,6322,28843,24857,53700,2021-11-26
3172021005,JAKARTA UTARA,TANJUNG PRIOK,KEBON BAWANG,50952,9912,41040,35004,76044,2021-11-26
3173051001,JAKARTA BARAT,KEBON JERUK,KEBON JERUK,53887,10574,43313,36203,79516,2021-11-26
3171071006,JAKARTA PUSAT,TANAH ABANG,KEBON KACANG,21531,4985,16546,13477,30023,2021-11-26
3171011005,JAKARTA PUSAT,GAMBIR,KEBON KELAPA,10163,1978,8185,7070,15255,2021-11-26
3171031002,JAKARTA PUSAT,KEMAYORAN,KEBON KOSONG,30019,5803,24216,20428,44644,2021-11-26
3175011005,JAKARTA TIMUR,MATRAMAN,KEBON MANGGIS,16490,3089,13401,11326,24727,2021-11-26
3171071005,JAKARTA PUSAT,TANAH ABANG,KEBON MELATI,32206,8357,23849,18277,42126,2021-11-26
3175081003,JAKARTA TIMUR,MAKASAR,KEBON PALA,46614,8859,37755,32193,69948,2021-11-26
3171061005,JAKARTA PUSAT,MENTENG,KEBON SIRIH,12299,2558,9741,8023,17764,2021-11-26
3173011004,JAKARTA BARAT,CENGKARENG,KEDAUNG KALI ANGKE,32612,6083,26529,22837,49366,2021-11-26
3173051007,JAKARTA BARAT,KEBON JERUK,KEDOYA SELATAN,32165,5704,26461,22330,48791,2021-11-26
3173051006,JAKARTA BARAT,KEBON JERUK,KEDOYA UTARA,45740,8488,37252,32041,69293,2021-11-26
3173051004,JAKARTA BARAT,KEBON JERUK,KELAPA DUA,23565,4462,19103,16303,35406,2021-11-26
3175091003,JAKARTA TIMUR,CIRACAS,KELAPA DUA WETAN,46875,7731,39144,33920,73064,2021-11-26
3172061003,JAKARTA UTARA,KELAPA GADING,KELAPA GADING BARAT,35717,6064,29653,27143,56796,2021-11-26
3172061001,JAKARTA UTARA,KELAPA GADING,KELAPA GADING TIMUR,33592,5007,28585,26832,55417,2021-11-26
3173071005,JAKARTA BARAT,PALMERAH,KEMANGGISAN,32139,5870,26269,22804,49073,2021-11-26
3171031001,JAKARTA PUSAT,KEMAYORAN,KEMAYORAN,20708,3975,16733,14114,30847,2021-11-26
3173081006,JAKARTA BARAT,KEMBANGAN,KEMBANGAN SELATAN,27130,5488,21642,18987,40629,2021-11-26
3173081001,JAKARTA BARAT,KEMBANGAN,KEMBANGAN UTARA,54451,11543,42908,36422,79330,2021-11-26
3171041002,JAKARTA PUSAT,SENEN,KENARI,9579,1818,7761,6725,14486,2021-11-26
3173041005,JAKARTA BARAT,TAMBORA,KERENDANG,19973,3916,16057,13390,29447,2021-11-26
3175071003,JAKARTA TIMUR,DUREN SAWIT,KLENDER,69978,15889,54089,44330,98419,2021-11-26
3172031001,JAKARTA UTARA,KOJA,KOJA,28175,6189,21986,18222,40208,2021-11-26
3173071006,JAKARTA BARAT,PALMERAH,KOTA BAMBU SELATAN,21158,4027,17131,13865,30996,2021-11-26
3173071003,JAKARTA BARAT,PALMERAH,KOTA BAMBU UTARA,24995,4935,20060,16043,36103,2021-11-26
3171041004,JAKARTA PUSAT,SENEN,KRAMAT,28835,6517,22318,17328,39646,2021-11-26
3175041001,JAKARTA TIMUR,KRAMAT JATI,KRAMAT JATI,34144,7005,27139,22546,49685,2021-11-26
3174071003,JAKARTA SELATAN,KEBAYORAN BARU,KRAMAT PELA,14413,2712,11701,10289,21990,2021-11-26
3173031002,JAKARTA BARAT,TAMAN SARI,KRUKUT,19244,3509,15735,13108,28843,2021-11-26
3174031005,JAKARTA SELATAN,MAMPANG PRAPATAN,KUNINGAN BARAT,12785,2257,10528,9047,19575,2021-11-26
3174021008,JAKARTA SELATAN,SETIA BUDI,KUNINGAN TIMUR,6008,1156,4852,4251,9103,2021-11-26
3171041005,JAKARTA PUSAT,SENEN,KWITANG,15486,3320,12166,9996,22162,2021-11-26
3172031003,JAKARTA UTARA,KOJA,LAGOA,59065,13433,45632,37065,82697,2021-11-26
3174061002,JAKARTA SELATAN,CILANDAK,LEBAK BULUS,37626,6858,30768,27596,58364,2021-11-26
3174091004,JAKARTA SELATAN,JAGAKARSA,LENTENG AGUNG,53946,9295,44651,37541,82192,2021-11-26
3175101007,JAKARTA TIMUR,CIPAYUNG,LUBANG BUAYA,63547,11588,51959,44223,96182,2021-11-26
3175081001,JAKARTA TIMUR,MAKASAR,MAKASAR,34390,5995,28395,24757,53152,2021-11-26
3175071006,JAKARTA TIMUR,DUREN SAWIT,MALAKA JAYA,30927,5061,25866,22831,48697,2021-11-26
3175071005,JAKARTA TIMUR,DUREN SAWIT,MALAKA SARI,27530,4384,23146,20550,43696,2021-11-26
3174031001,JAKARTA SELATAN,MAMPANG PRAPATAN,MAMPANG PRAPATAN,18159,3580,14579,12366,26945,2021-11-26
3173031005,JAKARTA BARAT,TAMAN SARI,MANGGA BESAR,7707,1271,6436,5770,12206,2021-11-26
3171021005,JAKARTA PUSAT,SAWAH BESAR,MANGGA DUA SELATAN,27442,5445,21997,18994,40991,2021-11-26
3174011007,JAKARTA SELATAN,TEBET,MANGGARAI,28373,4784,23589,19798,43387,2021-11-26
3174011006,JAKARTA SELATAN,TEBET,MANGGARAI SELATAN,23075,3630,19445,16716,36161,2021-11-26
3173031003,JAKARTA BARAT,TAMAN SARI,MAPHAR,16461,2978,13483,11520,25003,2021-11-26
3172041003,JAKARTA UTARA,CILINCING,MARUNDA,28943,6314,22629,17486,40115,2021-11-26
3174071001,JAKARTA SELATAN,KEBAYORAN BARU,MELAWAI,2627,497,2130,1980,4110,2021-11-26
3171061001,JAKARTA PUSAT,MENTENG,MENTENG,25624,5395,20229,16538,36767,2021-11-26
3174021005,JAKARTA SELATAN,SETIA BUDI,MENTENG ATAS,27816,4809,23007,19764,42771,2021-11-26
3174011003,JAKARTA SELATAN,TEBET,MENTENG DALAM,36028,6729,29299,25386,54685,2021-11-26
3173081003,JAKARTA BARAT,KEMBANGAN,MERUYA SELATAN,32130,6355,25775,22310,48085,2021-11-26
3173081002,JAKARTA BARAT,KEMBANGAN,MERUYA UTARA,43752,8709,35043,31134,66177,2021-11-26
3175101004,JAKARTA TIMUR,CIPAYUNG,MUNJUL,23871,4221,19650,17006,36656,2021-11-26
3172051002,JAKARTA UTARA,PADEMANGAN,PADEMANGAN BARAT,74240,16819,57421,47443,104864,2021-11-26
3172051001,JAKARTA UTARA,PADEMANGAN,PADEMANGAN TIMUR,37736,6439,31297,28129,59426,2021-11-26
3175011004,JAKARTA TIMUR,MATRAMAN,PAL MERIAM,19769,3872,15897,13144,29041,2021-11-26
3173071001,JAKARTA BARAT,PALMERAH,PALMERAH,63011,12720,50291,42137,92428,2021-11-26
3174081001,JAKARTA SELATAN,PANCORAN,PANCORAN,19421,3724,15697,13390,29087,2021-11-26
3172021003,JAKARTA UTARA,TANJUNG PRIOK,PAPANGGO,39097,7417,31680,26627,58307,2021-11-26
3171021001,JAKARTA PUSAT,SAWAH BESAR,PASAR BARU,12035,2229,9806,8914,18720,2021-11-26
3174021006,JAKARTA SELATAN,SETIA BUDI,PASAR MANGGIS,26752,4945,21807,18567,40374,2021-11-26
3174041001,JAKARTA SELATAN,PASAR MINGGU,PASAR MINGGU,24821,4504,20317,17820,38137,2021-11-26
3171041003,JAKARTA PUSAT,SENEN,PASEBAN,23533,4711,18822,15777,34599,2021-11-26
3173061005,JAKARTA BARAT,KALI DERES,PEGADUNGAN,75587,14193,61394,53564,114958,2021-11-26
3171061002,JAKARTA PUSAT,MENTENG,PEGANGSAAN,23455,4852,18603,14823,33426,2021-11-26
3172061002,JAKARTA UTARA,KELAPA GADING,PEGANGSAAN DUA,49976,8061,41915,38508,80423,2021-11-26
3172011004,JAKARTA UTARA,PENJARINGAN,PEJAGALAN,74578,14926,59652,52554,112206,2021-11-26
3174041006,JAKARTA SELATAN,PASAR MINGGU,PEJATEN BARAT,37346,6965,30381,26190,56571,2021-11-26
3174041005,JAKARTA SELATAN,PASAR MINGGU,PEJATEN TIMUR,57656,12023,45633,38011,83644,2021-11-26
3175051005,JAKARTA TIMUR,PASAR REBO,PEKAYON,43250,7567,35683,30455,66138,2021-11-26
3173041009,JAKARTA BARAT,TAMBORA,PEKOJAN,23587,4334,19253,16566,35819,2021-11-26
3174031003,JAKARTA SELATAN,MAMPANG PRAPATAN,PELA MAMPANG,43522,8233,35289,30403,65692,2021-11-26
3174081005,JAKARTA SELATAN,PANCORAN,PENGADEGAN,21478,3814,17664,15446,33110,2021-11-26
3175061003,JAKARTA TIMUR,CAKUNG,PENGGILINGAN,99255,21905,77350,63513,140863,2021-11-26
3172011001,JAKARTA UTARA,PENJARINGAN,PENJARINGAN,88308,21976,66332,52690,119022,2021-11-26
3174101001,JAKARTA SELATAN,PESANGGRAHAN,PESANGGRAHAN,27545,4579,22966,20165,43131,2021-11-26
3171071004,JAKARTA PUSAT,TANAH ABANG,PETAMBURAN,33271,8510,24761,19385,44146,2021-11-26
3174071008,JAKARTA SELATAN,KEBAYORAN BARU,PETOGOGAN,11499,2146,9353,8168,17521,2021-11-26
3171011004,JAKARTA PUSAT,GAMBIR,PETOJO SELATAN,14692,3205,11487,9924,21411,2021-11-26
3171011003,JAKARTA PUSAT,GAMBIR,PETOJO UTARA,17458,3664,13794,11613,25407,2021-11-26
3174101004,JAKARTA SELATAN,PESANGGRAHAN,PETUKANGAN SELATAN,37187,7425,29762,25729,55491,2021-11-26
3174101003,JAKARTA SELATAN,PESANGGRAHAN,PETUKANGAN UTARA,53716,11082,42634,36362,78996,2021-11-26
3175081002,JAKARTA TIMUR,MAKASAR,PINANG RANTI,27198,5704,21494,18172,39666,2021-11-26
3173031008,JAKARTA BARAT,TAMAN SARI,PINANGSIA,10729,1820,8909,7565,16474,2021-11-26
3175011001,JAKARTA TIMUR,MATRAMAN,PISANGAN BARU,31776,6275,25501,20986,46487,2021-11-26
3175021002,JAKARTA TIMUR,PULO GADUNG,PISANGAN TIMUR,41011,7315,33696,29122,62818,2021-11-26
3172011005,JAKARTA UTARA,PENJARINGAN,PLUIT,47783,9006,38777,34576,73353,2021-11-26
3175071002,JAKARTA TIMUR,DUREN SAWIT,PONDOK BAMBU,61550,12499,49051,42114,91165,2021-11-26
3175071004,JAKARTA TIMUR,DUREN SAWIT,PONDOK KELAPA,72015,13840,58175,50965,109140,2021-11-26
3175071007,JAKARTA TIMUR,DUREN SAWIT,PONDOK KOPI,35367,6417,28950,23908,52858,2021-11-26
3174061003,JAKARTA SELATAN,CILANDAK,PONDOK LABU,46464,7417,39047,34806,73853,2021-11-26
3174051002,JAKARTA SELATAN,KEBAYORAN LAMA,PONDOK PINANG,56169,10443,45726,40024,85750,2021-11-26
3175101003,JAKARTA TIMUR,CIPAYUNG,PONDOK RANGGON,25574,4637,20937,18101,39038,2021-11-26
3101011003,KAB.ADM.KEP.SERIBU,KEP. SERIBU UTARA,PULAU HARAPAN,2060,216,1844,1645,3489,2021-11-26
3101011002,KAB.ADM.KEP.SERIBU,KEP. SERIBU UTARA,PULAU KELAPA,5528,586,4942,4104,9046,2021-11-26
3101011001,KAB.ADM.KEP.SERIBU,KEP. SERIBU UTARA,PULAU PANGGANG,5450,427,5023,4517,9540,2021-11-26
3101021003,KAB.ADM.KEP.SERIBU,KEP. SERIBU SELATAN,PULAU PARI,2765,191,2574,2440,5014,2021-11-26
3101021002,KAB.ADM.KEP.SERIBU,KEP. SERIBU SELATAN,PULAU TIDUNG,4553,361,4192,3887,8079,2021-11-26
3101021001,KAB.ADM.KEP.SERIBU,KEP. SERIBU SELATAN,PULAU UNTUNG JAWA,1941,156,1785,1663,3448,2021-11-26
3174071007,JAKARTA SELATAN,KEBAYORAN BARU,PULO,5835,983,4852,4514,9366,2021-11-26
3175021001,JAKARTA TIMUR,PULO GADUNG,PULO GADUNG,34422,7280,27142,23193,50335,2021-11-26
3175061005,JAKARTA TIMUR,CAKUNG,PULO GEBANG,97301,18052,79249,66088,145337,2021-11-26
3174041004,JAKARTA SELATAN,PASAR MINGGU,RAGUNAN,39616,6807,32809,28599,61408,2021-11-26
3175091005,JAKARTA TIMUR,CIRACAS,RAMBUTAN,36771,8304,28467,23801,52268,2021-11-26
3172031006,JAKARTA UTARA,KOJA,RAWA BADAK SELATAN,42179,9620,32559,26494,59053,2021-11-26
3172031004,JAKARTA UTARA,KOJA,RAWA BADAK UTARA,34408,7436,26972,22411,49383,2021-11-26
3174071005,JAKARTA SELATAN,KEBAYORAN BARU,RAWA BARAT,5625,977,4648,4199,8847,2021-11-26
3173011003,JAKARTA BARAT,CENGKARENG,RAWA BUAYA,63799,12116,51683,43851,95534,2021-11-26
3175031004,JAKARTA TIMUR,JATINEGARA,RAWA BUNGA,21434,4990,16444,13736,30180,2021-11-26
3174081003,JAKARTA SELATAN,PANCORAN,RAWA JATI,20509,3787,16722,14655,31377,2021-11-26
3175061002,JAKARTA TIMUR,CAKUNG,RAWA TERATE,24637,4304,20333,17011,37344,2021-11-26
3175021005,JAKARTA TIMUR,PULO GADUNG,RAWAMANGUN,37612,7171,30441,26501,56942,2021-11-26
3171051003,JAKARTA PUSAT,CEMPAKA PUTIH,RAWASARI,21967,4299,17668,15488,33156,2021-11-26
3173041010,JAKARTA BARAT,TAMBORA,ROA MALAKA,3484,604,2880,2623,5503,2021-11-26
3172041006,JAKARTA UTARA,CILINCING,ROROTAN,41668,8067,33601,27853,61454,2021-11-26
3174071004,JAKARTA SELATAN,KEBAYORAN BARU,SELONG,2842,537,2305,2159,4464,2021-11-26
3173061002,JAKARTA BARAT,KALI DERES,SEMANAN,71354,14348,57006,47040,104046,2021-11-26
3172041007,JAKARTA UTARA,CILINCING,SEMPER BARAT,68587,12890,55697,47419,103116,2021-11-26
3172041005,JAKARTA UTARA,CILINCING,SEMPER TIMUR,36267,7479,28788,23966,52754,2021-11-26
3174071006,JAKARTA SELATAN,KEBAYORAN BARU,SENAYAN,2771,638,2133,1888,4021,2021-11-26
3171041001,JAKARTA PUSAT,SENEN,SENEN,6804,1389,5415,4596,10011,2021-11-26
3171031004,JAKARTA PUSAT,KEMAYORAN,SERDANG,29668,5542,24126,20634,44760,2021-11-26
3174021001,JAKARTA SELATAN,SETIA BUDI,SETIA BUDI,3023,590,2433,2132,4565,2021-11-26
3175101005,JAKARTA TIMUR,CIPAYUNG,SETU,20572,3952,16620,13977,30597,2021-11-26
3173071002,JAKARTA BARAT,PALMERAH,SLIPI,16591,2873,13718,11902,25620,2021-11-26
3173081004,JAKARTA BARAT,KEMBANGAN,SRENGSENG,45523,9845,35678,30811,66489,2021-11-26
3174091002,JAKARTA SELATAN,JAGAKARSA,SRENGSENG SAWAH,58196,8562,49634,43747,93381,2021-11-26
3173051003,JAKARTA BARAT,KEBON JERUK,SUKABUMI SELATAN,37033,7555,29478,23492,52970,2021-11-26
3173051002,JAKARTA BARAT,KEBON JERUK,SUKABUMI UTARA,38290,8648,29642,23983,53625,2021-11-26
3172041002,JAKARTA UTARA,CILINCING,SUKAPURA,53949,11756,42193,35582,77775,2021-11-26
3171031007,JAKARTA PUSAT,KEMAYORAN,SUMUR BATU,22717,4166,18551,16159,34710,2021-11-26
3172021004,JAKARTA UTARA,TANJUNG PRIOK,SUNGAI BAMBU,29876,5760,24116,20493,44609,2021-11-26
3172021006,JAKARTA UTARA,TANJUNG PRIOK,SUNTER AGUNG,71805,12022,59783,53454,113237,2021-11-26
3172021002,JAKARTA UTARA,TANJUNG PRIOK,SUNTER JAYA,63031,10708,52323,46414,98737,2021-11-26
3175091004,JAKARTA TIMUR,CIRACAS,SUSUKAN,38257,6961,31296,26770,58066,2021-11-26
3173031001,JAKARTA BARAT,TAMAN SARI,TAMAN SARI,14348,2538,11810,10328,22138,2021-11-26
3173041001,JAKARTA BARAT,TAMBORA,TAMBORA,10204,2124,8080,6651,14731,2021-11-26
3173041004,JAKARTA BARAT,TAMBORA,TANAH SEREAL,26387,4320,22067,18869,40936,2021-11-26
3171081004,JAKARTA PUSAT,JOHAR BARU,TANAH TINGGI,37693,6990,30703,25382,56085,2021-11-26
3173031004,JAKARTA BARAT,TAMAN SARI,TANGKI,13324,2153,11171,9703,20874,2021-11-26
3174091005,JAKARTA SELATAN,JAGAKARSA,TANJUNG BARAT,39770,6515,33255,28386,61641,2021-11-26
3173021005,JAKARTA BARAT,GROGOL PETAMBURAN,TANJUNG DUREN SELATAN,25337,4672,20665,18660,39325,2021-11-26
3173021002,JAKARTA BARAT,GROGOL PETAMBURAN,TANJUNG DUREN UTARA,17010,2776,14234,13042,27276,2021-11-26
3172021001,JAKARTA UTARA,TANJUNG PRIOK,TANJUNG PRIOK,34588,6904,27684,23164,50848,2021-11-26
3174011002,JAKARTA SELATAN,TEBET,TEBET BARAT,21194,3282,17912,16090,34002,2021-11-26
3174011001,JAKARTA SELATAN,TEBET,TEBET TIMUR,18199,2814,15385,14176,29561,2021-11-26
3173061003,JAKARTA BARAT,KALI DERES,TEGAL ALUR,83647,16694,66953,56632,123585,2021-11-26
3174031004,JAKARTA SELATAN,MAMPANG PRAPATAN,TEGAL PARANG,32401,6881,25520,20578,46098,2021-11-26
3173021003,JAKARTA BARAT,GROGOL PETAMBURAN,TOMANG,29605,5279,24326,21455,45781,2021-11-26
3172031005,JAKARTA UTARA,KOJA,TUGU SELATAN,39122,8448,30674,25574,56248,2021-11-26
3172031002,JAKARTA UTARA,KOJA,TUGU UTARA,67670,15458,52212,42513,94725,2021-11-26
3175061006,JAKARTA TIMUR,CAKUNG,UJUNG MENTENG,29934,4965,24969,21717,46686,2021-11-26
3174101005,JAKARTA SELATAN,PESANGGRAHAN,ULUJAMI,40544,8727,31817,26903,58720,2021-11-26
3175011006,JAKARTA TIMUR,MATRAMAN,UTAN KAYU SELATAN,33511,5790,27721,23564,51285,2021-11-26
3175011002,JAKARTA TIMUR,MATRAMAN,UTAN KAYU UTARA,28169,5503,22666,18951,41617,2021-11-26
3171031008,JAKARTA PUSAT,KEMAYORAN,UTAN PANJANG,29208,5558,23650,19607,43257,2021-11-26
3172021007,JAKARTA UTARA,TANJUNG PRIOK,WARAKAS,44401,7886,36515,30227,66742,2021-11-26
3173021007,JAKARTA BARAT,GROGOL PETAMBURAN,WIJAYA KUSUMA,38934,7820,31114,26870,57984,2021-11-26
3172051003,JAKARTA UTARA,PADEMANGAN,ANCOL,23947,5544,18403,15399,33802,2021-11-27
3173041007,JAKARTA BARAT,TAMBORA,ANGKE,29381,6020,23361,19313,42674,2021-11-27
3175041005,JAKARTA TIMUR,KRAMAT JATI,BALE KAMBANG,29074,6847,22227,17976,40203,2021-11-27
3175031003,JAKARTA TIMUR,JATINEGARA,BALI MESTER,9752,1934,7818,6726,14544,2021-11-27
3175101006,JAKARTA TIMUR,CIPAYUNG,BAMBU APUS,26285,4631,21654,18613,40267,2021-11-27
3174031002,JAKARTA SELATAN,MAMPANG PRAPATAN,BANGKA,21566,4356,17210,14600,31810,2021-11-27
3175051002,JAKARTA TIMUR,PASAR REBO,BARU,23886,3788,20098,17690,37788,2021-11-27
3175041004,JAKARTA TIMUR,KRAMAT JATI,BATU AMPAR,47898,11060,36838,30474,67312,2021-11-27
3171071002,JAKARTA PUSAT,TANAH ABANG,BENDUNGAN HILIR,21494,4205,17289,15049,32338,2021-11-27
3175031002,JAKARTA TIMUR,JATINEGARA,BIDARA CINA,36689,8480,28209,23426,51635,2021-11-27
3174101002,JAKARTA SELATAN,PESANGGRAHAN,BINTARO,53098,10313,42785,37960,80745,2021-11-27
3174011005,JAKARTA SELATAN,TEBET,BUKIT DURI,34183,6596,27587,23551,51138,2021-11-27
3171041006,JAKARTA PUSAT,SENEN,BUNGUR,18144,3631,14513,12259,26772,2021-11-27
3175061007,JAKARTA TIMUR,CAKUNG,CAKUNG BARAT,57724,11375,46349,38877,85226,2021-11-27
3175061004,JAKARTA TIMUR,CAKUNG,CAKUNG TIMUR,58287,11014,47273,40106,87379,2021-11-27
3175041007,JAKARTA TIMUR,KRAMAT JATI,CAWANG,32762,6685,26077,21544,47621,2021-11-27
3175101008,JAKARTA TIMUR,CIPAYUNG,CEGER,18932,3532,15400,13173,28573,2021-11-27
3171031006,JAKARTA PUSAT,KEMAYORAN,CEMPAKA BARU,32581,5908,26673,22196,48869,2021-11-27
3171051002,JAKARTA PUSAT,CEMPAKA PUTIH,CEMPAKA PUTIH BARAT,35885,7275,28610,24978,53588,2021-11-27
3171051001,JAKARTA PUSAT,CEMPAKA PUTIH,CEMPAKA PUTIH TIMUR,24292,4843,19449,17412,36861,2021-11-27
3173011001,JAKARTA BARAT,CENGKARENG,CENGKARENG BARAT,66284,12690,53594,47093,100687,2021-11-27
3173011006,JAKARTA BARAT,CENGKARENG,CENGKARENG TIMUR,81027,15434,65593,55903,121496,2021-11-27
3175091002,JAKARTA TIMUR,CIRACAS,CIBUBUR,66364,11004,55360,48049,103409,2021-11-27
3171011002,JAKARTA PUSAT,GAMBIR,CIDENG,15390,2931,12459,11064,23523,2021-11-27
3174091003,JAKARTA SELATAN,JAGAKARSA,CIGANJUR,38497,6223,32274,27577,59851,2021-11-27
3175051003,JAKARTA TIMUR,PASAR REBO,CIJANTUNG,41419,7371,34048,29113,63161,2021-11-27
3171061003,JAKARTA PUSAT,MENTENG,CIKINI,8274,1449,6825,5571,12396,2021-11-27
3174081006,JAKARTA SELATAN,PANCORAN,CIKOKO,10547,1758,8789,7745,16534,2021-11-27
3174061001,JAKARTA SELATAN,CILANDAK,CILANDAK BARAT,51752,8791,42961,38374,81335,2021-11-27
3174041003,JAKARTA SELATAN,PASAR MINGGU,CILANDAK TIMUR,25145,4410,20735,18046,38781,2021-11-27
3175101002,JAKARTA TIMUR,CIPAYUNG,CILANGKAP,27635,4704,22931,19954,42885,2021-11-27
3175041006,JAKARTA TIMUR,KRAMAT JATI,CILILITAN,40181,8131,32050,26620,58670,2021-11-27
3172041001,JAKARTA UTARA,CILINCING,CILINCING,43609,9995,33614,26909,60523,2021-11-27
3175101001,JAKARTA TIMUR,CIPAYUNG,CIPAYUNG,26104,4385,21719,19028,40747,2021-11-27
3174091006,JAKARTA SELATAN,JAGAKARSA,CIPEDAK,38303,6109,32194,27942,60136,2021-11-27
3174061005,JAKARTA SELATAN,CILANDAK,CIPETE SELATAN,26704,4910,21794,19565,41359,2021-11-27
3174071010,JAKARTA SELATAN,KEBAYORAN BARU,CIPETE UTARA,34102,6245,27857,23960,51817,2021-11-27
3175021003,JAKARTA TIMUR,PULO GADUNG,CIPINANG,39306,6862,32444,27706,60150,2021-11-27
3175031007,JAKARTA TIMUR,JATINEGARA,CIPINANG BESAR SELATAN,35212,7983,27229,22087,49316,2021-11-27
3175031008,JAKARTA TIMUR,JATINEGARA,CIPINANG BESAR UTARA,45319,10249,35070,28151,63221,2021-11-27
3175031005,JAKARTA TIMUR,JATINEGARA,CIPINANG CEMPEDAK,32824,6917,25907,22566,48473,2021-11-27
3175081005,JAKARTA TIMUR,MAKASAR,CIPINANG MELAYU,42308,7921,34387,29842,64229,2021-11-27
3175031006,JAKARTA TIMUR,JATINEGARA,CIPINANG MUARA,55243,11295,43948,36844,80792,2021-11-27
3174051003,JAKARTA SELATAN,KEBAYORAN LAMA,CIPULIR,39937,8134,31803,26797,58600,2021-11-27
3175091001,JAKARTA TIMUR,CIRACAS,CIRACAS,64594,11464,53130,45172,98302,2021-11-27
3175041003,JAKARTA TIMUR,KRAMAT JATI,DUKUH,24609,4370,20239,17121,37360,2021-11-27
3175071001,JAKARTA TIMUR,DUREN SAWIT,DUREN SAWIT,61160,12459,48701,41626,90327,2021-11-27
3174081004,JAKARTA SELATAN,PANCORAN,DUREN TIGA,28319,5401,22918,19573,42491,2021-11-27
3173051005,JAKARTA BARAT,KEBON JERUK,DURI KEPA,60138,11470,48668,42775,91443,2021-11-27
3173011002,JAKARTA BARAT,CENGKARENG,DURI KOSAMBI,77923,15957,61966,51316,113282,2021-11-27
3171011006,JAKARTA PUSAT,GAMBIR,DURI PULO,19610,4025,15585,12791,28376,2021-11-27
3173041011,JAKARTA BARAT,TAMBORA,DURI SELATAN,14259,2444,11815,10182,21997,2021-11-27
3173041003,JAKARTA BARAT,TAMBORA,DURI UTARA,19844,3446,16398,13773,30171,2021-11-27
3171081003,JAKARTA PUSAT,JOHAR BARU,GALUR,18243,3445,14798,12182,26980,2021-11-27
3171011001,JAKARTA PUSAT,GAMBIR,GAMBIR,2191,449,1742,1537,3279,2021-11-27
3174061004,JAKARTA SELATAN,CILANDAK,GANDARIA SELATAN,22119,4070,18049,15796,33845,2021-11-27
3174071009,JAKARTA SELATAN,KEBAYORAN BARU,GANDARIA UTARA,39922,7609,32313,28036,60349,2021-11-27
3175051001,JAKARTA TIMUR,PASAR REBO,GEDONG,35755,6922,28833,24868,53701,2021-11-27
3171071001,JAKARTA PUSAT,TANAH ABANG,GELORA,3127,593,2534,2245,4779,2021-11-27
3173031007,JAKARTA BARAT,TAMAN SARI,GLODOK,7837,1145,6692,6148,12840,2021-11-27
3171061004,JAKARTA PUSAT,MENTENG,GONDANGDIA,4100,896,3204,2948,6152,2021-11-27
3173021001,JAKARTA BARAT,GROGOL PETAMBURAN,GROGOL,16876,3227,13649,11796,25445,2021-11-27
3174051005,JAKARTA SELATAN,KEBAYORAN LAMA,GROGOL SELATAN,44251,8533,35718,30313,66031,2021-11-27
3174051004,JAKARTA SELATAN,KEBAYORAN LAMA,GROGOL UTARA,42494,8371,34123,29047,63170,2021-11-27
3174021007,JAKARTA SELATAN,SETIA BUDI,GUNTUR,3985,721,3264,2938,6202,2021-11-27
3174071002,JAKARTA SELATAN,KEBAYORAN BARU,GUNUNG,9436,1703,7733,7001,14734,2021-11-27
3171031005,JAKARTA PUSAT,KEMAYORAN,GUNUNG SAHARI SELATAN,19199,3600,15599,13433,29032,2021-11-27
3171021004,JAKARTA PUSAT,SAWAH BESAR,GUNUNG SAHARI UTARA,16650,2846,13804,12505,26309,2021-11-27
3175081004,JAKARTA TIMUR,MAKASAR,HALIM PERDANA KUSUMAH,28363,3549,24814,22935,47749,2021-11-27
3171031003,JAKARTA PUSAT,KEMAYORAN,HARAPAN MULIA,22557,4234,18323,15341,33664,2021-11-27
3174091001,JAKARTA SELATAN,JAGAKARSA,JAGAKARSA,62389,9817,52572,45739,98311,2021-11-27
3175021007,JAKARTA TIMUR,PULO GADUNG,JATI,32757,5924,26833,23821,50654,2021-11-27
3174041002,JAKARTA SELATAN,PASAR MINGGU,JATI PADANG,37502,6906,30596,26404,57000,2021-11-27
3173071004,JAKARTA BARAT,PALMERAH,JATI PULO,28738,5496,23242,19076,42318,2021-11-27
3175061001,JAKARTA TIMUR,CAKUNG,JATINEGARA,84160,17095,67065,56583,123648,2021-11-27
3175021004,JAKARTA TIMUR,PULO GADUNG,JATINEGARA KAUM,24632,4222,20410,17064,37474,2021-11-27
3173021004,JAKARTA BARAT,GROGOL PETAMBURAN,JELAMBAR,30266,5333,24933,22384,47317,2021-11-27
3173021006,JAKARTA BARAT,GROGOL PETAMBURAN,JELAMBAR BARU,38246,6637,31609,28073,59682,2021-11-27
3173041006,JAKARTA BARAT,TAMBORA,JEMBATAN BESI,29314,6853,22461,18037,40498,2021-11-27
3173041008,JAKARTA BARAT,TAMBORA,JEMBATAN LIMA,21021,4597,16424,13323,29747,2021-11-27
3173081005,JAKARTA BARAT,KEMBANGAN,JOGLO,40839,7889,32950,28463,61413,2021-11-27
3171081001,JAKARTA PUSAT,JOHAR BARU,JOHAR BARU,37488,6726,30762,26471,57233,2021-11-27
3173041002,JAKARTA BARAT,TAMBORA,KALI ANYAR,23856,4541,19315,15760,35075,2021-11-27
3172041004,JAKARTA UTARA,CILINCING,KALIBARU,67684,17823,49861,36438,86299,2021-11-27
3174081002,JAKARTA SELATAN,PANCORAN,KALIBATA,41994,9166,32828,27472,60300,2021-11-27
3173061001,JAKARTA BARAT,KALI DERES,KALIDERES,72447,13967,58480,50497,108977,2021-11-27
3175051004,JAKARTA TIMUR,PASAR REBO,KALISARI,43212,7376,35836,30928,66764,2021-11-27
3173061004,JAKARTA BARAT,KALI DERES,KAMAL,53783,11998,41785,34268,76053,2021-11-27
3172011002,JAKARTA UTARA,PENJARINGAN,KAMAL MUARA,12930,2247,10683,9191,19874,2021-11-27
3171071007,JAKARTA PUSAT,TANAH ABANG,KAMPUNG BALI,11358,2369,8989,7159,16148,2021-11-27
3175031001,JAKARTA TIMUR,JATINEGARA,KAMPUNG MELAYU,25717,5667,20050,16117,36167,2021-11-27
3171081002,JAKARTA PUSAT,JOHAR BARU,KAMPUNG RAWA,21237,3404,17833,14549,32382,2021-11-27
3175041002,JAKARTA TIMUR,KRAMAT JATI,KAMPUNG TENGAH,43993,10483,33510,27524,61034,2021-11-27
3173011005,JAKARTA BARAT,CENGKARENG,KAPUK,134466,31079,103387,85969,189356,2021-11-27
3172011003,JAKARTA UTARA,PENJARINGAN,KAPUK MUARA,35781,6627,29154,26035,55189,2021-11-27
3171021002,JAKARTA PUSAT,SAWAH BESAR,KARANG ANYAR,25761,4723,21038,18035,39073,2021-11-27
3174021004,JAKARTA SELATAN,SETIA BUDI,KARET,9623,1800,7823,6687,14510,2021-11-27
3174021003,JAKARTA SELATAN,SETIA BUDI,KARET KUNINGAN,16055,3019,13036,11310,24346,2021-11-27
3174021002,JAKARTA SELATAN,SETIA BUDI,KARET SEMANGGI,2770,544,2226,2003,4229,2021-11-27
3171071003,JAKARTA PUSAT,TANAH ABANG,KARET TENGSIN,19271,3599,15672,13128,28800,2021-11-27
3171021003,JAKARTA PUSAT,SAWAH BESAR,KARTINI,22292,4058,18234,15958,34192,2021-11-27
3175011003,JAKARTA TIMUR,MATRAMAN,KAYU MANIS,25284,5082,20202,16598,36800,2021-11-27
3175021006,JAKARTA TIMUR,PULO GADUNG,KAYU PUTIH,40696,7439,33257,29608,62865,2021-11-27
3173031006,JAKARTA BARAT,TAMAN SARI,KEAGUNGAN,17387,3112,14275,11986,26261,2021-11-27
3174041007,JAKARTA SELATAN,PASAR MINGGU,KEBAGUSAN,44552,8470,36082,30671,66753,2021-11-27
3174051006,JAKARTA SELATAN,KEBAYORAN LAMA,KEBAYORAN LAMA SELATAN,41212,7331,33881,29567,63448,2021-11-27
3174051001,JAKARTA SELATAN,KEBAYORAN LAMA,KEBAYORAN LAMA UTARA,42422,8448,33974,29050,63024,2021-11-27
3174011004,JAKARTA SELATAN,TEBET,KEBON BARU,35165,6312,28853,24881,53734,2021-11-27
3172021005,JAKARTA UTARA,TANJUNG PRIOK,KEBON BAWANG,50952,9883,41069,35043,76112,2021-11-27
3173051001,JAKARTA BARAT,KEBON JERUK,KEBON JERUK,53887,10551,43336,36234,79570,2021-11-27
3171071006,JAKARTA PUSAT,TANAH ABANG,KEBON KACANG,21531,4972,16559,13499,30058,2021-11-27
3171011005,JAKARTA PUSAT,GAMBIR,KEBON KELAPA,10163,1976,8187,7081,15268,2021-11-27
3171031002,JAKARTA PUSAT,KEMAYORAN,KEBON KOSONG,30019,5775,24244,20453,44697,2021-11-27
3175011005,JAKARTA TIMUR,MATRAMAN,KEBON MANGGIS,16490,3081,13409,11341,24750,2021-11-27
3171071005,JAKARTA PUSAT,TANAH ABANG,KEBON MELATI,32206,8338,23868,18291,42159,2021-11-27
3175081003,JAKARTA TIMUR,MAKASAR,KEBON PALA,46614,8846,37768,32216,69984,2021-11-27
3171061005,JAKARTA PUSAT,MENTENG,KEBON SIRIH,12299,2550,9749,8032,17781,2021-11-27
3173011004,JAKARTA BARAT,CENGKARENG,KEDAUNG KALI ANGKE,32612,6061,26551,22854,49405,2021-11-27
3173051007,JAKARTA BARAT,KEBON JERUK,KEDOYA SELATAN,32165,5685,26480,22360,48840,2021-11-27
3173051006,JAKARTA BARAT,KEBON JERUK,KEDOYA UTARA,45740,8468,37272,32061,69333,2021-11-27
3173051004,JAKARTA BARAT,KEBON JERUK,KELAPA DUA,23565,4453,19112,16310,35422,2021-11-27
3175091003,JAKARTA TIMUR,CIRACAS,KELAPA DUA WETAN,46875,7726,39149,33963,73112,2021-11-27
3172061003,JAKARTA UTARA,KELAPA GADING,KELAPA GADING BARAT,35717,6056,29661,27155,56816,2021-11-27
3172061001,JAKARTA UTARA,KELAPA GADING,KELAPA GADING TIMUR,33592,4999,28593,26846,55439,2021-11-27
3173071005,JAKARTA BARAT,PALMERAH,KEMANGGISAN,32139,5854,26285,22834,49119,2021-11-27
3171031001,JAKARTA PUSAT,KEMAYORAN,KEMAYORAN,20708,3964,16744,14121,30865,2021-11-27
3173081006,JAKARTA BARAT,KEMBANGAN,KEMBANGAN SELATAN,27130,5471,21659,19001,40660,2021-11-27
3173081001,JAKARTA BARAT,KEMBANGAN,KEMBANGAN UTARA,54451,11517,42934,36441,79375,2021-11-27
3171041002,JAKARTA PUSAT,SENEN,KENARI,9579,1816,7763,6734,14497,2021-11-27
3173041005,JAKARTA BARAT,TAMBORA,KERENDANG,19973,3904,16069,13401,29470,2021-11-27
3175071003,JAKARTA TIMUR,DUREN SAWIT,KLENDER,69978,15849,54129,44358,98487,2021-11-27
3172031001,JAKARTA UTARA,KOJA,KOJA,28175,6176,21999,18230,40229,2021-11-27
3173071006,JAKARTA BARAT,PALMERAH,KOTA BAMBU SELATAN,21158,4021,17137,13881,31018,2021-11-27
3173071003,JAKARTA BARAT,PALMERAH,KOTA BAMBU UTARA,24995,4919,20076,16058,36134,2021-11-27
3171041004,JAKARTA PUSAT,SENEN,KRAMAT,28835,6501,22334,17358,39692,2021-11-27
3175041001,JAKARTA TIMUR,KRAMAT JATI,KRAMAT JATI,34144,6986,27158,22560,49718,2021-11-27
3174071003,JAKARTA SELATAN,KEBAYORAN BARU,KRAMAT PELA,14413,2706,11707,10299,22006,2021-11-27
3173031002,JAKARTA BARAT,TAMAN SARI,KRUKUT,19244,3504,15740,13115,28855,2021-11-27
3174031005,JAKARTA SELATAN,MAMPANG PRAPATAN,KUNINGAN BARAT,12785,2253,10532,9047,19579,2021-11-27
3174021008,JAKARTA SELATAN,SETIA BUDI,KUNINGAN TIMUR,6008,1155,4853,4252,9105,2021-11-27
3171041005,JAKARTA PUSAT,SENEN,KWITANG,15486,3313,12173,9997,22170,2021-11-27
3172031003,JAKARTA UTARA,KOJA,LAGOA,59065,13370,45695,37097,82792,2021-11-27
3174061002,JAKARTA SELATAN,CILANDAK,LEBAK BULUS,37626,6841,30785,27617,58402,2021-11-27
3174091004,JAKARTA SELATAN,JAGAKARSA,LENTENG AGUNG,53946,9275,44671,37564,82235,2021-11-27
3175101007,JAKARTA TIMUR,CIPAYUNG,LUBANG BUAYA,63547,11555,51992,44268,96260,2021-11-27
3175081001,JAKARTA TIMUR,MAKASAR,MAKASAR,34390,5912,28478,24774,53252,2021-11-27
3175071006,JAKARTA TIMUR,DUREN SAWIT,MALAKA JAYA,30927,5050,25877,22850,48727,2021-11-27
3175071005,JAKARTA TIMUR,DUREN SAWIT,MALAKA SARI,27530,4375,23155,20565,43720,2021-11-27
3174031001,JAKARTA SELATAN,MAMPANG PRAPATAN,MAMPANG PRAPATAN,18159,3565,14594,12372,26966,2021-11-27
3173031005,JAKARTA BARAT,TAMAN SARI,MANGGA BESAR,7707,1267,6440,5773,12213,2021-11-27
3171021005,JAKARTA PUSAT,SAWAH BESAR,MANGGA DUA SELATAN,27442,5433,22009,19015,41024,2021-11-27
3174011007,JAKARTA SELATAN,TEBET,MANGGARAI,28373,4776,23597,19821,43418,2021-11-27
3174011006,JAKARTA SELATAN,TEBET,MANGGARAI SELATAN,23075,3623,19452,16729,36181,2021-11-27
3173031003,JAKARTA BARAT,TAMAN SARI,MAPHAR,16461,2973,13488,11530,25018,2021-11-27
3172041003,JAKARTA UTARA,CILINCING,MARUNDA,28943,6299,22644,17500,40144,2021-11-27
3174071001,JAKARTA SELATAN,KEBAYORAN BARU,MELAWAI,2627,497,2130,1982,4112,2021-11-27
3171061001,JAKARTA PUSAT,MENTENG,MENTENG,25624,5386,20238,16548,36786,2021-11-27
3174021005,JAKARTA SELATAN,SETIA BUDI,MENTENG ATAS,27816,4796,23020,19772,42792,2021-11-27
3174011003,JAKARTA SELATAN,TEBET,MENTENG DALAM,36028,6721,29307,25422,54729,2021-11-27
3173081003,JAKARTA BARAT,KEMBANGAN,MERUYA SELATAN,32130,6340,25790,22327,48117,2021-11-27
3173081002,JAKARTA BARAT,KEMBANGAN,MERUYA UTARA,43752,8685,35067,31160,66227,2021-11-27
3175101004,JAKARTA TIMUR,CIPAYUNG,MUNJUL,23871,4217,19654,17003,36657,2021-11-27
3172051002,JAKARTA UTARA,PADEMANGAN,PADEMANGAN BARAT,74240,16787,57453,47464,104917,2021-11-27
3172051001,JAKARTA UTARA,PADEMANGAN,PADEMANGAN TIMUR,37736,6419,31317,28142,59459,2021-11-27
3175011004,JAKARTA TIMUR,MATRAMAN,PAL MERIAM,19769,3863,15906,13155,29061,2021-11-27
3173071001,JAKARTA BARAT,PALMERAH,PALMERAH,63011,12693,50318,42161,92479,2021-11-27
3174081001,JAKARTA SELATAN,PANCORAN,PANCORAN,19421,3718,15703,13395,29098,2021-11-27
3172021003,JAKARTA UTARA,TANJUNG PRIOK,PAPANGGO,39097,7391,31706,26652,58358,2021-11-27
3171021001,JAKARTA PUSAT,SAWAH BESAR,PASAR BARU,12035,2220,9815,8929,18744,2021-11-27
3174021006,JAKARTA SELATAN,SETIA BUDI,PASAR MANGGIS,26752,4930,21822,18582,40404,2021-11-27
3174041001,JAKARTA SELATAN,PASAR MINGGU,PASAR MINGGU,24821,4492,20329,17831,38160,2021-11-27
3171041003,JAKARTA PUSAT,SENEN,PASEBAN,23533,4699,18834,15781,34615,2021-11-27
3173061005,JAKARTA BARAT,KALI DERES,PEGADUNGAN,75587,14156,61431,53581,115012,2021-11-27
3171061002,JAKARTA PUSAT,MENTENG,PEGANGSAAN,23455,4846,18609,14837,33446,2021-11-27
3172061002,JAKARTA UTARA,KELAPA GADING,PEGANGSAAN DUA,49976,8051,41925,38524,80449,2021-11-27
3172011004,JAKARTA UTARA,PENJARINGAN,PEJAGALAN,74578,14896,59682,52589,112271,2021-11-27
3174041006,JAKARTA SELATAN,PASAR MINGGU,PEJATEN BARAT,37346,6947,30399,26208,56607,2021-11-27
3174041005,JAKARTA SELATAN,PASAR MINGGU,PEJATEN TIMUR,57656,11997,45659,38043,83702,2021-11-27
3175051005,JAKARTA TIMUR,PASAR REBO,PEKAYON,43250,7544,35706,30478,66184,2021-11-27
3173041009,JAKARTA BARAT,TAMBORA,PEKOJAN,23587,4325,19262,16574,35836,2021-11-27
3174031003,JAKARTA SELATAN,MAMPANG PRAPATAN,PELA MAMPANG,43522,8209,35313,30425,65738,2021-11-27
3174081005,JAKARTA SELATAN,PANCORAN,PENGADEGAN,21478,3801,17677,15454,33131,2021-11-27
3175061003,JAKARTA TIMUR,CAKUNG,PENGGILINGAN,99255,21782,77473,63582,141055,2021-11-27
3172011001,JAKARTA UTARA,PENJARINGAN,PENJARINGAN,88308,21926,66382,52728,119110,2021-11-27
3174101001,JAKARTA SELATAN,PESANGGRAHAN,PESANGGRAHAN,27545,4569,22976,20181,43157,2021-11-27
3171071004,JAKARTA PUSAT,TANAH ABANG,PETAMBURAN,33271,8487,24784,19418,44202,2021-11-27
3174071008,JAKARTA SELATAN,KEBAYORAN BARU,PETOGOGAN,11499,2141,9358,8176,17534,2021-11-27
3171011004,JAKARTA PUSAT,GAMBIR,PETOJO SELATAN,14692,3201,11491,9934,21425,2021-11-27
3171011003,JAKARTA PUSAT,GAMBIR,PETOJO UTARA,17458,3660,13798,11622,25420,2021-11-27
3174101004,JAKARTA SELATAN,PESANGGRAHAN,PETUKANGAN SELATAN,37187,7381,29806,25759,55565,2021-11-27
3174101003,JAKARTA SELATAN,PESANGGRAHAN,PETUKANGAN UTARA,53716,11051,42665,36394,79059,2021-11-27
3175081002,JAKARTA TIMUR,MAKASAR,PINANG RANTI,27198,5693,21505,18192,39697,2021-11-27
3173031008,JAKARTA BARAT,TAMAN SARI,PINANGSIA,10729,1816,8913,7570,16483,2021-11-27
3175011001,JAKARTA TIMUR,MATRAMAN,PISANGAN BARU,31776,6259,25517,21014,46531,2021-11-27
3175021002,JAKARTA TIMUR,PULO GADUNG,PISANGAN TIMUR,41011,7282,33729,29147,62876,2021-11-27
3172011005,JAKARTA UTARA,PENJARINGAN,PLUIT,47783,8995,38788,34593,73381,2021-11-27
3175071002,JAKARTA TIMUR,DUREN SAWIT,PONDOK BAMBU,61550,12474,49076,42154,91230,2021-11-27
3175071004,JAKARTA TIMUR,DUREN SAWIT,PONDOK KELAPA,72015,13794,58221,51060,109281,2021-11-27
3175071007,JAKARTA TIMUR,DUREN SAWIT,PONDOK KOPI,35367,6406,28961,23939,52900,2021-11-27
3174061003,JAKARTA SELATAN,CILANDAK,PONDOK LABU,46464,7396,39068,34840,73908,2021-11-27
3174051002,JAKARTA SELATAN,KEBAYORAN LAMA,PONDOK PINANG,56169,10426,45743,40041,85784,2021-11-27
3175101003,JAKARTA TIMUR,CIPAYUNG,PONDOK RANGGON,25574,4630,20944,18114,39058,2021-11-27
3101011003,KAB.ADM.KEP.SERIBU,KEP. SERIBU UTARA,PULAU HARAPAN,2060,216,1844,1646,3490,2021-11-27
3101011002,KAB.ADM.KEP.SERIBU,KEP. SERIBU UTARA,PULAU KELAPA,5528,583,4945,4106,9051,2021-11-27
3101011001,KAB.ADM.KEP.SERIBU,KEP. SERIBU UTARA,PULAU PANGGANG,5450,426,5024,4523,9547,2021-11-27
3101021003,KAB.ADM.KEP.SERIBU,KEP. SERIBU SELATAN,PULAU PARI,2765,191,2574,2440,5014,2021-11-27
3101021002,KAB.ADM.KEP.SERIBU,KEP. SERIBU SELATAN,PULAU TIDUNG,4553,360,4193,3890,8083,2021-11-27
3101021001,KAB.ADM.KEP.SERIBU,KEP. SERIBU SELATAN,PULAU UNTUNG JAWA,1941,156,1785,1664,3449,2021-11-27
3174071007,JAKARTA SELATAN,KEBAYORAN BARU,PULO,5835,983,4852,4515,9367,2021-11-27
3175021001,JAKARTA TIMUR,PULO GADUNG,PULO GADUNG,34422,7273,27149,23205,50354,2021-11-27
3175061005,JAKARTA TIMUR,CAKUNG,PULO GEBANG,97301,18003,79298,66161,145459,2021-11-27
3174041004,JAKARTA SELATAN,PASAR MINGGU,RAGUNAN,39616,6783,32833,28622,61455,2021-11-27
3175091005,JAKARTA TIMUR,CIRACAS,RAMBUTAN,36771,8290,28481,23822,52303,2021-11-27
3172031006,JAKARTA UTARA,KOJA,RAWA BADAK SELATAN,42179,9591,32588,26536,59124,2021-11-27
3172031004,JAKARTA UTARA,KOJA,RAWA BADAK UTARA,34408,7418,26990,22434,49424,2021-11-27
3174071005,JAKARTA SELATAN,KEBAYORAN BARU,RAWA BARAT,5625,974,4651,4200,8851,2021-11-27
3173011003,JAKARTA BARAT,CENGKARENG,RAWA BUAYA,63799,12071,51728,43877,95605,2021-11-27
3175031004,JAKARTA TIMUR,JATINEGARA,RAWA BUNGA,21434,4974,16460,13749,30209,2021-11-27
3174081003,JAKARTA SELATAN,PANCORAN,RAWA JATI,20509,3778,16731,14666,31397,2021-11-27
3175061002,JAKARTA TIMUR,CAKUNG,RAWA TERATE,24637,4276,20361,17020,37381,2021-11-27
3175021005,JAKARTA TIMUR,PULO GADUNG,RAWAMANGUN,37612,7157,30455,26528,56983,2021-11-27
3171051003,JAKARTA PUSAT,CEMPAKA PUTIH,RAWASARI,21967,4290,17677,15496,33173,2021-11-27
3173041010,JAKARTA BARAT,TAMBORA,ROA MALAKA,3484,603,2881,2621,5502,2021-11-27
3172041006,JAKARTA UTARA,CILINCING,ROROTAN,41668,8051,33617,27875,61492,2021-11-27
3174071004,JAKARTA SELATAN,KEBAYORAN BARU,SELONG,2842,537,2305,2160,4465,2021-11-27
3173061002,JAKARTA BARAT,KALI DERES,SEMANAN,71354,14303,57051,47073,104124,2021-11-27
3172041007,JAKARTA UTARA,CILINCING,SEMPER BARAT,68587,12854,55733,47444,103177,2021-11-27
3172041005,JAKARTA UTARA,CILINCING,SEMPER TIMUR,36267,7456,28811,23972,52783,2021-11-27
3174071006,JAKARTA SELATAN,KEBAYORAN BARU,SENAYAN,2771,637,2134,1891,4025,2021-11-27
3171041001,JAKARTA PUSAT,SENEN,SENEN,6804,1386,5418,4597,10015,2021-11-27
3171031004,JAKARTA PUSAT,KEMAYORAN,SERDANG,29668,5516,24152,20647,44799,2021-11-27
3174021001,JAKARTA SELATAN,SETIA BUDI,SETIA BUDI,3023,586,2437,2137,4574,2021-11-27
3175101005,JAKARTA TIMUR,CIPAYUNG,SETU,20572,3939,16633,13983,30616,2021-11-27
3173071002,JAKARTA BARAT,PALMERAH,SLIPI,16591,2866,13725,11911,25636,2021-11-27
3173081004,JAKARTA BARAT,KEMBANGAN,SRENGSENG,45523,9807,35716,30826,66542,2021-11-27
3174091002,JAKARTA SELATAN,JAGAKARSA,SRENGSENG SAWAH,58196,8534,49662,43800,93462,2021-11-27
3173051003,JAKARTA BARAT,KEBON JERUK,SUKABUMI SELATAN,37033,7479,29554,23526,53080,2021-11-27
3173051002,JAKARTA BARAT,KEBON JERUK,SUKABUMI UTARA,38290,8626,29664,24010,53674,2021-11-27
3172041002,JAKARTA UTARA,CILINCING,SUKAPURA,53949,11720,42229,35600,77829,2021-11-27
3171031007,JAKARTA PUSAT,KEMAYORAN,SUMUR BATU,22717,4153,18564,16174,34738,2021-11-27
3172021004,JAKARTA UTARA,TANJUNG PRIOK,SUNGAI BAMBU,29876,5740,24136,20512,44648,2021-11-27
3172021006,JAKARTA UTARA,TANJUNG PRIOK,SUNTER AGUNG,71805,11998,59807,53484,113291,2021-11-27
3172021002,JAKARTA UTARA,TANJUNG PRIOK,SUNTER JAYA,63031,10690,52341,46433,98774,2021-11-27
3175091004,JAKARTA TIMUR,CIRACAS,SUSUKAN,38257,6944,31313,26782,58095,2021-11-27
3173031001,JAKARTA BARAT,TAMAN SARI,TAMAN SARI,14348,2536,11812,10339,22151,2021-11-27
3173041001,JAKARTA BARAT,TAMBORA,TAMBORA,10204,2118,8086,6658,14744,2021-11-27
3173041004,JAKARTA BARAT,TAMBORA,TANAH SEREAL,26387,4315,22072,18880,40952,2021-11-27
3171081004,JAKARTA PUSAT,JOHAR BARU,TANAH TINGGI,37693,6977,30716,25407,56123,2021-11-27
3173031004,JAKARTA BARAT,TAMAN SARI,TANGKI,13324,2147,11177,9708,20885,2021-11-27
3174091005,JAKARTA SELATAN,JAGAKARSA,TANJUNG BARAT,39770,6493,33277,28407,61684,2021-11-27
3173021005,JAKARTA BARAT,GROGOL PETAMBURAN,TANJUNG DUREN SELATAN,25337,4658,20679,18678,39357,2021-11-27
3173021002,JAKARTA BARAT,GROGOL PETAMBURAN,TANJUNG DUREN UTARA,17010,2764,14246,13046,27292,2021-11-27
3172021001,JAKARTA UTARA,TANJUNG PRIOK,TANJUNG PRIOK,34588,6877,27711,23185,50896,2021-11-27
3174011002,JAKARTA SELATAN,TEBET,TEBET BARAT,21194,3276,17918,16104,34022,2021-11-27
3174011001,JAKARTA SELATAN,TEBET,TEBET TIMUR,18199,2809,15390,14189,29579,2021-11-27
3173061003,JAKARTA BARAT,KALI DERES,TEGAL ALUR,83647,16650,66997,56665,123662,2021-11-27
3174031004,JAKARTA SELATAN,MAMPANG PRAPATAN,TEGAL PARANG,32401,6866,25535,20599,46134,2021-11-27
3173021003,JAKARTA BARAT,GROGOL PETAMBURAN,TOMANG,29605,5261,24344,21475,45819,2021-11-27
3172031005,JAKARTA UTARA,KOJA,TUGU SELATAN,39122,8420,30702,25582,56284,2021-11-27
3172031002,JAKARTA UTARA,KOJA,TUGU UTARA,67670,15425,52245,42552,94797,2021-11-27
3175061006,JAKARTA TIMUR,CAKUNG,UJUNG MENTENG,29934,4954,24980,21731,46711,2021-11-27
3174101005,JAKARTA SELATAN,PESANGGRAHAN,ULUJAMI,40544,8700,31844,26924,58768,2021-11-27
3175011006,JAKARTA TIMUR,MATRAMAN,UTAN KAYU SELATAN,33511,5780,27731,23580,51311,2021-11-27
3175011002,JAKARTA TIMUR,MATRAMAN,UTAN KAYU UTARA,28169,5488,22681,18957,41638,2021-11-27
3171031008,JAKARTA PUSAT,KEMAYORAN,UTAN PANJANG,29208,5542,23666,19622,43288,2021-11-27
3172021007,JAKARTA UTARA,TANJUNG PRIOK,WARAKAS,44401,7869,36532,30269,66801,2021-11-27
3173021007,JAKARTA BARAT,GROGOL PETAMBURAN,WIJAYA KUSUMA,38934,7801,31133,26889,58022,2021-11-27
3172051003,JAKARTA UTARA,PADEMANGAN,ANCOL,23947,5539,18408,15429,33837,2021-11-28
3173041007,JAKARTA BARAT,TAMBORA,ANGKE,29381,6004,23377,19361,42738,2021-11-28
3175041005,JAKARTA TIMUR,KRAMAT JATI,BALE KAMBANG,29074,6835,22239,18020,40259,2021-11-28
3175031003,JAKARTA TIMUR,JATINEGARA,BALI MESTER,9752,1934,7818,6745,14563,2021-11-28
3175101006,JAKARTA TIMUR,CIPAYUNG,BAMBU APUS,26285,4627,21658,18655,40313,2021-11-28
3174031002,JAKARTA SELATAN,MAMPANG PRAPATAN,BANGKA,21566,4353,17213,14642,31855,2021-11-28
3175051002,JAKARTA TIMUR,PASAR REBO,BARU,23886,3783,20103,17734,37837,2021-11-28
3175041004,JAKARTA TIMUR,KRAMAT JATI,BATU AMPAR,47898,11011,36887,30564,67451,2021-11-28
3171071002,JAKARTA PUSAT,TANAH ABANG,BENDUNGAN HILIR,21494,4196,17298,15094,32392,2021-11-28
3175031002,JAKARTA TIMUR,JATINEGARA,BIDARA CINA,36689,8474,28215,23522,51737,2021-11-28
3174101002,JAKARTA SELATAN,PESANGGRAHAN,BINTARO,53098,10302,42796,38062,80858,2021-11-28
3174011005,JAKARTA SELATAN,TEBET,BUKIT DURI,34183,6590,27593,23590,51183,2021-11-28
3171041006,JAKARTA PUSAT,SENEN,BUNGUR,18144,3630,14514,12281,26795,2021-11-28
3175061007,JAKARTA TIMUR,CAKUNG,CAKUNG BARAT,57724,11347,46377,38963,85340,2021-11-28
3175061004,JAKARTA TIMUR,CAKUNG,CAKUNG TIMUR,58287,10999,47288,40228,87516,2021-11-28
3175041007,JAKARTA TIMUR,KRAMAT JATI,CAWANG,32762,6681,26081,21658,47739,2021-11-28
3175101008,JAKARTA TIMUR,CIPAYUNG,CEGER,18932,3527,15405,13184,28589,2021-11-28
3171031006,JAKARTA PUSAT,KEMAYORAN,CEMPAKA BARU,32581,5901,26680,22315,48995,2021-11-28
3171051002,JAKARTA PUSAT,CEMPAKA PUTIH,CEMPAKA PUTIH BARAT,35885,7268,28617,25037,53654,2021-11-28
3171051001,JAKARTA PUSAT,CEMPAKA PUTIH,CEMPAKA PUTIH TIMUR,24292,4833,19459,17453,36912,2021-11-28
3173011001,JAKARTA BARAT,CENGKARENG,CENGKARENG BARAT,66284,12665,53619,47265,100884,2021-11-28
3173011006,JAKARTA BARAT,CENGKARENG,CENGKARENG TIMUR,81027,15407,65620,56088,121708,2021-11-28
3175091002,JAKARTA TIMUR,CIRACAS,CIBUBUR,66364,10994,55370,48128,103498,2021-11-28
3171011002,JAKARTA PUSAT,GAMBIR,CIDENG,15390,2923,12467,11084,23551,2021-11-28
3174091003,JAKARTA SELATAN,JAGAKARSA,CIGANJUR,38497,6219,32278,27663,59941,2021-11-28
3175051003,JAKARTA TIMUR,PASAR REBO,CIJANTUNG,41419,7367,34052,29202,63254,2021-11-28
3171061003,JAKARTA PUSAT,MENTENG,CIKINI,8274,1448,6826,5584,12410,2021-11-28
3174081006,JAKARTA SELATAN,PANCORAN,CIKOKO,10547,1757,8790,7759,16549,2021-11-28
3174061001,JAKARTA SELATAN,CILANDAK,CILANDAK BARAT,51752,8775,42977,38491,81468,2021-11-28
3174041003,JAKARTA SELATAN,PASAR MINGGU,CILANDAK TIMUR,25145,4393,20752,18185,38937,2021-11-28
3175101002,JAKARTA TIMUR,CIPAYUNG,CILANGKAP,27635,4698,22937,19998,42935,2021-11-28
3175041006,JAKARTA TIMUR,KRAMAT JATI,CILILITAN,40181,8122,32059,26721,58780,2021-11-28
3172041001,JAKARTA UTARA,CILINCING,CILINCING,43609,9984,33625,26971,60596,2021-11-28
3175101001,JAKARTA TIMUR,CIPAYUNG,CIPAYUNG,26104,4382,21722,19068,40790,2021-11-28
3174091006,JAKARTA SELATAN,JAGAKARSA,CIPEDAK,38303,6106,32197,28028,60225,2021-11-28
3174061005,JAKARTA SELATAN,CILANDAK,CIPETE SELATAN,26704,4900,21804,19611,41415,2021-11-28
3174071010,JAKARTA SELATAN,KEBAYORAN BARU,CIPETE UTARA,34102,6236,27866,24057,51923,2021-11-28
3175021003,JAKARTA TIMUR,PULO GADUNG,CIPINANG,39306,6854,32452,27825,60277,2021-11-28
3175031007,JAKARTA TIMUR,JATINEGARA,CIPINANG BESAR SELATAN,35212,7975,27237,22195,49432,2021-11-28
3175031008,JAKARTA TIMUR,JATINEGARA,CIPINANG BESAR UTARA,45319,10240,35079,28280,63359,2021-11-28
3175031005,JAKARTA TIMUR,JATINEGARA,CIPINANG CEMPEDAK,32824,6910,25914,22616,48530,2021-11-28
3175081005,JAKARTA TIMUR,MAKASAR,CIPINANG MELAYU,42308,7910,34398,29902,64300,2021-11-28
3175031006,JAKARTA TIMUR,JATINEGARA,CIPINANG MUARA,55243,11280,43963,36991,80954,2021-11-28
3174051003,JAKARTA SELATAN,KEBAYORAN LAMA,CIPULIR,39937,8126,31811,26895,58706,2021-11-28
3175091001,JAKARTA TIMUR,CIRACAS,CIRACAS,64594,11442,53152,45292,98444,2021-11-28
3175041003,JAKARTA TIMUR,KRAMAT JATI,DUKUH,24609,4366,20243,17186,37429,2021-11-28
3175071001,JAKARTA TIMUR,DUREN SAWIT,DUREN SAWIT,61160,12447,48713,41775,90488,2021-11-28
3174081004,JAKARTA SELATAN,PANCORAN,DUREN TIGA,28319,5395,22924,19629,42553,2021-11-28
3173051005,JAKARTA BARAT,KEBON JERUK,DURI KEPA,60138,11453,48685,42862,91547,2021-11-28
3173011002,JAKARTA BARAT,CENGKARENG,DURI KOSAMBI,77923,15936,61987,51457,113444,2021-11-28
3171011006,JAKARTA PUSAT,GAMBIR,DURI PULO,19610,4018,15592,12833,28425,2021-11-28
3173041011,JAKARTA BARAT,TAMBORA,DURI SELATAN,14259,2438,11821,10209,22030,2021-11-28
3173041003,JAKARTA BARAT,TAMBORA,DURI UTARA,19844,3438,16406,13800,30206,2021-11-28
3171081003,JAKARTA PUSAT,JOHAR BARU,GALUR,18243,3444,14799,12214,27013,2021-11-28
3171011001,JAKARTA PUSAT,GAMBIR,GAMBIR,2191,446,1745,1539,3284,2021-11-28
3174061004,JAKARTA SELATAN,CILANDAK,GANDARIA SELATAN,22119,4062,18057,15841,33898,2021-11-28
3174071009,JAKARTA SELATAN,KEBAYORAN BARU,GANDARIA UTARA,39922,7597,32325,28127,60452,2021-11-28
3175051001,JAKARTA TIMUR,PASAR REBO,GEDONG,35755,6917,28838,24927,53765,2021-11-28
3171071001,JAKARTA PUSAT,TANAH ABANG,GELORA,3127,593,2534,2251,4785,2021-11-28
3173031007,JAKARTA BARAT,TAMAN SARI,GLODOK,7837,1145,6692,6162,12854,2021-11-28
3171061004,JAKARTA PUSAT,MENTENG,GONDANGDIA,4100,896,3204,2954,6158,2021-11-28
3173021001,JAKARTA BARAT,GROGOL PETAMBURAN,GROGOL,16876,3222,13654,11828,25482,2021-11-28
3174051005,JAKARTA SELATAN,KEBAYORAN LAMA,GROGOL SELATAN,44251,8521,35730,30428,66158,2021-11-28
3174051004,JAKARTA SELATAN,KEBAYORAN LAMA,GROGOL UTARA,42494,8359,34135,29127,63262,2021-11-28
3174021007,JAKARTA SELATAN,SETIA BUDI,GUNTUR,3985,721,3264,2943,6207,2021-11-28
3174071002,JAKARTA SELATAN,KEBAYORAN BARU,GUNUNG,9436,1702,7734,7013,14747,2021-11-28
3171031005,JAKARTA PUSAT,KEMAYORAN,GUNUNG SAHARI SELATAN,19199,3597,15602,13468,29070,2021-11-28
3171021004,JAKARTA PUSAT,SAWAH BESAR,GUNUNG SAHARI UTARA,16650,2844,13806,12524,26330,2021-11-28
3175081004,JAKARTA TIMUR,MAKASAR,HALIM PERDANA KUSUMAH,28363,3547,24816,22980,47796,2021-11-28
3171031003,JAKARTA PUSAT,KEMAYORAN,HARAPAN MULIA,22557,4229,18328,15383,33711,2021-11-28
3174091001,JAKARTA SELATAN,JAGAKARSA,JAGAKARSA,62389,9807,52582,45915,98497,2021-11-28
3175021007,JAKARTA TIMUR,PULO GADUNG,JATI,32757,5918,26839,23866,50705,2021-11-28
3174041002,JAKARTA SELATAN,PASAR MINGGU,JATI PADANG,37502,6904,30598,26471,57069,2021-11-28
3173071004,JAKARTA BARAT,PALMERAH,JATI PULO,28738,5477,23261,19128,42389,2021-11-28
3175061001,JAKARTA TIMUR,CAKUNG,JATINEGARA,84160,17064,67096,56789,123885,2021-11-28
3175021004,JAKARTA TIMUR,PULO GADUNG,JATINEGARA KAUM,24632,4216,20416,17108,37524,2021-11-28
3173021004,JAKARTA BARAT,GROGOL PETAMBURAN,JELAMBAR,30266,5317,24949,22444,47393,2021-11-28
3173021006,JAKARTA BARAT,GROGOL PETAMBURAN,JELAMBAR BARU,38246,6634,31612,28161,59773,2021-11-28
3173041006,JAKARTA BARAT,TAMBORA,JEMBATAN BESI,29314,6840,22474,18095,40569,2021-11-28
3173041008,JAKARTA BARAT,TAMBORA,JEMBATAN LIMA,21021,4582,16439,13373,29812,2021-11-28
3173081005,JAKARTA BARAT,KEMBANGAN,JOGLO,40839,7872,32967,28549,61516,2021-11-28
3171081001,JAKARTA PUSAT,JOHAR BARU,JOHAR BARU,37488,6716,30772,26536,57308,2021-11-28
3173041002,JAKARTA BARAT,TAMBORA,KALI ANYAR,23856,4532,19324,15796,35120,2021-11-28
3172041004,JAKARTA UTARA,CILINCING,KALIBARU,67684,17780,49904,36566,86470,2021-11-28
3174081002,JAKARTA SELATAN,PANCORAN,KALIBATA,41994,9157,32837,27562,60399,2021-11-28
3173061001,JAKARTA BARAT,KALI DERES,KALIDERES,72447,13929,58518,50622,109140,2021-11-28
3175051004,JAKARTA TIMUR,PASAR REBO,KALISARI,43212,7367,35845,31004,66849,2021-11-28
3173061004,JAKARTA BARAT,KALI DERES,KAMAL,53783,11982,41801,34386,76187,2021-11-28
3172011002,JAKARTA UTARA,PENJARINGAN,KAMAL MUARA,12930,2245,10685,9200,19885,2021-11-28
3171071007,JAKARTA PUSAT,TANAH ABANG,KAMPUNG BALI,11358,2363,8995,7179,16174,2021-11-28
3175031001,JAKARTA TIMUR,JATINEGARA,KAMPUNG MELAYU,25717,5665,20052,16167,36219,2021-11-28
3171081002,JAKARTA PUSAT,JOHAR BARU,KAMPUNG RAWA,21237,3399,17838,14567,32405,2021-11-28
3175041002,JAKARTA TIMUR,KRAMAT JATI,KAMPUNG TENGAH,43993,10475,33518,27596,61114,2021-11-28
3173011005,JAKARTA BARAT,CENGKARENG,KAPUK,134466,31038,103428,86173,189601,2021-11-28
3172011003,JAKARTA UTARA,PENJARINGAN,KAPUK MUARA,35781,6618,29163,26099,55262,2021-11-28
3171021002,JAKARTA PUSAT,SAWAH BESAR,KARANG ANYAR,25761,4714,21047,18074,39121,2021-11-28
3174021004,JAKARTA SELATAN,SETIA BUDI,KARET,9623,1797,7826,6716,14542,2021-11-28
3174021003,JAKARTA SELATAN,SETIA BUDI,KARET KUNINGAN,16055,3016,13039,11352,24391,2021-11-28
3174021002,JAKARTA SELATAN,SETIA BUDI,KARET SEMANGGI,2770,542,2228,2006,4234,2021-11-28
3171071003,JAKARTA PUSAT,TANAH ABANG,KARET TENGSIN,19271,3595,15676,13147,28823,2021-11-28
3171021003,JAKARTA PUSAT,SAWAH BESAR,KARTINI,22292,4048,18244,15991,34235,2021-11-28
3175011003,JAKARTA TIMUR,MATRAMAN,KAYU MANIS,25284,5071,20213,16664,36877,2021-11-28
3175021006,JAKARTA TIMUR,PULO GADUNG,KAYU PUTIH,40696,7423,33273,29681,62954,2021-11-28
3173031006,JAKARTA BARAT,TAMAN SARI,KEAGUNGAN,17387,3107,14280,12024,26304,2021-11-28
3174041007,JAKARTA SELATAN,PASAR MINGGU,KEBAGUSAN,44552,8464,36088,30774,66862,2021-11-28
3174051006,JAKARTA SELATAN,KEBAYORAN LAMA,KEBAYORAN LAMA SELATAN,41212,7320,33892,29640,63532,2021-11-28
3174051001,JAKARTA SELATAN,KEBAYORAN LAMA,KEBAYORAN LAMA UTARA,42422,8433,33989,29147,63136,2021-11-28
3174011004,JAKARTA SELATAN,TEBET,KEBON BARU,35165,6302,28863,24951,53814,2021-11-28
3172021005,JAKARTA UTARA,TANJUNG PRIOK,KEBON BAWANG,50952,9869,41083,35124,76207,2021-11-28
3173051001,JAKARTA BARAT,KEBON JERUK,KEBON JERUK,53887,10531,43356,36346,79702,2021-11-28
3171071006,JAKARTA PUSAT,TANAH ABANG,KEBON KACANG,21531,4965,16566,13560,30126,2021-11-28
3171011005,JAKARTA PUSAT,GAMBIR,KEBON KELAPA,10163,1972,8191,7098,15289,2021-11-28
3171031002,JAKARTA PUSAT,KEMAYORAN,KEBON KOSONG,30019,5771,24248,20558,44806,2021-11-28
3175011005,JAKARTA TIMUR,MATRAMAN,KEBON MANGGIS,16490,3074,13416,11368,24784,2021-11-28
3171071005,JAKARTA PUSAT,TANAH ABANG,KEBON MELATI,32206,8327,23879,18345,42224,2021-11-28
3175081003,JAKARTA TIMUR,MAKASAR,KEBON PALA,46614,8841,37773,32281,70054,2021-11-28
3171061005,JAKARTA PUSAT,MENTENG,KEBON SIRIH,12299,2545,9754,8077,17831,2021-11-28
3173011004,JAKARTA BARAT,CENGKARENG,KEDAUNG KALI ANGKE,32612,6048,26564,22907,49471,2021-11-28
3173051007,JAKARTA BARAT,KEBON JERUK,KEDOYA SELATAN,32165,5676,26489,22420,48909,2021-11-28
3173051006,JAKARTA BARAT,KEBON JERUK,KEDOYA UTARA,45740,8449,37291,32122,69413,2021-11-28
3173051004,JAKARTA BARAT,KEBON JERUK,KELAPA DUA,23565,4447,19118,16349,35467,2021-11-28
3175091003,JAKARTA TIMUR,CIRACAS,KELAPA DUA WETAN,46875,7715,39160,34032,73192,2021-11-28
3172061003,JAKARTA UTARA,KELAPA GADING,KELAPA GADING BARAT,35717,6048,29669,27179,56848,2021-11-28
3172061001,JAKARTA UTARA,KELAPA GADING,KELAPA GADING TIMUR,33592,4995,28597,26876,55473,2021-11-28
3173071005,JAKARTA BARAT,PALMERAH,KEMANGGISAN,32139,5844,26295,22905,49200,2021-11-28
3171031001,JAKARTA PUSAT,KEMAYORAN,KEMAYORAN,20708,3960,16748,14165,30913,2021-11-28
3173081006,JAKARTA BARAT,KEMBANGAN,KEMBANGAN SELATAN,27130,5464,21666,19039,40705,2021-11-28
3173081001,JAKARTA BARAT,KEMBANGAN,KEMBANGAN UTARA,54451,11320,43131,36647,79778,2021-11-28
3171041002,JAKARTA PUSAT,SENEN,KENARI,9579,1814,7765,6750,14515,2021-11-28
3173041005,JAKARTA BARAT,TAMBORA,KERENDANG,19973,3898,16075,13436,29511,2021-11-28
3175071003,JAKARTA TIMUR,DUREN SAWIT,KLENDER,69978,15832,54146,44500,98646,2021-11-28
3172031001,JAKARTA UTARA,KOJA,KOJA,28175,6169,22006,18284,40290,2021-11-28
3173071006,JAKARTA BARAT,PALMERAH,KOTA BAMBU SELATAN,21158,4011,17147,13920,31067,2021-11-28
3173071003,JAKARTA BARAT,PALMERAH,KOTA BAMBU UTARA,24995,4911,20084,16124,36208,2021-11-28
3171041004,JAKARTA PUSAT,SENEN,KRAMAT,28835,6495,22340,17420,39760,2021-11-28
3175041001,JAKARTA TIMUR,KRAMAT JATI,KRAMAT JATI,34144,6978,27166,22623,49789,2021-11-28
3174071003,JAKARTA SELATAN,KEBAYORAN BARU,KRAMAT PELA,14413,2703,11710,10323,22033,2021-11-28
3173031002,JAKARTA BARAT,TAMAN SARI,KRUKUT,19244,3496,15748,13135,28883,2021-11-28
3174031005,JAKARTA SELATAN,MAMPANG PRAPATAN,KUNINGAN BARAT,12785,2249,10536,9066,19602,2021-11-28
3174021008,JAKARTA SELATAN,SETIA BUDI,KUNINGAN TIMUR,6008,1153,4855,4276,9131,2021-11-28
3171041005,JAKARTA PUSAT,SENEN,KWITANG,15486,3312,12174,10022,22196,2021-11-28
3172031003,JAKARTA UTARA,KOJA,LAGOA,59065,13343,45722,37289,83011,2021-11-28
3174061002,JAKARTA SELATAN,CILANDAK,LEBAK BULUS,37626,6828,30798,27693,58491,2021-11-28
3174091004,JAKARTA SELATAN,JAGAKARSA,LENTENG AGUNG,53946,9267,44679,37667,82346,2021-11-28
3175101007,JAKARTA TIMUR,CIPAYUNG,LUBANG BUAYA,63547,11533,52014,44442,96456,2021-11-28
3175081001,JAKARTA TIMUR,MAKASAR,MAKASAR,34390,5906,28484,24844,53328,2021-11-28
3175071006,JAKARTA TIMUR,DUREN SAWIT,MALAKA JAYA,30927,5042,25885,22909,48794,2021-11-28
3175071005,JAKARTA TIMUR,DUREN SAWIT,MALAKA SARI,27530,4368,23162,20609,43771,2021-11-28
3174031001,JAKARTA SELATAN,MAMPANG PRAPATAN,MAMPANG PRAPATAN,18159,3563,14596,12394,26990,2021-11-28
3173031005,JAKARTA BARAT,TAMAN SARI,MANGGA BESAR,7707,1263,6444,5785,12229,2021-11-28
3171021005,JAKARTA PUSAT,SAWAH BESAR,MANGGA DUA SELATAN,27442,5425,22017,19045,41062,2021-11-28
3174011007,JAKARTA SELATAN,TEBET,MANGGARAI,28373,4766,23607,19853,43460,2021-11-28
3174011006,JAKARTA SELATAN,TEBET,MANGGARAI SELATAN,23075,3620,19455,16767,36222,2021-11-28
3173031003,JAKARTA BARAT,TAMAN SARI,MAPHAR,16461,2971,13490,11563,25053,2021-11-28
3172041003,JAKARTA UTARA,CILINCING,MARUNDA,28943,6294,22649,17532,40181,2021-11-28
3174071001,JAKARTA SELATAN,KEBAYORAN BARU,MELAWAI,2627,497,2130,1987,4117,2021-11-28
3171061001,JAKARTA PUSAT,MENTENG,MENTENG,25624,5382,20242,16595,36837,2021-11-28
3174021005,JAKARTA SELATAN,SETIA BUDI,MENTENG ATAS,27816,4790,23026,19840,42866,2021-11-28
3174011003,JAKARTA SELATAN,TEBET,MENTENG DALAM,36028,6716,29312,25476,54788,2021-11-28
3173081003,JAKARTA BARAT,KEMBANGAN,MERUYA SELATAN,32130,6329,25801,22394,48195,2021-11-28
3173081002,JAKARTA BARAT,KEMBANGAN,MERUYA UTARA,43752,8672,35080,31219,66299,2021-11-28
3175101004,JAKARTA TIMUR,CIPAYUNG,MUNJUL,23871,4213,19658,17035,36693,2021-11-28
3172051002,JAKARTA UTARA,PADEMANGAN,PADEMANGAN BARAT,74240,16762,57478,47597,105075,2021-11-28
3172051001,JAKARTA UTARA,PADEMANGAN,PADEMANGAN TIMUR,37736,6408,31328,28197,59525,2021-11-28
3175011004,JAKARTA TIMUR,MATRAMAN,PAL MERIAM,19769,3854,15915,13195,29110,2021-11-28
3173071001,JAKARTA BARAT,PALMERAH,PALMERAH,63011,12648,50363,42322,92685,2021-11-28
3174081001,JAKARTA SELATAN,PANCORAN,PANCORAN,19421,3717,15704,13415,29119,2021-11-28
3172021003,JAKARTA UTARA,TANJUNG PRIOK,PAPANGGO,39097,7379,31718,26742,58460,2021-11-28
3171021001,JAKARTA PUSAT,SAWAH BESAR,PASAR BARU,12035,2215,9820,8943,18763,2021-11-28
3174021006,JAKARTA SELATAN,SETIA BUDI,PASAR MANGGIS,26752,4925,21827,18643,40470,2021-11-28
3174041001,JAKARTA SELATAN,PASAR MINGGU,PASAR MINGGU,24821,4487,20334,17872,38206,2021-11-28
3171041003,JAKARTA PUSAT,SENEN,PASEBAN,23533,4698,18835,15834,34669,2021-11-28
3173061005,JAKARTA BARAT,KALI DERES,PEGADUNGAN,75587,14143,61444,53673,115117,2021-11-28
3171061002,JAKARTA PUSAT,MENTENG,PEGANGSAAN,23455,4840,18615,14897,33512,2021-11-28
3172061002,JAKARTA UTARA,KELAPA GADING,PEGANGSAAN DUA,49976,8037,41939,38578,80517,2021-11-28
3172011004,JAKARTA UTARA,PENJARINGAN,PEJAGALAN,74578,14881,59697,52717,112414,2021-11-28
3174041006,JAKARTA SELATAN,PASAR MINGGU,PEJATEN BARAT,37346,6946,30400,26279,56679,2021-11-28
3174041005,JAKARTA SELATAN,PASAR MINGGU,PEJATEN TIMUR,57656,11989,45667,38126,83793,2021-11-28
3175051005,JAKARTA TIMUR,PASAR REBO,PEKAYON,43250,7532,35718,30582,66300,2021-11-28
3173041009,JAKARTA BARAT,TAMBORA,PEKOJAN,23587,4320,19267,16625,35892,2021-11-28
3174031003,JAKARTA SELATAN,MAMPANG PRAPATAN,PELA MAMPANG,43522,8200,35322,30514,65836,2021-11-28
3174081005,JAKARTA SELATAN,PANCORAN,PENGADEGAN,21478,3798,17680,15493,33173,2021-11-28
3175061003,JAKARTA TIMUR,CAKUNG,PENGGILINGAN,99255,21742,77513,63800,141313,2021-11-28
3172011001,JAKARTA UTARA,PENJARINGAN,PENJARINGAN,88308,21894,66414,52927,119341,2021-11-28
3174101001,JAKARTA SELATAN,PESANGGRAHAN,PESANGGRAHAN,27545,4563,22982,20227,43209,2021-11-28
3171071004,JAKARTA PUSAT,TANAH ABANG,PETAMBURAN,33271,8467,24804,19501,44305,2021-11-28
3174071008,JAKARTA SELATAN,KEBAYORAN BARU,PETOGOGAN,11499,2140,9359,8205,17564,2021-11-28
3171011004,JAKARTA PUSAT,GAMBIR,PETOJO SELATAN,14692,3196,11496,9957,21453,2021-11-28
3171011003,JAKARTA PUSAT,GAMBIR,PETOJO UTARA,17458,3655,13803,11646,25449,2021-11-28
3174101004,JAKARTA SELATAN,PESANGGRAHAN,PETUKANGAN SELATAN,37187,7369,29818,25864,55682,2021-11-28
3174101003,JAKARTA SELATAN,PESANGGRAHAN,PETUKANGAN UTARA,53716,11038,42678,36493,79171,2021-11-28
3175081002,JAKARTA TIMUR,MAKASAR,PINANG RANTI,27198,5689,21509,18253,39762,2021-11-28
3173031008,JAKARTA BARAT,TAMAN SARI,PINANGSIA,10729,1814,8915,7579,16494,2021-11-28
3175011001,JAKARTA TIMUR,MATRAMAN,PISANGAN BARU,31776,6247,25529,21076,46605,2021-11-28
3175021002,JAKARTA TIMUR,PULO GADUNG,PISANGAN TIMUR,41011,7277,33734,29229,62963,2021-11-28
3172011005,JAKARTA UTARA,PENJARINGAN,PLUIT,47783,8989,38794,34642,73436,2021-11-28
3175071002,JAKARTA TIMUR,DUREN SAWIT,PONDOK BAMBU,61550,12450,49100,42268,91368,2021-11-28
3175071004,JAKARTA TIMUR,DUREN SAWIT,PONDOK KELAPA,72015,13779,58236,51252,109488,2021-11-28
3175071007,JAKARTA TIMUR,DUREN SAWIT,PONDOK KOPI,35367,6399,28968,23985,52953,2021-11-28
3174061003,JAKARTA SELATAN,CILANDAK,PONDOK LABU,46464,7385,39079,34998,74077,2021-11-28
3174051002,JAKARTA SELATAN,KEBAYORAN LAMA,PONDOK PINANG,56169,10415,45754,40117,85871,2021-11-28
3175101003,JAKARTA TIMUR,CIPAYUNG,PONDOK RANGGON,25574,4623,20951,18147,39098,2021-11-28
3101011003,KAB.ADM.KEP.SERIBU,KEP. SERIBU UTARA,PULAU HARAPAN,2060,216,1844,1647,3491,2021-11-28
3101011002,KAB.ADM.KEP.SERIBU,KEP. SERIBU UTARA,PULAU KELAPA,5528,583,4945,4110,9055,2021-11-28
3101011001,KAB.ADM.KEP.SERIBU,KEP. SERIBU UTARA,PULAU PANGGANG,5450,426,5024,4530,9554,2021-11-28
3101021003,KAB.ADM.KEP.SERIBU,KEP. SERIBU SELATAN,PULAU PARI,2765,191,2574,2440,5014,2021-11-28
3101021002,KAB.ADM.KEP.SERIBU,KEP. SERIBU SELATAN,PULAU TIDUNG,4553,360,4193,3893,8086,2021-11-28
3101021001,KAB.ADM.KEP.SERIBU,KEP. SERIBU SELATAN,PULAU UNTUNG JAWA,1941,156,1785,1666,3451,2021-11-28
3174071007,JAKARTA SELATAN,KEBAYORAN BARU,PULO,5835,983,4852,4519,9371,2021-11-28
3175021001,JAKARTA TIMUR,PULO GADUNG,PULO GADUNG,34422,7263,27159,23253,50412,2021-11-28
3175061005,JAKARTA TIMUR,CAKUNG,PULO GEBANG,97301,17961,79340,66483,145823,2021-11-28
3174041004,JAKARTA SELATAN,PASAR MINGGU,RAGUNAN,39616,6777,32839,28730,61569,2021-11-28
3175091005,JAKARTA TIMUR,CIRACAS,RAMBUTAN,36771,8283,28488,23890,52378,2021-11-28
3172031006,JAKARTA UTARA,KOJA,RAWA BADAK SELATAN,42179,9565,32614,26581,59195,2021-11-28
3172031004,JAKARTA UTARA,KOJA,RAWA BADAK UTARA,34408,7402,27006,22497,49503,2021-11-28
3174071005,JAKARTA SELATAN,KEBAYORAN BARU,RAWA BARAT,5625,972,4653,4208,8861,2021-11-28
3173011003,JAKARTA BARAT,CENGKARENG,RAWA BUAYA,63799,12050,51749,44044,95793,2021-11-28
3175031004,JAKARTA TIMUR,JATINEGARA,RAWA BUNGA,21434,4971,16463,13817,30280,2021-11-28
3174081003,JAKARTA SELATAN,PANCORAN,RAWA JATI,20509,3768,16741,14698,31439,2021-11-28
3175061002,JAKARTA TIMUR,CAKUNG,RAWA TERATE,24637,4267,20370,17071,37441,2021-11-28
3175021005,JAKARTA TIMUR,PULO GADUNG,RAWAMANGUN,37612,7138,30474,26612,57086,2021-11-28
3171051003,JAKARTA PUSAT,CEMPAKA PUTIH,RAWASARI,21967,4283,17684,15530,33214,2021-11-28
3173041010,JAKARTA BARAT,TAMBORA,ROA MALAKA,3484,601,2883,2624,5507,2021-11-28
3172041006,JAKARTA UTARA,CILINCING,ROROTAN,41668,8033,33635,27938,61573,2021-11-28
3174071004,JAKARTA SELATAN,KEBAYORAN BARU,SELONG,2842,537,2305,2160,4465,2021-11-28
3173061002,JAKARTA BARAT,KALI DERES,SEMANAN,71354,14289,57065,47164,104229,2021-11-28
3172041007,JAKARTA UTARA,CILINCING,SEMPER BARAT,68587,12835,55752,47579,103331,2021-11-28
3172041005,JAKARTA UTARA,CILINCING,SEMPER TIMUR,36267,7448,28819,24031,52850,2021-11-28
3174071006,JAKARTA SELATAN,KEBAYORAN BARU,SENAYAN,2771,637,2134,1893,4027,2021-11-28
3171041001,JAKARTA PUSAT,SENEN,SENEN,6804,1384,5420,4602,10022,2021-11-28
3171031004,JAKARTA PUSAT,KEMAYORAN,SERDANG,29668,5506,24162,20708,44870,2021-11-28
3174021001,JAKARTA SELATAN,SETIA BUDI,SETIA BUDI,3023,586,2437,2141,4578,2021-11-28
3175101005,JAKARTA TIMUR,CIPAYUNG,SETU,20572,3934,16638,14015,30653,2021-11-28
3173071002,JAKARTA BARAT,PALMERAH,SLIPI,16591,2864,13727,11945,25672,2021-11-28
3173081004,JAKARTA BARAT,KEMBANGAN,SRENGSENG,45523,9780,35743,30953,66696,2021-11-28
3174091002,JAKARTA SELATAN,JAGAKARSA,SRENGSENG SAWAH,58196,8527,49669,43901,93570,2021-11-28
3173051003,JAKARTA BARAT,KEBON JERUK,SUKABUMI SELATAN,37033,7464,29569,23584,53153,2021-11-28
3173051002,JAKARTA BARAT,KEBON JERUK,SUKABUMI UTARA,38290,8611,29679,24072,53751,2021-11-28
3172041002,JAKARTA UTARA,CILINCING,SUKAPURA,53949,11696,42253,35707,77960,2021-11-28
3171031007,JAKARTA PUSAT,KEMAYORAN,SUMUR BATU,22717,4145,18572,16230,34802,2021-11-28
3172021004,JAKARTA UTARA,TANJUNG PRIOK,SUNGAI BAMBU,29876,5727,24149,20558,44707,2021-11-28
3172021006,JAKARTA UTARA,TANJUNG PRIOK,SUNTER AGUNG,71805,11987,59818,53587,113405,2021-11-28
3172021002,JAKARTA UTARA,TANJUNG PRIOK,SUNTER JAYA,63031,10665,52366,46541,98907,2021-11-28
3175091004,JAKARTA TIMUR,CIRACAS,SUSUKAN,38257,6937,31320,26826,58146,2021-11-28
3173031001,JAKARTA BARAT,TAMAN SARI,TAMAN SARI,14348,2535,11813,10361,22174,2021-11-28
3173041001,JAKARTA BARAT,TAMBORA,TAMBORA,10204,2113,8091,6682,14773,2021-11-28
3173041004,JAKARTA BARAT,TAMBORA,TANAH SEREAL,26387,4302,22085,18913,40998,2021-11-28
3171081004,JAKARTA PUSAT,JOHAR BARU,TANAH TINGGI,37693,6964,30729,25466,56195,2021-11-28
3173031004,JAKARTA BARAT,TAMAN SARI,TANGKI,13324,2143,11181,9725,20906,2021-11-28
3174091005,JAKARTA SELATAN,JAGAKARSA,TANJUNG BARAT,39770,6489,33281,28460,61741,2021-11-28
3173021005,JAKARTA BARAT,GROGOL PETAMBURAN,TANJUNG DUREN SELATAN,25337,4654,20683,18731,39414,2021-11-28
3173021002,JAKARTA BARAT,GROGOL PETAMBURAN,TANJUNG DUREN UTARA,17010,2763,14247,13068,27315,2021-11-28
3172021001,JAKARTA UTARA,TANJUNG PRIOK,TANJUNG PRIOK,34588,6864,27724,23236,50960,2021-11-28
3174011002,JAKARTA SELATAN,TEBET,TEBET BARAT,21194,3272,17922,16127,34049,2021-11-28
3174011001,JAKARTA SELATAN,TEBET,TEBET TIMUR,18199,2806,15393,14220,29613,2021-11-28
3173061003,JAKARTA BARAT,KALI DERES,TEGAL ALUR,83647,16602,67045,56815,123860,2021-11-28
3174031004,JAKARTA SELATAN,MAMPANG PRAPATAN,TEGAL PARANG,32401,6860,25541,20694,46235,2021-11-28
3173021003,JAKARTA BARAT,GROGOL PETAMBURAN,TOMANG,29605,5257,24348,21525,45873,2021-11-28
3172031005,JAKARTA UTARA,KOJA,TUGU SELATAN,39122,8406,30716,25636,56352,2021-11-28
3172031002,JAKARTA UTARA,KOJA,TUGU UTARA,67670,15398,52272,42644,94916,2021-11-28
3175061006,JAKARTA TIMUR,CAKUNG,UJUNG MENTENG,29934,4946,24988,21797,46785,2021-11-28
3174101005,JAKARTA SELATAN,PESANGGRAHAN,ULUJAMI,40544,8682,31862,27008,58870,2021-11-28
3175011006,JAKARTA TIMUR,MATRAMAN,UTAN KAYU SELATAN,33511,5774,27737,23638,51375,2021-11-28
3175011002,JAKARTA TIMUR,MATRAMAN,UTAN KAYU UTARA,28169,5465,22704,19016,41720,2021-11-28
3171031008,JAKARTA PUSAT,KEMAYORAN,UTAN PANJANG,29208,5532,23676,19694,43370,2021-11-28
3172021007,JAKARTA UTARA,TANJUNG PRIOK,WARAKAS,44401,7859,36542,30341,66883,2021-11-28
3173021007,JAKARTA BARAT,GROGOL PETAMBURAN,WIJAYA KUSUMA,38934,7776,31158,26959,58117,2021-11-28
3172051003,JAKARTA UTARA,PADEMANGAN,ANCOL,23947,5537,18410,15436,33846,2021-11-29
3173041007,JAKARTA BARAT,TAMBORA,ANGKE,29381,5999,23382,19374,42756,2021-11-29
3175041005,JAKARTA TIMUR,KRAMAT JATI,BALE KAMBANG,29074,6828,22246,18020,40266,2021-11-29
3175031003,JAKARTA TIMUR,JATINEGARA,BALI MESTER,9752,1932,7820,6752,14572,2021-11-29
3175101006,JAKARTA TIMUR,CIPAYUNG,BAMBU APUS,26285,4627,21658,18647,40305,2021-11-29
3174031002,JAKARTA SELATAN,MAMPANG PRAPATAN,BANGKA,21566,4352,17214,14651,31865,2021-11-29
3175051002,JAKARTA TIMUR,PASAR REBO,BARU,23886,3781,20105,17733,37838,2021-11-29
3175041004,JAKARTA TIMUR,KRAMAT JATI,BATU AMPAR,47898,11010,36888,30583,67471,2021-11-29
3171071002,JAKARTA PUSAT,TANAH ABANG,BENDUNGAN HILIR,21494,4195,17299,15088,32387,2021-11-29
3175031002,JAKARTA TIMUR,JATINEGARA,BIDARA CINA,36689,8469,28220,23530,51750,2021-11-29
3174101002,JAKARTA SELATAN,PESANGGRAHAN,BINTARO,53098,10296,42802,38073,80875,2021-11-29
3174011005,JAKARTA SELATAN,TEBET,BUKIT DURI,34183,6584,27599,23602,51201,2021-11-29
3171041006,JAKARTA PUSAT,SENEN,BUNGUR,18144,3629,14515,12289,26804,2021-11-29
3175061007,JAKARTA TIMUR,CAKUNG,CAKUNG BARAT,57724,11347,46377,38983,85360,2021-11-29
3175061004,JAKARTA TIMUR,CAKUNG,CAKUNG TIMUR,58287,10994,47293,40235,87528,2021-11-29
3175041007,JAKARTA TIMUR,KRAMAT JATI,CAWANG,32762,6674,26088,21669,47757,2021-11-29
3175101008,JAKARTA TIMUR,CIPAYUNG,CEGER,18932,3525,15407,13189,28596,2021-11-29
3171031006,JAKARTA PUSAT,KEMAYORAN,CEMPAKA BARU,32581,5899,26682,22324,49006,2021-11-29
3171051002,JAKARTA PUSAT,CEMPAKA PUTIH,CEMPAKA PUTIH BARAT,35885,7266,28619,25032,53651,2021-11-29
3171051001,JAKARTA PUSAT,CEMPAKA PUTIH,CEMPAKA PUTIH TIMUR,24292,4830,19462,17453,36915,2021-11-29
3173011001,JAKARTA BARAT,CENGKARENG,CENGKARENG BARAT,66284,12657,53627,47297,100924,2021-11-29
3173011006,JAKARTA BARAT,CENGKARENG,CENGKARENG TIMUR,81027,15396,65631,56109,121740,2021-11-29
3175091002,JAKARTA TIMUR,CIRACAS,CIBUBUR,66364,10978,55386,48178,103564,2021-11-29
3171011002,JAKARTA PUSAT,GAMBIR,CIDENG,15390,2921,12469,11084,23553,2021-11-29
3174091003,JAKARTA SELATAN,JAGAKARSA,CIGANJUR,38497,6214,32283,27674,59957,2021-11-29
3175051003,JAKARTA TIMUR,PASAR REBO,CIJANTUNG,41419,7367,34052,29208,63260,2021-11-29
3171061003,JAKARTA PUSAT,MENTENG,CIKINI,8274,1448,6826,5584,12410,2021-11-29
3174081006,JAKARTA SELATAN,PANCORAN,CIKOKO,10547,1756,8791,7765,16556,2021-11-29
3174061001,JAKARTA SELATAN,CILANDAK,CILANDAK BARAT,51752,8771,42981,38520,81501,2021-11-29
3174041003,JAKARTA SELATAN,PASAR MINGGU,CILANDAK TIMUR,25145,4391,20754,18192,38946,2021-11-29
3175101002,JAKARTA TIMUR,CIPAYUNG,CILANGKAP,27635,4695,22940,20006,42946,2021-11-29
3175041006,JAKARTA TIMUR,KRAMAT JATI,CILILITAN,40181,8117,32064,26721,58785,2021-11-29
3172041001,JAKARTA UTARA,CILINCING,CILINCING,43609,9971,33638,26976,60614,2021-11-29
3175101001,JAKARTA TIMUR,CIPAYUNG,CIPAYUNG,26104,4378,21726,19073,40799,2021-11-29
3174091006,JAKARTA SELATAN,JAGAKARSA,CIPEDAK,38303,6106,32197,28034,60231,2021-11-29
3174061005,JAKARTA SELATAN,CILANDAK,CIPETE SELATAN,26704,4900,21804,19625,41429,2021-11-29
3174071010,JAKARTA SELATAN,KEBAYORAN BARU,CIPETE UTARA,34102,6230,27872,24071,51943,2021-11-29
3175021003,JAKARTA TIMUR,PULO GADUNG,CIPINANG,39306,6849,32457,27816,60273,2021-11-29
3175031007,JAKARTA TIMUR,JATINEGARA,CIPINANG BESAR SELATAN,35212,7970,27242,22207,49449,2021-11-29
3175031008,JAKARTA TIMUR,JATINEGARA,CIPINANG BESAR UTARA,45319,10235,35084,28287,63371,2021-11-29
3175031005,JAKARTA TIMUR,JATINEGARA,CIPINANG CEMPEDAK,32824,6900,25924,22616,48540,2021-11-29
3175081005,JAKARTA TIMUR,MAKASAR,CIPINANG MELAYU,42308,7910,34398,29915,64313,2021-11-29
3175031006,JAKARTA TIMUR,JATINEGARA,CIPINANG MUARA,55243,11272,43971,36995,80966,2021-11-29
3174051003,JAKARTA SELATAN,KEBAYORAN LAMA,CIPULIR,39937,8088,31849,26952,58801,2021-11-29
3175091001,JAKARTA TIMUR,CIRACAS,CIRACAS,64594,11429,53165,45284,98449,2021-11-29
3175041003,JAKARTA TIMUR,KRAMAT JATI,DUKUH,24609,4364,20245,17192,37437,2021-11-29
3175071001,JAKARTA TIMUR,DUREN SAWIT,DUREN SAWIT,61160,12445,48715,41790,90505,2021-11-29
3174081004,JAKARTA SELATAN,PANCORAN,DUREN TIGA,28319,5392,22927,19635,42562,2021-11-29
3173051005,JAKARTA BARAT,KEBON JERUK,DURI KEPA,60138,11443,48695,42896,91591,2021-11-29
3173011002,JAKARTA BARAT,CENGKARENG,DURI KOSAMBI,77923,15927,61996,51458,113454,2021-11-29
3171011006,JAKARTA PUSAT,GAMBIR,DURI PULO,19610,4017,15593,12829,28422,2021-11-29
3173041011,JAKARTA BARAT,TAMBORA,DURI SELATAN,14259,2438,11821,10212,22033,2021-11-29
3173041003,JAKARTA BARAT,TAMBORA,DURI UTARA,19844,3437,16407,13805,30212,2021-11-29
3171081003,JAKARTA PUSAT,JOHAR BARU,GALUR,18243,3442,14801,12215,27016,2021-11-29
3171011001,JAKARTA PUSAT,GAMBIR,GAMBIR,2191,446,1745,1540,3285,2021-11-29
3174061004,JAKARTA SELATAN,CILANDAK,GANDARIA SELATAN,22119,4060,18059,15852,33911,2021-11-29
3174071009,JAKARTA SELATAN,KEBAYORAN BARU,GANDARIA UTARA,39922,7592,32330,28130,60460,2021-11-29
3175051001,JAKARTA TIMUR,PASAR REBO,GEDONG,35755,6917,28838,24928,53766,2021-11-29
3171071001,JAKARTA PUSAT,TANAH ABANG,GELORA,3127,592,2535,2252,4787,2021-11-29
3173031007,JAKARTA BARAT,TAMAN SARI,GLODOK,7837,1145,6692,6160,12852,2021-11-29
3171061004,JAKARTA PUSAT,MENTENG,GONDANGDIA,4100,896,3204,2956,6160,2021-11-29
3173021001,JAKARTA BARAT,GROGOL PETAMBURAN,GROGOL,16876,3222,13654,11835,25489,2021-11-29
3174051005,JAKARTA SELATAN,KEBAYORAN LAMA,GROGOL SELATAN,44251,8459,35792,30518,66310,2021-11-29
3174051004,JAKARTA SELATAN,KEBAYORAN LAMA,GROGOL UTARA,42494,8353,34141,29137,63278,2021-11-29
3174021007,JAKARTA SELATAN,SETIA BUDI,GUNTUR,3985,721,3264,2945,6209,2021-11-29
3174071002,JAKARTA SELATAN,KEBAYORAN BARU,GUNUNG,9436,1700,7736,7022,14758,2021-11-29
3171031005,JAKARTA PUSAT,KEMAYORAN,GUNUNG SAHARI SELATAN,19199,3596,15603,13471,29074,2021-11-29
3171021004,JAKARTA PUSAT,SAWAH BESAR,GUNUNG SAHARI UTARA,16650,2842,13808,12529,26337,2021-11-29
3175081004,JAKARTA TIMUR,MAKASAR,HALIM PERDANA KUSUMAH,28363,3547,24816,22979,47795,2021-11-29
3171031003,JAKARTA PUSAT,KEMAYORAN,HARAPAN MULIA,22557,4226,18331,15384,33715,2021-11-29
3174091001,JAKARTA SELATAN,JAGAKARSA,JAGAKARSA,62389,9802,52587,45942,98529,2021-11-29
3175021007,JAKARTA TIMUR,PULO GADUNG,JATI,32757,5911,26846,23870,50716,2021-11-29
3174041002,JAKARTA SELATAN,PASAR MINGGU,JATI PADANG,37502,6899,30603,26472,57075,2021-11-29
3173071004,JAKARTA BARAT,PALMERAH,JATI PULO,28738,5474,23264,19115,42379,2021-11-29
3175061001,JAKARTA TIMUR,CAKUNG,JATINEGARA,84160,17058,67102,56800,123902,2021-11-29
3175021004,JAKARTA TIMUR,PULO GADUNG,JATINEGARA KAUM,24632,4215,20417,17109,37526,2021-11-29
3173021004,JAKARTA BARAT,GROGOL PETAMBURAN,JELAMBAR,30266,5315,24951,22451,47402,2021-11-29
3173021006,JAKARTA BARAT,GROGOL PETAMBURAN,JELAMBAR BARU,38246,6628,31618,28174,59792,2021-11-29
3173041006,JAKARTA BARAT,TAMBORA,JEMBATAN BESI,29314,6785,22529,18143,40672,2021-11-29
3173041008,JAKARTA BARAT,TAMBORA,JEMBATAN LIMA,21021,4578,16443,13387,29830,2021-11-29
3173081005,JAKARTA BARAT,KEMBANGAN,JOGLO,40839,7869,32970,28553,61523,2021-11-29
3171081001,JAKARTA PUSAT,JOHAR BARU,JOHAR BARU,37488,6710,30778,26548,57326,2021-11-29
3173041002,JAKARTA BARAT,TAMBORA,KALI ANYAR,23856,4529,19327,15794,35121,2021-11-29
3172041004,JAKARTA UTARA,CILINCING,KALIBARU,67684,17752,49932,36589,86521,2021-11-29
3174081002,JAKARTA SELATAN,PANCORAN,KALIBATA,41994,9141,32853,27563,60416,2021-11-29
3173061001,JAKARTA BARAT,KALI DERES,KALIDERES,72447,13922,58525,50635,109160,2021-11-29
3175051004,JAKARTA TIMUR,PASAR REBO,KALISARI,43212,7365,35847,31015,66862,2021-11-29
3173061004,JAKARTA BARAT,KALI DERES,KAMAL,53783,11975,41808,34382,76190,2021-11-29
3172011002,JAKARTA UTARA,PENJARINGAN,KAMAL MUARA,12930,2245,10685,9204,19889,2021-11-29
3171071007,JAKARTA PUSAT,TANAH ABANG,KAMPUNG BALI,11358,2361,8997,7177,16174,2021-11-29
3175031001,JAKARTA TIMUR,JATINEGARA,KAMPUNG MELAYU,25717,5660,20057,16164,36221,2021-11-29
3171081002,JAKARTA PUSAT,JOHAR BARU,KAMPUNG RAWA,21237,3396,17841,14575,32416,2021-11-29
3175041002,JAKARTA TIMUR,KRAMAT JATI,KAMPUNG TENGAH,43993,10469,33524,27601,61125,2021-11-29
3173011005,JAKARTA BARAT,CENGKARENG,KAPUK,134466,30940,103526,86381,189907,2021-11-29
3172011003,JAKARTA UTARA,PENJARINGAN,KAPUK MUARA,35781,6613,29168,26096,55264,2021-11-29
3171021002,JAKARTA PUSAT,SAWAH BESAR,KARANG ANYAR,25761,4710,21051,18072,39123,2021-11-29
3174021004,JAKARTA SELATAN,SETIA BUDI,KARET,9623,1796,7827,6722,14549,2021-11-29
3174021003,JAKARTA SELATAN,SETIA BUDI,KARET KUNINGAN,16055,3013,13042,11356,24398,2021-11-29
3174021002,JAKARTA SELATAN,SETIA BUDI,KARET SEMANGGI,2770,541,2229,2007,4236,2021-11-29
3171071003,JAKARTA PUSAT,TANAH ABANG,KARET TENGSIN,19271,3593,15678,13160,28838,2021-11-29
3171021003,JAKARTA PUSAT,SAWAH BESAR,KARTINI,22292,4045,18247,16002,34249,2021-11-29
3175011003,JAKARTA TIMUR,MATRAMAN,KAYU MANIS,25284,5065,20219,16654,36873,2021-11-29
3175021006,JAKARTA TIMUR,PULO GADUNG,KAYU PUTIH,40696,7421,33275,29686,62961,2021-11-29
3173031006,JAKARTA BARAT,TAMAN SARI,KEAGUNGAN,17387,3105,14282,12023,26305,2021-11-29
3174041007,JAKARTA SELATAN,PASAR MINGGU,KEBAGUSAN,44552,8416,36136,30819,66955,2021-11-29
3174051006,JAKARTA SELATAN,KEBAYORAN LAMA,KEBAYORAN LAMA SELATAN,41212,7319,33893,29644,63537,2021-11-29
3174051001,JAKARTA SELATAN,KEBAYORAN LAMA,KEBAYORAN LAMA UTARA,42422,8430,33992,29158,63150,2021-11-29
3174011004,JAKARTA SELATAN,TEBET,KEBON BARU,35165,6298,28867,24948,53815,2021-11-29
3172021005,JAKARTA UTARA,TANJUNG PRIOK,KEBON BAWANG,50952,9864,41088,35130,76218,2021-11-29
3173051001,JAKARTA BARAT,KEBON JERUK,KEBON JERUK,53887,10521,43366,36364,79730,2021-11-29
3171071006,JAKARTA PUSAT,TANAH ABANG,KEBON KACANG,21531,4959,16572,13553,30125,2021-11-29
3171011005,JAKARTA PUSAT,GAMBIR,KEBON KELAPA,10163,1970,8193,7105,15298,2021-11-29
3171031002,JAKARTA PUSAT,KEMAYORAN,KEBON KOSONG,30019,5767,24252,20562,44814,2021-11-29
3175011005,JAKARTA TIMUR,MATRAMAN,KEBON MANGGIS,16490,3072,13418,11366,24784,2021-11-29
3171071005,JAKARTA PUSAT,TANAH ABANG,KEBON MELATI,32206,8317,23889,18342,42231,2021-11-29
3175081003,JAKARTA TIMUR,MAKASAR,KEBON PALA,46614,8837,37777,32300,70077,2021-11-29
3171061005,JAKARTA PUSAT,MENTENG,KEBON SIRIH,12299,2544,9755,8075,17830,2021-11-29
3173011004,JAKARTA BARAT,CENGKARENG,KEDAUNG KALI ANGKE,32612,6026,26586,22916,49502,2021-11-29
3173051007,JAKARTA BARAT,KEBON JERUK,KEDOYA SELATAN,32165,5672,26493,22433,48926,2021-11-29
3173051006,JAKARTA BARAT,KEBON JERUK,KEDOYA UTARA,45740,8443,37297,32128,69425,2021-11-29
3173051004,JAKARTA BARAT,KEBON JERUK,KELAPA DUA,23565,4443,19122,16357,35479,2021-11-29
3175091003,JAKARTA TIMUR,CIRACAS,KELAPA DUA WETAN,46875,7706,39169,34038,73207,2021-11-29
3172061003,JAKARTA UTARA,KELAPA GADING,KELAPA GADING BARAT,35717,6045,29672,27184,56856,2021-11-29
3172061001,JAKARTA UTARA,KELAPA GADING,KELAPA GADING TIMUR,33592,4993,28599,26887,55486,2021-11-29
3173071005,JAKARTA BARAT,PALMERAH,KEMANGGISAN,32139,5840,26299,22896,49195,2021-11-29
3171031001,JAKARTA PUSAT,KEMAYORAN,KEMAYORAN,20708,3959,16749,14157,30906,2021-11-29
3173081006,JAKARTA BARAT,KEMBANGAN,KEMBANGAN SELATAN,27130,5461,21669,19040,40709,2021-11-29
3173081001,JAKARTA BARAT,KEMBANGAN,KEMBANGAN UTARA,54451,11317,43134,36691,79825,2021-11-29
3171041002,JAKARTA PUSAT,SENEN,KENARI,9579,1812,7767,6754,14521,2021-11-29
3173041005,JAKARTA BARAT,TAMBORA,KERENDANG,19973,3895,16078,13448,29526,2021-11-29
3175071003,JAKARTA TIMUR,DUREN SAWIT,KLENDER,69978,15828,54150,44496,98646,2021-11-29
3172031001,JAKARTA UTARA,KOJA,KOJA,28175,6166,22009,18286,40295,2021-11-29
3173071006,JAKARTA BARAT,PALMERAH,KOTA BAMBU SELATAN,21158,4005,17153,13910,31063,2021-11-29
3173071003,JAKARTA BARAT,PALMERAH,KOTA BAMBU UTARA,24995,4910,20085,16121,36206,2021-11-29
3171041004,JAKARTA PUSAT,SENEN,KRAMAT,28835,6490,22345,17432,39777,2021-11-29
3175041001,JAKARTA TIMUR,KRAMAT JATI,KRAMAT JATI,34144,6973,27171,22637,49808,2021-11-29
3174071003,JAKARTA SELATAN,KEBAYORAN BARU,KRAMAT PELA,14413,2701,11712,10321,22033,2021-11-29
3173031002,JAKARTA BARAT,TAMAN SARI,KRUKUT,19244,3492,15752,13136,28888,2021-11-29
3174031005,JAKARTA SELATAN,MAMPANG PRAPATAN,KUNINGAN BARAT,12785,2248,10537,9070,19607,2021-11-29
3174021008,JAKARTA SELATAN,SETIA BUDI,KUNINGAN TIMUR,6008,1153,4855,4278,9133,2021-11-29
3171041005,JAKARTA PUSAT,SENEN,KWITANG,15486,3309,12177,10027,22204,2021-11-29
3172031003,JAKARTA UTARA,KOJA,LAGOA,59065,13338,45727,37308,83035,2021-11-29
3174061002,JAKARTA SELATAN,CILANDAK,LEBAK BULUS,37626,6827,30799,27705,58504,2021-11-29
3174091004,JAKARTA SELATAN,JAGAKARSA,LENTENG AGUNG,53946,9263,44683,37682,82365,2021-11-29
3175101007,JAKARTA TIMUR,CIPAYUNG,LUBANG BUAYA,63547,11516,52031,44476,96507,2021-11-29
3175081001,JAKARTA TIMUR,MAKASAR,MAKASAR,34390,5902,28488,24853,53341,2021-11-29
3175071006,JAKARTA TIMUR,DUREN SAWIT,MALAKA JAYA,30927,5041,25886,22921,48807,2021-11-29
3175071005,JAKARTA TIMUR,DUREN SAWIT,MALAKA SARI,27530,4366,23164,20619,43783,2021-11-29
3174031001,JAKARTA SELATAN,MAMPANG PRAPATAN,MAMPANG PRAPATAN,18159,3560,14599,12399,26998,2021-11-29
3173031005,JAKARTA BARAT,TAMAN SARI,MANGGA BESAR,7707,1262,6445,5780,12225,2021-11-29
3171021005,JAKARTA PUSAT,SAWAH BESAR,MANGGA DUA SELATAN,27442,5419,22023,19056,41079,2021-11-29
3174011007,JAKARTA SELATAN,TEBET,MANGGARAI,28373,4765,23608,19864,43472,2021-11-29
3174011006,JAKARTA SELATAN,TEBET,MANGGARAI SELATAN,23075,3617,19458,16771,36229,2021-11-29
3173031003,JAKARTA BARAT,TAMAN SARI,MAPHAR,16461,2969,13492,11572,25064,2021-11-29
3172041003,JAKARTA UTARA,CILINCING,MARUNDA,28943,6287,22656,17542,40198,2021-11-29
3174071001,JAKARTA SELATAN,KEBAYORAN BARU,MELAWAI,2627,496,2131,1988,4119,2021-11-29
3171061001,JAKARTA PUSAT,MENTENG,MENTENG,25624,5377,20247,16594,36841,2021-11-29
3174021005,JAKARTA SELATAN,SETIA BUDI,MENTENG ATAS,27816,4788,23028,19845,42873,2021-11-29
3174011003,JAKARTA SELATAN,TEBET,MENTENG DALAM,36028,6714,29314,25476,54790,2021-11-29
3173081003,JAKARTA BARAT,KEMBANGAN,MERUYA SELATAN,32130,6327,25803,22383,48186,2021-11-29
3173081002,JAKARTA BARAT,KEMBANGAN,MERUYA UTARA,43752,8667,35085,31221,66306,2021-11-29
3175101004,JAKARTA TIMUR,CIPAYUNG,MUNJUL,23871,4213,19658,17045,36703,2021-11-29
3172051002,JAKARTA UTARA,PADEMANGAN,PADEMANGAN BARAT,74240,16751,57489,47618,105107,2021-11-29
3172051001,JAKARTA UTARA,PADEMANGAN,PADEMANGAN TIMUR,37736,6404,31332,28197,59529,2021-11-29
3175011004,JAKARTA TIMUR,MATRAMAN,PAL MERIAM,19769,3851,15918,13192,29110,2021-11-29
3173071001,JAKARTA BARAT,PALMERAH,PALMERAH,63011,12638,50373,42291,92664,2021-11-29
3174081001,JAKARTA SELATAN,PANCORAN,PANCORAN,19421,3715,15706,13433,29139,2021-11-29
3172021003,JAKARTA UTARA,TANJUNG PRIOK,PAPANGGO,39097,7376,31721,26745,58466,2021-11-29
3171021001,JAKARTA PUSAT,SAWAH BESAR,PASAR BARU,12035,2215,9820,8945,18765,2021-11-29
3174021006,JAKARTA SELATAN,SETIA BUDI,PASAR MANGGIS,26752,4923,21829,18645,40474,2021-11-29
3174041001,JAKARTA SELATAN,PASAR MINGGU,PASAR MINGGU,24821,4485,20336,17880,38216,2021-11-29
3171041003,JAKARTA PUSAT,SENEN,PASEBAN,23533,4695,18838,15828,34666,2021-11-29
3173061005,JAKARTA BARAT,KALI DERES,PEGADUNGAN,75587,14137,61450,53682,115132,2021-11-29
3171061002,JAKARTA PUSAT,MENTENG,PEGANGSAAN,23455,4837,18618,14904,33522,2021-11-29
3172061002,JAKARTA UTARA,KELAPA GADING,PEGANGSAAN DUA,49976,8020,41956,38590,80546,2021-11-29
3172011004,JAKARTA UTARA,PENJARINGAN,PEJAGALAN,74578,14852,59726,52768,112494,2021-11-29
3174041006,JAKARTA SELATAN,PASAR MINGGU,PEJATEN BARAT,37346,6944,30402,26285,56687,2021-11-29
3174041005,JAKARTA SELATAN,PASAR MINGGU,PEJATEN TIMUR,57656,11915,45741,38155,83896,2021-11-29
3175051005,JAKARTA TIMUR,PASAR REBO,PEKAYON,43250,7528,35722,30593,66315,2021-11-29
3173041009,JAKARTA BARAT,TAMBORA,PEKOJAN,23587,4316,19271,16633,35904,2021-11-29
3174031003,JAKARTA SELATAN,MAMPANG PRAPATAN,PELA MAMPANG,43522,8194,35328,30525,65853,2021-11-29
3174081005,JAKARTA SELATAN,PANCORAN,PENGADEGAN,21478,3789,17689,15498,33187,2021-11-29
3175061003,JAKARTA TIMUR,CAKUNG,PENGGILINGAN,99255,21733,77522,63849,141371,2021-11-29
3172011001,JAKARTA UTARA,PENJARINGAN,PENJARINGAN,88308,21877,66431,52971,119402,2021-11-29
3174101001,JAKARTA SELATAN,PESANGGRAHAN,PESANGGRAHAN,27545,4558,22987,20232,43219,2021-11-29
3171071004,JAKARTA PUSAT,TANAH ABANG,PETAMBURAN,33271,8458,24813,19497,44310,2021-11-29
3174071008,JAKARTA SELATAN,KEBAYORAN BARU,PETOGOGAN,11499,2138,9361,8209,17570,2021-11-29
3171011004,JAKARTA PUSAT,GAMBIR,PETOJO SELATAN,14692,3193,11499,9961,21460,2021-11-29
3171011003,JAKARTA PUSAT,GAMBIR,PETOJO UTARA,17458,3654,13804,11647,25451,2021-11-29
3174101004,JAKARTA SELATAN,PESANGGRAHAN,PETUKANGAN SELATAN,37187,7365,29822,25877,55699,2021-11-29
3174101003,JAKARTA SELATAN,PESANGGRAHAN,PETUKANGAN UTARA,53716,11037,42679,36500,79179,2021-11-29
3175081002,JAKARTA TIMUR,MAKASAR,PINANG RANTI,27198,5686,21512,18255,39767,2021-11-29
3173031008,JAKARTA BARAT,TAMAN SARI,PINANGSIA,10729,1812,8917,7586,16503,2021-11-29
3175011001,JAKARTA TIMUR,MATRAMAN,PISANGAN BARU,31776,6244,25532,21073,46605,2021-11-29
3175021002,JAKARTA TIMUR,PULO GADUNG,PISANGAN TIMUR,41011,7274,33737,29233,62970,2021-11-29
3172011005,JAKARTA UTARA,PENJARINGAN,PLUIT,47783,8989,38794,34654,73448,2021-11-29
3175071002,JAKARTA TIMUR,DUREN SAWIT,PONDOK BAMBU,61550,12444,49106,42272,91378,2021-11-29
3175071004,JAKARTA TIMUR,DUREN SAWIT,PONDOK KELAPA,72015,13774,58241,51255,109496,2021-11-29
3175071007,JAKARTA TIMUR,DUREN SAWIT,PONDOK KOPI,35367,6396,28971,23985,52956,2021-11-29
3174061003,JAKARTA SELATAN,CILANDAK,PONDOK LABU,46464,7381,39083,35013,74096,2021-11-29
3174051002,JAKARTA SELATAN,KEBAYORAN LAMA,PONDOK PINANG,56169,10411,45758,40124,85882,2021-11-29
3175101003,JAKARTA TIMUR,CIPAYUNG,PONDOK RANGGON,25574,4621,20953,18152,39105,2021-11-29
3101011003,KAB.ADM.KEP.SERIBU,KEP. SERIBU UTARA,PULAU HARAPAN,2060,215,1845,1647,3492,2021-11-29
3101011002,KAB.ADM.KEP.SERIBU,KEP. SERIBU UTARA,PULAU KELAPA,5528,582,4946,4110,9056,2021-11-29
3101011001,KAB.ADM.KEP.SERIBU,KEP. SERIBU UTARA,PULAU PANGGANG,5450,425,5025,4535,9560,2021-11-29
3101021003,KAB.ADM.KEP.SERIBU,KEP. SERIBU SELATAN,PULAU PARI,2765,191,2574,2440,5014,2021-11-29
3101021002,KAB.ADM.KEP.SERIBU,KEP. SERIBU SELATAN,PULAU TIDUNG,4553,360,4193,3893,8086,2021-11-29
3101021001,KAB.ADM.KEP.SERIBU,KEP. SERIBU SELATAN,PULAU UNTUNG JAWA,1941,156,1785,1664,3449,2021-11-29
3174071007,JAKARTA SELATAN,KEBAYORAN BARU,PULO,5835,983,4852,4522,9374,2021-11-29
3175021001,JAKARTA TIMUR,PULO GADUNG,PULO GADUNG,34422,7260,27162,23262,50424,2021-11-29
3175061005,JAKARTA TIMUR,CAKUNG,PULO GEBANG,97301,17958,79343,66529,145872,2021-11-29
3174041004,JAKARTA SELATAN,PASAR MINGGU,RAGUNAN,39616,6774,32842,28737,61579,2021-11-29
3175091005,JAKARTA TIMUR,CIRACAS,RAMBUTAN,36771,8273,28498,23895,52393,2021-11-29
3172031006,JAKARTA UTARA,KOJA,RAWA BADAK SELATAN,42179,9559,32620,26587,59207,2021-11-29
3172031004,JAKARTA UTARA,KOJA,RAWA BADAK UTARA,34408,7402,27006,22491,49497,2021-11-29
3174071005,JAKARTA SELATAN,KEBAYORAN BARU,RAWA BARAT,5625,972,4653,4210,8863,2021-11-29
3173011003,JAKARTA BARAT,CENGKARENG,RAWA BUAYA,63799,12046,51753,44043,95796,2021-11-29
3175031004,JAKARTA TIMUR,JATINEGARA,RAWA BUNGA,21434,4969,16465,13822,30287,2021-11-29
3174081003,JAKARTA SELATAN,PANCORAN,RAWA JATI,20509,3764,16745,14702,31447,2021-11-29
3175061002,JAKARTA TIMUR,CAKUNG,RAWA TERATE,24637,4266,20371,17076,37447,2021-11-29
3175021005,JAKARTA TIMUR,PULO GADUNG,RAWAMANGUN,37612,7132,30480,26595,57075,2021-11-29
3171051003,JAKARTA PUSAT,CEMPAKA PUTIH,RAWASARI,21967,4278,17689,15540,33229,2021-11-29
3173041010,JAKARTA BARAT,TAMBORA,ROA MALAKA,3484,601,2883,2625,5508,2021-11-29
3172041006,JAKARTA UTARA,CILINCING,ROROTAN,41668,8032,33636,27951,61587,2021-11-29
3174071004,JAKARTA SELATAN,KEBAYORAN BARU,SELONG,2842,537,2305,2160,4465,2021-11-29
3173061002,JAKARTA BARAT,KALI DERES,SEMANAN,71354,14286,57068,47168,104236,2021-11-29
3172041007,JAKARTA UTARA,CILINCING,SEMPER BARAT,68587,12831,55756,47598,103354,2021-11-29
3172041005,JAKARTA UTARA,CILINCING,SEMPER TIMUR,36267,7445,28822,24039,52861,2021-11-29
3174071006,JAKARTA SELATAN,KEBAYORAN BARU,SENAYAN,2771,637,2134,1898,4032,2021-11-29
3171041001,JAKARTA PUSAT,SENEN,SENEN,6804,1384,5420,4600,10020,2021-11-29
3171031004,JAKARTA PUSAT,KEMAYORAN,SERDANG,29668,5503,24165,20717,44882,2021-11-29
3174021001,JAKARTA SELATAN,SETIA BUDI,SETIA BUDI,3023,585,2438,2142,4580,2021-11-29
3175101005,JAKARTA TIMUR,CIPAYUNG,SETU,20572,3934,16638,14022,30660,2021-11-29
3173071002,JAKARTA BARAT,PALMERAH,SLIPI,16591,2861,13730,11950,25680,2021-11-29
3173081004,JAKARTA BARAT,KEMBANGAN,SRENGSENG,45523,9765,35758,30970,66728,2021-11-29
3174091002,JAKARTA SELATAN,JAGAKARSA,SRENGSENG SAWAH,58196,8520,49676,43917,93593,2021-11-29
3173051003,JAKARTA BARAT,KEBON JERUK,SUKABUMI SELATAN,37033,7454,29579,23594,53173,2021-11-29
3173051002,JAKARTA BARAT,KEBON JERUK,SUKABUMI UTARA,38290,8585,29705,24120,53825,2021-11-29
3172041002,JAKARTA UTARA,CILINCING,SUKAPURA,53949,11691,42258,35715,77973,2021-11-29
3171031007,JAKARTA PUSAT,KEMAYORAN,SUMUR BATU,22717,4138,18579,16233,34812,2021-11-29
3172021004,JAKARTA UTARA,TANJUNG PRIOK,SUNGAI BAMBU,29876,5723,24153,20566,44719,2021-11-29
3172021006,JAKARTA UTARA,TANJUNG PRIOK,SUNTER AGUNG,71805,11985,59820,53602,113422,2021-11-29
3172021002,JAKARTA UTARA,TANJUNG PRIOK,SUNTER JAYA,63031,10646,52385,46554,98939,2021-11-29
3175091004,JAKARTA TIMUR,CIRACAS,SUSUKAN,38257,6925,31332,26841,58173,2021-11-29
3173031001,JAKARTA BARAT,TAMAN SARI,TAMAN SARI,14348,2529,11819,10374,22193,2021-11-29
3173041001,JAKARTA BARAT,TAMBORA,TAMBORA,10204,2112,8092,6688,14780,2021-11-29
3173041004,JAKARTA BARAT,TAMBORA,TANAH SEREAL,26387,4297,22090,18927,41017,2021-11-29
3171081004,JAKARTA PUSAT,JOHAR BARU,TANAH TINGGI,37693,6962,30731,25472,56203,2021-11-29
3173031004,JAKARTA BARAT,TAMAN SARI,TANGKI,13324,2142,11182,9728,20910,2021-11-29
3174091005,JAKARTA SELATAN,JAGAKARSA,TANJUNG BARAT,39770,6486,33284,28469,61753,2021-11-29
3173021005,JAKARTA BARAT,GROGOL PETAMBURAN,TANJUNG DUREN SELATAN,25337,4650,20687,18742,39429,2021-11-29
3173021002,JAKARTA BARAT,GROGOL PETAMBURAN,TANJUNG DUREN UTARA,17010,2760,14250,13077,27327,2021-11-29
3172021001,JAKARTA UTARA,TANJUNG PRIOK,TANJUNG PRIOK,34588,6862,27726,23242,50968,2021-11-29
3174011002,JAKARTA SELATAN,TEBET,TEBET BARAT,21194,3263,17931,16137,34068,2021-11-29
3174011001,JAKARTA SELATAN,TEBET,TEBET TIMUR,18199,2805,15394,14223,29617,2021-11-29
3173061003,JAKARTA BARAT,KALI DERES,TEGAL ALUR,83647,16589,67058,56840,123898,2021-11-29
3174031004,JAKARTA SELATAN,MAMPANG PRAPATAN,TEGAL PARANG,32401,6858,25543,20702,46245,2021-11-29
3173021003,JAKARTA BARAT,GROGOL PETAMBURAN,TOMANG,29605,5253,24352,21522,45874,2021-11-29
3172031005,JAKARTA UTARA,KOJA,TUGU SELATAN,39122,8402,30720,25643,56363,2021-11-29
3172031002,JAKARTA UTARA,KOJA,TUGU UTARA,67670,15389,52281,42654,94935,2021-11-29
3175061006,JAKARTA TIMUR,CAKUNG,UJUNG MENTENG,29934,4946,24988,21797,46785,2021-11-29
3174101005,JAKARTA SELATAN,PESANGGRAHAN,ULUJAMI,40544,8673,31871,27039,58910,2021-11-29
3175011006,JAKARTA TIMUR,MATRAMAN,UTAN KAYU SELATAN,33511,5767,27744,23627,51371,2021-11-29
3175011002,JAKARTA TIMUR,MATRAMAN,UTAN KAYU UTARA,28169,5460,22709,19023,41732,2021-11-29
3171031008,JAKARTA PUSAT,KEMAYORAN,UTAN PANJANG,29208,5528,23680,19696,43376,2021-11-29
3172021007,JAKARTA UTARA,TANJUNG PRIOK,WARAKAS,44401,7856,36545,30351,66896,2021-11-29
3173021007,JAKARTA BARAT,GROGOL PETAMBURAN,WIJAYA KUSUMA,38934,7767,31167,26963,58130,2021-11-29
3172051003,JAKARTA UTARA,PADEMANGAN,ANCOL,23947,5527,18420,15466,33886,2021-11-30
3173041007,JAKARTA BARAT,TAMBORA,ANGKE,29381,5986,23395,19404,42799,2021-11-30
3175041005,JAKARTA TIMUR,KRAMAT JATI,BALE KAMBANG,29074,6802,22272,18084,40356,2021-11-30
3175031003,JAKARTA TIMUR,JATINEGARA,BALI MESTER,9752,1920,7832,6773,14605,2021-11-30
3175101006,JAKARTA TIMUR,CIPAYUNG,BAMBU APUS,26285,4612,21673,18694,40367,2021-11-30
3174031002,JAKARTA SELATAN,MAMPANG PRAPATAN,BANGKA,21566,4346,17220,14694,31914,2021-11-30
3175051002,JAKARTA TIMUR,PASAR REBO,BARU,23886,3776,20110,17781,37891,2021-11-30
3175041004,JAKARTA TIMUR,KRAMAT JATI,BATU AMPAR,47898,10985,36913,30676,67589,2021-11-30
3171071002,JAKARTA PUSAT,TANAH ABANG,BENDUNGAN HILIR,21494,4187,17307,15114,32421,2021-11-30
3175031002,JAKARTA TIMUR,JATINEGARA,BIDARA CINA,36689,8447,28242,23616,51858,2021-11-30
3174101002,JAKARTA SELATAN,PESANGGRAHAN,BINTARO,53098,10277,42821,38146,80967,2021-11-30
3174011005,JAKARTA SELATAN,TEBET,BUKIT DURI,34183,6558,27625,23677,51302,2021-11-30
3171041006,JAKARTA PUSAT,SENEN,BUNGUR,18144,3618,14526,12325,26851,2021-11-30
3175061007,JAKARTA TIMUR,CAKUNG,CAKUNG BARAT,57724,11327,46397,39041,85438,2021-11-30
3175061004,JAKARTA TIMUR,CAKUNG,CAKUNG TIMUR,58287,10972,47315,40320,87635,2021-11-30
3175041007,JAKARTA TIMUR,KRAMAT JATI,CAWANG,32762,6653,26109,21729,47838,2021-11-30
3175101008,JAKARTA TIMUR,CIPAYUNG,CEGER,18932,3516,15416,13220,28636,2021-11-30
3171031006,JAKARTA PUSAT,KEMAYORAN,CEMPAKA BARU,32581,5882,26699,22471,49170,2021-11-30
3171051002,JAKARTA PUSAT,CEMPAKA PUTIH,CEMPAKA PUTIH BARAT,35885,7253,28632,25082,53714,2021-11-30
3171051001,JAKARTA PUSAT,CEMPAKA PUTIH,CEMPAKA PUTIH TIMUR,24292,4812,19480,17494,36974,2021-11-30
3173011001,JAKARTA BARAT,CENGKARENG,CENGKARENG BARAT,66284,12627,53657,47376,101033,2021-11-30
3173011006,JAKARTA BARAT,CENGKARENG,CENGKARENG TIMUR,81027,15368,65659,56267,121926,2021-11-30
3175091002,JAKARTA TIMUR,CIRACAS,CIBUBUR,66364,10955,55409,48278,103687,2021-11-30
3171011002,JAKARTA PUSAT,GAMBIR,CIDENG,15390,2916,12474,11100,23574,2021-11-30
3174091003,JAKARTA SELATAN,JAGAKARSA,CIGANJUR,38497,6202,32295,27763,60058,2021-11-30
3175051003,JAKARTA TIMUR,PASAR REBO,CIJANTUNG,41419,7345,34074,29284,63358,2021-11-30
3171061003,JAKARTA PUSAT,MENTENG,CIKINI,8274,1446,6828,5594,12422,2021-11-30
3174081006,JAKARTA SELATAN,PANCORAN,CIKOKO,10547,1753,8794,7781,16575,2021-11-30
3174061001,JAKARTA SELATAN,CILANDAK,CILANDAK BARAT,51752,8759,42993,38595,81588,2021-11-30
3174041003,JAKARTA SELATAN,PASAR MINGGU,CILANDAK TIMUR,25145,4384,20761,18244,39005,2021-11-30
3175101002,JAKARTA TIMUR,CIPAYUNG,CILANGKAP,27635,4691,22944,20028,42972,2021-11-30
3175041006,JAKARTA TIMUR,KRAMAT JATI,CILILITAN,40181,8069,32112,26834,58946,2021-11-30
3172041001,JAKARTA UTARA,CILINCING,CILINCING,43609,9941,33668,27041,60709,2021-11-30
3175101001,JAKARTA TIMUR,CIPAYUNG,CIPAYUNG,26104,4367,21737,19091,40828,2021-11-30
3174091006,JAKARTA SELATAN,JAGAKARSA,CIPEDAK,38303,6090,32213,28088,60301,2021-11-30
3174061005,JAKARTA SELATAN,CILANDAK,CIPETE SELATAN,26704,4891,21813,19663,41476,2021-11-30
3174071010,JAKARTA SELATAN,KEBAYORAN BARU,CIPETE UTARA,34102,6221,27881,24111,51992,2021-11-30
3175021003,JAKARTA TIMUR,PULO GADUNG,CIPINANG,39306,6831,32475,27891,60366,2021-11-30
3175031007,JAKARTA TIMUR,JATINEGARA,CIPINANG BESAR SELATAN,35212,7949,27263,22256,49519,2021-11-30
3175031008,JAKARTA TIMUR,JATINEGARA,CIPINANG BESAR UTARA,45319,10192,35127,28454,63581,2021-11-30
3175031005,JAKARTA TIMUR,JATINEGARA,CIPINANG CEMPEDAK,32824,6883,25941,22669,48610,2021-11-30
3175081005,JAKARTA TIMUR,MAKASAR,CIPINANG MELAYU,42308,7875,34433,30074,64507,2021-11-30
3175031006,JAKARTA TIMUR,JATINEGARA,CIPINANG MUARA,55243,11230,44013,37063,81076,2021-11-30
3174051003,JAKARTA SELATAN,KEBAYORAN LAMA,CIPULIR,39937,8066,31871,27013,58884,2021-11-30
3175091001,JAKARTA TIMUR,CIRACAS,CIRACAS,64594,11407,53187,45365,98552,2021-11-30
3175041003,JAKARTA TIMUR,KRAMAT JATI,DUKUH,24609,4357,20252,17229,37481,2021-11-30
3175071001,JAKARTA TIMUR,DUREN SAWIT,DUREN SAWIT,61160,12386,48774,41955,90729,2021-11-30
3174081004,JAKARTA SELATAN,PANCORAN,DUREN TIGA,28319,5381,22938,19674,42612,2021-11-30
3173051005,JAKARTA BARAT,KEBON JERUK,DURI KEPA,60138,11416,48722,42971,91693,2021-11-30
3173011002,JAKARTA BARAT,CENGKARENG,DURI KOSAMBI,77923,15888,62035,51599,113634,2021-11-30
3171011006,JAKARTA PUSAT,GAMBIR,DURI PULO,19610,4011,15599,12856,28455,2021-11-30
3173041011,JAKARTA BARAT,TAMBORA,DURI SELATAN,14259,2435,11824,10225,22049,2021-11-30
3173041003,JAKARTA BARAT,TAMBORA,DURI UTARA,19844,3425,16419,13842,30261,2021-11-30
3171081003,JAKARTA PUSAT,JOHAR BARU,GALUR,18243,3439,14804,12237,27041,2021-11-30
3171011001,JAKARTA PUSAT,GAMBIR,GAMBIR,2191,446,1745,1542,3287,2021-11-30
3174061004,JAKARTA SELATAN,CILANDAK,GANDARIA SELATAN,22119,4056,18063,15871,33934,2021-11-30
3174071009,JAKARTA SELATAN,KEBAYORAN BARU,GANDARIA UTARA,39922,7569,32353,28210,60563,2021-11-30
3175051001,JAKARTA TIMUR,PASAR REBO,GEDONG,35755,6900,28855,24986,53841,2021-11-30
3171071001,JAKARTA PUSAT,TANAH ABANG,GELORA,3127,591,2536,2255,4791,2021-11-30
3173031007,JAKARTA BARAT,TAMAN SARI,GLODOK,7837,1145,6692,6165,12857,2021-11-30
3171061004,JAKARTA PUSAT,MENTENG,GONDANGDIA,4100,894,3206,2959,6165,2021-11-30
3173021001,JAKARTA BARAT,GROGOL PETAMBURAN,GROGOL,16876,3214,13662,11857,25519,2021-11-30
3174051005,JAKARTA SELATAN,KEBAYORAN LAMA,GROGOL SELATAN,44251,8439,35812,30599,66411,2021-11-30
3174051004,JAKARTA SELATAN,KEBAYORAN LAMA,GROGOL UTARA,42494,8342,34152,29221,63373,2021-11-30
3174021007,JAKARTA SELATAN,SETIA BUDI,GUNTUR,3985,720,3265,2948,6213,2021-11-30
3174071002,JAKARTA SELATAN,KEBAYORAN BARU,GUNUNG,9436,1698,7738,7029,14767,2021-11-30
3171031005,JAKARTA PUSAT,KEMAYORAN,GUNUNG SAHARI SELATAN,19199,3575,15624,13508,29132,2021-11-30
3171021004,JAKARTA PUSAT,SAWAH BESAR,GUNUNG SAHARI UTARA,16650,2831,13819,12544,26363,2021-11-30
3175081004,JAKARTA TIMUR,MAKASAR,HALIM PERDANA KUSUMAH,28363,3545,24818,23008,47826,2021-11-30
3171031003,JAKARTA PUSAT,KEMAYORAN,HARAPAN MULIA,22557,4206,18351,15419,33770,2021-11-30
3174091001,JAKARTA SELATAN,JAGAKARSA,JAGAKARSA,62389,9773,52616,46062,98678,2021-11-30
3175021007,JAKARTA TIMUR,PULO GADUNG,JATI,32757,5890,26867,23925,50792,2021-11-30
3174041002,JAKARTA SELATAN,PASAR MINGGU,JATI PADANG,37502,6886,30616,26532,57148,2021-11-30
3173071004,JAKARTA BARAT,PALMERAH,JATI PULO,28738,5459,23279,19161,42440,2021-11-30
3175061001,JAKARTA TIMUR,CAKUNG,JATINEGARA,84160,17007,67153,56954,124107,2021-11-30
3175021004,JAKARTA TIMUR,PULO GADUNG,JATINEGARA KAUM,24632,4207,20425,17140,37565,2021-11-30
3173021004,JAKARTA BARAT,GROGOL PETAMBURAN,JELAMBAR,30266,5297,24969,22500,47469,2021-11-30
3173021006,JAKARTA BARAT,GROGOL PETAMBURAN,JELAMBAR BARU,38246,6585,31661,28261,59922,2021-11-30
3173041006,JAKARTA BARAT,TAMBORA,JEMBATAN BESI,29314,6769,22545,18195,40740,2021-11-30
3173041008,JAKARTA BARAT,TAMBORA,JEMBATAN LIMA,21021,4561,16460,13440,29900,2021-11-30
3173081005,JAKARTA BARAT,KEMBANGAN,JOGLO,40839,7856,32983,28584,61567,2021-11-30
3171081001,JAKARTA PUSAT,JOHAR BARU,JOHAR BARU,37488,6691,30797,26608,57405,2021-11-30
3173041002,JAKARTA BARAT,TAMBORA,KALI ANYAR,23856,4517,19339,15821,35160,2021-11-30
3172041004,JAKARTA UTARA,CILINCING,KALIBARU,67684,17702,49982,36678,86660,2021-11-30
3174081002,JAKARTA SELATAN,PANCORAN,KALIBATA,41994,9122,32872,27650,60522,2021-11-30
3173061001,JAKARTA BARAT,KALI DERES,KALIDERES,72447,13886,58561,50785,109346,2021-11-30
3175051004,JAKARTA TIMUR,PASAR REBO,KALISARI,43212,7345,35867,31091,66958,2021-11-30
3173061004,JAKARTA BARAT,KALI DERES,KAMAL,53783,11925,41858,34517,76375,2021-11-30
3172011002,JAKARTA UTARA,PENJARINGAN,KAMAL MUARA,12930,2240,10690,9214,19904,2021-11-30
3171071007,JAKARTA PUSAT,TANAH ABANG,KAMPUNG BALI,11358,2357,9001,7186,16187,2021-11-30
3175031001,JAKARTA TIMUR,JATINEGARA,KAMPUNG MELAYU,25717,5651,20066,16217,36283,2021-11-30
3171081002,JAKARTA PUSAT,JOHAR BARU,KAMPUNG RAWA,21237,3389,17848,14606,32454,2021-11-30
3175041002,JAKARTA TIMUR,KRAMAT JATI,KAMPUNG TENGAH,43993,10449,33544,27656,61200,2021-11-30
3173011005,JAKARTA BARAT,CENGKARENG,KAPUK,134466,30884,103582,86521,190103,2021-11-30
3172011003,JAKARTA UTARA,PENJARINGAN,KAPUK MUARA,35781,6600,29181,26149,55330,2021-11-30
3171021002,JAKARTA PUSAT,SAWAH BESAR,KARANG ANYAR,25761,4691,21070,18102,39172,2021-11-30
3174021004,JAKARTA SELATAN,SETIA BUDI,KARET,9623,1789,7834,6739,14573,2021-11-30
3174021003,JAKARTA SELATAN,SETIA BUDI,KARET KUNINGAN,16055,3009,13046,11365,24411,2021-11-30
3174021002,JAKARTA SELATAN,SETIA BUDI,KARET SEMANGGI,2770,540,2230,2013,4243,2021-11-30
3171071003,JAKARTA PUSAT,TANAH ABANG,KARET TENGSIN,19271,3585,15686,13200,28886,2021-11-30
3171021003,JAKARTA PUSAT,SAWAH BESAR,KARTINI,22292,4023,18269,16039,34308,2021-11-30
3175011003,JAKARTA TIMUR,MATRAMAN,KAYU MANIS,25284,5056,20228,16709,36937,2021-11-30
3175021006,JAKARTA TIMUR,PULO GADUNG,KAYU PUTIH,40696,7409,33287,29745,63032,2021-11-30
3173031006,JAKARTA BARAT,TAMAN SARI,KEAGUNGAN,17387,3099,14288,12047,26335,2021-11-30
3174041007,JAKARTA SELATAN,PASAR MINGGU,KEBAGUSAN,44552,8393,36159,30945,67104,2021-11-30
3174051006,JAKARTA SELATAN,KEBAYORAN LAMA,KEBAYORAN LAMA SELATAN,41212,7303,33909,29700,63609,2021-11-30
3174051001,JAKARTA SELATAN,KEBAYORAN LAMA,KEBAYORAN LAMA UTARA,42422,8399,34023,29232,63255,2021-11-30
3174011004,JAKARTA SELATAN,TEBET,KEBON BARU,35165,6288,28877,24976,53853,2021-11-30
3172021005,JAKARTA UTARA,TANJUNG PRIOK,KEBON BAWANG,50952,9830,41122,35187,76309,2021-11-30
3173051001,JAKARTA BARAT,KEBON JERUK,KEBON JERUK,53887,10491,43396,36469,79865,2021-11-30
3171071006,JAKARTA PUSAT,TANAH ABANG,KEBON KACANG,21531,4951,16580,13594,30174,2021-11-30
3171011005,JAKARTA PUSAT,GAMBIR,KEBON KELAPA,10163,1968,8195,7116,15311,2021-11-30
3171031002,JAKARTA PUSAT,KEMAYORAN,KEBON KOSONG,30019,5757,24262,20617,44879,2021-11-30
3175011005,JAKARTA TIMUR,MATRAMAN,KEBON MANGGIS,16490,3064,13426,11391,24817,2021-11-30
3171071005,JAKARTA PUSAT,TANAH ABANG,KEBON MELATI,32206,8298,23908,18431,42339,2021-11-30
3175081003,JAKARTA TIMUR,MAKASAR,KEBON PALA,46614,8823,37791,32349,70140,2021-11-30
3171061005,JAKARTA PUSAT,MENTENG,KEBON SIRIH,12299,2521,9778,8144,17922,2021-11-30
3173011004,JAKARTA BARAT,CENGKARENG,KEDAUNG KALI ANGKE,32612,6013,26599,22934,49533,2021-11-30
3173051007,JAKARTA BARAT,KEBON JERUK,KEDOYA SELATAN,32165,5664,26501,22483,48984,2021-11-30
3173051006,JAKARTA BARAT,KEBON JERUK,KEDOYA UTARA,45740,8423,37317,32177,69494,2021-11-30
3173051004,JAKARTA BARAT,KEBON JERUK,KELAPA DUA,23565,4438,19127,16404,35531,2021-11-30
3175091003,JAKARTA TIMUR,CIRACAS,KELAPA DUA WETAN,46875,7687,39188,34089,73277,2021-11-30
3172061003,JAKARTA UTARA,KELAPA GADING,KELAPA GADING BARAT,35717,6028,29689,27222,56911,2021-11-30
3172061001,JAKARTA UTARA,KELAPA GADING,KELAPA GADING TIMUR,33592,4988,28604,26918,55522,2021-11-30
3173071005,JAKARTA BARAT,PALMERAH,KEMANGGISAN,32139,5827,26312,22949,49261,2021-11-30
3171031001,JAKARTA PUSAT,KEMAYORAN,KEMAYORAN,20708,3944,16764,14178,30942,2021-11-30
3173081006,JAKARTA BARAT,KEMBANGAN,KEMBANGAN SELATAN,27130,5444,21686,19054,40740,2021-11-30
3173081001,JAKARTA BARAT,KEMBANGAN,KEMBANGAN UTARA,54451,11286,43165,36780,79945,2021-11-30
3171041002,JAKARTA PUSAT,SENEN,KENARI,9579,1808,7771,6768,14539,2021-11-30
3173041005,JAKARTA BARAT,TAMBORA,KERENDANG,19973,3887,16086,13494,29580,2021-11-30
3175071003,JAKARTA TIMUR,DUREN SAWIT,KLENDER,69978,15731,54247,44706,98953,2021-11-30
3172031001,JAKARTA UTARA,KOJA,KOJA,28175,6146,22029,18322,40351,2021-11-30
3173071006,JAKARTA BARAT,PALMERAH,KOTA BAMBU SELATAN,21158,3991,17167,13968,31135,2021-11-30
3173071003,JAKARTA BARAT,PALMERAH,KOTA BAMBU UTARA,24995,4893,20102,16225,36327,2021-11-30
3171041004,JAKARTA PUSAT,SENEN,KRAMAT,28835,6451,22384,17499,39883,2021-11-30
3175041001,JAKARTA TIMUR,KRAMAT JATI,KRAMAT JATI,34144,6960,27184,22695,49879,2021-11-30
3174071003,JAKARTA SELATAN,KEBAYORAN BARU,KRAMAT PELA,14413,2699,11714,10341,22055,2021-11-30
3173031002,JAKARTA BARAT,TAMAN SARI,KRUKUT,19244,3485,15759,13182,28941,2021-11-30
3174031005,JAKARTA SELATAN,MAMPANG PRAPATAN,KUNINGAN BARAT,12785,2240,10545,9091,19636,2021-11-30
3174021008,JAKARTA SELATAN,SETIA BUDI,KUNINGAN TIMUR,6008,1151,4857,4291,9148,2021-11-30
3171041005,JAKARTA PUSAT,SENEN,KWITANG,15486,3298,12188,10064,22252,2021-11-30
3172031003,JAKARTA UTARA,KOJA,LAGOA,59065,13297,45768,37413,83181,2021-11-30
3174061002,JAKARTA SELATAN,CILANDAK,LEBAK BULUS,37626,6811,30815,27754,58569,2021-11-30
3174091004,JAKARTA SELATAN,JAGAKARSA,LENTENG AGUNG,53946,9227,44719,37809,82528,2021-11-30
3175101007,JAKARTA TIMUR,CIPAYUNG,LUBANG BUAYA,63547,11502,52045,44522,96567,2021-11-30
3175081001,JAKARTA TIMUR,MAKASAR,MAKASAR,34390,5892,28498,24878,53376,2021-11-30
3175071006,JAKARTA TIMUR,DUREN SAWIT,MALAKA JAYA,30927,5025,25902,22965,48867,2021-11-30
3175071005,JAKARTA TIMUR,DUREN SAWIT,MALAKA SARI,27530,4359,23171,20659,43830,2021-11-30
3174031001,JAKARTA SELATAN,MAMPANG PRAPATAN,MAMPANG PRAPATAN,18159,3559,14600,12431,27031,2021-11-30
3173031005,JAKARTA BARAT,TAMAN SARI,MANGGA BESAR,7707,1261,6446,5794,12240,2021-11-30
3171021005,JAKARTA PUSAT,SAWAH BESAR,MANGGA DUA SELATAN,27442,5391,22051,19088,41139,2021-11-30
3174011007,JAKARTA SELATAN,TEBET,MANGGARAI,28373,4756,23617,19894,43511,2021-11-30
3174011006,JAKARTA SELATAN,TEBET,MANGGARAI SELATAN,23075,3612,19463,16794,36257,2021-11-30
3173031003,JAKARTA BARAT,TAMAN SARI,MAPHAR,16461,2961,13500,11587,25087,2021-11-30
3172041003,JAKARTA UTARA,CILINCING,MARUNDA,28943,6269,22674,17592,40266,2021-11-30
3174071001,JAKARTA SELATAN,KEBAYORAN BARU,MELAWAI,2627,495,2132,1993,4125,2021-11-30
3171061001,JAKARTA PUSAT,MENTENG,MENTENG,25624,5364,20260,16638,36898,2021-11-30
3174021005,JAKARTA SELATAN,SETIA BUDI,MENTENG ATAS,27816,4770,23046,19884,42930,2021-11-30
3174011003,JAKARTA SELATAN,TEBET,MENTENG DALAM,36028,6704,29324,25510,54834,2021-11-30
3173081003,JAKARTA BARAT,KEMBANGAN,MERUYA SELATAN,32130,6312,25818,22425,48243,2021-11-30
3173081002,JAKARTA BARAT,KEMBANGAN,MERUYA UTARA,43752,8649,35103,31270,66373,2021-11-30
3175101004,JAKARTA TIMUR,CIPAYUNG,MUNJUL,23871,4206,19665,17075,36740,2021-11-30
3172051002,JAKARTA UTARA,PADEMANGAN,PADEMANGAN BARAT,74240,16710,57530,47730,105260,2021-11-30
3172051001,JAKARTA UTARA,PADEMANGAN,PADEMANGAN TIMUR,37736,6394,31342,28270,59612,2021-11-30
3175011004,JAKARTA TIMUR,MATRAMAN,PAL MERIAM,19769,3845,15924,13224,29148,2021-11-30
3173071001,JAKARTA BARAT,PALMERAH,PALMERAH,63011,12602,50409,42408,92817,2021-11-30
3174081001,JAKARTA SELATAN,PANCORAN,PANCORAN,19421,3706,15715,13466,29181,2021-11-30
3172021003,JAKARTA UTARA,TANJUNG PRIOK,PAPANGGO,39097,7355,31742,26823,58565,2021-11-30
3171021001,JAKARTA PUSAT,SAWAH BESAR,PASAR BARU,12035,2211,9824,8963,18787,2021-11-30
3174021006,JAKARTA SELATAN,SETIA BUDI,PASAR MANGGIS,26752,4909,21843,18685,40528,2021-11-30
3174041001,JAKARTA SELATAN,PASAR MINGGU,PASAR MINGGU,24821,4477,20344,17912,38256,2021-11-30
3171041003,JAKARTA PUSAT,SENEN,PASEBAN,23533,4689,18844,15863,34707,2021-11-30
3173061005,JAKARTA BARAT,KALI DERES,PEGADUNGAN,75587,14087,61500,53781,115281,2021-11-30
3171061002,JAKARTA PUSAT,MENTENG,PEGANGSAAN,23455,4819,18636,14945,33581,2021-11-30
3172061002,JAKARTA UTARA,KELAPA GADING,PEGANGSAAN DUA,49976,8002,41974,38629,80603,2021-11-30
3172011004,JAKARTA UTARA,PENJARINGAN,PEJAGALAN,74578,14834,59744,52894,112638,2021-11-30
3174041006,JAKARTA SELATAN,PASAR MINGGU,PEJATEN BARAT,37346,6927,30419,26353,56772,2021-11-30
3174041005,JAKARTA SELATAN,PASAR MINGGU,PEJATEN TIMUR,57656,11885,45771,38329,84100,2021-11-30
3175051005,JAKARTA TIMUR,PASAR REBO,PEKAYON,43250,7509,35741,30683,66424,2021-11-30
3173041009,JAKARTA BARAT,TAMBORA,PEKOJAN,23587,4302,19285,16672,35957,2021-11-30
3174031003,JAKARTA SELATAN,MAMPANG PRAPATAN,PELA MAMPANG,43522,8183,35339,30617,65956,2021-11-30
3174081005,JAKARTA SELATAN,PANCORAN,PENGADEGAN,21478,3782,17696,15527,33223,2021-11-30
3175061003,JAKARTA TIMUR,CAKUNG,PENGGILINGAN,99255,21676,77579,64008,141587,2021-11-30
3172011001,JAKARTA UTARA,PENJARINGAN,PENJARINGAN,88308,21832,66476,53130,119606,2021-11-30
3174101001,JAKARTA SELATAN,PESANGGRAHAN,PESANGGRAHAN,27545,4549,22996,20273,43269,2021-11-30
3171071004,JAKARTA PUSAT,TANAH ABANG,PETAMBURAN,33271,8430,24841,19580,44421,2021-11-30
3174071008,JAKARTA SELATAN,KEBAYORAN BARU,PETOGOGAN,11499,2129,9370,8217,17587,2021-11-30
3171011004,JAKARTA PUSAT,GAMBIR,PETOJO SELATAN,14692,3190,11502,9976,21478,2021-11-30
3171011003,JAKARTA PUSAT,GAMBIR,PETOJO UTARA,17458,3648,13810,11665,25475,2021-11-30
3174101004,JAKARTA SELATAN,PESANGGRAHAN,PETUKANGAN SELATAN,37187,7349,29838,25940,55778,2021-11-30
3174101003,JAKARTA SELATAN,PESANGGRAHAN,PETUKANGAN UTARA,53716,11018,42698,36583,79281,2021-11-30
3175081002,JAKARTA TIMUR,MAKASAR,PINANG RANTI,27198,5671,21527,18278,39805,2021-11-30
3173031008,JAKARTA BARAT,TAMAN SARI,PINANGSIA,10729,1808,8921,7594,16515,2021-11-30
3175011001,JAKARTA TIMUR,MATRAMAN,PISANGAN BARU,31776,6232,25544,21105,46649,2021-11-30
3175021002,JAKARTA TIMUR,PULO GADUNG,PISANGAN TIMUR,41011,7256,33755,29306,63061,2021-11-30
3172011005,JAKARTA UTARA,PENJARINGAN,PLUIT,47783,8982,38801,34698,73499,2021-11-30
3175071002,JAKARTA TIMUR,DUREN SAWIT,PONDOK BAMBU,61550,12403,49147,42381,91528,2021-11-30
3175071004,JAKARTA TIMUR,DUREN SAWIT,PONDOK KELAPA,72015,13746,58269,51318,109587,2021-11-30
3175071007,JAKARTA TIMUR,DUREN SAWIT,PONDOK KOPI,35367,6384,28983,24006,52989,2021-11-30
3174061003,JAKARTA SELATAN,CILANDAK,PONDOK LABU,46464,7361,39103,35073,74176,2021-11-30
3174051002,JAKARTA SELATAN,KEBAYORAN LAMA,PONDOK PINANG,56169,10383,45786,40279,86065,2021-11-30
3175101003,JAKARTA TIMUR,CIPAYUNG,PONDOK RANGGON,25574,4610,20964,18271,39235,2021-11-30
3101011003,KAB.ADM.KEP.SERIBU,KEP. SERIBU UTARA,PULAU HARAPAN,2060,214,1846,1649,3495,2021-11-30
3101011002,KAB.ADM.KEP.SERIBU,KEP. SERIBU UTARA,PULAU KELAPA,5528,575,4953,4133,9086,2021-11-30
3101011001,KAB.ADM.KEP.SERIBU,KEP. SERIBU UTARA,PULAU PANGGANG,5450,425,5025,4535,9560,2021-11-30
3101021003,KAB.ADM.KEP.SERIBU,KEP. SERIBU SELATAN,PULAU PARI,2765,191,2574,2440,5014,2021-11-30
3101021002,KAB.ADM.KEP.SERIBU,KEP. SERIBU SELATAN,PULAU TIDUNG,4553,358,4195,3899,8094,2021-11-30
3101021001,KAB.ADM.KEP.SERIBU,KEP. SERIBU SELATAN,PULAU UNTUNG JAWA,1941,155,1786,1664,3450,2021-11-30
3174071007,JAKARTA SELATAN,KEBAYORAN BARU,PULO,5835,983,4852,4529,9381,2021-11-30
3175021001,JAKARTA TIMUR,PULO GADUNG,PULO GADUNG,34422,7244,27178,23305,50483,2021-11-30
3175061005,JAKARTA TIMUR,CAKUNG,PULO GEBANG,97301,17903,79398,66658,146056,2021-11-30
3174041004,JAKARTA SELATAN,PASAR MINGGU,RAGUNAN,39616,6749,32867,28826,61693,2021-11-30
3175091005,JAKARTA TIMUR,CIRACAS,RAMBUTAN,36771,8260,28511,23933,52444,2021-11-30
3172031006,JAKARTA UTARA,KOJA,RAWA BADAK SELATAN,42179,9540,32639,26658,59297,2021-11-30
3172031004,JAKARTA UTARA,KOJA,RAWA BADAK UTARA,34408,7384,27024,22582,49606,2021-11-30
3174071005,JAKARTA SELATAN,KEBAYORAN BARU,RAWA BARAT,5625,971,4654,4216,8870,2021-11-30
3173011003,JAKARTA BARAT,CENGKARENG,RAWA BUAYA,63799,12016,51783,44171,95954,2021-11-30
3175031004,JAKARTA TIMUR,JATINEGARA,RAWA BUNGA,21434,4953,16481,13849,30330,2021-11-30
3174081003,JAKARTA SELATAN,PANCORAN,RAWA JATI,20509,3755,16754,14735,31489,2021-11-30
3175061002,JAKARTA TIMUR,CAKUNG,RAWA TERATE,24637,4253,20384,17118,37502,2021-11-30
3175021005,JAKARTA TIMUR,PULO GADUNG,RAWAMANGUN,37612,7111,30501,26671,57172,2021-11-30
3171051003,JAKARTA PUSAT,CEMPAKA PUTIH,RAWASARI,21967,4265,17702,15572,33274,2021-11-30
3173041010,JAKARTA BARAT,TAMBORA,ROA MALAKA,3484,600,2884,2630,5514,2021-11-30
3172041006,JAKARTA UTARA,CILINCING,ROROTAN,41668,8016,33652,28023,61675,2021-11-30
3174071004,JAKARTA SELATAN,KEBAYORAN BARU,SELONG,2842,535,2307,2163,4470,2021-11-30
3173061002,JAKARTA BARAT,KALI DERES,SEMANAN,71354,14226,57128,47351,104479,2021-11-30
3172041007,JAKARTA UTARA,CILINCING,SEMPER BARAT,68587,12792,55795,47692,103487,2021-11-30
3172041005,JAKARTA UTARA,CILINCING,SEMPER TIMUR,36267,7422,28845,24094,52939,2021-11-30
3174071006,JAKARTA SELATAN,KEBAYORAN BARU,SENAYAN,2771,635,2136,1898,4034,2021-11-30
3171041001,JAKARTA PUSAT,SENEN,SENEN,6804,1382,5422,4607,10029,2021-11-30
3171031004,JAKARTA PUSAT,KEMAYORAN,SERDANG,29668,5465,24203,20769,44972,2021-11-30
3174021001,JAKARTA SELATAN,SETIA BUDI,SETIA BUDI,3023,583,2440,2145,4585,2021-11-30
3175101005,JAKARTA TIMUR,CIPAYUNG,SETU,20572,3926,16646,14077,30723,2021-11-30
3173071002,JAKARTA BARAT,PALMERAH,SLIPI,16591,2855,13736,11985,25721,2021-11-30
3173081004,JAKARTA BARAT,KEMBANGAN,SRENGSENG,45523,9736,35787,31045,66832,2021-11-30
3174091002,JAKARTA SELATAN,JAGAKARSA,SRENGSENG SAWAH,58196,8503,49693,44002,93695,2021-11-30
3173051003,JAKARTA BARAT,KEBON JERUK,SUKABUMI SELATAN,37033,7429,29604,23659,53263,2021-11-30
3173051002,JAKARTA BARAT,KEBON JERUK,SUKABUMI UTARA,38290,8498,29792,24172,53964,2021-11-30
3172041002,JAKARTA UTARA,CILINCING,SUKAPURA,53949,11659,42290,35797,78087,2021-11-30
3171031007,JAKARTA PUSAT,KEMAYORAN,SUMUR BATU,22717,4120,18597,16272,34869,2021-11-30
3172021004,JAKARTA UTARA,TANJUNG PRIOK,SUNGAI BAMBU,29876,5696,24180,20625,44805,2021-11-30
3172021006,JAKARTA UTARA,TANJUNG PRIOK,SUNTER AGUNG,71805,11958,59847,53707,113554,2021-11-30
3172021002,JAKARTA UTARA,TANJUNG PRIOK,SUNTER JAYA,63031,10620,52411,46624,99035,2021-11-30
3175091004,JAKARTA TIMUR,CIRACAS,SUSUKAN,38257,6915,31342,26900,58242,2021-11-30
3173031001,JAKARTA BARAT,TAMAN SARI,TAMAN SARI,14348,2523,11825,10398,22223,2021-11-30
3173041001,JAKARTA BARAT,TAMBORA,TAMBORA,10204,2111,8093,6704,14797,2021-11-30
3173041004,JAKARTA BARAT,TAMBORA,TANAH SEREAL,26387,4287,22100,18948,41048,2021-11-30
3171081004,JAKARTA PUSAT,JOHAR BARU,TANAH TINGGI,37693,6952,30741,25519,56260,2021-11-30
3173031004,JAKARTA BARAT,TAMAN SARI,TANGKI,13324,2137,11187,9747,20934,2021-11-30
3174091005,JAKARTA SELATAN,JAGAKARSA,TANJUNG BARAT,39770,6465,33305,28522,61827,2021-11-30
3173021005,JAKARTA BARAT,GROGOL PETAMBURAN,TANJUNG DUREN SELATAN,25337,4634,20703,18782,39485,2021-11-30
3173021002,JAKARTA BARAT,GROGOL PETAMBURAN,TANJUNG DUREN UTARA,17010,2756,14254,13096,27350,2021-11-30
3172021001,JAKARTA UTARA,TANJUNG PRIOK,TANJUNG PRIOK,34588,6847,27741,23273,51014,2021-11-30
3174011002,JAKARTA SELATAN,TEBET,TEBET BARAT,21194,3256,17938,16175,34113,2021-11-30
3174011001,JAKARTA SELATAN,TEBET,TEBET TIMUR,18199,2799,15400,14243,29643,2021-11-30
3173061003,JAKARTA BARAT,KALI DERES,TEGAL ALUR,83647,16560,67087,56946,124033,2021-11-30
3174031004,JAKARTA SELATAN,MAMPANG PRAPATAN,TEGAL PARANG,32401,6842,25559,20743,46302,2021-11-30
3173021003,JAKARTA BARAT,GROGOL PETAMBURAN,TOMANG,29605,5233,24372,21558,45930,2021-11-30
3172031005,JAKARTA UTARA,KOJA,TUGU SELATAN,39122,8367,30755,25706,56461,2021-11-30
3172031002,JAKARTA UTARA,KOJA,TUGU UTARA,67670,15359,52311,42769,95080,2021-11-30
3175061006,JAKARTA TIMUR,CAKUNG,UJUNG MENTENG,29934,4938,24996,21836,46832,2021-11-30
3174101005,JAKARTA SELATAN,PESANGGRAHAN,ULUJAMI,40544,8647,31897,27107,59004,2021-11-30
3175011006,JAKARTA TIMUR,MATRAMAN,UTAN KAYU SELATAN,33511,5753,27758,23688,51446,2021-11-30
3175011002,JAKARTA TIMUR,MATRAMAN,UTAN KAYU UTARA,28169,5448,22721,19074,41795,2021-11-30
3171031008,JAKARTA PUSAT,KEMAYORAN,UTAN PANJANG,29208,5515,23693,19731,43424,2021-11-30
3172021007,JAKARTA UTARA,TANJUNG PRIOK,WARAKAS,44401,7828,36573,30403,66976,2021-11-30
3173021007,JAKARTA BARAT,GROGOL PETAMBURAN,WIJAYA KUSUMA,38934,7741,31193,27022,58215,2021-11-30
3172051003,JAKARTA UTARA,PADEMANGAN,ANCOL,23947,5514,18433,15487,33920,2021-12-01
3173041007,JAKARTA BARAT,TAMBORA,ANGKE,29381,5968,23413,19433,42846,2021-12-01
3175041005,JAKARTA TIMUR,KRAMAT JATI,BALE KAMBANG,29074,6779,22295,18123,40418,2021-12-01
3175031003,JAKARTA TIMUR,JATINEGARA,BALI MESTER,9752,1916,7836,6780,14616,2021-12-01
3175101006,JAKARTA TIMUR,CIPAYUNG,BAMBU APUS,26285,4596,21689,18730,40419,2021-12-01
3174031002,JAKARTA SELATAN,MAMPANG PRAPATAN,BANGKA,21566,4339,17227,14724,31951,2021-12-01
3175051002,JAKARTA TIMUR,PASAR REBO,BARU,23886,3769,20117,17822,37939,2021-12-01
3175041004,JAKARTA TIMUR,KRAMAT JATI,BATU AMPAR,47898,10965,36933,30729,67662,2021-12-01
3171071002,JAKARTA PUSAT,TANAH ABANG,BENDUNGAN HILIR,21494,4174,17320,15147,32467,2021-12-01
3175031002,JAKARTA TIMUR,JATINEGARA,BIDARA CINA,36689,8419,28270,23699,51969,2021-12-01
3174101002,JAKARTA SELATAN,PESANGGRAHAN,BINTARO,53098,10250,42848,38240,81088,2021-12-01
3174011005,JAKARTA SELATAN,TEBET,BUKIT DURI,34183,6534,27649,23755,51404,2021-12-01
3171041006,JAKARTA PUSAT,SENEN,BUNGUR,18144,3614,14530,12345,26875,2021-12-01
3175061007,JAKARTA TIMUR,CAKUNG,CAKUNG BARAT,57724,11297,46427,39096,85523,2021-12-01
3175061004,JAKARTA TIMUR,CAKUNG,CAKUNG TIMUR,58287,10946,47341,40386,87727,2021-12-01
3175041007,JAKARTA TIMUR,KRAMAT JATI,CAWANG,32762,6631,26131,21786,47917,2021-12-01
3175101008,JAKARTA TIMUR,CIPAYUNG,CEGER,18932,3513,15419,13243,28662,2021-12-01
3171031006,JAKARTA PUSAT,KEMAYORAN,CEMPAKA BARU,32581,5864,26717,22545,49262,2021-12-01
3171051002,JAKARTA PUSAT,CEMPAKA PUTIH,CEMPAKA PUTIH BARAT,35885,7224,28661,25140,53801,2021-12-01
3171051001,JAKARTA PUSAT,CEMPAKA PUTIH,CEMPAKA PUTIH TIMUR,24292,4799,19493,17520,37013,2021-12-01
3173011001,JAKARTA BARAT,CENGKARENG,CENGKARENG BARAT,66284,12600,53684,47438,101122,2021-12-01
3173011006,JAKARTA BARAT,CENGKARENG,CENGKARENG TIMUR,81027,15321,65706,56371,122077,2021-12-01
3175091002,JAKARTA TIMUR,CIRACAS,CIBUBUR,66364,10942,55422,48325,103747,2021-12-01
3171011002,JAKARTA PUSAT,GAMBIR,CIDENG,15390,2908,12482,11111,23593,2021-12-01
3174091003,JAKARTA SELATAN,JAGAKARSA,CIGANJUR,38497,6195,32302,27835,60137,2021-12-01
3175051003,JAKARTA TIMUR,PASAR REBO,CIJANTUNG,41419,7328,34091,29347,63438,2021-12-01
3171061003,JAKARTA PUSAT,MENTENG,CIKINI,8274,1441,6833,5612,12445,2021-12-01
3174081006,JAKARTA SELATAN,PANCORAN,CIKOKO,10547,1747,8800,7796,16596,2021-12-01
3174061001,JAKARTA SELATAN,CILANDAK,CILANDAK BARAT,51752,8731,43021,38650,81671,2021-12-01
3174041003,JAKARTA SELATAN,PASAR MINGGU,CILANDAK TIMUR,25145,4336,20809,18270,39079,2021-12-01
3175101002,JAKARTA TIMUR,CIPAYUNG,CILANGKAP,27635,4679,22956,20081,43037,2021-12-01
3175041006,JAKARTA TIMUR,KRAMAT JATI,CILILITAN,40181,8031,32150,26886,59036,2021-12-01
3172041001,JAKARTA UTARA,CILINCING,CILINCING,43609,9914,33695,27083,60778,2021-12-01
3175101001,JAKARTA TIMUR,CIPAYUNG,CIPAYUNG,26104,4353,21751,19137,40888,2021-12-01
3174091006,JAKARTA SELATAN,JAGAKARSA,CIPEDAK,38303,6071,32232,28139,60371,2021-12-01
3174061005,JAKARTA SELATAN,CILANDAK,CIPETE SELATAN,26704,4867,21837,19697,41534,2021-12-01
3174071010,JAKARTA SELATAN,KEBAYORAN BARU,CIPETE UTARA,34102,6204,27898,24157,52055,2021-12-01
3175021003,JAKARTA TIMUR,PULO GADUNG,CIPINANG,39306,6797,32509,27961,60470,2021-12-01
3175031007,JAKARTA TIMUR,JATINEGARA,CIPINANG BESAR SELATAN,35212,7925,27287,22329,49616,2021-12-01
3175031008,JAKARTA TIMUR,JATINEGARA,CIPINANG BESAR UTARA,45319,10169,35150,28528,63678,2021-12-01
3175031005,JAKARTA TIMUR,JATINEGARA,CIPINANG CEMPEDAK,32824,6865,25959,22749,48708,2021-12-01
3175081005,JAKARTA TIMUR,MAKASAR,CIPINANG MELAYU,42308,7862,34446,30117,64563,2021-12-01
3175031006,JAKARTA TIMUR,JATINEGARA,CIPINANG MUARA,55243,11210,44033,37136,81169,2021-12-01
3174051003,JAKARTA SELATAN,KEBAYORAN LAMA,CIPULIR,39937,8046,31891,27063,58954,2021-12-01
3175091001,JAKARTA TIMUR,CIRACAS,CIRACAS,64594,11369,53225,45454,98679,2021-12-01
3175041003,JAKARTA TIMUR,KRAMAT JATI,DUKUH,24609,4351,20258,17240,37498,2021-12-01
3175071001,JAKARTA TIMUR,DUREN SAWIT,DUREN SAWIT,61160,12367,48793,42032,90825,2021-12-01
3174081004,JAKARTA SELATAN,PANCORAN,DUREN TIGA,28319,5371,22948,19697,42645,2021-12-01
3173051005,JAKARTA BARAT,KEBON JERUK,DURI KEPA,60138,11384,48754,43025,91779,2021-12-01
3173011002,JAKARTA BARAT,CENGKARENG,DURI KOSAMBI,77923,15842,62081,51751,113832,2021-12-01
3171011006,JAKARTA PUSAT,GAMBIR,DURI PULO,19610,4004,15606,12869,28475,2021-12-01
3173041011,JAKARTA BARAT,TAMBORA,DURI SELATAN,14259,2428,11831,10249,22080,2021-12-01
3173041003,JAKARTA BARAT,TAMBORA,DURI UTARA,19844,3417,16427,13883,30310,2021-12-01
3171081003,JAKARTA PUSAT,JOHAR BARU,GALUR,18243,3431,14812,12247,27059,2021-12-01
3171011001,JAKARTA PUSAT,GAMBIR,GAMBIR,2191,444,1747,1544,3291,2021-12-01
3174061004,JAKARTA SELATAN,CILANDAK,GANDARIA SELATAN,22119,4036,18083,15881,33964,2021-12-01
3174071009,JAKARTA SELATAN,KEBAYORAN BARU,GANDARIA UTARA,39922,7545,32377,28281,60658,2021-12-01
3175051001,JAKARTA TIMUR,PASAR REBO,GEDONG,35755,6891,28864,25034,53898,2021-12-01
3171071001,JAKARTA PUSAT,TANAH ABANG,GELORA,3127,590,2537,2258,4795,2021-12-01
3173031007,JAKARTA BARAT,TAMAN SARI,GLODOK,7837,1142,6695,6174,12869,2021-12-01
3171061004,JAKARTA PUSAT,MENTENG,GONDANGDIA,4100,894,3206,2961,6167,2021-12-01
3173021001,JAKARTA BARAT,GROGOL PETAMBURAN,GROGOL,16876,3207,13669,11879,25548,2021-12-01
3174051005,JAKARTA SELATAN,KEBAYORAN LAMA,GROGOL SELATAN,44251,8424,35827,30659,66486,2021-12-01
3174051004,JAKARTA SELATAN,KEBAYORAN LAMA,GROGOL UTARA,42494,8322,34172,29280,63452,2021-12-01
3174021007,JAKARTA SELATAN,SETIA BUDI,GUNTUR,3985,719,3266,2950,6216,2021-12-01
3174071002,JAKARTA SELATAN,KEBAYORAN BARU,GUNUNG,9436,1696,7740,7036,14776,2021-12-01
3171031005,JAKARTA PUSAT,KEMAYORAN,GUNUNG SAHARI SELATAN,19199,3565,15634,13539,29173,2021-12-01
3171021004,JAKARTA PUSAT,SAWAH BESAR,GUNUNG SAHARI UTARA,16650,2822,13828,12552,26380,2021-12-01
3175081004,JAKARTA TIMUR,MAKASAR,HALIM PERDANA KUSUMAH,28363,3526,24837,23025,47862,2021-12-01
3171031003,JAKARTA PUSAT,KEMAYORAN,HARAPAN MULIA,22557,4184,18373,15462,33835,2021-12-01
3174091001,JAKARTA SELATAN,JAGAKARSA,JAGAKARSA,62389,9742,52647,46201,98848,2021-12-01
3175021007,JAKARTA TIMUR,PULO GADUNG,JATI,32757,5866,26891,23973,50864,2021-12-01
3174041002,JAKARTA SELATAN,PASAR MINGGU,JATI PADANG,37502,6862,30640,26568,57208,2021-12-01
3173071004,JAKARTA BARAT,PALMERAH,JATI PULO,28738,5452,23286,19218,42504,2021-12-01
3175061001,JAKARTA TIMUR,CAKUNG,JATINEGARA,84160,16944,67216,57141,124357,2021-12-01
3175021004,JAKARTA TIMUR,PULO GADUNG,JATINEGARA KAUM,24632,4200,20432,17173,37605,2021-12-01
3173021004,JAKARTA BARAT,GROGOL PETAMBURAN,JELAMBAR,30266,5289,24977,22548,47525,2021-12-01
3173021006,JAKARTA BARAT,GROGOL PETAMBURAN,JELAMBAR BARU,38246,6563,31683,28326,60009,2021-12-01
3173041006,JAKARTA BARAT,TAMBORA,JEMBATAN BESI,29314,6752,22562,18232,40794,2021-12-01
3173041008,JAKARTA BARAT,TAMBORA,JEMBATAN LIMA,21021,4541,16480,13477,29957,2021-12-01
3173081005,JAKARTA BARAT,KEMBANGAN,JOGLO,40839,7836,33003,28635,61638,2021-12-01
3171081001,JAKARTA PUSAT,JOHAR BARU,JOHAR BARU,37488,6673,30815,26653,57468,2021-12-01
3173041002,JAKARTA BARAT,TAMBORA,KALI ANYAR,23856,4509,19347,15865,35212,2021-12-01
3172041004,JAKARTA UTARA,CILINCING,KALIBARU,67684,17668,50016,36754,86770,2021-12-01
3174081002,JAKARTA SELATAN,PANCORAN,KALIBATA,41994,9103,32891,27713,60604,2021-12-01
3173061001,JAKARTA BARAT,KALI DERES,KALIDERES,72447,13857,58590,50885,109475,2021-12-01
3175051004,JAKARTA TIMUR,PASAR REBO,KALISARI,43212,7322,35890,31166,67056,2021-12-01
3173061004,JAKARTA BARAT,KALI DERES,KAMAL,53783,11860,41923,34621,76544,2021-12-01
3172011002,JAKARTA UTARA,PENJARINGAN,KAMAL MUARA,12930,2239,10691,9217,19908,2021-12-01
3171071007,JAKARTA PUSAT,TANAH ABANG,KAMPUNG BALI,11358,2353,9005,7199,16204,2021-12-01
3175031001,JAKARTA TIMUR,JATINEGARA,KAMPUNG MELAYU,25717,5635,20082,16256,36338,2021-12-01
3171081002,JAKARTA PUSAT,JOHAR BARU,KAMPUNG RAWA,21237,3383,17854,14622,32476,2021-12-01
3175041002,JAKARTA TIMUR,KRAMAT JATI,KAMPUNG TENGAH,43993,10421,33572,27717,61289,2021-12-01
3173011005,JAKARTA BARAT,CENGKARENG,KAPUK,134466,30811,103655,86658,190313,2021-12-01
3172011003,JAKARTA UTARA,PENJARINGAN,KAPUK MUARA,35781,6587,29194,26219,55413,2021-12-01
3171021002,JAKARTA PUSAT,SAWAH BESAR,KARANG ANYAR,25761,4662,21099,18130,39229,2021-12-01
3174021004,JAKARTA SELATAN,SETIA BUDI,KARET,9623,1784,7839,6762,14601,2021-12-01
3174021003,JAKARTA SELATAN,SETIA BUDI,KARET KUNINGAN,16055,2991,13064,11406,24470,2021-12-01
3174021002,JAKARTA SELATAN,SETIA BUDI,KARET SEMANGGI,2770,538,2232,2018,4250,2021-12-01
3171071003,JAKARTA PUSAT,TANAH ABANG,KARET TENGSIN,19271,3574,15697,13234,28931,2021-12-01
3171021003,JAKARTA PUSAT,SAWAH BESAR,KARTINI,22292,4012,18280,16062,34342,2021-12-01
3175011003,JAKARTA TIMUR,MATRAMAN,KAYU MANIS,25284,5045,20239,16761,37000,2021-12-01
3175021006,JAKARTA TIMUR,PULO GADUNG,KAYU PUTIH,40696,7385,33311,29813,63124,2021-12-01
3173031006,JAKARTA BARAT,TAMAN SARI,KEAGUNGAN,17387,3090,14297,12067,26364,2021-12-01
3174041007,JAKARTA SELATAN,PASAR MINGGU,KEBAGUSAN,44552,8373,36179,31036,67215,2021-12-01
3174051006,JAKARTA SELATAN,KEBAYORAN LAMA,KEBAYORAN LAMA SELATAN,41212,7262,33950,29805,63755,2021-12-01
3174051001,JAKARTA SELATAN,KEBAYORAN LAMA,KEBAYORAN LAMA UTARA,42422,8381,34041,29289,63330,2021-12-01
3174011004,JAKARTA SELATAN,TEBET,KEBON BARU,35165,6246,28919,25041,53960,2021-12-01
3172021005,JAKARTA UTARA,TANJUNG PRIOK,KEBON BAWANG,50952,9806,41146,35260,76406,2021-12-01
3173051001,JAKARTA BARAT,KEBON JERUK,KEBON JERUK,53887,10467,43420,36552,79972,2021-12-01
3171071006,JAKARTA PUSAT,TANAH ABANG,KEBON KACANG,21531,4942,16589,13627,30216,2021-12-01
3171011005,JAKARTA PUSAT,GAMBIR,KEBON KELAPA,10163,1964,8199,7124,15323,2021-12-01
3171031002,JAKARTA PUSAT,KEMAYORAN,KEBON KOSONG,30019,5746,24273,20653,44926,2021-12-01
3175011005,JAKARTA TIMUR,MATRAMAN,KEBON MANGGIS,16490,3056,13434,11415,24849,2021-12-01
3171071005,JAKARTA PUSAT,TANAH ABANG,KEBON MELATI,32206,8274,23932,18495,42427,2021-12-01
3175081003,JAKARTA TIMUR,MAKASAR,KEBON PALA,46614,8802,37812,32412,70224,2021-12-01
3171061005,JAKARTA PUSAT,MENTENG,KEBON SIRIH,12299,2515,9784,8163,17947,2021-12-01
3173011004,JAKARTA BARAT,CENGKARENG,KEDAUNG KALI ANGKE,32612,6000,26612,22961,49573,2021-12-01
3173051007,JAKARTA BARAT,KEBON JERUK,KEDOYA SELATAN,32165,5653,26512,22525,49037,2021-12-01
3173051006,JAKARTA BARAT,KEBON JERUK,KEDOYA UTARA,45740,8403,37337,32224,69561,2021-12-01
3173051004,JAKARTA BARAT,KEBON JERUK,KELAPA DUA,23565,4424,19141,16441,35582,2021-12-01
3175091003,JAKARTA TIMUR,CIRACAS,KELAPA DUA WETAN,46875,7666,39209,34156,73365,2021-12-01
3172061003,JAKARTA UTARA,KELAPA GADING,KELAPA GADING BARAT,35717,6015,29702,27242,56944,2021-12-01
3172061001,JAKARTA UTARA,KELAPA GADING,KELAPA GADING TIMUR,33592,4962,28630,26941,55571,2021-12-01
3173071005,JAKARTA BARAT,PALMERAH,KEMANGGISAN,32139,5807,26332,23005,49337,2021-12-01
3171031001,JAKARTA PUSAT,KEMAYORAN,KEMAYORAN,20708,3931,16777,14194,30971,2021-12-01
3173081006,JAKARTA BARAT,KEMBANGAN,KEMBANGAN SELATAN,27130,5428,21702,19101,40803,2021-12-01
3173081001,JAKARTA BARAT,KEMBANGAN,KEMBANGAN UTARA,54451,11149,43302,36926,80228,2021-12-01
3171041002,JAKARTA PUSAT,SENEN,KENARI,9579,1803,7776,6781,14557,2021-12-01
3173041005,JAKARTA BARAT,TAMBORA,KERENDANG,19973,3879,16094,13539,29633,2021-12-01
3175071003,JAKARTA TIMUR,DUREN SAWIT,KLENDER,69978,15663,54315,44879,99194,2021-12-01
3172031001,JAKARTA UTARA,KOJA,KOJA,28175,6132,22043,18352,40395,2021-12-01
3173071006,JAKARTA BARAT,PALMERAH,KOTA BAMBU SELATAN,21158,3978,17180,14005,31185,2021-12-01
3173071003,JAKARTA BARAT,PALMERAH,KOTA BAMBU UTARA,24995,4879,20116,16268,36384,2021-12-01
3171041004,JAKARTA PUSAT,SENEN,KRAMAT,28835,6410,22425,17549,39974,2021-12-01
3175041001,JAKARTA TIMUR,KRAMAT JATI,KRAMAT JATI,34144,6939,27205,22733,49938,2021-12-01
3174071003,JAKARTA SELATAN,KEBAYORAN BARU,KRAMAT PELA,14413,2689,11724,10352,22076,2021-12-01
3173031002,JAKARTA BARAT,TAMAN SARI,KRUKUT,19244,3480,15764,13216,28980,2021-12-01
3174031005,JAKARTA SELATAN,MAMPANG PRAPATAN,KUNINGAN BARAT,12785,2225,10560,9110,19670,2021-12-01
3174021008,JAKARTA SELATAN,SETIA BUDI,KUNINGAN TIMUR,6008,1149,4859,4295,9154,2021-12-01
3171041005,JAKARTA PUSAT,SENEN,KWITANG,15486,3271,12215,10094,22309,2021-12-01
3172031003,JAKARTA UTARA,KOJA,LAGOA,59065,13260,45805,37490,83295,2021-12-01
3174061002,JAKARTA SELATAN,CILANDAK,LEBAK BULUS,37626,6793,30833,27800,58633,2021-12-01
3174091004,JAKARTA SELATAN,JAGAKARSA,LENTENG AGUNG,53946,9201,44745,37917,82662,2021-12-01
3175101007,JAKARTA TIMUR,CIPAYUNG,LUBANG BUAYA,63547,11467,52080,44623,96703,2021-12-01
3175081001,JAKARTA TIMUR,MAKASAR,MAKASAR,34390,5886,28504,24906,53410,2021-12-01
3175071006,JAKARTA TIMUR,DUREN SAWIT,MALAKA JAYA,30927,5011,25916,23007,48923,2021-12-01
3175071005,JAKARTA TIMUR,DUREN SAWIT,MALAKA SARI,27530,4352,23178,20704,43882,2021-12-01
3174031001,JAKARTA SELATAN,MAMPANG PRAPATAN,MAMPANG PRAPATAN,18159,3550,14609,12455,27064,2021-12-01
3173031005,JAKARTA BARAT,TAMAN SARI,MANGGA BESAR,7707,1258,6449,5805,12254,2021-12-01
3171021005,JAKARTA PUSAT,SAWAH BESAR,MANGGA DUA SELATAN,27442,5362,22080,19118,41198,2021-12-01
3174011007,JAKARTA SELATAN,TEBET,MANGGARAI,28373,4746,23627,19950,43577,2021-12-01
3174011006,JAKARTA SELATAN,TEBET,MANGGARAI SELATAN,23075,3594,19481,16820,36301,2021-12-01
3173031003,JAKARTA BARAT,TAMAN SARI,MAPHAR,16461,2948,13513,11625,25138,2021-12-01
3172041003,JAKARTA UTARA,CILINCING,MARUNDA,28943,6254,22689,17622,40311,2021-12-01
3174071001,JAKARTA SELATAN,KEBAYORAN BARU,MELAWAI,2627,495,2132,1995,4127,2021-12-01
3171061001,JAKARTA PUSAT,MENTENG,MENTENG,25624,5354,20270,16667,36937,2021-12-01
3174021005,JAKARTA SELATAN,SETIA BUDI,MENTENG ATAS,27816,4757,23059,19902,42961,2021-12-01
3174011003,JAKARTA SELATAN,TEBET,MENTENG DALAM,36028,6686,29342,25606,54948,2021-12-01
3173081003,JAKARTA BARAT,KEMBANGAN,MERUYA SELATAN,32130,6293,25837,22480,48317,2021-12-01
3173081002,JAKARTA BARAT,KEMBANGAN,MERUYA UTARA,43752,8618,35134,31347,66481,2021-12-01
3175101004,JAKARTA TIMUR,CIPAYUNG,MUNJUL,23871,4203,19668,17097,36765,2021-12-01
3172051002,JAKARTA UTARA,PADEMANGAN,PADEMANGAN BARAT,74240,16677,57563,47818,105381,2021-12-01
3172051001,JAKARTA UTARA,PADEMANGAN,PADEMANGAN TIMUR,37736,6375,31361,28304,59665,2021-12-01
3175011004,JAKARTA TIMUR,MATRAMAN,PAL MERIAM,19769,3830,15939,13249,29188,2021-12-01
3173071001,JAKARTA BARAT,PALMERAH,PALMERAH,63011,12546,50465,42502,92967,2021-12-01
3174081001,JAKARTA SELATAN,PANCORAN,PANCORAN,19421,3698,15723,13478,29201,2021-12-01
3172021003,JAKARTA UTARA,TANJUNG PRIOK,PAPANGGO,39097,7338,31759,26891,58650,2021-12-01
3171021001,JAKARTA PUSAT,SAWAH BESAR,PASAR BARU,12035,2203,9832,8970,18802,2021-12-01
3174021006,JAKARTA SELATAN,SETIA BUDI,PASAR MANGGIS,26752,4894,21858,18715,40573,2021-12-01
3174041001,JAKARTA SELATAN,PASAR MINGGU,PASAR MINGGU,24821,4469,20352,17938,38290,2021-12-01
3171041003,JAKARTA PUSAT,SENEN,PASEBAN,23533,4669,18864,15896,34760,2021-12-01
3173061005,JAKARTA BARAT,KALI DERES,PEGADUNGAN,75587,14051,61536,53867,115403,2021-12-01
3171061002,JAKARTA PUSAT,MENTENG,PEGANGSAAN,23455,4811,18644,14986,33630,2021-12-01
3172061002,JAKARTA UTARA,KELAPA GADING,PEGANGSAAN DUA,49976,7982,41994,38669,80663,2021-12-01
3172011004,JAKARTA UTARA,PENJARINGAN,PEJAGALAN,74578,14808,59770,52981,112751,2021-12-01
3174041006,JAKARTA SELATAN,PASAR MINGGU,PEJATEN BARAT,37346,6898,30448,26434,56882,2021-12-01
3174041005,JAKARTA SELATAN,PASAR MINGGU,PEJATEN TIMUR,57656,11847,45809,38387,84196,2021-12-01
3175051005,JAKARTA TIMUR,PASAR REBO,PEKAYON,43250,7478,35772,30749,66521,2021-12-01
3173041009,JAKARTA BARAT,TAMBORA,PEKOJAN,23587,4294,19293,16719,36012,2021-12-01
3174031003,JAKARTA SELATAN,MAMPANG PRAPATAN,PELA MAMPANG,43522,8164,35358,30690,66048,2021-12-01
3174081005,JAKARTA SELATAN,PANCORAN,PENGADEGAN,21478,3778,17700,15547,33247,2021-12-01
3175061003,JAKARTA TIMUR,CAKUNG,PENGGILINGAN,99255,21594,77661,64224,141885,2021-12-01
3172011001,JAKARTA UTARA,PENJARINGAN,PENJARINGAN,88308,21776,66532,53274,119806,2021-12-01
3174101001,JAKARTA SELATAN,PESANGGRAHAN,PESANGGRAHAN,27545,4539,23006,20299,43305,2021-12-01
3171071004,JAKARTA PUSAT,TANAH ABANG,PETAMBURAN,33271,8413,24858,19644,44502,2021-12-01
3174071008,JAKARTA SELATAN,KEBAYORAN BARU,PETOGOGAN,11499,2116,9383,8228,17611,2021-12-01
3171011004,JAKARTA PUSAT,GAMBIR,PETOJO SELATAN,14692,3185,11507,9992,21499,2021-12-01
3171011003,JAKARTA PUSAT,GAMBIR,PETOJO UTARA,17458,3640,13818,11690,25508,2021-12-01
3174101004,JAKARTA SELATAN,PESANGGRAHAN,PETUKANGAN SELATAN,37187,7331,29856,25992,55848,2021-12-01
3174101003,JAKARTA SELATAN,PESANGGRAHAN,PETUKANGAN UTARA,53716,10999,42717,36666,79383,2021-12-01
3175081002,JAKARTA TIMUR,MAKASAR,PINANG RANTI,27198,5663,21535,18313,39848,2021-12-01
3173031008,JAKARTA BARAT,TAMAN SARI,PINANGSIA,10729,1803,8926,7605,16531,2021-12-01
3175011001,JAKARTA TIMUR,MATRAMAN,PISANGAN BARU,31776,6219,25557,21150,46707,2021-12-01
3175021002,JAKARTA TIMUR,PULO GADUNG,PISANGAN TIMUR,41011,7239,33772,29373,63145,2021-12-01
3172011005,JAKARTA UTARA,PENJARINGAN,PLUIT,47783,8969,38814,34722,73536,2021-12-01
3175071002,JAKARTA TIMUR,DUREN SAWIT,PONDOK BAMBU,61550,12374,49176,42464,91640,2021-12-01
3175071004,JAKARTA TIMUR,DUREN SAWIT,PONDOK KELAPA,72015,13728,58287,51358,109645,2021-12-01
3175071007,JAKARTA TIMUR,DUREN SAWIT,PONDOK KOPI,35367,6360,29007,24196,53203,2021-12-01
3174061003,JAKARTA SELATAN,CILANDAK,PONDOK LABU,46464,7338,39126,35129,74255,2021-12-01
3174051002,JAKARTA SELATAN,KEBAYORAN LAMA,PONDOK PINANG,56169,10361,45808,40333,86141,2021-12-01
3175101003,JAKARTA TIMUR,CIPAYUNG,PONDOK RANGGON,25574,4605,20969,18289,39258,2021-12-01
3101011003,KAB.ADM.KEP.SERIBU,KEP. SERIBU UTARA,PULAU HARAPAN,2060,213,1847,1649,3496,2021-12-01
3101011002,KAB.ADM.KEP.SERIBU,KEP. SERIBU UTARA,PULAU KELAPA,5528,570,4958,4145,9103,2021-12-01
3101011001,KAB.ADM.KEP.SERIBU,KEP. SERIBU UTARA,PULAU PANGGANG,5450,423,5027,4535,9562,2021-12-01
3101021003,KAB.ADM.KEP.SERIBU,KEP. SERIBU SELATAN,PULAU PARI,2765,191,2574,2440,5014,2021-12-01
3101021002,KAB.ADM.KEP.SERIBU,KEP. SERIBU SELATAN,PULAU TIDUNG,4553,357,4196,3899,8095,2021-12-01
3101021001,KAB.ADM.KEP.SERIBU,KEP. SERIBU SELATAN,PULAU UNTUNG JAWA,1941,155,1786,1664,3450,2021-12-01
3174071007,JAKARTA SELATAN,KEBAYORAN BARU,PULO,5835,979,4856,4537,9393,2021-12-01
3175021001,JAKARTA TIMUR,PULO GADUNG,PULO GADUNG,34422,7230,27192,23356,50548,2021-12-01
3175061005,JAKARTA TIMUR,CAKUNG,PULO GEBANG,97301,17866,79435,66757,146192,2021-12-01
3174041004,JAKARTA SELATAN,PASAR MINGGU,RAGUNAN,39616,6728,32888,28881,61769,2021-12-01
3175091005,JAKARTA TIMUR,CIRACAS,RAMBUTAN,36771,8245,28526,23970,52496,2021-12-01
3172031006,JAKARTA UTARA,KOJA,RAWA BADAK SELATAN,42179,9506,32673,26709,59382,2021-12-01
3172031004,JAKARTA UTARA,KOJA,RAWA BADAK UTARA,34408,7359,27049,22645,49694,2021-12-01
3174071005,JAKARTA SELATAN,KEBAYORAN BARU,RAWA BARAT,5625,969,4656,4225,8881,2021-12-01
3173011003,JAKARTA BARAT,CENGKARENG,RAWA BUAYA,63799,11989,51810,44250,96060,2021-12-01
3175031004,JAKARTA TIMUR,JATINEGARA,RAWA BUNGA,21434,4931,16503,13878,30381,2021-12-01
3174081003,JAKARTA SELATAN,PANCORAN,RAWA JATI,20509,3743,16766,14758,31524,2021-12-01
3175061002,JAKARTA TIMUR,CAKUNG,RAWA TERATE,24637,4244,20393,17142,37535,2021-12-01
3175021005,JAKARTA TIMUR,PULO GADUNG,RAWAMANGUN,37612,7090,30522,26732,57254,2021-12-01
3171051003,JAKARTA PUSAT,CEMPAKA PUTIH,RAWASARI,21967,4248,17719,15602,33321,2021-12-01
3173041010,JAKARTA BARAT,TAMBORA,ROA MALAKA,3484,598,2886,2632,5518,2021-12-01
3172041006,JAKARTA UTARA,CILINCING,ROROTAN,41668,7992,33676,28077,61753,2021-12-01
3174071004,JAKARTA SELATAN,KEBAYORAN BARU,SELONG,2842,534,2308,2163,4471,2021-12-01
3173061002,JAKARTA BARAT,KALI DERES,SEMANAN,71354,14195,57159,47448,104607,2021-12-01
3172041007,JAKARTA UTARA,CILINCING,SEMPER BARAT,68587,12754,55833,47790,103623,2021-12-01
3172041005,JAKARTA UTARA,CILINCING,SEMPER TIMUR,36267,7399,28868,24134,53002,2021-12-01
3174071006,JAKARTA SELATAN,KEBAYORAN BARU,SENAYAN,2771,634,2137,1904,4041,2021-12-01
3171041001,JAKARTA PUSAT,SENEN,SENEN,6804,1373,5431,4626,10057,2021-12-01
3171031004,JAKARTA PUSAT,KEMAYORAN,SERDANG,29668,5449,24219,20808,45027,2021-12-01
3174021001,JAKARTA SELATAN,SETIA BUDI,SETIA BUDI,3023,581,2442,2145,4587,2021-12-01
3175101005,JAKARTA TIMUR,CIPAYUNG,SETU,20572,3923,16649,14093,30742,2021-12-01
3173071002,JAKARTA BARAT,PALMERAH,SLIPI,16591,2848,13743,12011,25754,2021-12-01
3173081004,JAKARTA BARAT,KEMBANGAN,SRENGSENG,45523,9706,35817,31080,66897,2021-12-01
3174091002,JAKARTA SELATAN,JAGAKARSA,SRENGSENG SAWAH,58196,8471,49725,44094,93819,2021-12-01
3173051003,JAKARTA BARAT,KEBON JERUK,SUKABUMI SELATAN,37033,7390,29643,23709,53352,2021-12-01
3173051002,JAKARTA BARAT,KEBON JERUK,SUKABUMI UTARA,38290,8370,29920,24242,54162,2021-12-01
3172041002,JAKARTA UTARA,CILINCING,SUKAPURA,53949,11623,42326,35864,78190,2021-12-01
3171031007,JAKARTA PUSAT,KEMAYORAN,SUMUR BATU,22717,4108,18609,16305,34914,2021-12-01
3172021004,JAKARTA UTARA,TANJUNG PRIOK,SUNGAI BAMBU,29876,5678,24198,20674,44872,2021-12-01
3172021006,JAKARTA UTARA,TANJUNG PRIOK,SUNTER AGUNG,71805,11927,59878,53794,113672,2021-12-01
3172021002,JAKARTA UTARA,TANJUNG PRIOK,SUNTER JAYA,63031,10588,52443,46721,99164,2021-12-01
3175091004,JAKARTA TIMUR,CIRACAS,SUSUKAN,38257,6906,31351,26939,58290,2021-12-01
3173031001,JAKARTA BARAT,TAMAN SARI,TAMAN SARI,14348,2519,11829,10415,22244,2021-12-01
3173041001,JAKARTA BARAT,TAMBORA,TAMBORA,10204,2108,8096,6715,14811,2021-12-01
3173041004,JAKARTA BARAT,TAMBORA,TANAH SEREAL,26387,4274,22113,18977,41090,2021-12-01
3171081004,JAKARTA PUSAT,JOHAR BARU,TANAH TINGGI,37693,6933,30760,25561,56321,2021-12-01
3173031004,JAKARTA BARAT,TAMAN SARI,TANGKI,13324,2135,11189,9776,20965,2021-12-01
3174091005,JAKARTA SELATAN,JAGAKARSA,TANJUNG BARAT,39770,6457,33313,28668,61981,2021-12-01
3173021005,JAKARTA BARAT,GROGOL PETAMBURAN,TANJUNG DUREN SELATAN,25337,4625,20712,18822,39534,2021-12-01
3173021002,JAKARTA BARAT,GROGOL PETAMBURAN,TANJUNG DUREN UTARA,17010,2748,14262,13108,27370,2021-12-01
3172021001,JAKARTA UTARA,TANJUNG PRIOK,TANJUNG PRIOK,34588,6836,27752,23317,51069,2021-12-01
3174011002,JAKARTA SELATAN,TEBET,TEBET BARAT,21194,3242,17952,16235,34187,2021-12-01
3174011001,JAKARTA SELATAN,TEBET,TEBET TIMUR,18199,2795,15404,14261,29665,2021-12-01
3173061003,JAKARTA BARAT,KALI DERES,TEGAL ALUR,83647,16531,67116,57060,124176,2021-12-01
3174031004,JAKARTA SELATAN,MAMPANG PRAPATAN,TEGAL PARANG,32401,6815,25586,20781,46367,2021-12-01
3173021003,JAKARTA BARAT,GROGOL PETAMBURAN,TOMANG,29605,5217,24388,21615,46003,2021-12-01
3172031005,JAKARTA UTARA,KOJA,TUGU SELATAN,39122,8324,30798,25774,56572,2021-12-01
3172031002,JAKARTA UTARA,KOJA,TUGU UTARA,67670,15327,52343,42849,95192,2021-12-01
3175061006,JAKARTA TIMUR,CAKUNG,UJUNG MENTENG,29934,4916,25018,21885,46903,2021-12-01
3174101005,JAKARTA SELATAN,PESANGGRAHAN,ULUJAMI,40544,8626,31918,27168,59086,2021-12-01
3175011006,JAKARTA TIMUR,MATRAMAN,UTAN KAYU SELATAN,33511,5732,27779,23755,51534,2021-12-01
3175011002,JAKARTA TIMUR,MATRAMAN,UTAN KAYU UTARA,28169,5435,22734,19113,41847,2021-12-01
3171031008,JAKARTA PUSAT,KEMAYORAN,UTAN PANJANG,29208,5495,23713,19772,43485,2021-12-01
3172021007,JAKARTA UTARA,TANJUNG PRIOK,WARAKAS,44401,7816,36585,30502,67087,2021-12-01
3173021007,JAKARTA BARAT,GROGOL PETAMBURAN,WIJAYA KUSUMA,38934,7706,31228,27069,58297,2021-12-01
3172051003,JAKARTA UTARA,PADEMANGAN,ANCOL,23947,5496,18451,15507,33958,2021-12-02
3173041007,JAKARTA BARAT,TAMBORA,ANGKE,29381,5954,23427,19475,42902,2021-12-02
3175041005,JAKARTA TIMUR,KRAMAT JATI,BALE KAMBANG,29074,6758,22316,18153,40469,2021-12-02
3175031003,JAKARTA TIMUR,JATINEGARA,BALI MESTER,9752,1914,7838,6792,14630,2021-12-02
3175101006,JAKARTA TIMUR,CIPAYUNG,BAMBU APUS,26285,4587,21698,18770,40468,2021-12-02
3174031002,JAKARTA SELATAN,MAMPANG PRAPATAN,BANGKA,21566,4332,17234,14758,31992,2021-12-02
3175051002,JAKARTA TIMUR,PASAR REBO,BARU,23886,3754,20132,17866,37998,2021-12-02
3175041004,JAKARTA TIMUR,KRAMAT JATI,BATU AMPAR,47898,10936,36962,30785,67747,2021-12-02
3171071002,JAKARTA PUSAT,TANAH ABANG,BENDUNGAN HILIR,21494,4167,17327,15171,32498,2021-12-02
3175031002,JAKARTA TIMUR,JATINEGARA,BIDARA CINA,36689,8399,28290,23741,52031,2021-12-02
3174101002,JAKARTA SELATAN,PESANGGRAHAN,BINTARO,53098,10232,42866,38309,81175,2021-12-02
3174011005,JAKARTA SELATAN,TEBET,BUKIT DURI,34183,6516,27667,23794,51461,2021-12-02
3171041006,JAKARTA PUSAT,SENEN,BUNGUR,18144,3604,14540,12371,26911,2021-12-02
3175061007,JAKARTA TIMUR,CAKUNG,CAKUNG BARAT,57724,11260,46464,39209,85673,2021-12-02
3175061004,JAKARTA TIMUR,CAKUNG,CAKUNG TIMUR,58287,10921,47366,40463,87829,2021-12-02
3175041007,JAKARTA TIMUR,KRAMAT JATI,CAWANG,32762,6610,26152,21824,47976,2021-12-02
3175101008,JAKARTA TIMUR,CIPAYUNG,CEGER,18932,3507,15425,13258,28683,2021-12-02
3171031006,JAKARTA PUSAT,KEMAYORAN,CEMPAKA BARU,32581,5851,26730,22602,49332,2021-12-02
3171051002,JAKARTA PUSAT,CEMPAKA PUTIH,CEMPAKA PUTIH BARAT,35885,7202,28683,25184,53867,2021-12-02
3171051001,JAKARTA PUSAT,CEMPAKA PUTIH,CEMPAKA PUTIH TIMUR,24292,4790,19502,17545,37047,2021-12-02
3173011001,JAKARTA BARAT,CENGKARENG,CENGKARENG BARAT,66284,12576,53708,47497,101205,2021-12-02
3173011006,JAKARTA BARAT,CENGKARENG,CENGKARENG TIMUR,81027,15291,65736,56475,122211,2021-12-02
3175091002,JAKARTA TIMUR,CIRACAS,CIBUBUR,66364,10911,55453,48427,103880,2021-12-02
3171011002,JAKARTA PUSAT,GAMBIR,CIDENG,15390,2902,12488,11121,23609,2021-12-02
3174091003,JAKARTA SELATAN,JAGAKARSA,CIGANJUR,38497,6181,32316,27893,60209,2021-12-02
3175051003,JAKARTA TIMUR,PASAR REBO,CIJANTUNG,41419,7312,34107,29396,63503,2021-12-02
3171061003,JAKARTA PUSAT,MENTENG,CIKINI,8274,1433,6841,5636,12477,2021-12-02
3174081006,JAKARTA SELATAN,PANCORAN,CIKOKO,10547,1742,8805,7811,16616,2021-12-02
3174061001,JAKARTA SELATAN,CILANDAK,CILANDAK BARAT,51752,8717,43035,38707,81742,2021-12-02
3174041003,JAKARTA SELATAN,PASAR MINGGU,CILANDAK TIMUR,25145,4326,20819,18300,39119,2021-12-02
3175101002,JAKARTA TIMUR,CIPAYUNG,CILANGKAP,27635,4675,22960,20112,43072,2021-12-02
3175041006,JAKARTA TIMUR,KRAMAT JATI,CILILITAN,40181,8001,32180,26946,59126,2021-12-02
3172041001,JAKARTA UTARA,CILINCING,CILINCING,43609,9891,33718,27140,60858,2021-12-02
3175101001,JAKARTA TIMUR,CIPAYUNG,CIPAYUNG,26104,4344,21760,19153,40913,2021-12-02
3174091006,JAKARTA SELATAN,JAGAKARSA,CIPEDAK,38303,6063,32240,28189,60429,2021-12-02
3174061005,JAKARTA SELATAN,CILANDAK,CIPETE SELATAN,26704,4855,21849,19725,41574,2021-12-02
3174071010,JAKARTA SELATAN,KEBAYORAN BARU,CIPETE UTARA,34102,6193,27909,24212,52121,2021-12-02
3175021003,JAKARTA TIMUR,PULO GADUNG,CIPINANG,39306,6767,32539,28017,60556,2021-12-02
3175031007,JAKARTA TIMUR,JATINEGARA,CIPINANG BESAR SELATAN,35212,7917,27295,22445,49740,2021-12-02
3175031008,JAKARTA TIMUR,JATINEGARA,CIPINANG BESAR UTARA,45319,10130,35189,28656,63845,2021-12-02
3175031005,JAKARTA TIMUR,JATINEGARA,CIPINANG CEMPEDAK,32824,6858,25966,22789,48755,2021-12-02
3175081005,JAKARTA TIMUR,MAKASAR,CIPINANG MELAYU,42308,7853,34455,30165,64620,2021-12-02
3175031006,JAKARTA TIMUR,JATINEGARA,CIPINANG MUARA,55243,11181,44062,37243,81305,2021-12-02
3174051003,JAKARTA SELATAN,KEBAYORAN LAMA,CIPULIR,39937,8031,31906,27098,59004,2021-12-02
3175091001,JAKARTA TIMUR,CIRACAS,CIRACAS,64594,11342,53252,45523,98775,2021-12-02
3175041003,JAKARTA TIMUR,KRAMAT JATI,DUKUH,24609,4340,20269,17269,37538,2021-12-02
3175071001,JAKARTA TIMUR,DUREN SAWIT,DUREN SAWIT,61160,12338,48822,42127,90949,2021-12-02
3174081004,JAKARTA SELATAN,PANCORAN,DUREN TIGA,28319,5343,22976,19754,42730,2021-12-02
3173051005,JAKARTA BARAT,KEBON JERUK,DURI KEPA,60138,11364,48774,43078,91852,2021-12-02
3173011002,JAKARTA BARAT,CENGKARENG,DURI KOSAMBI,77923,15818,62105,51823,113928,2021-12-02
3171011006,JAKARTA PUSAT,GAMBIR,DURI PULO,19610,3993,15617,12885,28502,2021-12-02
3173041011,JAKARTA BARAT,TAMBORA,DURI SELATAN,14259,2422,11837,10259,22096,2021-12-02
3173041003,JAKARTA BARAT,TAMBORA,DURI UTARA,19844,3410,16434,13919,30353,2021-12-02
3171081003,JAKARTA PUSAT,JOHAR BARU,GALUR,18243,3426,14817,12261,27078,2021-12-02
3171011001,JAKARTA PUSAT,GAMBIR,GAMBIR,2191,444,1747,1546,3293,2021-12-02
3174061004,JAKARTA SELATAN,CILANDAK,GANDARIA SELATAN,22119,4019,18100,15912,34012,2021-12-02
3174071009,JAKARTA SELATAN,KEBAYORAN BARU,GANDARIA UTARA,39922,7522,32400,28342,60742,2021-12-02
3175051001,JAKARTA TIMUR,PASAR REBO,GEDONG,35755,6873,28882,25060,53942,2021-12-02
3171071001,JAKARTA PUSAT,TANAH ABANG,GELORA,3127,590,2537,2261,4798,2021-12-02
3173031007,JAKARTA BARAT,TAMAN SARI,GLODOK,7837,1141,6696,6178,12874,2021-12-02
3171061004,JAKARTA PUSAT,MENTENG,GONDANGDIA,4100,893,3207,2967,6174,2021-12-02
3173021001,JAKARTA BARAT,GROGOL PETAMBURAN,GROGOL,16876,3199,13677,11902,25579,2021-12-02
3174051005,JAKARTA SELATAN,KEBAYORAN LAMA,GROGOL SELATAN,44251,8407,35844,30705,66549,2021-12-02
3174051004,JAKARTA SELATAN,KEBAYORAN LAMA,GROGOL UTARA,42494,8303,34191,29337,63528,2021-12-02
3174021007,JAKARTA SELATAN,SETIA BUDI,GUNTUR,3985,719,3266,2954,6220,2021-12-02
3174071002,JAKARTA SELATAN,KEBAYORAN BARU,GUNUNG,9436,1693,7743,7048,14791,2021-12-02
3171031005,JAKARTA PUSAT,KEMAYORAN,GUNUNG SAHARI SELATAN,19199,3554,15645,13566,29211,2021-12-02
3171021004,JAKARTA PUSAT,SAWAH BESAR,GUNUNG SAHARI UTARA,16650,2815,13835,12565,26400,2021-12-02
3175081004,JAKARTA TIMUR,MAKASAR,HALIM PERDANA KUSUMAH,28363,3510,24853,23063,47916,2021-12-02
3171031003,JAKARTA PUSAT,KEMAYORAN,HARAPAN MULIA,22557,4164,18393,15512,33905,2021-12-02
3174091001,JAKARTA SELATAN,JAGAKARSA,JAGAKARSA,62389,9709,52680,46283,98963,2021-12-02
3175021007,JAKARTA TIMUR,PULO GADUNG,JATI,32757,5861,26896,24031,50927,2021-12-02
3174041002,JAKARTA SELATAN,PASAR MINGGU,JATI PADANG,37502,6829,30673,26656,57329,2021-12-02
3173071004,JAKARTA BARAT,PALMERAH,JATI PULO,28738,5444,23294,19249,42543,2021-12-02
3175061001,JAKARTA TIMUR,CAKUNG,JATINEGARA,84160,16920,67240,57226,124466,2021-12-02
3175021004,JAKARTA TIMUR,PULO GADUNG,JATINEGARA KAUM,24632,4192,20440,17219,37659,2021-12-02
3173021004,JAKARTA BARAT,GROGOL PETAMBURAN,JELAMBAR,30266,5275,24991,22584,47575,2021-12-02
3173021006,JAKARTA BARAT,GROGOL PETAMBURAN,JELAMBAR BARU,38246,6534,31712,28394,60106,2021-12-02
3173041006,JAKARTA BARAT,TAMBORA,JEMBATAN BESI,29314,6741,22573,18255,40828,2021-12-02
3173041008,JAKARTA BARAT,TAMBORA,JEMBATAN LIMA,21021,4517,16504,13500,30004,2021-12-02
3173081005,JAKARTA BARAT,KEMBANGAN,JOGLO,40839,7815,33024,28680,61704,2021-12-02
3171081001,JAKARTA PUSAT,JOHAR BARU,JOHAR BARU,37488,6659,30829,26690,57519,2021-12-02
3173041002,JAKARTA BARAT,TAMBORA,KALI ANYAR,23856,4501,19355,15905,35260,2021-12-02
3172041004,JAKARTA UTARA,CILINCING,KALIBARU,67684,17638,50046,36810,86856,2021-12-02
3174081002,JAKARTA SELATAN,PANCORAN,KALIBATA,41994,9086,32908,27775,60683,2021-12-02
3173061001,JAKARTA BARAT,KALI DERES,KALIDERES,72447,13823,58624,51022,109646,2021-12-02
3175051004,JAKARTA TIMUR,PASAR REBO,KALISARI,43212,7297,35915,31234,67149,2021-12-02
3173061004,JAKARTA BARAT,KALI DERES,KAMAL,53783,11812,41971,34718,76689,2021-12-02
3172011002,JAKARTA UTARA,PENJARINGAN,KAMAL MUARA,12930,2237,10693,9223,19916,2021-12-02
3171071007,JAKARTA PUSAT,TANAH ABANG,KAMPUNG BALI,11358,2347,9011,7219,16230,2021-12-02
3175031001,JAKARTA TIMUR,JATINEGARA,KAMPUNG MELAYU,25717,5623,20094,16307,36401,2021-12-02
3171081002,JAKARTA PUSAT,JOHAR BARU,KAMPUNG RAWA,21237,3373,17864,14637,32501,2021-12-02
3175041002,JAKARTA TIMUR,KRAMAT JATI,KAMPUNG TENGAH,43993,10402,33591,27770,61361,2021-12-02
3173011005,JAKARTA BARAT,CENGKARENG,KAPUK,134466,30749,103717,86792,190509,2021-12-02
3172011003,JAKARTA UTARA,PENJARINGAN,KAPUK MUARA,35781,6572,29209,26249,55458,2021-12-02
3171021002,JAKARTA PUSAT,SAWAH BESAR,KARANG ANYAR,25761,4643,21118,18161,39279,2021-12-02
3174021004,JAKARTA SELATAN,SETIA BUDI,KARET,9623,1782,7841,6775,14616,2021-12-02
3174021003,JAKARTA SELATAN,SETIA BUDI,KARET KUNINGAN,16055,2988,13067,11418,24485,2021-12-02
3174021002,JAKARTA SELATAN,SETIA BUDI,KARET SEMANGGI,2770,537,2233,2018,4251,2021-12-02
3171071003,JAKARTA PUSAT,TANAH ABANG,KARET TENGSIN,19271,3570,15701,13263,28964,2021-12-02
3171021003,JAKARTA PUSAT,SAWAH BESAR,KARTINI,22292,4002,18290,16099,34389,2021-12-02
3175011003,JAKARTA TIMUR,MATRAMAN,KAYU MANIS,25284,5024,20260,16796,37056,2021-12-02
3175021006,JAKARTA TIMUR,PULO GADUNG,KAYU PUTIH,40696,7367,33329,29845,63174,2021-12-02
3173031006,JAKARTA BARAT,TAMAN SARI,KEAGUNGAN,17387,3086,14301,12086,26387,2021-12-02
3174041007,JAKARTA SELATAN,PASAR MINGGU,KEBAGUSAN,44552,8348,36204,31109,67313,2021-12-02
3174051006,JAKARTA SELATAN,KEBAYORAN LAMA,KEBAYORAN LAMA SELATAN,41212,7247,33965,29842,63807,2021-12-02
3174051001,JAKARTA SELATAN,KEBAYORAN LAMA,KEBAYORAN LAMA UTARA,42422,8370,34052,29328,63380,2021-12-02
3174011004,JAKARTA SELATAN,TEBET,KEBON BARU,35165,6218,28947,25091,54038,2021-12-02
3172021005,JAKARTA UTARA,TANJUNG PRIOK,KEBON BAWANG,50952,9781,41171,35304,76475,2021-12-02
3173051001,JAKARTA BARAT,KEBON JERUK,KEBON JERUK,53887,10445,43442,36622,80064,2021-12-02
3171071006,JAKARTA PUSAT,TANAH ABANG,KEBON KACANG,21531,4933,16598,13653,30251,2021-12-02
3171011005,JAKARTA PUSAT,GAMBIR,KEBON KELAPA,10163,1961,8202,7131,15333,2021-12-02
3171031002,JAKARTA PUSAT,KEMAYORAN,KEBON KOSONG,30019,5733,24286,20701,44987,2021-12-02
3175011005,JAKARTA TIMUR,MATRAMAN,KEBON MANGGIS,16490,3042,13448,11445,24893,2021-12-02
3171071005,JAKARTA PUSAT,TANAH ABANG,KEBON MELATI,32206,8256,23950,18532,42482,2021-12-02
3175081003,JAKARTA TIMUR,MAKASAR,KEBON PALA,46614,8794,37820,32478,70298,2021-12-02
3171061005,JAKARTA PUSAT,MENTENG,KEBON SIRIH,12299,2507,9792,8179,17971,2021-12-02
3173011004,JAKARTA BARAT,CENGKARENG,KEDAUNG KALI ANGKE,32612,5987,26625,22990,49615,2021-12-02
3173051007,JAKARTA BARAT,KEBON JERUK,KEDOYA SELATAN,32165,5652,26513,22565,49078,2021-12-02
3173051006,JAKARTA BARAT,KEBON JERUK,KEDOYA UTARA,45740,8395,37345,32248,69593,2021-12-02
3173051004,JAKARTA BARAT,KEBON JERUK,KELAPA DUA,23565,4409,19156,16471,35627,2021-12-02
3175091003,JAKARTA TIMUR,CIRACAS,KELAPA DUA WETAN,46875,7656,39219,34190,73409,2021-12-02
3172061003,JAKARTA UTARA,KELAPA GADING,KELAPA GADING BARAT,35717,6000,29717,27266,56983,2021-12-02
3172061001,JAKARTA UTARA,KELAPA GADING,KELAPA GADING TIMUR,33592,4959,28633,26962,55595,2021-12-02
3173071005,JAKARTA BARAT,PALMERAH,KEMANGGISAN,32139,5796,26343,23048,49391,2021-12-02
3171031001,JAKARTA PUSAT,KEMAYORAN,KEMAYORAN,20708,3920,16788,14235,31023,2021-12-02
3173081006,JAKARTA BARAT,KEMBANGAN,KEMBANGAN SELATAN,27130,5426,21704,19116,40820,2021-12-02
3173081001,JAKARTA BARAT,KEMBANGAN,KEMBANGAN UTARA,54451,11129,43322,36981,80303,2021-12-02
3171041002,JAKARTA PUSAT,SENEN,KENARI,9579,1799,7780,6790,14570,2021-12-02
3173041005,JAKARTA BARAT,TAMBORA,KERENDANG,19973,3871,16102,13563,29665,2021-12-02
3175071003,JAKARTA TIMUR,DUREN SAWIT,KLENDER,69978,15606,54372,45068,99440,2021-12-02
3172031001,JAKARTA UTARA,KOJA,KOJA,28175,6116,22059,18386,40445,2021-12-02
3173071006,JAKARTA BARAT,PALMERAH,KOTA BAMBU SELATAN,21158,3967,17191,14066,31257,2021-12-02
3173071003,JAKARTA BARAT,PALMERAH,KOTA BAMBU UTARA,24995,4872,20123,16340,36463,2021-12-02
3171041004,JAKARTA PUSAT,SENEN,KRAMAT,28835,6304,22531,17593,40124,2021-12-02
3175041001,JAKARTA TIMUR,KRAMAT JATI,KRAMAT JATI,34144,6915,27229,22772,50001,2021-12-02
3174071003,JAKARTA SELATAN,KEBAYORAN BARU,KRAMAT PELA,14413,2685,11728,10363,22091,2021-12-02
3173031002,JAKARTA BARAT,TAMAN SARI,KRUKUT,19244,3474,15770,13239,29009,2021-12-02
3174031005,JAKARTA SELATAN,MAMPANG PRAPATAN,KUNINGAN BARAT,12785,2216,10569,9135,19704,2021-12-02
3174021008,JAKARTA SELATAN,SETIA BUDI,KUNINGAN TIMUR,6008,1147,4861,4303,9164,2021-12-02
3171041005,JAKARTA PUSAT,SENEN,KWITANG,15486,3245,12241,10108,22349,2021-12-02
3172031003,JAKARTA UTARA,KOJA,LAGOA,59065,13240,45825,37542,83367,2021-12-02
3174061002,JAKARTA SELATAN,CILANDAK,LEBAK BULUS,37626,6785,30841,27839,58680,2021-12-02
3174091004,JAKARTA SELATAN,JAGAKARSA,LENTENG AGUNG,53946,9184,44762,37984,82746,2021-12-02
3175101007,JAKARTA TIMUR,CIPAYUNG,LUBANG BUAYA,63547,11458,52089,44666,96755,2021-12-02
3175081001,JAKARTA TIMUR,MAKASAR,MAKASAR,34390,5871,28519,24990,53509,2021-12-02
3175071006,JAKARTA TIMUR,DUREN SAWIT,MALAKA JAYA,30927,4990,25937,23043,48980,2021-12-02
3175071005,JAKARTA TIMUR,DUREN SAWIT,MALAKA SARI,27530,4345,23185,20746,43931,2021-12-02
3174031001,JAKARTA SELATAN,MAMPANG PRAPATAN,MAMPANG PRAPATAN,18159,3536,14623,12494,27117,2021-12-02
3173031005,JAKARTA BARAT,TAMAN SARI,MANGGA BESAR,7707,1257,6450,5812,12262,2021-12-02
3171021005,JAKARTA PUSAT,SAWAH BESAR,MANGGA DUA SELATAN,27442,5349,22093,19145,41238,2021-12-02
3174011007,JAKARTA SELATAN,TEBET,MANGGARAI,28373,4739,23634,19976,43610,2021-12-02
3174011006,JAKARTA SELATAN,TEBET,MANGGARAI SELATAN,23075,3547,19528,16871,36399,2021-12-02
3173031003,JAKARTA BARAT,TAMAN SARI,MAPHAR,16461,2943,13518,11643,25161,2021-12-02
3172041003,JAKARTA UTARA,CILINCING,MARUNDA,28943,6212,22731,17694,40425,2021-12-02
3174071001,JAKARTA SELATAN,KEBAYORAN BARU,MELAWAI,2627,495,2132,1996,4128,2021-12-02
3171061001,JAKARTA PUSAT,MENTENG,MENTENG,25624,5344,20280,16693,36973,2021-12-02
3174021005,JAKARTA SELATAN,SETIA BUDI,MENTENG ATAS,27816,4739,23077,19942,43019,2021-12-02
3174011003,JAKARTA SELATAN,TEBET,MENTENG DALAM,36028,6673,29355,25635,54990,2021-12-02
3173081003,JAKARTA BARAT,KEMBANGAN,MERUYA SELATAN,32130,6281,25849,22503,48352,2021-12-02
3173081002,JAKARTA BARAT,KEMBANGAN,MERUYA UTARA,43752,8600,35152,31390,66542,2021-12-02
3175101004,JAKARTA TIMUR,CIPAYUNG,MUNJUL,23871,4198,19673,17123,36796,2021-12-02
3172051002,JAKARTA UTARA,PADEMANGAN,PADEMANGAN BARAT,74240,16637,57603,47891,105494,2021-12-02
3172051001,JAKARTA UTARA,PADEMANGAN,PADEMANGAN TIMUR,37736,6366,31370,28335,59705,2021-12-02
3175011004,JAKARTA TIMUR,MATRAMAN,PAL MERIAM,19769,3823,15946,13287,29233,2021-12-02
3173071001,JAKARTA BARAT,PALMERAH,PALMERAH,63011,12511,50500,42601,93101,2021-12-02
3174081001,JAKARTA SELATAN,PANCORAN,PANCORAN,19421,3665,15756,13532,29288,2021-12-02
3172021003,JAKARTA UTARA,TANJUNG PRIOK,PAPANGGO,39097,7323,31774,26940,58714,2021-12-02
3171021001,JAKARTA PUSAT,SAWAH BESAR,PASAR BARU,12035,2198,9837,8976,18813,2021-12-02
3174021006,JAKARTA SELATAN,SETIA BUDI,PASAR MANGGIS,26752,4854,21898,18762,40660,2021-12-02
3174041001,JAKARTA SELATAN,PASAR MINGGU,PASAR MINGGU,24821,4461,20360,17965,38325,2021-12-02
3171041003,JAKARTA PUSAT,SENEN,PASEBAN,23533,4656,18877,15930,34807,2021-12-02
3173061005,JAKARTA BARAT,KALI DERES,PEGADUNGAN,75587,13997,61590,53971,115561,2021-12-02
3171061002,JAKARTA PUSAT,MENTENG,PEGANGSAAN,23455,4808,18647,15015,33662,2021-12-02
3172061002,JAKARTA UTARA,KELAPA GADING,PEGANGSAAN DUA,49976,7972,42004,38688,80692,2021-12-02
3172011004,JAKARTA UTARA,PENJARINGAN,PEJAGALAN,74578,14790,59788,53073,112861,2021-12-02
3174041006,JAKARTA SELATAN,PASAR MINGGU,PEJATEN BARAT,37346,6865,30481,26520,57001,2021-12-02
3174041005,JAKARTA SELATAN,PASAR MINGGU,PEJATEN TIMUR,57656,11817,45839,38448,84287,2021-12-02
3175051005,JAKARTA TIMUR,PASAR REBO,PEKAYON,43250,7457,35793,30820,66613,2021-12-02
3173041009,JAKARTA BARAT,TAMBORA,PEKOJAN,23587,4289,19298,16745,36043,2021-12-02
3174031003,JAKARTA SELATAN,MAMPANG PRAPATAN,PELA MAMPANG,43522,8151,35371,30755,66126,2021-12-02
3174081005,JAKARTA SELATAN,PANCORAN,PENGADEGAN,21478,3771,17707,15576,33283,2021-12-02
3175061003,JAKARTA TIMUR,CAKUNG,PENGGILINGAN,99255,21528,77727,64389,142116,2021-12-02
3172011001,JAKARTA UTARA,PENJARINGAN,PENJARINGAN,88308,21726,66582,53381,119963,2021-12-02
3174101001,JAKARTA SELATAN,PESANGGRAHAN,PESANGGRAHAN,27545,4531,23014,20324,43338,2021-12-02
3171071004,JAKARTA PUSAT,TANAH ABANG,PETAMBURAN,33271,8395,24876,19699,44575,2021-12-02
3174071008,JAKARTA SELATAN,KEBAYORAN BARU,PETOGOGAN,11499,2110,9389,8236,17625,2021-12-02
3171011004,JAKARTA PUSAT,GAMBIR,PETOJO SELATAN,14692,3179,11513,10005,21518,2021-12-02
3171011003,JAKARTA PUSAT,GAMBIR,PETOJO UTARA,17458,3638,13820,11705,25525,2021-12-02
3174101004,JAKARTA SELATAN,PESANGGRAHAN,PETUKANGAN SELATAN,37187,7315,29872,26028,55900,2021-12-02
3174101003,JAKARTA SELATAN,PESANGGRAHAN,PETUKANGAN UTARA,53716,10973,42743,36736,79479,2021-12-02
3175081002,JAKARTA TIMUR,MAKASAR,PINANG RANTI,27198,5653,21545,18357,39902,2021-12-02
3173031008,JAKARTA BARAT,TAMAN SARI,PINANGSIA,10729,1798,8931,7615,16546,2021-12-02
3175011001,JAKARTA TIMUR,MATRAMAN,PISANGAN BARU,31776,6209,25567,21194,46761,2021-12-02
3175021002,JAKARTA TIMUR,PULO GADUNG,PISANGAN TIMUR,41011,7226,33785,29424,63209,2021-12-02
3172011005,JAKARTA UTARA,PENJARINGAN,PLUIT,47783,8961,38822,34745,73567,2021-12-02
3175071002,JAKARTA TIMUR,DUREN SAWIT,PONDOK BAMBU,61550,12345,49205,42569,91774,2021-12-02
3175071004,JAKARTA TIMUR,DUREN SAWIT,PONDOK KELAPA,72015,13716,58299,51434,109733,2021-12-02
3175071007,JAKARTA TIMUR,DUREN SAWIT,PONDOK KOPI,35367,6357,29010,24222,53232,2021-12-02
3174061003,JAKARTA SELATAN,CILANDAK,PONDOK LABU,46464,7314,39150,35168,74318,2021-12-02
3174051002,JAKARTA SELATAN,KEBAYORAN LAMA,PONDOK PINANG,56169,10336,45833,40496,86329,2021-12-02
3175101003,JAKARTA TIMUR,CIPAYUNG,PONDOK RANGGON,25574,4591,20983,18335,39318,2021-12-02
3101011003,KAB.ADM.KEP.SERIBU,KEP. SERIBU UTARA,PULAU HARAPAN,2060,213,1847,1655,3502,2021-12-02
3101011002,KAB.ADM.KEP.SERIBU,KEP. SERIBU UTARA,PULAU KELAPA,5528,569,4959,4174,9133,2021-12-02
3101011001,KAB.ADM.KEP.SERIBU,KEP. SERIBU UTARA,PULAU PANGGANG,5450,423,5027,4539,9566,2021-12-02
3101021003,KAB.ADM.KEP.SERIBU,KEP. SERIBU SELATAN,PULAU PARI,2765,191,2574,2440,5014,2021-12-02
3101021002,KAB.ADM.KEP.SERIBU,KEP. SERIBU SELATAN,PULAU TIDUNG,4553,357,4196,3903,8099,2021-12-02
3101021001,KAB.ADM.KEP.SERIBU,KEP. SERIBU SELATAN,PULAU UNTUNG JAWA,1941,154,1787,1664,3451,2021-12-02
3174071007,JAKARTA SELATAN,KEBAYORAN BARU,PULO,5835,979,4856,4545,9401,2021-12-02
3175021001,JAKARTA TIMUR,PULO GADUNG,PULO GADUNG,34422,7202,27220,23415,50635,2021-12-02
3175061005,JAKARTA TIMUR,CAKUNG,PULO GEBANG,97301,17835,79466,66863,146329,2021-12-02
3174041004,JAKARTA SELATAN,PASAR MINGGU,RAGUNAN,39616,6712,32904,28933,61837,2021-12-02
3175091005,JAKARTA TIMUR,CIRACAS,RAMBUTAN,36771,8225,28546,24006,52552,2021-12-02
3172031006,JAKARTA UTARA,KOJA,RAWA BADAK SELATAN,42179,9495,32684,26748,59432,2021-12-02
3172031004,JAKARTA UTARA,KOJA,RAWA BADAK UTARA,34408,7338,27070,22708,49778,2021-12-02
3174071005,JAKARTA SELATAN,KEBAYORAN BARU,RAWA BARAT,5625,967,4658,4227,8885,2021-12-02
3173011003,JAKARTA BARAT,CENGKARENG,RAWA BUAYA,63799,11964,51835,44323,96158,2021-12-02
3175031004,JAKARTA TIMUR,JATINEGARA,RAWA BUNGA,21434,4917,16517,13927,30444,2021-12-02
3174081003,JAKARTA SELATAN,PANCORAN,RAWA JATI,20509,3734,16775,14789,31564,2021-12-02
3175061002,JAKARTA TIMUR,CAKUNG,RAWA TERATE,24637,4238,20399,17157,37556,2021-12-02
3175021005,JAKARTA TIMUR,PULO GADUNG,RAWAMANGUN,37612,7068,30544,26777,57321,2021-12-02
3171051003,JAKARTA PUSAT,CEMPAKA PUTIH,RAWASARI,21967,4238,17729,15625,33354,2021-12-02
3173041010,JAKARTA BARAT,TAMBORA,ROA MALAKA,3484,597,2887,2634,5521,2021-12-02
3172041006,JAKARTA UTARA,CILINCING,ROROTAN,41668,7979,33689,28145,61834,2021-12-02
3174071004,JAKARTA SELATAN,KEBAYORAN BARU,SELONG,2842,534,2308,2164,4472,2021-12-02
3173061002,JAKARTA BARAT,KALI DERES,SEMANAN,71354,14166,57188,47540,104728,2021-12-02
3172041007,JAKARTA UTARA,CILINCING,SEMPER BARAT,68587,12729,55858,47884,103742,2021-12-02
3172041005,JAKARTA UTARA,CILINCING,SEMPER TIMUR,36267,7386,28881,24195,53076,2021-12-02
3174071006,JAKARTA SELATAN,KEBAYORAN BARU,SENAYAN,2771,633,2138,1907,4045,2021-12-02
3171041001,JAKARTA PUSAT,SENEN,SENEN,6804,1372,5432,4627,10059,2021-12-02
3171031004,JAKARTA PUSAT,KEMAYORAN,SERDANG,29668,5422,24246,20854,45100,2021-12-02
3174021001,JAKARTA SELATAN,SETIA BUDI,SETIA BUDI,3023,581,2442,2148,4590,2021-12-02
3175101005,JAKARTA TIMUR,CIPAYUNG,SETU,20572,3921,16651,14118,30769,2021-12-02
3173071002,JAKARTA BARAT,PALMERAH,SLIPI,16591,2837,13754,12034,25788,2021-12-02
3173081004,JAKARTA BARAT,KEMBANGAN,SRENGSENG,45523,9674,35849,31121,66970,2021-12-02
3174091002,JAKARTA SELATAN,JAGAKARSA,SRENGSENG SAWAH,58196,8446,49750,44161,93911,2021-12-02
3173051003,JAKARTA BARAT,KEBON JERUK,SUKABUMI SELATAN,37033,7379,29654,23739,53393,2021-12-02
3173051002,JAKARTA BARAT,KEBON JERUK,SUKABUMI UTARA,38290,8307,29983,24287,54270,2021-12-02
3172041002,JAKARTA UTARA,CILINCING,SUKAPURA,53949,11597,42352,35935,78287,2021-12-02
3171031007,JAKARTA PUSAT,KEMAYORAN,SUMUR BATU,22717,4089,18628,16333,34961,2021-12-02
3172021004,JAKARTA UTARA,TANJUNG PRIOK,SUNGAI BAMBU,29876,5659,24217,20721,44938,2021-12-02
3172021006,JAKARTA UTARA,TANJUNG PRIOK,SUNTER AGUNG,71805,11901,59904,53846,113750,2021-12-02
3172021002,JAKARTA UTARA,TANJUNG PRIOK,SUNTER JAYA,63031,10567,52464,46803,99267,2021-12-02
3175091004,JAKARTA TIMUR,CIRACAS,SUSUKAN,38257,6889,31368,26974,58342,2021-12-02
3173031001,JAKARTA BARAT,TAMAN SARI,TAMAN SARI,14348,2514,11834,10443,22277,2021-12-02
3173041001,JAKARTA BARAT,TAMBORA,TAMBORA,10204,2103,8101,6726,14827,2021-12-02
3173041004,JAKARTA BARAT,TAMBORA,TANAH SEREAL,26387,4259,22128,18995,41123,2021-12-02
3171081004,JAKARTA PUSAT,JOHAR BARU,TANAH TINGGI,37693,6925,30768,25588,56356,2021-12-02
3173031004,JAKARTA BARAT,TAMAN SARI,TANGKI,13324,2131,11193,9791,20984,2021-12-02
3174091005,JAKARTA SELATAN,JAGAKARSA,TANJUNG BARAT,39770,6440,33330,28715,62045,2021-12-02
3173021005,JAKARTA BARAT,GROGOL PETAMBURAN,TANJUNG DUREN SELATAN,25337,4615,20722,18839,39561,2021-12-02
3173021002,JAKARTA BARAT,GROGOL PETAMBURAN,TANJUNG DUREN UTARA,17010,2740,14270,13116,27386,2021-12-02
3172021001,JAKARTA UTARA,TANJUNG PRIOK,TANJUNG PRIOK,34588,6825,27763,23349,51112,2021-12-02
3174011002,JAKARTA SELATAN,TEBET,TEBET BARAT,21194,3235,17959,16271,34230,2021-12-02
3174011001,JAKARTA SELATAN,TEBET,TEBET TIMUR,18199,2790,15409,14281,29690,2021-12-02
3173061003,JAKARTA BARAT,KALI DERES,TEGAL ALUR,83647,16497,67150,57167,124317,2021-12-02
3174031004,JAKARTA SELATAN,MAMPANG PRAPATAN,TEGAL PARANG,32401,6780,25621,20841,46462,2021-12-02
3173021003,JAKARTA BARAT,GROGOL PETAMBURAN,TOMANG,29605,5207,24398,21642,46040,2021-12-02
3172031005,JAKARTA UTARA,KOJA,TUGU SELATAN,39122,8279,30843,25825,56668,2021-12-02
3172031002,JAKARTA UTARA,KOJA,TUGU UTARA,67670,15308,52362,42938,95300,2021-12-02
3175061006,JAKARTA TIMUR,CAKUNG,UJUNG MENTENG,29934,4908,25026,21919,46945,2021-12-02
3174101005,JAKARTA SELATAN,PESANGGRAHAN,ULUJAMI,40544,8547,31997,27256,59253,2021-12-02
3175011006,JAKARTA TIMUR,MATRAMAN,UTAN KAYU SELATAN,33511,5719,27792,23801,51593,2021-12-02
3175011002,JAKARTA TIMUR,MATRAMAN,UTAN KAYU UTARA,28169,5424,22745,19156,41901,2021-12-02
3171031008,JAKARTA PUSAT,KEMAYORAN,UTAN PANJANG,29208,5481,23727,19810,43537,2021-12-02
3172021007,JAKARTA UTARA,TANJUNG PRIOK,WARAKAS,44401,7796,36605,30565,67170,2021-12-02
3173021007,JAKARTA BARAT,GROGOL PETAMBURAN,WIJAYA KUSUMA,38934,7688,31246,27107,58353,2021-12-02
3172051003,JAKARTA UTARA,PADEMANGAN,ANCOL,23947,5491,18456,15526,33982,2021-12-03
3173041007,JAKARTA BARAT,TAMBORA,ANGKE,29381,5942,23439,19511,42950,2021-12-03
3175041005,JAKARTA TIMUR,KRAMAT JATI,BALE KAMBANG,29074,6742,22332,18186,40518,2021-12-03
3175031003,JAKARTA TIMUR,JATINEGARA,BALI MESTER,9752,1909,7843,6807,14650,2021-12-03
3175101006,JAKARTA TIMUR,CIPAYUNG,BAMBU APUS,26285,4580,21705,18800,40505,2021-12-03
3174031002,JAKARTA SELATAN,MAMPANG PRAPATAN,BANGKA,21566,4327,17239,14781,32020,2021-12-03
3175051002,JAKARTA TIMUR,PASAR REBO,BARU,23886,3750,20136,17901,38037,2021-12-03
3175041004,JAKARTA TIMUR,KRAMAT JATI,BATU AMPAR,47898,10912,36986,30842,67828,2021-12-03
3171071002,JAKARTA PUSAT,TANAH ABANG,BENDUNGAN HILIR,21494,4162,17332,15207,32539,2021-12-03
3175031002,JAKARTA TIMUR,JATINEGARA,BIDARA CINA,36689,8387,28302,23787,52089,2021-12-03
3174101002,JAKARTA SELATAN,PESANGGRAHAN,BINTARO,53098,10203,42895,38389,81284,2021-12-03
3174011005,JAKARTA SELATAN,TEBET,BUKIT DURI,34183,6498,27685,23843,51528,2021-12-03
3171041006,JAKARTA PUSAT,SENEN,BUNGUR,18144,3598,14546,12393,26939,2021-12-03
3175061007,JAKARTA TIMUR,CAKUNG,CAKUNG BARAT,57724,11231,46493,39246,85739,2021-12-03
3175061004,JAKARTA TIMUR,CAKUNG,CAKUNG TIMUR,58287,10898,47389,40512,87901,2021-12-03
3175041007,JAKARTA TIMUR,KRAMAT JATI,CAWANG,32762,6591,26171,21888,48059,2021-12-03
3175101008,JAKARTA TIMUR,CIPAYUNG,CEGER,18932,3497,15435,13283,28718,2021-12-03
3171031006,JAKARTA PUSAT,KEMAYORAN,CEMPAKA BARU,32581,5840,26741,22681,49422,2021-12-03
3171051002,JAKARTA PUSAT,CEMPAKA PUTIH,CEMPAKA PUTIH BARAT,35885,7184,28701,25224,53925,2021-12-03
3171051001,JAKARTA PUSAT,CEMPAKA PUTIH,CEMPAKA PUTIH TIMUR,24292,4778,19514,17567,37081,2021-12-03
3173011001,JAKARTA BARAT,CENGKARENG,CENGKARENG BARAT,66284,12549,53735,47576,101311,2021-12-03
3173011006,JAKARTA BARAT,CENGKARENG,CENGKARENG TIMUR,81027,15256,65771,56588,122359,2021-12-03
3175091002,JAKARTA TIMUR,CIRACAS,CIBUBUR,66364,10894,55470,48478,103948,2021-12-03
3171011002,JAKARTA PUSAT,GAMBIR,CIDENG,15390,2900,12490,11130,23620,2021-12-03
3174091003,JAKARTA SELATAN,JAGAKARSA,CIGANJUR,38497,6160,32337,27957,60294,2021-12-03
3175051003,JAKARTA TIMUR,PASAR REBO,CIJANTUNG,41419,7296,34123,29463,63586,2021-12-03
3171061003,JAKARTA PUSAT,MENTENG,CIKINI,8274,1432,6842,5650,12492,2021-12-03
3174081006,JAKARTA SELATAN,PANCORAN,CIKOKO,10547,1738,8809,7821,16630,2021-12-03
3174061001,JAKARTA SELATAN,CILANDAK,CILANDAK BARAT,51752,8702,43050,38778,81828,2021-12-03
3174041003,JAKARTA SELATAN,PASAR MINGGU,CILANDAK TIMUR,25145,4315,20830,18321,39151,2021-12-03
3175101002,JAKARTA TIMUR,CIPAYUNG,CILANGKAP,27635,4668,22967,20145,43112,2021-12-03
3175041006,JAKARTA TIMUR,KRAMAT JATI,CILILITAN,40181,7980,32201,27007,59208,2021-12-03
3172041001,JAKARTA UTARA,CILINCING,CILINCING,43609,9860,33749,27205,60954,2021-12-03
3175101001,JAKARTA TIMUR,CIPAYUNG,CIPAYUNG,26104,4326,21778,19214,40992,2021-12-03
3174091006,JAKARTA SELATAN,JAGAKARSA,CIPEDAK,38303,6044,32259,28249,60508,2021-12-03
3174061005,JAKARTA SELATAN,CILANDAK,CIPETE SELATAN,26704,4841,21863,19747,41610,2021-12-03
3174071010,JAKARTA SELATAN,KEBAYORAN BARU,CIPETE UTARA,34102,6180,27922,24240,52162,2021-12-03
3175021003,JAKARTA TIMUR,PULO GADUNG,CIPINANG,39306,6744,32562,28063,60625,2021-12-03
3175031007,JAKARTA TIMUR,JATINEGARA,CIPINANG BESAR SELATAN,35212,7902,27310,22518,49828,2021-12-03
3175031008,JAKARTA TIMUR,JATINEGARA,CIPINANG BESAR UTARA,45319,10101,35218,28722,63940,2021-12-03
3175031005,JAKARTA TIMUR,JATINEGARA,CIPINANG CEMPEDAK,32824,6847,25977,22845,48822,2021-12-03
3175081005,JAKARTA TIMUR,MAKASAR,CIPINANG MELAYU,42308,7836,34472,30212,64684,2021-12-03
3175031006,JAKARTA TIMUR,JATINEGARA,CIPINANG MUARA,55243,11160,44083,37318,81401,2021-12-03
3174051003,JAKARTA SELATAN,KEBAYORAN LAMA,CIPULIR,39937,8014,31923,27144,59067,2021-12-03
3175091001,JAKARTA TIMUR,CIRACAS,CIRACAS,64594,11313,53281,45599,98880,2021-12-03
3175041003,JAKARTA TIMUR,KRAMAT JATI,DUKUH,24609,4325,20284,17285,37569,2021-12-03
3175071001,JAKARTA TIMUR,DUREN SAWIT,DUREN SAWIT,61160,12313,48847,42214,91061,2021-12-03
3174081004,JAKARTA SELATAN,PANCORAN,DUREN TIGA,28319,5331,22988,19795,42783,2021-12-03
3173051005,JAKARTA BARAT,KEBON JERUK,DURI KEPA,60138,11355,48783,43128,91911,2021-12-03
3173011002,JAKARTA BARAT,CENGKARENG,DURI KOSAMBI,77923,15748,62175,52003,114178,2021-12-03
3171011006,JAKARTA PUSAT,GAMBIR,DURI PULO,19610,3983,15627,12909,28536,2021-12-03
3173041011,JAKARTA BARAT,TAMBORA,DURI SELATAN,14259,2410,11849,10269,22118,2021-12-03
3173041003,JAKARTA BARAT,TAMBORA,DURI UTARA,19844,3403,16441,13941,30382,2021-12-03
3171081003,JAKARTA PUSAT,JOHAR BARU,GALUR,18243,3417,14826,12272,27098,2021-12-03
3171011001,JAKARTA PUSAT,GAMBIR,GAMBIR,2191,444,1747,1546,3293,2021-12-03
3174061004,JAKARTA SELATAN,CILANDAK,GANDARIA SELATAN,22119,4003,18116,15937,34053,2021-12-03
3174071009,JAKARTA SELATAN,KEBAYORAN BARU,GANDARIA UTARA,39922,7503,32419,28385,60804,2021-12-03
3175051001,JAKARTA TIMUR,PASAR REBO,GEDONG,35755,6801,28954,25183,54137,2021-12-03
3171071001,JAKARTA PUSAT,TANAH ABANG,GELORA,3127,590,2537,2265,4802,2021-12-03
3173031007,JAKARTA BARAT,TAMAN SARI,GLODOK,7837,1137,6700,6192,12892,2021-12-03
3171061004,JAKARTA PUSAT,MENTENG,GONDANGDIA,4100,892,3208,2974,6182,2021-12-03
3173021001,JAKARTA BARAT,GROGOL PETAMBURAN,GROGOL,16876,3189,13687,11930,25617,2021-12-03
3174051005,JAKARTA SELATAN,KEBAYORAN LAMA,GROGOL SELATAN,44251,8386,35865,30775,66640,2021-12-03
3174051004,JAKARTA SELATAN,KEBAYORAN LAMA,GROGOL UTARA,42494,8288,34206,29384,63590,2021-12-03
3174021007,JAKARTA SELATAN,SETIA BUDI,GUNTUR,3985,719,3266,2959,6225,2021-12-03
3174071002,JAKARTA SELATAN,KEBAYORAN BARU,GUNUNG,9436,1692,7744,7049,14793,2021-12-03
3171031005,JAKARTA PUSAT,KEMAYORAN,GUNUNG SAHARI SELATAN,19199,3546,15653,13595,29248,2021-12-03
3171021004,JAKARTA PUSAT,SAWAH BESAR,GUNUNG SAHARI UTARA,16650,2807,13843,12583,26426,2021-12-03
3175081004,JAKARTA TIMUR,MAKASAR,HALIM PERDANA KUSUMAH,28363,3466,24897,23127,48024,2021-12-03
3171031003,JAKARTA PUSAT,KEMAYORAN,HARAPAN MULIA,22557,4153,18404,15549,33953,2021-12-03
3174091001,JAKARTA SELATAN,JAGAKARSA,JAGAKARSA,62389,9684,52705,46411,99116,2021-12-03
3175021007,JAKARTA TIMUR,PULO GADUNG,JATI,32757,5852,26905,24086,50991,2021-12-03
3174041002,JAKARTA SELATAN,PASAR MINGGU,JATI PADANG,37502,6792,30710,26745,57455,2021-12-03
3173071004,JAKARTA BARAT,PALMERAH,JATI PULO,28738,5437,23301,19269,42570,2021-12-03
3175061001,JAKARTA TIMUR,CAKUNG,JATINEGARA,84160,16892,67268,57308,124576,2021-12-03
3175021004,JAKARTA TIMUR,PULO GADUNG,JATINEGARA KAUM,24632,4182,20450,17244,37694,2021-12-03
3173021004,JAKARTA BARAT,GROGOL PETAMBURAN,JELAMBAR,30266,5270,24996,22613,47609,2021-12-03
3173021006,JAKARTA BARAT,GROGOL PETAMBURAN,JELAMBAR BARU,38246,6512,31734,28449,60183,2021-12-03
3173041006,JAKARTA BARAT,TAMBORA,JEMBATAN BESI,29314,6725,22589,18290,40879,2021-12-03
3173041008,JAKARTA BARAT,TAMBORA,JEMBATAN LIMA,21021,4501,16520,13537,30057,2021-12-03
3173081005,JAKARTA BARAT,KEMBANGAN,JOGLO,40839,7805,33034,28721,61755,2021-12-03
3171081001,JAKARTA PUSAT,JOHAR BARU,JOHAR BARU,37488,6649,30839,26728,57567,2021-12-03
3173041002,JAKARTA BARAT,TAMBORA,KALI ANYAR,23856,4488,19368,15925,35293,2021-12-03
3172041004,JAKARTA UTARA,CILINCING,KALIBARU,67684,17605,50079,36865,86944,2021-12-03
3174081002,JAKARTA SELATAN,PANCORAN,KALIBATA,41994,9018,32976,27907,60883,2021-12-03
3173061001,JAKARTA BARAT,KALI DERES,KALIDERES,72447,13792,58655,51107,109762,2021-12-03
3175051004,JAKARTA TIMUR,PASAR REBO,KALISARI,43212,7277,35935,31288,67223,2021-12-03
3173061004,JAKARTA BARAT,KALI DERES,KAMAL,53783,11782,42001,34795,76796,2021-12-03
3172011002,JAKARTA UTARA,PENJARINGAN,KAMAL MUARA,12930,2235,10695,9229,19924,2021-12-03
3171071007,JAKARTA PUSAT,TANAH ABANG,KAMPUNG BALI,11358,2342,9016,7233,16249,2021-12-03
3175031001,JAKARTA TIMUR,JATINEGARA,KAMPUNG MELAYU,25717,5607,20110,16336,36446,2021-12-03
3171081002,JAKARTA PUSAT,JOHAR BARU,KAMPUNG RAWA,21237,3366,17871,14649,32520,2021-12-03
3175041002,JAKARTA TIMUR,KRAMAT JATI,KAMPUNG TENGAH,43993,10378,33615,27848,61463,2021-12-03
3173011005,JAKARTA BARAT,CENGKARENG,KAPUK,134466,30699,103767,86901,190668,2021-12-03
3172011003,JAKARTA UTARA,PENJARINGAN,KAPUK MUARA,35781,6553,29228,26283,55511,2021-12-03
3171021002,JAKARTA PUSAT,SAWAH BESAR,KARANG ANYAR,25761,4631,21130,18187,39317,2021-12-03
3174021004,JAKARTA SELATAN,SETIA BUDI,KARET,9623,1778,7845,6789,14634,2021-12-03
3174021003,JAKARTA SELATAN,SETIA BUDI,KARET KUNINGAN,16055,2987,13068,11425,24493,2021-12-03
3174021002,JAKARTA SELATAN,SETIA BUDI,KARET SEMANGGI,2770,537,2233,2018,4251,2021-12-03
3171071003,JAKARTA PUSAT,TANAH ABANG,KARET TENGSIN,19271,3563,15708,13284,28992,2021-12-03
3171021003,JAKARTA PUSAT,SAWAH BESAR,KARTINI,22292,3992,18300,16124,34424,2021-12-03
3175011003,JAKARTA TIMUR,MATRAMAN,KAYU MANIS,25284,5012,20272,16819,37091,2021-12-03
3175021006,JAKARTA TIMUR,PULO GADUNG,KAYU PUTIH,40696,7350,33346,29890,63236,2021-12-03
3173031006,JAKARTA BARAT,TAMAN SARI,KEAGUNGAN,17387,3081,14306,12100,26406,2021-12-03
3174041007,JAKARTA SELATAN,PASAR MINGGU,KEBAGUSAN,44552,8327,36225,31173,67398,2021-12-03
3174051006,JAKARTA SELATAN,KEBAYORAN LAMA,KEBAYORAN LAMA SELATAN,41212,7234,33978,29889,63867,2021-12-03
3174051001,JAKARTA SELATAN,KEBAYORAN LAMA,KEBAYORAN LAMA UTARA,42422,8358,34064,29385,63449,2021-12-03
3174011004,JAKARTA SELATAN,TEBET,KEBON BARU,35165,6197,28968,25140,54108,2021-12-03
3172021005,JAKARTA UTARA,TANJUNG PRIOK,KEBON BAWANG,50952,9750,41202,35382,76584,2021-12-03
3173051001,JAKARTA BARAT,KEBON JERUK,KEBON JERUK,53887,10426,43461,36694,80155,2021-12-03
3171071006,JAKARTA PUSAT,TANAH ABANG,KEBON KACANG,21531,4927,16604,13697,30301,2021-12-03
3171011005,JAKARTA PUSAT,GAMBIR,KEBON KELAPA,10163,1961,8202,7142,15344,2021-12-03
3171031002,JAKARTA PUSAT,KEMAYORAN,KEBON KOSONG,30019,5727,24292,20742,45034,2021-12-03
3175011005,JAKARTA TIMUR,MATRAMAN,KEBON MANGGIS,16490,3036,13454,11462,24916,2021-12-03
3171071005,JAKARTA PUSAT,TANAH ABANG,KEBON MELATI,32206,8235,23971,18571,42542,2021-12-03
3175081003,JAKARTA TIMUR,MAKASAR,KEBON PALA,46614,8780,37834,32550,70384,2021-12-03
3171061005,JAKARTA PUSAT,MENTENG,KEBON SIRIH,12299,2500,9799,8192,17991,2021-12-03
3173011004,JAKARTA BARAT,CENGKARENG,KEDAUNG KALI ANGKE,32612,5977,26635,23015,49650,2021-12-03
3173051007,JAKARTA BARAT,KEBON JERUK,KEDOYA SELATAN,32165,5641,26524,22596,49120,2021-12-03
3173051006,JAKARTA BARAT,KEBON JERUK,KEDOYA UTARA,45740,8388,37352,32280,69632,2021-12-03
3173051004,JAKARTA BARAT,KEBON JERUK,KELAPA DUA,23565,4404,19161,16503,35664,2021-12-03
3175091003,JAKARTA TIMUR,CIRACAS,KELAPA DUA WETAN,46875,7641,39234,34262,73496,2021-12-03
3172061003,JAKARTA UTARA,KELAPA GADING,KELAPA GADING BARAT,35717,5989,29728,27301,57029,2021-12-03
3172061001,JAKARTA UTARA,KELAPA GADING,KELAPA GADING TIMUR,33592,4952,28640,26987,55627,2021-12-03
3173071005,JAKARTA BARAT,PALMERAH,KEMANGGISAN,32139,5785,26354,23109,49463,2021-12-03
3171031001,JAKARTA PUSAT,KEMAYORAN,KEMAYORAN,20708,3911,16797,14253,31050,2021-12-03
3173081006,JAKARTA BARAT,KEMBANGAN,KEMBANGAN SELATAN,27130,5406,21724,19145,40869,2021-12-03
3173081001,JAKARTA BARAT,KEMBANGAN,KEMBANGAN UTARA,54451,11112,43339,37023,80362,2021-12-03
3171041002,JAKARTA PUSAT,SENEN,KENARI,9579,1796,7783,6805,14588,2021-12-03
3173041005,JAKARTA BARAT,TAMBORA,KERENDANG,19973,3862,16111,13602,29713,2021-12-03
3175071003,JAKARTA TIMUR,DUREN SAWIT,KLENDER,69978,15565,54413,45158,99571,2021-12-03
3172031001,JAKARTA UTARA,KOJA,KOJA,28175,6104,22071,18415,40486,2021-12-03
3173071006,JAKARTA BARAT,PALMERAH,KOTA BAMBU SELATAN,21158,3956,17202,14100,31302,2021-12-03
3173071003,JAKARTA BARAT,PALMERAH,KOTA BAMBU UTARA,24995,4851,20144,16363,36507,2021-12-03
3171041004,JAKARTA PUSAT,SENEN,KRAMAT,28835,6267,22568,17633,40201,2021-12-03
3175041001,JAKARTA TIMUR,KRAMAT JATI,KRAMAT JATI,34144,6890,27254,22832,50086,2021-12-03
3174071003,JAKARTA SELATAN,KEBAYORAN BARU,KRAMAT PELA,14413,2678,11735,10383,22118,2021-12-03
3173031002,JAKARTA BARAT,TAMAN SARI,KRUKUT,19244,3471,15773,13254,29027,2021-12-03
3174031005,JAKARTA SELATAN,MAMPANG PRAPATAN,KUNINGAN BARAT,12785,2205,10580,9156,19736,2021-12-03
3174021008,JAKARTA SELATAN,SETIA BUDI,KUNINGAN TIMUR,6008,1143,4865,4307,9172,2021-12-03
3171041005,JAKARTA PUSAT,SENEN,KWITANG,15486,3226,12260,10132,22392,2021-12-03
3172031003,JAKARTA UTARA,KOJA,LAGOA,59065,13219,45846,37595,83441,2021-12-03
3174061002,JAKARTA SELATAN,CILANDAK,LEBAK BULUS,37626,6768,30858,27916,58774,2021-12-03
3174091004,JAKARTA SELATAN,JAGAKARSA,LENTENG AGUNG,53946,9154,44792,38068,82860,2021-12-03
3175101007,JAKARTA TIMUR,CIPAYUNG,LUBANG BUAYA,63547,11419,52128,44753,96881,2021-12-03
3175081001,JAKARTA TIMUR,MAKASAR,MAKASAR,34390,5857,28533,25023,53556,2021-12-03
3175071006,JAKARTA TIMUR,DUREN SAWIT,MALAKA JAYA,30927,4979,25948,23087,49035,2021-12-03
3175071005,JAKARTA TIMUR,DUREN SAWIT,MALAKA SARI,27530,4337,23193,20794,43987,2021-12-03
3174031001,JAKARTA SELATAN,MAMPANG PRAPATAN,MAMPANG PRAPATAN,18159,3531,14628,12508,27136,2021-12-03
3173031005,JAKARTA BARAT,TAMAN SARI,MANGGA BESAR,7707,1251,6456,5817,12273,2021-12-03
3171021005,JAKARTA PUSAT,SAWAH BESAR,MANGGA DUA SELATAN,27442,5314,22128,19163,41291,2021-12-03
3174011007,JAKARTA SELATAN,TEBET,MANGGARAI,28373,4718,23655,20038,43693,2021-12-03
3174011006,JAKARTA SELATAN,TEBET,MANGGARAI SELATAN,23075,3512,19563,16955,36518,2021-12-03
3173031003,JAKARTA BARAT,TAMAN SARI,MAPHAR,16461,2933,13528,11652,25180,2021-12-03
3172041003,JAKARTA UTARA,CILINCING,MARUNDA,28943,6203,22740,17734,40474,2021-12-03
3174071001,JAKARTA SELATAN,KEBAYORAN BARU,MELAWAI,2627,493,2134,1997,4131,2021-12-03
3171061001,JAKARTA PUSAT,MENTENG,MENTENG,25624,5332,20292,16725,37017,2021-12-03
3174021005,JAKARTA SELATAN,SETIA BUDI,MENTENG ATAS,27816,4737,23079,19964,43043,2021-12-03
3174011003,JAKARTA SELATAN,TEBET,MENTENG DALAM,36028,6650,29378,25721,55099,2021-12-03
3173081003,JAKARTA BARAT,KEMBANGAN,MERUYA SELATAN,32130,6260,25870,22556,48426,2021-12-03
3173081002,JAKARTA BARAT,KEMBANGAN,MERUYA UTARA,43752,8573,35179,31435,66614,2021-12-03
3175101004,JAKARTA TIMUR,CIPAYUNG,MUNJUL,23871,4187,19684,17150,36834,2021-12-03
3172051002,JAKARTA UTARA,PADEMANGAN,PADEMANGAN BARAT,74240,16602,57638,47989,105627,2021-12-03
3172051001,JAKARTA UTARA,PADEMANGAN,PADEMANGAN TIMUR,37736,6350,31386,28374,59760,2021-12-03
3175011004,JAKARTA TIMUR,MATRAMAN,PAL MERIAM,19769,3798,15971,13313,29284,2021-12-03
3173071001,JAKARTA BARAT,PALMERAH,PALMERAH,63011,12482,50529,42688,93217,2021-12-03
3174081001,JAKARTA SELATAN,PANCORAN,PANCORAN,19421,3654,15767,13553,29320,2021-12-03
3172021003,JAKARTA UTARA,TANJUNG PRIOK,PAPANGGO,39097,7306,31791,26996,58787,2021-12-03
3171021001,JAKARTA PUSAT,SAWAH BESAR,PASAR BARU,12035,2195,9840,8984,18824,2021-12-03
3174021006,JAKARTA SELATAN,SETIA BUDI,PASAR MANGGIS,26752,4836,21916,18803,40719,2021-12-03
3174041001,JAKARTA SELATAN,PASAR MINGGU,PASAR MINGGU,24821,4451,20370,17991,38361,2021-12-03
3171041003,JAKARTA PUSAT,SENEN,PASEBAN,23533,4646,18887,15958,34845,2021-12-03
3173061005,JAKARTA BARAT,KALI DERES,PEGADUNGAN,75587,13967,61620,54068,115688,2021-12-03
3171061002,JAKARTA PUSAT,MENTENG,PEGANGSAAN,23455,4795,18660,15050,33710,2021-12-03
3172061002,JAKARTA UTARA,KELAPA GADING,PEGANGSAAN DUA,49976,7952,42024,38729,80753,2021-12-03
3172011004,JAKARTA UTARA,PENJARINGAN,PEJAGALAN,74578,14748,59830,53174,113004,2021-12-03
3174041006,JAKARTA SELATAN,PASAR MINGGU,PEJATEN BARAT,37346,6828,30518,26627,57145,2021-12-03
3174041005,JAKARTA SELATAN,PASAR MINGGU,PEJATEN TIMUR,57656,11771,45885,38493,84378,2021-12-03
3175051005,JAKARTA TIMUR,PASAR REBO,PEKAYON,43250,7436,35814,30869,66683,2021-12-03
3173041009,JAKARTA BARAT,TAMBORA,PEKOJAN,23587,4277,19310,16774,36084,2021-12-03
3174031003,JAKARTA SELATAN,MAMPANG PRAPATAN,PELA MAMPANG,43522,8133,35389,30821,66210,2021-12-03
3174081005,JAKARTA SELATAN,PANCORAN,PENGADEGAN,21478,3758,17720,15596,33316,2021-12-03
3175061003,JAKARTA TIMUR,CAKUNG,PENGGILINGAN,99255,21462,77793,64495,142288,2021-12-03
3172011001,JAKARTA UTARA,PENJARINGAN,PENJARINGAN,88308,21661,66647,53484,120131,2021-12-03
3174101001,JAKARTA SELATAN,PESANGGRAHAN,PESANGGRAHAN,27545,4518,23027,20348,43375,2021-12-03
3171071004,JAKARTA PUSAT,TANAH ABANG,PETAMBURAN,33271,8378,24893,19747,44640,2021-12-03
3174071008,JAKARTA SELATAN,KEBAYORAN BARU,PETOGOGAN,11499,2107,9392,8255,17647,2021-12-03
3171011004,JAKARTA PUSAT,GAMBIR,PETOJO SELATAN,14692,3173,11519,10019,21538,2021-12-03
3171011003,JAKARTA PUSAT,GAMBIR,PETOJO UTARA,17458,3618,13840,11725,25565,2021-12-03
3174101004,JAKARTA SELATAN,PESANGGRAHAN,PETUKANGAN SELATAN,37187,7303,29884,26070,55954,2021-12-03
3174101003,JAKARTA SELATAN,PESANGGRAHAN,PETUKANGAN UTARA,53716,10946,42770,36843,79613,2021-12-03
3175081002,JAKARTA TIMUR,MAKASAR,PINANG RANTI,27198,5640,21558,18385,39943,2021-12-03
3173031008,JAKARTA BARAT,TAMAN SARI,PINANGSIA,10729,1794,8935,7622,16557,2021-12-03
3175011001,JAKARTA TIMUR,MATRAMAN,PISANGAN BARU,31776,6196,25580,21237,46817,2021-12-03
3175021002,JAKARTA TIMUR,PULO GADUNG,PISANGAN TIMUR,41011,7165,33846,29665,63511,2021-12-03
3172011005,JAKARTA UTARA,PENJARINGAN,PLUIT,47783,8952,38831,34782,73613,2021-12-03
3175071002,JAKARTA TIMUR,DUREN SAWIT,PONDOK BAMBU,61550,12315,49235,42674,91909,2021-12-03
3175071004,JAKARTA TIMUR,DUREN SAWIT,PONDOK KELAPA,72015,13688,58327,51495,109822,2021-12-03
3175071007,JAKARTA TIMUR,DUREN SAWIT,PONDOK KOPI,35367,6333,29034,24410,53444,2021-12-03
3174061003,JAKARTA SELATAN,CILANDAK,PONDOK LABU,46464,7290,39174,35248,74422,2021-12-03
3174051002,JAKARTA SELATAN,KEBAYORAN LAMA,PONDOK PINANG,56169,10314,45855,40578,86433,2021-12-03
3175101003,JAKARTA TIMUR,CIPAYUNG,PONDOK RANGGON,25574,4586,20988,18345,39333,2021-12-03
3101011003,KAB.ADM.KEP.SERIBU,KEP. SERIBU UTARA,PULAU HARAPAN,2060,202,1858,1662,3520,2021-12-03
3101011002,KAB.ADM.KEP.SERIBU,KEP. SERIBU UTARA,PULAU KELAPA,5528,566,4962,4188,9150,2021-12-03
3101011001,KAB.ADM.KEP.SERIBU,KEP. SERIBU UTARA,PULAU PANGGANG,5450,423,5027,4539,9566,2021-12-03
3101021003,KAB.ADM.KEP.SERIBU,KEP. SERIBU SELATAN,PULAU PARI,2765,191,2574,2440,5014,2021-12-03
3101021002,KAB.ADM.KEP.SERIBU,KEP. SERIBU SELATAN,PULAU TIDUNG,4553,357,4196,3904,8100,2021-12-03
3101021001,KAB.ADM.KEP.SERIBU,KEP. SERIBU SELATAN,PULAU UNTUNG JAWA,1941,154,1787,1664,3451,2021-12-03
3174071007,JAKARTA SELATAN,KEBAYORAN BARU,PULO,5835,979,4856,4554,9410,2021-12-03
3175021001,JAKARTA TIMUR,PULO GADUNG,PULO GADUNG,34422,7177,27245,23462,50707,2021-12-03
3175061005,JAKARTA TIMUR,CAKUNG,PULO GEBANG,97301,17799,79502,66957,146459,2021-12-03
3174041004,JAKARTA SELATAN,PASAR MINGGU,RAGUNAN,39616,6646,32970,28995,61965,2021-12-03
3175091005,JAKARTA TIMUR,CIRACAS,RAMBUTAN,36771,8200,28571,24045,52616,2021-12-03
3172031006,JAKARTA UTARA,KOJA,RAWA BADAK SELATAN,42179,9473,32706,26794,59500,2021-12-03
3172031004,JAKARTA UTARA,KOJA,RAWA BADAK UTARA,34408,7329,27079,22770,49849,2021-12-03
3174071005,JAKARTA SELATAN,KEBAYORAN BARU,RAWA BARAT,5625,966,4659,4231,8890,2021-12-03
3173011003,JAKARTA BARAT,CENGKARENG,RAWA BUAYA,63799,11938,51861,44413,96274,2021-12-03
3175031004,JAKARTA TIMUR,JATINEGARA,RAWA BUNGA,21434,4878,16556,13966,30522,2021-12-03
3174081003,JAKARTA SELATAN,PANCORAN,RAWA JATI,20509,3726,16783,14798,31581,2021-12-03
3175061002,JAKARTA TIMUR,CAKUNG,RAWA TERATE,24637,4226,20411,17212,37623,2021-12-03
3175021005,JAKARTA TIMUR,PULO GADUNG,RAWAMANGUN,37612,7047,30565,26821,57386,2021-12-03
3171051003,JAKARTA PUSAT,CEMPAKA PUTIH,RAWASARI,21967,4227,17740,15650,33390,2021-12-03
3173041010,JAKARTA BARAT,TAMBORA,ROA MALAKA,3484,597,2887,2634,5521,2021-12-03
3172041006,JAKARTA UTARA,CILINCING,ROROTAN,41668,7962,33706,28195,61901,2021-12-03
3174071004,JAKARTA SELATAN,KEBAYORAN BARU,SELONG,2842,534,2308,2165,4473,2021-12-03
3173061002,JAKARTA BARAT,KALI DERES,SEMANAN,71354,14137,57217,47597,104814,2021-12-03
3172041007,JAKARTA UTARA,CILINCING,SEMPER BARAT,68587,12710,55877,47979,103856,2021-12-03
3172041005,JAKARTA UTARA,CILINCING,SEMPER TIMUR,36267,7360,28907,24241,53148,2021-12-03
3174071006,JAKARTA SELATAN,KEBAYORAN BARU,SENAYAN,2771,631,2140,1911,4051,2021-12-03
3171041001,JAKARTA PUSAT,SENEN,SENEN,6804,1367,5437,4632,10069,2021-12-03
3171031004,JAKARTA PUSAT,KEMAYORAN,SERDANG,29668,5408,24260,20903,45163,2021-12-03
3174021001,JAKARTA SELATAN,SETIA BUDI,SETIA BUDI,3023,581,2442,2155,4597,2021-12-03
3175101005,JAKARTA TIMUR,CIPAYUNG,SETU,20572,3915,16657,14138,30795,2021-12-03
3173071002,JAKARTA BARAT,PALMERAH,SLIPI,16591,2828,13763,12048,25811,2021-12-03
3173081004,JAKARTA BARAT,KEMBANGAN,SRENGSENG,45523,9658,35865,31163,67028,2021-12-03
3174091002,JAKARTA SELATAN,JAGAKARSA,SRENGSENG SAWAH,58196,8422,49774,44226,94000,2021-12-03
3173051003,JAKARTA BARAT,KEBON JERUK,SUKABUMI SELATAN,37033,7360,29673,23793,53466,2021-12-03
3173051002,JAKARTA BARAT,KEBON JERUK,SUKABUMI UTARA,38290,8227,30063,24340,54403,2021-12-03
3172041002,JAKARTA UTARA,CILINCING,SUKAPURA,53949,11577,42372,36017,78389,2021-12-03
3171031007,JAKARTA PUSAT,KEMAYORAN,SUMUR BATU,22717,4081,18636,16397,35033,2021-12-03
3172021004,JAKARTA UTARA,TANJUNG PRIOK,SUNGAI BAMBU,29876,5642,24234,20759,44993,2021-12-03
3172021006,JAKARTA UTARA,TANJUNG PRIOK,SUNTER AGUNG,71805,11881,59924,53907,113831,2021-12-03
3172021002,JAKARTA UTARA,TANJUNG PRIOK,SUNTER JAYA,63031,10550,52481,46881,99362,2021-12-03
3175091004,JAKARTA TIMUR,CIRACAS,SUSUKAN,38257,6867,31390,26997,58387,2021-12-03
3173031001,JAKARTA BARAT,TAMAN SARI,TAMAN SARI,14348,2512,11836,10450,22286,2021-12-03
3173041001,JAKARTA BARAT,TAMBORA,TAMBORA,10204,2098,8106,6736,14842,2021-12-03
3173041004,JAKARTA BARAT,TAMBORA,TANAH SEREAL,26387,4253,22134,19015,41149,2021-12-03
3171081004,JAKARTA PUSAT,JOHAR BARU,TANAH TINGGI,37693,6919,30774,25625,56399,2021-12-03
3173031004,JAKARTA BARAT,TAMAN SARI,TANGKI,13324,2122,11202,9803,21005,2021-12-03
3174091005,JAKARTA SELATAN,JAGAKARSA,TANJUNG BARAT,39770,6419,33351,28759,62110,2021-12-03
3173021005,JAKARTA BARAT,GROGOL PETAMBURAN,TANJUNG DUREN SELATAN,25337,4612,20725,18867,39592,2021-12-03
3173021002,JAKARTA BARAT,GROGOL PETAMBURAN,TANJUNG DUREN UTARA,17010,2735,14275,13130,27405,2021-12-03
3172021001,JAKARTA UTARA,TANJUNG PRIOK,TANJUNG PRIOK,34588,6810,27778,23394,51172,2021-12-03
3174011002,JAKARTA SELATAN,TEBET,TEBET BARAT,21194,3222,17972,16312,34284,2021-12-03
3174011001,JAKARTA SELATAN,TEBET,TEBET TIMUR,18199,2786,15413,14292,29705,2021-12-03
3173061003,JAKARTA BARAT,KALI DERES,TEGAL ALUR,83647,16470,67177,57247,124424,2021-12-03
3174031004,JAKARTA SELATAN,MAMPANG PRAPATAN,TEGAL PARANG,32401,6769,25632,20891,46523,2021-12-03
3173021003,JAKARTA BARAT,GROGOL PETAMBURAN,TOMANG,29605,5191,24414,21677,46091,2021-12-03
3172031005,JAKARTA UTARA,KOJA,TUGU SELATAN,39122,8247,30875,25876,56751,2021-12-03
3172031002,JAKARTA UTARA,KOJA,TUGU UTARA,67670,15263,52407,43044,95451,2021-12-03
3175061006,JAKARTA TIMUR,CAKUNG,UJUNG MENTENG,29934,4902,25032,21945,46977,2021-12-03
3174101005,JAKARTA SELATAN,PESANGGRAHAN,ULUJAMI,40544,8487,32057,27355,59412,2021-12-03
3175011006,JAKARTA TIMUR,MATRAMAN,UTAN KAYU SELATAN,33511,5700,27811,23855,51666,2021-12-03
3175011002,JAKARTA TIMUR,MATRAMAN,UTAN KAYU UTARA,28169,5406,22763,19202,41965,2021-12-03
3171031008,JAKARTA PUSAT,KEMAYORAN,UTAN PANJANG,29208,5472,23736,19857,43593,2021-12-03
3172021007,JAKARTA UTARA,TANJUNG PRIOK,WARAKAS,44401,7782,36619,30638,67257,2021-12-03
3173021007,JAKARTA BARAT,GROGOL PETAMBURAN,WIJAYA KUSUMA,38934,7668,31266,27163,58429,2021-12-03
3172051003,JAKARTA UTARA,PADEMANGAN,ANCOL,23947,5487,18460,15548,34008,2021-12-04
3173041007,JAKARTA BARAT,TAMBORA,ANGKE,29381,5930,23451,19570,43021,2021-12-04
3175041005,JAKARTA TIMUR,KRAMAT JATI,BALE KAMBANG,29074,6733,22341,18226,40567,2021-12-04
3175031003,JAKARTA TIMUR,JATINEGARA,BALI MESTER,9752,1904,7848,6815,14663,2021-12-04
3175101006,JAKARTA TIMUR,CIPAYUNG,BAMBU APUS,26285,4571,21714,18835,40549,2021-12-04
3174031002,JAKARTA SELATAN,MAMPANG PRAPATAN,BANGKA,21566,4319,17247,14800,32047,2021-12-04
3175051002,JAKARTA TIMUR,PASAR REBO,BARU,23886,3742,20144,17930,38074,2021-12-04
3175041004,JAKARTA TIMUR,KRAMAT JATI,BATU AMPAR,47898,10888,37010,30914,67924,2021-12-04
3171071002,JAKARTA PUSAT,TANAH ABANG,BENDUNGAN HILIR,21494,4153,17341,15229,32570,2021-12-04
3175031002,JAKARTA TIMUR,JATINEGARA,BIDARA CINA,36689,8370,28319,23849,52168,2021-12-04
3174101002,JAKARTA SELATAN,PESANGGRAHAN,BINTARO,53098,10185,42913,38470,81383,2021-12-04
3174011005,JAKARTA SELATAN,TEBET,BUKIT DURI,34183,6486,27697,23877,51574,2021-12-04
3171041006,JAKARTA PUSAT,SENEN,BUNGUR,18144,3593,14551,12410,26961,2021-12-04
3175061007,JAKARTA TIMUR,CAKUNG,CAKUNG BARAT,57724,11199,46525,39277,85802,2021-12-04
3175061004,JAKARTA TIMUR,CAKUNG,CAKUNG TIMUR,58287,10877,47410,40559,87969,2021-12-04
3175041007,JAKARTA TIMUR,KRAMAT JATI,CAWANG,32762,6571,26191,21937,48128,2021-12-04
3175101008,JAKARTA TIMUR,CIPAYUNG,CEGER,18932,3492,15440,13305,28745,2021-12-04
3171031006,JAKARTA PUSAT,KEMAYORAN,CEMPAKA BARU,32581,5827,26754,22743,49497,2021-12-04
3171051002,JAKARTA PUSAT,CEMPAKA PUTIH,CEMPAKA PUTIH BARAT,35885,7140,28745,25279,54024,2021-12-04
3171051001,JAKARTA PUSAT,CEMPAKA PUTIH,CEMPAKA PUTIH TIMUR,24292,4764,19528,17592,37120,2021-12-04
3173011001,JAKARTA BARAT,CENGKARENG,CENGKARENG BARAT,66284,12521,53763,47637,101400,2021-12-04
3173011006,JAKARTA BARAT,CENGKARENG,CENGKARENG TIMUR,81027,15201,65826,56731,122557,2021-12-04
3175091002,JAKARTA TIMUR,CIRACAS,CIBUBUR,66364,10870,55494,48536,104030,2021-12-04
3171011002,JAKARTA PUSAT,GAMBIR,CIDENG,15390,2893,12497,11144,23641,2021-12-04
3174091003,JAKARTA SELATAN,JAGAKARSA,CIGANJUR,38497,6146,32351,28039,60390,2021-12-04
3175051003,JAKARTA TIMUR,PASAR REBO,CIJANTUNG,41419,7282,34137,29526,63663,2021-12-04
3171061003,JAKARTA PUSAT,MENTENG,CIKINI,8274,1429,6845,5661,12506,2021-12-04
3174081006,JAKARTA SELATAN,PANCORAN,CIKOKO,10547,1733,8814,7835,16649,2021-12-04
3174061001,JAKARTA SELATAN,CILANDAK,CILANDAK BARAT,51752,8682,43070,38839,81909,2021-12-04
3174041003,JAKARTA SELATAN,PASAR MINGGU,CILANDAK TIMUR,25145,4308,20837,18368,39205,2021-12-04
3175101002,JAKARTA TIMUR,CIPAYUNG,CILANGKAP,27635,4659,22976,20177,43153,2021-12-04
3175041006,JAKARTA TIMUR,KRAMAT JATI,CILILITAN,40181,7964,32217,27056,59273,2021-12-04
3172041001,JAKARTA UTARA,CILINCING,CILINCING,43609,9839,33770,27267,61037,2021-12-04
3175101001,JAKARTA TIMUR,CIPAYUNG,CIPAYUNG,26104,4320,21784,19244,41028,2021-12-04
3174091006,JAKARTA SELATAN,JAGAKARSA,CIPEDAK,38303,6027,32276,28304,60580,2021-12-04
3174061005,JAKARTA SELATAN,CILANDAK,CIPETE SELATAN,26704,4825,21879,19782,41661,2021-12-04
3174071010,JAKARTA SELATAN,KEBAYORAN BARU,CIPETE UTARA,34102,6167,27935,24271,52206,2021-12-04
3175021003,JAKARTA TIMUR,PULO GADUNG,CIPINANG,39306,6720,32586,28137,60723,2021-12-04
3175031007,JAKARTA TIMUR,JATINEGARA,CIPINANG BESAR SELATAN,35212,7885,27327,22587,49914,2021-12-04
3175031008,JAKARTA TIMUR,JATINEGARA,CIPINANG BESAR UTARA,45319,10074,35245,28796,64041,2021-12-04
3175031005,JAKARTA TIMUR,JATINEGARA,CIPINANG CEMPEDAK,32824,6816,26008,22914,48922,2021-12-04
3175081005,JAKARTA TIMUR,MAKASAR,CIPINANG MELAYU,42308,7824,34484,30253,64737,2021-12-04
3175031006,JAKARTA TIMUR,JATINEGARA,CIPINANG MUARA,55243,11140,44103,37434,81537,2021-12-04
3174051003,JAKARTA SELATAN,KEBAYORAN LAMA,CIPULIR,39937,7999,31938,27184,59122,2021-12-04
3175091001,JAKARTA TIMUR,CIRACAS,CIRACAS,64594,11293,53301,45649,98950,2021-12-04
3175041003,JAKARTA TIMUR,KRAMAT JATI,DUKUH,24609,4310,20299,17314,37613,2021-12-04
3175071001,JAKARTA TIMUR,DUREN SAWIT,DUREN SAWIT,61160,12272,48888,42295,91183,2021-12-04
3174081004,JAKARTA SELATAN,PANCORAN,DUREN TIGA,28319,5320,22999,19822,42821,2021-12-04
3173051005,JAKARTA BARAT,KEBON JERUK,DURI KEPA,60138,11338,48800,43185,91985,2021-12-04
3173011002,JAKARTA BARAT,CENGKARENG,DURI KOSAMBI,77923,15708,62215,52081,114296,2021-12-04
3171011006,JAKARTA PUSAT,GAMBIR,DURI PULO,19610,3974,15636,12929,28565,2021-12-04
3173041011,JAKARTA BARAT,TAMBORA,DURI SELATAN,14259,2405,11854,10278,22132,2021-12-04
3173041003,JAKARTA BARAT,TAMBORA,DURI UTARA,19844,3393,16451,13971,30422,2021-12-04
3171081003,JAKARTA PUSAT,JOHAR BARU,GALUR,18243,3406,14837,12301,27138,2021-12-04
3171011001,JAKARTA PUSAT,GAMBIR,GAMBIR,2191,443,1748,1546,3294,2021-12-04
3174061004,JAKARTA SELATAN,CILANDAK,GANDARIA SELATAN,22119,3987,18132,15974,34106,2021-12-04
3174071009,JAKARTA SELATAN,KEBAYORAN BARU,GANDARIA UTARA,39922,7486,32436,28434,60870,2021-12-04
3175051001,JAKARTA TIMUR,PASAR REBO,GEDONG,35755,6790,28965,25219,54184,2021-12-04
3171071001,JAKARTA PUSAT,TANAH ABANG,GELORA,3127,589,2538,2269,4807,2021-12-04
3173031007,JAKARTA BARAT,TAMAN SARI,GLODOK,7837,1133,6704,6199,12903,2021-12-04
3171061004,JAKARTA PUSAT,MENTENG,GONDANGDIA,4100,891,3209,2976,6185,2021-12-04
3173021001,JAKARTA BARAT,GROGOL PETAMBURAN,GROGOL,16876,3181,13695,11957,25652,2021-12-04
3174051005,JAKARTA SELATAN,KEBAYORAN LAMA,GROGOL SELATAN,44251,8369,35882,30829,66711,2021-12-04
3174051004,JAKARTA SELATAN,KEBAYORAN LAMA,GROGOL UTARA,42494,8275,34219,29450,63669,2021-12-04
3174021007,JAKARTA SELATAN,SETIA BUDI,GUNTUR,3985,718,3267,2964,6231,2021-12-04
3174071002,JAKARTA SELATAN,KEBAYORAN BARU,GUNUNG,9436,1689,7747,7058,14805,2021-12-04
3171031005,JAKARTA PUSAT,KEMAYORAN,GUNUNG SAHARI SELATAN,19199,3540,15659,13604,29263,2021-12-04
3171021004,JAKARTA PUSAT,SAWAH BESAR,GUNUNG SAHARI UTARA,16650,2799,13851,12598,26449,2021-12-04
3175081004,JAKARTA TIMUR,MAKASAR,HALIM PERDANA KUSUMAH,28363,3455,24908,23145,48053,2021-12-04
3171031003,JAKARTA PUSAT,KEMAYORAN,HARAPAN MULIA,22557,4142,18415,15585,34000,2021-12-04
3174091001,JAKARTA SELATAN,JAGAKARSA,JAGAKARSA,62389,9665,52724,46512,99236,2021-12-04
3175021007,JAKARTA TIMUR,PULO GADUNG,JATI,32757,5833,26924,24140,51064,2021-12-04
3174041002,JAKARTA SELATAN,PASAR MINGGU,JATI PADANG,37502,6779,30723,26803,57526,2021-12-04
3173071004,JAKARTA BARAT,PALMERAH,JATI PULO,28738,5425,23313,19312,42625,2021-12-04
3175061001,JAKARTA TIMUR,CAKUNG,JATINEGARA,84160,16843,67317,57447,124764,2021-12-04
3175021004,JAKARTA TIMUR,PULO GADUNG,JATINEGARA KAUM,24632,4174,20458,17282,37740,2021-12-04
3173021004,JAKARTA BARAT,GROGOL PETAMBURAN,JELAMBAR,30266,5258,25008,22649,47657,2021-12-04
3173021006,JAKARTA BARAT,GROGOL PETAMBURAN,JELAMBAR BARU,38246,6493,31753,28514,60267,2021-12-04
3173041006,JAKARTA BARAT,TAMBORA,JEMBATAN BESI,29314,6710,22604,18337,40941,2021-12-04
3173041008,JAKARTA BARAT,TAMBORA,JEMBATAN LIMA,21021,4488,16533,13569,30102,2021-12-04
3173081005,JAKARTA BARAT,KEMBANGAN,JOGLO,40839,7786,33053,28773,61826,2021-12-04
3171081001,JAKARTA PUSAT,JOHAR BARU,JOHAR BARU,37488,6639,30849,26767,57616,2021-12-04
3173041002,JAKARTA BARAT,TAMBORA,KALI ANYAR,23856,4479,19377,15942,35319,2021-12-04
3172041004,JAKARTA UTARA,CILINCING,KALIBARU,67684,17460,50224,37066,87290,2021-12-04
3174081002,JAKARTA SELATAN,PANCORAN,KALIBATA,41994,9001,32993,27969,60962,2021-12-04
3173061001,JAKARTA BARAT,KALI DERES,KALIDERES,72447,13727,58720,51237,109957,2021-12-04
3175051004,JAKARTA TIMUR,PASAR REBO,KALISARI,43212,7246,35966,31360,67326,2021-12-04
3173061004,JAKARTA BARAT,KALI DERES,KAMAL,53783,11734,42049,34883,76932,2021-12-04
3172011002,JAKARTA UTARA,PENJARINGAN,KAMAL MUARA,12930,2234,10696,9239,19935,2021-12-04
3171071007,JAKARTA PUSAT,TANAH ABANG,KAMPUNG BALI,11358,2335,9023,7270,16293,2021-12-04
3175031001,JAKARTA TIMUR,JATINEGARA,KAMPUNG MELAYU,25717,5600,20117,16368,36485,2021-12-04
3171081002,JAKARTA PUSAT,JOHAR BARU,KAMPUNG RAWA,21237,3357,17880,14664,32544,2021-12-04
3175041002,JAKARTA TIMUR,KRAMAT JATI,KAMPUNG TENGAH,43993,10360,33633,27892,61525,2021-12-04
3173011005,JAKARTA BARAT,CENGKARENG,KAPUK,134466,30637,103829,87038,190867,2021-12-04
3172011003,JAKARTA UTARA,PENJARINGAN,KAPUK MUARA,35781,6541,29240,26339,55579,2021-12-04
3171021002,JAKARTA PUSAT,SAWAH BESAR,KARANG ANYAR,25761,4626,21135,18212,39347,2021-12-04
3174021004,JAKARTA SELATAN,SETIA BUDI,KARET,9623,1776,7847,6804,14651,2021-12-04
3174021003,JAKARTA SELATAN,SETIA BUDI,KARET KUNINGAN,16055,2980,13075,11447,24522,2021-12-04
3174021002,JAKARTA SELATAN,SETIA BUDI,KARET SEMANGGI,2770,537,2233,2020,4253,2021-12-04
3171071003,JAKARTA PUSAT,TANAH ABANG,KARET TENGSIN,19271,3557,15714,13311,29025,2021-12-04
3171021003,JAKARTA PUSAT,SAWAH BESAR,KARTINI,22292,3983,18309,16145,34454,2021-12-04
3175011003,JAKARTA TIMUR,MATRAMAN,KAYU MANIS,25284,5000,20284,16860,37144,2021-12-04
3175021006,JAKARTA TIMUR,PULO GADUNG,KAYU PUTIH,40696,7326,33370,29939,63309,2021-12-04
3173031006,JAKARTA BARAT,TAMAN SARI,KEAGUNGAN,17387,3072,14315,12113,26428,2021-12-04
3174041007,JAKARTA SELATAN,PASAR MINGGU,KEBAGUSAN,44552,8311,36241,31251,67492,2021-12-04
3174051006,JAKARTA SELATAN,KEBAYORAN LAMA,KEBAYORAN LAMA SELATAN,41212,7224,33988,29926,63914,2021-12-04
3174051001,JAKARTA SELATAN,KEBAYORAN LAMA,KEBAYORAN LAMA UTARA,42422,8345,34077,29443,63520,2021-12-04
3174011004,JAKARTA SELATAN,TEBET,KEBON BARU,35165,6187,28978,25156,54134,2021-12-04
3172021005,JAKARTA UTARA,TANJUNG PRIOK,KEBON BAWANG,50952,9726,41226,35454,76680,2021-12-04
3173051001,JAKARTA BARAT,KEBON JERUK,KEBON JERUK,53887,10414,43473,36767,80240,2021-12-04
3171071006,JAKARTA PUSAT,TANAH ABANG,KEBON KACANG,21531,4920,16611,13726,30337,2021-12-04
3171011005,JAKARTA PUSAT,GAMBIR,KEBON KELAPA,10163,1957,8206,7151,15357,2021-12-04
3171031002,JAKARTA PUSAT,KEMAYORAN,KEBON KOSONG,30019,5717,24302,20782,45084,2021-12-04
3175011005,JAKARTA TIMUR,MATRAMAN,KEBON MANGGIS,16490,3025,13465,11488,24953,2021-12-04
3171071005,JAKARTA PUSAT,TANAH ABANG,KEBON MELATI,32206,8220,23986,18598,42584,2021-12-04
3175081003,JAKARTA TIMUR,MAKASAR,KEBON PALA,46614,8769,37845,32599,70444,2021-12-04
3171061005,JAKARTA PUSAT,MENTENG,KEBON SIRIH,12299,2496,9803,8210,18013,2021-12-04
3173011004,JAKARTA BARAT,CENGKARENG,KEDAUNG KALI ANGKE,32612,5958,26654,23048,49702,2021-12-04
3173051007,JAKARTA BARAT,KEBON JERUK,KEDOYA SELATAN,32165,5638,26527,22623,49150,2021-12-04
3173051006,JAKARTA BARAT,KEBON JERUK,KEDOYA UTARA,45740,8366,37374,32330,69704,2021-12-04
3173051004,JAKARTA BARAT,KEBON JERUK,KELAPA DUA,23565,4394,19171,16528,35699,2021-12-04
3175091003,JAKARTA TIMUR,CIRACAS,KELAPA DUA WETAN,46875,7630,39245,34295,73540,2021-12-04
3172061003,JAKARTA UTARA,KELAPA GADING,KELAPA GADING BARAT,35717,5975,29742,27337,57079,2021-12-04
3172061001,JAKARTA UTARA,KELAPA GADING,KELAPA GADING TIMUR,33592,4936,28656,27009,55665,2021-12-04
3173071005,JAKARTA BARAT,PALMERAH,KEMANGGISAN,32139,5772,26367,23142,49509,2021-12-04
3171031001,JAKARTA PUSAT,KEMAYORAN,KEMAYORAN,20708,3903,16805,14302,31107,2021-12-04
3173081006,JAKARTA BARAT,KEMBANGAN,KEMBANGAN SELATAN,27130,5402,21728,19164,40892,2021-12-04
3173081001,JAKARTA BARAT,KEMBANGAN,KEMBANGAN UTARA,54451,11080,43371,37074,80445,2021-12-04
3171041002,JAKARTA PUSAT,SENEN,KENARI,9579,1791,7788,6818,14606,2021-12-04
3173041005,JAKARTA BARAT,TAMBORA,KERENDANG,19973,3859,16114,13626,29740,2021-12-04
3175071003,JAKARTA TIMUR,DUREN SAWIT,KLENDER,69978,15541,54437,45248,99685,2021-12-04
3172031001,JAKARTA UTARA,KOJA,KOJA,28175,6092,22083,18440,40523,2021-12-04
3173071006,JAKARTA BARAT,PALMERAH,KOTA BAMBU SELATAN,21158,3945,17213,14152,31365,2021-12-04
3173071003,JAKARTA BARAT,PALMERAH,KOTA BAMBU UTARA,24995,4836,20159,16416,36575,2021-12-04
3171041004,JAKARTA PUSAT,SENEN,KRAMAT,28835,6231,22604,17661,40265,2021-12-04
3175041001,JAKARTA TIMUR,KRAMAT JATI,KRAMAT JATI,34144,6870,27274,22872,50146,2021-12-04
3174071003,JAKARTA SELATAN,KEBAYORAN BARU,KRAMAT PELA,14413,2669,11744,10401,22145,2021-12-04
3173031002,JAKARTA BARAT,TAMAN SARI,KRUKUT,19244,3466,15778,13266,29044,2021-12-04
3174031005,JAKARTA SELATAN,MAMPANG PRAPATAN,KUNINGAN BARAT,12785,2201,10584,9179,19763,2021-12-04
3174021008,JAKARTA SELATAN,SETIA BUDI,KUNINGAN TIMUR,6008,1142,4866,4316,9182,2021-12-04
3171041005,JAKARTA PUSAT,SENEN,KWITANG,15486,3222,12264,10148,22412,2021-12-04
3172031003,JAKARTA UTARA,KOJA,LAGOA,59065,13190,45875,37693,83568,2021-12-04
3174061002,JAKARTA SELATAN,CILANDAK,LEBAK BULUS,37626,6754,30872,27962,58834,2021-12-04
3174091004,JAKARTA SELATAN,JAGAKARSA,LENTENG AGUNG,53946,9129,44817,38143,82960,2021-12-04
3175101007,JAKARTA TIMUR,CIPAYUNG,LUBANG BUAYA,63547,11389,52158,44850,97008,2021-12-04
3175081001,JAKARTA TIMUR,MAKASAR,MAKASAR,34390,5844,28546,25038,53584,2021-12-04
3175071006,JAKARTA TIMUR,DUREN SAWIT,MALAKA JAYA,30927,4965,25962,23132,49094,2021-12-04
3175071005,JAKARTA TIMUR,DUREN SAWIT,MALAKA SARI,27530,4327,23203,20838,44041,2021-12-04
3174031001,JAKARTA SELATAN,MAMPANG PRAPATAN,MAMPANG PRAPATAN,18159,3527,14632,12518,27150,2021-12-04
3173031005,JAKARTA BARAT,TAMAN SARI,MANGGA BESAR,7707,1250,6457,5819,12276,2021-12-04
3171021005,JAKARTA PUSAT,SAWAH BESAR,MANGGA DUA SELATAN,27442,5294,22148,19196,41344,2021-12-04
3174011007,JAKARTA SELATAN,TEBET,MANGGARAI,28373,4713,23660,20058,43718,2021-12-04
3174011006,JAKARTA SELATAN,TEBET,MANGGARAI SELATAN,23075,3503,19572,16977,36549,2021-12-04
3173031003,JAKARTA BARAT,TAMAN SARI,MAPHAR,16461,2928,13533,11667,25200,2021-12-04
3172041003,JAKARTA UTARA,CILINCING,MARUNDA,28943,6190,22753,17749,40502,2021-12-04
3174071001,JAKARTA SELATAN,KEBAYORAN BARU,MELAWAI,2627,493,2134,2001,4135,2021-12-04
3171061001,JAKARTA PUSAT,MENTENG,MENTENG,25624,5320,20304,16766,37070,2021-12-04
3174021005,JAKARTA SELATAN,SETIA BUDI,MENTENG ATAS,27816,4724,23092,19990,43082,2021-12-04
3174011003,JAKARTA SELATAN,TEBET,MENTENG DALAM,36028,6639,29389,25765,55154,2021-12-04
3173081003,JAKARTA BARAT,KEMBANGAN,MERUYA SELATAN,32130,6238,25892,22587,48479,2021-12-04
3173081002,JAKARTA BARAT,KEMBANGAN,MERUYA UTARA,43752,8564,35188,31477,66665,2021-12-04
3175101004,JAKARTA TIMUR,CIPAYUNG,MUNJUL,23871,4176,19695,17176,36871,2021-12-04
3172051002,JAKARTA UTARA,PADEMANGAN,PADEMANGAN BARAT,74240,16574,57666,48075,105741,2021-12-04
3172051001,JAKARTA UTARA,PADEMANGAN,PADEMANGAN TIMUR,37736,6324,31412,28425,59837,2021-12-04
3175011004,JAKARTA TIMUR,MATRAMAN,PAL MERIAM,19769,3782,15987,13349,29336,2021-12-04
3173071001,JAKARTA BARAT,PALMERAH,PALMERAH,63011,12452,50559,42781,93340,2021-12-04
3174081001,JAKARTA SELATAN,PANCORAN,PANCORAN,19421,3645,15776,13577,29353,2021-12-04
3172021003,JAKARTA UTARA,TANJUNG PRIOK,PAPANGGO,39097,7300,31797,27056,58853,2021-12-04
3171021001,JAKARTA PUSAT,SAWAH BESAR,PASAR BARU,12035,2189,9846,8991,18837,2021-12-04
3174021006,JAKARTA SELATAN,SETIA BUDI,PASAR MANGGIS,26752,4808,21944,18840,40784,2021-12-04
3174041001,JAKARTA SELATAN,PASAR MINGGU,PASAR MINGGU,24821,4443,20378,18020,38398,2021-12-04
3171041003,JAKARTA PUSAT,SENEN,PASEBAN,23533,4640,18893,15983,34876,2021-12-04
3173061005,JAKARTA BARAT,KALI DERES,PEGADUNGAN,75587,13938,61649,54144,115793,2021-12-04
3171061002,JAKARTA PUSAT,MENTENG,PEGANGSAAN,23455,4789,18666,15080,33746,2021-12-04
3172061002,JAKARTA UTARA,KELAPA GADING,PEGANGSAAN DUA,49976,7935,42041,38755,80796,2021-12-04
3172011004,JAKARTA UTARA,PENJARINGAN,PEJAGALAN,74578,14709,59869,53285,113154,2021-12-04
3174041006,JAKARTA SELATAN,PASAR MINGGU,PEJATEN BARAT,37346,6812,30534,26701,57235,2021-12-04
3174041005,JAKARTA SELATAN,PASAR MINGGU,PEJATEN TIMUR,57656,11738,45918,38555,84473,2021-12-04
3175051005,JAKARTA TIMUR,PASAR REBO,PEKAYON,43250,7412,35838,30924,66762,2021-12-04
3173041009,JAKARTA BARAT,TAMBORA,PEKOJAN,23587,4271,19316,16806,36122,2021-12-04
3174031003,JAKARTA SELATAN,MAMPANG PRAPATAN,PELA MAMPANG,43522,8117,35405,30874,66279,2021-12-04
3174081005,JAKARTA SELATAN,PANCORAN,PENGADEGAN,21478,3749,17729,15638,33367,2021-12-04
3175061003,JAKARTA TIMUR,CAKUNG,PENGGILINGAN,99255,21418,77837,64584,142421,2021-12-04
3172011001,JAKARTA UTARA,PENJARINGAN,PENJARINGAN,88308,21625,66683,53592,120275,2021-12-04
3174101001,JAKARTA SELATAN,PESANGGRAHAN,PESANGGRAHAN,27545,4508,23037,20372,43409,2021-12-04
3171071004,JAKARTA PUSAT,TANAH ABANG,PETAMBURAN,33271,8367,24904,19784,44688,2021-12-04
3174071008,JAKARTA SELATAN,KEBAYORAN BARU,PETOGOGAN,11499,2100,9399,8270,17669,2021-12-04
3171011004,JAKARTA PUSAT,GAMBIR,PETOJO SELATAN,14692,3168,11524,10029,21553,2021-12-04
3171011003,JAKARTA PUSAT,GAMBIR,PETOJO UTARA,17458,3613,13845,11735,25580,2021-12-04
3174101004,JAKARTA SELATAN,PESANGGRAHAN,PETUKANGAN SELATAN,37187,7275,29912,26164,56076,2021-12-04
3174101003,JAKARTA SELATAN,PESANGGRAHAN,PETUKANGAN UTARA,53716,10929,42787,36915,79702,2021-12-04
3175081002,JAKARTA TIMUR,MAKASAR,PINANG RANTI,27198,5627,21571,18408,39979,2021-12-04
3173031008,JAKARTA BARAT,TAMAN SARI,PINANGSIA,10729,1792,8937,7626,16563,2021-12-04
3175011001,JAKARTA TIMUR,MATRAMAN,PISANGAN BARU,31776,6182,25594,21280,46874,2021-12-04
3175021002,JAKARTA TIMUR,PULO GADUNG,PISANGAN TIMUR,41011,7147,33864,29725,63589,2021-12-04
3172011005,JAKARTA UTARA,PENJARINGAN,PLUIT,47783,8936,38847,34816,73663,2021-12-04
3175071002,JAKARTA TIMUR,DUREN SAWIT,PONDOK BAMBU,61550,12288,49262,42750,92012,2021-12-04
3175071004,JAKARTA TIMUR,DUREN SAWIT,PONDOK KELAPA,72015,13628,58387,51668,110055,2021-12-04
3175071007,JAKARTA TIMUR,DUREN SAWIT,PONDOK KOPI,35367,6326,29041,24444,53485,2021-12-04
3174061003,JAKARTA SELATAN,CILANDAK,PONDOK LABU,46464,7276,39188,35277,74465,2021-12-04
3174051002,JAKARTA SELATAN,KEBAYORAN LAMA,PONDOK PINANG,56169,10295,45874,40695,86569,2021-12-04
3175101003,JAKARTA TIMUR,CIPAYUNG,PONDOK RANGGON,25574,4581,20993,18370,39363,2021-12-04
3101011003,KAB.ADM.KEP.SERIBU,KEP. SERIBU UTARA,PULAU HARAPAN,2060,200,1860,1665,3525,2021-12-04
3101011002,KAB.ADM.KEP.SERIBU,KEP. SERIBU UTARA,PULAU KELAPA,5528,564,4964,4205,9169,2021-12-04
3101011001,KAB.ADM.KEP.SERIBU,KEP. SERIBU UTARA,PULAU PANGGANG,5450,423,5027,4543,9570,2021-12-04
3101021003,KAB.ADM.KEP.SERIBU,KEP. SERIBU SELATAN,PULAU PARI,2765,191,2574,2441,5015,2021-12-04
3101021002,KAB.ADM.KEP.SERIBU,KEP. SERIBU SELATAN,PULAU TIDUNG,4553,355,4198,3906,8104,2021-12-04
3101021001,KAB.ADM.KEP.SERIBU,KEP. SERIBU SELATAN,PULAU UNTUNG JAWA,1941,154,1787,1664,3451,2021-12-04
3174071007,JAKARTA SELATAN,KEBAYORAN BARU,PULO,5835,973,4862,4564,9426,2021-12-04
3175021001,JAKARTA TIMUR,PULO GADUNG,PULO GADUNG,34422,7168,27254,23498,50752,2021-12-04
3175061005,JAKARTA TIMUR,CAKUNG,PULO GEBANG,97301,17770,79531,67046,146577,2021-12-04
3174041004,JAKARTA SELATAN,PASAR MINGGU,RAGUNAN,39616,6627,32989,29067,62056,2021-12-04
3175091005,JAKARTA TIMUR,CIRACAS,RAMBUTAN,36771,8185,28586,24082,52668,2021-12-04
3172031006,JAKARTA UTARA,KOJA,RAWA BADAK SELATAN,42179,9458,32721,26829,59550,2021-12-04
3172031004,JAKARTA UTARA,KOJA,RAWA BADAK UTARA,34408,7307,27101,22832,49933,2021-12-04
3174071005,JAKARTA SELATAN,KEBAYORAN BARU,RAWA BARAT,5625,966,4659,4234,8893,2021-12-04
3173011003,JAKARTA BARAT,CENGKARENG,RAWA BUAYA,63799,11918,51881,44507,96388,2021-12-04
3175031004,JAKARTA TIMUR,JATINEGARA,RAWA BUNGA,21434,4861,16573,14008,30581,2021-12-04
3174081003,JAKARTA SELATAN,PANCORAN,RAWA JATI,20509,3719,16790,14829,31619,2021-12-04
3175061002,JAKARTA TIMUR,CAKUNG,RAWA TERATE,24637,4212,20425,17256,37681,2021-12-04
3175021005,JAKARTA TIMUR,PULO GADUNG,RAWAMANGUN,37612,7034,30578,26863,57441,2021-12-04
3171051003,JAKARTA PUSAT,CEMPAKA PUTIH,RAWASARI,21967,4209,17758,15698,33456,2021-12-04
3173041010,JAKARTA BARAT,TAMBORA,ROA MALAKA,3484,594,2890,2638,5528,2021-12-04
3172041006,JAKARTA UTARA,CILINCING,ROROTAN,41668,7954,33714,28237,61951,2021-12-04
3174071004,JAKARTA SELATAN,KEBAYORAN BARU,SELONG,2842,534,2308,2167,4475,2021-12-04
3173061002,JAKARTA BARAT,KALI DERES,SEMANAN,71354,14106,57248,47689,104937,2021-12-04
3172041007,JAKARTA UTARA,CILINCING,SEMPER BARAT,68587,12687,55900,48068,103968,2021-12-04
3172041005,JAKARTA UTARA,CILINCING,SEMPER TIMUR,36267,7340,28927,24277,53204,2021-12-04
3174071006,JAKARTA SELATAN,KEBAYORAN BARU,SENAYAN,2771,631,2140,1911,4051,2021-12-04
3171041001,JAKARTA PUSAT,SENEN,SENEN,6804,1367,5437,4641,10078,2021-12-04
3171031004,JAKARTA PUSAT,KEMAYORAN,SERDANG,29668,5393,24275,20944,45219,2021-12-04
3174021001,JAKARTA SELATAN,SETIA BUDI,SETIA BUDI,3023,581,2442,2159,4601,2021-12-04
3175101005,JAKARTA TIMUR,CIPAYUNG,SETU,20572,3907,16665,14178,30843,2021-12-04
3173071002,JAKARTA BARAT,PALMERAH,SLIPI,16591,2823,13768,12070,25838,2021-12-04
3173081004,JAKARTA BARAT,KEMBANGAN,SRENGSENG,45523,9628,35895,31228,67123,2021-12-04
3174091002,JAKARTA SELATAN,JAGAKARSA,SRENGSENG SAWAH,58196,8409,49787,44306,94093,2021-12-04
3173051003,JAKARTA BARAT,KEBON JERUK,SUKABUMI SELATAN,37033,7347,29686,23842,53528,2021-12-04
3173051002,JAKARTA BARAT,KEBON JERUK,SUKABUMI UTARA,38290,8190,30100,24375,54475,2021-12-04
3172041002,JAKARTA UTARA,CILINCING,SUKAPURA,53949,11555,42394,36084,78478,2021-12-04
3171031007,JAKARTA PUSAT,KEMAYORAN,SUMUR BATU,22717,4063,18654,16454,35108,2021-12-04
3172021004,JAKARTA UTARA,TANJUNG PRIOK,SUNGAI BAMBU,29876,5633,24243,20798,45041,2021-12-04
3172021006,JAKARTA UTARA,TANJUNG PRIOK,SUNTER AGUNG,71805,11864,59941,53975,113916,2021-12-04
3172021002,JAKARTA UTARA,TANJUNG PRIOK,SUNTER JAYA,63031,10532,52499,46954,99453,2021-12-04
3175091004,JAKARTA TIMUR,CIRACAS,SUSUKAN,38257,6854,31403,27031,58434,2021-12-04
3173031001,JAKARTA BARAT,TAMAN SARI,TAMAN SARI,14348,2509,11839,10460,22299,2021-12-04
3173041001,JAKARTA BARAT,TAMBORA,TAMBORA,10204,2098,8106,6755,14861,2021-12-04
3173041004,JAKARTA BARAT,TAMBORA,TANAH SEREAL,26387,4240,22147,19043,41190,2021-12-04
3171081004,JAKARTA PUSAT,JOHAR BARU,TANAH TINGGI,37693,6903,30790,25656,56446,2021-12-04
3173031004,JAKARTA BARAT,TAMAN SARI,TANGKI,13324,2119,11205,9816,21021,2021-12-04
3174091005,JAKARTA SELATAN,JAGAKARSA,TANJUNG BARAT,39770,6408,33362,28798,62160,2021-12-04
3173021005,JAKARTA BARAT,GROGOL PETAMBURAN,TANJUNG DUREN SELATAN,25337,4601,20736,18894,39630,2021-12-04
3173021002,JAKARTA BARAT,GROGOL PETAMBURAN,TANJUNG DUREN UTARA,17010,2733,14277,13147,27424,2021-12-04
3172021001,JAKARTA UTARA,TANJUNG PRIOK,TANJUNG PRIOK,34588,6792,27796,23424,51220,2021-12-04
3174011002,JAKARTA SELATAN,TEBET,TEBET BARAT,21194,3216,17978,16330,34308,2021-12-04
3174011001,JAKARTA SELATAN,TEBET,TEBET TIMUR,18199,2775,15424,14321,29745,2021-12-04
3173061003,JAKARTA BARAT,KALI DERES,TEGAL ALUR,83647,16448,67199,57319,124518,2021-12-04
3174031004,JAKARTA SELATAN,MAMPANG PRAPATAN,TEGAL PARANG,32401,6758,25643,20944,46587,2021-12-04
3173021003,JAKARTA BARAT,GROGOL PETAMBURAN,TOMANG,29605,5182,24423,21717,46140,2021-12-04
3172031005,JAKARTA UTARA,KOJA,TUGU SELATAN,39122,8229,30893,25928,56821,2021-12-04
3172031002,JAKARTA UTARA,KOJA,TUGU UTARA,67670,15235,52435,43153,95588,2021-12-04
3175061006,JAKARTA TIMUR,CAKUNG,UJUNG MENTENG,29934,4899,25035,21964,46999,2021-12-04
3174101005,JAKARTA SELATAN,PESANGGRAHAN,ULUJAMI,40544,8459,32085,27421,59506,2021-12-04
3175011006,JAKARTA TIMUR,MATRAMAN,UTAN KAYU SELATAN,33511,5675,27836,23923,51759,2021-12-04
3175011002,JAKARTA TIMUR,MATRAMAN,UTAN KAYU UTARA,28169,5391,22778,19251,42029,2021-12-04
3171031008,JAKARTA PUSAT,KEMAYORAN,UTAN PANJANG,29208,5462,23746,19913,43659,2021-12-04
3172021007,JAKARTA UTARA,TANJUNG PRIOK,WARAKAS,44401,7765,36636,30728,67364,2021-12-04
3173021007,JAKARTA BARAT,GROGOL PETAMBURAN,WIJAYA KUSUMA,38934,7643,31291,27208,58499,2021-12-04
3172051003,JAKARTA UTARA,PADEMANGAN,ANCOL,23947,5483,18464,15561,34025,2021-12-05
3173041007,JAKARTA BARAT,TAMBORA,ANGKE,29381,5925,23456,19582,43038,2021-12-05
3175041005,JAKARTA TIMUR,KRAMAT JATI,BALE KAMBANG,29074,6721,22353,18237,40590,2021-12-05
3175031003,JAKARTA TIMUR,JATINEGARA,BALI MESTER,9752,1902,7850,6820,14670,2021-12-05
3175101006,JAKARTA TIMUR,CIPAYUNG,BAMBU APUS,26285,4571,21714,18839,40553,2021-12-05
3174031002,JAKARTA SELATAN,MAMPANG PRAPATAN,BANGKA,21566,4317,17249,14804,32053,2021-12-05
3175051002,JAKARTA TIMUR,PASAR REBO,BARU,23886,3741,20145,17938,38083,2021-12-05
3175041004,JAKARTA TIMUR,KRAMAT JATI,BATU AMPAR,47898,10881,37017,30934,67951,2021-12-05
3171071002,JAKARTA PUSAT,TANAH ABANG,BENDUNGAN HILIR,21494,4150,17344,15237,32581,2021-12-05
3175031002,JAKARTA TIMUR,JATINEGARA,BIDARA CINA,36689,8366,28323,23869,52192,2021-12-05
3174101002,JAKARTA SELATAN,PESANGGRAHAN,BINTARO,53098,10177,42921,38483,81404,2021-12-05
3174011005,JAKARTA SELATAN,TEBET,BUKIT DURI,34183,6484,27699,23888,51587,2021-12-05
3171041006,JAKARTA PUSAT,SENEN,BUNGUR,18144,3591,14553,12423,26976,2021-12-05
3175061007,JAKARTA TIMUR,CAKUNG,CAKUNG BARAT,57724,11180,46544,39332,85876,2021-12-05
3175061004,JAKARTA TIMUR,CAKUNG,CAKUNG TIMUR,58287,10869,47418,40569,87987,2021-12-05
3175041007,JAKARTA TIMUR,KRAMAT JATI,CAWANG,32762,6566,26196,21952,48148,2021-12-05
3175101008,JAKARTA TIMUR,CIPAYUNG,CEGER,18932,3488,15444,13310,28754,2021-12-05
3171031006,JAKARTA PUSAT,KEMAYORAN,CEMPAKA BARU,32581,5817,26764,22763,49527,2021-12-05
3171051002,JAKARTA PUSAT,CEMPAKA PUTIH,CEMPAKA PUTIH BARAT,35885,7136,28749,25293,54042,2021-12-05
3171051001,JAKARTA PUSAT,CEMPAKA PUTIH,CEMPAKA PUTIH TIMUR,24292,4764,19528,17600,37128,2021-12-05
3173011001,JAKARTA BARAT,CENGKARENG,CENGKARENG BARAT,66284,12516,53768,47652,101420,2021-12-05
3173011006,JAKARTA BARAT,CENGKARENG,CENGKARENG TIMUR,81027,15183,65844,56761,122605,2021-12-05
3175091002,JAKARTA TIMUR,CIRACAS,CIBUBUR,66364,10863,55501,48598,104099,2021-12-05
3171011002,JAKARTA PUSAT,GAMBIR,CIDENG,15390,2893,12497,11156,23653,2021-12-05
3174091003,JAKARTA SELATAN,JAGAKARSA,CIGANJUR,38497,6144,32353,28047,60400,2021-12-05
3175051003,JAKARTA TIMUR,PASAR REBO,CIJANTUNG,41419,7280,34139,29535,63674,2021-12-05
3171061003,JAKARTA PUSAT,MENTENG,CIKINI,8274,1428,6846,5661,12507,2021-12-05
3174081006,JAKARTA SELATAN,PANCORAN,CIKOKO,10547,1731,8816,7837,16653,2021-12-05
3174061001,JAKARTA SELATAN,CILANDAK,CILANDAK BARAT,51752,8677,43075,38863,81938,2021-12-05
3174041003,JAKARTA SELATAN,PASAR MINGGU,CILANDAK TIMUR,25145,4307,20838,18378,39216,2021-12-05
3175101002,JAKARTA TIMUR,CIPAYUNG,CILANGKAP,27635,4657,22978,20185,43163,2021-12-05
3175041006,JAKARTA TIMUR,KRAMAT JATI,CILILITAN,40181,7948,32233,27106,59339,2021-12-05
3172041001,JAKARTA UTARA,CILINCING,CILINCING,43609,9829,33780,27289,61069,2021-12-05
3175101001,JAKARTA TIMUR,CIPAYUNG,CIPAYUNG,26104,4318,21786,19250,41036,2021-12-05
3174091006,JAKARTA SELATAN,JAGAKARSA,CIPEDAK,38303,6023,32280,28312,60592,2021-12-05
3174061005,JAKARTA SELATAN,CILANDAK,CIPETE SELATAN,26704,4821,21883,19788,41671,2021-12-05
3174071010,JAKARTA SELATAN,KEBAYORAN BARU,CIPETE UTARA,34102,6163,27939,24282,52221,2021-12-05
3175021003,JAKARTA TIMUR,PULO GADUNG,CIPINANG,39306,6720,32586,28147,60733,2021-12-05
3175031007,JAKARTA TIMUR,JATINEGARA,CIPINANG BESAR SELATAN,35212,7884,27328,22603,49931,2021-12-05
3175031008,JAKARTA TIMUR,JATINEGARA,CIPINANG BESAR UTARA,45319,10069,35250,28810,64060,2021-12-05
3175031005,JAKARTA TIMUR,JATINEGARA,CIPINANG CEMPEDAK,32824,6808,26016,22945,48961,2021-12-05
3175081005,JAKARTA TIMUR,MAKASAR,CIPINANG MELAYU,42308,7821,34487,30266,64753,2021-12-05
3175031006,JAKARTA TIMUR,JATINEGARA,CIPINANG MUARA,55243,11134,44109,37449,81558,2021-12-05
3174051003,JAKARTA SELATAN,KEBAYORAN LAMA,CIPULIR,39937,7994,31943,27195,59138,2021-12-05
3175091001,JAKARTA TIMUR,CIRACAS,CIRACAS,64594,11286,53308,45661,98969,2021-12-05
3175041003,JAKARTA TIMUR,KRAMAT JATI,DUKUH,24609,4304,20305,17316,37621,2021-12-05
3175071001,JAKARTA TIMUR,DUREN SAWIT,DUREN SAWIT,61160,12262,48898,42307,91205,2021-12-05
3174081004,JAKARTA SELATAN,PANCORAN,DUREN TIGA,28319,5319,23000,19827,42827,2021-12-05
3173051005,JAKARTA BARAT,KEBON JERUK,DURI KEPA,60138,11329,48809,43211,92020,2021-12-05
3173011002,JAKARTA BARAT,CENGKARENG,DURI KOSAMBI,77923,15701,62222,52108,114330,2021-12-05
3171011006,JAKARTA PUSAT,GAMBIR,DURI PULO,19610,3973,15637,12945,28582,2021-12-05
3173041011,JAKARTA BARAT,TAMBORA,DURI SELATAN,14259,2400,11859,10286,22145,2021-12-05
3173041003,JAKARTA BARAT,TAMBORA,DURI UTARA,19844,3388,16456,13971,30427,2021-12-05
3171081003,JAKARTA PUSAT,JOHAR BARU,GALUR,18243,3403,14840,12304,27144,2021-12-05
3171011001,JAKARTA PUSAT,GAMBIR,GAMBIR,2191,442,1749,1546,3295,2021-12-05
3174061004,JAKARTA SELATAN,CILANDAK,GANDARIA SELATAN,22119,3984,18135,15981,34116,2021-12-05
3174071009,JAKARTA SELATAN,KEBAYORAN BARU,GANDARIA UTARA,39922,7483,32439,28450,60889,2021-12-05
3175051001,JAKARTA TIMUR,PASAR REBO,GEDONG,35755,6786,28969,25230,54199,2021-12-05
3171071001,JAKARTA PUSAT,TANAH ABANG,GELORA,3127,589,2538,2271,4809,2021-12-05
3173031007,JAKARTA BARAT,TAMAN SARI,GLODOK,7837,1131,6706,6204,12910,2021-12-05
3171061004,JAKARTA PUSAT,MENTENG,GONDANGDIA,4100,891,3209,2979,6188,2021-12-05
3173021001,JAKARTA BARAT,GROGOL PETAMBURAN,GROGOL,16876,3176,13700,11959,25659,2021-12-05
3174051005,JAKARTA SELATAN,KEBAYORAN LAMA,GROGOL SELATAN,44251,8363,35888,30841,66729,2021-12-05
3174051004,JAKARTA SELATAN,KEBAYORAN LAMA,GROGOL UTARA,42494,8269,34225,29462,63687,2021-12-05
3174021007,JAKARTA SELATAN,SETIA BUDI,GUNTUR,3985,718,3267,2976,6243,2021-12-05
3174071002,JAKARTA SELATAN,KEBAYORAN BARU,GUNUNG,9436,1688,7748,7061,14809,2021-12-05
3171031005,JAKARTA PUSAT,KEMAYORAN,GUNUNG SAHARI SELATAN,19199,3537,15662,13608,29270,2021-12-05
3171021004,JAKARTA PUSAT,SAWAH BESAR,GUNUNG SAHARI UTARA,16650,2795,13855,12603,26458,2021-12-05
3175081004,JAKARTA TIMUR,MAKASAR,HALIM PERDANA KUSUMAH,28363,3454,24909,23151,48060,2021-12-05
3171031003,JAKARTA PUSAT,KEMAYORAN,HARAPAN MULIA,22557,4141,18416,15598,34014,2021-12-05
3174091001,JAKARTA SELATAN,JAGAKARSA,JAGAKARSA,62389,9662,52727,46553,99280,2021-12-05
3175021007,JAKARTA TIMUR,PULO GADUNG,JATI,32757,5832,26925,24148,51073,2021-12-05
3174041002,JAKARTA SELATAN,PASAR MINGGU,JATI PADANG,37502,6775,30727,26819,57546,2021-12-05
3173071004,JAKARTA BARAT,PALMERAH,JATI PULO,28738,5423,23315,19323,42638,2021-12-05
3175061001,JAKARTA TIMUR,CAKUNG,JATINEGARA,84160,16825,67335,57464,124799,2021-12-05
3175021004,JAKARTA TIMUR,PULO GADUNG,JATINEGARA KAUM,24632,4174,20458,17283,37741,2021-12-05
3173021004,JAKARTA BARAT,GROGOL PETAMBURAN,JELAMBAR,30266,5252,25014,22660,47674,2021-12-05
3173021006,JAKARTA BARAT,GROGOL PETAMBURAN,JELAMBAR BARU,38246,6487,31759,28531,60290,2021-12-05
3173041006,JAKARTA BARAT,TAMBORA,JEMBATAN BESI,29314,6704,22610,18355,40965,2021-12-05
3173041008,JAKARTA BARAT,TAMBORA,JEMBATAN LIMA,21021,4479,16542,13586,30128,2021-12-05
3173081005,JAKARTA BARAT,KEMBANGAN,JOGLO,40839,7776,33063,28782,61845,2021-12-05
3171081001,JAKARTA PUSAT,JOHAR BARU,JOHAR BARU,37488,6631,30857,26776,57633,2021-12-05
3173041002,JAKARTA BARAT,TAMBORA,KALI ANYAR,23856,4476,19380,15949,35329,2021-12-05
3172041004,JAKARTA UTARA,CILINCING,KALIBARU,67684,17426,50258,37156,87414,2021-12-05
3174081002,JAKARTA SELATAN,PANCORAN,KALIBATA,41994,8997,32997,27989,60986,2021-12-05
3173061001,JAKARTA BARAT,KALI DERES,KALIDERES,72447,13720,58727,51267,109994,2021-12-05
3175051004,JAKARTA TIMUR,PASAR REBO,KALISARI,43212,7245,35967,31372,67339,2021-12-05
3173061004,JAKARTA BARAT,KALI DERES,KAMAL,53783,11727,42056,34895,76951,2021-12-05
3172011002,JAKARTA UTARA,PENJARINGAN,KAMAL MUARA,12930,2234,10696,9240,19936,2021-12-05
3171071007,JAKARTA PUSAT,TANAH ABANG,KAMPUNG BALI,11358,2335,9023,7277,16300,2021-12-05
3175031001,JAKARTA TIMUR,JATINEGARA,KAMPUNG MELAYU,25717,5596,20121,16385,36506,2021-12-05
3171081002,JAKARTA PUSAT,JOHAR BARU,KAMPUNG RAWA,21237,3357,17880,14669,32549,2021-12-05
3175041002,JAKARTA TIMUR,KRAMAT JATI,KAMPUNG TENGAH,43993,10289,33704,27934,61638,2021-12-05
3173011005,JAKARTA BARAT,CENGKARENG,KAPUK,134466,30535,103931,87232,191163,2021-12-05
3172011003,JAKARTA UTARA,PENJARINGAN,KAPUK MUARA,35781,6533,29248,26351,55599,2021-12-05
3171021002,JAKARTA PUSAT,SAWAH BESAR,KARANG ANYAR,25761,4624,21137,18225,39362,2021-12-05
3174021004,JAKARTA SELATAN,SETIA BUDI,KARET,9623,1774,7849,6808,14657,2021-12-05
3174021003,JAKARTA SELATAN,SETIA BUDI,KARET KUNINGAN,16055,2977,13078,11452,24530,2021-12-05
3174021002,JAKARTA SELATAN,SETIA BUDI,KARET SEMANGGI,2770,537,2233,2021,4254,2021-12-05
3171071003,JAKARTA PUSAT,TANAH ABANG,KARET TENGSIN,19271,3555,15716,13320,29036,2021-12-05
3171021003,JAKARTA PUSAT,SAWAH BESAR,KARTINI,22292,3981,18311,16154,34465,2021-12-05
3175011003,JAKARTA TIMUR,MATRAMAN,KAYU MANIS,25284,4998,20286,16870,37156,2021-12-05
3175021006,JAKARTA TIMUR,PULO GADUNG,KAYU PUTIH,40696,7320,33376,29954,63330,2021-12-05
3173031006,JAKARTA BARAT,TAMAN SARI,KEAGUNGAN,17387,3071,14316,12120,26436,2021-12-05
3174041007,JAKARTA SELATAN,PASAR MINGGU,KEBAGUSAN,44552,8306,36246,31263,67509,2021-12-05
3174051006,JAKARTA SELATAN,KEBAYORAN LAMA,KEBAYORAN LAMA SELATAN,41212,7223,33989,29936,63925,2021-12-05
3174051001,JAKARTA SELATAN,KEBAYORAN LAMA,KEBAYORAN LAMA UTARA,42422,8342,34080,29460,63540,2021-12-05
3174011004,JAKARTA SELATAN,TEBET,KEBON BARU,35165,6182,28983,25168,54151,2021-12-05
3172021005,JAKARTA UTARA,TANJUNG PRIOK,KEBON BAWANG,50952,9715,41237,35502,76739,2021-12-05
3173051001,JAKARTA BARAT,KEBON JERUK,KEBON JERUK,53887,10407,43480,36788,80268,2021-12-05
3171071006,JAKARTA PUSAT,TANAH ABANG,KEBON KACANG,21531,4918,16613,13733,30346,2021-12-05
3171011005,JAKARTA PUSAT,GAMBIR,KEBON KELAPA,10163,1955,8208,7157,15365,2021-12-05
3171031002,JAKARTA PUSAT,KEMAYORAN,KEBON KOSONG,30019,5713,24306,20791,45097,2021-12-05
3175011005,JAKARTA TIMUR,MATRAMAN,KEBON MANGGIS,16490,3021,13469,11493,24962,2021-12-05
3171071005,JAKARTA PUSAT,TANAH ABANG,KEBON MELATI,32206,8211,23995,18618,42613,2021-12-05
3175081003,JAKARTA TIMUR,MAKASAR,KEBON PALA,46614,8766,37848,32611,70459,2021-12-05
3171061005,JAKARTA PUSAT,MENTENG,KEBON SIRIH,12299,2490,9809,8214,18023,2021-12-05
3173011004,JAKARTA BARAT,CENGKARENG,KEDAUNG KALI ANGKE,32612,5952,26660,23057,49717,2021-12-05
3173051007,JAKARTA BARAT,KEBON JERUK,KEDOYA SELATAN,32165,5635,26530,22640,49170,2021-12-05
3173051006,JAKARTA BARAT,KEBON JERUK,KEDOYA UTARA,45740,8359,37381,32344,69725,2021-12-05
3173051004,JAKARTA BARAT,KEBON JERUK,KELAPA DUA,23565,4389,19176,16538,35714,2021-12-05
3175091003,JAKARTA TIMUR,CIRACAS,KELAPA DUA WETAN,46875,7624,39251,34312,73563,2021-12-05
3172061003,JAKARTA UTARA,KELAPA GADING,KELAPA GADING BARAT,35717,5972,29745,27348,57093,2021-12-05
3172061001,JAKARTA UTARA,KELAPA GADING,KELAPA GADING TIMUR,33592,4930,28662,27019,55681,2021-12-05
3173071005,JAKARTA BARAT,PALMERAH,KEMANGGISAN,32139,5768,26371,23151,49522,2021-12-05
3171031001,JAKARTA PUSAT,KEMAYORAN,KEMAYORAN,20708,3901,16807,14311,31118,2021-12-05
3173081006,JAKARTA BARAT,KEMBANGAN,KEMBANGAN SELATAN,27130,5398,21732,19169,40901,2021-12-05
3173081001,JAKARTA BARAT,KEMBANGAN,KEMBANGAN UTARA,54451,11069,43382,37079,80461,2021-12-05
3171041002,JAKARTA PUSAT,SENEN,KENARI,9579,1791,7788,6818,14606,2021-12-05
3173041005,JAKARTA BARAT,TAMBORA,KERENDANG,19973,3856,16117,13638,29755,2021-12-05
3175071003,JAKARTA TIMUR,DUREN SAWIT,KLENDER,69978,15532,54446,45273,99719,2021-12-05
3172031001,JAKARTA UTARA,KOJA,KOJA,28175,6086,22089,18458,40547,2021-12-05
3173071006,JAKARTA BARAT,PALMERAH,KOTA BAMBU SELATAN,21158,3943,17215,14161,31376,2021-12-05
3173071003,JAKARTA BARAT,PALMERAH,KOTA BAMBU UTARA,24995,4824,20171,16428,36599,2021-12-05
3171041004,JAKARTA PUSAT,SENEN,KRAMAT,28835,6228,22607,17667,40274,2021-12-05
3175041001,JAKARTA TIMUR,KRAMAT JATI,KRAMAT JATI,34144,6841,27303,22893,50196,2021-12-05
3174071003,JAKARTA SELATAN,KEBAYORAN BARU,KRAMAT PELA,14413,2669,11744,10404,22148,2021-12-05
3173031002,JAKARTA BARAT,TAMAN SARI,KRUKUT,19244,3465,15779,13274,29053,2021-12-05
3174031005,JAKARTA SELATAN,MAMPANG PRAPATAN,KUNINGAN BARAT,12785,2199,10586,9183,19769,2021-12-05
3174021008,JAKARTA SELATAN,SETIA BUDI,KUNINGAN TIMUR,6008,1141,4867,4319,9186,2021-12-05
3171041005,JAKARTA PUSAT,SENEN,KWITANG,15486,3221,12265,10150,22415,2021-12-05
3172031003,JAKARTA UTARA,KOJA,LAGOA,59065,13183,45882,37720,83602,2021-12-05
3174061002,JAKARTA SELATAN,CILANDAK,LEBAK BULUS,37626,6747,30879,27980,58859,2021-12-05
3174091004,JAKARTA SELATAN,JAGAKARSA,LENTENG AGUNG,53946,9124,44822,38155,82977,2021-12-05
3175101007,JAKARTA TIMUR,CIPAYUNG,LUBANG BUAYA,63547,11375,52172,44893,97065,2021-12-05
3175081001,JAKARTA TIMUR,MAKASAR,MAKASAR,34390,5842,28548,25045,53593,2021-12-05
3175071006,JAKARTA TIMUR,DUREN SAWIT,MALAKA JAYA,30927,4961,25966,23146,49112,2021-12-05
3175071005,JAKARTA TIMUR,DUREN SAWIT,MALAKA SARI,27530,4326,23204,20842,44046,2021-12-05
3174031001,JAKARTA SELATAN,MAMPANG PRAPATAN,MAMPANG PRAPATAN,18159,3523,14636,12525,27161,2021-12-05
3173031005,JAKARTA BARAT,TAMAN SARI,MANGGA BESAR,7707,1249,6458,5822,12280,2021-12-05
3171021005,JAKARTA PUSAT,SAWAH BESAR,MANGGA DUA SELATAN,27442,5288,22154,19208,41362,2021-12-05
3174011007,JAKARTA SELATAN,TEBET,MANGGARAI,28373,4707,23666,20068,43734,2021-12-05
3174011006,JAKARTA SELATAN,TEBET,MANGGARAI SELATAN,23075,3502,19573,16985,36558,2021-12-05
3173031003,JAKARTA BARAT,TAMAN SARI,MAPHAR,16461,2926,13535,11675,25210,2021-12-05
3172041003,JAKARTA UTARA,CILINCING,MARUNDA,28943,6189,22754,17755,40509,2021-12-05
3174071001,JAKARTA SELATAN,KEBAYORAN BARU,MELAWAI,2627,493,2134,2004,4138,2021-12-05
3171061001,JAKARTA PUSAT,MENTENG,MENTENG,25624,5318,20306,16773,37079,2021-12-05
3174021005,JAKARTA SELATAN,SETIA BUDI,MENTENG ATAS,27816,4722,23094,20002,43096,2021-12-05
3174011003,JAKARTA SELATAN,TEBET,MENTENG DALAM,36028,6636,29392,25784,55176,2021-12-05
3173081003,JAKARTA BARAT,KEMBANGAN,MERUYA SELATAN,32130,6237,25893,22591,48484,2021-12-05
3173081002,JAKARTA BARAT,KEMBANGAN,MERUYA UTARA,43752,8556,35196,31491,66687,2021-12-05
3175101004,JAKARTA TIMUR,CIPAYUNG,MUNJUL,23871,4174,19697,17181,36878,2021-12-05
3172051002,JAKARTA UTARA,PADEMANGAN,PADEMANGAN BARAT,74240,16560,57680,48109,105789,2021-12-05
3172051001,JAKARTA UTARA,PADEMANGAN,PADEMANGAN TIMUR,37736,6320,31416,28439,59855,2021-12-05
3175011004,JAKARTA TIMUR,MATRAMAN,PAL MERIAM,19769,3778,15991,13361,29352,2021-12-05
3173071001,JAKARTA BARAT,PALMERAH,PALMERAH,63011,12439,50572,42802,93374,2021-12-05
3174081001,JAKARTA SELATAN,PANCORAN,PANCORAN,19421,3642,15779,13580,29359,2021-12-05
3172021003,JAKARTA UTARA,TANJUNG PRIOK,PAPANGGO,39097,7293,31804,27063,58867,2021-12-05
3171021001,JAKARTA PUSAT,SAWAH BESAR,PASAR BARU,12035,2188,9847,8996,18843,2021-12-05
3174021006,JAKARTA SELATAN,SETIA BUDI,PASAR MANGGIS,26752,4806,21946,18851,40797,2021-12-05
3174041001,JAKARTA SELATAN,PASAR MINGGU,PASAR MINGGU,24821,4439,20382,18031,38413,2021-12-05
3171041003,JAKARTA PUSAT,SENEN,PASEBAN,23533,4639,18894,15989,34883,2021-12-05
3173061005,JAKARTA BARAT,KALI DERES,PEGADUNGAN,75587,13931,61656,54193,115849,2021-12-05
3171061002,JAKARTA PUSAT,MENTENG,PEGANGSAAN,23455,4787,18668,15093,33761,2021-12-05
3172061002,JAKARTA UTARA,KELAPA GADING,PEGANGSAAN DUA,49976,7927,42049,38771,80820,2021-12-05
3172011004,JAKARTA UTARA,PENJARINGAN,PEJAGALAN,74578,14701,59877,53327,113204,2021-12-05
3174041006,JAKARTA SELATAN,PASAR MINGGU,PEJATEN BARAT,37346,6809,30537,26711,57248,2021-12-05
3174041005,JAKARTA SELATAN,PASAR MINGGU,PEJATEN TIMUR,57656,11731,45925,38579,84504,2021-12-05
3175051005,JAKARTA TIMUR,PASAR REBO,PEKAYON,43250,7408,35842,30933,66775,2021-12-05
3173041009,JAKARTA BARAT,TAMBORA,PEKOJAN,23587,4267,19320,16815,36135,2021-12-05
3174031003,JAKARTA SELATAN,MAMPANG PRAPATAN,PELA MAMPANG,43522,8112,35410,30894,66304,2021-12-05
3174081005,JAKARTA SELATAN,PANCORAN,PENGADEGAN,21478,3743,17735,15647,33382,2021-12-05
3175061003,JAKARTA TIMUR,CAKUNG,PENGGILINGAN,99255,21404,77851,64607,142458,2021-12-05
3172011001,JAKARTA UTARA,PENJARINGAN,PENJARINGAN,88308,21600,66708,53657,120365,2021-12-05
3174101001,JAKARTA SELATAN,PESANGGRAHAN,PESANGGRAHAN,27545,4505,23040,20376,43416,2021-12-05
3171071004,JAKARTA PUSAT,TANAH ABANG,PETAMBURAN,33271,8358,24913,19802,44715,2021-12-05
3174071008,JAKARTA SELATAN,KEBAYORAN BARU,PETOGOGAN,11499,2098,9401,8273,17674,2021-12-05
3171011004,JAKARTA PUSAT,GAMBIR,PETOJO SELATAN,14692,3167,11525,10033,21558,2021-12-05
3171011003,JAKARTA PUSAT,GAMBIR,PETOJO UTARA,17458,3612,13846,11739,25585,2021-12-05
3174101004,JAKARTA SELATAN,PESANGGRAHAN,PETUKANGAN SELATAN,37187,7267,29920,26176,56096,2021-12-05
3174101003,JAKARTA SELATAN,PESANGGRAHAN,PETUKANGAN UTARA,53716,10919,42797,36949,79746,2021-12-05
3175081002,JAKARTA TIMUR,MAKASAR,PINANG RANTI,27198,5625,21573,18413,39986,2021-12-05
3173031008,JAKARTA BARAT,TAMAN SARI,PINANGSIA,10729,1789,8940,7630,16570,2021-12-05
3175011001,JAKARTA TIMUR,MATRAMAN,PISANGAN BARU,31776,6178,25598,21284,46882,2021-12-05
3175021002,JAKARTA TIMUR,PULO GADUNG,PISANGAN TIMUR,41011,7146,33865,29732,63597,2021-12-05
3172011005,JAKARTA UTARA,PENJARINGAN,PLUIT,47783,8932,38851,34839,73690,2021-12-05
3175071002,JAKARTA TIMUR,DUREN SAWIT,PONDOK BAMBU,61550,12277,49273,42771,92044,2021-12-05
3175071004,JAKARTA TIMUR,DUREN SAWIT,PONDOK KELAPA,72015,13623,58392,51684,110076,2021-12-05
3175071007,JAKARTA TIMUR,DUREN SAWIT,PONDOK KOPI,35367,6324,29043,24456,53499,2021-12-05
3174061003,JAKARTA SELATAN,CILANDAK,PONDOK LABU,46464,7270,39194,35293,74487,2021-12-05
3174051002,JAKARTA SELATAN,KEBAYORAN LAMA,PONDOK PINANG,56169,10291,45878,40712,86590,2021-12-05
3175101003,JAKARTA TIMUR,CIPAYUNG,PONDOK RANGGON,25574,4579,20995,18375,39370,2021-12-05
3101011003,KAB.ADM.KEP.SERIBU,KEP. SERIBU UTARA,PULAU HARAPAN,2060,200,1860,1665,3525,2021-12-05
3101011002,KAB.ADM.KEP.SERIBU,KEP. SERIBU UTARA,PULAU KELAPA,5528,564,4964,4205,9169,2021-12-05
3101011001,KAB.ADM.KEP.SERIBU,KEP. SERIBU UTARA,PULAU PANGGANG,5450,423,5027,4543,9570,2021-12-05
3101021003,KAB.ADM.KEP.SERIBU,KEP. SERIBU SELATAN,PULAU PARI,2765,191,2574,2441,5015,2021-12-05
3101021002,KAB.ADM.KEP.SERIBU,KEP. SERIBU SELATAN,PULAU TIDUNG,4553,355,4198,3908,8106,2021-12-05
3101021001,KAB.ADM.KEP.SERIBU,KEP. SERIBU SELATAN,PULAU UNTUNG JAWA,1941,154,1787,1664,3451,2021-12-05
3174071007,JAKARTA SELATAN,KEBAYORAN BARU,PULO,5835,972,4863,4567,9430,2021-12-05
3175021001,JAKARTA TIMUR,PULO GADUNG,PULO GADUNG,34422,7165,27257,23506,50763,2021-12-05
3175061005,JAKARTA TIMUR,CAKUNG,PULO GEBANG,97301,17761,79540,67067,146607,2021-12-05
3174041004,JAKARTA SELATAN,PASAR MINGGU,RAGUNAN,39616,6620,32996,29083,62079,2021-12-05
3175091005,JAKARTA TIMUR,CIRACAS,RAMBUTAN,36771,8181,28590,24090,52680,2021-12-05
3172031006,JAKARTA UTARA,KOJA,RAWA BADAK SELATAN,42179,9445,32734,26846,59580,2021-12-05
3172031004,JAKARTA UTARA,KOJA,RAWA BADAK UTARA,34408,7301,27107,22845,49952,2021-12-05
3174071005,JAKARTA SELATAN,KEBAYORAN BARU,RAWA BARAT,5625,966,4659,4238,8897,2021-12-05
3173011003,JAKARTA BARAT,CENGKARENG,RAWA BUAYA,63799,11913,51886,44520,96406,2021-12-05
3175031004,JAKARTA TIMUR,JATINEGARA,RAWA BUNGA,21434,4860,16574,14011,30585,2021-12-05
3174081003,JAKARTA SELATAN,PANCORAN,RAWA JATI,20509,3717,16792,14841,31633,2021-12-05
3175061002,JAKARTA TIMUR,CAKUNG,RAWA TERATE,24637,4211,20426,17262,37688,2021-12-05
3175021005,JAKARTA TIMUR,PULO GADUNG,RAWAMANGUN,37612,7026,30586,26868,57454,2021-12-05
3171051003,JAKARTA PUSAT,CEMPAKA PUTIH,RAWASARI,21967,4208,17759,15704,33463,2021-12-05
3173041010,JAKARTA BARAT,TAMBORA,ROA MALAKA,3484,594,2890,2640,5530,2021-12-05
3172041006,JAKARTA UTARA,CILINCING,ROROTAN,41668,7949,33719,28252,61971,2021-12-05
3174071004,JAKARTA SELATAN,KEBAYORAN BARU,SELONG,2842,534,2308,2170,4478,2021-12-05
3173061002,JAKARTA BARAT,KALI DERES,SEMANAN,71354,14093,57261,47708,104969,2021-12-05
3172041007,JAKARTA UTARA,CILINCING,SEMPER BARAT,68587,12684,55903,48094,103997,2021-12-05
3172041005,JAKARTA UTARA,CILINCING,SEMPER TIMUR,36267,7332,28935,24288,53223,2021-12-05
3174071006,JAKARTA SELATAN,KEBAYORAN BARU,SENAYAN,2771,631,2140,1911,4051,2021-12-05
3171041001,JAKARTA PUSAT,SENEN,SENEN,6804,1366,5438,4643,10081,2021-12-05
3171031004,JAKARTA PUSAT,KEMAYORAN,SERDANG,29668,5390,24278,20954,45232,2021-12-05
3174021001,JAKARTA SELATAN,SETIA BUDI,SETIA BUDI,3023,580,2443,2160,4603,2021-12-05
3175101005,JAKARTA TIMUR,CIPAYUNG,SETU,20572,3904,16668,14186,30854,2021-12-05
3173071002,JAKARTA BARAT,PALMERAH,SLIPI,16591,2820,13771,12074,25845,2021-12-05
3173081004,JAKARTA BARAT,KEMBANGAN,SRENGSENG,45523,9626,35897,31243,67140,2021-12-05
3174091002,JAKARTA SELATAN,JAGAKARSA,SRENGSENG SAWAH,58196,8403,49793,44319,94112,2021-12-05
3173051003,JAKARTA BARAT,KEBON JERUK,SUKABUMI SELATAN,37033,7343,29690,23850,53540,2021-12-05
3173051002,JAKARTA BARAT,KEBON JERUK,SUKABUMI UTARA,38290,8172,30118,24409,54527,2021-12-05
3172041002,JAKARTA UTARA,CILINCING,SUKAPURA,53949,11549,42400,36103,78503,2021-12-05
3171031007,JAKARTA PUSAT,KEMAYORAN,SUMUR BATU,22717,4062,18655,16458,35113,2021-12-05
3172021004,JAKARTA UTARA,TANJUNG PRIOK,SUNGAI BAMBU,29876,5632,24244,20808,45052,2021-12-05
3172021006,JAKARTA UTARA,TANJUNG PRIOK,SUNTER AGUNG,71805,11854,59951,54002,113953,2021-12-05
3172021002,JAKARTA UTARA,TANJUNG PRIOK,SUNTER JAYA,63031,10523,52508,46966,99474,2021-12-05
3175091004,JAKARTA TIMUR,CIRACAS,SUSUKAN,38257,6847,31410,27041,58451,2021-12-05
3173031001,JAKARTA BARAT,TAMAN SARI,TAMAN SARI,14348,2507,11841,10467,22308,2021-12-05
3173041001,JAKARTA BARAT,TAMBORA,TAMBORA,10204,2096,8108,6762,14870,2021-12-05
3173041004,JAKARTA BARAT,TAMBORA,TANAH SEREAL,26387,4234,22153,19052,41205,2021-12-05
3171081004,JAKARTA PUSAT,JOHAR BARU,TANAH TINGGI,37693,6897,30796,25666,56462,2021-12-05
3173031004,JAKARTA BARAT,TAMAN SARI,TANGKI,13324,2114,11210,9822,21032,2021-12-05
3174091005,JAKARTA SELATAN,JAGAKARSA,TANJUNG BARAT,39770,6403,33367,28806,62173,2021-12-05
3173021005,JAKARTA BARAT,GROGOL PETAMBURAN,TANJUNG DUREN SELATAN,25337,4598,20739,18907,39646,2021-12-05
3173021002,JAKARTA BARAT,GROGOL PETAMBURAN,TANJUNG DUREN UTARA,17010,2731,14279,13154,27433,2021-12-05
3172021001,JAKARTA UTARA,TANJUNG PRIOK,TANJUNG PRIOK,34588,6787,27801,23435,51236,2021-12-05
3174011002,JAKARTA SELATAN,TEBET,TEBET BARAT,21194,3215,17979,16339,34318,2021-12-05
3174011001,JAKARTA SELATAN,TEBET,TEBET TIMUR,18199,2774,15425,14324,29749,2021-12-05
3173061003,JAKARTA BARAT,KALI DERES,TEGAL ALUR,83647,16436,67211,57341,124552,2021-12-05
3174031004,JAKARTA SELATAN,MAMPANG PRAPATAN,TEGAL PARANG,32401,6753,25648,20955,46603,2021-12-05
3173021003,JAKARTA BARAT,GROGOL PETAMBURAN,TOMANG,29605,5175,24430,21723,46153,2021-12-05
3172031005,JAKARTA UTARA,KOJA,TUGU SELATAN,39122,8222,30900,25945,56845,2021-12-05
3172031002,JAKARTA UTARA,KOJA,TUGU UTARA,67670,15227,52443,43179,95622,2021-12-05
3175061006,JAKARTA TIMUR,CAKUNG,UJUNG MENTENG,29934,4894,25040,21975,47015,2021-12-05
3174101005,JAKARTA SELATAN,PESANGGRAHAN,ULUJAMI,40544,8448,32096,27470,59566,2021-12-05
3175011006,JAKARTA TIMUR,MATRAMAN,UTAN KAYU SELATAN,33511,5669,27842,23935,51777,2021-12-05
3175011002,JAKARTA TIMUR,MATRAMAN,UTAN KAYU UTARA,28169,5389,22780,19260,42040,2021-12-05
3171031008,JAKARTA PUSAT,KEMAYORAN,UTAN PANJANG,29208,5458,23750,19921,43671,2021-12-05
3172021007,JAKARTA UTARA,TANJUNG PRIOK,WARAKAS,44401,7755,36646,30738,67384,2021-12-05
3173021007,JAKARTA BARAT,GROGOL PETAMBURAN,WIJAYA KUSUMA,38934,7629,31305,27230,58535,2021-12-05
3172051003,JAKARTA UTARA,PADEMANGAN,ANCOL,23947,5482,18465,15561,34026,2021-12-06
3173041007,JAKARTA BARAT,TAMBORA,ANGKE,29381,5898,23483,19596,43079,2021-12-06
3175041005,JAKARTA TIMUR,KRAMAT JATI,BALE KAMBANG,29074,6701,22373,18249,40622,2021-12-06
3175031003,JAKARTA TIMUR,JATINEGARA,BALI MESTER,9752,1900,7852,6822,14674,2021-12-06
3175101006,JAKARTA TIMUR,CIPAYUNG,BAMBU APUS,26285,4571,21714,18841,40555,2021-12-06
3174031002,JAKARTA SELATAN,MAMPANG PRAPATAN,BANGKA,21566,4317,17249,14805,32054,2021-12-06
3175051002,JAKARTA TIMUR,PASAR REBO,BARU,23886,3741,20145,17939,38084,2021-12-06
3175041004,JAKARTA TIMUR,KRAMAT JATI,BATU AMPAR,47898,10878,37020,30941,67961,2021-12-06
3171071002,JAKARTA PUSAT,TANAH ABANG,BENDUNGAN HILIR,21494,4150,17344,15240,32584,2021-12-06
3175031002,JAKARTA TIMUR,JATINEGARA,BIDARA CINA,36689,8364,28325,23878,52203,2021-12-06
3174101002,JAKARTA SELATAN,PESANGGRAHAN,BINTARO,53098,10174,42924,38483,81407,2021-12-06
3174011005,JAKARTA SELATAN,TEBET,BUKIT DURI,34183,6484,27699,23891,51590,2021-12-06
3171041006,JAKARTA PUSAT,SENEN,BUNGUR,18144,3591,14553,12426,26979,2021-12-06
3175061007,JAKARTA TIMUR,CAKUNG,CAKUNG BARAT,57724,11167,46557,39347,85904,2021-12-06
3175061004,JAKARTA TIMUR,CAKUNG,CAKUNG TIMUR,58287,10862,47425,40580,88005,2021-12-06
3175041007,JAKARTA TIMUR,KRAMAT JATI,CAWANG,32762,6562,26200,21955,48155,2021-12-06
3175101008,JAKARTA TIMUR,CIPAYUNG,CEGER,18932,3488,15444,13312,28756,2021-12-06
3171031006,JAKARTA PUSAT,KEMAYORAN,CEMPAKA BARU,32581,5816,26765,22769,49534,2021-12-06
3171051002,JAKARTA PUSAT,CEMPAKA PUTIH,CEMPAKA PUTIH BARAT,35885,7136,28749,25294,54043,2021-12-06
3171051001,JAKARTA PUSAT,CEMPAKA PUTIH,CEMPAKA PUTIH TIMUR,24292,4764,19528,17602,37130,2021-12-06
3173011001,JAKARTA BARAT,CENGKARENG,CENGKARENG BARAT,66284,12513,53771,47654,101425,2021-12-06
3173011006,JAKARTA BARAT,CENGKARENG,CENGKARENG TIMUR,81027,15183,65844,56767,122611,2021-12-06
3175091002,JAKARTA TIMUR,CIRACAS,CIBUBUR,66364,10859,55505,48601,104106,2021-12-06
3171011002,JAKARTA PUSAT,GAMBIR,CIDENG,15390,2891,12499,11156,23655,2021-12-06
3174091003,JAKARTA SELATAN,JAGAKARSA,CIGANJUR,38497,6143,32354,28048,60402,2021-12-06
3175051003,JAKARTA TIMUR,PASAR REBO,CIJANTUNG,41419,7280,34139,29538,63677,2021-12-06
3171061003,JAKARTA PUSAT,MENTENG,CIKINI,8274,1428,6846,5662,12508,2021-12-06
3174081006,JAKARTA SELATAN,PANCORAN,CIKOKO,10547,1731,8816,7838,16654,2021-12-06
3174061001,JAKARTA SELATAN,CILANDAK,CILANDAK BARAT,51752,8677,43075,38868,81943,2021-12-06
3174041003,JAKARTA SELATAN,PASAR MINGGU,CILANDAK TIMUR,25145,4306,20839,18380,39219,2021-12-06
3175101002,JAKARTA TIMUR,CIPAYUNG,CILANGKAP,27635,4657,22978,20185,43163,2021-12-06
3175041006,JAKARTA TIMUR,KRAMAT JATI,CILILITAN,40181,7948,32233,27108,59341,2021-12-06
3172041001,JAKARTA UTARA,CILINCING,CILINCING,43609,9827,33782,27297,61079,2021-12-06
3175101001,JAKARTA TIMUR,CIPAYUNG,CIPAYUNG,26104,4314,21790,19250,41040,2021-12-06
3174091006,JAKARTA SELATAN,JAGAKARSA,CIPEDAK,38303,6021,32282,28312,60594,2021-12-06
3174061005,JAKARTA SELATAN,CILANDAK,CIPETE SELATAN,26704,4821,21883,19790,41673,2021-12-06
3174071010,JAKARTA SELATAN,KEBAYORAN BARU,CIPETE UTARA,34102,6161,27941,24283,52224,2021-12-06
3175021003,JAKARTA TIMUR,PULO GADUNG,CIPINANG,39306,6719,32587,28149,60736,2021-12-06
3175031007,JAKARTA TIMUR,JATINEGARA,CIPINANG BESAR SELATAN,35212,7883,27329,22609,49938,2021-12-06
3175031008,JAKARTA TIMUR,JATINEGARA,CIPINANG BESAR UTARA,45319,10067,35252,28812,64064,2021-12-06
3175031005,JAKARTA TIMUR,JATINEGARA,CIPINANG CEMPEDAK,32824,6798,26026,22973,48999,2021-12-06
3175081005,JAKARTA TIMUR,MAKASAR,CIPINANG MELAYU,42308,7821,34487,30268,64755,2021-12-06
3175031006,JAKARTA TIMUR,JATINEGARA,CIPINANG MUARA,55243,11134,44109,37451,81560,2021-12-06
3174051003,JAKARTA SELATAN,KEBAYORAN LAMA,CIPULIR,39937,7993,31944,27196,59140,2021-12-06
3175091001,JAKARTA TIMUR,CIRACAS,CIRACAS,64594,11286,53308,45667,98975,2021-12-06
3175041003,JAKARTA TIMUR,KRAMAT JATI,DUKUH,24609,4303,20306,17316,37622,2021-12-06
3175071001,JAKARTA TIMUR,DUREN SAWIT,DUREN SAWIT,61160,12259,48901,42311,91212,2021-12-06
3174081004,JAKARTA SELATAN,PANCORAN,DUREN TIGA,28319,5319,23000,19830,42830,2021-12-06
3173051005,JAKARTA BARAT,KEBON JERUK,DURI KEPA,60138,11327,48811,43215,92026,2021-12-06
3173011002,JAKARTA BARAT,CENGKARENG,DURI KOSAMBI,77923,15698,62225,52110,114335,2021-12-06
3171011006,JAKARTA PUSAT,GAMBIR,DURI PULO,19610,3971,15639,12946,28585,2021-12-06
3173041011,JAKARTA BARAT,TAMBORA,DURI SELATAN,14259,2400,11859,10288,22147,2021-12-06
3173041003,JAKARTA BARAT,TAMBORA,DURI UTARA,19844,3387,16457,13972,30429,2021-12-06
3171081003,JAKARTA PUSAT,JOHAR BARU,GALUR,18243,3401,14842,12304,27146,2021-12-06
3171011001,JAKARTA PUSAT,GAMBIR,GAMBIR,2191,442,1749,1546,3295,2021-12-06
3174061004,JAKARTA SELATAN,CILANDAK,GANDARIA SELATAN,22119,3983,18136,15984,34120,2021-12-06
3174071009,JAKARTA SELATAN,KEBAYORAN BARU,GANDARIA UTARA,39922,7481,32441,28454,60895,2021-12-06
3175051001,JAKARTA TIMUR,PASAR REBO,GEDONG,35755,6785,28970,25232,54202,2021-12-06
3171071001,JAKARTA PUSAT,TANAH ABANG,GELORA,3127,589,2538,2272,4810,2021-12-06
3173031007,JAKARTA BARAT,TAMAN SARI,GLODOK,7837,1130,6707,6204,12911,2021-12-06
3171061004,JAKARTA PUSAT,MENTENG,GONDANGDIA,4100,891,3209,2979,6188,2021-12-06
3173021001,JAKARTA BARAT,GROGOL PETAMBURAN,GROGOL,16876,3176,13700,11959,25659,2021-12-06
3174051005,JAKARTA SELATAN,KEBAYORAN LAMA,GROGOL SELATAN,44251,8360,35891,30842,66733,2021-12-06
3174051004,JAKARTA SELATAN,KEBAYORAN LAMA,GROGOL UTARA,42494,8268,34226,29462,63688,2021-12-06
3174021007,JAKARTA SELATAN,SETIA BUDI,GUNTUR,3985,718,3267,2976,6243,2021-12-06
3174071002,JAKARTA SELATAN,KEBAYORAN BARU,GUNUNG,9436,1688,7748,7063,14811,2021-12-06
3171031005,JAKARTA PUSAT,KEMAYORAN,GUNUNG SAHARI SELATAN,19199,3535,15664,13609,29273,2021-12-06
3171021004,JAKARTA PUSAT,SAWAH BESAR,GUNUNG SAHARI UTARA,16650,2795,13855,12604,26459,2021-12-06
3175081004,JAKARTA TIMUR,MAKASAR,HALIM PERDANA KUSUMAH,28363,3454,24909,23152,48061,2021-12-06
3171031003,JAKARTA PUSAT,KEMAYORAN,HARAPAN MULIA,22557,4140,18417,15598,34015,2021-12-06
3174091001,JAKARTA SELATAN,JAGAKARSA,JAGAKARSA,62389,9659,52730,46555,99285,2021-12-06
3175021007,JAKARTA TIMUR,PULO GADUNG,JATI,32757,5832,26925,24150,51075,2021-12-06
3174041002,JAKARTA SELATAN,PASAR MINGGU,JATI PADANG,37502,6774,30728,26820,57548,2021-12-06
3173071004,JAKARTA BARAT,PALMERAH,JATI PULO,28738,5423,23315,19324,42639,2021-12-06
3175061001,JAKARTA TIMUR,CAKUNG,JATINEGARA,84160,16820,67340,57467,124807,2021-12-06
3175021004,JAKARTA TIMUR,PULO GADUNG,JATINEGARA KAUM,24632,4173,20459,17286,37745,2021-12-06
3173021004,JAKARTA BARAT,GROGOL PETAMBURAN,JELAMBAR,30266,5248,25018,22662,47680,2021-12-06
3173021006,JAKARTA BARAT,GROGOL PETAMBURAN,JELAMBAR BARU,38246,6483,31763,28535,60298,2021-12-06
3173041006,JAKARTA BARAT,TAMBORA,JEMBATAN BESI,29314,6704,22610,18357,40967,2021-12-06
3173041008,JAKARTA BARAT,TAMBORA,JEMBATAN LIMA,21021,4474,16547,13587,30134,2021-12-06
3173081005,JAKARTA BARAT,KEMBANGAN,JOGLO,40839,7776,33063,28784,61847,2021-12-06
3171081001,JAKARTA PUSAT,JOHAR BARU,JOHAR BARU,37488,6630,30858,26777,57635,2021-12-06
3173041002,JAKARTA BARAT,TAMBORA,KALI ANYAR,23856,4474,19382,15950,35332,2021-12-06
3172041004,JAKARTA UTARA,CILINCING,KALIBARU,67684,17416,50268,37179,87447,2021-12-06
3174081002,JAKARTA SELATAN,PANCORAN,KALIBATA,41994,8993,33001,27990,60991,2021-12-06
3173061001,JAKARTA BARAT,KALI DERES,KALIDERES,72447,13715,58732,51273,110005,2021-12-06
3175051004,JAKARTA TIMUR,PASAR REBO,KALISARI,43212,7243,35969,31374,67343,2021-12-06
3173061004,JAKARTA BARAT,KALI DERES,KAMAL,53783,11722,42061,34900,76961,2021-12-06
3172011002,JAKARTA UTARA,PENJARINGAN,KAMAL MUARA,12930,2234,10696,9241,19937,2021-12-06
3171071007,JAKARTA PUSAT,TANAH ABANG,KAMPUNG BALI,11358,2333,9025,7277,16302,2021-12-06
3175031001,JAKARTA TIMUR,JATINEGARA,KAMPUNG MELAYU,25717,5596,20121,16386,36507,2021-12-06
3171081002,JAKARTA PUSAT,JOHAR BARU,KAMPUNG RAWA,21237,3355,17882,14672,32554,2021-12-06
3175041002,JAKARTA TIMUR,KRAMAT JATI,KAMPUNG TENGAH,43993,10286,33707,27939,61646,2021-12-06
3173011005,JAKARTA BARAT,CENGKARENG,KAPUK,134466,30524,103942,87278,191220,2021-12-06
3172011003,JAKARTA UTARA,PENJARINGAN,KAPUK MUARA,35781,6532,29249,26352,55601,2021-12-06
3171021002,JAKARTA PUSAT,SAWAH BESAR,KARANG ANYAR,25761,4623,21138,18227,39365,2021-12-06
3174021004,JAKARTA SELATAN,SETIA BUDI,KARET,9623,1774,7849,6809,14658,2021-12-06
3174021003,JAKARTA SELATAN,SETIA BUDI,KARET KUNINGAN,16055,2977,13078,11454,24532,2021-12-06
3174021002,JAKARTA SELATAN,SETIA BUDI,KARET SEMANGGI,2770,536,2234,2022,4256,2021-12-06
3171071003,JAKARTA PUSAT,TANAH ABANG,KARET TENGSIN,19271,3555,15716,13321,29037,2021-12-06
3171021003,JAKARTA PUSAT,SAWAH BESAR,KARTINI,22292,3981,18311,16154,34465,2021-12-06
3175011003,JAKARTA TIMUR,MATRAMAN,KAYU MANIS,25284,4998,20286,16871,37157,2021-12-06
3175021006,JAKARTA TIMUR,PULO GADUNG,KAYU PUTIH,40696,7320,33376,29956,63332,2021-12-06
3173031006,JAKARTA BARAT,TAMAN SARI,KEAGUNGAN,17387,3071,14316,12120,26436,2021-12-06
3174041007,JAKARTA SELATAN,PASAR MINGGU,KEBAGUSAN,44552,8306,36246,31264,67510,2021-12-06
3174051006,JAKARTA SELATAN,KEBAYORAN LAMA,KEBAYORAN LAMA SELATAN,41212,7221,33991,29936,63927,2021-12-06
3174051001,JAKARTA SELATAN,KEBAYORAN LAMA,KEBAYORAN LAMA UTARA,42422,8341,34081,29462,63543,2021-12-06
3174011004,JAKARTA SELATAN,TEBET,KEBON BARU,35165,6181,28984,25171,54155,2021-12-06
3172021005,JAKARTA UTARA,TANJUNG PRIOK,KEBON BAWANG,50952,9712,41240,35502,76742,2021-12-06
3173051001,JAKARTA BARAT,KEBON JERUK,KEBON JERUK,53887,10405,43482,36796,80278,2021-12-06
3171071006,JAKARTA PUSAT,TANAH ABANG,KEBON KACANG,21531,4917,16614,13734,30348,2021-12-06
3171011005,JAKARTA PUSAT,GAMBIR,KEBON KELAPA,10163,1955,8208,7159,15367,2021-12-06
3171031002,JAKARTA PUSAT,KEMAYORAN,KEBON KOSONG,30019,5711,24308,20791,45099,2021-12-06
3175011005,JAKARTA TIMUR,MATRAMAN,KEBON MANGGIS,16490,3020,13470,11494,24964,2021-12-06
3171071005,JAKARTA PUSAT,TANAH ABANG,KEBON MELATI,32206,8210,23996,18620,42616,2021-12-06
3175081003,JAKARTA TIMUR,MAKASAR,KEBON PALA,46614,8765,37849,32613,70462,2021-12-06
3171061005,JAKARTA PUSAT,MENTENG,KEBON SIRIH,12299,2490,9809,8214,18023,2021-12-06
3173011004,JAKARTA BARAT,CENGKARENG,KEDAUNG KALI ANGKE,32612,5949,26663,23060,49723,2021-12-06
3173051007,JAKARTA BARAT,KEBON JERUK,KEDOYA SELATAN,32165,5631,26534,22645,49179,2021-12-06
3173051006,JAKARTA BARAT,KEBON JERUK,KEDOYA UTARA,45740,8358,37382,32352,69734,2021-12-06
3173051004,JAKARTA BARAT,KEBON JERUK,KELAPA DUA,23565,4388,19177,16544,35721,2021-12-06
3175091003,JAKARTA TIMUR,CIRACAS,KELAPA DUA WETAN,46875,7624,39251,34315,73566,2021-12-06
3172061003,JAKARTA UTARA,KELAPA GADING,KELAPA GADING BARAT,35717,5969,29748,27354,57102,2021-12-06
3172061001,JAKARTA UTARA,KELAPA GADING,KELAPA GADING TIMUR,33592,4926,28666,27023,55689,2021-12-06
3173071005,JAKARTA BARAT,PALMERAH,KEMANGGISAN,32139,5767,26372,23152,49524,2021-12-06
3171031001,JAKARTA PUSAT,KEMAYORAN,KEMAYORAN,20708,3900,16808,14313,31121,2021-12-06
3173081006,JAKARTA BARAT,KEMBANGAN,KEMBANGAN SELATAN,27130,5397,21733,19169,40902,2021-12-06
3173081001,JAKARTA BARAT,KEMBANGAN,KEMBANGAN UTARA,54451,11065,43386,37080,80466,2021-12-06
3171041002,JAKARTA PUSAT,SENEN,KENARI,9579,1791,7788,6818,14606,2021-12-06
3173041005,JAKARTA BARAT,TAMBORA,KERENDANG,19973,3856,16117,13639,29756,2021-12-06
3175071003,JAKARTA TIMUR,DUREN SAWIT,KLENDER,69978,15526,54452,45280,99732,2021-12-06
3172031001,JAKARTA UTARA,KOJA,KOJA,28175,6085,22090,18458,40548,2021-12-06
3173071006,JAKARTA BARAT,PALMERAH,KOTA BAMBU SELATAN,21158,3943,17215,14162,31377,2021-12-06
3173071003,JAKARTA BARAT,PALMERAH,KOTA BAMBU UTARA,24995,4823,20172,16430,36602,2021-12-06
3171041004,JAKARTA PUSAT,SENEN,KRAMAT,28835,6228,22607,17670,40277,2021-12-06
3175041001,JAKARTA TIMUR,KRAMAT JATI,KRAMAT JATI,34144,6823,27321,22902,50223,2021-12-06
3174071003,JAKARTA SELATAN,KEBAYORAN BARU,KRAMAT PELA,14413,2668,11745,10404,22149,2021-12-06
3173031002,JAKARTA BARAT,TAMAN SARI,KRUKUT,19244,3465,15779,13277,29056,2021-12-06
3174031005,JAKARTA SELATAN,MAMPANG PRAPATAN,KUNINGAN BARAT,12785,2199,10586,9184,19770,2021-12-06
3174021008,JAKARTA SELATAN,SETIA BUDI,KUNINGAN TIMUR,6008,1141,4867,4320,9187,2021-12-06
3171041005,JAKARTA PUSAT,SENEN,KWITANG,15486,3221,12265,10150,22415,2021-12-06
3172031003,JAKARTA UTARA,KOJA,LAGOA,59065,13177,45888,37727,83615,2021-12-06
3174061002,JAKARTA SELATAN,CILANDAK,LEBAK BULUS,37626,6746,30880,27983,58863,2021-12-06
3174091004,JAKARTA SELATAN,JAGAKARSA,LENTENG AGUNG,53946,9122,44824,38156,82980,2021-12-06
3175101007,JAKARTA TIMUR,CIPAYUNG,LUBANG BUAYA,63547,11372,52175,44899,97074,2021-12-06
3175081001,JAKARTA TIMUR,MAKASAR,MAKASAR,34390,5838,28552,25046,53598,2021-12-06
3175071006,JAKARTA TIMUR,DUREN SAWIT,MALAKA JAYA,30927,4961,25966,23153,49119,2021-12-06
3175071005,JAKARTA TIMUR,DUREN SAWIT,MALAKA SARI,27530,4324,23206,20844,44050,2021-12-06
3174031001,JAKARTA SELATAN,MAMPANG PRAPATAN,MAMPANG PRAPATAN,18159,3523,14636,12525,27161,2021-12-06
3173031005,JAKARTA BARAT,TAMAN SARI,MANGGA BESAR,7707,1249,6458,5822,12280,2021-12-06
3171021005,JAKARTA PUSAT,SAWAH BESAR,MANGGA DUA SELATAN,27442,5287,22155,19209,41364,2021-12-06
3174011007,JAKARTA SELATAN,TEBET,MANGGARAI,28373,4707,23666,20072,43738,2021-12-06
3174011006,JAKARTA SELATAN,TEBET,MANGGARAI SELATAN,23075,3502,19573,16987,36560,2021-12-06
3173031003,JAKARTA BARAT,TAMAN SARI,MAPHAR,16461,2926,13535,11677,25212,2021-12-06
3172041003,JAKARTA UTARA,CILINCING,MARUNDA,28943,6188,22755,17756,40511,2021-12-06
3174071001,JAKARTA SELATAN,KEBAYORAN BARU,MELAWAI,2627,493,2134,2004,4138,2021-12-06
3171061001,JAKARTA PUSAT,MENTENG,MENTENG,25624,5317,20307,16773,37080,2021-12-06
3174021005,JAKARTA SELATAN,SETIA BUDI,MENTENG ATAS,27816,4720,23096,20002,43098,2021-12-06
3174011003,JAKARTA SELATAN,TEBET,MENTENG DALAM,36028,6634,29394,25789,55183,2021-12-06
3173081003,JAKARTA BARAT,KEMBANGAN,MERUYA SELATAN,32130,6236,25894,22592,48486,2021-12-06
3173081002,JAKARTA BARAT,KEMBANGAN,MERUYA UTARA,43752,8555,35197,31494,66691,2021-12-06
3175101004,JAKARTA TIMUR,CIPAYUNG,MUNJUL,23871,4174,19697,17184,36881,2021-12-06
3172051002,JAKARTA UTARA,PADEMANGAN,PADEMANGAN BARAT,74240,16555,57685,48118,105803,2021-12-06
3172051001,JAKARTA UTARA,PADEMANGAN,PADEMANGAN TIMUR,37736,6320,31416,28440,59856,2021-12-06
3175011004,JAKARTA TIMUR,MATRAMAN,PAL MERIAM,19769,3778,15991,13364,29355,2021-12-06
3173071001,JAKARTA BARAT,PALMERAH,PALMERAH,63011,12439,50572,42803,93375,2021-12-06
3174081001,JAKARTA SELATAN,PANCORAN,PANCORAN,19421,3642,15779,13582,29361,2021-12-06
3172021003,JAKARTA UTARA,TANJUNG PRIOK,PAPANGGO,39097,7292,31805,27065,58870,2021-12-06
3171021001,JAKARTA PUSAT,SAWAH BESAR,PASAR BARU,12035,2188,9847,8996,18843,2021-12-06
3174021006,JAKARTA SELATAN,SETIA BUDI,PASAR MANGGIS,26752,4805,21947,18851,40798,2021-12-06
3174041001,JAKARTA SELATAN,PASAR MINGGU,PASAR MINGGU,24821,4438,20383,18032,38415,2021-12-06
3171041003,JAKARTA PUSAT,SENEN,PASEBAN,23533,4639,18894,15990,34884,2021-12-06
3173061005,JAKARTA BARAT,KALI DERES,PEGADUNGAN,75587,13930,61657,54195,115852,2021-12-06
3171061002,JAKARTA PUSAT,MENTENG,PEGANGSAAN,23455,4787,18668,15094,33762,2021-12-06
3172061002,JAKARTA UTARA,KELAPA GADING,PEGANGSAAN DUA,49976,7925,42051,38779,80830,2021-12-06
3172011004,JAKARTA UTARA,PENJARINGAN,PEJAGALAN,74578,14691,59887,53335,113222,2021-12-06
3174041006,JAKARTA SELATAN,PASAR MINGGU,PEJATEN BARAT,37346,6807,30539,26714,57253,2021-12-06
3174041005,JAKARTA SELATAN,PASAR MINGGU,PEJATEN TIMUR,57656,11682,45974,38605,84579,2021-12-06
3175051005,JAKARTA TIMUR,PASAR REBO,PEKAYON,43250,7406,35844,30934,66778,2021-12-06
3173041009,JAKARTA BARAT,TAMBORA,PEKOJAN,23587,4266,19321,16816,36137,2021-12-06
3174031003,JAKARTA SELATAN,MAMPANG PRAPATAN,PELA MAMPANG,43522,8112,35410,30896,66306,2021-12-06
3174081005,JAKARTA SELATAN,PANCORAN,PENGADEGAN,21478,3741,17737,15649,33386,2021-12-06
3175061003,JAKARTA TIMUR,CAKUNG,PENGGILINGAN,99255,21396,77859,64610,142469,2021-12-06
3172011001,JAKARTA UTARA,PENJARINGAN,PENJARINGAN,88308,21582,66726,53705,120431,2021-12-06
3174101001,JAKARTA SELATAN,PESANGGRAHAN,PESANGGRAHAN,27545,4505,23040,20376,43416,2021-12-06
3171071004,JAKARTA PUSAT,TANAH ABANG,PETAMBURAN,33271,8357,24914,19803,44717,2021-12-06
3174071008,JAKARTA SELATAN,KEBAYORAN BARU,PETOGOGAN,11499,2098,9401,8274,17675,2021-12-06
3171011004,JAKARTA PUSAT,GAMBIR,PETOJO SELATAN,14692,3166,11526,10033,21559,2021-12-06
3171011003,JAKARTA PUSAT,GAMBIR,PETOJO UTARA,17458,3611,13847,11739,25586,2021-12-06
3174101004,JAKARTA SELATAN,PESANGGRAHAN,PETUKANGAN SELATAN,37187,7267,29920,26176,56096,2021-12-06
3174101003,JAKARTA SELATAN,PESANGGRAHAN,PETUKANGAN UTARA,53716,10914,42802,36950,79752,2021-12-06
3175081002,JAKARTA TIMUR,MAKASAR,PINANG RANTI,27198,5623,21575,18414,39989,2021-12-06
3173031008,JAKARTA BARAT,TAMAN SARI,PINANGSIA,10729,1789,8940,7631,16571,2021-12-06
3175011001,JAKARTA TIMUR,MATRAMAN,PISANGAN BARU,31776,6178,25598,21285,46883,2021-12-06
3175021002,JAKARTA TIMUR,PULO GADUNG,PISANGAN TIMUR,41011,7146,33865,29737,63602,2021-12-06
3172011005,JAKARTA UTARA,PENJARINGAN,PLUIT,47783,8930,38853,34840,73693,2021-12-06
3175071002,JAKARTA TIMUR,DUREN SAWIT,PONDOK BAMBU,61550,12273,49277,42776,92053,2021-12-06
3175071004,JAKARTA TIMUR,DUREN SAWIT,PONDOK KELAPA,72015,13621,58394,51686,110080,2021-12-06
3175071007,JAKARTA TIMUR,DUREN SAWIT,PONDOK KOPI,35367,6321,29046,24459,53505,2021-12-06
3174061003,JAKARTA SELATAN,CILANDAK,PONDOK LABU,46464,7269,39195,35296,74491,2021-12-06
3174051002,JAKARTA SELATAN,KEBAYORAN LAMA,PONDOK PINANG,56169,10287,45882,40715,86597,2021-12-06
3175101003,JAKARTA TIMUR,CIPAYUNG,PONDOK RANGGON,25574,4579,20995,18377,39372,2021-12-06
3101011003,KAB.ADM.KEP.SERIBU,KEP. SERIBU UTARA,PULAU HARAPAN,2060,200,1860,1665,3525,2021-12-06
3101011002,KAB.ADM.KEP.SERIBU,KEP. SERIBU UTARA,PULAU KELAPA,5528,564,4964,4205,9169,2021-12-06
3101011001,KAB.ADM.KEP.SERIBU,KEP. SERIBU UTARA,PULAU PANGGANG,5450,422,5028,4543,9571,2021-12-06
3101021003,KAB.ADM.KEP.SERIBU,KEP. SERIBU SELATAN,PULAU PARI,2765,191,2574,2441,5015,2021-12-06
3101021002,KAB.ADM.KEP.SERIBU,KEP. SERIBU SELATAN,PULAU TIDUNG,4553,355,4198,3908,8106,2021-12-06
3101021001,KAB.ADM.KEP.SERIBU,KEP. SERIBU SELATAN,PULAU UNTUNG JAWA,1941,154,1787,1664,3451,2021-12-06
3174071007,JAKARTA SELATAN,KEBAYORAN BARU,PULO,5835,971,4864,4567,9431,2021-12-06
3175021001,JAKARTA TIMUR,PULO GADUNG,PULO GADUNG,34422,7161,27261,23508,50769,2021-12-06
3175061005,JAKARTA TIMUR,CAKUNG,PULO GEBANG,97301,17755,79546,67101,146647,2021-12-06
3174041004,JAKARTA SELATAN,PASAR MINGGU,RAGUNAN,39616,6619,32997,29083,62080,2021-12-06
3175091005,JAKARTA TIMUR,CIRACAS,RAMBUTAN,36771,8181,28590,24089,52679,2021-12-06
3172031006,JAKARTA UTARA,KOJA,RAWA BADAK SELATAN,42179,9444,32735,26847,59582,2021-12-06
3172031004,JAKARTA UTARA,KOJA,RAWA BADAK UTARA,34408,7301,27107,22845,49952,2021-12-06
3174071005,JAKARTA SELATAN,KEBAYORAN BARU,RAWA BARAT,5625,966,4659,4239,8898,2021-12-06
3173011003,JAKARTA BARAT,CENGKARENG,RAWA BUAYA,63799,11911,51888,44525,96413,2021-12-06
3175031004,JAKARTA TIMUR,JATINEGARA,RAWA BUNGA,21434,4860,16574,14015,30589,2021-12-06
3174081003,JAKARTA SELATAN,PANCORAN,RAWA JATI,20509,3714,16795,14841,31636,2021-12-06
3175061002,JAKARTA TIMUR,CAKUNG,RAWA TERATE,24637,4211,20426,17264,37690,2021-12-06
3175021005,JAKARTA TIMUR,PULO GADUNG,RAWAMANGUN,37612,7026,30586,26869,57455,2021-12-06
3171051003,JAKARTA PUSAT,CEMPAKA PUTIH,RAWASARI,21967,4208,17759,15705,33464,2021-12-06
3173041010,JAKARTA BARAT,TAMBORA,ROA MALAKA,3484,594,2890,2640,5530,2021-12-06
3172041006,JAKARTA UTARA,CILINCING,ROROTAN,41668,7947,33721,28255,61976,2021-12-06
3174071004,JAKARTA SELATAN,KEBAYORAN BARU,SELONG,2842,533,2309,2170,4479,2021-12-06
3173061002,JAKARTA BARAT,KALI DERES,SEMANAN,71354,14093,57261,47711,104972,2021-12-06
3172041007,JAKARTA UTARA,CILINCING,SEMPER BARAT,68587,12682,55905,48096,104001,2021-12-06
3172041005,JAKARTA UTARA,CILINCING,SEMPER TIMUR,36267,7332,28935,24288,53223,2021-12-06
3174071006,JAKARTA SELATAN,KEBAYORAN BARU,SENAYAN,2771,630,2141,1911,4052,2021-12-06
3171041001,JAKARTA PUSAT,SENEN,SENEN,6804,1366,5438,4643,10081,2021-12-06
3171031004,JAKARTA PUSAT,KEMAYORAN,SERDANG,29668,5389,24279,20957,45236,2021-12-06
3174021001,JAKARTA SELATAN,SETIA BUDI,SETIA BUDI,3023,580,2443,2161,4604,2021-12-06
3175101005,JAKARTA TIMUR,CIPAYUNG,SETU,20572,3904,16668,14186,30854,2021-12-06
3173071002,JAKARTA BARAT,PALMERAH,SLIPI,16591,2819,13772,12076,25848,2021-12-06
3173081004,JAKARTA BARAT,KEMBANGAN,SRENGSENG,45523,9626,35897,31243,67140,2021-12-06
3174091002,JAKARTA SELATAN,JAGAKARSA,SRENGSENG SAWAH,58196,8399,49797,44324,94121,2021-12-06
3173051003,JAKARTA BARAT,KEBON JERUK,SUKABUMI SELATAN,37033,7340,29693,23854,53547,2021-12-06
3173051002,JAKARTA BARAT,KEBON JERUK,SUKABUMI UTARA,38290,8145,30145,24451,54596,2021-12-06
3172041002,JAKARTA UTARA,CILINCING,SUKAPURA,53949,11548,42401,36109,78510,2021-12-06
3171031007,JAKARTA PUSAT,KEMAYORAN,SUMUR BATU,22717,4062,18655,16460,35115,2021-12-06
3172021004,JAKARTA UTARA,TANJUNG PRIOK,SUNGAI BAMBU,29876,5632,24244,20808,45052,2021-12-06
3172021006,JAKARTA UTARA,TANJUNG PRIOK,SUNTER AGUNG,71805,11836,59969,54076,114045,2021-12-06
3172021002,JAKARTA UTARA,TANJUNG PRIOK,SUNTER JAYA,63031,10522,52509,46972,99481,2021-12-06
3175091004,JAKARTA TIMUR,CIRACAS,SUSUKAN,38257,6847,31410,27042,58452,2021-12-06
3173031001,JAKARTA BARAT,TAMAN SARI,TAMAN SARI,14348,2506,11842,10470,22312,2021-12-06
3173041001,JAKARTA BARAT,TAMBORA,TAMBORA,10204,2095,8109,6762,14871,2021-12-06
3173041004,JAKARTA BARAT,TAMBORA,TANAH SEREAL,26387,4234,22153,19053,41206,2021-12-06
3171081004,JAKARTA PUSAT,JOHAR BARU,TANAH TINGGI,37693,6897,30796,25667,56463,2021-12-06
3173031004,JAKARTA BARAT,TAMAN SARI,TANGKI,13324,2114,11210,9822,21032,2021-12-06
3174091005,JAKARTA SELATAN,JAGAKARSA,TANJUNG BARAT,39770,6402,33368,28807,62175,2021-12-06
3173021005,JAKARTA BARAT,GROGOL PETAMBURAN,TANJUNG DUREN SELATAN,25337,4598,20739,18908,39647,2021-12-06
3173021002,JAKARTA BARAT,GROGOL PETAMBURAN,TANJUNG DUREN UTARA,17010,2731,14279,13154,27433,2021-12-06
3172021001,JAKARTA UTARA,TANJUNG PRIOK,TANJUNG PRIOK,34588,6785,27803,23436,51239,2021-12-06
3174011002,JAKARTA SELATAN,TEBET,TEBET BARAT,21194,3215,17979,16339,34318,2021-12-06
3174011001,JAKARTA SELATAN,TEBET,TEBET TIMUR,18199,2773,15426,14324,29750,2021-12-06
3173061003,JAKARTA BARAT,KALI DERES,TEGAL ALUR,83647,16436,67211,57345,124556,2021-12-06
3174031004,JAKARTA SELATAN,MAMPANG PRAPATAN,TEGAL PARANG,32401,6752,25649,20956,46605,2021-12-06
3173021003,JAKARTA BARAT,GROGOL PETAMBURAN,TOMANG,29605,5175,24430,21724,46154,2021-12-06
3172031005,JAKARTA UTARA,KOJA,TUGU SELATAN,39122,8220,30902,25946,56848,2021-12-06
3172031002,JAKARTA UTARA,KOJA,TUGU UTARA,67670,15220,52450,43184,95634,2021-12-06
3175061006,JAKARTA TIMUR,CAKUNG,UJUNG MENTENG,29934,4893,25041,21976,47017,2021-12-06
3174101005,JAKARTA SELATAN,PESANGGRAHAN,ULUJAMI,40544,8447,32097,27476,59573,2021-12-06
3175011006,JAKARTA TIMUR,MATRAMAN,UTAN KAYU SELATAN,33511,5669,27842,23938,51780,2021-12-06
3175011002,JAKARTA TIMUR,MATRAMAN,UTAN KAYU UTARA,28169,5386,22783,19260,42043,2021-12-06
3171031008,JAKARTA PUSAT,KEMAYORAN,UTAN PANJANG,29208,5456,23752,19923,43675,2021-12-06
3172021007,JAKARTA UTARA,TANJUNG PRIOK,WARAKAS,44401,7755,36646,30741,67387,2021-12-06
3173021007,JAKARTA BARAT,GROGOL PETAMBURAN,WIJAYA KUSUMA,38934,7627,31307,27231,58538,2021-12-06
3172051003,JAKARTA UTARA,PADEMANGAN,ANCOL,23947,5475,18472,15581,34053,2021-12-07
3173041007,JAKARTA BARAT,TAMBORA,ANGKE,29381,5880,23501,19629,43130,2021-12-07
3175041005,JAKARTA TIMUR,KRAMAT JATI,BALE KAMBANG,29074,6693,22381,18283,40664,2021-12-07
3175031003,JAKARTA TIMUR,JATINEGARA,BALI MESTER,9752,1895,7857,6832,14689,2021-12-07
3175101006,JAKARTA TIMUR,CIPAYUNG,BAMBU APUS,26285,4567,21718,18864,40582,2021-12-07
3174031002,JAKARTA SELATAN,MAMPANG PRAPATAN,BANGKA,21566,4311,17255,14828,32083,2021-12-07
3175051002,JAKARTA TIMUR,PASAR REBO,BARU,23886,3727,20159,17964,38123,2021-12-07
3175041004,JAKARTA TIMUR,KRAMAT JATI,BATU AMPAR,47898,10854,37044,30995,68039,2021-12-07
3171071002,JAKARTA PUSAT,TANAH ABANG,BENDUNGAN HILIR,21494,4142,17352,15250,32602,2021-12-07
3175031002,JAKARTA TIMUR,JATINEGARA,BIDARA CINA,36689,8346,28343,23923,52266,2021-12-07
3174101002,JAKARTA SELATAN,PESANGGRAHAN,BINTARO,53098,10160,42938,38535,81473,2021-12-07
3174011005,JAKARTA SELATAN,TEBET,BUKIT DURI,34183,6470,27713,23936,51649,2021-12-07
3171041006,JAKARTA PUSAT,SENEN,BUNGUR,18144,3586,14558,12443,27001,2021-12-07
3175061007,JAKARTA TIMUR,CAKUNG,CAKUNG BARAT,57724,11158,46566,39385,85951,2021-12-07
3175061004,JAKARTA TIMUR,CAKUNG,CAKUNG TIMUR,58287,10838,47449,40645,88094,2021-12-07
3175041007,JAKARTA TIMUR,KRAMAT JATI,CAWANG,32762,6546,26216,22006,48222,2021-12-07
3175101008,JAKARTA TIMUR,CIPAYUNG,CEGER,18932,3485,15447,13332,28779,2021-12-07
3171031006,JAKARTA PUSAT,KEMAYORAN,CEMPAKA BARU,32581,5807,26774,22818,49592,2021-12-07
3171051002,JAKARTA PUSAT,CEMPAKA PUTIH,CEMPAKA PUTIH BARAT,35885,7122,28763,25334,54097,2021-12-07
3171051001,JAKARTA PUSAT,CEMPAKA PUTIH,CEMPAKA PUTIH TIMUR,24292,4756,19536,17633,37169,2021-12-07
3173011001,JAKARTA BARAT,CENGKARENG,CENGKARENG BARAT,66284,12490,53794,47712,101506,2021-12-07
3173011006,JAKARTA BARAT,CENGKARENG,CENGKARENG TIMUR,81027,15137,65890,56882,122772,2021-12-07
3175091002,JAKARTA TIMUR,CIRACAS,CIBUBUR,66364,10846,55518,48641,104159,2021-12-07
3171011002,JAKARTA PUSAT,GAMBIR,CIDENG,15390,2886,12504,11162,23666,2021-12-07
3174091003,JAKARTA SELATAN,JAGAKARSA,CIGANJUR,38497,6125,32372,28147,60519,2021-12-07
3175051003,JAKARTA TIMUR,PASAR REBO,CIJANTUNG,41419,7255,34164,29605,63769,2021-12-07
3171061003,JAKARTA PUSAT,MENTENG,CIKINI,8274,1426,6848,5678,12526,2021-12-07
3174081006,JAKARTA SELATAN,PANCORAN,CIKOKO,10547,1729,8818,7845,16663,2021-12-07
3174061001,JAKARTA SELATAN,CILANDAK,CILANDAK BARAT,51752,8657,43095,38931,82026,2021-12-07
3174041003,JAKARTA SELATAN,PASAR MINGGU,CILANDAK TIMUR,25145,4296,20849,18408,39257,2021-12-07
3175101002,JAKARTA TIMUR,CIPAYUNG,CILANGKAP,27635,4652,22983,20204,43187,2021-12-07
3175041006,JAKARTA TIMUR,KRAMAT JATI,CILILITAN,40181,7930,32251,27166,59417,2021-12-07
3172041001,JAKARTA UTARA,CILINCING,CILINCING,43609,9802,33807,27333,61140,2021-12-07
3175101001,JAKARTA TIMUR,CIPAYUNG,CIPAYUNG,26104,4308,21796,19263,41059,2021-12-07
3174091006,JAKARTA SELATAN,JAGAKARSA,CIPEDAK,38303,6009,32294,28346,60640,2021-12-07
3174061005,JAKARTA SELATAN,CILANDAK,CIPETE SELATAN,26704,4810,21894,19818,41712,2021-12-07
3174071010,JAKARTA SELATAN,KEBAYORAN BARU,CIPETE UTARA,34102,6154,27948,24313,52261,2021-12-07
3175021003,JAKARTA TIMUR,PULO GADUNG,CIPINANG,39306,6699,32607,28203,60810,2021-12-07
3175031007,JAKARTA TIMUR,JATINEGARA,CIPINANG BESAR SELATAN,35212,7869,27343,22650,49993,2021-12-07
3175031008,JAKARTA TIMUR,JATINEGARA,CIPINANG BESAR UTARA,45319,10038,35281,28907,64188,2021-12-07
3175031005,JAKARTA TIMUR,JATINEGARA,CIPINANG CEMPEDAK,32824,6784,26040,22995,49035,2021-12-07
3175081005,JAKARTA TIMUR,MAKASAR,CIPINANG MELAYU,42308,7774,34534,30338,64872,2021-12-07
3175031006,JAKARTA TIMUR,JATINEGARA,CIPINANG MUARA,55243,11119,44124,37505,81629,2021-12-07
3174051003,JAKARTA SELATAN,KEBAYORAN LAMA,CIPULIR,39937,7986,31951,27240,59191,2021-12-07
3175091001,JAKARTA TIMUR,CIRACAS,CIRACAS,64594,11275,53319,45696,99015,2021-12-07
3175041003,JAKARTA TIMUR,KRAMAT JATI,DUKUH,24609,4300,20309,17326,37635,2021-12-07
3175071001,JAKARTA TIMUR,DUREN SAWIT,DUREN SAWIT,61160,12223,48937,42421,91358,2021-12-07
3174081004,JAKARTA SELATAN,PANCORAN,DUREN TIGA,28319,5306,23013,19847,42860,2021-12-07
3173051005,JAKARTA BARAT,KEBON JERUK,DURI KEPA,60138,11309,48829,43260,92089,2021-12-07
3173011002,JAKARTA BARAT,CENGKARENG,DURI KOSAMBI,77923,15659,62264,52159,114423,2021-12-07
3171011006,JAKARTA PUSAT,GAMBIR,DURI PULO,19610,3969,15641,12964,28605,2021-12-07
3173041011,JAKARTA BARAT,TAMBORA,DURI SELATAN,14259,2395,11864,10302,22166,2021-12-07
3173041003,JAKARTA BARAT,TAMBORA,DURI UTARA,19844,3376,16468,13990,30458,2021-12-07
3171081003,JAKARTA PUSAT,JOHAR BARU,GALUR,18243,3396,14847,12315,27162,2021-12-07
3171011001,JAKARTA PUSAT,GAMBIR,GAMBIR,2191,441,1750,1548,3298,2021-12-07
3174061004,JAKARTA SELATAN,CILANDAK,GANDARIA SELATAN,22119,3979,18140,16002,34142,2021-12-07
3174071009,JAKARTA SELATAN,KEBAYORAN BARU,GANDARIA UTARA,39922,7468,32454,28501,60955,2021-12-07
3175051001,JAKARTA TIMUR,PASAR REBO,GEDONG,35755,6778,28977,25285,54262,2021-12-07
3171071001,JAKARTA PUSAT,TANAH ABANG,GELORA,3127,586,2541,2273,4814,2021-12-07
3173031007,JAKARTA BARAT,TAMAN SARI,GLODOK,7837,1128,6709,6207,12916,2021-12-07
3171061004,JAKARTA PUSAT,MENTENG,GONDANGDIA,4100,890,3210,2982,6192,2021-12-07
3173021001,JAKARTA BARAT,GROGOL PETAMBURAN,GROGOL,16876,3166,13710,11975,25685,2021-12-07
3174051005,JAKARTA SELATAN,KEBAYORAN LAMA,GROGOL SELATAN,44251,8351,35900,30879,66779,2021-12-07
3174051004,JAKARTA SELATAN,KEBAYORAN LAMA,GROGOL UTARA,42494,8251,34243,29511,63754,2021-12-07
3174021007,JAKARTA SELATAN,SETIA BUDI,GUNTUR,3985,718,3267,2982,6249,2021-12-07
3174071002,JAKARTA SELATAN,KEBAYORAN BARU,GUNUNG,9436,1687,7749,7065,14814,2021-12-07
3171031005,JAKARTA PUSAT,KEMAYORAN,GUNUNG SAHARI SELATAN,19199,3518,15681,13639,29320,2021-12-07
3171021004,JAKARTA PUSAT,SAWAH BESAR,GUNUNG SAHARI UTARA,16650,2792,13858,12612,26470,2021-12-07
3175081004,JAKARTA TIMUR,MAKASAR,HALIM PERDANA KUSUMAH,28363,3451,24912,23165,48077,2021-12-07
3171031003,JAKARTA PUSAT,KEMAYORAN,HARAPAN MULIA,22557,4134,18423,15651,34074,2021-12-07
3174091001,JAKARTA SELATAN,JAGAKARSA,JAGAKARSA,62389,9640,52749,46655,99404,2021-12-07
3175021007,JAKARTA TIMUR,PULO GADUNG,JATI,32757,5811,26946,24192,51138,2021-12-07
3174041002,JAKARTA SELATAN,PASAR MINGGU,JATI PADANG,37502,6759,30743,26857,57600,2021-12-07
3173071004,JAKARTA BARAT,PALMERAH,JATI PULO,28738,5413,23325,19353,42678,2021-12-07
3175061001,JAKARTA TIMUR,CAKUNG,JATINEGARA,84160,16780,67380,57555,124935,2021-12-07
3175021004,JAKARTA TIMUR,PULO GADUNG,JATINEGARA KAUM,24632,4160,20472,17325,37797,2021-12-07
3173021004,JAKARTA BARAT,GROGOL PETAMBURAN,JELAMBAR,30266,5237,25029,22691,47720,2021-12-07
3173021006,JAKARTA BARAT,GROGOL PETAMBURAN,JELAMBAR BARU,38246,6457,31789,28579,60368,2021-12-07
3173041006,JAKARTA BARAT,TAMBORA,JEMBATAN BESI,29314,6692,22622,18390,41012,2021-12-07
3173041008,JAKARTA BARAT,TAMBORA,JEMBATAN LIMA,21021,4463,16558,13612,30170,2021-12-07
3173081005,JAKARTA BARAT,KEMBANGAN,JOGLO,40839,7767,33072,28816,61888,2021-12-07
3171081001,JAKARTA PUSAT,JOHAR BARU,JOHAR BARU,37488,6623,30865,26793,57658,2021-12-07
3173041002,JAKARTA BARAT,TAMBORA,KALI ANYAR,23856,4463,19393,15976,35369,2021-12-07
3172041004,JAKARTA UTARA,CILINCING,KALIBARU,67684,17384,50300,37232,87532,2021-12-07
3174081002,JAKARTA SELATAN,PANCORAN,KALIBATA,41994,8973,33021,28019,61040,2021-12-07
3173061001,JAKARTA BARAT,KALI DERES,KALIDERES,72447,13695,58752,51330,110082,2021-12-07
3175051004,JAKARTA TIMUR,PASAR REBO,KALISARI,43212,7225,35987,31445,67432,2021-12-07
3173061004,JAKARTA BARAT,KALI DERES,KAMAL,53783,11717,42066,34924,76990,2021-12-07
3172011002,JAKARTA UTARA,PENJARINGAN,KAMAL MUARA,12930,2233,10697,9248,19945,2021-12-07
3171071007,JAKARTA PUSAT,TANAH ABANG,KAMPUNG BALI,11358,2330,9028,7287,16315,2021-12-07
3175031001,JAKARTA TIMUR,JATINEGARA,KAMPUNG MELAYU,25717,5582,20135,16409,36544,2021-12-07
3171081002,JAKARTA PUSAT,JOHAR BARU,KAMPUNG RAWA,21237,3350,17887,14682,32569,2021-12-07
3175041002,JAKARTA TIMUR,KRAMAT JATI,KAMPUNG TENGAH,43993,10271,33722,27986,61708,2021-12-07
3173011005,JAKARTA BARAT,CENGKARENG,KAPUK,134466,30460,104006,87425,191431,2021-12-07
3172011003,JAKARTA UTARA,PENJARINGAN,KAPUK MUARA,35781,6517,29264,26391,55655,2021-12-07
3171021002,JAKARTA PUSAT,SAWAH BESAR,KARANG ANYAR,25761,4611,21150,18264,39414,2021-12-07
3174021004,JAKARTA SELATAN,SETIA BUDI,KARET,9623,1772,7851,6824,14675,2021-12-07
3174021003,JAKARTA SELATAN,SETIA BUDI,KARET KUNINGAN,16055,2974,13081,11463,24544,2021-12-07
3174021002,JAKARTA SELATAN,SETIA BUDI,KARET SEMANGGI,2770,536,2234,2023,4257,2021-12-07
3171071003,JAKARTA PUSAT,TANAH ABANG,KARET TENGSIN,19271,3555,15716,13334,29050,2021-12-07
3171021003,JAKARTA PUSAT,SAWAH BESAR,KARTINI,22292,3969,18323,16191,34514,2021-12-07
3175011003,JAKARTA TIMUR,MATRAMAN,KAYU MANIS,25284,4986,20298,16890,37188,2021-12-07
3175021006,JAKARTA TIMUR,PULO GADUNG,KAYU PUTIH,40696,7307,33389,29989,63378,2021-12-07
3173031006,JAKARTA BARAT,TAMAN SARI,KEAGUNGAN,17387,3065,14322,12129,26451,2021-12-07
3174041007,JAKARTA SELATAN,PASAR MINGGU,KEBAGUSAN,44552,8291,36261,31329,67590,2021-12-07
3174051006,JAKARTA SELATAN,KEBAYORAN LAMA,KEBAYORAN LAMA SELATAN,41212,7204,34008,29970,63978,2021-12-07
3174051001,JAKARTA SELATAN,KEBAYORAN LAMA,KEBAYORAN LAMA UTARA,42422,8331,34091,29511,63602,2021-12-07
3174011004,JAKARTA SELATAN,TEBET,KEBON BARU,35165,6160,29005,25221,54226,2021-12-07
3172021005,JAKARTA UTARA,TANJUNG PRIOK,KEBON BAWANG,50952,9680,41272,35556,76828,2021-12-07
3173051001,JAKARTA BARAT,KEBON JERUK,KEBON JERUK,53887,10383,43504,36865,80369,2021-12-07
3171071006,JAKARTA PUSAT,TANAH ABANG,KEBON KACANG,21531,4908,16623,13751,30374,2021-12-07
3171011005,JAKARTA PUSAT,GAMBIR,KEBON KELAPA,10163,1953,8210,7169,15379,2021-12-07
3171031002,JAKARTA PUSAT,KEMAYORAN,KEBON KOSONG,30019,5706,24313,20815,45128,2021-12-07
3175011005,JAKARTA TIMUR,MATRAMAN,KEBON MANGGIS,16490,3012,13478,11506,24984,2021-12-07
3171071005,JAKARTA PUSAT,TANAH ABANG,KEBON MELATI,32206,8203,24003,18644,42647,2021-12-07
3175081003,JAKARTA TIMUR,MAKASAR,KEBON PALA,46614,8736,37878,32693,70571,2021-12-07
3171061005,JAKARTA PUSAT,MENTENG,KEBON SIRIH,12299,2486,9813,8225,18038,2021-12-07
3173011004,JAKARTA BARAT,CENGKARENG,KEDAUNG KALI ANGKE,32612,5936,26676,23084,49760,2021-12-07
3173051007,JAKARTA BARAT,KEBON JERUK,KEDOYA SELATAN,32165,5607,26558,22677,49235,2021-12-07
3173051006,JAKARTA BARAT,KEBON JERUK,KEDOYA UTARA,45740,8346,37394,32390,69784,2021-12-07
3173051004,JAKARTA BARAT,KEBON JERUK,KELAPA DUA,23565,4377,19188,16592,35780,2021-12-07
3175091003,JAKARTA TIMUR,CIRACAS,KELAPA DUA WETAN,46875,7617,39258,34339,73597,2021-12-07
3172061003,JAKARTA UTARA,KELAPA GADING,KELAPA GADING BARAT,35717,5960,29757,27380,57137,2021-12-07
3172061001,JAKARTA UTARA,KELAPA GADING,KELAPA GADING TIMUR,33592,4918,28674,27051,55725,2021-12-07
3173071005,JAKARTA BARAT,PALMERAH,KEMANGGISAN,32139,5760,26379,23194,49573,2021-12-07
3171031001,JAKARTA PUSAT,KEMAYORAN,KEMAYORAN,20708,3894,16814,14346,31160,2021-12-07
3173081006,JAKARTA BARAT,KEMBANGAN,KEMBANGAN SELATAN,27130,5390,21740,19180,40920,2021-12-07
3173081001,JAKARTA BARAT,KEMBANGAN,KEMBANGAN UTARA,54451,11030,43421,37126,80547,2021-12-07
3171041002,JAKARTA PUSAT,SENEN,KENARI,9579,1788,7791,6822,14613,2021-12-07
3173041005,JAKARTA BARAT,TAMBORA,KERENDANG,19973,3853,16120,13657,29777,2021-12-07
3175071003,JAKARTA TIMUR,DUREN SAWIT,KLENDER,69978,15486,54492,45371,99863,2021-12-07
3172031001,JAKARTA UTARA,KOJA,KOJA,28175,6070,22105,18500,40605,2021-12-07
3173071006,JAKARTA BARAT,PALMERAH,KOTA BAMBU SELATAN,21158,3936,17222,14188,31410,2021-12-07
3173071003,JAKARTA BARAT,PALMERAH,KOTA BAMBU UTARA,24995,4813,20182,16454,36636,2021-12-07
3171041004,JAKARTA PUSAT,SENEN,KRAMAT,28835,6178,22657,17686,40343,2021-12-07
3175041001,JAKARTA TIMUR,KRAMAT JATI,KRAMAT JATI,34144,6795,27349,22942,50291,2021-12-07
3174071003,JAKARTA SELATAN,KEBAYORAN BARU,KRAMAT PELA,14413,2664,11749,10424,22173,2021-12-07
3173031002,JAKARTA BARAT,TAMAN SARI,KRUKUT,19244,3457,15787,13297,29084,2021-12-07
3174031005,JAKARTA SELATAN,MAMPANG PRAPATAN,KUNINGAN BARAT,12785,2193,10592,9204,19796,2021-12-07
3174021008,JAKARTA SELATAN,SETIA BUDI,KUNINGAN TIMUR,6008,1141,4867,4326,9193,2021-12-07
3171041005,JAKARTA PUSAT,SENEN,KWITANG,15486,3212,12274,10172,22446,2021-12-07
3172031003,JAKARTA UTARA,KOJA,LAGOA,59065,13138,45927,37834,83761,2021-12-07
3174061002,JAKARTA SELATAN,CILANDAK,LEBAK BULUS,37626,6729,30897,28025,58922,2021-12-07
3174091004,JAKARTA SELATAN,JAGAKARSA,LENTENG AGUNG,53946,9102,44844,38246,83090,2021-12-07
3175101007,JAKARTA TIMUR,CIPAYUNG,LUBANG BUAYA,63547,11353,52194,44929,97123,2021-12-07
3175081001,JAKARTA TIMUR,MAKASAR,MAKASAR,34390,5836,28554,25061,53615,2021-12-07
3175071006,JAKARTA TIMUR,DUREN SAWIT,MALAKA JAYA,30927,4951,25976,23189,49165,2021-12-07
3175071005,JAKARTA TIMUR,DUREN SAWIT,MALAKA SARI,27530,4312,23218,20888,44106,2021-12-07
3174031001,JAKARTA SELATAN,MAMPANG PRAPATAN,MAMPANG PRAPATAN,18159,3517,14642,12541,27183,2021-12-07
3173031005,JAKARTA BARAT,TAMAN SARI,MANGGA BESAR,7707,1249,6458,5828,12286,2021-12-07
3171021005,JAKARTA PUSAT,SAWAH BESAR,MANGGA DUA SELATAN,27442,5253,22189,19238,41427,2021-12-07
3174011007,JAKARTA SELATAN,TEBET,MANGGARAI,28373,4703,23670,20088,43758,2021-12-07
3174011006,JAKARTA SELATAN,TEBET,MANGGARAI SELATAN,23075,3498,19577,17003,36580,2021-12-07
3173031003,JAKARTA BARAT,TAMAN SARI,MAPHAR,16461,2922,13539,11691,25230,2021-12-07
3172041003,JAKARTA UTARA,CILINCING,MARUNDA,28943,6175,22768,17795,40563,2021-12-07
3174071001,JAKARTA SELATAN,KEBAYORAN BARU,MELAWAI,2627,493,2134,2006,4140,2021-12-07
3171061001,JAKARTA PUSAT,MENTENG,MENTENG,25624,5306,20318,16803,37121,2021-12-07
3174021005,JAKARTA SELATAN,SETIA BUDI,MENTENG ATAS,27816,4712,23104,20018,43122,2021-12-07
3174011003,JAKARTA SELATAN,TEBET,MENTENG DALAM,36028,6625,29403,25811,55214,2021-12-07
3173081003,JAKARTA BARAT,KEMBANGAN,MERUYA SELATAN,32130,6227,25903,22620,48523,2021-12-07
3173081002,JAKARTA BARAT,KEMBANGAN,MERUYA UTARA,43752,8546,35206,31520,66726,2021-12-07
3175101004,JAKARTA TIMUR,CIPAYUNG,MUNJUL,23871,4163,19708,17211,36919,2021-12-07
3172051002,JAKARTA UTARA,PADEMANGAN,PADEMANGAN BARAT,74240,16511,57729,48229,105958,2021-12-07
3172051001,JAKARTA UTARA,PADEMANGAN,PADEMANGAN TIMUR,37736,6309,31427,28477,59904,2021-12-07
3175011004,JAKARTA TIMUR,MATRAMAN,PAL MERIAM,19769,3771,15998,13388,29386,2021-12-07
3173071001,JAKARTA BARAT,PALMERAH,PALMERAH,63011,12412,50599,42875,93474,2021-12-07
3174081001,JAKARTA SELATAN,PANCORAN,PANCORAN,19421,3636,15785,13596,29381,2021-12-07
3172021003,JAKARTA UTARA,TANJUNG PRIOK,PAPANGGO,39097,7276,31821,27113,58934,2021-12-07
3171021001,JAKARTA PUSAT,SAWAH BESAR,PASAR BARU,12035,2185,9850,9000,18850,2021-12-07
3174021006,JAKARTA SELATAN,SETIA BUDI,PASAR MANGGIS,26752,4790,21962,18890,40852,2021-12-07
3174041001,JAKARTA SELATAN,PASAR MINGGU,PASAR MINGGU,24821,4427,20394,18060,38454,2021-12-07
3171041003,JAKARTA PUSAT,SENEN,PASEBAN,23533,4629,18904,16010,34914,2021-12-07
3173061005,JAKARTA BARAT,KALI DERES,PEGADUNGAN,75587,13906,61681,54266,115947,2021-12-07
3171061002,JAKARTA PUSAT,MENTENG,PEGANGSAAN,23455,4770,18685,15132,33817,2021-12-07
3172061002,JAKARTA UTARA,KELAPA GADING,PEGANGSAAN DUA,49976,7917,42059,38804,80863,2021-12-07
3172011004,JAKARTA UTARA,PENJARINGAN,PEJAGALAN,74578,14652,59926,53419,113345,2021-12-07
3174041006,JAKARTA SELATAN,PASAR MINGGU,PEJATEN BARAT,37346,6781,30565,26789,57354,2021-12-07
3174041005,JAKARTA SELATAN,PASAR MINGGU,PEJATEN TIMUR,57656,11644,46012,38781,84793,2021-12-07
3175051005,JAKARTA TIMUR,PASAR REBO,PEKAYON,43250,7386,35864,31000,66864,2021-12-07
3173041009,JAKARTA BARAT,TAMBORA,PEKOJAN,23587,4261,19326,16831,36157,2021-12-07
3174031003,JAKARTA SELATAN,MAMPANG PRAPATAN,PELA MAMPANG,43522,8100,35422,30952,66374,2021-12-07
3174081005,JAKARTA SELATAN,PANCORAN,PENGADEGAN,21478,3734,17744,15662,33406,2021-12-07
3175061003,JAKARTA TIMUR,CAKUNG,PENGGILINGAN,99255,21364,77891,64725,142616,2021-12-07
3172011001,JAKARTA UTARA,PENJARINGAN,PENJARINGAN,88308,21547,66761,53814,120575,2021-12-07
3174101001,JAKARTA SELATAN,PESANGGRAHAN,PESANGGRAHAN,27545,4492,23053,20410,43463,2021-12-07
3171071004,JAKARTA PUSAT,TANAH ABANG,PETAMBURAN,33271,8343,24928,19847,44775,2021-12-07
3174071008,JAKARTA SELATAN,KEBAYORAN BARU,PETOGOGAN,11499,2093,9406,8283,17689,2021-12-07
3171011004,JAKARTA PUSAT,GAMBIR,PETOJO SELATAN,14692,3165,11527,10044,21571,2021-12-07
3171011003,JAKARTA PUSAT,GAMBIR,PETOJO UTARA,17458,3606,13852,11749,25601,2021-12-07
3174101004,JAKARTA SELATAN,PESANGGRAHAN,PETUKANGAN SELATAN,37187,7261,29926,26216,56142,2021-12-07
3174101003,JAKARTA SELATAN,PESANGGRAHAN,PETUKANGAN UTARA,53716,10894,42822,37013,79835,2021-12-07
3175081002,JAKARTA TIMUR,MAKASAR,PINANG RANTI,27198,5613,21585,18435,40020,2021-12-07
3173031008,JAKARTA BARAT,TAMAN SARI,PINANGSIA,10729,1784,8945,7639,16584,2021-12-07
3175011001,JAKARTA TIMUR,MATRAMAN,PISANGAN BARU,31776,6162,25614,21325,46939,2021-12-07
3175021002,JAKARTA TIMUR,PULO GADUNG,PISANGAN TIMUR,41011,7134,33877,29775,63652,2021-12-07
3172011005,JAKARTA UTARA,PENJARINGAN,PLUIT,47783,8925,38858,34868,73726,2021-12-07
3175071002,JAKARTA TIMUR,DUREN SAWIT,PONDOK BAMBU,61550,12246,49304,42878,92182,2021-12-07
3175071004,JAKARTA TIMUR,DUREN SAWIT,PONDOK KELAPA,72015,13595,58420,51757,110177,2021-12-07
3175071007,JAKARTA TIMUR,DUREN SAWIT,PONDOK KOPI,35367,6311,29056,24506,53562,2021-12-07
3174061003,JAKARTA SELATAN,CILANDAK,PONDOK LABU,46464,7254,39210,35370,74580,2021-12-07
3174051002,JAKARTA SELATAN,KEBAYORAN LAMA,PONDOK PINANG,56169,10275,45894,40760,86654,2021-12-07
3175101003,JAKARTA TIMUR,CIPAYUNG,PONDOK RANGGON,25574,4574,21000,18447,39447,2021-12-07
3101011003,KAB.ADM.KEP.SERIBU,KEP. SERIBU UTARA,PULAU HARAPAN,2060,200,1860,1668,3528,2021-12-07
3101011002,KAB.ADM.KEP.SERIBU,KEP. SERIBU UTARA,PULAU KELAPA,5528,561,4967,4217,9184,2021-12-07
3101011001,KAB.ADM.KEP.SERIBU,KEP. SERIBU UTARA,PULAU PANGGANG,5450,420,5030,4558,9588,2021-12-07
3101021003,KAB.ADM.KEP.SERIBU,KEP. SERIBU SELATAN,PULAU PARI,2765,191,2574,2441,5015,2021-12-07
3101021002,KAB.ADM.KEP.SERIBU,KEP. SERIBU SELATAN,PULAU TIDUNG,4553,355,4198,3909,8107,2021-12-07
3101021001,KAB.ADM.KEP.SERIBU,KEP. SERIBU SELATAN,PULAU UNTUNG JAWA,1941,154,1787,1664,3451,2021-12-07
3174071007,JAKARTA SELATAN,KEBAYORAN BARU,PULO,5835,970,4865,4571,9436,2021-12-07
3175021001,JAKARTA TIMUR,PULO GADUNG,PULO GADUNG,34422,7139,27283,23548,50831,2021-12-07
3175061005,JAKARTA TIMUR,CAKUNG,PULO GEBANG,97301,17735,79566,67207,146773,2021-12-07
3174041004,JAKARTA SELATAN,PASAR MINGGU,RAGUNAN,39616,6606,33010,29152,62162,2021-12-07
3175091005,JAKARTA TIMUR,CIRACAS,RAMBUTAN,36771,8178,28593,24107,52700,2021-12-07
3172031006,JAKARTA UTARA,KOJA,RAWA BADAK SELATAN,42179,9432,32747,26873,59620,2021-12-07
3172031004,JAKARTA UTARA,KOJA,RAWA BADAK UTARA,34408,7280,27128,22883,50011,2021-12-07
3174071005,JAKARTA SELATAN,KEBAYORAN BARU,RAWA BARAT,5625,965,4660,4240,8900,2021-12-07
3173011003,JAKARTA BARAT,CENGKARENG,RAWA BUAYA,63799,11891,51908,44585,96493,2021-12-07
3175031004,JAKARTA TIMUR,JATINEGARA,RAWA BUNGA,21434,4844,16590,14035,30625,2021-12-07
3174081003,JAKARTA SELATAN,PANCORAN,RAWA JATI,20509,3702,16807,14870,31677,2021-12-07
3175061002,JAKARTA TIMUR,CAKUNG,RAWA TERATE,24637,4203,20434,17284,37718,2021-12-07
3175021005,JAKARTA TIMUR,PULO GADUNG,RAWAMANGUN,37612,7008,30604,26918,57522,2021-12-07
3171051003,JAKARTA PUSAT,CEMPAKA PUTIH,RAWASARI,21967,4200,17767,15726,33493,2021-12-07
3173041010,JAKARTA BARAT,TAMBORA,ROA MALAKA,3484,594,2890,2642,5532,2021-12-07
3172041006,JAKARTA UTARA,CILINCING,ROROTAN,41668,7934,33734,28305,62039,2021-12-07
3174071004,JAKARTA SELATAN,KEBAYORAN BARU,SELONG,2842,532,2310,2173,4483,2021-12-07
3173061002,JAKARTA BARAT,KALI DERES,SEMANAN,71354,14072,57282,47768,105050,2021-12-07
3172041007,JAKARTA UTARA,CILINCING,SEMPER BARAT,68587,12656,55931,48182,104113,2021-12-07
3172041005,JAKARTA UTARA,CILINCING,SEMPER TIMUR,36267,7316,28951,24315,53266,2021-12-07
3174071006,JAKARTA SELATAN,KEBAYORAN BARU,SENAYAN,2771,630,2141,1913,4054,2021-12-07
3171041001,JAKARTA PUSAT,SENEN,SENEN,6804,1365,5439,4648,10087,2021-12-07
3171031004,JAKARTA PUSAT,KEMAYORAN,SERDANG,29668,5368,24300,21018,45318,2021-12-07
3174021001,JAKARTA SELATAN,SETIA BUDI,SETIA BUDI,3023,580,2443,2163,4606,2021-12-07
3175101005,JAKARTA TIMUR,CIPAYUNG,SETU,20572,3896,16676,14212,30888,2021-12-07
3173071002,JAKARTA BARAT,PALMERAH,SLIPI,16591,2816,13775,12101,25876,2021-12-07
3173081004,JAKARTA BARAT,KEMBANGAN,SRENGSENG,45523,9606,35917,31275,67192,2021-12-07
3174091002,JAKARTA SELATAN,JAGAKARSA,SRENGSENG SAWAH,58196,8382,49814,44393,94207,2021-12-07
3173051003,JAKARTA BARAT,KEBON JERUK,SUKABUMI SELATAN,37033,7331,29702,23887,53589,2021-12-07
3173051002,JAKARTA BARAT,KEBON JERUK,SUKABUMI UTARA,38290,8109,30181,24490,54671,2021-12-07
3172041002,JAKARTA UTARA,CILINCING,SUKAPURA,53949,11520,42429,36172,78601,2021-12-07
3171031007,JAKARTA PUSAT,KEMAYORAN,SUMUR BATU,22717,4046,18671,16518,35189,2021-12-07
3172021004,JAKARTA UTARA,TANJUNG PRIOK,SUNGAI BAMBU,29876,5618,24258,20840,45098,2021-12-07
3172021006,JAKARTA UTARA,TANJUNG PRIOK,SUNTER AGUNG,71805,11808,59997,54147,114144,2021-12-07
3172021002,JAKARTA UTARA,TANJUNG PRIOK,SUNTER JAYA,63031,10498,52533,47039,99572,2021-12-07
3175091004,JAKARTA TIMUR,CIRACAS,SUSUKAN,38257,6836,31421,27068,58489,2021-12-07
3173031001,JAKARTA BARAT,TAMAN SARI,TAMAN SARI,14348,2502,11846,10480,22326,2021-12-07
3173041001,JAKARTA BARAT,TAMBORA,TAMBORA,10204,2088,8116,6778,14894,2021-12-07
3173041004,JAKARTA BARAT,TAMBORA,TANAH SEREAL,26387,4227,22160,19074,41234,2021-12-07
3171081004,JAKARTA PUSAT,JOHAR BARU,TANAH TINGGI,37693,6890,30803,25685,56488,2021-12-07
3173031004,JAKARTA BARAT,TAMAN SARI,TANGKI,13324,2112,11212,9833,21045,2021-12-07
3174091005,JAKARTA SELATAN,JAGAKARSA,TANJUNG BARAT,39770,6386,33384,28846,62230,2021-12-07
3173021005,JAKARTA BARAT,GROGOL PETAMBURAN,TANJUNG DUREN SELATAN,25337,4593,20744,18931,39675,2021-12-07
3173021002,JAKARTA BARAT,GROGOL PETAMBURAN,TANJUNG DUREN UTARA,17010,2725,14285,13163,27448,2021-12-07
3172021001,JAKARTA UTARA,TANJUNG PRIOK,TANJUNG PRIOK,34588,6775,27813,23463,51276,2021-12-07
3174011002,JAKARTA SELATAN,TEBET,TEBET BARAT,21194,3211,17983,16355,34338,2021-12-07
3174011001,JAKARTA SELATAN,TEBET,TEBET TIMUR,18199,2770,15429,14340,29769,2021-12-07
3173061003,JAKARTA BARAT,KALI DERES,TEGAL ALUR,83647,16402,67245,57418,124663,2021-12-07
3174031004,JAKARTA SELATAN,MAMPANG PRAPATAN,TEGAL PARANG,32401,6740,25661,20978,46639,2021-12-07
3173021003,JAKARTA BARAT,GROGOL PETAMBURAN,TOMANG,29605,5163,24442,21751,46193,2021-12-07
3172031005,JAKARTA UTARA,KOJA,TUGU SELATAN,39122,8199,30923,25999,56922,2021-12-07
3172031002,JAKARTA UTARA,KOJA,TUGU UTARA,67670,15189,52481,43280,95761,2021-12-07
3175061006,JAKARTA TIMUR,CAKUNG,UJUNG MENTENG,29934,4889,25045,21995,47040,2021-12-07
3174101005,JAKARTA SELATAN,PESANGGRAHAN,ULUJAMI,40544,8416,32128,27522,59650,2021-12-07
3175011006,JAKARTA TIMUR,MATRAMAN,UTAN KAYU SELATAN,33511,5658,27853,23955,51808,2021-12-07
3175011002,JAKARTA TIMUR,MATRAMAN,UTAN KAYU UTARA,28169,5375,22794,19283,42077,2021-12-07
3171031008,JAKARTA PUSAT,KEMAYORAN,UTAN PANJANG,29208,5442,23766,19991,43757,2021-12-07
3172021007,JAKARTA UTARA,TANJUNG PRIOK,WARAKAS,44401,7730,36671,30773,67444,2021-12-07
3173021007,JAKARTA BARAT,GROGOL PETAMBURAN,WIJAYA KUSUMA,38934,7617,31317,27263,58580,2021-12-07
3172051003,JAKARTA UTARA,PADEMANGAN,ANCOL,23947,5470,18477,15592,34069,2021-12-08
3173041007,JAKARTA BARAT,TAMBORA,ANGKE,29381,5873,23508,19643,43151,2021-12-08
3175041005,JAKARTA TIMUR,KRAMAT JATI,BALE KAMBANG,29074,6683,22391,18318,40709,2021-12-08
3175031003,JAKARTA TIMUR,JATINEGARA,BALI MESTER,9752,1891,7861,6837,14698,2021-12-08
3175101006,JAKARTA TIMUR,CIPAYUNG,BAMBU APUS,26285,4559,21726,18875,40601,2021-12-08
3174031002,JAKARTA SELATAN,MAMPANG PRAPATAN,BANGKA,21566,4309,17257,14834,32091,2021-12-08
3175051002,JAKARTA TIMUR,PASAR REBO,BARU,23886,3724,20162,17971,38133,2021-12-08
3175041004,JAKARTA TIMUR,KRAMAT JATI,BATU AMPAR,47898,10846,37052,31021,68073,2021-12-08
3171071002,JAKARTA PUSAT,TANAH ABANG,BENDUNGAN HILIR,21494,4141,17353,15258,32611,2021-12-08
3175031002,JAKARTA TIMUR,JATINEGARA,BIDARA CINA,36689,8337,28352,23936,52288,2021-12-08
3174101002,JAKARTA SELATAN,PESANGGRAHAN,BINTARO,53098,10155,42943,38558,81501,2021-12-08
3174011005,JAKARTA SELATAN,TEBET,BUKIT DURI,34183,6461,27722,23953,51675,2021-12-08
3171041006,JAKARTA PUSAT,SENEN,BUNGUR,18144,3584,14560,12451,27011,2021-12-08
3175061007,JAKARTA TIMUR,CAKUNG,CAKUNG BARAT,57724,11145,46579,39418,85997,2021-12-08
3175061004,JAKARTA TIMUR,CAKUNG,CAKUNG TIMUR,58287,10830,47457,40665,88122,2021-12-08
3175041007,JAKARTA TIMUR,KRAMAT JATI,CAWANG,32762,6539,26223,22024,48247,2021-12-08
3175101008,JAKARTA TIMUR,CIPAYUNG,CEGER,18932,3480,15452,13341,28793,2021-12-08
3171031006,JAKARTA PUSAT,KEMAYORAN,CEMPAKA BARU,32581,5804,26777,22836,49613,2021-12-08
3171051002,JAKARTA PUSAT,CEMPAKA PUTIH,CEMPAKA PUTIH BARAT,35885,7114,28771,25350,54121,2021-12-08
3171051001,JAKARTA PUSAT,CEMPAKA PUTIH,CEMPAKA PUTIH TIMUR,24292,4754,19538,17647,37185,2021-12-08
3173011001,JAKARTA BARAT,CENGKARENG,CENGKARENG BARAT,66284,12474,53810,47742,101552,2021-12-08
3173011006,JAKARTA BARAT,CENGKARENG,CENGKARENG TIMUR,81027,15117,65910,56912,122822,2021-12-08
3175091002,JAKARTA TIMUR,CIRACAS,CIBUBUR,66364,10832,55532,48725,104257,2021-12-08
3171011002,JAKARTA PUSAT,GAMBIR,CIDENG,15390,2886,12504,11167,23671,2021-12-08
3174091003,JAKARTA SELATAN,JAGAKARSA,CIGANJUR,38497,6117,32380,28179,60559,2021-12-08
3175051003,JAKARTA TIMUR,PASAR REBO,CIJANTUNG,41419,7243,34176,29623,63799,2021-12-08
3171061003,JAKARTA PUSAT,MENTENG,CIKINI,8274,1426,6848,5681,12529,2021-12-08
3174081006,JAKARTA SELATAN,PANCORAN,CIKOKO,10547,1728,8819,7850,16669,2021-12-08
3174061001,JAKARTA SELATAN,CILANDAK,CILANDAK BARAT,51752,8648,43104,38947,82051,2021-12-08
3174041003,JAKARTA SELATAN,PASAR MINGGU,CILANDAK TIMUR,25145,4291,20854,18421,39275,2021-12-08
3175101002,JAKARTA TIMUR,CIPAYUNG,CILANGKAP,27635,4644,22991,20214,43205,2021-12-08
3175041006,JAKARTA TIMUR,KRAMAT JATI,CILILITAN,40181,7925,32256,27194,59450,2021-12-08
3172041001,JAKARTA UTARA,CILINCING,CILINCING,43609,9787,33822,27351,61173,2021-12-08
3175101001,JAKARTA TIMUR,CIPAYUNG,CIPAYUNG,26104,4305,21799,19285,41084,2021-12-08
3174091006,JAKARTA SELATAN,JAGAKARSA,CIPEDAK,38303,6006,32297,28365,60662,2021-12-08
3174061005,JAKARTA SELATAN,CILANDAK,CIPETE SELATAN,26704,4808,21896,19828,41724,2021-12-08
3174071010,JAKARTA SELATAN,KEBAYORAN BARU,CIPETE UTARA,34102,6146,27956,24323,52279,2021-12-08
3175021003,JAKARTA TIMUR,PULO GADUNG,CIPINANG,39306,6693,32613,28221,60834,2021-12-08
3175031007,JAKARTA TIMUR,JATINEGARA,CIPINANG BESAR SELATAN,35212,7863,27349,22673,50022,2021-12-08
3175031008,JAKARTA TIMUR,JATINEGARA,CIPINANG BESAR UTARA,45319,10028,35291,28930,64221,2021-12-08
3175031005,JAKARTA TIMUR,JATINEGARA,CIPINANG CEMPEDAK,32824,6777,26047,23006,49053,2021-12-08
3175081005,JAKARTA TIMUR,MAKASAR,CIPINANG MELAYU,42308,7759,34549,30362,64911,2021-12-08
3175031006,JAKARTA TIMUR,JATINEGARA,CIPINANG MUARA,55243,11110,44133,37541,81674,2021-12-08
3174051003,JAKARTA SELATAN,KEBAYORAN LAMA,CIPULIR,39937,7973,31964,27254,59218,2021-12-08
3175091001,JAKARTA TIMUR,CIRACAS,CIRACAS,64594,11263,53331,45722,99053,2021-12-08
3175041003,JAKARTA TIMUR,KRAMAT JATI,DUKUH,24609,4296,20313,17332,37645,2021-12-08
3175071001,JAKARTA TIMUR,DUREN SAWIT,DUREN SAWIT,61160,12216,48944,42441,91385,2021-12-08
3174081004,JAKARTA SELATAN,PANCORAN,DUREN TIGA,28319,5297,23022,19866,42888,2021-12-08
3173051005,JAKARTA BARAT,KEBON JERUK,DURI KEPA,60138,11297,48841,43275,92116,2021-12-08
3173011002,JAKARTA BARAT,CENGKARENG,DURI KOSAMBI,77923,15642,62281,52190,114471,2021-12-08
3171011006,JAKARTA PUSAT,GAMBIR,DURI PULO,19610,3967,15643,12969,28612,2021-12-08
3173041011,JAKARTA BARAT,TAMBORA,DURI SELATAN,14259,2392,11867,10310,22177,2021-12-08
3173041003,JAKARTA BARAT,TAMBORA,DURI UTARA,19844,3374,16470,14000,30470,2021-12-08
3171081003,JAKARTA PUSAT,JOHAR BARU,GALUR,18243,3388,14855,12321,27176,2021-12-08
3171011001,JAKARTA PUSAT,GAMBIR,GAMBIR,2191,440,1751,1548,3299,2021-12-08
3174061004,JAKARTA SELATAN,CILANDAK,GANDARIA SELATAN,22119,3978,18141,16006,34147,2021-12-08
3174071009,JAKARTA SELATAN,KEBAYORAN BARU,GANDARIA UTARA,39922,7460,32462,28523,60985,2021-12-08
3175051001,JAKARTA TIMUR,PASAR REBO,GEDONG,35755,6770,28985,25304,54289,2021-12-08
3171071001,JAKARTA PUSAT,TANAH ABANG,GELORA,3127,586,2541,2275,4816,2021-12-08
3173031007,JAKARTA BARAT,TAMAN SARI,GLODOK,7837,1126,6711,6210,12921,2021-12-08
3171061004,JAKARTA PUSAT,MENTENG,GONDANGDIA,4100,888,3212,2983,6195,2021-12-08
3173021001,JAKARTA BARAT,GROGOL PETAMBURAN,GROGOL,16876,3162,13714,11981,25695,2021-12-08
3174051005,JAKARTA SELATAN,KEBAYORAN LAMA,GROGOL SELATAN,44251,8345,35906,30901,66807,2021-12-08
3174051004,JAKARTA SELATAN,KEBAYORAN LAMA,GROGOL UTARA,42494,8245,34249,29526,63775,2021-12-08
3174021007,JAKARTA SELATAN,SETIA BUDI,GUNTUR,3985,718,3267,2984,6251,2021-12-08
3174071002,JAKARTA SELATAN,KEBAYORAN BARU,GUNUNG,9436,1685,7751,7068,14819,2021-12-08
3171031005,JAKARTA PUSAT,KEMAYORAN,GUNUNG SAHARI SELATAN,19199,3517,15682,13648,29330,2021-12-08
3171021004,JAKARTA PUSAT,SAWAH BESAR,GUNUNG SAHARI UTARA,16650,2788,13862,12617,26479,2021-12-08
3175081004,JAKARTA TIMUR,MAKASAR,HALIM PERDANA KUSUMAH,28363,3446,24917,23175,48092,2021-12-08
3171031003,JAKARTA PUSAT,KEMAYORAN,HARAPAN MULIA,22557,4127,18430,15661,34091,2021-12-08
3174091001,JAKARTA SELATAN,JAGAKARSA,JAGAKARSA,62389,9629,52760,46704,99464,2021-12-08
3175021007,JAKARTA TIMUR,PULO GADUNG,JATI,32757,5806,26951,24209,51160,2021-12-08
3174041002,JAKARTA SELATAN,PASAR MINGGU,JATI PADANG,37502,6744,30758,26877,57635,2021-12-08
3173071004,JAKARTA BARAT,PALMERAH,JATI PULO,28738,5411,23327,19371,42698,2021-12-08
3175061001,JAKARTA TIMUR,CAKUNG,JATINEGARA,84160,16757,67403,57599,125002,2021-12-08
3175021004,JAKARTA TIMUR,PULO GADUNG,JATINEGARA KAUM,24632,4152,20480,17351,37831,2021-12-08
3173021004,JAKARTA BARAT,GROGOL PETAMBURAN,JELAMBAR,30266,5235,25031,22700,47731,2021-12-08
3173021006,JAKARTA BARAT,GROGOL PETAMBURAN,JELAMBAR BARU,38246,6454,31792,28593,60385,2021-12-08
3173041006,JAKARTA BARAT,TAMBORA,JEMBATAN BESI,29314,6684,22630,18406,41036,2021-12-08
3173041008,JAKARTA BARAT,TAMBORA,JEMBATAN LIMA,21021,4457,16564,13623,30187,2021-12-08
3173081005,JAKARTA BARAT,KEMBANGAN,JOGLO,40839,7762,33077,28839,61916,2021-12-08
3171081001,JAKARTA PUSAT,JOHAR BARU,JOHAR BARU,37488,6620,30868,26811,57679,2021-12-08
3173041002,JAKARTA BARAT,TAMBORA,KALI ANYAR,23856,4461,19395,15988,35383,2021-12-08
3172041004,JAKARTA UTARA,CILINCING,KALIBARU,67684,17358,50326,37259,87585,2021-12-08
3174081002,JAKARTA SELATAN,PANCORAN,KALIBATA,41994,8958,33036,28040,61076,2021-12-08
3173061001,JAKARTA BARAT,KALI DERES,KALIDERES,72447,13685,58762,51364,110126,2021-12-08
3175051004,JAKARTA TIMUR,PASAR REBO,KALISARI,43212,7218,35994,31460,67454,2021-12-08
3173061004,JAKARTA BARAT,KALI DERES,KAMAL,53783,11702,42081,34953,77034,2021-12-08
3172011002,JAKARTA UTARA,PENJARINGAN,KAMAL MUARA,12930,2230,10700,9251,19951,2021-12-08
3171071007,JAKARTA PUSAT,TANAH ABANG,KAMPUNG BALI,11358,2330,9028,7291,16319,2021-12-08
3175031001,JAKARTA TIMUR,JATINEGARA,KAMPUNG MELAYU,25717,5578,20139,16417,36556,2021-12-08
3171081002,JAKARTA PUSAT,JOHAR BARU,KAMPUNG RAWA,21237,3347,17890,14686,32576,2021-12-08
3175041002,JAKARTA TIMUR,KRAMAT JATI,KAMPUNG TENGAH,43993,10260,33733,28004,61737,2021-12-08
3173011005,JAKARTA BARAT,CENGKARENG,KAPUK,134466,30430,104036,87475,191511,2021-12-08
3172011003,JAKARTA UTARA,PENJARINGAN,KAPUK MUARA,35781,6515,29266,26407,55673,2021-12-08
3171021002,JAKARTA PUSAT,SAWAH BESAR,KARANG ANYAR,25761,4605,21156,18286,39442,2021-12-08
3174021004,JAKARTA SELATAN,SETIA BUDI,KARET,9623,1770,7853,6826,14679,2021-12-08
3174021003,JAKARTA SELATAN,SETIA BUDI,KARET KUNINGAN,16055,2972,13083,11472,24555,2021-12-08
3174021002,JAKARTA SELATAN,SETIA BUDI,KARET SEMANGGI,2770,536,2234,2025,4259,2021-12-08
3171071003,JAKARTA PUSAT,TANAH ABANG,KARET TENGSIN,19271,3554,15717,13338,29055,2021-12-08
3171021003,JAKARTA PUSAT,SAWAH BESAR,KARTINI,22292,3964,18328,16198,34526,2021-12-08
3175011003,JAKARTA TIMUR,MATRAMAN,KAYU MANIS,25284,4978,20306,16904,37210,2021-12-08
3175021006,JAKARTA TIMUR,PULO GADUNG,KAYU PUTIH,40696,7305,33391,30004,63395,2021-12-08
3173031006,JAKARTA BARAT,TAMAN SARI,KEAGUNGAN,17387,3060,14327,12140,26467,2021-12-08
3174041007,JAKARTA SELATAN,PASAR MINGGU,KEBAGUSAN,44552,8283,36269,31346,67615,2021-12-08
3174051006,JAKARTA SELATAN,KEBAYORAN LAMA,KEBAYORAN LAMA SELATAN,41212,7201,34011,29988,63999,2021-12-08
3174051001,JAKARTA SELATAN,KEBAYORAN LAMA,KEBAYORAN LAMA UTARA,42422,8326,34096,29533,63629,2021-12-08
3174011004,JAKARTA SELATAN,TEBET,KEBON BARU,35165,6154,29011,25235,54246,2021-12-08
3172021005,JAKARTA UTARA,TANJUNG PRIOK,KEBON BAWANG,50952,9667,41285,35580,76865,2021-12-08
3173051001,JAKARTA BARAT,KEBON JERUK,KEBON JERUK,53887,10375,43512,36900,80412,2021-12-08
3171071006,JAKARTA PUSAT,TANAH ABANG,KEBON KACANG,21531,4898,16633,13761,30394,2021-12-08
3171011005,JAKARTA PUSAT,GAMBIR,KEBON KELAPA,10163,1949,8214,7174,15388,2021-12-08
3171031002,JAKARTA PUSAT,KEMAYORAN,KEBON KOSONG,30019,5702,24317,20829,45146,2021-12-08
3175011005,JAKARTA TIMUR,MATRAMAN,KEBON MANGGIS,16490,3009,13481,11521,25002,2021-12-08
3171071005,JAKARTA PUSAT,TANAH ABANG,KEBON MELATI,32206,8194,24012,18651,42663,2021-12-08
3175081003,JAKARTA TIMUR,MAKASAR,KEBON PALA,46614,8728,37886,32713,70599,2021-12-08
3171061005,JAKARTA PUSAT,MENTENG,KEBON SIRIH,12299,2483,9816,8231,18047,2021-12-08
3173011004,JAKARTA BARAT,CENGKARENG,KEDAUNG KALI ANGKE,32612,5931,26681,23099,49780,2021-12-08
3173051007,JAKARTA BARAT,KEBON JERUK,KEDOYA SELATAN,32165,5599,26566,22695,49261,2021-12-08
3173051006,JAKARTA BARAT,KEBON JERUK,KEDOYA UTARA,45740,8340,37400,32401,69801,2021-12-08
3173051004,JAKARTA BARAT,KEBON JERUK,KELAPA DUA,23565,4374,19191,16605,35796,2021-12-08
3175091003,JAKARTA TIMUR,CIRACAS,KELAPA DUA WETAN,46875,7607,39268,34352,73620,2021-12-08
3172061003,JAKARTA UTARA,KELAPA GADING,KELAPA GADING BARAT,35717,5954,29763,27385,57148,2021-12-08
3172061001,JAKARTA UTARA,KELAPA GADING,KELAPA GADING TIMUR,33592,4916,28676,27060,55736,2021-12-08
3173071005,JAKARTA BARAT,PALMERAH,KEMANGGISAN,32139,5754,26385,23212,49597,2021-12-08
3171031001,JAKARTA PUSAT,KEMAYORAN,KEMAYORAN,20708,3890,16818,14354,31172,2021-12-08
3173081006,JAKARTA BARAT,KEMBANGAN,KEMBANGAN SELATAN,27130,5384,21746,19189,40935,2021-12-08
3173081001,JAKARTA BARAT,KEMBANGAN,KEMBANGAN UTARA,54451,11025,43426,37152,80578,2021-12-08
3171041002,JAKARTA PUSAT,SENEN,KENARI,9579,1786,7793,6823,14616,2021-12-08
3173041005,JAKARTA BARAT,TAMBORA,KERENDANG,19973,3850,16123,13666,29789,2021-12-08
3175071003,JAKARTA TIMUR,DUREN SAWIT,KLENDER,69978,15454,54524,45406,99930,2021-12-08
3172031001,JAKARTA UTARA,KOJA,KOJA,28175,6067,22108,18510,40618,2021-12-08
3173071006,JAKARTA BARAT,PALMERAH,KOTA BAMBU SELATAN,21158,3932,17226,14197,31423,2021-12-08
3173071003,JAKARTA BARAT,PALMERAH,KOTA BAMBU UTARA,24995,4806,20189,16462,36651,2021-12-08
3171041004,JAKARTA PUSAT,SENEN,KRAMAT,28835,6161,22674,17700,40374,2021-12-08
3175041001,JAKARTA TIMUR,KRAMAT JATI,KRAMAT JATI,34144,6789,27355,22961,50316,2021-12-08
3174071003,JAKARTA SELATAN,KEBAYORAN BARU,KRAMAT PELA,14413,2662,11751,10431,22182,2021-12-08
3173031002,JAKARTA BARAT,TAMAN SARI,KRUKUT,19244,3453,15791,13305,29096,2021-12-08
3174031005,JAKARTA SELATAN,MAMPANG PRAPATAN,KUNINGAN BARAT,12785,2189,10596,9216,19812,2021-12-08
3174021008,JAKARTA SELATAN,SETIA BUDI,KUNINGAN TIMUR,6008,1139,4869,4327,9196,2021-12-08
3171041005,JAKARTA PUSAT,SENEN,KWITANG,15486,3211,12275,10175,22450,2021-12-08
3172031003,JAKARTA UTARA,KOJA,LAGOA,59065,13123,45942,37871,83813,2021-12-08
3174061002,JAKARTA SELATAN,CILANDAK,LEBAK BULUS,37626,6719,30907,28045,58952,2021-12-08
3174091004,JAKARTA SELATAN,JAGAKARSA,LENTENG AGUNG,53946,9094,44852,38264,83116,2021-12-08
3175101007,JAKARTA TIMUR,CIPAYUNG,LUBANG BUAYA,63547,11342,52205,44967,97172,2021-12-08
3175081001,JAKARTA TIMUR,MAKASAR,MAKASAR,34390,5832,28558,25079,53637,2021-12-08
3175071006,JAKARTA TIMUR,DUREN SAWIT,MALAKA JAYA,30927,4942,25985,23204,49189,2021-12-08
3175071005,JAKARTA TIMUR,DUREN SAWIT,MALAKA SARI,27530,4306,23224,20906,44130,2021-12-08
3174031001,JAKARTA SELATAN,MAMPANG PRAPATAN,MAMPANG PRAPATAN,18159,3511,14648,12548,27196,2021-12-08
3173031005,JAKARTA BARAT,TAMAN SARI,MANGGA BESAR,7707,1248,6459,5831,12290,2021-12-08
3171021005,JAKARTA PUSAT,SAWAH BESAR,MANGGA DUA SELATAN,27442,5244,22198,19253,41451,2021-12-08
3174011007,JAKARTA SELATAN,TEBET,MANGGARAI,28373,4697,23676,20113,43789,2021-12-08
3174011006,JAKARTA SELATAN,TEBET,MANGGARAI SELATAN,23075,3495,19580,17010,36590,2021-12-08
3173031003,JAKARTA BARAT,TAMAN SARI,MAPHAR,16461,2918,13543,11702,25245,2021-12-08
3172041003,JAKARTA UTARA,CILINCING,MARUNDA,28943,6169,22774,17807,40581,2021-12-08
3174071001,JAKARTA SELATAN,KEBAYORAN BARU,MELAWAI,2627,493,2134,2006,4140,2021-12-08
3171061001,JAKARTA PUSAT,MENTENG,MENTENG,25624,5305,20319,16811,37130,2021-12-08
3174021005,JAKARTA SELATAN,SETIA BUDI,MENTENG ATAS,27816,4703,23113,20047,43160,2021-12-08
3174011003,JAKARTA SELATAN,TEBET,MENTENG DALAM,36028,6621,29407,25823,55230,2021-12-08
3173081003,JAKARTA BARAT,KEMBANGAN,MERUYA SELATAN,32130,6217,25913,22635,48548,2021-12-08
3173081002,JAKARTA BARAT,KEMBANGAN,MERUYA UTARA,43752,8530,35222,31532,66754,2021-12-08
3175101004,JAKARTA TIMUR,CIPAYUNG,MUNJUL,23871,4161,19710,17220,36930,2021-12-08
3172051002,JAKARTA UTARA,PADEMANGAN,PADEMANGAN BARAT,74240,16501,57739,48264,106003,2021-12-08
3172051001,JAKARTA UTARA,PADEMANGAN,PADEMANGAN TIMUR,37736,6302,31434,28490,59924,2021-12-08
3175011004,JAKARTA TIMUR,MATRAMAN,PAL MERIAM,19769,3769,16000,13399,29399,2021-12-08
3173071001,JAKARTA BARAT,PALMERAH,PALMERAH,63011,12403,50608,42906,93514,2021-12-08
3174081001,JAKARTA SELATAN,PANCORAN,PANCORAN,19421,3632,15789,13606,29395,2021-12-08
3172021003,JAKARTA UTARA,TANJUNG PRIOK,PAPANGGO,39097,7259,31838,27121,58959,2021-12-08
3171021001,JAKARTA PUSAT,SAWAH BESAR,PASAR BARU,12035,2185,9850,9000,18850,2021-12-08
3174021006,JAKARTA SELATAN,SETIA BUDI,PASAR MANGGIS,26752,4784,21968,18902,40870,2021-12-08
3174041001,JAKARTA SELATAN,PASAR MINGGU,PASAR MINGGU,24821,4418,20403,18071,38474,2021-12-08
3171041003,JAKARTA PUSAT,SENEN,PASEBAN,23533,4623,18910,16016,34926,2021-12-08
3173061005,JAKARTA BARAT,KALI DERES,PEGADUNGAN,75587,13901,61686,54283,115969,2021-12-08
3171061002,JAKARTA PUSAT,MENTENG,PEGANGSAAN,23455,4766,18689,15136,33825,2021-12-08
3172061002,JAKARTA UTARA,KELAPA GADING,PEGANGSAAN DUA,49976,7914,42062,38812,80874,2021-12-08
3172011004,JAKARTA UTARA,PENJARINGAN,PEJAGALAN,74578,14631,59947,53457,113404,2021-12-08
3174041006,JAKARTA SELATAN,PASAR MINGGU,PEJATEN BARAT,37346,6770,30576,26810,57386,2021-12-08
3174041005,JAKARTA SELATAN,PASAR MINGGU,PEJATEN TIMUR,57656,11637,46019,38811,84830,2021-12-08
3175051005,JAKARTA TIMUR,PASAR REBO,PEKAYON,43250,7377,35873,31034,66907,2021-12-08
3173041009,JAKARTA BARAT,TAMBORA,PEKOJAN,23587,4259,19328,16847,36175,2021-12-08
3174031003,JAKARTA SELATAN,MAMPANG PRAPATAN,PELA MAMPANG,43522,8091,35431,30974,66405,2021-12-08
3174081005,JAKARTA SELATAN,PANCORAN,PENGADEGAN,21478,3730,17748,15669,33417,2021-12-08
3175061003,JAKARTA TIMUR,CAKUNG,PENGGILINGAN,99255,21337,77918,64762,142680,2021-12-08
3172011001,JAKARTA UTARA,PENJARINGAN,PENJARINGAN,88308,21524,66784,53869,120653,2021-12-08
3174101001,JAKARTA SELATAN,PESANGGRAHAN,PESANGGRAHAN,27545,4490,23055,20420,43475,2021-12-08
3171071004,JAKARTA PUSAT,TANAH ABANG,PETAMBURAN,33271,8338,24933,19861,44794,2021-12-08
3174071008,JAKARTA SELATAN,KEBAYORAN BARU,PETOGOGAN,11499,2093,9406,8293,17699,2021-12-08
3171011004,JAKARTA PUSAT,GAMBIR,PETOJO SELATAN,14692,3163,11529,10052,21581,2021-12-08
3171011003,JAKARTA PUSAT,GAMBIR,PETOJO UTARA,17458,3602,13856,11760,25616,2021-12-08
3174101004,JAKARTA SELATAN,PESANGGRAHAN,PETUKANGAN SELATAN,37187,7254,29933,26231,56164,2021-12-08
3174101003,JAKARTA SELATAN,PESANGGRAHAN,PETUKANGAN UTARA,53716,10887,42829,37050,79879,2021-12-08
3175081002,JAKARTA TIMUR,MAKASAR,PINANG RANTI,27198,5610,21588,18447,40035,2021-12-08
3173031008,JAKARTA BARAT,TAMAN SARI,PINANGSIA,10729,1783,8946,7640,16586,2021-12-08
3175011001,JAKARTA TIMUR,MATRAMAN,PISANGAN BARU,31776,6160,25616,21340,46956,2021-12-08
3175021002,JAKARTA TIMUR,PULO GADUNG,PISANGAN TIMUR,41011,7127,33884,29798,63682,2021-12-08
3172011005,JAKARTA UTARA,PENJARINGAN,PLUIT,47783,8922,38861,34887,73748,2021-12-08
3175071002,JAKARTA TIMUR,DUREN SAWIT,PONDOK BAMBU,61550,12234,49316,42915,92231,2021-12-08
3175071004,JAKARTA TIMUR,DUREN SAWIT,PONDOK KELAPA,72015,13584,58431,51787,110218,2021-12-08
3175071007,JAKARTA TIMUR,DUREN SAWIT,PONDOK KOPI,35367,6304,29063,24536,53599,2021-12-08
3174061003,JAKARTA SELATAN,CILANDAK,PONDOK LABU,46464,7248,39216,35396,74612,2021-12-08
3174051002,JAKARTA SELATAN,KEBAYORAN LAMA,PONDOK PINANG,56169,10270,45899,40776,86675,2021-12-08
3175101003,JAKARTA TIMUR,CIPAYUNG,PONDOK RANGGON,25574,4569,21005,18453,39458,2021-12-08
3101011003,KAB.ADM.KEP.SERIBU,KEP. SERIBU UTARA,PULAU HARAPAN,2060,198,1862,1668,3530,2021-12-08
3101011002,KAB.ADM.KEP.SERIBU,KEP. SERIBU UTARA,PULAU KELAPA,5528,560,4968,4219,9187,2021-12-08
3101011001,KAB.ADM.KEP.SERIBU,KEP. SERIBU UTARA,PULAU PANGGANG,5450,419,5031,4559,9590,2021-12-08
3101021003,KAB.ADM.KEP.SERIBU,KEP. SERIBU SELATAN,PULAU PARI,2765,191,2574,2442,5016,2021-12-08
3101021002,KAB.ADM.KEP.SERIBU,KEP. SERIBU SELATAN,PULAU TIDUNG,4553,354,4199,3913,8112,2021-12-08
3101021001,KAB.ADM.KEP.SERIBU,KEP. SERIBU SELATAN,PULAU UNTUNG JAWA,1941,154,1787,1664,3451,2021-12-08
3174071007,JAKARTA SELATAN,KEBAYORAN BARU,PULO,5835,970,4865,4573,9438,2021-12-08
3175021001,JAKARTA TIMUR,PULO GADUNG,PULO GADUNG,34422,7129,27293,23569,50862,2021-12-08
3175061005,JAKARTA TIMUR,CAKUNG,PULO GEBANG,97301,17715,79586,67228,146814,2021-12-08
3174041004,JAKARTA SELATAN,PASAR MINGGU,RAGUNAN,39616,6600,33016,29171,62187,2021-12-08
3175091005,JAKARTA TIMUR,CIRACAS,RAMBUTAN,36771,8172,28599,24130,52729,2021-12-08
3172031006,JAKARTA UTARA,KOJA,RAWA BADAK SELATAN,42179,9420,32759,26906,59665,2021-12-08
3172031004,JAKARTA UTARA,KOJA,RAWA BADAK UTARA,34408,7274,27134,22899,50033,2021-12-08
3174071005,JAKARTA SELATAN,KEBAYORAN BARU,RAWA BARAT,5625,965,4660,4241,8901,2021-12-08
3173011003,JAKARTA BARAT,CENGKARENG,RAWA BUAYA,63799,11883,51916,44608,96524,2021-12-08
3175031004,JAKARTA TIMUR,JATINEGARA,RAWA BUNGA,21434,4822,16612,14053,30665,2021-12-08
3174081003,JAKARTA SELATAN,PANCORAN,RAWA JATI,20509,3699,16810,14871,31681,2021-12-08
3175061002,JAKARTA TIMUR,CAKUNG,RAWA TERATE,24637,4197,20440,17292,37732,2021-12-08
3175021005,JAKARTA TIMUR,PULO GADUNG,RAWAMANGUN,37612,7006,30606,26935,57541,2021-12-08
3171051003,JAKARTA PUSAT,CEMPAKA PUTIH,RAWASARI,21967,4192,17775,15735,33510,2021-12-08
3173041010,JAKARTA BARAT,TAMBORA,ROA MALAKA,3484,593,2891,2642,5533,2021-12-08
3172041006,JAKARTA UTARA,CILINCING,ROROTAN,41668,7929,33739,28320,62059,2021-12-08
3174071004,JAKARTA SELATAN,KEBAYORAN BARU,SELONG,2842,532,2310,2173,4483,2021-12-08
3173061002,JAKARTA BARAT,KALI DERES,SEMANAN,71354,14059,57295,47801,105096,2021-12-08
3172041007,JAKARTA UTARA,CILINCING,SEMPER BARAT,68587,12645,55942,48210,104152,2021-12-08
3172041005,JAKARTA UTARA,CILINCING,SEMPER TIMUR,36267,7308,28959,24326,53285,2021-12-08
3174071006,JAKARTA SELATAN,KEBAYORAN BARU,SENAYAN,2771,629,2142,1913,4055,2021-12-08
3171041001,JAKARTA PUSAT,SENEN,SENEN,6804,1365,5439,4648,10087,2021-12-08
3171031004,JAKARTA PUSAT,KEMAYORAN,SERDANG,29668,5360,24308,21035,45343,2021-12-08
3174021001,JAKARTA SELATAN,SETIA BUDI,SETIA BUDI,3023,580,2443,2163,4606,2021-12-08
3175101005,JAKARTA TIMUR,CIPAYUNG,SETU,20572,3893,16679,14218,30897,2021-12-08
3173071002,JAKARTA BARAT,PALMERAH,SLIPI,16591,2816,13775,12108,25883,2021-12-08
3173081004,JAKARTA BARAT,KEMBANGAN,SRENGSENG,45523,9593,35930,31295,67225,2021-12-08
3174091002,JAKARTA SELATAN,JAGAKARSA,SRENGSENG SAWAH,58196,8369,49827,44411,94238,2021-12-08
3173051003,JAKARTA BARAT,KEBON JERUK,SUKABUMI SELATAN,37033,7324,29709,23898,53607,2021-12-08
3173051002,JAKARTA BARAT,KEBON JERUK,SUKABUMI UTARA,38290,8094,30196,24507,54703,2021-12-08
3172041002,JAKARTA UTARA,CILINCING,SUKAPURA,53949,11503,42446,36199,78645,2021-12-08
3171031007,JAKARTA PUSAT,KEMAYORAN,SUMUR BATU,22717,4042,18675,16545,35220,2021-12-08
3172021004,JAKARTA UTARA,TANJUNG PRIOK,SUNGAI BAMBU,29876,5611,24265,20852,45117,2021-12-08
3172021006,JAKARTA UTARA,TANJUNG PRIOK,SUNTER AGUNG,71805,11801,60004,54171,114175,2021-12-08
3172021002,JAKARTA UTARA,TANJUNG PRIOK,SUNTER JAYA,63031,10491,52540,47064,99604,2021-12-08
3175091004,JAKARTA TIMUR,CIRACAS,SUSUKAN,38257,6825,31432,27091,58523,2021-12-08
3173031001,JAKARTA BARAT,TAMAN SARI,TAMAN SARI,14348,2499,11849,10484,22333,2021-12-08
3173041001,JAKARTA BARAT,TAMBORA,TAMBORA,10204,2088,8116,6780,14896,2021-12-08
3173041004,JAKARTA BARAT,TAMBORA,TANAH SEREAL,26387,4226,22161,19084,41245,2021-12-08
3171081004,JAKARTA PUSAT,JOHAR BARU,TANAH TINGGI,37693,6887,30806,25699,56505,2021-12-08
3173031004,JAKARTA BARAT,TAMAN SARI,TANGKI,13324,2112,11212,9836,21048,2021-12-08
3174091005,JAKARTA SELATAN,JAGAKARSA,TANJUNG BARAT,39770,6381,33389,28901,62290,2021-12-08
3173021005,JAKARTA BARAT,GROGOL PETAMBURAN,TANJUNG DUREN SELATAN,25337,4588,20749,18944,39693,2021-12-08
3173021002,JAKARTA BARAT,GROGOL PETAMBURAN,TANJUNG DUREN UTARA,17010,2721,14289,13168,27457,2021-12-08
3172021001,JAKARTA UTARA,TANJUNG PRIOK,TANJUNG PRIOK,34588,6763,27825,23477,51302,2021-12-08
3174011002,JAKARTA SELATAN,TEBET,TEBET BARAT,21194,3203,17991,16367,34358,2021-12-08
3174011001,JAKARTA SELATAN,TEBET,TEBET TIMUR,18199,2767,15432,14349,29781,2021-12-08
3173061003,JAKARTA BARAT,KALI DERES,TEGAL ALUR,83647,16391,67256,57446,124702,2021-12-08
3174031004,JAKARTA SELATAN,MAMPANG PRAPATAN,TEGAL PARANG,32401,6736,25665,20992,46657,2021-12-08
3173021003,JAKARTA BARAT,GROGOL PETAMBURAN,TOMANG,29605,5162,24443,21760,46203,2021-12-08
3172031005,JAKARTA UTARA,KOJA,TUGU SELATAN,39122,8191,30931,26011,56942,2021-12-08
3172031002,JAKARTA UTARA,KOJA,TUGU UTARA,67670,15179,52491,43308,95799,2021-12-08
3175061006,JAKARTA TIMUR,CAKUNG,UJUNG MENTENG,29934,4887,25047,22014,47061,2021-12-08
3174101005,JAKARTA SELATAN,PESANGGRAHAN,ULUJAMI,40544,8403,32141,27535,59676,2021-12-08
3175011006,JAKARTA TIMUR,MATRAMAN,UTAN KAYU SELATAN,33511,5653,27858,23977,51835,2021-12-08
3175011002,JAKARTA TIMUR,MATRAMAN,UTAN KAYU UTARA,28169,5368,22801,19306,42107,2021-12-08
3171031008,JAKARTA PUSAT,KEMAYORAN,UTAN PANJANG,29208,5440,23768,20003,43771,2021-12-08
3172021007,JAKARTA UTARA,TANJUNG PRIOK,WARAKAS,44401,7721,36680,30806,67486,2021-12-08
3173021007,JAKARTA BARAT,GROGOL PETAMBURAN,WIJAYA KUSUMA,38934,7610,31324,27284,58608,2021-12-08
3172051003,JAKARTA UTARA,PADEMANGAN,ANCOL,23947,5462,18485,15615,34100,2021-12-09
3173041007,JAKARTA BARAT,TAMBORA,ANGKE,29381,5858,23523,19674,43197,2021-12-09
3175041005,JAKARTA TIMUR,KRAMAT JATI,BALE KAMBANG,29074,6669,22405,18361,40766,2021-12-09
3175031003,JAKARTA TIMUR,JATINEGARA,BALI MESTER,9752,1884,7868,6849,14717,2021-12-09
3175101006,JAKARTA TIMUR,CIPAYUNG,BAMBU APUS,26285,4549,21736,18891,40627,2021-12-09
3174031002,JAKARTA SELATAN,MAMPANG PRAPATAN,BANGKA,21566,4290,17276,14865,32141,2021-12-09
3175051002,JAKARTA TIMUR,PASAR REBO,BARU,23886,3714,20172,17990,38162,2021-12-09
3175041004,JAKARTA TIMUR,KRAMAT JATI,BATU AMPAR,47898,10829,37069,31093,68162,2021-12-09
3171071002,JAKARTA PUSAT,TANAH ABANG,BENDUNGAN HILIR,21494,4138,17356,15275,32631,2021-12-09
3175031002,JAKARTA TIMUR,JATINEGARA,BIDARA CINA,36689,8325,28364,23987,52351,2021-12-09
3174101002,JAKARTA SELATAN,PESANGGRAHAN,BINTARO,53098,10137,42961,38599,81560,2021-12-09
3174011005,JAKARTA SELATAN,TEBET,BUKIT DURI,34183,6453,27730,23983,51713,2021-12-09
3171041006,JAKARTA PUSAT,SENEN,BUNGUR,18144,3580,14564,12478,27042,2021-12-09
3175061007,JAKARTA TIMUR,CAKUNG,CAKUNG BARAT,57724,11132,46592,39458,86050,2021-12-09
3175061004,JAKARTA TIMUR,CAKUNG,CAKUNG TIMUR,58287,10819,47468,40714,88182,2021-12-09
3175041007,JAKARTA TIMUR,KRAMAT JATI,CAWANG,32762,6525,26237,22068,48305,2021-12-09
3175101008,JAKARTA TIMUR,CIPAYUNG,CEGER,18932,3473,15459,13363,28822,2021-12-09
3171031006,JAKARTA PUSAT,KEMAYORAN,CEMPAKA BARU,32581,5790,26791,22878,49669,2021-12-09
3171051002,JAKARTA PUSAT,CEMPAKA PUTIH,CEMPAKA PUTIH BARAT,35885,7103,28782,25379,54161,2021-12-09
3171051001,JAKARTA PUSAT,CEMPAKA PUTIH,CEMPAKA PUTIH TIMUR,24292,4751,19541,17664,37205,2021-12-09
3173011001,JAKARTA BARAT,CENGKARENG,CENGKARENG BARAT,66284,12444,53840,47797,101637,2021-12-09
3173011006,JAKARTA BARAT,CENGKARENG,CENGKARENG TIMUR,81027,15075,65952,57009,122961,2021-12-09
3175091002,JAKARTA TIMUR,CIRACAS,CIBUBUR,66364,10808,55556,48806,104362,2021-12-09
3171011002,JAKARTA PUSAT,GAMBIR,CIDENG,15390,2884,12506,11175,23681,2021-12-09
3174091003,JAKARTA SELATAN,JAGAKARSA,CIGANJUR,38497,6088,32409,28276,60685,2021-12-09
3175051003,JAKARTA TIMUR,PASAR REBO,CIJANTUNG,41419,7227,34192,29678,63870,2021-12-09
3171061003,JAKARTA PUSAT,MENTENG,CIKINI,8274,1424,6850,5686,12536,2021-12-09
3174081006,JAKARTA SELATAN,PANCORAN,CIKOKO,10547,1724,8823,7864,16687,2021-12-09
3174061001,JAKARTA SELATAN,CILANDAK,CILANDAK BARAT,51752,8634,43118,39005,82123,2021-12-09
3174041003,JAKARTA SELATAN,PASAR MINGGU,CILANDAK TIMUR,25145,4288,20857,18447,39304,2021-12-09
3175101002,JAKARTA TIMUR,CIPAYUNG,CILANGKAP,27635,4631,23004,20241,43245,2021-12-09
3175041006,JAKARTA TIMUR,KRAMAT JATI,CILILITAN,40181,7907,32274,27263,59537,2021-12-09
3172041001,JAKARTA UTARA,CILINCING,CILINCING,43609,9757,33852,27426,61278,2021-12-09
3175101001,JAKARTA TIMUR,CIPAYUNG,CIPAYUNG,26104,4301,21803,19303,41106,2021-12-09
3174091006,JAKARTA SELATAN,JAGAKARSA,CIPEDAK,38303,5994,32309,28422,60731,2021-12-09
3174061005,JAKARTA SELATAN,CILANDAK,CIPETE SELATAN,26704,4801,21903,19859,41762,2021-12-09
3174071010,JAKARTA SELATAN,KEBAYORAN BARU,CIPETE UTARA,34102,6139,27963,24363,52326,2021-12-09
3175021003,JAKARTA TIMUR,PULO GADUNG,CIPINANG,39306,6676,32630,28261,60891,2021-12-09
3175031007,JAKARTA TIMUR,JATINEGARA,CIPINANG BESAR SELATAN,35212,7851,27361,22738,50099,2021-12-09
3175031008,JAKARTA TIMUR,JATINEGARA,CIPINANG BESAR UTARA,45319,10010,35309,28984,64293,2021-12-09
3175031005,JAKARTA TIMUR,JATINEGARA,CIPINANG CEMPEDAK,32824,6762,26062,23033,49095,2021-12-09
3175081005,JAKARTA TIMUR,MAKASAR,CIPINANG MELAYU,42308,7718,34590,30438,65028,2021-12-09
3175031006,JAKARTA TIMUR,JATINEGARA,CIPINANG MUARA,55243,11082,44161,37661,81822,2021-12-09
3174051003,JAKARTA SELATAN,KEBAYORAN LAMA,CIPULIR,39937,7960,31977,27297,59274,2021-12-09
3175091001,JAKARTA TIMUR,CIRACAS,CIRACAS,64594,11256,53338,45758,99096,2021-12-09
3175041003,JAKARTA TIMUR,KRAMAT JATI,DUKUH,24609,4279,20330,17374,37704,2021-12-09
3175071001,JAKARTA TIMUR,DUREN SAWIT,DUREN SAWIT,61160,12192,48968,42536,91504,2021-12-09
3174081004,JAKARTA SELATAN,PANCORAN,DUREN TIGA,28319,5286,23033,19894,42927,2021-12-09
3173051005,JAKARTA BARAT,KEBON JERUK,DURI KEPA,60138,11280,48858,43322,92180,2021-12-09
3173011002,JAKARTA BARAT,CENGKARENG,DURI KOSAMBI,77923,15526,62397,52274,114671,2021-12-09
3171011006,JAKARTA PUSAT,GAMBIR,DURI PULO,19610,3960,15650,12980,28630,2021-12-09
3173041011,JAKARTA BARAT,TAMBORA,DURI SELATAN,14259,2391,11868,10322,22190,2021-12-09
3173041003,JAKARTA BARAT,TAMBORA,DURI UTARA,19844,3366,16478,14030,30508,2021-12-09
3171081003,JAKARTA PUSAT,JOHAR BARU,GALUR,18243,3383,14860,12337,27197,2021-12-09
3171011001,JAKARTA PUSAT,GAMBIR,GAMBIR,2191,439,1752,1548,3300,2021-12-09
3174061004,JAKARTA SELATAN,CILANDAK,GANDARIA SELATAN,22119,3971,18148,16031,34179,2021-12-09
3174071009,JAKARTA SELATAN,KEBAYORAN BARU,GANDARIA UTARA,39922,7446,32476,28568,61044,2021-12-09
3175051001,JAKARTA TIMUR,PASAR REBO,GEDONG,35755,6759,28996,25344,54340,2021-12-09
3171071001,JAKARTA PUSAT,TANAH ABANG,GELORA,3127,586,2541,2276,4817,2021-12-09
3173031007,JAKARTA BARAT,TAMAN SARI,GLODOK,7837,1124,6713,6216,12929,2021-12-09
3171061004,JAKARTA PUSAT,MENTENG,GONDANGDIA,4100,888,3212,2987,6199,2021-12-09
3173021001,JAKARTA BARAT,GROGOL PETAMBURAN,GROGOL,16876,3151,13725,11996,25721,2021-12-09
3174051005,JAKARTA SELATAN,KEBAYORAN LAMA,GROGOL SELATAN,44251,8332,35919,30953,66872,2021-12-09
3174051004,JAKARTA SELATAN,KEBAYORAN LAMA,GROGOL UTARA,42494,8230,34264,29564,63828,2021-12-09
3174021007,JAKARTA SELATAN,SETIA BUDI,GUNTUR,3985,718,3267,2985,6252,2021-12-09
3174071002,JAKARTA SELATAN,KEBAYORAN BARU,GUNUNG,9436,1682,7754,7069,14823,2021-12-09
3171031005,JAKARTA PUSAT,KEMAYORAN,GUNUNG SAHARI SELATAN,19199,3509,15690,13674,29364,2021-12-09
3171021004,JAKARTA PUSAT,SAWAH BESAR,GUNUNG SAHARI UTARA,16650,2784,13866,12630,26496,2021-12-09
3175081004,JAKARTA TIMUR,MAKASAR,HALIM PERDANA KUSUMAH,28363,3437,24926,23196,48122,2021-12-09
3171031003,JAKARTA PUSAT,KEMAYORAN,HARAPAN MULIA,22557,4112,18445,15689,34134,2021-12-09
3174091001,JAKARTA SELATAN,JAGAKARSA,JAGAKARSA,62389,9610,52779,46800,99579,2021-12-09
3175021007,JAKARTA TIMUR,PULO GADUNG,JATI,32757,5795,26962,24247,51209,2021-12-09
3174041002,JAKARTA SELATAN,PASAR MINGGU,JATI PADANG,37502,6713,30789,26930,57719,2021-12-09
3173071004,JAKARTA BARAT,PALMERAH,JATI PULO,28738,5400,23338,19396,42734,2021-12-09
3175061001,JAKARTA TIMUR,CAKUNG,JATINEGARA,84160,16724,67436,57671,125107,2021-12-09
3175021004,JAKARTA TIMUR,PULO GADUNG,JATINEGARA KAUM,24632,4141,20491,17388,37879,2021-12-09
3173021004,JAKARTA BARAT,GROGOL PETAMBURAN,JELAMBAR,30266,5223,25043,22717,47760,2021-12-09
3173021006,JAKARTA BARAT,GROGOL PETAMBURAN,JELAMBAR BARU,38246,6435,31811,28626,60437,2021-12-09
3173041006,JAKARTA BARAT,TAMBORA,JEMBATAN BESI,29314,6668,22646,18437,41083,2021-12-09
3173041008,JAKARTA BARAT,TAMBORA,JEMBATAN LIMA,21021,4449,16572,13647,30219,2021-12-09
3173081005,JAKARTA BARAT,KEMBANGAN,JOGLO,40839,7745,33094,28896,61990,2021-12-09
3171081001,JAKARTA PUSAT,JOHAR BARU,JOHAR BARU,37488,6615,30873,26839,57712,2021-12-09
3173041002,JAKARTA BARAT,TAMBORA,KALI ANYAR,23856,4453,19403,16018,35421,2021-12-09
3172041004,JAKARTA UTARA,CILINCING,KALIBARU,67684,17322,50362,37305,87667,2021-12-09
3174081002,JAKARTA SELATAN,PANCORAN,KALIBATA,41994,8938,33056,28089,61145,2021-12-09
3173061001,JAKARTA BARAT,KALI DERES,KALIDERES,72447,13665,58782,51418,110200,2021-12-09
3175051004,JAKARTA TIMUR,PASAR REBO,KALISARI,43212,7205,36007,31520,67527,2021-12-09
3173061004,JAKARTA BARAT,KALI DERES,KAMAL,53783,11672,42111,35027,77138,2021-12-09
3172011002,JAKARTA UTARA,PENJARINGAN,KAMAL MUARA,12930,2228,10702,9256,19958,2021-12-09
3171071007,JAKARTA PUSAT,TANAH ABANG,KAMPUNG BALI,11358,2324,9034,7307,16341,2021-12-09
3175031001,JAKARTA TIMUR,JATINEGARA,KAMPUNG MELAYU,25717,5570,20147,16460,36607,2021-12-09
3171081002,JAKARTA PUSAT,JOHAR BARU,KAMPUNG RAWA,21237,3340,17897,14703,32600,2021-12-09
3175041002,JAKARTA TIMUR,KRAMAT JATI,KAMPUNG TENGAH,43993,10243,33750,28043,61793,2021-12-09
3173011005,JAKARTA BARAT,CENGKARENG,KAPUK,134466,30334,104132,87586,191718,2021-12-09
3172011003,JAKARTA UTARA,PENJARINGAN,KAPUK MUARA,35781,6510,29271,26433,55704,2021-12-09
3171021002,JAKARTA PUSAT,SAWAH BESAR,KARANG ANYAR,25761,4583,21178,18314,39492,2021-12-09
3174021004,JAKARTA SELATAN,SETIA BUDI,KARET,9623,1766,7857,6832,14689,2021-12-09
3174021003,JAKARTA SELATAN,SETIA BUDI,KARET KUNINGAN,16055,2970,13085,11486,24571,2021-12-09
3174021002,JAKARTA SELATAN,SETIA BUDI,KARET SEMANGGI,2770,536,2234,2026,4260,2021-12-09
3171071003,JAKARTA PUSAT,TANAH ABANG,KARET TENGSIN,19271,3550,15721,13351,29072,2021-12-09
3171021003,JAKARTA PUSAT,SAWAH BESAR,KARTINI,22292,3956,18336,16220,34556,2021-12-09
3175011003,JAKARTA TIMUR,MATRAMAN,KAYU MANIS,25284,4969,20315,16941,37256,2021-12-09
3175021006,JAKARTA TIMUR,PULO GADUNG,KAYU PUTIH,40696,7291,33405,30040,63445,2021-12-09
3173031006,JAKARTA BARAT,TAMAN SARI,KEAGUNGAN,17387,3049,14338,12157,26495,2021-12-09
3174041007,JAKARTA SELATAN,PASAR MINGGU,KEBAGUSAN,44552,8267,36285,31395,67680,2021-12-09
3174051006,JAKARTA SELATAN,KEBAYORAN LAMA,KEBAYORAN LAMA SELATAN,41212,7188,34024,30033,64057,2021-12-09
3174051001,JAKARTA SELATAN,KEBAYORAN LAMA,KEBAYORAN LAMA UTARA,42422,8314,34108,29558,63666,2021-12-09
3174011004,JAKARTA SELATAN,TEBET,KEBON BARU,35165,6134,29031,25298,54329,2021-12-09
3172021005,JAKARTA UTARA,TANJUNG PRIOK,KEBON BAWANG,50952,9641,41311,35625,76936,2021-12-09
3173051001,JAKARTA BARAT,KEBON JERUK,KEBON JERUK,53887,10356,43531,36975,80506,2021-12-09
3171071006,JAKARTA PUSAT,TANAH ABANG,KEBON KACANG,21531,4893,16638,13785,30423,2021-12-09
3171011005,JAKARTA PUSAT,GAMBIR,KEBON KELAPA,10163,1947,8216,7181,15397,2021-12-09
3171031002,JAKARTA PUSAT,KEMAYORAN,KEBON KOSONG,30019,5693,24326,20853,45179,2021-12-09
3175011005,JAKARTA TIMUR,MATRAMAN,KEBON MANGGIS,16490,3006,13484,11538,25022,2021-12-09
3171071005,JAKARTA PUSAT,TANAH ABANG,KEBON MELATI,32206,8177,24029,18681,42710,2021-12-09
3175081003,JAKARTA TIMUR,MAKASAR,KEBON PALA,46614,8691,37923,32816,70739,2021-12-09
3171061005,JAKARTA PUSAT,MENTENG,KEBON SIRIH,12299,2473,9826,8245,18071,2021-12-09
3173011004,JAKARTA BARAT,CENGKARENG,KEDAUNG KALI ANGKE,32612,5923,26689,23122,49811,2021-12-09
3173051007,JAKARTA BARAT,KEBON JERUK,KEDOYA SELATAN,32165,5594,26571,22720,49291,2021-12-09
3173051006,JAKARTA BARAT,KEBON JERUK,KEDOYA UTARA,45740,8331,37409,32428,69837,2021-12-09
3173051004,JAKARTA BARAT,KEBON JERUK,KELAPA DUA,23565,4369,19196,16617,35813,2021-12-09
3175091003,JAKARTA TIMUR,CIRACAS,KELAPA DUA WETAN,46875,7596,39279,34382,73661,2021-12-09
3172061003,JAKARTA UTARA,KELAPA GADING,KELAPA GADING BARAT,35717,5942,29775,27401,57176,2021-12-09
3172061001,JAKARTA UTARA,KELAPA GADING,KELAPA GADING TIMUR,33592,4905,28687,27076,55763,2021-12-09
3173071005,JAKARTA BARAT,PALMERAH,KEMANGGISAN,32139,5741,26398,23238,49636,2021-12-09
3171031001,JAKARTA PUSAT,KEMAYORAN,KEMAYORAN,20708,3882,16826,14383,31209,2021-12-09
3173081006,JAKARTA BARAT,KEMBANGAN,KEMBANGAN SELATAN,27130,5379,21751,19210,40961,2021-12-09
3173081001,JAKARTA BARAT,KEMBANGAN,KEMBANGAN UTARA,54451,11006,43445,37189,80634,2021-12-09
3171041002,JAKARTA PUSAT,SENEN,KENARI,9579,1785,7794,6831,14625,2021-12-09
3173041005,JAKARTA BARAT,TAMBORA,KERENDANG,19973,3847,16126,13687,29813,2021-12-09
3175071003,JAKARTA TIMUR,DUREN SAWIT,KLENDER,69978,15423,54555,45492,100047,2021-12-09
3172031001,JAKARTA UTARA,KOJA,KOJA,28175,6047,22128,18536,40664,2021-12-09
3173071006,JAKARTA BARAT,PALMERAH,KOTA BAMBU SELATAN,21158,3921,17237,14218,31455,2021-12-09
3173071003,JAKARTA BARAT,PALMERAH,KOTA BAMBU UTARA,24995,4794,20201,16508,36709,2021-12-09
3171041004,JAKARTA PUSAT,SENEN,KRAMAT,28835,6133,22702,17735,40437,2021-12-09
3175041001,JAKARTA TIMUR,KRAMAT JATI,KRAMAT JATI,34144,6779,27365,23015,50380,2021-12-09
3174071003,JAKARTA SELATAN,KEBAYORAN BARU,KRAMAT PELA,14413,2649,11764,10445,22209,2021-12-09
3173031002,JAKARTA BARAT,TAMAN SARI,KRUKUT,19244,3448,15796,13326,29122,2021-12-09
3174031005,JAKARTA SELATAN,MAMPANG PRAPATAN,KUNINGAN BARAT,12785,2183,10602,9225,19827,2021-12-09
3174021008,JAKARTA SELATAN,SETIA BUDI,KUNINGAN TIMUR,6008,1137,4871,4338,9209,2021-12-09
3171041005,JAKARTA PUSAT,SENEN,KWITANG,15486,3206,12280,10207,22487,2021-12-09
3172031003,JAKARTA UTARA,KOJA,LAGOA,59065,13085,45980,37939,83919,2021-12-09
3174061002,JAKARTA SELATAN,CILANDAK,LEBAK BULUS,37626,6707,30919,28084,59003,2021-12-09
3174091004,JAKARTA SELATAN,JAGAKARSA,LENTENG AGUNG,53946,9081,44865,38313,83178,2021-12-09
3175101007,JAKARTA TIMUR,CIPAYUNG,LUBANG BUAYA,63547,11335,52212,44991,97203,2021-12-09
3175081001,JAKARTA TIMUR,MAKASAR,MAKASAR,34390,5796,28594,25182,53776,2021-12-09
3175071006,JAKARTA TIMUR,DUREN SAWIT,MALAKA JAYA,30927,4937,25990,23248,49238,2021-12-09
3175071005,JAKARTA TIMUR,DUREN SAWIT,MALAKA SARI,27530,4297,23233,20939,44172,2021-12-09
3174031001,JAKARTA SELATAN,MAMPANG PRAPATAN,MAMPANG PRAPATAN,18159,3500,14659,12569,27228,2021-12-09
3173031005,JAKARTA BARAT,TAMAN SARI,MANGGA BESAR,7707,1245,6462,5839,12301,2021-12-09
3171021005,JAKARTA PUSAT,SAWAH BESAR,MANGGA DUA SELATAN,27442,5231,22211,19278,41489,2021-12-09
3174011007,JAKARTA SELATAN,TEBET,MANGGARAI,28373,4688,23685,20136,43821,2021-12-09
3174011006,JAKARTA SELATAN,TEBET,MANGGARAI SELATAN,23075,3483,19592,17046,36638,2021-12-09
3173031003,JAKARTA BARAT,TAMAN SARI,MAPHAR,16461,2914,13547,11711,25258,2021-12-09
3172041003,JAKARTA UTARA,CILINCING,MARUNDA,28943,6158,22785,17823,40608,2021-12-09
3174071001,JAKARTA SELATAN,KEBAYORAN BARU,MELAWAI,2627,491,2136,2009,4145,2021-12-09
3171061001,JAKARTA PUSAT,MENTENG,MENTENG,25624,5301,20323,16835,37158,2021-12-09
3174021005,JAKARTA SELATAN,SETIA BUDI,MENTENG ATAS,27816,4691,23125,20075,43200,2021-12-09
3174011003,JAKARTA SELATAN,TEBET,MENTENG DALAM,36028,6608,29420,25843,55263,2021-12-09
3173081003,JAKARTA BARAT,KEMBANGAN,MERUYA SELATAN,32130,6212,25918,22669,48587,2021-12-09
3173081002,JAKARTA BARAT,KEMBANGAN,MERUYA UTARA,43752,8510,35242,31560,66802,2021-12-09
3175101004,JAKARTA TIMUR,CIPAYUNG,MUNJUL,23871,4153,19718,17246,36964,2021-12-09
3172051002,JAKARTA UTARA,PADEMANGAN,PADEMANGAN BARAT,74240,16447,57793,48354,106147,2021-12-09
3172051001,JAKARTA UTARA,PADEMANGAN,PADEMANGAN TIMUR,37736,6296,31440,28511,59951,2021-12-09
3175011004,JAKARTA TIMUR,MATRAMAN,PAL MERIAM,19769,3765,16004,13427,29431,2021-12-09
3173071001,JAKARTA BARAT,PALMERAH,PALMERAH,63011,12376,50635,42975,93610,2021-12-09
3174081001,JAKARTA SELATAN,PANCORAN,PANCORAN,19421,3622,15799,13644,29443,2021-12-09
3172021003,JAKARTA UTARA,TANJUNG PRIOK,PAPANGGO,39097,7243,31854,27161,59015,2021-12-09
3171021001,JAKARTA PUSAT,SAWAH BESAR,PASAR BARU,12035,2183,9852,9006,18858,2021-12-09
3174021006,JAKARTA SELATAN,SETIA BUDI,PASAR MANGGIS,26752,4772,21980,18953,40933,2021-12-09
3174041001,JAKARTA SELATAN,PASAR MINGGU,PASAR MINGGU,24821,4412,20409,18091,38500,2021-12-09
3171041003,JAKARTA PUSAT,SENEN,PASEBAN,23533,4617,18916,16040,34956,2021-12-09
3173061005,JAKARTA BARAT,KALI DERES,PEGADUNGAN,75587,13884,61703,54344,116047,2021-12-09
3171061002,JAKARTA PUSAT,MENTENG,PEGANGSAAN,23455,4758,18697,15164,33861,2021-12-09
3172061002,JAKARTA UTARA,KELAPA GADING,PEGANGSAAN DUA,49976,7907,42069,38831,80900,2021-12-09
3172011004,JAKARTA UTARA,PENJARINGAN,PEJAGALAN,74578,14593,59985,53539,113524,2021-12-09
3174041006,JAKARTA SELATAN,PASAR MINGGU,PEJATEN BARAT,37346,6739,30607,26864,57471,2021-12-09
3174041005,JAKARTA SELATAN,PASAR MINGGU,PEJATEN TIMUR,57656,11613,46043,38866,84909,2021-12-09
3175051005,JAKARTA TIMUR,PASAR REBO,PEKAYON,43250,7358,35892,31098,66990,2021-12-09
3173041009,JAKARTA BARAT,TAMBORA,PEKOJAN,23587,4251,19336,16868,36204,2021-12-09
3174031003,JAKARTA SELATAN,MAMPANG PRAPATAN,PELA MAMPANG,43522,8074,35448,31018,66466,2021-12-09
3174081005,JAKARTA SELATAN,PANCORAN,PENGADEGAN,21478,3722,17756,15682,33438,2021-12-09
3175061003,JAKARTA TIMUR,CAKUNG,PENGGILINGAN,99255,21289,77966,64863,142829,2021-12-09
3172011001,JAKARTA UTARA,PENJARINGAN,PENJARINGAN,88308,21430,66878,54125,121003,2021-12-09
3174101001,JAKARTA SELATAN,PESANGGRAHAN,PESANGGRAHAN,27545,4485,23060,20437,43497,2021-12-09
3171071004,JAKARTA PUSAT,TANAH ABANG,PETAMBURAN,33271,8323,24948,19890,44838,2021-12-09
3174071008,JAKARTA SELATAN,KEBAYORAN BARU,PETOGOGAN,11499,2092,9407,8307,17714,2021-12-09
3171011004,JAKARTA PUSAT,GAMBIR,PETOJO SELATAN,14692,3152,11540,10073,21613,2021-12-09
3171011003,JAKARTA PUSAT,GAMBIR,PETOJO UTARA,17458,3597,13861,11769,25630,2021-12-09
3174101004,JAKARTA SELATAN,PESANGGRAHAN,PETUKANGAN SELATAN,37187,7246,29941,26259,56200,2021-12-09
3174101003,JAKARTA SELATAN,PESANGGRAHAN,PETUKANGAN UTARA,53716,10871,42845,37114,79959,2021-12-09
3175081002,JAKARTA TIMUR,MAKASAR,PINANG RANTI,27198,5595,21603,18497,40100,2021-12-09
3173031008,JAKARTA BARAT,TAMAN SARI,PINANGSIA,10729,1780,8949,7651,16600,2021-12-09
3175011001,JAKARTA TIMUR,MATRAMAN,PISANGAN BARU,31776,6147,25629,21385,47014,2021-12-09
3175021002,JAKARTA TIMUR,PULO GADUNG,PISANGAN TIMUR,41011,7118,33893,29839,63732,2021-12-09
3172011005,JAKARTA UTARA,PENJARINGAN,PLUIT,47783,8905,38878,34919,73797,2021-12-09
3175071002,JAKARTA TIMUR,DUREN SAWIT,PONDOK BAMBU,61550,12208,49342,42995,92337,2021-12-09
3175071004,JAKARTA TIMUR,DUREN SAWIT,PONDOK KELAPA,72015,13560,58455,51863,110318,2021-12-09
3175071007,JAKARTA TIMUR,DUREN SAWIT,PONDOK KOPI,35367,6293,29074,24592,53666,2021-12-09
3174061003,JAKARTA SELATAN,CILANDAK,PONDOK LABU,46464,7227,39237,35503,74740,2021-12-09
3174051002,JAKARTA SELATAN,KEBAYORAN LAMA,PONDOK PINANG,56169,10249,45920,40832,86752,2021-12-09
3175101003,JAKARTA TIMUR,CIPAYUNG,PONDOK RANGGON,25574,4555,21019,18479,39498,2021-12-09
3101011003,KAB.ADM.KEP.SERIBU,KEP. SERIBU UTARA,PULAU HARAPAN,2060,198,1862,1668,3530,2021-12-09
3101011002,KAB.ADM.KEP.SERIBU,KEP. SERIBU UTARA,PULAU KELAPA,5528,557,4971,4226,9197,2021-12-09
3101011001,KAB.ADM.KEP.SERIBU,KEP. SERIBU UTARA,PULAU PANGGANG,5450,419,5031,4567,9598,2021-12-09
3101021003,KAB.ADM.KEP.SERIBU,KEP. SERIBU SELATAN,PULAU PARI,2765,191,2574,2442,5016,2021-12-09
3101021002,KAB.ADM.KEP.SERIBU,KEP. SERIBU SELATAN,PULAU TIDUNG,4553,351,4202,3917,8119,2021-12-09
3101021001,KAB.ADM.KEP.SERIBU,KEP. SERIBU SELATAN,PULAU UNTUNG JAWA,1941,154,1787,1664,3451,2021-12-09
3174071007,JAKARTA SELATAN,KEBAYORAN BARU,PULO,5835,970,4865,4579,9444,2021-12-09
3175021001,JAKARTA TIMUR,PULO GADUNG,PULO GADUNG,34422,7125,27297,23602,50899,2021-12-09
3175061005,JAKARTA TIMUR,CAKUNG,PULO GEBANG,97301,17682,79619,67371,146990,2021-12-09
3174041004,JAKARTA SELATAN,PASAR MINGGU,RAGUNAN,39616,6587,33029,29213,62242,2021-12-09
3175091005,JAKARTA TIMUR,CIRACAS,RAMBUTAN,36771,8156,28615,24148,52763,2021-12-09
3172031006,JAKARTA UTARA,KOJA,RAWA BADAK SELATAN,42179,9380,32799,26956,59755,2021-12-09
3172031004,JAKARTA UTARA,KOJA,RAWA BADAK UTARA,34408,7260,27148,22943,50091,2021-12-09
3174071005,JAKARTA SELATAN,KEBAYORAN BARU,RAWA BARAT,5625,962,4663,4243,8906,2021-12-09
3173011003,JAKARTA BARAT,CENGKARENG,RAWA BUAYA,63799,11854,51945,44690,96635,2021-12-09
3175031004,JAKARTA TIMUR,JATINEGARA,RAWA BUNGA,21434,4812,16622,14093,30715,2021-12-09
3174081003,JAKARTA SELATAN,PANCORAN,RAWA JATI,20509,3692,16817,14879,31696,2021-12-09
3175061002,JAKARTA TIMUR,CAKUNG,RAWA TERATE,24637,4193,20444,17304,37748,2021-12-09
3175021005,JAKARTA TIMUR,PULO GADUNG,RAWAMANGUN,37612,6983,30629,26971,57600,2021-12-09
3171051003,JAKARTA PUSAT,CEMPAKA PUTIH,RAWASARI,21967,4189,17778,15754,33532,2021-12-09
3173041010,JAKARTA BARAT,TAMBORA,ROA MALAKA,3484,593,2891,2642,5533,2021-12-09
3172041006,JAKARTA UTARA,CILINCING,ROROTAN,41668,7925,33743,28351,62094,2021-12-09
3174071004,JAKARTA SELATAN,KEBAYORAN BARU,SELONG,2842,530,2312,2175,4487,2021-12-09
3173061002,JAKARTA BARAT,KALI DERES,SEMANAN,71354,14034,57320,47866,105186,2021-12-09
3172041007,JAKARTA UTARA,CILINCING,SEMPER BARAT,68587,12621,55966,48266,104232,2021-12-09
3172041005,JAKARTA UTARA,CILINCING,SEMPER TIMUR,36267,7290,28977,24373,53350,2021-12-09
3174071006,JAKARTA SELATAN,KEBAYORAN BARU,SENAYAN,2771,629,2142,1918,4060,2021-12-09
3171041001,JAKARTA PUSAT,SENEN,SENEN,6804,1363,5441,4653,10094,2021-12-09
3171031004,JAKARTA PUSAT,KEMAYORAN,SERDANG,29668,5341,24327,21116,45443,2021-12-09
3174021001,JAKARTA SELATAN,SETIA BUDI,SETIA BUDI,3023,580,2443,2164,4607,2021-12-09
3175101005,JAKARTA TIMUR,CIPAYUNG,SETU,20572,3883,16689,14251,30940,2021-12-09
3173071002,JAKARTA BARAT,PALMERAH,SLIPI,16591,2813,13778,12120,25898,2021-12-09
3173081004,JAKARTA BARAT,KEMBANGAN,SRENGSENG,45523,9571,35952,31340,67292,2021-12-09
3174091002,JAKARTA SELATAN,JAGAKARSA,SRENGSENG SAWAH,58196,8338,49858,44475,94333,2021-12-09
3173051003,JAKARTA BARAT,KEBON JERUK,SUKABUMI SELATAN,37033,7309,29724,23933,53657,2021-12-09
3173051002,JAKARTA BARAT,KEBON JERUK,SUKABUMI UTARA,38290,8066,30224,24537,54761,2021-12-09
3172041002,JAKARTA UTARA,CILINCING,SUKAPURA,53949,11488,42461,36236,78697,2021-12-09
3171031007,JAKARTA PUSAT,KEMAYORAN,SUMUR BATU,22717,4031,18686,16583,35269,2021-12-09
3172021004,JAKARTA UTARA,TANJUNG PRIOK,SUNGAI BAMBU,29876,5598,24278,20894,45172,2021-12-09
3172021006,JAKARTA UTARA,TANJUNG PRIOK,SUNTER AGUNG,71805,11771,60034,54222,114256,2021-12-09
3172021002,JAKARTA UTARA,TANJUNG PRIOK,SUNTER JAYA,63031,10462,52569,47111,99680,2021-12-09
3175091004,JAKARTA TIMUR,CIRACAS,SUSUKAN,38257,6815,31442,27108,58550,2021-12-09
3173031001,JAKARTA BARAT,TAMAN SARI,TAMAN SARI,14348,2487,11861,10494,22355,2021-12-09
3173041001,JAKARTA BARAT,TAMBORA,TAMBORA,10204,2082,8122,6794,14916,2021-12-09
3173041004,JAKARTA BARAT,TAMBORA,TANAH SEREAL,26387,4222,22165,19111,41276,2021-12-09
3171081004,JAKARTA PUSAT,JOHAR BARU,TANAH TINGGI,37693,6875,30818,25727,56545,2021-12-09
3173031004,JAKARTA BARAT,TAMAN SARI,TANGKI,13324,2111,11213,9844,21057,2021-12-09
3174091005,JAKARTA SELATAN,JAGAKARSA,TANJUNG BARAT,39770,6362,33408,28948,62356,2021-12-09
3173021005,JAKARTA BARAT,GROGOL PETAMBURAN,TANJUNG DUREN SELATAN,25337,4578,20759,18954,39713,2021-12-09
3173021002,JAKARTA BARAT,GROGOL PETAMBURAN,TANJUNG DUREN UTARA,17010,2716,14294,13182,27476,2021-12-09
3172021001,JAKARTA UTARA,TANJUNG PRIOK,TANJUNG PRIOK,34588,6752,27836,23499,51335,2021-12-09
3174011002,JAKARTA SELATAN,TEBET,TEBET BARAT,21194,3197,17997,16392,34389,2021-12-09
3174011001,JAKARTA SELATAN,TEBET,TEBET TIMUR,18199,2765,15434,14361,29795,2021-12-09
3173061003,JAKARTA BARAT,KALI DERES,TEGAL ALUR,83647,16350,67297,57533,124830,2021-12-09
3174031004,JAKARTA SELATAN,MAMPANG PRAPATAN,TEGAL PARANG,32401,6726,25675,21033,46708,2021-12-09
3173021003,JAKARTA BARAT,GROGOL PETAMBURAN,TOMANG,29605,5141,24464,21789,46253,2021-12-09
3172031005,JAKARTA UTARA,KOJA,TUGU SELATAN,39122,8176,30946,26045,56991,2021-12-09
3172031002,JAKARTA UTARA,KOJA,TUGU UTARA,67670,15156,52514,43383,95897,2021-12-09
3175061006,JAKARTA TIMUR,CAKUNG,UJUNG MENTENG,29934,4882,25052,22037,47089,2021-12-09
3174101005,JAKARTA SELATAN,PESANGGRAHAN,ULUJAMI,40544,8355,32189,27585,59774,2021-12-09
3175011006,JAKARTA TIMUR,MATRAMAN,UTAN KAYU SELATAN,33511,5642,27869,24031,51900,2021-12-09
3175011002,JAKARTA TIMUR,MATRAMAN,UTAN KAYU UTARA,28169,5362,22807,19344,42151,2021-12-09
3171031008,JAKARTA PUSAT,KEMAYORAN,UTAN PANJANG,29208,5431,23777,20045,43822,2021-12-09
3172021007,JAKARTA UTARA,TANJUNG PRIOK,WARAKAS,44401,7707,36694,30845,67539,2021-12-09
3173021007,JAKARTA BARAT,GROGOL PETAMBURAN,WIJAYA KUSUMA,38934,7593,31341,27316,58657,2021-12-09
3172051003,JAKARTA UTARA,PADEMANGAN,ANCOL,23947,5455,18492,15635,34127,2021-12-10
3173041007,JAKARTA BARAT,TAMBORA,ANGKE,29381,5849,23532,19701,43233,2021-12-10
3175041005,JAKARTA TIMUR,KRAMAT JATI,BALE KAMBANG,29074,6659,22415,18389,40804,2021-12-10
3175031003,JAKARTA TIMUR,JATINEGARA,BALI MESTER,9752,1880,7872,6861,14733,2021-12-10
3175101006,JAKARTA TIMUR,CIPAYUNG,BAMBU APUS,26285,4545,21740,18943,40683,2021-12-10
3174031002,JAKARTA SELATAN,MAMPANG PRAPATAN,BANGKA,21566,4285,17281,14874,32155,2021-12-10
3175051002,JAKARTA TIMUR,PASAR REBO,BARU,23886,3710,20176,17996,38172,2021-12-10
3175041004,JAKARTA TIMUR,KRAMAT JATI,BATU AMPAR,47898,10812,37086,31151,68237,2021-12-10
3171071002,JAKARTA PUSAT,TANAH ABANG,BENDUNGAN HILIR,21494,4124,17370,15302,32672,2021-12-10
3175031002,JAKARTA TIMUR,JATINEGARA,BIDARA CINA,36689,8307,28382,24042,52424,2021-12-10
3174101002,JAKARTA SELATAN,PESANGGRAHAN,BINTARO,53098,10109,42989,38651,81640,2021-12-10
3174011005,JAKARTA SELATAN,TEBET,BUKIT DURI,34183,6447,27736,24003,51739,2021-12-10
3171041006,JAKARTA PUSAT,SENEN,BUNGUR,18144,3576,14568,12490,27058,2021-12-10
3175061007,JAKARTA TIMUR,CAKUNG,CAKUNG BARAT,57724,11115,46609,39492,86101,2021-12-10
3175061004,JAKARTA TIMUR,CAKUNG,CAKUNG TIMUR,58287,10808,47479,40767,88246,2021-12-10
3175041007,JAKARTA TIMUR,KRAMAT JATI,CAWANG,32762,6515,26247,22110,48357,2021-12-10
3175101008,JAKARTA TIMUR,CIPAYUNG,CEGER,18932,3464,15468,13389,28857,2021-12-10
3171031006,JAKARTA PUSAT,KEMAYORAN,CEMPAKA BARU,32581,5785,26796,22908,49704,2021-12-10
3171051002,JAKARTA PUSAT,CEMPAKA PUTIH,CEMPAKA PUTIH BARAT,35885,7094,28791,25419,54210,2021-12-10
3171051001,JAKARTA PUSAT,CEMPAKA PUTIH,CEMPAKA PUTIH TIMUR,24292,4744,19548,17687,37235,2021-12-10
3173011001,JAKARTA BARAT,CENGKARENG,CENGKARENG BARAT,66284,12418,53866,47865,101731,2021-12-10
3173011006,JAKARTA BARAT,CENGKARENG,CENGKARENG TIMUR,81027,15047,65980,57065,123045,2021-12-10
3175091002,JAKARTA TIMUR,CIRACAS,CIBUBUR,66364,10791,55573,48828,104401,2021-12-10
3171011002,JAKARTA PUSAT,GAMBIR,CIDENG,15390,2877,12513,11185,23698,2021-12-10
3174091003,JAKARTA SELATAN,JAGAKARSA,CIGANJUR,38497,6074,32423,28331,60754,2021-12-10
3175051003,JAKARTA TIMUR,PASAR REBO,CIJANTUNG,41419,7216,34203,29718,63921,2021-12-10
3171061003,JAKARTA PUSAT,MENTENG,CIKINI,8274,1415,6859,5696,12555,2021-12-10
3174081006,JAKARTA SELATAN,PANCORAN,CIKOKO,10547,1723,8824,7872,16696,2021-12-10
3174061001,JAKARTA SELATAN,CILANDAK,CILANDAK BARAT,51752,8622,43130,39049,82179,2021-12-10
3174041003,JAKARTA SELATAN,PASAR MINGGU,CILANDAK TIMUR,25145,4275,20870,18472,39342,2021-12-10
3175101002,JAKARTA TIMUR,CIPAYUNG,CILANGKAP,27635,4619,23016,20271,43287,2021-12-10
3175041006,JAKARTA TIMUR,KRAMAT JATI,CILILITAN,40181,7895,32286,27296,59582,2021-12-10
3172041001,JAKARTA UTARA,CILINCING,CILINCING,43609,9705,33904,27515,61419,2021-12-10
3175101001,JAKARTA TIMUR,CIPAYUNG,CIPAYUNG,26104,4291,21813,19344,41157,2021-12-10
3174091006,JAKARTA SELATAN,JAGAKARSA,CIPEDAK,38303,5978,32325,28457,60782,2021-12-10
3174061005,JAKARTA SELATAN,CILANDAK,CIPETE SELATAN,26704,4787,21917,19891,41808,2021-12-10
3174071010,JAKARTA SELATAN,KEBAYORAN BARU,CIPETE UTARA,34102,6127,27975,24389,52364,2021-12-10
3175021003,JAKARTA TIMUR,PULO GADUNG,CIPINANG,39306,6661,32645,28296,60941,2021-12-10
3175031007,JAKARTA TIMUR,JATINEGARA,CIPINANG BESAR SELATAN,35212,7844,27368,22779,50147,2021-12-10
3175031008,JAKARTA TIMUR,JATINEGARA,CIPINANG BESAR UTARA,45319,9983,35336,29042,64378,2021-12-10
3175031005,JAKARTA TIMUR,JATINEGARA,CIPINANG CEMPEDAK,32824,6752,26072,23072,49144,2021-12-10
3175081005,JAKARTA TIMUR,MAKASAR,CIPINANG MELAYU,42308,7712,34596,30464,65060,2021-12-10
3175031006,JAKARTA TIMUR,JATINEGARA,CIPINANG MUARA,55243,11041,44202,37738,81940,2021-12-10
3174051003,JAKARTA SELATAN,KEBAYORAN LAMA,CIPULIR,39937,7942,31995,27332,59327,2021-12-10
3175091001,JAKARTA TIMUR,CIRACAS,CIRACAS,64594,11235,53359,45821,99180,2021-12-10
3175041003,JAKARTA TIMUR,KRAMAT JATI,DUKUH,24609,4274,20335,17395,37730,2021-12-10
3175071001,JAKARTA TIMUR,DUREN SAWIT,DUREN SAWIT,61160,12175,48985,42595,91580,2021-12-10
3174081004,JAKARTA SELATAN,PANCORAN,DUREN TIGA,28319,5272,23047,19953,43000,2021-12-10
3173051005,JAKARTA BARAT,KEBON JERUK,DURI KEPA,60138,11257,48881,43366,92247,2021-12-10
3173011002,JAKARTA BARAT,CENGKARENG,DURI KOSAMBI,77923,15486,62437,52346,114783,2021-12-10
3171011006,JAKARTA PUSAT,GAMBIR,DURI PULO,19610,3925,15685,13004,28689,2021-12-10
3173041011,JAKARTA BARAT,TAMBORA,DURI SELATAN,14259,2390,11869,10342,22211,2021-12-10
3173041003,JAKARTA BARAT,TAMBORA,DURI UTARA,19844,3362,16482,14052,30534,2021-12-10
3171081003,JAKARTA PUSAT,JOHAR BARU,GALUR,18243,3372,14871,12358,27229,2021-12-10
3171011001,JAKARTA PUSAT,GAMBIR,GAMBIR,2191,437,1754,1548,3302,2021-12-10
3174061004,JAKARTA SELATAN,CILANDAK,GANDARIA SELATAN,22119,3967,18152,16054,34206,2021-12-10
3174071009,JAKARTA SELATAN,KEBAYORAN BARU,GANDARIA UTARA,39922,7436,32486,28613,61099,2021-12-10
3175051001,JAKARTA TIMUR,PASAR REBO,GEDONG,35755,6744,29011,25379,54390,2021-12-10
3171071001,JAKARTA PUSAT,TANAH ABANG,GELORA,3127,584,2543,2283,4826,2021-12-10
3173031007,JAKARTA BARAT,TAMAN SARI,GLODOK,7837,1123,6714,6224,12938,2021-12-10
3171061004,JAKARTA PUSAT,MENTENG,GONDANGDIA,4100,888,3212,2990,6202,2021-12-10
3173021001,JAKARTA BARAT,GROGOL PETAMBURAN,GROGOL,16876,3140,13736,12009,25745,2021-12-10
3174051005,JAKARTA SELATAN,KEBAYORAN LAMA,GROGOL SELATAN,44251,8320,35931,30993,66924,2021-12-10
3174051004,JAKARTA SELATAN,KEBAYORAN LAMA,GROGOL UTARA,42494,8219,34275,29611,63886,2021-12-10
3174021007,JAKARTA SELATAN,SETIA BUDI,GUNTUR,3985,715,3270,2991,6261,2021-12-10
3174071002,JAKARTA SELATAN,KEBAYORAN BARU,GUNUNG,9436,1680,7756,7076,14832,2021-12-10
3171031005,JAKARTA PUSAT,KEMAYORAN,GUNUNG SAHARI SELATAN,19199,3504,15695,13694,29389,2021-12-10
3171021004,JAKARTA PUSAT,SAWAH BESAR,GUNUNG SAHARI UTARA,16650,2778,13872,12650,26522,2021-12-10
3175081004,JAKARTA TIMUR,MAKASAR,HALIM PERDANA KUSUMAH,28363,3426,24937,23215,48152,2021-12-10
3171031003,JAKARTA PUSAT,KEMAYORAN,HARAPAN MULIA,22557,4076,18481,15731,34212,2021-12-10
3174091001,JAKARTA SELATAN,JAGAKARSA,JAGAKARSA,62389,9578,52811,46879,99690,2021-12-10
3175021007,JAKARTA TIMUR,PULO GADUNG,JATI,32757,5789,26968,24277,51245,2021-12-10
3174041002,JAKARTA SELATAN,PASAR MINGGU,JATI PADANG,37502,6680,30822,26999,57821,2021-12-10
3173071004,JAKARTA BARAT,PALMERAH,JATI PULO,28738,5382,23356,19419,42775,2021-12-10
3175061001,JAKARTA TIMUR,CAKUNG,JATINEGARA,84160,16696,67464,57745,125209,2021-12-10
3175021004,JAKARTA TIMUR,PULO GADUNG,JATINEGARA KAUM,24632,4139,20493,17410,37903,2021-12-10
3173021004,JAKARTA BARAT,GROGOL PETAMBURAN,JELAMBAR,30266,5217,25049,22733,47782,2021-12-10
3173021006,JAKARTA BARAT,GROGOL PETAMBURAN,JELAMBAR BARU,38246,6420,31826,28660,60486,2021-12-10
3173041006,JAKARTA BARAT,TAMBORA,JEMBATAN BESI,29314,6664,22650,18465,41115,2021-12-10
3173041008,JAKARTA BARAT,TAMBORA,JEMBATAN LIMA,21021,4437,16584,13666,30250,2021-12-10
3173081005,JAKARTA BARAT,KEMBANGAN,JOGLO,40839,7730,33109,28933,62042,2021-12-10
3171081001,JAKARTA PUSAT,JOHAR BARU,JOHAR BARU,37488,6588,30900,26861,57761,2021-12-10
3173041002,JAKARTA BARAT,TAMBORA,KALI ANYAR,23856,4447,19409,16031,35440,2021-12-10
3172041004,JAKARTA UTARA,CILINCING,KALIBARU,67684,17252,50432,37513,87945,2021-12-10
3174081002,JAKARTA SELATAN,PANCORAN,KALIBATA,41994,8922,33072,28126,61198,2021-12-10
3173061001,JAKARTA BARAT,KALI DERES,KALIDERES,72447,13655,58792,51492,110284,2021-12-10
3175051004,JAKARTA TIMUR,PASAR REBO,KALISARI,43212,7182,36030,31564,67594,2021-12-10
3173061004,JAKARTA BARAT,KALI DERES,KAMAL,53783,11646,42137,35088,77225,2021-12-10
3172011002,JAKARTA UTARA,PENJARINGAN,KAMAL MUARA,12930,2224,10706,9260,19966,2021-12-10
3171071007,JAKARTA PUSAT,TANAH ABANG,KAMPUNG BALI,11358,2320,9038,7329,16367,2021-12-10
3175031001,JAKARTA TIMUR,JATINEGARA,KAMPUNG MELAYU,25717,5560,20157,16494,36651,2021-12-10
3171081002,JAKARTA PUSAT,JOHAR BARU,KAMPUNG RAWA,21237,3319,17918,14723,32641,2021-12-10
3175041002,JAKARTA TIMUR,KRAMAT JATI,KAMPUNG TENGAH,43993,10230,33763,28074,61837,2021-12-10
3173011005,JAKARTA BARAT,CENGKARENG,KAPUK,134466,30272,104194,87694,191888,2021-12-10
3172011003,JAKARTA UTARA,PENJARINGAN,KAPUK MUARA,35781,6505,29276,26458,55734,2021-12-10
3171021002,JAKARTA PUSAT,SAWAH BESAR,KARANG ANYAR,25761,4574,21187,18341,39528,2021-12-10
3174021004,JAKARTA SELATAN,SETIA BUDI,KARET,9623,1764,7859,6839,14698,2021-12-10
3174021003,JAKARTA SELATAN,SETIA BUDI,KARET KUNINGAN,16055,2966,13089,11495,24584,2021-12-10
3174021002,JAKARTA SELATAN,SETIA BUDI,KARET SEMANGGI,2770,534,2236,2027,4263,2021-12-10
3171071003,JAKARTA PUSAT,TANAH ABANG,KARET TENGSIN,19271,3535,15736,13420,29156,2021-12-10
3171021003,JAKARTA PUSAT,SAWAH BESAR,KARTINI,22292,3950,18342,16233,34575,2021-12-10
3175011003,JAKARTA TIMUR,MATRAMAN,KAYU MANIS,25284,4958,20326,16968,37294,2021-12-10
3175021006,JAKARTA TIMUR,PULO GADUNG,KAYU PUTIH,40696,7277,33419,30082,63501,2021-12-10
3173031006,JAKARTA BARAT,TAMAN SARI,KEAGUNGAN,17387,3039,14348,12177,26525,2021-12-10
3174041007,JAKARTA SELATAN,PASAR MINGGU,KEBAGUSAN,44552,8246,36306,31449,67755,2021-12-10
3174051006,JAKARTA SELATAN,KEBAYORAN LAMA,KEBAYORAN LAMA SELATAN,41212,7167,34045,30135,64180,2021-12-10
3174051001,JAKARTA SELATAN,KEBAYORAN LAMA,KEBAYORAN LAMA UTARA,42422,8291,34131,29630,63761,2021-12-10
3174011004,JAKARTA SELATAN,TEBET,KEBON BARU,35165,6131,29034,25311,54345,2021-12-10
3172021005,JAKARTA UTARA,TANJUNG PRIOK,KEBON BAWANG,50952,9623,41329,35672,77001,2021-12-10
3173051001,JAKARTA BARAT,KEBON JERUK,KEBON JERUK,53887,10341,43546,37078,80624,2021-12-10
3171071006,JAKARTA PUSAT,TANAH ABANG,KEBON KACANG,21531,4886,16645,13809,30454,2021-12-10
3171011005,JAKARTA PUSAT,GAMBIR,KEBON KELAPA,10163,1943,8220,7190,15410,2021-12-10
3171031002,JAKARTA PUSAT,KEMAYORAN,KEBON KOSONG,30019,5685,24334,20882,45216,2021-12-10
3175011005,JAKARTA TIMUR,MATRAMAN,KEBON MANGGIS,16490,2997,13493,11552,25045,2021-12-10
3171071005,JAKARTA PUSAT,TANAH ABANG,KEBON MELATI,32206,8167,24039,18720,42759,2021-12-10
3175081003,JAKARTA TIMUR,MAKASAR,KEBON PALA,46614,8676,37938,32877,70815,2021-12-10
3171061005,JAKARTA PUSAT,MENTENG,KEBON SIRIH,12299,2467,9832,8260,18092,2021-12-10
3173011004,JAKARTA BARAT,CENGKARENG,KEDAUNG KALI ANGKE,32612,5912,26700,23141,49841,2021-12-10
3173051007,JAKARTA BARAT,KEBON JERUK,KEDOYA SELATAN,32165,5580,26585,22772,49357,2021-12-10
3173051006,JAKARTA BARAT,KEBON JERUK,KEDOYA UTARA,45740,8318,37422,32466,69888,2021-12-10
3173051004,JAKARTA BARAT,KEBON JERUK,KELAPA DUA,23565,4356,19209,16637,35846,2021-12-10
3175091003,JAKARTA TIMUR,CIRACAS,KELAPA DUA WETAN,46875,7590,39285,34411,73696,2021-12-10
3172061003,JAKARTA UTARA,KELAPA GADING,KELAPA GADING BARAT,35717,5934,29783,27427,57210,2021-12-10
3172061001,JAKARTA UTARA,KELAPA GADING,KELAPA GADING TIMUR,33592,4892,28700,27094,55794,2021-12-10
3173071005,JAKARTA BARAT,PALMERAH,KEMANGGISAN,32139,5733,26406,23262,49668,2021-12-10
3171031001,JAKARTA PUSAT,KEMAYORAN,KEMAYORAN,20708,3880,16828,14401,31229,2021-12-10
3173081006,JAKARTA BARAT,KEMBANGAN,KEMBANGAN SELATAN,27130,5369,21761,19227,40988,2021-12-10
3173081001,JAKARTA BARAT,KEMBANGAN,KEMBANGAN UTARA,54451,10987,43464,37230,80694,2021-12-10
3171041002,JAKARTA PUSAT,SENEN,KENARI,9579,1783,7796,6832,14628,2021-12-10
3173041005,JAKARTA BARAT,TAMBORA,KERENDANG,19973,3833,16140,13698,29838,2021-12-10
3175071003,JAKARTA TIMUR,DUREN SAWIT,KLENDER,69978,15400,54578,45564,100142,2021-12-10
3172031001,JAKARTA UTARA,KOJA,KOJA,28175,6042,22133,18565,40698,2021-12-10
3173071006,JAKARTA BARAT,PALMERAH,KOTA BAMBU SELATAN,21158,3919,17239,14232,31471,2021-12-10
3173071003,JAKARTA BARAT,PALMERAH,KOTA BAMBU UTARA,24995,4790,20205,16523,36728,2021-12-10
3171041004,JAKARTA PUSAT,SENEN,KRAMAT,28835,6063,22772,17775,40547,2021-12-10
3175041001,JAKARTA TIMUR,KRAMAT JATI,KRAMAT JATI,34144,6768,27376,23066,50442,2021-12-10
3174071003,JAKARTA SELATAN,KEBAYORAN BARU,KRAMAT PELA,14413,2646,11767,10457,22224,2021-12-10
3173031002,JAKARTA BARAT,TAMAN SARI,KRUKUT,19244,3447,15797,13336,29133,2021-12-10
3174031005,JAKARTA SELATAN,MAMPANG PRAPATAN,KUNINGAN BARAT,12785,2179,10606,9235,19841,2021-12-10
3174021008,JAKARTA SELATAN,SETIA BUDI,KUNINGAN TIMUR,6008,1137,4871,4341,9212,2021-12-10
3171041005,JAKARTA PUSAT,SENEN,KWITANG,15486,3153,12333,10252,22585,2021-12-10
3172031003,JAKARTA UTARA,KOJA,LAGOA,59065,13018,46047,38025,84072,2021-12-10
3174061002,JAKARTA SELATAN,CILANDAK,LEBAK BULUS,37626,6695,30931,28149,59080,2021-12-10
3174091004,JAKARTA SELATAN,JAGAKARSA,LENTENG AGUNG,53946,9030,44916,38500,83416,2021-12-10
3175101007,JAKARTA TIMUR,CIPAYUNG,LUBANG BUAYA,63547,11304,52243,45082,97325,2021-12-10
3175081001,JAKARTA TIMUR,MAKASAR,MAKASAR,34390,5790,28600,25214,53814,2021-12-10
3175071006,JAKARTA TIMUR,DUREN SAWIT,MALAKA JAYA,30927,4900,26027,23295,49322,2021-12-10
3175071005,JAKARTA TIMUR,DUREN SAWIT,MALAKA SARI,27530,4280,23250,20974,44224,2021-12-10
3174031001,JAKARTA SELATAN,MAMPANG PRAPATAN,MAMPANG PRAPATAN,18159,3497,14662,12587,27249,2021-12-10
3173031005,JAKARTA BARAT,TAMAN SARI,MANGGA BESAR,7707,1245,6462,5844,12306,2021-12-10
3171021005,JAKARTA PUSAT,SAWAH BESAR,MANGGA DUA SELATAN,27442,5227,22215,19299,41514,2021-12-10
3174011007,JAKARTA SELATAN,TEBET,MANGGARAI,28373,4667,23706,20176,43882,2021-12-10
3174011006,JAKARTA SELATAN,TEBET,MANGGARAI SELATAN,23075,3471,19604,17092,36696,2021-12-10
3173031003,JAKARTA BARAT,TAMAN SARI,MAPHAR,16461,2911,13550,11722,25272,2021-12-10
3172041003,JAKARTA UTARA,CILINCING,MARUNDA,28943,6147,22796,17852,40648,2021-12-10
3174071001,JAKARTA SELATAN,KEBAYORAN BARU,MELAWAI,2627,491,2136,2009,4145,2021-12-10
3171061001,JAKARTA PUSAT,MENTENG,MENTENG,25624,5258,20366,16873,37239,2021-12-10
3174021005,JAKARTA SELATAN,SETIA BUDI,MENTENG ATAS,27816,4688,23128,20089,43217,2021-12-10
3174011003,JAKARTA SELATAN,TEBET,MENTENG DALAM,36028,6594,29434,25902,55336,2021-12-10
3173081003,JAKARTA BARAT,KEMBANGAN,MERUYA SELATAN,32130,6196,25934,22703,48637,2021-12-10
3173081002,JAKARTA BARAT,KEMBANGAN,MERUYA UTARA,43752,8494,35258,31610,66868,2021-12-10
3175101004,JAKARTA TIMUR,CIPAYUNG,MUNJUL,23871,4147,19724,17272,36996,2021-12-10
3172051002,JAKARTA UTARA,PADEMANGAN,PADEMANGAN BARAT,74240,16427,57813,48409,106222,2021-12-10
3172051001,JAKARTA UTARA,PADEMANGAN,PADEMANGAN TIMUR,37736,6291,31445,28543,59988,2021-12-10
3175011004,JAKARTA TIMUR,MATRAMAN,PAL MERIAM,19769,3746,16023,13456,29479,2021-12-10
3173071001,JAKARTA BARAT,PALMERAH,PALMERAH,63011,12347,50664,43041,93705,2021-12-10
3174081001,JAKARTA SELATAN,PANCORAN,PANCORAN,19421,3614,15807,13659,29466,2021-12-10
3172021003,JAKARTA UTARA,TANJUNG PRIOK,PAPANGGO,39097,7230,31867,27192,59059,2021-12-10
3171021001,JAKARTA PUSAT,SAWAH BESAR,PASAR BARU,12035,2180,9855,9017,18872,2021-12-10
3174021006,JAKARTA SELATAN,SETIA BUDI,PASAR MANGGIS,26752,4763,21989,18969,40958,2021-12-10
3174041001,JAKARTA SELATAN,PASAR MINGGU,PASAR MINGGU,24821,4410,20411,18106,38517,2021-12-10
3171041003,JAKARTA PUSAT,SENEN,PASEBAN,23533,4609,18924,16050,34974,2021-12-10
3173061005,JAKARTA BARAT,KALI DERES,PEGADUNGAN,75587,13860,61727,54395,116122,2021-12-10
3171061002,JAKARTA PUSAT,MENTENG,PEGANGSAAN,23455,4746,18709,15188,33897,2021-12-10
3172061002,JAKARTA UTARA,KELAPA GADING,PEGANGSAAN DUA,49976,7895,42081,38861,80942,2021-12-10
3172011004,JAKARTA UTARA,PENJARINGAN,PEJAGALAN,74578,14572,60006,53598,113604,2021-12-10
3174041006,JAKARTA SELATAN,PASAR MINGGU,PEJATEN BARAT,37346,6724,30622,26919,57541,2021-12-10
3174041005,JAKARTA SELATAN,PASAR MINGGU,PEJATEN TIMUR,57656,11603,46053,38914,84967,2021-12-10
3175051005,JAKARTA TIMUR,PASAR REBO,PEKAYON,43250,7343,35907,31168,67075,2021-12-10
3173041009,JAKARTA BARAT,TAMBORA,PEKOJAN,23587,4244,19343,16886,36229,2021-12-10
3174031003,JAKARTA SELATAN,MAMPANG PRAPATAN,PELA MAMPANG,43522,8063,35459,31069,66528,2021-12-10
3174081005,JAKARTA SELATAN,PANCORAN,PENGADEGAN,21478,3718,17760,15689,33449,2021-12-10
3175061003,JAKARTA TIMUR,CAKUNG,PENGGILINGAN,99255,21245,78010,64951,142961,2021-12-10
3172011001,JAKARTA UTARA,PENJARINGAN,PENJARINGAN,88308,21392,66916,54210,121126,2021-12-10
3174101001,JAKARTA SELATAN,PESANGGRAHAN,PESANGGRAHAN,27545,4478,23067,20465,43532,2021-12-10
3171071004,JAKARTA PUSAT,TANAH ABANG,PETAMBURAN,33271,8308,24963,19926,44889,2021-12-10
3174071008,JAKARTA SELATAN,KEBAYORAN BARU,PETOGOGAN,11499,2084,9415,8313,17728,2021-12-10
3171011004,JAKARTA PUSAT,GAMBIR,PETOJO SELATAN,14692,3132,11560,10121,21681,2021-12-10
3171011003,JAKARTA PUSAT,GAMBIR,PETOJO UTARA,17458,3561,13897,11796,25693,2021-12-10
3174101004,JAKARTA SELATAN,PESANGGRAHAN,PETUKANGAN SELATAN,37187,7235,29952,26288,56240,2021-12-10
3174101003,JAKARTA SELATAN,PESANGGRAHAN,PETUKANGAN UTARA,53716,10814,42902,37200,80102,2021-12-10
3175081002,JAKARTA TIMUR,MAKASAR,PINANG RANTI,27198,5583,21615,18543,40158,2021-12-10
3173031008,JAKARTA BARAT,TAMAN SARI,PINANGSIA,10729,1777,8952,7657,16609,2021-12-10
3175011001,JAKARTA TIMUR,MATRAMAN,PISANGAN BARU,31776,6130,25646,21415,47061,2021-12-10
3175021002,JAKARTA TIMUR,PULO GADUNG,PISANGAN TIMUR,41011,7100,33911,29873,63784,2021-12-10
3172011005,JAKARTA UTARA,PENJARINGAN,PLUIT,47783,8894,38889,34955,73844,2021-12-10
3175071002,JAKARTA TIMUR,DUREN SAWIT,PONDOK BAMBU,61550,12186,49364,43088,92452,2021-12-10
3175071004,JAKARTA TIMUR,DUREN SAWIT,PONDOK KELAPA,72015,13533,58482,51953,110435,2021-12-10
3175071007,JAKARTA TIMUR,DUREN SAWIT,PONDOK KOPI,35367,6284,29083,24658,53741,2021-12-10
3174061003,JAKARTA SELATAN,CILANDAK,PONDOK LABU,46464,7209,39255,35565,74820,2021-12-10
3174051002,JAKARTA SELATAN,KEBAYORAN LAMA,PONDOK PINANG,56169,10235,45934,40877,86811,2021-12-10
3175101003,JAKARTA TIMUR,CIPAYUNG,PONDOK RANGGON,25574,4551,21023,18489,39512,2021-12-10
3101011003,KAB.ADM.KEP.SERIBU,KEP. SERIBU UTARA,PULAU HARAPAN,2060,195,1865,1669,3534,2021-12-10
3101011002,KAB.ADM.KEP.SERIBU,KEP. SERIBU UTARA,PULAU KELAPA,5528,552,4976,4250,9226,2021-12-10
3101011001,KAB.ADM.KEP.SERIBU,KEP. SERIBU UTARA,PULAU PANGGANG,5450,419,5031,4567,9598,2021-12-10
3101021003,KAB.ADM.KEP.SERIBU,KEP. SERIBU SELATAN,PULAU PARI,2765,191,2574,2442,5016,2021-12-10
3101021002,KAB.ADM.KEP.SERIBU,KEP. SERIBU SELATAN,PULAU TIDUNG,4553,351,4202,3917,8119,2021-12-10
3101021001,KAB.ADM.KEP.SERIBU,KEP. SERIBU SELATAN,PULAU UNTUNG JAWA,1941,154,1787,1664,3451,2021-12-10
3174071007,JAKARTA SELATAN,KEBAYORAN BARU,PULO,5835,970,4865,4583,9448,2021-12-10
3175021001,JAKARTA TIMUR,PULO GADUNG,PULO GADUNG,34422,7109,27313,23638,50951,2021-12-10
3175061005,JAKARTA TIMUR,CAKUNG,PULO GEBANG,97301,17642,79659,67576,147235,2021-12-10
3174041004,JAKARTA SELATAN,PASAR MINGGU,RAGUNAN,39616,6578,33038,29260,62298,2021-12-10
3175091005,JAKARTA TIMUR,CIRACAS,RAMBUTAN,36771,8151,28620,24172,52792,2021-12-10
3172031006,JAKARTA UTARA,KOJA,RAWA BADAK SELATAN,42179,9353,32826,27021,59847,2021-12-10
3172031004,JAKARTA UTARA,KOJA,RAWA BADAK UTARA,34408,7244,27164,22977,50141,2021-12-10
3174071005,JAKARTA SELATAN,KEBAYORAN BARU,RAWA BARAT,5625,961,4664,4246,8910,2021-12-10
3173011003,JAKARTA BARAT,CENGKARENG,RAWA BUAYA,63799,11831,51968,44746,96714,2021-12-10
3175031004,JAKARTA TIMUR,JATINEGARA,RAWA BUNGA,21434,4766,16668,14125,30793,2021-12-10
3174081003,JAKARTA SELATAN,PANCORAN,RAWA JATI,20509,3688,16821,14892,31713,2021-12-10
3175061002,JAKARTA TIMUR,CAKUNG,RAWA TERATE,24637,4179,20458,17317,37775,2021-12-10
3175021005,JAKARTA TIMUR,PULO GADUNG,RAWAMANGUN,37612,6973,30639,27002,57641,2021-12-10
3171051003,JAKARTA PUSAT,CEMPAKA PUTIH,RAWASARI,21967,4182,17785,15770,33555,2021-12-10
3173041010,JAKARTA BARAT,TAMBORA,ROA MALAKA,3484,591,2893,2651,5544,2021-12-10
3172041006,JAKARTA UTARA,CILINCING,ROROTAN,41668,7903,33765,28395,62160,2021-12-10
3174071004,JAKARTA SELATAN,KEBAYORAN BARU,SELONG,2842,529,2313,2176,4489,2021-12-10
3173061002,JAKARTA BARAT,KALI DERES,SEMANAN,71354,14013,57341,47933,105274,2021-12-10
3172041007,JAKARTA UTARA,CILINCING,SEMPER BARAT,68587,12593,55994,48342,104336,2021-12-10
3172041005,JAKARTA UTARA,CILINCING,SEMPER TIMUR,36267,7277,28990,24406,53396,2021-12-10
3174071006,JAKARTA SELATAN,KEBAYORAN BARU,SENAYAN,2771,629,2142,1920,4062,2021-12-10
3171041001,JAKARTA PUSAT,SENEN,SENEN,6804,1363,5441,4656,10097,2021-12-10
3171031004,JAKARTA PUSAT,KEMAYORAN,SERDANG,29668,5327,24341,21148,45489,2021-12-10
3174021001,JAKARTA SELATAN,SETIA BUDI,SETIA BUDI,3023,580,2443,2166,4609,2021-12-10
3175101005,JAKARTA TIMUR,CIPAYUNG,SETU,20572,3881,16691,14274,30965,2021-12-10
3173071002,JAKARTA BARAT,PALMERAH,SLIPI,16591,2806,13785,12137,25922,2021-12-10
3173081004,JAKARTA BARAT,KEMBANGAN,SRENGSENG,45523,9534,35989,31362,67351,2021-12-10
3174091002,JAKARTA SELATAN,JAGAKARSA,SRENGSENG SAWAH,58196,8320,49876,44537,94413,2021-12-10
3173051003,JAKARTA BARAT,KEBON JERUK,SUKABUMI SELATAN,37033,7298,29735,23964,53699,2021-12-10
3173051002,JAKARTA BARAT,KEBON JERUK,SUKABUMI UTARA,38290,8022,30268,24561,54829,2021-12-10
3172041002,JAKARTA UTARA,CILINCING,SUKAPURA,53949,11461,42488,36274,78762,2021-12-10
3171031007,JAKARTA PUSAT,KEMAYORAN,SUMUR BATU,22717,4028,18689,16610,35299,2021-12-10
3172021004,JAKARTA UTARA,TANJUNG PRIOK,SUNGAI BAMBU,29876,5587,24289,20910,45199,2021-12-10
3172021006,JAKARTA UTARA,TANJUNG PRIOK,SUNTER AGUNG,71805,11743,60062,54275,114337,2021-12-10
3172021002,JAKARTA UTARA,TANJUNG PRIOK,SUNTER JAYA,63031,10448,52583,47163,99746,2021-12-10
3175091004,JAKARTA TIMUR,CIRACAS,SUSUKAN,38257,6810,31447,27119,58566,2021-12-10
3173031001,JAKARTA BARAT,TAMAN SARI,TAMAN SARI,14348,2483,11865,10511,22376,2021-12-10
3173041001,JAKARTA BARAT,TAMBORA,TAMBORA,10204,2066,8138,6815,14953,2021-12-10
3173041004,JAKARTA BARAT,TAMBORA,TANAH SEREAL,26387,4217,22170,19126,41296,2021-12-10
3171081004,JAKARTA PUSAT,JOHAR BARU,TANAH TINGGI,37693,6855,30838,25756,56594,2021-12-10
3173031004,JAKARTA BARAT,TAMAN SARI,TANGKI,13324,2109,11215,9849,21064,2021-12-10
3174091005,JAKARTA SELATAN,JAGAKARSA,TANJUNG BARAT,39770,6349,33421,28978,62399,2021-12-10
3173021005,JAKARTA BARAT,GROGOL PETAMBURAN,TANJUNG DUREN SELATAN,25337,4572,20765,18964,39729,2021-12-10
3173021002,JAKARTA BARAT,GROGOL PETAMBURAN,TANJUNG DUREN UTARA,17010,2711,14299,13195,27494,2021-12-10
3172021001,JAKARTA UTARA,TANJUNG PRIOK,TANJUNG PRIOK,34588,6745,27843,23517,51360,2021-12-10
3174011002,JAKARTA SELATAN,TEBET,TEBET BARAT,21194,3189,18005,16409,34414,2021-12-10
3174011001,JAKARTA SELATAN,TEBET,TEBET TIMUR,18199,2764,15435,14368,29803,2021-12-10
3173061003,JAKARTA BARAT,KALI DERES,TEGAL ALUR,83647,16328,67319,57597,124916,2021-12-10
3174031004,JAKARTA SELATAN,MAMPANG PRAPATAN,TEGAL PARANG,32401,6707,25694,21062,46756,2021-12-10
3173021003,JAKARTA BARAT,GROGOL PETAMBURAN,TOMANG,29605,5132,24473,21812,46285,2021-12-10
3172031005,JAKARTA UTARA,KOJA,TUGU SELATAN,39122,8144,30978,26071,57049,2021-12-10
3172031002,JAKARTA UTARA,KOJA,TUGU UTARA,67670,15129,52541,43457,95998,2021-12-10
3175061006,JAKARTA TIMUR,CAKUNG,UJUNG MENTENG,29934,4874,25060,22064,47124,2021-12-10
3174101005,JAKARTA SELATAN,PESANGGRAHAN,ULUJAMI,40544,8327,32217,27674,59891,2021-12-10
3175011006,JAKARTA TIMUR,MATRAMAN,UTAN KAYU SELATAN,33511,5628,27883,24084,51967,2021-12-10
3175011002,JAKARTA TIMUR,MATRAMAN,UTAN KAYU UTARA,28169,5352,22817,19365,42182,2021-12-10
3171031008,JAKARTA PUSAT,KEMAYORAN,UTAN PANJANG,29208,5425,23783,20072,43855,2021-12-10
3172021007,JAKARTA UTARA,TANJUNG PRIOK,WARAKAS,44401,7700,36701,30887,67588,2021-12-10
3173021007,JAKARTA BARAT,GROGOL PETAMBURAN,WIJAYA KUSUMA,38934,7575,31359,27342,58701,2021-12-10
3172051003,JAKARTA UTARA,PADEMANGAN,ANCOL,23947,5447,18500,15650,34150,2021-12-11
3173041007,JAKARTA BARAT,TAMBORA,ANGKE,29381,5830,23551,19724,43275,2021-12-11
3175041005,JAKARTA TIMUR,KRAMAT JATI,BALE KAMBANG,29074,6641,22433,18417,40850,2021-12-11
3175031003,JAKARTA TIMUR,JATINEGARA,BALI MESTER,9752,1872,7880,6877,14757,2021-12-11
3175101006,JAKARTA TIMUR,CIPAYUNG,BAMBU APUS,26285,4533,21752,18975,40727,2021-12-11
3174031002,JAKARTA SELATAN,MAMPANG PRAPATAN,BANGKA,21566,4280,17286,14903,32189,2021-12-11
3175051002,JAKARTA TIMUR,PASAR REBO,BARU,23886,3702,20184,18007,38191,2021-12-11
3175041004,JAKARTA TIMUR,KRAMAT JATI,BATU AMPAR,47898,10786,37112,31218,68330,2021-12-11
3171071002,JAKARTA PUSAT,TANAH ABANG,BENDUNGAN HILIR,21494,4108,17386,15316,32702,2021-12-11
3175031002,JAKARTA TIMUR,JATINEGARA,BIDARA CINA,36689,8283,28406,24097,52503,2021-12-11
3174101002,JAKARTA SELATAN,PESANGGRAHAN,BINTARO,53098,10083,43015,38697,81712,2021-12-11
3174011005,JAKARTA SELATAN,TEBET,BUKIT DURI,34183,6424,27759,24026,51785,2021-12-11
3171041006,JAKARTA PUSAT,SENEN,BUNGUR,18144,3568,14576,12504,27080,2021-12-11
3175061007,JAKARTA TIMUR,CAKUNG,CAKUNG BARAT,57724,11088,46636,39525,86161,2021-12-11
3175061004,JAKARTA TIMUR,CAKUNG,CAKUNG TIMUR,58287,10780,47507,40828,88335,2021-12-11
3175041007,JAKARTA TIMUR,KRAMAT JATI,CAWANG,32762,6499,26263,22159,48422,2021-12-11
3175101008,JAKARTA TIMUR,CIPAYUNG,CEGER,18932,3455,15477,13410,28887,2021-12-11
3171031006,JAKARTA PUSAT,KEMAYORAN,CEMPAKA BARU,32581,5772,26809,22950,49759,2021-12-11
3171051002,JAKARTA PUSAT,CEMPAKA PUTIH,CEMPAKA PUTIH BARAT,35885,7061,28824,25443,54267,2021-12-11
3171051001,JAKARTA PUSAT,CEMPAKA PUTIH,CEMPAKA PUTIH TIMUR,24292,4735,19557,17711,37268,2021-12-11
3173011001,JAKARTA BARAT,CENGKARENG,CENGKARENG BARAT,66284,12345,53939,47935,101874,2021-12-11
3173011006,JAKARTA BARAT,CENGKARENG,CENGKARENG TIMUR,81027,14995,66032,57122,123154,2021-12-11
3175091002,JAKARTA TIMUR,CIRACAS,CIBUBUR,66364,10764,55600,48932,104532,2021-12-11
3171011002,JAKARTA PUSAT,GAMBIR,CIDENG,15390,2876,12514,11194,23708,2021-12-11
3174091003,JAKARTA SELATAN,JAGAKARSA,CIGANJUR,38497,6044,32453,28397,60850,2021-12-11
3175051003,JAKARTA TIMUR,PASAR REBO,CIJANTUNG,41419,7197,34222,29777,63999,2021-12-11
3171061003,JAKARTA PUSAT,MENTENG,CIKINI,8274,1411,6863,5702,12565,2021-12-11
3174081006,JAKARTA SELATAN,PANCORAN,CIKOKO,10547,1717,8830,7883,16713,2021-12-11
3174061001,JAKARTA SELATAN,CILANDAK,CILANDAK BARAT,51752,8605,43147,39091,82238,2021-12-11
3174041003,JAKARTA SELATAN,PASAR MINGGU,CILANDAK TIMUR,25145,4266,20879,18494,39373,2021-12-11
3175101002,JAKARTA TIMUR,CIPAYUNG,CILANGKAP,27635,4612,23023,20309,43332,2021-12-11
3175041006,JAKARTA TIMUR,KRAMAT JATI,CILILITAN,40181,7872,32309,27339,59648,2021-12-11
3172041001,JAKARTA UTARA,CILINCING,CILINCING,43609,9687,33922,27545,61467,2021-12-11
3175101001,JAKARTA TIMUR,CIPAYUNG,CIPAYUNG,26104,4283,21821,19360,41181,2021-12-11
3174091006,JAKARTA SELATAN,JAGAKARSA,CIPEDAK,38303,5956,32347,28498,60845,2021-12-11
3174061005,JAKARTA SELATAN,CILANDAK,CIPETE SELATAN,26704,4781,21923,19923,41846,2021-12-11
3174071010,JAKARTA SELATAN,KEBAYORAN BARU,CIPETE UTARA,34102,6116,27986,24426,52412,2021-12-11
3175021003,JAKARTA TIMUR,PULO GADUNG,CIPINANG,39306,6642,32664,28351,61015,2021-12-11
3175031007,JAKARTA TIMUR,JATINEGARA,CIPINANG BESAR SELATAN,35212,7826,27386,22849,50235,2021-12-11
3175031008,JAKARTA TIMUR,JATINEGARA,CIPINANG BESAR UTARA,45319,9939,35380,29116,64496,2021-12-11
3175031005,JAKARTA TIMUR,JATINEGARA,CIPINANG CEMPEDAK,32824,6729,26095,23104,49199,2021-12-11
3175081005,JAKARTA TIMUR,MAKASAR,CIPINANG MELAYU,42308,7644,34664,30575,65239,2021-12-11
3175031006,JAKARTA TIMUR,JATINEGARA,CIPINANG MUARA,55243,11006,44237,37839,82076,2021-12-11
3174051003,JAKARTA SELATAN,KEBAYORAN LAMA,CIPULIR,39937,7925,32012,27391,59403,2021-12-11
3175091001,JAKARTA TIMUR,CIRACAS,CIRACAS,64594,11215,53379,45865,99244,2021-12-11
3175041003,JAKARTA TIMUR,KRAMAT JATI,DUKUH,24609,4268,20341,17411,37752,2021-12-11
3175071001,JAKARTA TIMUR,DUREN SAWIT,DUREN SAWIT,61160,12145,49015,42667,91682,2021-12-11
3174081004,JAKARTA SELATAN,PANCORAN,DUREN TIGA,28319,5254,23065,19974,43039,2021-12-11
3173051005,JAKARTA BARAT,KEBON JERUK,DURI KEPA,60138,11217,48921,43411,92332,2021-12-11
3173011002,JAKARTA BARAT,CENGKARENG,DURI KOSAMBI,77923,15419,62504,52408,114912,2021-12-11
3171011006,JAKARTA PUSAT,GAMBIR,DURI PULO,19610,3895,15715,13080,28795,2021-12-11
3173041011,JAKARTA BARAT,TAMBORA,DURI SELATAN,14259,2381,11878,10351,22229,2021-12-11
3173041003,JAKARTA BARAT,TAMBORA,DURI UTARA,19844,3349,16495,14070,30565,2021-12-11
3171081003,JAKARTA PUSAT,JOHAR BARU,GALUR,18243,3359,14884,12380,27264,2021-12-11
3171011001,JAKARTA PUSAT,GAMBIR,GAMBIR,2191,435,1756,1550,3306,2021-12-11
3174061004,JAKARTA SELATAN,CILANDAK,GANDARIA SELATAN,22119,3962,18157,16072,34229,2021-12-11
3174071009,JAKARTA SELATAN,KEBAYORAN BARU,GANDARIA UTARA,39922,7416,32506,28666,61172,2021-12-11
3175051001,JAKARTA TIMUR,PASAR REBO,GEDONG,35755,6725,29030,25419,54449,2021-12-11
3171071001,JAKARTA PUSAT,TANAH ABANG,GELORA,3127,584,2543,2284,4827,2021-12-11
3173031007,JAKARTA BARAT,TAMAN SARI,GLODOK,7837,1121,6716,6228,12944,2021-12-11
3171061004,JAKARTA PUSAT,MENTENG,GONDANGDIA,4100,887,3213,2996,6209,2021-12-11
3173021001,JAKARTA BARAT,GROGOL PETAMBURAN,GROGOL,16876,3130,13746,12026,25772,2021-12-11
3174051005,JAKARTA SELATAN,KEBAYORAN LAMA,GROGOL SELATAN,44251,8298,35953,31034,66987,2021-12-11
3174051004,JAKARTA SELATAN,KEBAYORAN LAMA,GROGOL UTARA,42494,8195,34299,29658,63957,2021-12-11
3174021007,JAKARTA SELATAN,SETIA BUDI,GUNTUR,3985,714,3271,2993,6264,2021-12-11
3174071002,JAKARTA SELATAN,KEBAYORAN BARU,GUNUNG,9436,1675,7761,7081,14842,2021-12-11
3171031005,JAKARTA PUSAT,KEMAYORAN,GUNUNG SAHARI SELATAN,19199,3496,15703,13708,29411,2021-12-11
3171021004,JAKARTA PUSAT,SAWAH BESAR,GUNUNG SAHARI UTARA,16650,2772,13878,12655,26533,2021-12-11
3175081004,JAKARTA TIMUR,MAKASAR,HALIM PERDANA KUSUMAH,28363,3416,24947,23231,48178,2021-12-11
3171031003,JAKARTA PUSAT,KEMAYORAN,HARAPAN MULIA,22557,4051,18506,15756,34262,2021-12-11
3174091001,JAKARTA SELATAN,JAGAKARSA,JAGAKARSA,62389,9542,52847,46951,99798,2021-12-11
3175021007,JAKARTA TIMUR,PULO GADUNG,JATI,32757,5770,26987,24296,51283,2021-12-11
3174041002,JAKARTA SELATAN,PASAR MINGGU,JATI PADANG,37502,6663,30839,27039,57878,2021-12-11
3173071004,JAKARTA BARAT,PALMERAH,JATI PULO,28738,5366,23372,19439,42811,2021-12-11
3175061001,JAKARTA TIMUR,CAKUNG,JATINEGARA,84160,16625,67535,57815,125350,2021-12-11
3175021004,JAKARTA TIMUR,PULO GADUNG,JATINEGARA KAUM,24632,4123,20509,17446,37955,2021-12-11
3173021004,JAKARTA BARAT,GROGOL PETAMBURAN,JELAMBAR,30266,5198,25068,22760,47828,2021-12-11
3173021006,JAKARTA BARAT,GROGOL PETAMBURAN,JELAMBAR BARU,38246,6397,31849,28714,60563,2021-12-11
3173041006,JAKARTA BARAT,TAMBORA,JEMBATAN BESI,29314,6634,22680,18504,41184,2021-12-11
3173041008,JAKARTA BARAT,TAMBORA,JEMBATAN LIMA,21021,4420,16601,13678,30279,2021-12-11
3173081005,JAKARTA BARAT,KEMBANGAN,JOGLO,40839,7695,33144,28981,62125,2021-12-11
3171081001,JAKARTA PUSAT,JOHAR BARU,JOHAR BARU,37488,6571,30917,26888,57805,2021-12-11
3173041002,JAKARTA BARAT,TAMBORA,KALI ANYAR,23856,4441,19415,16054,35469,2021-12-11
3172041004,JAKARTA UTARA,CILINCING,KALIBARU,67684,17176,50508,37638,88146,2021-12-11
3174081002,JAKARTA SELATAN,PANCORAN,KALIBATA,41994,8866,33128,28178,61306,2021-12-11
3173061001,JAKARTA BARAT,KALI DERES,KALIDERES,72447,13610,58837,51548,110385,2021-12-11
3175051004,JAKARTA TIMUR,PASAR REBO,KALISARI,43212,7160,36052,31611,67663,2021-12-11
3173061004,JAKARTA BARAT,KALI DERES,KAMAL,53783,11603,42180,35135,77315,2021-12-11
3172011002,JAKARTA UTARA,PENJARINGAN,KAMAL MUARA,12930,2220,10710,9260,19970,2021-12-11
3171071007,JAKARTA PUSAT,TANAH ABANG,KAMPUNG BALI,11358,2316,9042,7337,16379,2021-12-11
3175031001,JAKARTA TIMUR,JATINEGARA,KAMPUNG MELAYU,25717,5548,20169,16521,36690,2021-12-11
3171081002,JAKARTA PUSAT,JOHAR BARU,KAMPUNG RAWA,21237,3312,17925,14736,32661,2021-12-11
3175041002,JAKARTA TIMUR,KRAMAT JATI,KAMPUNG TENGAH,43993,10215,33778,28134,61912,2021-12-11
3173011005,JAKARTA BARAT,CENGKARENG,KAPUK,134466,30188,104278,87808,192086,2021-12-11
3172011003,JAKARTA UTARA,PENJARINGAN,KAPUK MUARA,35781,6495,29286,26495,55781,2021-12-11
3171021002,JAKARTA PUSAT,SAWAH BESAR,KARANG ANYAR,25761,4554,21207,18351,39558,2021-12-11
3174021004,JAKARTA SELATAN,SETIA BUDI,KARET,9623,1756,7867,6846,14713,2021-12-11
3174021003,JAKARTA SELATAN,SETIA BUDI,KARET KUNINGAN,16055,2953,13102,11513,24615,2021-12-11
3174021002,JAKARTA SELATAN,SETIA BUDI,KARET SEMANGGI,2770,532,2238,2029,4267,2021-12-11
3171071003,JAKARTA PUSAT,TANAH ABANG,KARET TENGSIN,19271,3528,15743,13435,29178,2021-12-11
3171021003,JAKARTA PUSAT,SAWAH BESAR,KARTINI,22292,3934,18358,16254,34612,2021-12-11
3175011003,JAKARTA TIMUR,MATRAMAN,KAYU MANIS,25284,4935,20349,17002,37351,2021-12-11
3175021006,JAKARTA TIMUR,PULO GADUNG,KAYU PUTIH,40696,7260,33436,30106,63542,2021-12-11
3173031006,JAKARTA BARAT,TAMAN SARI,KEAGUNGAN,17387,3035,14352,12186,26538,2021-12-11
3174041007,JAKARTA SELATAN,PASAR MINGGU,KEBAGUSAN,44552,8222,36330,31506,67836,2021-12-11
3174051006,JAKARTA SELATAN,KEBAYORAN LAMA,KEBAYORAN LAMA SELATAN,41212,7153,34059,30174,64233,2021-12-11
3174051001,JAKARTA SELATAN,KEBAYORAN LAMA,KEBAYORAN LAMA UTARA,42422,8276,34146,29655,63801,2021-12-11
3174011004,JAKARTA SELATAN,TEBET,KEBON BARU,35165,6103,29062,25363,54425,2021-12-11
3172021005,JAKARTA UTARA,TANJUNG PRIOK,KEBON BAWANG,50952,9602,41350,35715,77065,2021-12-11
3173051001,JAKARTA BARAT,KEBON JERUK,KEBON JERUK,53887,10319,43568,37151,80719,2021-12-11
3171071006,JAKARTA PUSAT,TANAH ABANG,KEBON KACANG,21531,4876,16655,13831,30486,2021-12-11
3171011005,JAKARTA PUSAT,GAMBIR,KEBON KELAPA,10163,1943,8220,7193,15413,2021-12-11
3171031002,JAKARTA PUSAT,KEMAYORAN,KEBON KOSONG,30019,5676,24343,20911,45254,2021-12-11
3175011005,JAKARTA TIMUR,MATRAMAN,KEBON MANGGIS,16490,2982,13508,11576,25084,2021-12-11
3171071005,JAKARTA PUSAT,TANAH ABANG,KEBON MELATI,32206,8142,24064,18777,42841,2021-12-11
3175081003,JAKARTA TIMUR,MAKASAR,KEBON PALA,46614,8643,37971,32930,70901,2021-12-11
3171061005,JAKARTA PUSAT,MENTENG,KEBON SIRIH,12299,2463,9836,8265,18101,2021-12-11
3173011004,JAKARTA BARAT,CENGKARENG,KEDAUNG KALI ANGKE,32612,5894,26718,23170,49888,2021-12-11
3173051007,JAKARTA BARAT,KEBON JERUK,KEDOYA SELATAN,32165,5557,26608,22817,49425,2021-12-11
3173051006,JAKARTA BARAT,KEBON JERUK,KEDOYA UTARA,45740,8291,37449,32498,69947,2021-12-11
3173051004,JAKARTA BARAT,KEBON JERUK,KELAPA DUA,23565,4345,19220,16658,35878,2021-12-11
3175091003,JAKARTA TIMUR,CIRACAS,KELAPA DUA WETAN,46875,7554,39321,34468,73789,2021-12-11
3172061003,JAKARTA UTARA,KELAPA GADING,KELAPA GADING BARAT,35717,5920,29797,27442,57239,2021-12-11
3172061001,JAKARTA UTARA,KELAPA GADING,KELAPA GADING TIMUR,33592,4884,28708,27110,55818,2021-12-11
3173071005,JAKARTA BARAT,PALMERAH,KEMANGGISAN,32139,5716,26423,23304,49727,2021-12-11
3171031001,JAKARTA PUSAT,KEMAYORAN,KEMAYORAN,20708,3864,16844,14418,31262,2021-12-11
3173081006,JAKARTA BARAT,KEMBANGAN,KEMBANGAN SELATAN,27130,5361,21769,19240,41009,2021-12-11
3173081001,JAKARTA BARAT,KEMBANGAN,KEMBANGAN UTARA,54451,10957,43494,37267,80761,2021-12-11
3171041002,JAKARTA PUSAT,SENEN,KENARI,9579,1777,7802,6837,14639,2021-12-11
3173041005,JAKARTA BARAT,TAMBORA,KERENDANG,19973,3820,16153,13715,29868,2021-12-11
3175071003,JAKARTA TIMUR,DUREN SAWIT,KLENDER,69978,15331,54647,45647,100294,2021-12-11
3172031001,JAKARTA UTARA,KOJA,KOJA,28175,6000,22175,18602,40777,2021-12-11
3173071006,JAKARTA BARAT,PALMERAH,KOTA BAMBU SELATAN,21158,3903,17255,14247,31502,2021-12-11
3173071003,JAKARTA BARAT,PALMERAH,KOTA BAMBU UTARA,24995,4776,20219,16547,36766,2021-12-11
3171041004,JAKARTA PUSAT,SENEN,KRAMAT,28835,6025,22810,17795,40605,2021-12-11
3175041001,JAKARTA TIMUR,KRAMAT JATI,KRAMAT JATI,34144,6751,27393,23143,50536,2021-12-11
3174071003,JAKARTA SELATAN,KEBAYORAN BARU,KRAMAT PELA,14413,2638,11775,10468,22243,2021-12-11
3173031002,JAKARTA BARAT,TAMAN SARI,KRUKUT,19244,3443,15801,13338,29139,2021-12-11
3174031005,JAKARTA SELATAN,MAMPANG PRAPATAN,KUNINGAN BARAT,12785,2173,10612,9252,19864,2021-12-11
3174021008,JAKARTA SELATAN,SETIA BUDI,KUNINGAN TIMUR,6008,1134,4874,4348,9222,2021-12-11
3171041005,JAKARTA PUSAT,SENEN,KWITANG,15486,3144,12342,10271,22613,2021-12-11
3172031003,JAKARTA UTARA,KOJA,LAGOA,59065,12973,46092,38107,84199,2021-12-11
3174061002,JAKARTA SELATAN,CILANDAK,LEBAK BULUS,37626,6664,30962,28184,59146,2021-12-11
3174091004,JAKARTA SELATAN,JAGAKARSA,LENTENG AGUNG,53946,8967,44979,38730,83709,2021-12-11
3175101007,JAKARTA TIMUR,CIPAYUNG,LUBANG BUAYA,63547,11265,52282,45175,97457,2021-12-11
3175081001,JAKARTA TIMUR,MAKASAR,MAKASAR,34390,5774,28616,25241,53857,2021-12-11
3175071006,JAKARTA TIMUR,DUREN SAWIT,MALAKA JAYA,30927,4858,26069,23339,49408,2021-12-11
3175071005,JAKARTA TIMUR,DUREN SAWIT,MALAKA SARI,27530,4259,23271,21026,44297,2021-12-11
3174031001,JAKARTA SELATAN,MAMPANG PRAPATAN,MAMPANG PRAPATAN,18159,3486,14673,12600,27273,2021-12-11
3173031005,JAKARTA BARAT,TAMAN SARI,MANGGA BESAR,7707,1242,6465,5846,12311,2021-12-11
3171021005,JAKARTA PUSAT,SAWAH BESAR,MANGGA DUA SELATAN,27442,5208,22234,19315,41549,2021-12-11
3174011007,JAKARTA SELATAN,TEBET,MANGGARAI,28373,4654,23719,20190,43909,2021-12-11
3174011006,JAKARTA SELATAN,TEBET,MANGGARAI SELATAN,23075,3463,19612,17104,36716,2021-12-11
3173031003,JAKARTA BARAT,TAMAN SARI,MAPHAR,16461,2904,13557,11734,25291,2021-12-11
3172041003,JAKARTA UTARA,CILINCING,MARUNDA,28943,6137,22806,17870,40676,2021-12-11
3174071001,JAKARTA SELATAN,KEBAYORAN BARU,MELAWAI,2627,490,2137,2010,4147,2021-12-11
3171061001,JAKARTA PUSAT,MENTENG,MENTENG,25624,5239,20385,16900,37285,2021-12-11
3174021005,JAKARTA SELATAN,SETIA BUDI,MENTENG ATAS,27816,4671,23145,20121,43266,2021-12-11
3174011003,JAKARTA SELATAN,TEBET,MENTENG DALAM,36028,6583,29445,25924,55369,2021-12-11
3173081003,JAKARTA BARAT,KEMBANGAN,MERUYA SELATAN,32130,6175,25955,22738,48693,2021-12-11
3173081002,JAKARTA BARAT,KEMBANGAN,MERUYA UTARA,43752,8467,35285,31632,66917,2021-12-11
3175101004,JAKARTA TIMUR,CIPAYUNG,MUNJUL,23871,4133,19738,17294,37032,2021-12-11
3172051002,JAKARTA UTARA,PADEMANGAN,PADEMANGAN BARAT,74240,16377,57863,48479,106342,2021-12-11
3172051001,JAKARTA UTARA,PADEMANGAN,PADEMANGAN TIMUR,37736,6268,31468,28583,60051,2021-12-11
3175011004,JAKARTA TIMUR,MATRAMAN,PAL MERIAM,19769,3729,16040,13490,29530,2021-12-11
3173071001,JAKARTA BARAT,PALMERAH,PALMERAH,63011,12318,50693,43100,93793,2021-12-11
3174081001,JAKARTA SELATAN,PANCORAN,PANCORAN,19421,3605,15816,13680,29496,2021-12-11
3172021003,JAKARTA UTARA,TANJUNG PRIOK,PAPANGGO,39097,7212,31885,27230,59115,2021-12-11
3171021001,JAKARTA PUSAT,SAWAH BESAR,PASAR BARU,12035,2177,9858,9020,18878,2021-12-11
3174021006,JAKARTA SELATAN,SETIA BUDI,PASAR MANGGIS,26752,4754,21998,18985,40983,2021-12-11
3174041001,JAKARTA SELATAN,PASAR MINGGU,PASAR MINGGU,24821,4400,20421,18137,38558,2021-12-11
3171041003,JAKARTA PUSAT,SENEN,PASEBAN,23533,4597,18936,16071,35007,2021-12-11
3173061005,JAKARTA BARAT,KALI DERES,PEGADUNGAN,75587,13828,61759,54452,116211,2021-12-11
3171061002,JAKARTA PUSAT,MENTENG,PEGANGSAAN,23455,4735,18720,15213,33933,2021-12-11
3172061002,JAKARTA UTARA,KELAPA GADING,PEGANGSAAN DUA,49976,7881,42095,38887,80982,2021-12-11
3172011004,JAKARTA UTARA,PENJARINGAN,PEJAGALAN,74578,14543,60035,53662,113697,2021-12-11
3174041006,JAKARTA SELATAN,PASAR MINGGU,PEJATEN BARAT,37346,6706,30640,26967,57607,2021-12-11
3174041005,JAKARTA SELATAN,PASAR MINGGU,PEJATEN TIMUR,57656,11533,46123,38989,85112,2021-12-11
3175051005,JAKARTA TIMUR,PASAR REBO,PEKAYON,43250,7317,35933,31221,67154,2021-12-11
3173041009,JAKARTA BARAT,TAMBORA,PEKOJAN,23587,4238,19349,16904,36253,2021-12-11
3174031003,JAKARTA SELATAN,MAMPANG PRAPATAN,PELA MAMPANG,43522,8046,35476,31117,66593,2021-12-11
3174081005,JAKARTA SELATAN,PANCORAN,PENGADEGAN,21478,3706,17772,15701,33473,2021-12-11
3175061003,JAKARTA TIMUR,CAKUNG,PENGGILINGAN,99255,21160,78095,65082,143177,2021-12-11
3172011001,JAKARTA UTARA,PENJARINGAN,PENJARINGAN,88308,21329,66979,54291,121270,2021-12-11
3174101001,JAKARTA SELATAN,PESANGGRAHAN,PESANGGRAHAN,27545,4469,23076,20483,43559,2021-12-11
3171071004,JAKARTA PUSAT,TANAH ABANG,PETAMBURAN,33271,8287,24984,19943,44927,2021-12-11
3174071008,JAKARTA SELATAN,KEBAYORAN BARU,PETOGOGAN,11499,2079,9420,8324,17744,2021-12-11
3171011004,JAKARTA PUSAT,GAMBIR,PETOJO SELATAN,14692,3120,11572,10137,21709,2021-12-11
3171011003,JAKARTA PUSAT,GAMBIR,PETOJO UTARA,17458,3548,13910,11810,25720,2021-12-11
3174101004,JAKARTA SELATAN,PESANGGRAHAN,PETUKANGAN SELATAN,37187,7202,29985,26364,56349,2021-12-11
3174101003,JAKARTA SELATAN,PESANGGRAHAN,PETUKANGAN UTARA,53716,10779,42937,37250,80187,2021-12-11
3175081002,JAKARTA TIMUR,MAKASAR,PINANG RANTI,27198,5560,21638,18563,40201,2021-12-11
3173031008,JAKARTA BARAT,TAMAN SARI,PINANGSIA,10729,1775,8954,7663,16617,2021-12-11
3175011001,JAKARTA TIMUR,MATRAMAN,PISANGAN BARU,31776,6110,25666,21447,47113,2021-12-11
3175021002,JAKARTA TIMUR,PULO GADUNG,PISANGAN TIMUR,41011,7082,33929,29906,63835,2021-12-11
3172011005,JAKARTA UTARA,PENJARINGAN,PLUIT,47783,8879,38904,34982,73886,2021-12-11
3175071002,JAKARTA TIMUR,DUREN SAWIT,PONDOK BAMBU,61550,12151,49399,43165,92564,2021-12-11
3175071004,JAKARTA TIMUR,DUREN SAWIT,PONDOK KELAPA,72015,13489,58526,52025,110551,2021-12-11
3175071007,JAKARTA TIMUR,DUREN SAWIT,PONDOK KOPI,35367,6267,29100,24700,53800,2021-12-11
3174061003,JAKARTA SELATAN,CILANDAK,PONDOK LABU,46464,7185,39279,35645,74924,2021-12-11
3174051002,JAKARTA SELATAN,KEBAYORAN LAMA,PONDOK PINANG,56169,10213,45956,40916,86872,2021-12-11
3175101003,JAKARTA TIMUR,CIPAYUNG,PONDOK RANGGON,25574,4541,21033,18496,39529,2021-12-11
3101011003,KAB.ADM.KEP.SERIBU,KEP. SERIBU UTARA,PULAU HARAPAN,2060,194,1866,1671,3537,2021-12-11
3101011002,KAB.ADM.KEP.SERIBU,KEP. SERIBU UTARA,PULAU KELAPA,5528,549,4979,4276,9255,2021-12-11
3101011001,KAB.ADM.KEP.SERIBU,KEP. SERIBU UTARA,PULAU PANGGANG,5450,416,5034,4586,9620,2021-12-11
3101021003,KAB.ADM.KEP.SERIBU,KEP. SERIBU SELATAN,PULAU PARI,2765,191,2574,2442,5016,2021-12-11
3101021002,KAB.ADM.KEP.SERIBU,KEP. SERIBU SELATAN,PULAU TIDUNG,4553,349,4204,3920,8124,2021-12-11
3101021001,KAB.ADM.KEP.SERIBU,KEP. SERIBU SELATAN,PULAU UNTUNG JAWA,1941,154,1787,1664,3451,2021-12-11
3174071007,JAKARTA SELATAN,KEBAYORAN BARU,PULO,5835,970,4865,4585,9450,2021-12-11
3175021001,JAKARTA TIMUR,PULO GADUNG,PULO GADUNG,34422,7085,27337,23675,51012,2021-12-11
3175061005,JAKARTA TIMUR,CAKUNG,PULO GEBANG,97301,17615,79686,67677,147363,2021-12-11
3174041004,JAKARTA SELATAN,PASAR MINGGU,RAGUNAN,39616,6556,33060,29318,62378,2021-12-11
3175091005,JAKARTA TIMUR,CIRACAS,RAMBUTAN,36771,8119,28652,24204,52856,2021-12-11
3172031006,JAKARTA UTARA,KOJA,RAWA BADAK SELATAN,42179,9313,32866,27081,59947,2021-12-11
3172031004,JAKARTA UTARA,KOJA,RAWA BADAK UTARA,34408,7214,27194,23014,50208,2021-12-11
3174071005,JAKARTA SELATAN,KEBAYORAN BARU,RAWA BARAT,5625,960,4665,4246,8911,2021-12-11
3173011003,JAKARTA BARAT,CENGKARENG,RAWA BUAYA,63799,11799,52000,44805,96805,2021-12-11
3175031004,JAKARTA TIMUR,JATINEGARA,RAWA BUNGA,21434,4731,16703,14157,30860,2021-12-11
3174081003,JAKARTA SELATAN,PANCORAN,RAWA JATI,20509,3683,16826,14914,31740,2021-12-11
3175061002,JAKARTA TIMUR,CAKUNG,RAWA TERATE,24637,4162,20475,17352,37827,2021-12-11
3175021005,JAKARTA TIMUR,PULO GADUNG,RAWAMANGUN,37612,6952,30660,27047,57707,2021-12-11
3171051003,JAKARTA PUSAT,CEMPAKA PUTIH,RAWASARI,21967,4165,17802,15791,33593,2021-12-11
3173041010,JAKARTA BARAT,TAMBORA,ROA MALAKA,3484,590,2894,2652,5546,2021-12-11
3172041006,JAKARTA UTARA,CILINCING,ROROTAN,41668,7883,33785,28426,62211,2021-12-11
3174071004,JAKARTA SELATAN,KEBAYORAN BARU,SELONG,2842,529,2313,2177,4490,2021-12-11
3173061002,JAKARTA BARAT,KALI DERES,SEMANAN,71354,13974,57380,47994,105374,2021-12-11
3172041007,JAKARTA UTARA,CILINCING,SEMPER BARAT,68587,12556,56031,48396,104427,2021-12-11
3172041005,JAKARTA UTARA,CILINCING,SEMPER TIMUR,36267,7251,29016,24450,53466,2021-12-11
3174071006,JAKARTA SELATAN,KEBAYORAN BARU,SENAYAN,2771,629,2142,1921,4063,2021-12-11
3171041001,JAKARTA PUSAT,SENEN,SENEN,6804,1360,5444,4659,10103,2021-12-11
3171031004,JAKARTA PUSAT,KEMAYORAN,SERDANG,29668,5308,24360,21184,45544,2021-12-11
3174021001,JAKARTA SELATAN,SETIA BUDI,SETIA BUDI,3023,577,2446,2167,4613,2021-12-11
3175101005,JAKARTA TIMUR,CIPAYUNG,SETU,20572,3873,16699,14294,30993,2021-12-11
3173071002,JAKARTA BARAT,PALMERAH,SLIPI,16591,2797,13794,12154,25948,2021-12-11
3173081004,JAKARTA BARAT,KEMBANGAN,SRENGSENG,45523,9485,36038,31414,67452,2021-12-11
3174091002,JAKARTA SELATAN,JAGAKARSA,SRENGSENG SAWAH,58196,8291,49905,44589,94494,2021-12-11
3173051003,JAKARTA BARAT,KEBON JERUK,SUKABUMI SELATAN,37033,7271,29762,23993,53755,2021-12-11
3173051002,JAKARTA BARAT,KEBON JERUK,SUKABUMI UTARA,38290,7976,30314,24596,54910,2021-12-11
3172041002,JAKARTA UTARA,CILINCING,SUKAPURA,53949,11437,42512,36309,78821,2021-12-11
3171031007,JAKARTA PUSAT,KEMAYORAN,SUMUR BATU,22717,4012,18705,16675,35380,2021-12-11
3172021004,JAKARTA UTARA,TANJUNG PRIOK,SUNGAI BAMBU,29876,5570,24306,20939,45245,2021-12-11
3172021006,JAKARTA UTARA,TANJUNG PRIOK,SUNTER AGUNG,71805,11723,60082,54337,114419,2021-12-11
3172021002,JAKARTA UTARA,TANJUNG PRIOK,SUNTER JAYA,63031,10421,52610,47206,99816,2021-12-11
3175091004,JAKARTA TIMUR,CIRACAS,SUSUKAN,38257,6782,31475,27158,58633,2021-12-11
3173031001,JAKARTA BARAT,TAMAN SARI,TAMAN SARI,14348,2475,11873,10515,22388,2021-12-11
3173041001,JAKARTA BARAT,TAMBORA,TAMBORA,10204,2013,8191,6835,15026,2021-12-11
3173041004,JAKARTA BARAT,TAMBORA,TANAH SEREAL,26387,4203,22184,19159,41343,2021-12-11
3171081004,JAKARTA PUSAT,JOHAR BARU,TANAH TINGGI,37693,6844,30849,25777,56626,2021-12-11
3173031004,JAKARTA BARAT,TAMAN SARI,TANGKI,13324,2106,11218,9861,21079,2021-12-11
3174091005,JAKARTA SELATAN,JAGAKARSA,TANJUNG BARAT,39770,6329,33441,29009,62450,2021-12-11
3173021005,JAKARTA BARAT,GROGOL PETAMBURAN,TANJUNG DUREN SELATAN,25337,4552,20785,18990,39775,2021-12-11
3173021002,JAKARTA BARAT,GROGOL PETAMBURAN,TANJUNG DUREN UTARA,17010,2705,14305,13214,27519,2021-12-11
3172021001,JAKARTA UTARA,TANJUNG PRIOK,TANJUNG PRIOK,34588,6734,27854,23540,51394,2021-12-11
3174011002,JAKARTA SELATAN,TEBET,TEBET BARAT,21194,3182,18012,16430,34442,2021-12-11
3174011001,JAKARTA SELATAN,TEBET,TEBET TIMUR,18199,2748,15451,14391,29842,2021-12-11
3173061003,JAKARTA BARAT,KALI DERES,TEGAL ALUR,83647,16280,67367,57693,125060,2021-12-11
3174031004,JAKARTA SELATAN,MAMPANG PRAPATAN,TEGAL PARANG,32401,6685,25716,21128,46844,2021-12-11
3173021003,JAKARTA BARAT,GROGOL PETAMBURAN,TOMANG,29605,5123,24482,21834,46316,2021-12-11
3172031005,JAKARTA UTARA,KOJA,TUGU SELATAN,39122,8085,31037,26112,57149,2021-12-11
3172031002,JAKARTA UTARA,KOJA,TUGU UTARA,67670,15087,52583,43557,96140,2021-12-11
3175061006,JAKARTA TIMUR,CAKUNG,UJUNG MENTENG,29934,4856,25078,22083,47161,2021-12-11
3174101005,JAKARTA SELATAN,PESANGGRAHAN,ULUJAMI,40544,8292,32252,27709,59961,2021-12-11
3175011006,JAKARTA TIMUR,MATRAMAN,UTAN KAYU SELATAN,33511,5606,27905,24131,52036,2021-12-11
3175011002,JAKARTA TIMUR,MATRAMAN,UTAN KAYU UTARA,28169,5333,22836,19396,42232,2021-12-11
3171031008,JAKARTA PUSAT,KEMAYORAN,UTAN PANJANG,29208,5405,23803,20109,43912,2021-12-11
3172021007,JAKARTA UTARA,TANJUNG PRIOK,WARAKAS,44401,7676,36725,30942,67667,2021-12-11
3173021007,JAKARTA BARAT,GROGOL PETAMBURAN,WIJAYA KUSUMA,38934,7552,31382,27386,58768,2021-12-11
3172051003,JAKARTA UTARA,PADEMANGAN,ANCOL,23947,5443,18504,15660,34164,2021-12-12
3173041007,JAKARTA BARAT,TAMBORA,ANGKE,29381,5819,23562,19731,43293,2021-12-12
3175041005,JAKARTA TIMUR,KRAMAT JATI,BALE KAMBANG,29074,6637,22437,18431,40868,2021-12-12
3175031003,JAKARTA TIMUR,JATINEGARA,BALI MESTER,9752,1868,7884,6885,14769,2021-12-12
3175101006,JAKARTA TIMUR,CIPAYUNG,BAMBU APUS,26285,4527,21758,18982,40740,2021-12-12
3174031002,JAKARTA SELATAN,MAMPANG PRAPATAN,BANGKA,21566,4276,17290,14909,32199,2021-12-12
3175051002,JAKARTA TIMUR,PASAR REBO,BARU,23886,3696,20190,18011,38201,2021-12-12
3175041004,JAKARTA TIMUR,KRAMAT JATI,BATU AMPAR,47898,10777,37121,31234,68355,2021-12-12
3171071002,JAKARTA PUSAT,TANAH ABANG,BENDUNGAN HILIR,21494,4106,17388,15324,32712,2021-12-12
3175031002,JAKARTA TIMUR,JATINEGARA,BIDARA CINA,36689,8278,28411,24106,52517,2021-12-12
3174101002,JAKARTA SELATAN,PESANGGRAHAN,BINTARO,53098,10073,43025,38713,81738,2021-12-12
3174011005,JAKARTA SELATAN,TEBET,BUKIT DURI,34183,6421,27762,24033,51795,2021-12-12
3171041006,JAKARTA PUSAT,SENEN,BUNGUR,18144,3563,14581,12510,27091,2021-12-12
3175061007,JAKARTA TIMUR,CAKUNG,CAKUNG BARAT,57724,11077,46647,39546,86193,2021-12-12
3175061004,JAKARTA TIMUR,CAKUNG,CAKUNG TIMUR,58287,10777,47510,40841,88351,2021-12-12
3175041007,JAKARTA TIMUR,KRAMAT JATI,CAWANG,32762,6494,26268,22174,48442,2021-12-12
3175101008,JAKARTA TIMUR,CIPAYUNG,CEGER,18932,3451,15481,13416,28897,2021-12-12
3171031006,JAKARTA PUSAT,KEMAYORAN,CEMPAKA BARU,32581,5767,26814,22967,49781,2021-12-12
3171051002,JAKARTA PUSAT,CEMPAKA PUTIH,CEMPAKA PUTIH BARAT,35885,7058,28827,25452,54279,2021-12-12
3171051001,JAKARTA PUSAT,CEMPAKA PUTIH,CEMPAKA PUTIH TIMUR,24292,4732,19560,17714,37274,2021-12-12
3173011001,JAKARTA BARAT,CENGKARENG,CENGKARENG BARAT,66284,12336,53948,47958,101906,2021-12-12
3173011006,JAKARTA BARAT,CENGKARENG,CENGKARENG TIMUR,81027,14989,66038,57144,123182,2021-12-12
3175091002,JAKARTA TIMUR,CIRACAS,CIBUBUR,66364,10752,55612,48986,104598,2021-12-12
3171011002,JAKARTA PUSAT,GAMBIR,CIDENG,15390,2872,12518,11201,23719,2021-12-12
3174091003,JAKARTA SELATAN,JAGAKARSA,CIGANJUR,38497,6041,32456,28408,60864,2021-12-12
3175051003,JAKARTA TIMUR,PASAR REBO,CIJANTUNG,41419,7194,34225,29780,64005,2021-12-12
3171061003,JAKARTA PUSAT,MENTENG,CIKINI,8274,1408,6866,5704,12570,2021-12-12
3174081006,JAKARTA SELATAN,PANCORAN,CIKOKO,10547,1714,8833,7886,16719,2021-12-12
3174061001,JAKARTA SELATAN,CILANDAK,CILANDAK BARAT,51752,8602,43150,39105,82255,2021-12-12
3174041003,JAKARTA SELATAN,PASAR MINGGU,CILANDAK TIMUR,25145,4261,20884,18499,39383,2021-12-12
3175101002,JAKARTA TIMUR,CIPAYUNG,CILANGKAP,27635,4609,23026,20315,43341,2021-12-12
3175041006,JAKARTA TIMUR,KRAMAT JATI,CILILITAN,40181,7864,32317,27355,59672,2021-12-12
3172041001,JAKARTA UTARA,CILINCING,CILINCING,43609,9685,33924,27562,61486,2021-12-12
3175101001,JAKARTA TIMUR,CIPAYUNG,CIPAYUNG,26104,4281,21823,19367,41190,2021-12-12
3174091006,JAKARTA SELATAN,JAGAKARSA,CIPEDAK,38303,5953,32350,28501,60851,2021-12-12
3174061005,JAKARTA SELATAN,CILANDAK,CIPETE SELATAN,26704,4780,21924,19931,41855,2021-12-12
3174071010,JAKARTA SELATAN,KEBAYORAN BARU,CIPETE UTARA,34102,6112,27990,24430,52420,2021-12-12
3175021003,JAKARTA TIMUR,PULO GADUNG,CIPINANG,39306,6638,32668,28364,61032,2021-12-12
3175031007,JAKARTA TIMUR,JATINEGARA,CIPINANG BESAR SELATAN,35212,7821,27391,22859,50250,2021-12-12
3175031008,JAKARTA TIMUR,JATINEGARA,CIPINANG BESAR UTARA,45319,9928,35391,29127,64518,2021-12-12
3175031005,JAKARTA TIMUR,JATINEGARA,CIPINANG CEMPEDAK,32824,6728,26096,23109,49205,2021-12-12
3175081005,JAKARTA TIMUR,MAKASAR,CIPINANG MELAYU,42308,7636,34672,30583,65255,2021-12-12
3175031006,JAKARTA TIMUR,JATINEGARA,CIPINANG MUARA,55243,10995,44248,37858,82106,2021-12-12
3174051003,JAKARTA SELATAN,KEBAYORAN LAMA,CIPULIR,39937,7922,32015,27403,59418,2021-12-12
3175091001,JAKARTA TIMUR,CIRACAS,CIRACAS,64594,11207,53387,45876,99263,2021-12-12
3175041003,JAKARTA TIMUR,KRAMAT JATI,DUKUH,24609,4267,20342,17415,37757,2021-12-12
3175071001,JAKARTA TIMUR,DUREN SAWIT,DUREN SAWIT,61160,12138,49022,42703,91725,2021-12-12
3174081004,JAKARTA SELATAN,PANCORAN,DUREN TIGA,28319,5248,23071,19982,43053,2021-12-12
3173051005,JAKARTA BARAT,KEBON JERUK,DURI KEPA,60138,11205,48933,43429,92362,2021-12-12
3173011002,JAKARTA BARAT,CENGKARENG,DURI KOSAMBI,77923,15404,62519,52420,114939,2021-12-12
3171011006,JAKARTA PUSAT,GAMBIR,DURI PULO,19610,3893,15717,13089,28806,2021-12-12
3173041011,JAKARTA BARAT,TAMBORA,DURI SELATAN,14259,2379,11880,10358,22238,2021-12-12
3173041003,JAKARTA BARAT,TAMBORA,DURI UTARA,19844,3344,16500,14078,30578,2021-12-12
3171081003,JAKARTA PUSAT,JOHAR BARU,GALUR,18243,3357,14886,12387,27273,2021-12-12
3171011001,JAKARTA PUSAT,GAMBIR,GAMBIR,2191,434,1757,1552,3309,2021-12-12
3174061004,JAKARTA SELATAN,CILANDAK,GANDARIA SELATAN,22119,3960,18159,16080,34239,2021-12-12
3174071009,JAKARTA SELATAN,KEBAYORAN BARU,GANDARIA UTARA,39922,7406,32516,28681,61197,2021-12-12
3175051001,JAKARTA TIMUR,PASAR REBO,GEDONG,35755,6719,29036,25425,54461,2021-12-12
3171071001,JAKARTA PUSAT,TANAH ABANG,GELORA,3127,584,2543,2284,4827,2021-12-12
3173031007,JAKARTA BARAT,TAMAN SARI,GLODOK,7837,1119,6718,6231,12949,2021-12-12
3171061004,JAKARTA PUSAT,MENTENG,GONDANGDIA,4100,887,3213,2996,6209,2021-12-12
3173021001,JAKARTA BARAT,GROGOL PETAMBURAN,GROGOL,16876,3127,13749,12032,25781,2021-12-12
3174051005,JAKARTA SELATAN,KEBAYORAN LAMA,GROGOL SELATAN,44251,8291,35960,31051,67011,2021-12-12
3174051004,JAKARTA SELATAN,KEBAYORAN LAMA,GROGOL UTARA,42494,8186,34308,29665,63973,2021-12-12
3174021007,JAKARTA SELATAN,SETIA BUDI,GUNTUR,3985,713,3272,2994,6266,2021-12-12
3174071002,JAKARTA SELATAN,KEBAYORAN BARU,GUNUNG,9436,1674,7762,7083,14845,2021-12-12
3171031005,JAKARTA PUSAT,KEMAYORAN,GUNUNG SAHARI SELATAN,19199,3491,15708,13716,29424,2021-12-12
3171021004,JAKARTA PUSAT,SAWAH BESAR,GUNUNG SAHARI UTARA,16650,2767,13883,12660,26543,2021-12-12
3175081004,JAKARTA TIMUR,MAKASAR,HALIM PERDANA KUSUMAH,28363,3413,24950,23235,48185,2021-12-12
3171031003,JAKARTA PUSAT,KEMAYORAN,HARAPAN MULIA,22557,4046,18511,15762,34273,2021-12-12
3174091001,JAKARTA SELATAN,JAGAKARSA,JAGAKARSA,62389,9536,52853,46966,99819,2021-12-12
3175021007,JAKARTA TIMUR,PULO GADUNG,JATI,32757,5755,27002,24323,51325,2021-12-12
3174041002,JAKARTA SELATAN,PASAR MINGGU,JATI PADANG,37502,6661,30841,27046,57887,2021-12-12
3173071004,JAKARTA BARAT,PALMERAH,JATI PULO,28738,5359,23379,19450,42829,2021-12-12
3175061001,JAKARTA TIMUR,CAKUNG,JATINEGARA,84160,16608,67552,57849,125401,2021-12-12
3175021004,JAKARTA TIMUR,PULO GADUNG,JATINEGARA KAUM,24632,4122,20510,17455,37965,2021-12-12
3173021004,JAKARTA BARAT,GROGOL PETAMBURAN,JELAMBAR,30266,5193,25073,22770,47843,2021-12-12
3173021006,JAKARTA BARAT,GROGOL PETAMBURAN,JELAMBAR BARU,38246,6394,31852,28722,60574,2021-12-12
3173041006,JAKARTA BARAT,TAMBORA,JEMBATAN BESI,29314,6627,22687,18515,41202,2021-12-12
3173041008,JAKARTA BARAT,TAMBORA,JEMBATAN LIMA,21021,4412,16609,13691,30300,2021-12-12
3173081005,JAKARTA BARAT,KEMBANGAN,JOGLO,40839,7690,33149,28991,62140,2021-12-12
3171081001,JAKARTA PUSAT,JOHAR BARU,JOHAR BARU,37488,6564,30924,26898,57822,2021-12-12
3173041002,JAKARTA BARAT,TAMBORA,KALI ANYAR,23856,4438,19418,16062,35480,2021-12-12
3172041004,JAKARTA UTARA,CILINCING,KALIBARU,67684,17141,50543,37680,88223,2021-12-12
3174081002,JAKARTA SELATAN,PANCORAN,KALIBATA,41994,8862,33132,28185,61317,2021-12-12
3173061001,JAKARTA BARAT,KALI DERES,KALIDERES,72447,13599,58848,51591,110439,2021-12-12
3175051004,JAKARTA TIMUR,PASAR REBO,KALISARI,43212,7158,36054,31617,67671,2021-12-12
3173061004,JAKARTA BARAT,KALI DERES,KAMAL,53783,11598,42185,35144,77329,2021-12-12
3172011002,JAKARTA UTARA,PENJARINGAN,KAMAL MUARA,12930,2217,10713,9262,19975,2021-12-12
3171071007,JAKARTA PUSAT,TANAH ABANG,KAMPUNG BALI,11358,2314,9044,7340,16384,2021-12-12
3175031001,JAKARTA TIMUR,JATINEGARA,KAMPUNG MELAYU,25717,5547,20170,16526,36696,2021-12-12
3171081002,JAKARTA PUSAT,JOHAR BARU,KAMPUNG RAWA,21237,3307,17930,14737,32667,2021-12-12
3175041002,JAKARTA TIMUR,KRAMAT JATI,KAMPUNG TENGAH,43993,10210,33783,28143,61926,2021-12-12
3173011005,JAKARTA BARAT,CENGKARENG,KAPUK,134466,30105,104361,87960,192321,2021-12-12
3172011003,JAKARTA UTARA,PENJARINGAN,KAPUK MUARA,35781,6489,29292,26508,55800,2021-12-12
3171021002,JAKARTA PUSAT,SAWAH BESAR,KARANG ANYAR,25761,4549,21212,18362,39574,2021-12-12
3174021004,JAKARTA SELATAN,SETIA BUDI,KARET,9623,1754,7869,6848,14717,2021-12-12
3174021003,JAKARTA SELATAN,SETIA BUDI,KARET KUNINGAN,16055,2947,13108,11515,24623,2021-12-12
3174021002,JAKARTA SELATAN,SETIA BUDI,KARET SEMANGGI,2770,532,2238,2030,4268,2021-12-12
3171071003,JAKARTA PUSAT,TANAH ABANG,KARET TENGSIN,19271,3525,15746,13436,29182,2021-12-12
3171021003,JAKARTA PUSAT,SAWAH BESAR,KARTINI,22292,3932,18360,16261,34621,2021-12-12
3175011003,JAKARTA TIMUR,MATRAMAN,KAYU MANIS,25284,4928,20356,17006,37362,2021-12-12
3175021006,JAKARTA TIMUR,PULO GADUNG,KAYU PUTIH,40696,7254,33442,30116,63558,2021-12-12
3173031006,JAKARTA BARAT,TAMAN SARI,KEAGUNGAN,17387,3031,14356,12195,26551,2021-12-12
3174041007,JAKARTA SELATAN,PASAR MINGGU,KEBAGUSAN,44552,8216,36336,31520,67856,2021-12-12
3174051006,JAKARTA SELATAN,KEBAYORAN LAMA,KEBAYORAN LAMA SELATAN,41212,7147,34065,30183,64248,2021-12-12
3174051001,JAKARTA SELATAN,KEBAYORAN LAMA,KEBAYORAN LAMA UTARA,42422,8272,34150,29668,63818,2021-12-12
3174011004,JAKARTA SELATAN,TEBET,KEBON BARU,35165,6100,29065,25380,54445,2021-12-12
3172021005,JAKARTA UTARA,TANJUNG PRIOK,KEBON BAWANG,50952,9594,41358,35735,77093,2021-12-12
3173051001,JAKARTA BARAT,KEBON JERUK,KEBON JERUK,53887,10313,43574,37166,80740,2021-12-12
3171071006,JAKARTA PUSAT,TANAH ABANG,KEBON KACANG,21531,4872,16659,13841,30500,2021-12-12
3171011005,JAKARTA PUSAT,GAMBIR,KEBON KELAPA,10163,1940,8223,7199,15422,2021-12-12
3171031002,JAKARTA PUSAT,KEMAYORAN,KEBON KOSONG,30019,5671,24348,20921,45269,2021-12-12
3175011005,JAKARTA TIMUR,MATRAMAN,KEBON MANGGIS,16490,2979,13511,11582,25093,2021-12-12
3171071005,JAKARTA PUSAT,TANAH ABANG,KEBON MELATI,32206,8139,24067,18787,42854,2021-12-12
3175081003,JAKARTA TIMUR,MAKASAR,KEBON PALA,46614,8639,37975,32942,70917,2021-12-12
3171061005,JAKARTA PUSAT,MENTENG,KEBON SIRIH,12299,2460,9839,8270,18109,2021-12-12
3173011004,JAKARTA BARAT,CENGKARENG,KEDAUNG KALI ANGKE,32612,5890,26722,23178,49900,2021-12-12
3173051007,JAKARTA BARAT,KEBON JERUK,KEDOYA SELATAN,32165,5556,26609,22826,49435,2021-12-12
3173051006,JAKARTA BARAT,KEBON JERUK,KEDOYA UTARA,45740,8284,37456,32503,69959,2021-12-12
3173051004,JAKARTA BARAT,KEBON JERUK,KELAPA DUA,23565,4343,19222,16664,35886,2021-12-12
3175091003,JAKARTA TIMUR,CIRACAS,KELAPA DUA WETAN,46875,7550,39325,34481,73806,2021-12-12
3172061003,JAKARTA UTARA,KELAPA GADING,KELAPA GADING BARAT,35717,5916,29801,27448,57249,2021-12-12
3172061001,JAKARTA UTARA,KELAPA GADING,KELAPA GADING TIMUR,33592,4883,28709,27122,55831,2021-12-12
3173071005,JAKARTA BARAT,PALMERAH,KEMANGGISAN,32139,5712,26427,23312,49739,2021-12-12
3171031001,JAKARTA PUSAT,KEMAYORAN,KEMAYORAN,20708,3858,16850,14426,31276,2021-12-12
3173081006,JAKARTA BARAT,KEMBANGAN,KEMBANGAN SELATAN,27130,5360,21770,19244,41014,2021-12-12
3173081001,JAKARTA BARAT,KEMBANGAN,KEMBANGAN UTARA,54451,10952,43499,37283,80782,2021-12-12
3171041002,JAKARTA PUSAT,SENEN,KENARI,9579,1776,7803,6839,14642,2021-12-12
3173041005,JAKARTA BARAT,TAMBORA,KERENDANG,19973,3814,16159,13726,29885,2021-12-12
3175071003,JAKARTA TIMUR,DUREN SAWIT,KLENDER,69978,15312,54666,45679,100345,2021-12-12
3172031001,JAKARTA UTARA,KOJA,KOJA,28175,5995,22180,18610,40790,2021-12-12
3173071006,JAKARTA BARAT,PALMERAH,KOTA BAMBU SELATAN,21158,3899,17259,14255,31514,2021-12-12
3173071003,JAKARTA BARAT,PALMERAH,KOTA BAMBU UTARA,24995,4768,20227,16557,36784,2021-12-12
3171041004,JAKARTA PUSAT,SENEN,KRAMAT,28835,6017,22818,17802,40620,2021-12-12
3175041001,JAKARTA TIMUR,KRAMAT JATI,KRAMAT JATI,34144,6748,27396,23153,50549,2021-12-12
3174071003,JAKARTA SELATAN,KEBAYORAN BARU,KRAMAT PELA,14413,2637,11776,10474,22250,2021-12-12
3173031002,JAKARTA BARAT,TAMAN SARI,KRUKUT,19244,3440,15804,13345,29149,2021-12-12
3174031005,JAKARTA SELATAN,MAMPANG PRAPATAN,KUNINGAN BARAT,12785,2172,10613,9256,19869,2021-12-12
3174021008,JAKARTA SELATAN,SETIA BUDI,KUNINGAN TIMUR,6008,1134,4874,4350,9224,2021-12-12
3171041005,JAKARTA PUSAT,SENEN,KWITANG,15486,3143,12343,10276,22619,2021-12-12
3172031003,JAKARTA UTARA,KOJA,LAGOA,59065,12962,46103,38120,84223,2021-12-12
3174061002,JAKARTA SELATAN,CILANDAK,LEBAK BULUS,37626,6661,30965,28200,59165,2021-12-12
3174091004,JAKARTA SELATAN,JAGAKARSA,LENTENG AGUNG,53946,8963,44983,38747,83730,2021-12-12
3175101007,JAKARTA TIMUR,CIPAYUNG,LUBANG BUAYA,63547,11253,52294,45237,97531,2021-12-12
3175081001,JAKARTA TIMUR,MAKASAR,MAKASAR,34390,5771,28619,25250,53869,2021-12-12
3175071006,JAKARTA TIMUR,DUREN SAWIT,MALAKA JAYA,30927,4850,26077,23359,49436,2021-12-12
3175071005,JAKARTA TIMUR,DUREN SAWIT,MALAKA SARI,27530,4244,23286,21046,44332,2021-12-12
3174031001,JAKARTA SELATAN,MAMPANG PRAPATAN,MAMPANG PRAPATAN,18159,3485,14674,12605,27279,2021-12-12
3173031005,JAKARTA BARAT,TAMAN SARI,MANGGA BESAR,7707,1241,6466,5852,12318,2021-12-12
3171021005,JAKARTA PUSAT,SAWAH BESAR,MANGGA DUA SELATAN,27442,5205,22237,19321,41558,2021-12-12
3174011007,JAKARTA SELATAN,TEBET,MANGGARAI,28373,4651,23722,20200,43922,2021-12-12
3174011006,JAKARTA SELATAN,TEBET,MANGGARAI SELATAN,23075,3461,19614,17119,36733,2021-12-12
3173031003,JAKARTA BARAT,TAMAN SARI,MAPHAR,16461,2902,13559,11739,25298,2021-12-12
3172041003,JAKARTA UTARA,CILINCING,MARUNDA,28943,6128,22815,17875,40690,2021-12-12
3174071001,JAKARTA SELATAN,KEBAYORAN BARU,MELAWAI,2627,488,2139,2010,4149,2021-12-12
3171061001,JAKARTA PUSAT,MENTENG,MENTENG,25624,5234,20390,16904,37294,2021-12-12
3174021005,JAKARTA SELATAN,SETIA BUDI,MENTENG ATAS,27816,4662,23154,20125,43279,2021-12-12
3174011003,JAKARTA SELATAN,TEBET,MENTENG DALAM,36028,6581,29447,25936,55383,2021-12-12
3173081003,JAKARTA BARAT,KEMBANGAN,MERUYA SELATAN,32130,6168,25962,22744,48706,2021-12-12
3173081002,JAKARTA BARAT,KEMBANGAN,MERUYA UTARA,43752,8458,35294,31637,66931,2021-12-12
3175101004,JAKARTA TIMUR,CIPAYUNG,MUNJUL,23871,4133,19738,17294,37032,2021-12-12
3172051002,JAKARTA UTARA,PADEMANGAN,PADEMANGAN BARAT,74240,16357,57883,48507,106390,2021-12-12
3172051001,JAKARTA UTARA,PADEMANGAN,PADEMANGAN TIMUR,37736,6261,31475,28600,60075,2021-12-12
3175011004,JAKARTA TIMUR,MATRAMAN,PAL MERIAM,19769,3726,16043,13497,29540,2021-12-12
3173071001,JAKARTA BARAT,PALMERAH,PALMERAH,63011,12310,50701,43114,93815,2021-12-12
3174081001,JAKARTA SELATAN,PANCORAN,PANCORAN,19421,3601,15820,13686,29506,2021-12-12
3172021003,JAKARTA UTARA,TANJUNG PRIOK,PAPANGGO,39097,7208,31889,27236,59125,2021-12-12
3171021001,JAKARTA PUSAT,SAWAH BESAR,PASAR BARU,12035,2177,9858,9026,18884,2021-12-12
3174021006,JAKARTA SELATAN,SETIA BUDI,PASAR MANGGIS,26752,4752,22000,18993,40993,2021-12-12
3174041001,JAKARTA SELATAN,PASAR MINGGU,PASAR MINGGU,24821,4399,20422,18145,38567,2021-12-12
3171041003,JAKARTA PUSAT,SENEN,PASEBAN,23533,4592,18941,16078,35019,2021-12-12
3173061005,JAKARTA BARAT,KALI DERES,PEGADUNGAN,75587,13816,61771,54470,116241,2021-12-12
3171061002,JAKARTA PUSAT,MENTENG,PEGANGSAAN,23455,4731,18724,15220,33944,2021-12-12
3172061002,JAKARTA UTARA,KELAPA GADING,PEGANGSAAN DUA,49976,7875,42101,38901,81002,2021-12-12
3172011004,JAKARTA UTARA,PENJARINGAN,PEJAGALAN,74578,14536,60042,53682,113724,2021-12-12
3174041006,JAKARTA SELATAN,PASAR MINGGU,PEJATEN BARAT,37346,6703,30643,26974,57617,2021-12-12
3174041005,JAKARTA SELATAN,PASAR MINGGU,PEJATEN TIMUR,57656,11523,46133,39001,85134,2021-12-12
3175051005,JAKARTA TIMUR,PASAR REBO,PEKAYON,43250,7315,35935,31231,67166,2021-12-12
3173041009,JAKARTA BARAT,TAMBORA,PEKOJAN,23587,4232,19355,16912,36267,2021-12-12
3174031003,JAKARTA SELATAN,MAMPANG PRAPATAN,PELA MAMPANG,43522,8042,35480,31127,66607,2021-12-12
3174081005,JAKARTA SELATAN,PANCORAN,PENGADEGAN,21478,3705,17773,15706,33479,2021-12-12
3175061003,JAKARTA TIMUR,CAKUNG,PENGGILINGAN,99255,21143,78112,65115,143227,2021-12-12
3172011001,JAKARTA UTARA,PENJARINGAN,PENJARINGAN,88308,21299,67009,54324,121333,2021-12-12
3174101001,JAKARTA SELATAN,PESANGGRAHAN,PESANGGRAHAN,27545,4462,23083,20494,43577,2021-12-12
3171071004,JAKARTA PUSAT,TANAH ABANG,PETAMBURAN,33271,8285,24986,19966,44952,2021-12-12
3174071008,JAKARTA SELATAN,KEBAYORAN BARU,PETOGOGAN,11499,2079,9420,8330,17750,2021-12-12
3171011004,JAKARTA PUSAT,GAMBIR,PETOJO SELATAN,14692,3119,11573,10142,21715,2021-12-12
3171011003,JAKARTA PUSAT,GAMBIR,PETOJO UTARA,17458,3542,13916,11821,25737,2021-12-12
3174101004,JAKARTA SELATAN,PESANGGRAHAN,PETUKANGAN SELATAN,37187,7193,29994,26375,56369,2021-12-12
3174101003,JAKARTA SELATAN,PESANGGRAHAN,PETUKANGAN UTARA,53716,10770,42946,37270,80216,2021-12-12
3175081002,JAKARTA TIMUR,MAKASAR,PINANG RANTI,27198,5559,21639,18571,40210,2021-12-12
3173031008,JAKARTA BARAT,TAMAN SARI,PINANGSIA,10729,1773,8956,7667,16623,2021-12-12
3175011001,JAKARTA TIMUR,MATRAMAN,PISANGAN BARU,31776,6108,25668,21454,47122,2021-12-12
3175021002,JAKARTA TIMUR,PULO GADUNG,PISANGAN TIMUR,41011,7073,33938,29910,63848,2021-12-12
3172011005,JAKARTA UTARA,PENJARINGAN,PLUIT,47783,8874,38909,34992,73901,2021-12-12
3175071002,JAKARTA TIMUR,DUREN SAWIT,PONDOK BAMBU,61550,12141,49409,43192,92601,2021-12-12
3175071004,JAKARTA TIMUR,DUREN SAWIT,PONDOK KELAPA,72015,13472,58543,52069,110612,2021-12-12
3175071007,JAKARTA TIMUR,DUREN SAWIT,PONDOK KOPI,35367,6258,29109,24731,53840,2021-12-12
3174061003,JAKARTA SELATAN,CILANDAK,PONDOK LABU,46464,7181,39283,35651,74934,2021-12-12
3174051002,JAKARTA SELATAN,KEBAYORAN LAMA,PONDOK PINANG,56169,10202,45967,40924,86891,2021-12-12
3175101003,JAKARTA TIMUR,CIPAYUNG,PONDOK RANGGON,25574,4537,21037,18501,39538,2021-12-12
3101011003,KAB.ADM.KEP.SERIBU,KEP. SERIBU UTARA,PULAU HARAPAN,2060,194,1866,1671,3537,2021-12-12
3101011002,KAB.ADM.KEP.SERIBU,KEP. SERIBU UTARA,PULAU KELAPA,5528,549,4979,4277,9256,2021-12-12
3101011001,KAB.ADM.KEP.SERIBU,KEP. SERIBU UTARA,PULAU PANGGANG,5450,415,5035,4587,9622,2021-12-12
3101021003,KAB.ADM.KEP.SERIBU,KEP. SERIBU SELATAN,PULAU PARI,2765,191,2574,2442,5016,2021-12-12
3101021002,KAB.ADM.KEP.SERIBU,KEP. SERIBU SELATAN,PULAU TIDUNG,4553,349,4204,3921,8125,2021-12-12
3101021001,KAB.ADM.KEP.SERIBU,KEP. SERIBU SELATAN,PULAU UNTUNG JAWA,1941,154,1787,1664,3451,2021-12-12
3174071007,JAKARTA SELATAN,KEBAYORAN BARU,PULO,5835,969,4866,4585,9451,2021-12-12
3175021001,JAKARTA TIMUR,PULO GADUNG,PULO GADUNG,34422,7077,27345,23683,51028,2021-12-12
3175061005,JAKARTA TIMUR,CAKUNG,PULO GEBANG,97301,17604,79697,67724,147421,2021-12-12
3174041004,JAKARTA SELATAN,PASAR MINGGU,RAGUNAN,39616,6549,33067,29328,62395,2021-12-12
3175091005,JAKARTA TIMUR,CIRACAS,RAMBUTAN,36771,8115,28656,24222,52878,2021-12-12
3172031006,JAKARTA UTARA,KOJA,RAWA BADAK SELATAN,42179,9310,32869,27095,59964,2021-12-12
3172031004,JAKARTA UTARA,KOJA,RAWA BADAK UTARA,34408,7201,27207,23023,50230,2021-12-12
3174071005,JAKARTA SELATAN,KEBAYORAN BARU,RAWA BARAT,5625,959,4666,4249,8915,2021-12-12
3173011003,JAKARTA BARAT,CENGKARENG,RAWA BUAYA,63799,11794,52005,44821,96826,2021-12-12
3175031004,JAKARTA TIMUR,JATINEGARA,RAWA BUNGA,21434,4726,16708,14161,30869,2021-12-12
3174081003,JAKARTA SELATAN,PANCORAN,RAWA JATI,20509,3677,16832,14918,31750,2021-12-12
3175061002,JAKARTA TIMUR,CAKUNG,RAWA TERATE,24637,4156,20481,17363,37844,2021-12-12
3175021005,JAKARTA TIMUR,PULO GADUNG,RAWAMANGUN,37612,6949,30663,27064,57727,2021-12-12
3171051003,JAKARTA PUSAT,CEMPAKA PUTIH,RAWASARI,21967,4157,17810,15801,33611,2021-12-12
3173041010,JAKARTA BARAT,TAMBORA,ROA MALAKA,3484,590,2894,2653,5547,2021-12-12
3172041006,JAKARTA UTARA,CILINCING,ROROTAN,41668,7878,33790,28436,62226,2021-12-12
3174071004,JAKARTA SELATAN,KEBAYORAN BARU,SELONG,2842,529,2313,2178,4491,2021-12-12
3173061002,JAKARTA BARAT,KALI DERES,SEMANAN,71354,13963,57391,48006,105397,2021-12-12
3172041007,JAKARTA UTARA,CILINCING,SEMPER BARAT,68587,12532,56055,48444,104499,2021-12-12
3172041005,JAKARTA UTARA,CILINCING,SEMPER TIMUR,36267,7217,29050,24460,53510,2021-12-12
3174071006,JAKARTA SELATAN,KEBAYORAN BARU,SENAYAN,2771,628,2143,1923,4066,2021-12-12
3171041001,JAKARTA PUSAT,SENEN,SENEN,6804,1360,5444,4660,10104,2021-12-12
3171031004,JAKARTA PUSAT,KEMAYORAN,SERDANG,29668,5298,24370,21192,45562,2021-12-12
3174021001,JAKARTA SELATAN,SETIA BUDI,SETIA BUDI,3023,577,2446,2167,4613,2021-12-12
3175101005,JAKARTA TIMUR,CIPAYUNG,SETU,20572,3872,16700,14303,31003,2021-12-12
3173071002,JAKARTA BARAT,PALMERAH,SLIPI,16591,2790,13801,12158,25959,2021-12-12
3173081004,JAKARTA BARAT,KEMBANGAN,SRENGSENG,45523,9477,36046,31424,67470,2021-12-12
3174091002,JAKARTA SELATAN,JAGAKARSA,SRENGSENG SAWAH,58196,8283,49913,44597,94510,2021-12-12
3173051003,JAKARTA BARAT,KEBON JERUK,SUKABUMI SELATAN,37033,7266,29767,24001,53768,2021-12-12
3173051002,JAKARTA BARAT,KEBON JERUK,SUKABUMI UTARA,38290,7968,30322,24599,54921,2021-12-12
3172041002,JAKARTA UTARA,CILINCING,SUKAPURA,53949,11431,42518,36328,78846,2021-12-12
3171031007,JAKARTA PUSAT,KEMAYORAN,SUMUR BATU,22717,4006,18711,16689,35400,2021-12-12
3172021004,JAKARTA UTARA,TANJUNG PRIOK,SUNGAI BAMBU,29876,5567,24309,20952,45261,2021-12-12
3172021006,JAKARTA UTARA,TANJUNG PRIOK,SUNTER AGUNG,71805,11715,60090,54369,114459,2021-12-12
3172021002,JAKARTA UTARA,TANJUNG PRIOK,SUNTER JAYA,63031,10412,52619,47229,99848,2021-12-12
3175091004,JAKARTA TIMUR,CIRACAS,SUSUKAN,38257,6779,31478,27160,58638,2021-12-12
3173031001,JAKARTA BARAT,TAMAN SARI,TAMAN SARI,14348,2471,11877,10522,22399,2021-12-12
3173041001,JAKARTA BARAT,TAMBORA,TAMBORA,10204,2011,8193,6841,15034,2021-12-12
3173041004,JAKARTA BARAT,TAMBORA,TANAH SEREAL,26387,4197,22190,19170,41360,2021-12-12
3171081004,JAKARTA PUSAT,JOHAR BARU,TANAH TINGGI,37693,6837,30856,25785,56641,2021-12-12
3173031004,JAKARTA BARAT,TAMAN SARI,TANGKI,13324,2105,11219,9864,21083,2021-12-12
3174091005,JAKARTA SELATAN,JAGAKARSA,TANJUNG BARAT,39770,6319,33451,29019,62470,2021-12-12
3173021005,JAKARTA BARAT,GROGOL PETAMBURAN,TANJUNG DUREN SELATAN,25337,4546,20791,18997,39788,2021-12-12
3173021002,JAKARTA BARAT,GROGOL PETAMBURAN,TANJUNG DUREN UTARA,17010,2703,14307,13218,27525,2021-12-12
3172021001,JAKARTA UTARA,TANJUNG PRIOK,TANJUNG PRIOK,34588,6728,27860,23552,51412,2021-12-12
3174011002,JAKARTA SELATAN,TEBET,TEBET BARAT,21194,3178,18016,16434,34450,2021-12-12
3174011001,JAKARTA SELATAN,TEBET,TEBET TIMUR,18199,2744,15455,14395,29850,2021-12-12
3173061003,JAKARTA BARAT,KALI DERES,TEGAL ALUR,83647,16267,67380,57714,125094,2021-12-12
3174031004,JAKARTA SELATAN,MAMPANG PRAPATAN,TEGAL PARANG,32401,6683,25718,21139,46857,2021-12-12
3173021003,JAKARTA BARAT,GROGOL PETAMBURAN,TOMANG,29605,5118,24487,21843,46330,2021-12-12
3172031005,JAKARTA UTARA,KOJA,TUGU SELATAN,39122,8077,31045,26127,57172,2021-12-12
3172031002,JAKARTA UTARA,KOJA,TUGU UTARA,67670,15074,52596,43568,96164,2021-12-12
3175061006,JAKARTA TIMUR,CAKUNG,UJUNG MENTENG,29934,4838,25096,22134,47230,2021-12-12
3174101005,JAKARTA SELATAN,PESANGGRAHAN,ULUJAMI,40544,8276,32268,27733,60001,2021-12-12
3175011006,JAKARTA TIMUR,MATRAMAN,UTAN KAYU SELATAN,33511,5602,27909,24136,52045,2021-12-12
3175011002,JAKARTA TIMUR,MATRAMAN,UTAN KAYU UTARA,28169,5327,22842,19409,42251,2021-12-12
3171031008,JAKARTA PUSAT,KEMAYORAN,UTAN PANJANG,29208,5400,23808,20116,43924,2021-12-12
3172021007,JAKARTA UTARA,TANJUNG PRIOK,WARAKAS,44401,7668,36733,30959,67692,2021-12-12
3173021007,JAKARTA BARAT,GROGOL PETAMBURAN,WIJAYA KUSUMA,38934,7546,31388,27404,58792,2021-12-12
3172051003,JAKARTA UTARA,PADEMANGAN,ANCOL,23947,5438,18509,15663,34172,2021-12-13
3173041007,JAKARTA BARAT,TAMBORA,ANGKE,29381,5816,23565,19735,43300,2021-12-13
3175041005,JAKARTA TIMUR,KRAMAT JATI,BALE KAMBANG,29074,6636,22438,18437,40875,2021-12-13
3175031003,JAKARTA TIMUR,JATINEGARA,BALI MESTER,9752,1868,7884,6886,14770,2021-12-13
3175101006,JAKARTA TIMUR,CIPAYUNG,BAMBU APUS,26285,4525,21760,18984,40744,2021-12-13
3174031002,JAKARTA SELATAN,MAMPANG PRAPATAN,BANGKA,21566,4274,17292,14909,32201,2021-12-13
3175051002,JAKARTA TIMUR,PASAR REBO,BARU,23886,3695,20191,18012,38203,2021-12-13
3175041004,JAKARTA TIMUR,KRAMAT JATI,BATU AMPAR,47898,10774,37124,31236,68360,2021-12-13
3171071002,JAKARTA PUSAT,TANAH ABANG,BENDUNGAN HILIR,21494,4105,17389,15325,32714,2021-12-13
3175031002,JAKARTA TIMUR,JATINEGARA,BIDARA CINA,36689,8274,28415,24110,52525,2021-12-13
3174101002,JAKARTA SELATAN,PESANGGRAHAN,BINTARO,53098,10071,43027,38715,81742,2021-12-13
3174011005,JAKARTA SELATAN,TEBET,BUKIT DURI,34183,6421,27762,24039,51801,2021-12-13
3171041006,JAKARTA PUSAT,SENEN,BUNGUR,18144,3561,14583,12511,27094,2021-12-13
3175061007,JAKARTA TIMUR,CAKUNG,CAKUNG BARAT,57724,11075,46649,39549,86198,2021-12-13
3175061004,JAKARTA TIMUR,CAKUNG,CAKUNG TIMUR,58287,10776,47511,40842,88353,2021-12-13
3175041007,JAKARTA TIMUR,KRAMAT JATI,CAWANG,32762,6493,26269,22176,48445,2021-12-13
3175101008,JAKARTA TIMUR,CIPAYUNG,CEGER,18932,3451,15481,13416,28897,2021-12-13
3171031006,JAKARTA PUSAT,KEMAYORAN,CEMPAKA BARU,32581,5765,26816,22968,49784,2021-12-13
3171051002,JAKARTA PUSAT,CEMPAKA PUTIH,CEMPAKA PUTIH BARAT,35885,7055,28830,25452,54282,2021-12-13
3171051001,JAKARTA PUSAT,CEMPAKA PUTIH,CEMPAKA PUTIH TIMUR,24292,4731,19561,17714,37275,2021-12-13
3173011001,JAKARTA BARAT,CENGKARENG,CENGKARENG BARAT,66284,12336,53948,47961,101909,2021-12-13
3173011006,JAKARTA BARAT,CENGKARENG,CENGKARENG TIMUR,81027,14984,66043,57146,123189,2021-12-13
3175091002,JAKARTA TIMUR,CIRACAS,CIBUBUR,66364,10752,55612,48991,104603,2021-12-13
3171011002,JAKARTA PUSAT,GAMBIR,CIDENG,15390,2871,12519,11202,23721,2021-12-13
3174091003,JAKARTA SELATAN,JAGAKARSA,CIGANJUR,38497,6039,32458,28409,60867,2021-12-13
3175051003,JAKARTA TIMUR,PASAR REBO,CIJANTUNG,41419,7193,34226,29783,64009,2021-12-13
3171061003,JAKARTA PUSAT,MENTENG,CIKINI,8274,1407,6867,5705,12572,2021-12-13
3174081006,JAKARTA SELATAN,PANCORAN,CIKOKO,10547,1714,8833,7886,16719,2021-12-13
3174061001,JAKARTA SELATAN,CILANDAK,CILANDAK BARAT,51752,8601,43151,39107,82258,2021-12-13
3174041003,JAKARTA SELATAN,PASAR MINGGU,CILANDAK TIMUR,25145,4257,20888,18501,39389,2021-12-13
3175101002,JAKARTA TIMUR,CIPAYUNG,CILANGKAP,27635,4607,23028,20317,43345,2021-12-13
3175041006,JAKARTA TIMUR,KRAMAT JATI,CILILITAN,40181,7861,32320,27357,59677,2021-12-13
3172041001,JAKARTA UTARA,CILINCING,CILINCING,43609,9680,33929,27568,61497,2021-12-13
3175101001,JAKARTA TIMUR,CIPAYUNG,CIPAYUNG,26104,4279,21825,19369,41194,2021-12-13
3174091006,JAKARTA SELATAN,JAGAKARSA,CIPEDAK,38303,5952,32351,28507,60858,2021-12-13
3174061005,JAKARTA SELATAN,CILANDAK,CIPETE SELATAN,26704,4778,21926,19931,41857,2021-12-13
3174071010,JAKARTA SELATAN,KEBAYORAN BARU,CIPETE UTARA,34102,6112,27990,24435,52425,2021-12-13
3175021003,JAKARTA TIMUR,PULO GADUNG,CIPINANG,39306,6638,32668,28368,61036,2021-12-13
3175031007,JAKARTA TIMUR,JATINEGARA,CIPINANG BESAR SELATAN,35212,7816,27396,22867,50263,2021-12-13
3175031008,JAKARTA TIMUR,JATINEGARA,CIPINANG BESAR UTARA,45319,9927,35392,29128,64520,2021-12-13
3175031005,JAKARTA TIMUR,JATINEGARA,CIPINANG CEMPEDAK,32824,6726,26098,23117,49215,2021-12-13
3175081005,JAKARTA TIMUR,MAKASAR,CIPINANG MELAYU,42308,7633,34675,30584,65259,2021-12-13
3175031006,JAKARTA TIMUR,JATINEGARA,CIPINANG MUARA,55243,10989,44254,37863,82117,2021-12-13
3174051003,JAKARTA SELATAN,KEBAYORAN LAMA,CIPULIR,39937,7919,32018,27409,59427,2021-12-13
3175091001,JAKARTA TIMUR,CIRACAS,CIRACAS,64594,11205,53389,45879,99268,2021-12-13
3175041003,JAKARTA TIMUR,KRAMAT JATI,DUKUH,24609,4267,20342,17417,37759,2021-12-13
3175071001,JAKARTA TIMUR,DUREN SAWIT,DUREN SAWIT,61160,12136,49024,42704,91728,2021-12-13
3174081004,JAKARTA SELATAN,PANCORAN,DUREN TIGA,28319,5246,23073,19983,43056,2021-12-13
3173051005,JAKARTA BARAT,KEBON JERUK,DURI KEPA,60138,11203,48935,43433,92368,2021-12-13
3173011002,JAKARTA BARAT,CENGKARENG,DURI KOSAMBI,77923,15401,62522,52437,114959,2021-12-13
3171011006,JAKARTA PUSAT,GAMBIR,DURI PULO,19610,3892,15718,13090,28808,2021-12-13
3173041011,JAKARTA BARAT,TAMBORA,DURI SELATAN,14259,2378,11881,10358,22239,2021-12-13
3173041003,JAKARTA BARAT,TAMBORA,DURI UTARA,19844,3344,16500,14078,30578,2021-12-13
3171081003,JAKARTA PUSAT,JOHAR BARU,GALUR,18243,3356,14887,12391,27278,2021-12-13
3171011001,JAKARTA PUSAT,GAMBIR,GAMBIR,2191,433,1758,1552,3310,2021-12-13
3174061004,JAKARTA SELATAN,CILANDAK,GANDARIA SELATAN,22119,3960,18159,16084,34243,2021-12-13
3174071009,JAKARTA SELATAN,KEBAYORAN BARU,GANDARIA UTARA,39922,7402,32520,28683,61203,2021-12-13
3175051001,JAKARTA TIMUR,PASAR REBO,GEDONG,35755,6718,29037,25426,54463,2021-12-13
3171071001,JAKARTA PUSAT,TANAH ABANG,GELORA,3127,584,2543,2285,4828,2021-12-13
3173031007,JAKARTA BARAT,TAMAN SARI,GLODOK,7837,1119,6718,6232,12950,2021-12-13
3171061004,JAKARTA PUSAT,MENTENG,GONDANGDIA,4100,887,3213,2996,6209,2021-12-13
3173021001,JAKARTA BARAT,GROGOL PETAMBURAN,GROGOL,16876,3126,13750,12032,25782,2021-12-13
3174051005,JAKARTA SELATAN,KEBAYORAN LAMA,GROGOL SELATAN,44251,8290,35961,31054,67015,2021-12-13
3174051004,JAKARTA SELATAN,KEBAYORAN LAMA,GROGOL UTARA,42494,8183,34311,29670,63981,2021-12-13
3174021007,JAKARTA SELATAN,SETIA BUDI,GUNTUR,3985,713,3272,2994,6266,2021-12-13
3174071002,JAKARTA SELATAN,KEBAYORAN BARU,GUNUNG,9436,1674,7762,7083,14845,2021-12-13
3171031005,JAKARTA PUSAT,KEMAYORAN,GUNUNG SAHARI SELATAN,19199,3491,15708,13716,29424,2021-12-13
3171021004,JAKARTA PUSAT,SAWAH BESAR,GUNUNG SAHARI UTARA,16650,2767,13883,12661,26544,2021-12-13
3175081004,JAKARTA TIMUR,MAKASAR,HALIM PERDANA KUSUMAH,28363,3412,24951,23235,48186,2021-12-13
3171031003,JAKARTA PUSAT,KEMAYORAN,HARAPAN MULIA,22557,4046,18511,15762,34273,2021-12-13
3174091001,JAKARTA SELATAN,JAGAKARSA,JAGAKARSA,62389,9534,52855,46966,99821,2021-12-13
3175021007,JAKARTA TIMUR,PULO GADUNG,JATI,32757,5755,27002,24324,51326,2021-12-13
3174041002,JAKARTA SELATAN,PASAR MINGGU,JATI PADANG,37502,6661,30841,27048,57889,2021-12-13
3173071004,JAKARTA BARAT,PALMERAH,JATI PULO,28738,5356,23382,19453,42835,2021-12-13
3175061001,JAKARTA TIMUR,CAKUNG,JATINEGARA,84160,16603,67557,57852,125409,2021-12-13
3175021004,JAKARTA TIMUR,PULO GADUNG,JATINEGARA KAUM,24632,4120,20512,17456,37968,2021-12-13
3173021004,JAKARTA BARAT,GROGOL PETAMBURAN,JELAMBAR,30266,5191,25075,22770,47845,2021-12-13
3173021006,JAKARTA BARAT,GROGOL PETAMBURAN,JELAMBAR BARU,38246,6392,31854,28728,60582,2021-12-13
3173041006,JAKARTA BARAT,TAMBORA,JEMBATAN BESI,29314,6626,22688,18517,41205,2021-12-13
3173041008,JAKARTA BARAT,TAMBORA,JEMBATAN LIMA,21021,4410,16611,13695,30306,2021-12-13
3173081005,JAKARTA BARAT,KEMBANGAN,JOGLO,40839,7690,33149,28994,62143,2021-12-13
3171081001,JAKARTA PUSAT,JOHAR BARU,JOHAR BARU,37488,6564,30924,26902,57826,2021-12-13
3173041002,JAKARTA BARAT,TAMBORA,KALI ANYAR,23856,4438,19418,16063,35481,2021-12-13
3172041004,JAKARTA UTARA,CILINCING,KALIBARU,67684,17124,50560,37726,88286,2021-12-13
3174081002,JAKARTA SELATAN,PANCORAN,KALIBATA,41994,8855,33139,28189,61328,2021-12-13
3173061001,JAKARTA BARAT,KALI DERES,KALIDERES,72447,13587,58860,51616,110476,2021-12-13
3175051004,JAKARTA TIMUR,PASAR REBO,KALISARI,43212,7158,36054,31619,67673,2021-12-13
3173061004,JAKARTA BARAT,KALI DERES,KAMAL,53783,11436,42347,35240,77587,2021-12-13
3172011002,JAKARTA UTARA,PENJARINGAN,KAMAL MUARA,12930,2216,10714,9262,19976,2021-12-13
3171071007,JAKARTA PUSAT,TANAH ABANG,KAMPUNG BALI,11358,2314,9044,7340,16384,2021-12-13
3175031001,JAKARTA TIMUR,JATINEGARA,KAMPUNG MELAYU,25717,5545,20172,16526,36698,2021-12-13
3171081002,JAKARTA PUSAT,JOHAR BARU,KAMPUNG RAWA,21237,3306,17931,14738,32669,2021-12-13
3175041002,JAKARTA TIMUR,KRAMAT JATI,KAMPUNG TENGAH,43993,10208,33785,28146,61931,2021-12-13
3173011005,JAKARTA BARAT,CENGKARENG,KAPUK,134466,30084,104382,87995,192377,2021-12-13
3172011003,JAKARTA UTARA,PENJARINGAN,KAPUK MUARA,35781,6487,29294,26508,55802,2021-12-13
3171021002,JAKARTA PUSAT,SAWAH BESAR,KARANG ANYAR,25761,4547,21214,18363,39577,2021-12-13
3174021004,JAKARTA SELATAN,SETIA BUDI,KARET,9623,1754,7869,6849,14718,2021-12-13
3174021003,JAKARTA SELATAN,SETIA BUDI,KARET KUNINGAN,16055,2947,13108,11516,24624,2021-12-13
3174021002,JAKARTA SELATAN,SETIA BUDI,KARET SEMANGGI,2770,532,2238,2030,4268,2021-12-13
3171071003,JAKARTA PUSAT,TANAH ABANG,KARET TENGSIN,19271,3525,15746,13438,29184,2021-12-13
3171021003,JAKARTA PUSAT,SAWAH BESAR,KARTINI,22292,3931,18361,16262,34623,2021-12-13
3175011003,JAKARTA TIMUR,MATRAMAN,KAYU MANIS,25284,4927,20357,17010,37367,2021-12-13
3175021006,JAKARTA TIMUR,PULO GADUNG,KAYU PUTIH,40696,7252,33444,30119,63563,2021-12-13
3173031006,JAKARTA BARAT,TAMAN SARI,KEAGUNGAN,17387,3030,14357,12197,26554,2021-12-13
3174041007,JAKARTA SELATAN,PASAR MINGGU,KEBAGUSAN,44552,8213,36339,31520,67859,2021-12-13
3174051006,JAKARTA SELATAN,KEBAYORAN LAMA,KEBAYORAN LAMA SELATAN,41212,7146,34066,30192,64258,2021-12-13
3174051001,JAKARTA SELATAN,KEBAYORAN LAMA,KEBAYORAN LAMA UTARA,42422,8271,34151,29668,63819,2021-12-13
3174011004,JAKARTA SELATAN,TEBET,KEBON BARU,35165,6099,29066,25383,54449,2021-12-13
3172021005,JAKARTA UTARA,TANJUNG PRIOK,KEBON BAWANG,50952,9588,41364,35741,77105,2021-12-13
3173051001,JAKARTA BARAT,KEBON JERUK,KEBON JERUK,53887,10309,43578,37174,80752,2021-12-13
3171071006,JAKARTA PUSAT,TANAH ABANG,KEBON KACANG,21531,4871,16660,13845,30505,2021-12-13
3171011005,JAKARTA PUSAT,GAMBIR,KEBON KELAPA,10163,1940,8223,7199,15422,2021-12-13
3171031002,JAKARTA PUSAT,KEMAYORAN,KEBON KOSONG,30019,5669,24350,20923,45273,2021-12-13
3175011005,JAKARTA TIMUR,MATRAMAN,KEBON MANGGIS,16490,2978,13512,11582,25094,2021-12-13
3171071005,JAKARTA PUSAT,TANAH ABANG,KEBON MELATI,32206,8138,24068,18790,42858,2021-12-13
3175081003,JAKARTA TIMUR,MAKASAR,KEBON PALA,46614,8634,37980,32945,70925,2021-12-13
3171061005,JAKARTA PUSAT,MENTENG,KEBON SIRIH,12299,2460,9839,8270,18109,2021-12-13
3173011004,JAKARTA BARAT,CENGKARENG,KEDAUNG KALI ANGKE,32612,5889,26723,23181,49904,2021-12-13
3173051007,JAKARTA BARAT,KEBON JERUK,KEDOYA SELATAN,32165,5555,26610,22832,49442,2021-12-13
3173051006,JAKARTA BARAT,KEBON JERUK,KEDOYA UTARA,45740,8283,37457,32505,69962,2021-12-13
3173051004,JAKARTA BARAT,KEBON JERUK,KELAPA DUA,23565,4342,19223,16672,35895,2021-12-13
3175091003,JAKARTA TIMUR,CIRACAS,KELAPA DUA WETAN,46875,7549,39326,34483,73809,2021-12-13
3172061003,JAKARTA UTARA,KELAPA GADING,KELAPA GADING BARAT,35717,5910,29807,27454,57261,2021-12-13
3172061001,JAKARTA UTARA,KELAPA GADING,KELAPA GADING TIMUR,33592,4880,28712,27124,55836,2021-12-13
3173071005,JAKARTA BARAT,PALMERAH,KEMANGGISAN,32139,5711,26428,23314,49742,2021-12-13
3171031001,JAKARTA PUSAT,KEMAYORAN,KEMAYORAN,20708,3857,16851,14426,31277,2021-12-13
3173081006,JAKARTA BARAT,KEMBANGAN,KEMBANGAN SELATAN,27130,5359,21771,19244,41015,2021-12-13
3173081001,JAKARTA BARAT,KEMBANGAN,KEMBANGAN UTARA,54451,10951,43500,37287,80787,2021-12-13
3171041002,JAKARTA PUSAT,SENEN,KENARI,9579,1775,7804,6839,14643,2021-12-13
3173041005,JAKARTA BARAT,TAMBORA,KERENDANG,19973,3814,16159,13726,29885,2021-12-13
3175071003,JAKARTA TIMUR,DUREN SAWIT,KLENDER,69978,15305,54673,45682,100355,2021-12-13
3172031001,JAKARTA UTARA,KOJA,KOJA,28175,5992,22183,18614,40797,2021-12-13
3173071006,JAKARTA BARAT,PALMERAH,KOTA BAMBU SELATAN,21158,3896,17262,14255,31517,2021-12-13
3173071003,JAKARTA BARAT,PALMERAH,KOTA BAMBU UTARA,24995,4764,20231,16558,36789,2021-12-13
3171041004,JAKARTA PUSAT,SENEN,KRAMAT,28835,6016,22819,17808,40627,2021-12-13
3175041001,JAKARTA TIMUR,KRAMAT JATI,KRAMAT JATI,34144,6748,27396,23159,50555,2021-12-13
3174071003,JAKARTA SELATAN,KEBAYORAN BARU,KRAMAT PELA,14413,2636,11777,10474,22251,2021-12-13
3173031002,JAKARTA BARAT,TAMAN SARI,KRUKUT,19244,3439,15805,13347,29152,2021-12-13
3174031005,JAKARTA SELATAN,MAMPANG PRAPATAN,KUNINGAN BARAT,12785,2172,10613,9257,19870,2021-12-13
3174021008,JAKARTA SELATAN,SETIA BUDI,KUNINGAN TIMUR,6008,1134,4874,4350,9224,2021-12-13
3171041005,JAKARTA PUSAT,SENEN,KWITANG,15486,3142,12344,10276,22620,2021-12-13
3172031003,JAKARTA UTARA,KOJA,LAGOA,59065,12949,46116,38126,84242,2021-12-13
3174061002,JAKARTA SELATAN,CILANDAK,LEBAK BULUS,37626,6661,30965,28201,59166,2021-12-13
3174091004,JAKARTA SELATAN,JAGAKARSA,LENTENG AGUNG,53946,8963,44983,38752,83735,2021-12-13
3175101007,JAKARTA TIMUR,CIPAYUNG,LUBANG BUAYA,63547,11253,52294,45238,97532,2021-12-13
3175081001,JAKARTA TIMUR,MAKASAR,MAKASAR,34390,5771,28619,25255,53874,2021-12-13
3175071006,JAKARTA TIMUR,DUREN SAWIT,MALAKA JAYA,30927,4844,26083,23363,49446,2021-12-13
3175071005,JAKARTA TIMUR,DUREN SAWIT,MALAKA SARI,27530,4242,23288,21047,44335,2021-12-13
3174031001,JAKARTA SELATAN,MAMPANG PRAPATAN,MAMPANG PRAPATAN,18159,3485,14674,12605,27279,2021-12-13
3173031005,JAKARTA BARAT,TAMAN SARI,MANGGA BESAR,7707,1241,6466,5852,12318,2021-12-13
3171021005,JAKARTA PUSAT,SAWAH BESAR,MANGGA DUA SELATAN,27442,5203,22239,19323,41562,2021-12-13
3174011007,JAKARTA SELATAN,TEBET,MANGGARAI,28373,4651,23722,20200,43922,2021-12-13
3174011006,JAKARTA SELATAN,TEBET,MANGGARAI SELATAN,23075,3461,19614,17120,36734,2021-12-13
3173031003,JAKARTA BARAT,TAMAN SARI,MAPHAR,16461,2899,13562,11742,25304,2021-12-13
3172041003,JAKARTA UTARA,CILINCING,MARUNDA,28943,6128,22815,17876,40691,2021-12-13
3174071001,JAKARTA SELATAN,KEBAYORAN BARU,MELAWAI,2627,488,2139,2010,4149,2021-12-13
3171061001,JAKARTA PUSAT,MENTENG,MENTENG,25624,5234,20390,16905,37295,2021-12-13
3174021005,JAKARTA SELATAN,SETIA BUDI,MENTENG ATAS,27816,4660,23156,20125,43281,2021-12-13
3174011003,JAKARTA SELATAN,TEBET,MENTENG DALAM,36028,6581,29447,25936,55383,2021-12-13
3173081003,JAKARTA BARAT,KEMBANGAN,MERUYA SELATAN,32130,6164,25966,22744,48710,2021-12-13
3173081002,JAKARTA BARAT,KEMBANGAN,MERUYA UTARA,43752,8458,35294,31641,66935,2021-12-13
3175101004,JAKARTA TIMUR,CIPAYUNG,MUNJUL,23871,4131,19740,17297,37037,2021-12-13
3172051002,JAKARTA UTARA,PADEMANGAN,PADEMANGAN BARAT,74240,16356,57884,48511,106395,2021-12-13
3172051001,JAKARTA UTARA,PADEMANGAN,PADEMANGAN TIMUR,37736,6261,31475,28601,60076,2021-12-13
3175011004,JAKARTA TIMUR,MATRAMAN,PAL MERIAM,19769,3725,16044,13497,29541,2021-12-13
3173071001,JAKARTA BARAT,PALMERAH,PALMERAH,63011,12307,50704,43117,93821,2021-12-13
3174081001,JAKARTA SELATAN,PANCORAN,PANCORAN,19421,3601,15820,13686,29506,2021-12-13
3172021003,JAKARTA UTARA,TANJUNG PRIOK,PAPANGGO,39097,7205,31892,27239,59131,2021-12-13
3171021001,JAKARTA PUSAT,SAWAH BESAR,PASAR BARU,12035,2177,9858,9026,18884,2021-12-13
3174021006,JAKARTA SELATAN,SETIA BUDI,PASAR MANGGIS,26752,4752,22000,18994,40994,2021-12-13
3174041001,JAKARTA SELATAN,PASAR MINGGU,PASAR MINGGU,24821,4398,20423,18146,38569,2021-12-13
3171041003,JAKARTA PUSAT,SENEN,PASEBAN,23533,4590,18943,16080,35023,2021-12-13
3173061005,JAKARTA BARAT,KALI DERES,PEGADUNGAN,75587,13808,61779,54476,116255,2021-12-13
3171061002,JAKARTA PUSAT,MENTENG,PEGANGSAAN,23455,4730,18725,15220,33945,2021-12-13
3172061002,JAKARTA UTARA,KELAPA GADING,PEGANGSAAN DUA,49976,7869,42107,38919,81026,2021-12-13
3172011004,JAKARTA UTARA,PENJARINGAN,PEJAGALAN,74578,14536,60042,53686,113728,2021-12-13
3174041006,JAKARTA SELATAN,PASAR MINGGU,PEJATEN BARAT,37346,6702,30644,26974,57618,2021-12-13
3174041005,JAKARTA SELATAN,PASAR MINGGU,PEJATEN TIMUR,57656,11521,46135,39006,85141,2021-12-13
3175051005,JAKARTA TIMUR,PASAR REBO,PEKAYON,43250,7313,35937,31234,67171,2021-12-13
3173041009,JAKARTA BARAT,TAMBORA,PEKOJAN,23587,4231,19356,16913,36269,2021-12-13
3174031003,JAKARTA SELATAN,MAMPANG PRAPATAN,PELA MAMPANG,43522,8040,35482,31131,66613,2021-12-13
3174081005,JAKARTA SELATAN,PANCORAN,PENGADEGAN,21478,3701,17777,15706,33483,2021-12-13
3175061003,JAKARTA TIMUR,CAKUNG,PENGGILINGAN,99255,21138,78117,65121,143238,2021-12-13
3172011001,JAKARTA UTARA,PENJARINGAN,PENJARINGAN,88308,21288,67020,54350,121370,2021-12-13
3174101001,JAKARTA SELATAN,PESANGGRAHAN,PESANGGRAHAN,27545,4461,23084,20494,43578,2021-12-13
3171071004,JAKARTA PUSAT,TANAH ABANG,PETAMBURAN,33271,8284,24987,19969,44956,2021-12-13
3174071008,JAKARTA SELATAN,KEBAYORAN BARU,PETOGOGAN,11499,2079,9420,8330,17750,2021-12-13
3171011004,JAKARTA PUSAT,GAMBIR,PETOJO SELATAN,14692,3119,11573,10143,21716,2021-12-13
3171011003,JAKARTA PUSAT,GAMBIR,PETOJO UTARA,17458,3541,13917,11823,25740,2021-12-13
3174101004,JAKARTA SELATAN,PESANGGRAHAN,PETUKANGAN SELATAN,37187,7190,29997,26378,56375,2021-12-13
3174101003,JAKARTA SELATAN,PESANGGRAHAN,PETUKANGAN UTARA,53716,10768,42948,37275,80223,2021-12-13
3175081002,JAKARTA TIMUR,MAKASAR,PINANG RANTI,27198,5558,21640,18572,40212,2021-12-13
3173031008,JAKARTA BARAT,TAMAN SARI,PINANGSIA,10729,1773,8956,7668,16624,2021-12-13
3175011001,JAKARTA TIMUR,MATRAMAN,PISANGAN BARU,31776,6107,25669,21458,47127,2021-12-13
3175021002,JAKARTA TIMUR,PULO GADUNG,PISANGAN TIMUR,41011,7072,33939,29913,63852,2021-12-13
3172011005,JAKARTA UTARA,PENJARINGAN,PLUIT,47783,8872,38911,34997,73908,2021-12-13
3175071002,JAKARTA TIMUR,DUREN SAWIT,PONDOK BAMBU,61550,12138,49412,43193,92605,2021-12-13
3175071004,JAKARTA TIMUR,DUREN SAWIT,PONDOK KELAPA,72015,13470,58545,52075,110620,2021-12-13
3175071007,JAKARTA TIMUR,DUREN SAWIT,PONDOK KOPI,35367,6251,29116,24731,53847,2021-12-13
3174061003,JAKARTA SELATAN,CILANDAK,PONDOK LABU,46464,7180,39284,35655,74939,2021-12-13
3174051002,JAKARTA SELATAN,KEBAYORAN LAMA,PONDOK PINANG,56169,10202,45967,40931,86898,2021-12-13
3175101003,JAKARTA TIMUR,CIPAYUNG,PONDOK RANGGON,25574,4534,21040,18501,39541,2021-12-13
3101011003,KAB.ADM.KEP.SERIBU,KEP. SERIBU UTARA,PULAU HARAPAN,2060,194,1866,1671,3537,2021-12-13
3101011002,KAB.ADM.KEP.SERIBU,KEP. SERIBU UTARA,PULAU KELAPA,5528,549,4979,4277,9256,2021-12-13
3101011001,KAB.ADM.KEP.SERIBU,KEP. SERIBU UTARA,PULAU PANGGANG,5450,415,5035,4587,9622,2021-12-13
3101021003,KAB.ADM.KEP.SERIBU,KEP. SERIBU SELATAN,PULAU PARI,2765,191,2574,2442,5016,2021-12-13
3101021002,KAB.ADM.KEP.SERIBU,KEP. SERIBU SELATAN,PULAU TIDUNG,4553,348,4205,3923,8128,2021-12-13
3101021001,KAB.ADM.KEP.SERIBU,KEP. SERIBU SELATAN,PULAU UNTUNG JAWA,1941,154,1787,1664,3451,2021-12-13
3174071007,JAKARTA SELATAN,KEBAYORAN BARU,PULO,5835,969,4866,4586,9452,2021-12-13
3175021001,JAKARTA TIMUR,PULO GADUNG,PULO GADUNG,34422,7073,27349,23684,51033,2021-12-13
3175061005,JAKARTA TIMUR,CAKUNG,PULO GEBANG,97301,17595,79706,67732,147438,2021-12-13
3174041004,JAKARTA SELATAN,PASAR MINGGU,RAGUNAN,39616,6548,33068,29331,62399,2021-12-13
3175091005,JAKARTA TIMUR,CIRACAS,RAMBUTAN,36771,8113,28658,24223,52881,2021-12-13
3172031006,JAKARTA UTARA,KOJA,RAWA BADAK SELATAN,42179,9308,32871,27097,59968,2021-12-13
3172031004,JAKARTA UTARA,KOJA,RAWA BADAK UTARA,34408,7200,27208,23025,50233,2021-12-13
3174071005,JAKARTA SELATAN,KEBAYORAN BARU,RAWA BARAT,5625,958,4667,4249,8916,2021-12-13
3173011003,JAKARTA BARAT,CENGKARENG,RAWA BUAYA,63799,11791,52008,44822,96830,2021-12-13
3175031004,JAKARTA TIMUR,JATINEGARA,RAWA BUNGA,21434,4724,16710,14162,30872,2021-12-13
3174081003,JAKARTA SELATAN,PANCORAN,RAWA JATI,20509,3676,16833,14918,31751,2021-12-13
3175061002,JAKARTA TIMUR,CAKUNG,RAWA TERATE,24637,4152,20485,17367,37852,2021-12-13
3175021005,JAKARTA TIMUR,PULO GADUNG,RAWAMANGUN,37612,6947,30665,27067,57732,2021-12-13
3171051003,JAKARTA PUSAT,CEMPAKA PUTIH,RAWASARI,21967,4154,17813,15802,33615,2021-12-13
3173041010,JAKARTA BARAT,TAMBORA,ROA MALAKA,3484,590,2894,2653,5547,2021-12-13
3172041006,JAKARTA UTARA,CILINCING,ROROTAN,41668,7877,33791,28441,62232,2021-12-13
3174071004,JAKARTA SELATAN,KEBAYORAN BARU,SELONG,2842,529,2313,2178,4491,2021-12-13
3173061002,JAKARTA BARAT,KALI DERES,SEMANAN,71354,13960,57394,48016,105410,2021-12-13
3172041007,JAKARTA UTARA,CILINCING,SEMPER BARAT,68587,12526,56061,48451,104512,2021-12-13
3172041005,JAKARTA UTARA,CILINCING,SEMPER TIMUR,36267,7215,29052,24465,53517,2021-12-13
3174071006,JAKARTA SELATAN,KEBAYORAN BARU,SENAYAN,2771,628,2143,1923,4066,2021-12-13
3171041001,JAKARTA PUSAT,SENEN,SENEN,6804,1359,5445,4660,10105,2021-12-13
3171031004,JAKARTA PUSAT,KEMAYORAN,SERDANG,29668,5295,24373,21193,45566,2021-12-13
3174021001,JAKARTA SELATAN,SETIA BUDI,SETIA BUDI,3023,577,2446,2167,4613,2021-12-13
3175101005,JAKARTA TIMUR,CIPAYUNG,SETU,20572,3870,16702,14305,31007,2021-12-13
3173071002,JAKARTA BARAT,PALMERAH,SLIPI,16591,2788,13803,12161,25964,2021-12-13
3173081004,JAKARTA BARAT,KEMBANGAN,SRENGSENG,45523,9471,36052,31430,67482,2021-12-13
3174091002,JAKARTA SELATAN,JAGAKARSA,SRENGSENG SAWAH,58196,8283,49913,44598,94511,2021-12-13
3173051003,JAKARTA BARAT,KEBON JERUK,SUKABUMI SELATAN,37033,7266,29767,24006,53773,2021-12-13
3173051002,JAKARTA BARAT,KEBON JERUK,SUKABUMI UTARA,38290,7967,30323,24603,54926,2021-12-13
3172041002,JAKARTA UTARA,CILINCING,SUKAPURA,53949,11425,42524,36336,78860,2021-12-13
3171031007,JAKARTA PUSAT,KEMAYORAN,SUMUR BATU,22717,4005,18712,16692,35404,2021-12-13
3172021004,JAKARTA UTARA,TANJUNG PRIOK,SUNGAI BAMBU,29876,5565,24311,20954,45265,2021-12-13
3172021006,JAKARTA UTARA,TANJUNG PRIOK,SUNTER AGUNG,71805,11714,60091,54375,114466,2021-12-13
3172021002,JAKARTA UTARA,TANJUNG PRIOK,SUNTER JAYA,63031,10409,52622,47234,99856,2021-12-13
3175091004,JAKARTA TIMUR,CIRACAS,SUSUKAN,38257,6778,31479,27161,58640,2021-12-13
3173031001,JAKARTA BARAT,TAMAN SARI,TAMAN SARI,14348,2471,11877,10523,22400,2021-12-13
3173041001,JAKARTA BARAT,TAMBORA,TAMBORA,10204,2010,8194,6841,15035,2021-12-13
3173041004,JAKARTA BARAT,TAMBORA,TANAH SEREAL,26387,4196,22191,19170,41361,2021-12-13
3171081004,JAKARTA PUSAT,JOHAR BARU,TANAH TINGGI,37693,6834,30859,25785,56644,2021-12-13
3173031004,JAKARTA BARAT,TAMAN SARI,TANGKI,13324,2105,11219,9866,21085,2021-12-13
3174091005,JAKARTA SELATAN,JAGAKARSA,TANJUNG BARAT,39770,6318,33452,29020,62472,2021-12-13
3173021005,JAKARTA BARAT,GROGOL PETAMBURAN,TANJUNG DUREN SELATAN,25337,4546,20791,18999,39790,2021-12-13
3173021002,JAKARTA BARAT,GROGOL PETAMBURAN,TANJUNG DUREN UTARA,17010,2703,14307,13219,27526,2021-12-13
3172021001,JAKARTA UTARA,TANJUNG PRIOK,TANJUNG PRIOK,34588,6728,27860,23554,51414,2021-12-13
3174011002,JAKARTA SELATAN,TEBET,TEBET BARAT,21194,3177,18017,16436,34453,2021-12-13
3174011001,JAKARTA SELATAN,TEBET,TEBET TIMUR,18199,2744,15455,14397,29852,2021-12-13
3173061003,JAKARTA BARAT,KALI DERES,TEGAL ALUR,83647,16258,67389,57728,125117,2021-12-13
3174031004,JAKARTA SELATAN,MAMPANG PRAPATAN,TEGAL PARANG,32401,6682,25719,21140,46859,2021-12-13
3173021003,JAKARTA BARAT,GROGOL PETAMBURAN,TOMANG,29605,5118,24487,21845,46332,2021-12-13
3172031005,JAKARTA UTARA,KOJA,TUGU SELATAN,39122,8071,31051,26133,57184,2021-12-13
3172031002,JAKARTA UTARA,KOJA,TUGU UTARA,67670,15067,52603,43575,96178,2021-12-13
3175061006,JAKARTA TIMUR,CAKUNG,UJUNG MENTENG,29934,4837,25097,22136,47233,2021-12-13
3174101005,JAKARTA SELATAN,PESANGGRAHAN,ULUJAMI,40544,8273,32271,27738,60009,2021-12-13
3175011006,JAKARTA TIMUR,MATRAMAN,UTAN KAYU SELATAN,33511,5600,27911,24137,52048,2021-12-13
3175011002,JAKARTA TIMUR,MATRAMAN,UTAN KAYU UTARA,28169,5326,22843,19412,42255,2021-12-13
3171031008,JAKARTA PUSAT,KEMAYORAN,UTAN PANJANG,29208,5400,23808,20117,43925,2021-12-13
3172021007,JAKARTA UTARA,TANJUNG PRIOK,WARAKAS,44401,7662,36739,30964,67703,2021-12-13
3173021007,JAKARTA BARAT,GROGOL PETAMBURAN,WIJAYA KUSUMA,38934,7545,31389,27405,58794,2021-12-13
3172051003,JAKARTA UTARA,PADEMANGAN,ANCOL,23947,5423,18524,15679,34203,2021-12-14
3173041007,JAKARTA BARAT,TAMBORA,ANGKE,29381,5808,23573,19754,43327,2021-12-14
3175041005,JAKARTA TIMUR,KRAMAT JATI,BALE KAMBANG,29074,6623,22451,18454,40905,2021-12-14
3175031003,JAKARTA TIMUR,JATINEGARA,BALI MESTER,9752,1857,7895,6898,14793,2021-12-14
3175101006,JAKARTA TIMUR,CIPAYUNG,BAMBU APUS,26285,4518,21767,19012,40779,2021-12-14
3174031002,JAKARTA SELATAN,MAMPANG PRAPATAN,BANGKA,21566,4268,17298,14923,32221,2021-12-14
3175051002,JAKARTA TIMUR,PASAR REBO,BARU,23886,3690,20196,18025,38221,2021-12-14
3175041004,JAKARTA TIMUR,KRAMAT JATI,BATU AMPAR,47898,10760,37138,31271,68409,2021-12-14
3171071002,JAKARTA PUSAT,TANAH ABANG,BENDUNGAN HILIR,21494,4101,17393,15337,32730,2021-12-14
3175031002,JAKARTA TIMUR,JATINEGARA,BIDARA CINA,36689,8260,28429,24140,52569,2021-12-14
3174101002,JAKARTA SELATAN,PESANGGRAHAN,BINTARO,53098,10044,43054,38748,81802,2021-12-14
3174011005,JAKARTA SELATAN,TEBET,BUKIT DURI,34183,6408,27775,24090,51865,2021-12-14
3171041006,JAKARTA PUSAT,SENEN,BUNGUR,18144,3548,14596,12522,27118,2021-12-14
3175061007,JAKARTA TIMUR,CAKUNG,CAKUNG BARAT,57724,11058,46666,39578,86244,2021-12-14
3175061004,JAKARTA TIMUR,CAKUNG,CAKUNG TIMUR,58287,10761,47526,40882,88408,2021-12-14
3175041007,JAKARTA TIMUR,KRAMAT JATI,CAWANG,32762,6479,26283,22202,48485,2021-12-14
3175101008,JAKARTA TIMUR,CIPAYUNG,CEGER,18932,3443,15489,13441,28930,2021-12-14
3171031006,JAKARTA PUSAT,KEMAYORAN,CEMPAKA BARU,32581,5755,26826,23016,49842,2021-12-14
3171051002,JAKARTA PUSAT,CEMPAKA PUTIH,CEMPAKA PUTIH BARAT,35885,7038,28847,25469,54316,2021-12-14
3171051001,JAKARTA PUSAT,CEMPAKA PUTIH,CEMPAKA PUTIH TIMUR,24292,4726,19566,17724,37290,2021-12-14
3173011001,JAKARTA BARAT,CENGKARENG,CENGKARENG BARAT,66284,12308,53976,48008,101984,2021-12-14
3173011006,JAKARTA BARAT,CENGKARENG,CENGKARENG TIMUR,81027,14948,66079,57207,123286,2021-12-14
3175091002,JAKARTA TIMUR,CIRACAS,CIBUBUR,66364,10740,55624,49017,104641,2021-12-14
3171011002,JAKARTA PUSAT,GAMBIR,CIDENG,15390,2868,12522,11208,23730,2021-12-14
3174091003,JAKARTA SELATAN,JAGAKARSA,CIGANJUR,38497,6027,32470,28433,60903,2021-12-14
3175051003,JAKARTA TIMUR,PASAR REBO,CIJANTUNG,41419,7175,34244,29819,64063,2021-12-14
3171061003,JAKARTA PUSAT,MENTENG,CIKINI,8274,1403,6871,5712,12583,2021-12-14
3174081006,JAKARTA SELATAN,PANCORAN,CIKOKO,10547,1712,8835,7888,16723,2021-12-14
3174061001,JAKARTA SELATAN,CILANDAK,CILANDAK BARAT,51752,8592,43160,39141,82301,2021-12-14
3174041003,JAKARTA SELATAN,PASAR MINGGU,CILANDAK TIMUR,25145,4256,20889,18518,39407,2021-12-14
3175101002,JAKARTA TIMUR,CIPAYUNG,CILANGKAP,27635,4602,23033,20347,43380,2021-12-14
3175041006,JAKARTA TIMUR,KRAMAT JATI,CILILITAN,40181,7851,32330,27407,59737,2021-12-14
3172041001,JAKARTA UTARA,CILINCING,CILINCING,43609,9664,33945,27610,61555,2021-12-14
3175101001,JAKARTA TIMUR,CIPAYUNG,CIPAYUNG,26104,4271,21833,19380,41213,2021-12-14
3174091006,JAKARTA SELATAN,JAGAKARSA,CIPEDAK,38303,5940,32363,28528,60891,2021-12-14
3174061005,JAKARTA SELATAN,CILANDAK,CIPETE SELATAN,26704,4774,21930,19938,41868,2021-12-14
3174071010,JAKARTA SELATAN,KEBAYORAN BARU,CIPETE UTARA,34102,6107,27995,24464,52459,2021-12-14
3175021003,JAKARTA TIMUR,PULO GADUNG,CIPINANG,39306,6621,32685,28402,61087,2021-12-14
3175031007,JAKARTA TIMUR,JATINEGARA,CIPINANG BESAR SELATAN,35212,7788,27424,22899,50323,2021-12-14
3175031008,JAKARTA TIMUR,JATINEGARA,CIPINANG BESAR UTARA,45319,9900,35419,29213,64632,2021-12-14
3175031005,JAKARTA TIMUR,JATINEGARA,CIPINANG CEMPEDAK,32824,6715,26109,23145,49254,2021-12-14
3175081005,JAKARTA TIMUR,MAKASAR,CIPINANG MELAYU,42308,7576,34732,30652,65384,2021-12-14
3175031006,JAKARTA TIMUR,JATINEGARA,CIPINANG MUARA,55243,10951,44292,37895,82187,2021-12-14
3174051003,JAKARTA SELATAN,KEBAYORAN LAMA,CIPULIR,39937,7909,32028,27444,59472,2021-12-14
3175091001,JAKARTA TIMUR,CIRACAS,CIRACAS,64594,11193,53401,45910,99311,2021-12-14
3175041003,JAKARTA TIMUR,KRAMAT JATI,DUKUH,24609,4262,20347,17430,37777,2021-12-14
3175071001,JAKARTA TIMUR,DUREN SAWIT,DUREN SAWIT,61160,12109,49051,42763,91814,2021-12-14
3174081004,JAKARTA SELATAN,PANCORAN,DUREN TIGA,28319,5244,23075,19993,43068,2021-12-14
3173051005,JAKARTA BARAT,KEBON JERUK,DURI KEPA,60138,11187,48951,43467,92418,2021-12-14
3173011002,JAKARTA BARAT,CENGKARENG,DURI KOSAMBI,77923,15367,62556,52498,115054,2021-12-14
3171011006,JAKARTA PUSAT,GAMBIR,DURI PULO,19610,3884,15726,13101,28827,2021-12-14
3173041011,JAKARTA BARAT,TAMBORA,DURI SELATAN,14259,2374,11885,10365,22250,2021-12-14
3173041003,JAKARTA BARAT,TAMBORA,DURI UTARA,19844,3336,16508,14094,30602,2021-12-14
3171081003,JAKARTA PUSAT,JOHAR BARU,GALUR,18243,3355,14888,12397,27285,2021-12-14
3171011001,JAKARTA PUSAT,GAMBIR,GAMBIR,2191,431,1760,1553,3313,2021-12-14
3174061004,JAKARTA SELATAN,CILANDAK,GANDARIA SELATAN,22119,3952,18167,16093,34260,2021-12-14
3174071009,JAKARTA SELATAN,KEBAYORAN BARU,GANDARIA UTARA,39922,7390,32532,28704,61236,2021-12-14
3175051001,JAKARTA TIMUR,PASAR REBO,GEDONG,35755,6703,29052,25448,54500,2021-12-14
3171071001,JAKARTA PUSAT,TANAH ABANG,GELORA,3127,584,2543,2288,4831,2021-12-14
3173031007,JAKARTA BARAT,TAMAN SARI,GLODOK,7837,1119,6718,6236,12954,2021-12-14
3171061004,JAKARTA PUSAT,MENTENG,GONDANGDIA,4100,887,3213,2998,6211,2021-12-14
3173021001,JAKARTA BARAT,GROGOL PETAMBURAN,GROGOL,16876,3124,13752,12056,25808,2021-12-14
3174051005,JAKARTA SELATAN,KEBAYORAN LAMA,GROGOL SELATAN,44251,8278,35973,31074,67047,2021-12-14
3174051004,JAKARTA SELATAN,KEBAYORAN LAMA,GROGOL UTARA,42494,8174,34320,29695,64015,2021-12-14
3174021007,JAKARTA SELATAN,SETIA BUDI,GUNTUR,3985,713,3272,2999,6271,2021-12-14
3174071002,JAKARTA SELATAN,KEBAYORAN BARU,GUNUNG,9436,1671,7765,7088,14853,2021-12-14
3171031005,JAKARTA PUSAT,KEMAYORAN,GUNUNG SAHARI SELATAN,19199,3471,15728,13756,29484,2021-12-14
3171021004,JAKARTA PUSAT,SAWAH BESAR,GUNUNG SAHARI UTARA,16650,2763,13887,12674,26561,2021-12-14
3175081004,JAKARTA TIMUR,MAKASAR,HALIM PERDANA KUSUMAH,28363,3409,24954,23245,48199,2021-12-14
3171031003,JAKARTA PUSAT,KEMAYORAN,HARAPAN MULIA,22557,4035,18522,15776,34298,2021-12-14
3174091001,JAKARTA SELATAN,JAGAKARSA,JAGAKARSA,62389,9515,52874,47010,99884,2021-12-14
3175021007,JAKARTA TIMUR,PULO GADUNG,JATI,32757,5737,27020,24346,51366,2021-12-14
3174041002,JAKARTA SELATAN,PASAR MINGGU,JATI PADANG,37502,6652,30850,27088,57938,2021-12-14
3173071004,JAKARTA BARAT,PALMERAH,JATI PULO,28738,5346,23392,19471,42863,2021-12-14
3175061001,JAKARTA TIMUR,CAKUNG,JATINEGARA,84160,16576,67584,57908,125492,2021-12-14
3175021004,JAKARTA TIMUR,PULO GADUNG,JATINEGARA KAUM,24632,4114,20518,17480,37998,2021-12-14
3173021004,JAKARTA BARAT,GROGOL PETAMBURAN,JELAMBAR,30266,5178,25088,22802,47890,2021-12-14
3173021006,JAKARTA BARAT,GROGOL PETAMBURAN,JELAMBAR BARU,38246,6386,31860,28753,60613,2021-12-14
3173041006,JAKARTA BARAT,TAMBORA,JEMBATAN BESI,29314,6600,22714,18536,41250,2021-12-14
3173041008,JAKARTA BARAT,TAMBORA,JEMBATAN LIMA,21021,4397,16624,13710,30334,2021-12-14
3173081005,JAKARTA BARAT,KEMBANGAN,JOGLO,40839,7684,33155,29011,62166,2021-12-14
3171081001,JAKARTA PUSAT,JOHAR BARU,JOHAR BARU,37488,6556,30932,26917,57849,2021-12-14
3173041002,JAKARTA BARAT,TAMBORA,KALI ANYAR,23856,4418,19438,16087,35525,2021-12-14
3172041004,JAKARTA UTARA,CILINCING,KALIBARU,67684,17091,50593,37795,88388,2021-12-14
3174081002,JAKARTA SELATAN,PANCORAN,KALIBATA,41994,8833,33161,28209,61370,2021-12-14
3173061001,JAKARTA BARAT,KALI DERES,KALIDERES,72447,13577,58870,51680,110550,2021-12-14
3175051004,JAKARTA TIMUR,PASAR REBO,KALISARI,43212,7139,36073,31646,67719,2021-12-14
3173061004,JAKARTA BARAT,KALI DERES,KAMAL,53783,11424,42359,35270,77629,2021-12-14
3172011002,JAKARTA UTARA,PENJARINGAN,KAMAL MUARA,12930,2216,10714,9268,19982,2021-12-14
3171071007,JAKARTA PUSAT,TANAH ABANG,KAMPUNG BALI,11358,2309,9049,7366,16415,2021-12-14
3175031001,JAKARTA TIMUR,JATINEGARA,KAMPUNG MELAYU,25717,5531,20186,16541,36727,2021-12-14
3171081002,JAKARTA PUSAT,JOHAR BARU,KAMPUNG RAWA,21237,3298,17939,14751,32690,2021-12-14
3175041002,JAKARTA TIMUR,KRAMAT JATI,KAMPUNG TENGAH,43993,10182,33811,28174,61985,2021-12-14
3173011005,JAKARTA BARAT,CENGKARENG,KAPUK,134466,29950,104516,88097,192613,2021-12-14
3172011003,JAKARTA UTARA,PENJARINGAN,KAPUK MUARA,35781,6474,29307,26540,55847,2021-12-14
3171021002,JAKARTA PUSAT,SAWAH BESAR,KARANG ANYAR,25761,4534,21227,18387,39614,2021-12-14
3174021004,JAKARTA SELATAN,SETIA BUDI,KARET,9623,1749,7874,6855,14729,2021-12-14
3174021003,JAKARTA SELATAN,SETIA BUDI,KARET KUNINGAN,16055,2943,13112,11518,24630,2021-12-14
3174021002,JAKARTA SELATAN,SETIA BUDI,KARET SEMANGGI,2770,531,2239,2032,4271,2021-12-14
3171071003,JAKARTA PUSAT,TANAH ABANG,KARET TENGSIN,19271,3515,15756,13447,29203,2021-12-14
3171021003,JAKARTA PUSAT,SAWAH BESAR,KARTINI,22292,3929,18363,16277,34640,2021-12-14
3175011003,JAKARTA TIMUR,MATRAMAN,KAYU MANIS,25284,4913,20371,17024,37395,2021-12-14
3175021006,JAKARTA TIMUR,PULO GADUNG,KAYU PUTIH,40696,7238,33458,30144,63602,2021-12-14
3173031006,JAKARTA BARAT,TAMAN SARI,KEAGUNGAN,17387,3018,14369,12207,26576,2021-12-14
3174041007,JAKARTA SELATAN,PASAR MINGGU,KEBAGUSAN,44552,8191,36361,31548,67909,2021-12-14
3174051006,JAKARTA SELATAN,KEBAYORAN LAMA,KEBAYORAN LAMA SELATAN,41212,7134,34078,30206,64284,2021-12-14
3174051001,JAKARTA SELATAN,KEBAYORAN LAMA,KEBAYORAN LAMA UTARA,42422,8254,34168,29698,63866,2021-12-14
3174011004,JAKARTA SELATAN,TEBET,KEBON BARU,35165,6083,29082,25433,54515,2021-12-14
3172021005,JAKARTA UTARA,TANJUNG PRIOK,KEBON BAWANG,50952,9561,41391,35791,77182,2021-12-14
3173051001,JAKARTA BARAT,KEBON JERUK,KEBON JERUK,53887,10289,43598,37246,80844,2021-12-14
3171071006,JAKARTA PUSAT,TANAH ABANG,KEBON KACANG,21531,4862,16669,13865,30534,2021-12-14
3171011005,JAKARTA PUSAT,GAMBIR,KEBON KELAPA,10163,1939,8224,7203,15427,2021-12-14
3171031002,JAKARTA PUSAT,KEMAYORAN,KEBON KOSONG,30019,5659,24360,20956,45316,2021-12-14
3175011005,JAKARTA TIMUR,MATRAMAN,KEBON MANGGIS,16490,2973,13517,11592,25109,2021-12-14
3171071005,JAKARTA PUSAT,TANAH ABANG,KEBON MELATI,32206,8134,24072,18799,42871,2021-12-14
3175081003,JAKARTA TIMUR,MAKASAR,KEBON PALA,46614,8609,38005,32993,70998,2021-12-14
3171061005,JAKARTA PUSAT,MENTENG,KEBON SIRIH,12299,2457,9842,8274,18116,2021-12-14
3173011004,JAKARTA BARAT,CENGKARENG,KEDAUNG KALI ANGKE,32612,5871,26741,23208,49949,2021-12-14
3173051007,JAKARTA BARAT,KEBON JERUK,KEDOYA SELATAN,32165,5550,26615,22865,49480,2021-12-14
3173051006,JAKARTA BARAT,KEBON JERUK,KEDOYA UTARA,45740,8268,37472,32527,69999,2021-12-14
3173051004,JAKARTA BARAT,KEBON JERUK,KELAPA DUA,23565,4334,19231,16690,35921,2021-12-14
3175091003,JAKARTA TIMUR,CIRACAS,KELAPA DUA WETAN,46875,7537,39338,34513,73851,2021-12-14
3172061003,JAKARTA UTARA,KELAPA GADING,KELAPA GADING BARAT,35717,5905,29812,27475,57287,2021-12-14
3172061001,JAKARTA UTARA,KELAPA GADING,KELAPA GADING TIMUR,33592,4875,28717,27136,55853,2021-12-14
3173071005,JAKARTA BARAT,PALMERAH,KEMANGGISAN,32139,5707,26432,23339,49771,2021-12-14
3171031001,JAKARTA PUSAT,KEMAYORAN,KEMAYORAN,20708,3848,16860,14441,31301,2021-12-14
3173081006,JAKARTA BARAT,KEMBANGAN,KEMBANGAN SELATAN,27130,5350,21780,19260,41040,2021-12-14
3173081001,JAKARTA BARAT,KEMBANGAN,KEMBANGAN UTARA,54451,10889,43562,37357,80919,2021-12-14
3171041002,JAKARTA PUSAT,SENEN,KENARI,9579,1773,7806,6844,14650,2021-12-14
3173041005,JAKARTA BARAT,TAMBORA,KERENDANG,19973,3808,16165,13741,29906,2021-12-14
3175071003,JAKARTA TIMUR,DUREN SAWIT,KLENDER,69978,15278,54700,45740,100440,2021-12-14
3172031001,JAKARTA UTARA,KOJA,KOJA,28175,5946,22229,18631,40860,2021-12-14
3173071006,JAKARTA BARAT,PALMERAH,KOTA BAMBU SELATAN,21158,3887,17271,14277,31548,2021-12-14
3173071003,JAKARTA BARAT,PALMERAH,KOTA BAMBU UTARA,24995,4751,20244,16576,36820,2021-12-14
3171041004,JAKARTA PUSAT,SENEN,KRAMAT,28835,6000,22835,17834,40669,2021-12-14
3175041001,JAKARTA TIMUR,KRAMAT JATI,KRAMAT JATI,34144,6736,27408,23202,50610,2021-12-14
3174071003,JAKARTA SELATAN,KEBAYORAN BARU,KRAMAT PELA,14413,2628,11785,10485,22270,2021-12-14
3173031002,JAKARTA BARAT,TAMAN SARI,KRUKUT,19244,3435,15809,13360,29169,2021-12-14
3174031005,JAKARTA SELATAN,MAMPANG PRAPATAN,KUNINGAN BARAT,12785,2169,10616,9265,19881,2021-12-14
3174021008,JAKARTA SELATAN,SETIA BUDI,KUNINGAN TIMUR,6008,1131,4877,4356,9233,2021-12-14
3171041005,JAKARTA PUSAT,SENEN,KWITANG,15486,3132,12354,10290,22644,2021-12-14
3172031003,JAKARTA UTARA,KOJA,LAGOA,59065,12929,46136,38183,84319,2021-12-14
3174061002,JAKARTA SELATAN,CILANDAK,LEBAK BULUS,37626,6641,30985,28229,59214,2021-12-14
3174091004,JAKARTA SELATAN,JAGAKARSA,LENTENG AGUNG,53946,8944,45002,38784,83786,2021-12-14
3175101007,JAKARTA TIMUR,CIPAYUNG,LUBANG BUAYA,63547,11244,52303,45264,97567,2021-12-14
3175081001,JAKARTA TIMUR,MAKASAR,MAKASAR,34390,5763,28627,25276,53903,2021-12-14
3175071006,JAKARTA TIMUR,DUREN SAWIT,MALAKA JAYA,30927,4834,26093,23396,49489,2021-12-14
3175071005,JAKARTA TIMUR,DUREN SAWIT,MALAKA SARI,27530,4232,23298,21067,44365,2021-12-14
3174031001,JAKARTA SELATAN,MAMPANG PRAPATAN,MAMPANG PRAPATAN,18159,3482,14677,12619,27296,2021-12-14
3173031005,JAKARTA BARAT,TAMAN SARI,MANGGA BESAR,7707,1238,6469,5856,12325,2021-12-14
3171021005,JAKARTA PUSAT,SAWAH BESAR,MANGGA DUA SELATAN,27442,5192,22250,19339,41589,2021-12-14
3174011007,JAKARTA SELATAN,TEBET,MANGGARAI,28373,4647,23726,20215,43941,2021-12-14
3174011006,JAKARTA SELATAN,TEBET,MANGGARAI SELATAN,23075,3458,19617,17125,36742,2021-12-14
3173031003,JAKARTA BARAT,TAMAN SARI,MAPHAR,16461,2892,13569,11759,25328,2021-12-14
3172041003,JAKARTA UTARA,CILINCING,MARUNDA,28943,6116,22827,17910,40737,2021-12-14
3174071001,JAKARTA SELATAN,KEBAYORAN BARU,MELAWAI,2627,488,2139,2012,4151,2021-12-14
3171061001,JAKARTA PUSAT,MENTENG,MENTENG,25624,5228,20396,16930,37326,2021-12-14
3174021005,JAKARTA SELATAN,SETIA BUDI,MENTENG ATAS,27816,4653,23163,20151,43314,2021-12-14
3174011003,JAKARTA SELATAN,TEBET,MENTENG DALAM,36028,6566,29462,25952,55414,2021-12-14
3173081003,JAKARTA BARAT,KEMBANGAN,MERUYA SELATAN,32130,6152,25978,22775,48753,2021-12-14
3173081002,JAKARTA BARAT,KEMBANGAN,MERUYA UTARA,43752,8442,35310,31667,66977,2021-12-14
3175101004,JAKARTA TIMUR,CIPAYUNG,MUNJUL,23871,4124,19747,17314,37061,2021-12-14
3172051002,JAKARTA UTARA,PADEMANGAN,PADEMANGAN BARAT,74240,16324,57916,48564,106480,2021-12-14
3172051001,JAKARTA UTARA,PADEMANGAN,PADEMANGAN TIMUR,37736,6252,31484,28628,60112,2021-12-14
3175011004,JAKARTA TIMUR,MATRAMAN,PAL MERIAM,19769,3717,16052,13516,29568,2021-12-14
3173071001,JAKARTA BARAT,PALMERAH,PALMERAH,63011,12286,50725,43155,93880,2021-12-14
3174081001,JAKARTA SELATAN,PANCORAN,PANCORAN,19421,3596,15825,13690,29515,2021-12-14
3172021003,JAKARTA UTARA,TANJUNG PRIOK,PAPANGGO,39097,7191,31906,27273,59179,2021-12-14
3171021001,JAKARTA PUSAT,SAWAH BESAR,PASAR BARU,12035,2175,9860,9030,18890,2021-12-14
3174021006,JAKARTA SELATAN,SETIA BUDI,PASAR MANGGIS,26752,4743,22009,19022,41031,2021-12-14
3174041001,JAKARTA SELATAN,PASAR MINGGU,PASAR MINGGU,24821,4384,20437,18173,38610,2021-12-14
3171041003,JAKARTA PUSAT,SENEN,PASEBAN,23533,4581,18952,16103,35055,2021-12-14
3173061005,JAKARTA BARAT,KALI DERES,PEGADUNGAN,75587,13792,61795,54509,116304,2021-12-14
3171061002,JAKARTA PUSAT,MENTENG,PEGANGSAAN,23455,4725,18730,15241,33971,2021-12-14
3172061002,JAKARTA UTARA,KELAPA GADING,PEGANGSAAN DUA,49976,7854,42122,38942,81064,2021-12-14
3172011004,JAKARTA UTARA,PENJARINGAN,PEJAGALAN,74578,14506,60072,53738,113810,2021-12-14
3174041006,JAKARTA SELATAN,PASAR MINGGU,PEJATEN BARAT,37346,6685,30661,27007,57668,2021-12-14
3174041005,JAKARTA SELATAN,PASAR MINGGU,PEJATEN TIMUR,57656,11485,46171,39129,85300,2021-12-14
3175051005,JAKARTA TIMUR,PASAR REBO,PEKAYON,43250,7294,35956,31270,67226,2021-12-14
3173041009,JAKARTA BARAT,TAMBORA,PEKOJAN,23587,4227,19360,16924,36284,2021-12-14
3174031003,JAKARTA SELATAN,MAMPANG PRAPATAN,PELA MAMPANG,43522,8029,35493,31149,66642,2021-12-14
3174081005,JAKARTA SELATAN,PANCORAN,PENGADEGAN,21478,3696,17782,15713,33495,2021-12-14
3175061003,JAKARTA TIMUR,CAKUNG,PENGGILINGAN,99255,21088,78167,65194,143361,2021-12-14
3172011001,JAKARTA UTARA,PENJARINGAN,PENJARINGAN,88308,21231,67077,54430,121507,2021-12-14
3174101001,JAKARTA SELATAN,PESANGGRAHAN,PESANGGRAHAN,27545,4450,23095,20523,43618,2021-12-14
3171071004,JAKARTA PUSAT,TANAH ABANG,PETAMBURAN,33271,8263,25008,19998,45006,2021-12-14
3174071008,JAKARTA SELATAN,KEBAYORAN BARU,PETOGOGAN,11499,2077,9422,8338,17760,2021-12-14
3171011004,JAKARTA PUSAT,GAMBIR,PETOJO SELATAN,14692,3116,11576,10158,21734,2021-12-14
3171011003,JAKARTA PUSAT,GAMBIR,PETOJO UTARA,17458,3535,13923,11829,25752,2021-12-14
3174101004,JAKARTA SELATAN,PESANGGRAHAN,PETUKANGAN SELATAN,37187,7176,30011,26403,56414,2021-12-14
3174101003,JAKARTA SELATAN,PESANGGRAHAN,PETUKANGAN UTARA,53716,10749,42967,37311,80278,2021-12-14
3175081002,JAKARTA TIMUR,MAKASAR,PINANG RANTI,27198,5554,21644,18584,40228,2021-12-14
3173031008,JAKARTA BARAT,TAMAN SARI,PINANGSIA,10729,1772,8957,7673,16630,2021-12-14
3175011001,JAKARTA TIMUR,MATRAMAN,PISANGAN BARU,31776,6097,25679,21477,47156,2021-12-14
3175021002,JAKARTA TIMUR,PULO GADUNG,PISANGAN TIMUR,41011,7052,33959,29955,63914,2021-12-14
3172011005,JAKARTA UTARA,PENJARINGAN,PLUIT,47783,8859,38924,35016,73940,2021-12-14
3175071002,JAKARTA TIMUR,DUREN SAWIT,PONDOK BAMBU,61550,12108,49442,43253,92695,2021-12-14
3175071004,JAKARTA TIMUR,DUREN SAWIT,PONDOK KELAPA,72015,13402,58613,52143,110756,2021-12-14
3175071007,JAKARTA TIMUR,DUREN SAWIT,PONDOK KOPI,35367,6237,29130,24754,53884,2021-12-14
3174061003,JAKARTA SELATAN,CILANDAK,PONDOK LABU,46464,7171,39293,35671,74964,2021-12-14
3174051002,JAKARTA SELATAN,KEBAYORAN LAMA,PONDOK PINANG,56169,10191,45978,40971,86949,2021-12-14
3175101003,JAKARTA TIMUR,CIPAYUNG,PONDOK RANGGON,25574,4529,21045,18544,39589,2021-12-14
3101011003,KAB.ADM.KEP.SERIBU,KEP. SERIBU UTARA,PULAU HARAPAN,2060,193,1867,1672,3539,2021-12-14
3101011002,KAB.ADM.KEP.SERIBU,KEP. SERIBU UTARA,PULAU KELAPA,5528,546,4982,4293,9275,2021-12-14
3101011001,KAB.ADM.KEP.SERIBU,KEP. SERIBU UTARA,PULAU PANGGANG,5450,415,5035,4589,9624,2021-12-14
3101021003,KAB.ADM.KEP.SERIBU,KEP. SERIBU SELATAN,PULAU PARI,2765,191,2574,2442,5016,2021-12-14
3101021002,KAB.ADM.KEP.SERIBU,KEP. SERIBU SELATAN,PULAU TIDUNG,4553,347,4206,3927,8133,2021-12-14
3101021001,KAB.ADM.KEP.SERIBU,KEP. SERIBU SELATAN,PULAU UNTUNG JAWA,1941,154,1787,1671,3458,2021-12-14
3174071007,JAKARTA SELATAN,KEBAYORAN BARU,PULO,5835,965,4870,4588,9458,2021-12-14
3175021001,JAKARTA TIMUR,PULO GADUNG,PULO GADUNG,34422,7062,27360,23716,51076,2021-12-14
3175061005,JAKARTA TIMUR,CAKUNG,PULO GEBANG,97301,17572,79729,67792,147521,2021-12-14
3174041004,JAKARTA SELATAN,PASAR MINGGU,RAGUNAN,39616,6524,33092,29353,62445,2021-12-14
3175091005,JAKARTA TIMUR,CIRACAS,RAMBUTAN,36771,8055,28716,24258,52974,2021-12-14
3172031006,JAKARTA UTARA,KOJA,RAWA BADAK SELATAN,42179,9284,32895,27133,60028,2021-12-14
3172031004,JAKARTA UTARA,KOJA,RAWA BADAK UTARA,34408,7180,27228,23065,50293,2021-12-14
3174071005,JAKARTA SELATAN,KEBAYORAN BARU,RAWA BARAT,5625,958,4667,4252,8919,2021-12-14
3173011003,JAKARTA BARAT,CENGKARENG,RAWA BUAYA,63799,11769,52030,44874,96904,2021-12-14
3175031004,JAKARTA TIMUR,JATINEGARA,RAWA BUNGA,21434,4712,16722,14178,30900,2021-12-14
3174081003,JAKARTA SELATAN,PANCORAN,RAWA JATI,20509,3665,16844,14932,31776,2021-12-14
3175061002,JAKARTA TIMUR,CAKUNG,RAWA TERATE,24637,4146,20491,17382,37873,2021-12-14
3175021005,JAKARTA TIMUR,PULO GADUNG,RAWAMANGUN,37612,6936,30676,27096,57772,2021-12-14
3171051003,JAKARTA PUSAT,CEMPAKA PUTIH,RAWASARI,21967,4144,17823,15817,33640,2021-12-14
3173041010,JAKARTA BARAT,TAMBORA,ROA MALAKA,3484,589,2895,2653,5548,2021-12-14
3172041006,JAKARTA UTARA,CILINCING,ROROTAN,41668,7857,33811,28481,62292,2021-12-14
3174071004,JAKARTA SELATAN,KEBAYORAN BARU,SELONG,2842,529,2313,2178,4491,2021-12-14
3173061002,JAKARTA BARAT,KALI DERES,SEMANAN,71354,13935,57419,48074,105493,2021-12-14
3172041007,JAKARTA UTARA,CILINCING,SEMPER BARAT,68587,12491,56096,48504,104600,2021-12-14
3172041005,JAKARTA UTARA,CILINCING,SEMPER TIMUR,36267,7184,29083,24507,53590,2021-12-14
3174071006,JAKARTA SELATAN,KEBAYORAN BARU,SENAYAN,2771,628,2143,1923,4066,2021-12-14
3171041001,JAKARTA PUSAT,SENEN,SENEN,6804,1359,5445,4662,10107,2021-12-14
3171031004,JAKARTA PUSAT,KEMAYORAN,SERDANG,29668,5267,24401,21225,45626,2021-12-14
3174021001,JAKARTA SELATAN,SETIA BUDI,SETIA BUDI,3023,576,2447,2171,4618,2021-12-14
3175101005,JAKARTA TIMUR,CIPAYUNG,SETU,20572,3867,16705,14328,31033,2021-12-14
3173071002,JAKARTA BARAT,PALMERAH,SLIPI,16591,2778,13813,12173,25986,2021-12-14
3173081004,JAKARTA BARAT,KEMBANGAN,SRENGSENG,45523,9457,36066,31460,67526,2021-12-14
3174091002,JAKARTA SELATAN,JAGAKARSA,SRENGSENG SAWAH,58196,8259,49937,44624,94561,2021-12-14
3173051003,JAKARTA BARAT,KEBON JERUK,SUKABUMI SELATAN,37033,7257,29776,24026,53802,2021-12-14
3173051002,JAKARTA BARAT,KEBON JERUK,SUKABUMI UTARA,38290,7950,30340,24631,54971,2021-12-14
3172041002,JAKARTA UTARA,CILINCING,SUKAPURA,53949,11396,42553,36403,78956,2021-12-14
3171031007,JAKARTA PUSAT,KEMAYORAN,SUMUR BATU,22717,3992,18725,16715,35440,2021-12-14
3172021004,JAKARTA UTARA,TANJUNG PRIOK,SUNGAI BAMBU,29876,5554,24322,20990,45312,2021-12-14
3172021006,JAKARTA UTARA,TANJUNG PRIOK,SUNTER AGUNG,71805,11683,60122,54420,114542,2021-12-14
3172021002,JAKARTA UTARA,TANJUNG PRIOK,SUNTER JAYA,63031,10390,52641,47267,99908,2021-12-14
3175091004,JAKARTA TIMUR,CIRACAS,SUSUKAN,38257,6764,31493,27181,58674,2021-12-14
3173031001,JAKARTA BARAT,TAMAN SARI,TAMAN SARI,14348,2468,11880,10538,22418,2021-12-14
3173041001,JAKARTA BARAT,TAMBORA,TAMBORA,10204,2003,8201,6852,15053,2021-12-14
3173041004,JAKARTA BARAT,TAMBORA,TANAH SEREAL,26387,4189,22198,19185,41383,2021-12-14
3171081004,JAKARTA PUSAT,JOHAR BARU,TANAH TINGGI,37693,6818,30875,25811,56686,2021-12-14
3173031004,JAKARTA BARAT,TAMAN SARI,TANGKI,13324,2102,11222,9873,21095,2021-12-14
3174091005,JAKARTA SELATAN,JAGAKARSA,TANJUNG BARAT,39770,6300,33470,29042,62512,2021-12-14
3173021005,JAKARTA BARAT,GROGOL PETAMBURAN,TANJUNG DUREN SELATAN,25337,4539,20798,19012,39810,2021-12-14
3173021002,JAKARTA BARAT,GROGOL PETAMBURAN,TANJUNG DUREN UTARA,17010,2697,14313,13225,27538,2021-12-14
3172021001,JAKARTA UTARA,TANJUNG PRIOK,TANJUNG PRIOK,34588,6714,27874,23581,51455,2021-12-14
3174011002,JAKARTA SELATAN,TEBET,TEBET BARAT,21194,3171,18023,16442,34465,2021-12-14
3174011001,JAKARTA SELATAN,TEBET,TEBET TIMUR,18199,2732,15467,14413,29880,2021-12-14
3173061003,JAKARTA BARAT,KALI DERES,TEGAL ALUR,83647,16233,67414,57783,125197,2021-12-14
3174031004,JAKARTA SELATAN,MAMPANG PRAPATAN,TEGAL PARANG,32401,6669,25732,21166,46898,2021-12-14
3173021003,JAKARTA BARAT,GROGOL PETAMBURAN,TOMANG,29605,5106,24499,21858,46357,2021-12-14
3172031005,JAKARTA UTARA,KOJA,TUGU SELATAN,39122,8022,31100,26162,57262,2021-12-14
3172031002,JAKARTA UTARA,KOJA,TUGU UTARA,67670,15043,52627,43615,96242,2021-12-14
3175061006,JAKARTA TIMUR,CAKUNG,UJUNG MENTENG,29934,4830,25104,22156,47260,2021-12-14
3174101005,JAKARTA SELATAN,PESANGGRAHAN,ULUJAMI,40544,8230,32314,27757,60071,2021-12-14
3175011006,JAKARTA TIMUR,MATRAMAN,UTAN KAYU SELATAN,33511,5587,27924,24154,52078,2021-12-14
3175011002,JAKARTA TIMUR,MATRAMAN,UTAN KAYU UTARA,28169,5309,22860,19439,42299,2021-12-14
3171031008,JAKARTA PUSAT,KEMAYORAN,UTAN PANJANG,29208,5386,23822,20163,43985,2021-12-14
3172021007,JAKARTA UTARA,TANJUNG PRIOK,WARAKAS,44401,7646,36755,31007,67762,2021-12-14
3173021007,JAKARTA BARAT,GROGOL PETAMBURAN,WIJAYA KUSUMA,38934,7527,31407,27433,58840,2021-12-14
3172051003,JAKARTA UTARA,PADEMANGAN,ANCOL,23947,5419,18528,15701,34229,2021-12-15
3173041007,JAKARTA BARAT,TAMBORA,ANGKE,29381,5793,23588,19780,43368,2021-12-15
3175041005,JAKARTA TIMUR,KRAMAT JATI,BALE KAMBANG,29074,6619,22455,18474,40929,2021-12-15
3175031003,JAKARTA TIMUR,JATINEGARA,BALI MESTER,9752,1849,7903,6907,14810,2021-12-15
3175101006,JAKARTA TIMUR,CIPAYUNG,BAMBU APUS,26285,4513,21772,19041,40813,2021-12-15
3174031002,JAKARTA SELATAN,MAMPANG PRAPATAN,BANGKA,21566,4267,17299,14940,32239,2021-12-15
3175051002,JAKARTA TIMUR,PASAR REBO,BARU,23886,3682,20204,18041,38245,2021-12-15
3175041004,JAKARTA TIMUR,KRAMAT JATI,BATU AMPAR,47898,10746,37152,31309,68461,2021-12-15
3171071002,JAKARTA PUSAT,TANAH ABANG,BENDUNGAN HILIR,21494,4098,17396,15349,32745,2021-12-15
3175031002,JAKARTA TIMUR,JATINEGARA,BIDARA CINA,36689,8253,28436,24161,52597,2021-12-15
3174101002,JAKARTA SELATAN,PESANGGRAHAN,BINTARO,53098,10030,43068,38776,81844,2021-12-15
3174011005,JAKARTA SELATAN,TEBET,BUKIT DURI,34183,6394,27789,24122,51911,2021-12-15
3171041006,JAKARTA PUSAT,SENEN,BUNGUR,18144,3545,14599,12533,27132,2021-12-15
3175061007,JAKARTA TIMUR,CAKUNG,CAKUNG BARAT,57724,11015,46709,39606,86315,2021-12-15
3175061004,JAKARTA TIMUR,CAKUNG,CAKUNG TIMUR,58287,10747,47540,40927,88467,2021-12-15
3175041007,JAKARTA TIMUR,KRAMAT JATI,CAWANG,32762,6472,26290,22234,48524,2021-12-15
3175101008,JAKARTA TIMUR,CIPAYUNG,CEGER,18932,3437,15495,13454,28949,2021-12-15
3171031006,JAKARTA PUSAT,KEMAYORAN,CEMPAKA BARU,32581,5748,26833,23046,49879,2021-12-15
3171051002,JAKARTA PUSAT,CEMPAKA PUTIH,CEMPAKA PUTIH BARAT,35885,7032,28853,25490,54343,2021-12-15
3171051001,JAKARTA PUSAT,CEMPAKA PUTIH,CEMPAKA PUTIH TIMUR,24292,4716,19576,17736,37312,2021-12-15
3173011001,JAKARTA BARAT,CENGKARENG,CENGKARENG BARAT,66284,12253,54031,48089,102120,2021-12-15
3173011006,JAKARTA BARAT,CENGKARENG,CENGKARENG TIMUR,81027,14930,66097,57266,123363,2021-12-15
3175091002,JAKARTA TIMUR,CIRACAS,CIBUBUR,66364,10716,55648,49092,104740,2021-12-15
3171011002,JAKARTA PUSAT,GAMBIR,CIDENG,15390,2864,12526,11214,23740,2021-12-15
3174091003,JAKARTA SELATAN,JAGAKARSA,CIGANJUR,38497,6019,32478,28451,60929,2021-12-15
3175051003,JAKARTA TIMUR,PASAR REBO,CIJANTUNG,41419,7164,34255,29848,64103,2021-12-15
3171061003,JAKARTA PUSAT,MENTENG,CIKINI,8274,1403,6871,5720,12591,2021-12-15
3174081006,JAKARTA SELATAN,PANCORAN,CIKOKO,10547,1712,8835,7890,16725,2021-12-15
3174061001,JAKARTA SELATAN,CILANDAK,CILANDAK BARAT,51752,8583,43169,39154,82323,2021-12-15
3174041003,JAKARTA SELATAN,PASAR MINGGU,CILANDAK TIMUR,25145,4251,20894,18541,39435,2021-12-15
3175101002,JAKARTA TIMUR,CIPAYUNG,CILANGKAP,27635,4597,23038,20364,43402,2021-12-15
3175041006,JAKARTA TIMUR,KRAMAT JATI,CILILITAN,40181,7816,32365,27509,59874,2021-12-15
3172041001,JAKARTA UTARA,CILINCING,CILINCING,43609,9643,33966,27645,61611,2021-12-15
3175101001,JAKARTA TIMUR,CIPAYUNG,CIPAYUNG,26104,4259,21845,19421,41266,2021-12-15
3174091006,JAKARTA SELATAN,JAGAKARSA,CIPEDAK,38303,5934,32369,28544,60913,2021-12-15
3174061005,JAKARTA SELATAN,CILANDAK,CIPETE SELATAN,26704,4769,21935,19947,41882,2021-12-15
3174071010,JAKARTA SELATAN,KEBAYORAN BARU,CIPETE UTARA,34102,6104,27998,24482,52480,2021-12-15
3175021003,JAKARTA TIMUR,PULO GADUNG,CIPINANG,39306,6614,32692,28429,61121,2021-12-15
3175031007,JAKARTA TIMUR,JATINEGARA,CIPINANG BESAR SELATAN,35212,7783,27429,22927,50356,2021-12-15
3175031008,JAKARTA TIMUR,JATINEGARA,CIPINANG BESAR UTARA,45319,9887,35432,29235,64667,2021-12-15
3175031005,JAKARTA TIMUR,JATINEGARA,CIPINANG CEMPEDAK,32824,6699,26125,23171,49296,2021-12-15
3175081005,JAKARTA TIMUR,MAKASAR,CIPINANG MELAYU,42308,7570,34738,30667,65405,2021-12-15
3175031006,JAKARTA TIMUR,JATINEGARA,CIPINANG MUARA,55243,10933,44310,37937,82247,2021-12-15
3174051003,JAKARTA SELATAN,KEBAYORAN LAMA,CIPULIR,39937,7894,32043,27467,59510,2021-12-15
3175091001,JAKARTA TIMUR,CIRACAS,CIRACAS,64594,11167,53427,45970,99397,2021-12-15
3175041003,JAKARTA TIMUR,KRAMAT JATI,DUKUH,24609,4258,20351,17437,37788,2021-12-15
3175071001,JAKARTA TIMUR,DUREN SAWIT,DUREN SAWIT,61160,12088,49072,42809,91881,2021-12-15
3174081004,JAKARTA SELATAN,PANCORAN,DUREN TIGA,28319,5230,23089,20021,43110,2021-12-15
3173051005,JAKARTA BARAT,KEBON JERUK,DURI KEPA,60138,11167,48971,43494,92465,2021-12-15
3173011002,JAKARTA BARAT,CENGKARENG,DURI KOSAMBI,77923,15351,62572,52555,115127,2021-12-15
3171011006,JAKARTA PUSAT,GAMBIR,DURI PULO,19610,3881,15729,13107,28836,2021-12-15
3173041011,JAKARTA BARAT,TAMBORA,DURI SELATAN,14259,2370,11889,10370,22259,2021-12-15
3173041003,JAKARTA BARAT,TAMBORA,DURI UTARA,19844,3335,16509,14106,30615,2021-12-15
3171081003,JAKARTA PUSAT,JOHAR BARU,GALUR,18243,3352,14891,12401,27292,2021-12-15
3171011001,JAKARTA PUSAT,GAMBIR,GAMBIR,2191,429,1762,1554,3316,2021-12-15
3174061004,JAKARTA SELATAN,CILANDAK,GANDARIA SELATAN,22119,3947,18172,16101,34273,2021-12-15
3174071009,JAKARTA SELATAN,KEBAYORAN BARU,GANDARIA UTARA,39922,7381,32541,28724,61265,2021-12-15
3175051001,JAKARTA TIMUR,PASAR REBO,GEDONG,35755,6692,29063,25466,54529,2021-12-15
3171071001,JAKARTA PUSAT,TANAH ABANG,GELORA,3127,584,2543,2289,4832,2021-12-15
3173031007,JAKARTA BARAT,TAMAN SARI,GLODOK,7837,1119,6718,6239,12957,2021-12-15
3171061004,JAKARTA PUSAT,MENTENG,GONDANGDIA,4100,886,3214,2999,6213,2021-12-15
3173021001,JAKARTA BARAT,GROGOL PETAMBURAN,GROGOL,16876,3124,13752,12058,25810,2021-12-15
3174051005,JAKARTA SELATAN,KEBAYORAN LAMA,GROGOL SELATAN,44251,8272,35979,31091,67070,2021-12-15
3174051004,JAKARTA SELATAN,KEBAYORAN LAMA,GROGOL UTARA,42494,8160,34334,29728,64062,2021-12-15
3174021007,JAKARTA SELATAN,SETIA BUDI,GUNTUR,3985,711,3274,3001,6275,2021-12-15
3174071002,JAKARTA SELATAN,KEBAYORAN BARU,GUNUNG,9436,1670,7766,7090,14856,2021-12-15
3171031005,JAKARTA PUSAT,KEMAYORAN,GUNUNG SAHARI SELATAN,19199,3450,15749,13795,29544,2021-12-15
3171021004,JAKARTA PUSAT,SAWAH BESAR,GUNUNG SAHARI UTARA,16650,2762,13888,12679,26567,2021-12-15
3175081004,JAKARTA TIMUR,MAKASAR,HALIM PERDANA KUSUMAH,28363,3406,24957,23258,48215,2021-12-15
3171031003,JAKARTA PUSAT,KEMAYORAN,HARAPAN MULIA,22557,4032,18525,15809,34334,2021-12-15
3174091001,JAKARTA SELATAN,JAGAKARSA,JAGAKARSA,62389,9500,52889,47050,99939,2021-12-15
3175021007,JAKARTA TIMUR,PULO GADUNG,JATI,32757,5729,27028,24361,51389,2021-12-15
3174041002,JAKARTA SELATAN,PASAR MINGGU,JATI PADANG,37502,6640,30862,27111,57973,2021-12-15
3173071004,JAKARTA BARAT,PALMERAH,JATI PULO,28738,5340,23398,19484,42882,2021-12-15
3175061001,JAKARTA TIMUR,CAKUNG,JATINEGARA,84160,16554,67606,57950,125556,2021-12-15
3175021004,JAKARTA TIMUR,PULO GADUNG,JATINEGARA KAUM,24632,4108,20524,17500,38024,2021-12-15
3173021004,JAKARTA BARAT,GROGOL PETAMBURAN,JELAMBAR,30266,5170,25096,22817,47913,2021-12-15
3173021006,JAKARTA BARAT,GROGOL PETAMBURAN,JELAMBAR BARU,38246,6384,31862,28776,60638,2021-12-15
3173041006,JAKARTA BARAT,TAMBORA,JEMBATAN BESI,29314,6590,22724,18550,41274,2021-12-15
3173041008,JAKARTA BARAT,TAMBORA,JEMBATAN LIMA,21021,4391,16630,13723,30353,2021-12-15
3173081005,JAKARTA BARAT,KEMBANGAN,JOGLO,40839,7677,33162,29023,62185,2021-12-15
3171081001,JAKARTA PUSAT,JOHAR BARU,JOHAR BARU,37488,6544,30944,26936,57880,2021-12-15
3173041002,JAKARTA BARAT,TAMBORA,KALI ANYAR,23856,4411,19445,16093,35538,2021-12-15
3172041004,JAKARTA UTARA,CILINCING,KALIBARU,67684,17004,50680,37947,88627,2021-12-15
3174081002,JAKARTA SELATAN,PANCORAN,KALIBATA,41994,8827,33167,28223,61390,2021-12-15
3173061001,JAKARTA BARAT,KALI DERES,KALIDERES,72447,13561,58886,51712,110598,2021-12-15
3175051004,JAKARTA TIMUR,PASAR REBO,KALISARI,43212,7124,36088,31686,67774,2021-12-15
3173061004,JAKARTA BARAT,KALI DERES,KAMAL,53783,11418,42365,35295,77660,2021-12-15
3172011002,JAKARTA UTARA,PENJARINGAN,KAMAL MUARA,12930,2216,10714,9270,19984,2021-12-15
3171071007,JAKARTA PUSAT,TANAH ABANG,KAMPUNG BALI,11358,2305,9053,7379,16432,2021-12-15
3175031001,JAKARTA TIMUR,JATINEGARA,KAMPUNG MELAYU,25717,5524,20193,16568,36761,2021-12-15
3171081002,JAKARTA PUSAT,JOHAR BARU,KAMPUNG RAWA,21237,3298,17939,14759,32698,2021-12-15
3175041002,JAKARTA TIMUR,KRAMAT JATI,KAMPUNG TENGAH,43993,10176,33817,28217,62034,2021-12-15
3173011005,JAKARTA BARAT,CENGKARENG,KAPUK,134466,29794,104672,88207,192879,2021-12-15
3172011003,JAKARTA UTARA,PENJARINGAN,KAPUK MUARA,35781,6468,29313,26564,55877,2021-12-15
3171021002,JAKARTA PUSAT,SAWAH BESAR,KARANG ANYAR,25761,4530,21231,18397,39628,2021-12-15
3174021004,JAKARTA SELATAN,SETIA BUDI,KARET,9623,1747,7876,6858,14734,2021-12-15
3174021003,JAKARTA SELATAN,SETIA BUDI,KARET KUNINGAN,16055,2932,13123,11530,24653,2021-12-15
3174021002,JAKARTA SELATAN,SETIA BUDI,KARET SEMANGGI,2770,531,2239,2033,4272,2021-12-15
3171071003,JAKARTA PUSAT,TANAH ABANG,KARET TENGSIN,19271,3513,15758,13455,29213,2021-12-15
3171021003,JAKARTA PUSAT,SAWAH BESAR,KARTINI,22292,3924,18368,16291,34659,2021-12-15
3175011003,JAKARTA TIMUR,MATRAMAN,KAYU MANIS,25284,4909,20375,17051,37426,2021-12-15
3175021006,JAKARTA TIMUR,PULO GADUNG,KAYU PUTIH,40696,7233,33463,30166,63629,2021-12-15
3173031006,JAKARTA BARAT,TAMAN SARI,KEAGUNGAN,17387,3014,14373,12215,26588,2021-12-15
3174041007,JAKARTA SELATAN,PASAR MINGGU,KEBAGUSAN,44552,8182,36370,31575,67945,2021-12-15
3174051006,JAKARTA SELATAN,KEBAYORAN LAMA,KEBAYORAN LAMA SELATAN,41212,7125,34087,30233,64320,2021-12-15
3174051001,JAKARTA SELATAN,KEBAYORAN LAMA,KEBAYORAN LAMA UTARA,42422,8238,34184,29780,63964,2021-12-15
3174011004,JAKARTA SELATAN,TEBET,KEBON BARU,35165,6082,29083,25444,54527,2021-12-15
3172021005,JAKARTA UTARA,TANJUNG PRIOK,KEBON BAWANG,50952,9550,41402,35809,77211,2021-12-15
3173051001,JAKARTA BARAT,KEBON JERUK,KEBON JERUK,53887,10274,43613,37318,80931,2021-12-15
3171071006,JAKARTA PUSAT,TANAH ABANG,KEBON KACANG,21531,4853,16678,13878,30556,2021-12-15
3171011005,JAKARTA PUSAT,GAMBIR,KEBON KELAPA,10163,1934,8229,7207,15436,2021-12-15
3171031002,JAKARTA PUSAT,KEMAYORAN,KEBON KOSONG,30019,5657,24362,20968,45330,2021-12-15
3175011005,JAKARTA TIMUR,MATRAMAN,KEBON MANGGIS,16490,2967,13523,11596,25119,2021-12-15
3171071005,JAKARTA PUSAT,TANAH ABANG,KEBON MELATI,32206,8123,24083,18813,42896,2021-12-15
3175081003,JAKARTA TIMUR,MAKASAR,KEBON PALA,46614,8604,38010,33043,71053,2021-12-15
3171061005,JAKARTA PUSAT,MENTENG,KEBON SIRIH,12299,2456,9843,8279,18122,2021-12-15
3173011004,JAKARTA BARAT,CENGKARENG,KEDAUNG KALI ANGKE,32612,5865,26747,23225,49972,2021-12-15
3173051007,JAKARTA BARAT,KEBON JERUK,KEDOYA SELATAN,32165,5542,26623,22894,49517,2021-12-15
3173051006,JAKARTA BARAT,KEBON JERUK,KEDOYA UTARA,45740,8262,37478,32545,70023,2021-12-15
3173051004,JAKARTA BARAT,KEBON JERUK,KELAPA DUA,23565,4329,19236,16700,35936,2021-12-15
3175091003,JAKARTA TIMUR,CIRACAS,KELAPA DUA WETAN,46875,7523,39352,34559,73911,2021-12-15
3172061003,JAKARTA UTARA,KELAPA GADING,KELAPA GADING BARAT,35717,5903,29814,27489,57303,2021-12-15
3172061001,JAKARTA UTARA,KELAPA GADING,KELAPA GADING TIMUR,33592,4870,28722,27150,55872,2021-12-15
3173071005,JAKARTA BARAT,PALMERAH,KEMANGGISAN,32139,5699,26440,23357,49797,2021-12-15
3171031001,JAKARTA PUSAT,KEMAYORAN,KEMAYORAN,20708,3846,16862,14450,31312,2021-12-15
3173081006,JAKARTA BARAT,KEMBANGAN,KEMBANGAN SELATAN,27130,5339,21791,19272,41063,2021-12-15
3173081001,JAKARTA BARAT,KEMBANGAN,KEMBANGAN UTARA,54451,10877,43574,37394,80968,2021-12-15
3171041002,JAKARTA PUSAT,SENEN,KENARI,9579,1773,7806,6846,14652,2021-12-15
3173041005,JAKARTA BARAT,TAMBORA,KERENDANG,19973,3804,16169,13757,29926,2021-12-15
3175071003,JAKARTA TIMUR,DUREN SAWIT,KLENDER,69978,15253,54725,45774,100499,2021-12-15
3172031001,JAKARTA UTARA,KOJA,KOJA,28175,5926,22249,18657,40906,2021-12-15
3173071006,JAKARTA BARAT,PALMERAH,KOTA BAMBU SELATAN,21158,3886,17272,14283,31555,2021-12-15
3173071003,JAKARTA BARAT,PALMERAH,KOTA BAMBU UTARA,24995,4745,20250,16592,36842,2021-12-15
3171041004,JAKARTA PUSAT,SENEN,KRAMAT,28835,5995,22840,17845,40685,2021-12-15
3175041001,JAKARTA TIMUR,KRAMAT JATI,KRAMAT JATI,34144,6708,27436,23255,50691,2021-12-15
3174071003,JAKARTA SELATAN,KEBAYORAN BARU,KRAMAT PELA,14413,2620,11793,10495,22288,2021-12-15
3173031002,JAKARTA BARAT,TAMAN SARI,KRUKUT,19244,3430,15814,13373,29187,2021-12-15
3174031005,JAKARTA SELATAN,MAMPANG PRAPATAN,KUNINGAN BARAT,12785,2169,10616,9271,19887,2021-12-15
3174021008,JAKARTA SELATAN,SETIA BUDI,KUNINGAN TIMUR,6008,1130,4878,4358,9236,2021-12-15
3171041005,JAKARTA PUSAT,SENEN,KWITANG,15486,3123,12363,10304,22667,2021-12-15
3172031003,JAKARTA UTARA,KOJA,LAGOA,59065,12897,46168,38244,84412,2021-12-15
3174061002,JAKARTA SELATAN,CILANDAK,LEBAK BULUS,37626,6619,31007,28280,59287,2021-12-15
3174091004,JAKARTA SELATAN,JAGAKARSA,LENTENG AGUNG,53946,8931,45015,38817,83832,2021-12-15
3175101007,JAKARTA TIMUR,CIPAYUNG,LUBANG BUAYA,63547,11226,52321,45318,97639,2021-12-15
3175081001,JAKARTA TIMUR,MAKASAR,MAKASAR,34390,5753,28637,25295,53932,2021-12-15
3175071006,JAKARTA TIMUR,DUREN SAWIT,MALAKA JAYA,30927,4823,26104,23413,49517,2021-12-15
3175071005,JAKARTA TIMUR,DUREN SAWIT,MALAKA SARI,27530,4224,23306,21092,44398,2021-12-15
3174031001,JAKARTA SELATAN,MAMPANG PRAPATAN,MAMPANG PRAPATAN,18159,3477,14682,12629,27311,2021-12-15
3173031005,JAKARTA BARAT,TAMAN SARI,MANGGA BESAR,7707,1238,6469,5860,12329,2021-12-15
3171021005,JAKARTA PUSAT,SAWAH BESAR,MANGGA DUA SELATAN,27442,5186,22256,19351,41607,2021-12-15
3174011007,JAKARTA SELATAN,TEBET,MANGGARAI,28373,4637,23736,20247,43983,2021-12-15
3174011006,JAKARTA SELATAN,TEBET,MANGGARAI SELATAN,23075,3453,19622,17134,36756,2021-12-15
3173031003,JAKARTA BARAT,TAMAN SARI,MAPHAR,16461,2888,13573,11763,25336,2021-12-15
3172041003,JAKARTA UTARA,CILINCING,MARUNDA,28943,6113,22830,17932,40762,2021-12-15
3174071001,JAKARTA SELATAN,KEBAYORAN BARU,MELAWAI,2627,488,2139,2012,4151,2021-12-15
3171061001,JAKARTA PUSAT,MENTENG,MENTENG,25624,5226,20398,16951,37349,2021-12-15
3174021005,JAKARTA SELATAN,SETIA BUDI,MENTENG ATAS,27816,4650,23166,20164,43330,2021-12-15
3174011003,JAKARTA SELATAN,TEBET,MENTENG DALAM,36028,6551,29477,25988,55465,2021-12-15
3173081003,JAKARTA BARAT,KEMBANGAN,MERUYA SELATAN,32130,6142,25988,22799,48787,2021-12-15
3173081002,JAKARTA BARAT,KEMBANGAN,MERUYA UTARA,43752,8429,35323,31694,67017,2021-12-15
3175101004,JAKARTA TIMUR,CIPAYUNG,MUNJUL,23871,4119,19752,17327,37079,2021-12-15
3172051002,JAKARTA UTARA,PADEMANGAN,PADEMANGAN BARAT,74240,16245,57995,48675,106670,2021-12-15
3172051001,JAKARTA UTARA,PADEMANGAN,PADEMANGAN TIMUR,37736,6235,31501,28648,60149,2021-12-15
3175011004,JAKARTA TIMUR,MATRAMAN,PAL MERIAM,19769,3714,16055,13532,29587,2021-12-15
3173071001,JAKARTA BARAT,PALMERAH,PALMERAH,63011,12267,50744,43200,93944,2021-12-15
3174081001,JAKARTA SELATAN,PANCORAN,PANCORAN,19421,3593,15828,13703,29531,2021-12-15
3172021003,JAKARTA UTARA,TANJUNG PRIOK,PAPANGGO,39097,7178,31919,27290,59209,2021-12-15
3171021001,JAKARTA PUSAT,SAWAH BESAR,PASAR BARU,12035,2175,9860,9035,18895,2021-12-15
3174021006,JAKARTA SELATAN,SETIA BUDI,PASAR MANGGIS,26752,4741,22011,19030,41041,2021-12-15
3174041001,JAKARTA SELATAN,PASAR MINGGU,PASAR MINGGU,24821,4374,20447,18188,38635,2021-12-15
3171041003,JAKARTA PUSAT,SENEN,PASEBAN,23533,4578,18955,16120,35075,2021-12-15
3173061005,JAKARTA BARAT,KALI DERES,PEGADUNGAN,75587,13779,61808,54545,116353,2021-12-15
3171061002,JAKARTA PUSAT,MENTENG,PEGANGSAAN,23455,4717,18738,15263,34001,2021-12-15
3172061002,JAKARTA UTARA,KELAPA GADING,PEGANGSAAN DUA,49976,7786,42190,39014,81204,2021-12-15
3172011004,JAKARTA UTARA,PENJARINGAN,PEJAGALAN,74578,14495,60083,53792,113875,2021-12-15
3174041006,JAKARTA SELATAN,PASAR MINGGU,PEJATEN BARAT,37346,6669,30677,27037,57714,2021-12-15
3174041005,JAKARTA SELATAN,PASAR MINGGU,PEJATEN TIMUR,57656,11460,46196,39184,85380,2021-12-15
3175051005,JAKARTA TIMUR,PASAR REBO,PEKAYON,43250,7278,35972,31310,67282,2021-12-15
3173041009,JAKARTA BARAT,TAMBORA,PEKOJAN,23587,4222,19365,16940,36305,2021-12-15
3174031003,JAKARTA SELATAN,MAMPANG PRAPATAN,PELA MAMPANG,43522,8012,35510,31178,66688,2021-12-15
3174081005,JAKARTA SELATAN,PANCORAN,PENGADEGAN,21478,3692,17786,15722,33508,2021-12-15
3175061003,JAKARTA TIMUR,CAKUNG,PENGGILINGAN,99255,21051,78204,65256,143460,2021-12-15
3172011001,JAKARTA UTARA,PENJARINGAN,PENJARINGAN,88308,21153,67155,54490,121645,2021-12-15
3174101001,JAKARTA SELATAN,PESANGGRAHAN,PESANGGRAHAN,27545,4443,23102,20538,43640,2021-12-15
3171071004,JAKARTA PUSAT,TANAH ABANG,PETAMBURAN,33271,8255,25016,20011,45027,2021-12-15
3174071008,JAKARTA SELATAN,KEBAYORAN BARU,PETOGOGAN,11499,2074,9425,8341,17766,2021-12-15
3171011004,JAKARTA PUSAT,GAMBIR,PETOJO SELATAN,14692,3113,11579,10167,21746,2021-12-15
3171011003,JAKARTA PUSAT,GAMBIR,PETOJO UTARA,17458,3514,13944,11839,25783,2021-12-15
3174101004,JAKARTA SELATAN,PESANGGRAHAN,PETUKANGAN SELATAN,37187,7171,30016,26415,56431,2021-12-15
3174101003,JAKARTA SELATAN,PESANGGRAHAN,PETUKANGAN UTARA,53716,10742,42974,37339,80313,2021-12-15
3175081002,JAKARTA TIMUR,MAKASAR,PINANG RANTI,27198,5539,21659,18614,40273,2021-12-15
3173031008,JAKARTA BARAT,TAMAN SARI,PINANGSIA,10729,1771,8958,7681,16639,2021-12-15
3175011001,JAKARTA TIMUR,MATRAMAN,PISANGAN BARU,31776,6089,25687,21497,47184,2021-12-15
3175021002,JAKARTA TIMUR,PULO GADUNG,PISANGAN TIMUR,41011,7041,33970,29979,63949,2021-12-15
3172011005,JAKARTA UTARA,PENJARINGAN,PLUIT,47783,8850,38933,35028,73961,2021-12-15
3175071002,JAKARTA TIMUR,DUREN SAWIT,PONDOK BAMBU,61550,12101,49449,43302,92751,2021-12-15
3175071004,JAKARTA TIMUR,DUREN SAWIT,PONDOK KELAPA,72015,13355,58660,52198,110858,2021-12-15
3175071007,JAKARTA TIMUR,DUREN SAWIT,PONDOK KOPI,35367,6232,29135,24792,53927,2021-12-15
3174061003,JAKARTA SELATAN,CILANDAK,PONDOK LABU,46464,7167,39297,35681,74978,2021-12-15
3174051002,JAKARTA SELATAN,KEBAYORAN LAMA,PONDOK PINANG,56169,10173,45996,40997,86993,2021-12-15
3175101003,JAKARTA TIMUR,CIPAYUNG,PONDOK RANGGON,25574,4526,21048,18553,39601,2021-12-15
3101011003,KAB.ADM.KEP.SERIBU,KEP. SERIBU UTARA,PULAU HARAPAN,2060,193,1867,1673,3540,2021-12-15
3101011002,KAB.ADM.KEP.SERIBU,KEP. SERIBU UTARA,PULAU KELAPA,5528,546,4982,4308,9290,2021-12-15
3101011001,KAB.ADM.KEP.SERIBU,KEP. SERIBU UTARA,PULAU PANGGANG,5450,412,5038,4593,9631,2021-12-15
3101021003,KAB.ADM.KEP.SERIBU,KEP. SERIBU SELATAN,PULAU PARI,2765,191,2574,2443,5017,2021-12-15
3101021002,KAB.ADM.KEP.SERIBU,KEP. SERIBU SELATAN,PULAU TIDUNG,4553,347,4206,3931,8137,2021-12-15
3101021001,KAB.ADM.KEP.SERIBU,KEP. SERIBU SELATAN,PULAU UNTUNG JAWA,1941,154,1787,1672,3459,2021-12-15
3174071007,JAKARTA SELATAN,KEBAYORAN BARU,PULO,5835,964,4871,4590,9461,2021-12-15
3175021001,JAKARTA TIMUR,PULO GADUNG,PULO GADUNG,34422,7037,27385,23742,51127,2021-12-15
3175061005,JAKARTA TIMUR,CAKUNG,PULO GEBANG,97301,17557,79744,67854,147598,2021-12-15
3174041004,JAKARTA SELATAN,PASAR MINGGU,RAGUNAN,39616,6516,33100,29397,62497,2021-12-15
3175091005,JAKARTA TIMUR,CIRACAS,RAMBUTAN,36771,7997,28774,24281,53055,2021-12-15
3172031006,JAKARTA UTARA,KOJA,RAWA BADAK SELATAN,42179,9275,32904,27152,60056,2021-12-15
3172031004,JAKARTA UTARA,KOJA,RAWA BADAK UTARA,34408,7155,27253,23090,50343,2021-12-15
3174071005,JAKARTA SELATAN,KEBAYORAN BARU,RAWA BARAT,5625,958,4667,4253,8920,2021-12-15
3173011003,JAKARTA BARAT,CENGKARENG,RAWA BUAYA,63799,11751,52048,44909,96957,2021-12-15
3175031004,JAKARTA TIMUR,JATINEGARA,RAWA BUNGA,21434,4693,16741,14187,30928,2021-12-15
3174081003,JAKARTA SELATAN,PANCORAN,RAWA JATI,20509,3664,16845,14944,31789,2021-12-15
3175061002,JAKARTA TIMUR,CAKUNG,RAWA TERATE,24637,4140,20497,17393,37890,2021-12-15
3175021005,JAKARTA TIMUR,PULO GADUNG,RAWAMANGUN,37612,6925,30687,27128,57815,2021-12-15
3171051003,JAKARTA PUSAT,CEMPAKA PUTIH,RAWASARI,21967,4137,17830,15829,33659,2021-12-15
3173041010,JAKARTA BARAT,TAMBORA,ROA MALAKA,3484,587,2897,2654,5551,2021-12-15
3172041006,JAKARTA UTARA,CILINCING,ROROTAN,41668,7840,33828,28527,62355,2021-12-15
3174071004,JAKARTA SELATAN,KEBAYORAN BARU,SELONG,2842,529,2313,2178,4491,2021-12-15
3173061002,JAKARTA BARAT,KALI DERES,SEMANAN,71354,13925,57429,48133,105562,2021-12-15
3172041007,JAKARTA UTARA,CILINCING,SEMPER BARAT,68587,12472,56115,48547,104662,2021-12-15
3172041005,JAKARTA UTARA,CILINCING,SEMPER TIMUR,36267,7172,29095,24535,53630,2021-12-15
3174071006,JAKARTA SELATAN,KEBAYORAN BARU,SENAYAN,2771,628,2143,1926,4069,2021-12-15
3171041001,JAKARTA PUSAT,SENEN,SENEN,6804,1357,5447,4664,10111,2021-12-15
3171031004,JAKARTA PUSAT,KEMAYORAN,SERDANG,29668,5255,24413,21250,45663,2021-12-15
3174021001,JAKARTA SELATAN,SETIA BUDI,SETIA BUDI,3023,576,2447,2171,4618,2021-12-15
3175101005,JAKARTA TIMUR,CIPAYUNG,SETU,20572,3865,16707,14343,31050,2021-12-15
3173071002,JAKARTA BARAT,PALMERAH,SLIPI,16591,2775,13816,12180,25996,2021-12-15
3173081004,JAKARTA BARAT,KEMBANGAN,SRENGSENG,45523,9454,36069,31474,67543,2021-12-15
3174091002,JAKARTA SELATAN,JAGAKARSA,SRENGSENG SAWAH,58196,8246,49950,44647,94597,2021-12-15
3173051003,JAKARTA BARAT,KEBON JERUK,SUKABUMI SELATAN,37033,7247,29786,24049,53835,2021-12-15
3173051002,JAKARTA BARAT,KEBON JERUK,SUKABUMI UTARA,38290,7930,30360,24646,55006,2021-12-15
3172041002,JAKARTA UTARA,CILINCING,SUKAPURA,53949,11377,42572,36431,79003,2021-12-15
3171031007,JAKARTA PUSAT,KEMAYORAN,SUMUR BATU,22717,3988,18729,16727,35456,2021-12-15
3172021004,JAKARTA UTARA,TANJUNG PRIOK,SUNGAI BAMBU,29876,5549,24327,21011,45338,2021-12-15
3172021006,JAKARTA UTARA,TANJUNG PRIOK,SUNTER AGUNG,71805,11665,60140,54457,114597,2021-12-15
3172021002,JAKARTA UTARA,TANJUNG PRIOK,SUNTER JAYA,63031,10375,52656,47299,99955,2021-12-15
3175091004,JAKARTA TIMUR,CIRACAS,SUSUKAN,38257,6754,31503,27202,58705,2021-12-15
3173031001,JAKARTA BARAT,TAMAN SARI,TAMAN SARI,14348,2464,11884,10547,22431,2021-12-15
3173041001,JAKARTA BARAT,TAMBORA,TAMBORA,10204,2003,8201,6853,15054,2021-12-15
3173041004,JAKARTA BARAT,TAMBORA,TANAH SEREAL,26387,4183,22204,19192,41396,2021-12-15
3171081004,JAKARTA PUSAT,JOHAR BARU,TANAH TINGGI,37693,6809,30884,25824,56708,2021-12-15
3173031004,JAKARTA BARAT,TAMAN SARI,TANGKI,13324,2099,11225,9880,21105,2021-12-15
3174091005,JAKARTA SELATAN,JAGAKARSA,TANJUNG BARAT,39770,6291,33479,29140,62619,2021-12-15
3173021005,JAKARTA BARAT,GROGOL PETAMBURAN,TANJUNG DUREN SELATAN,25337,4534,20803,19018,39821,2021-12-15
3173021002,JAKARTA BARAT,GROGOL PETAMBURAN,TANJUNG DUREN UTARA,17010,2694,14316,13230,27546,2021-12-15
3172021001,JAKARTA UTARA,TANJUNG PRIOK,TANJUNG PRIOK,34588,6705,27883,23599,51482,2021-12-15
3174011002,JAKARTA SELATAN,TEBET,TEBET BARAT,21194,3169,18025,16463,34488,2021-12-15
3174011001,JAKARTA SELATAN,TEBET,TEBET TIMUR,18199,2729,15470,14418,29888,2021-12-15
3173061003,JAKARTA BARAT,KALI DERES,TEGAL ALUR,83647,16217,67430,57830,125260,2021-12-15
3174031004,JAKARTA SELATAN,MAMPANG PRAPATAN,TEGAL PARANG,32401,6663,25738,21176,46914,2021-12-15
3173021003,JAKARTA BARAT,GROGOL PETAMBURAN,TOMANG,29605,5102,24503,21867,46370,2021-12-15
3172031005,JAKARTA UTARA,KOJA,TUGU SELATAN,39122,7970,31152,26186,57338,2021-12-15
3172031002,JAKARTA UTARA,KOJA,TUGU UTARA,67670,15018,52652,43662,96314,2021-12-15
3175061006,JAKARTA TIMUR,CAKUNG,UJUNG MENTENG,29934,4824,25110,22166,47276,2021-12-15
3174101005,JAKARTA SELATAN,PESANGGRAHAN,ULUJAMI,40544,8219,32325,27775,60100,2021-12-15
3175011006,JAKARTA TIMUR,MATRAMAN,UTAN KAYU SELATAN,33511,5582,27929,24177,52106,2021-12-15
3175011002,JAKARTA TIMUR,MATRAMAN,UTAN KAYU UTARA,28169,5300,22869,19449,42318,2021-12-15
3171031008,JAKARTA PUSAT,KEMAYORAN,UTAN PANJANG,29208,5374,23834,20190,44024,2021-12-15
3172021007,JAKARTA UTARA,TANJUNG PRIOK,WARAKAS,44401,7639,36762,31046,67808,2021-12-15
3173021007,JAKARTA BARAT,GROGOL PETAMBURAN,WIJAYA KUSUMA,38934,7520,31414,27455,58869,2021-12-15
